station_id,dayofweek,hour,is_member,starts,ends,diff,lat,lng
KA1503000014,1,8,false,17,14,-3,41.7851,-87.60108
TA1309000011,1,8,false,5,17,12,41.78873,-87.60131
KA1503000071,1,8,false,6,10,4,41.79148,-87.59988
KA1504000076,1,8,false,9,10,1,41.7943,-87.60145
TA1308000009,1,8,false,12,5,-7,41.79522,-87.58075
KA1503000052,1,8,false,12,4,-8,41.79935,-87.60097
KA1503000059,1,8,false,11,7,-4,41.79952,-87.58643
TA1309000037,1,8,false,11,8,-3,41.79957,-87.59474
13398,1,8,false,19,8,-11,41.80256,-87.59035
TA1308000035,1,8,false,7,11,4,41.80944,-87.59188
KA1503000032,1,8,false,15,1,-14,41.81912,-87.64328
TA1307000048,1,8,false,11,4,-7,41.83855,-87.60821
TA1305000004,1,8,false,14,13,-1,41.8514,-87.61884
13102,1,8,false,14,4,-10,41.85762,-87.61942
13150,1,8,false,12,5,-7,41.85783,-87.62455
13164,1,8,false,12,4,-8,41.85818,-87.65648
SL-012,1,8,false,14,3,-11,41.86038,-87.62581
TA1307000124,1,8,false,17,12,-5,41.86411,-87.62372
TA1305000002,1,8,false,23,26,3,41.86721,-87.62597
15544,1,8,false,12,33,21,41.86723,-87.61536
SL-005,1,8,false,33,18,-15,41.8679,-87.62304
13285,1,8,false,1,10,9,41.86928,-87.67372
TA1309000010,1,8,false,31,12,-19,41.87074,-87.62574
TA1309000064,1,8,false,5,10,5,41.87127,-87.67369
TA1307000130,1,8,false,2,10,8,41.87178,-87.65103
SL-008,1,8,false,28,11,-17,41.87209,-87.62956
13332,1,8,false,22,5,-17,41.87219,-87.6615
SL-011,1,8,false,13,7,-6,41.87256,-87.63356
623,1,8,false,37,11,-26,41.87272,-87.62399
KA1504000104,1,8,false,5,15,10,41.87296,-87.66912
SL-007,1,8,false,12,9,-3,41.87404,-87.6277
13028,1,8,false,10,11,1,41.87475,-87.64981
SL-010,1,8,false,6,23,17,41.87501,-87.63309
15541,1,8,false,16,9,-7,41.8758,-87.62086
TA1305000010,1,8,false,24,12,-12,41.87623,-87.62444
624,1,8,false,8,30,22,41.87626,-87.62923
13138,1,8,false,11,16,5,41.87723,-87.63941
15539,1,8,false,17,7,-10,41.87763,-87.64405
13158,1,8,false,21,22,1,41.87764,-87.64957
TA1305000025,1,8,false,25,63,38,41.87773,-87.63528
TA1309000002,1,8,false,13,10,-3,41.87784,-87.62408
TA1309000004,1,8,false,8,25,17,41.87811,-87.63184
638,1,8,false,11,25,14,41.87827,-87.64078
TA1305000005,1,8,false,9,20,11,41.87924,-87.62975
13011,1,8,false,16,45,29,41.87931,-87.63993
TA1309000008,1,8,false,14,34,20,41.87933,-87.6355
KA1503000034,1,8,false,10,18,8,41.87938,-87.63197
TA1309000007,1,8,false,10,49,39,41.88022,-87.63526
WL-011,1,8,false,12,18,6,41.88034,-87.64273
13300,1,8,false,46,36,-10,41.88097,-87.61675
13008,1,8,false,38,42,4,41.88105,-87.62408
49,1,8,false,1,15,14,41.88116,-87.62963
TA1305000006,1,8,false,23,47,24,41.88122,-87.6296
13056,1,8,false,15,21,6,41.88168,-87.63951
TA1307000120,1,8,false,33,19,-14,41.88188,-87.64879
13341,1,8,false,29,27,-2,41.88208,-87.63985
13036,1,8,false,9,19,10,41.8821,-87.62513
TA1305000032,1,8,false,44,48,4,41.88218,-87.64109
13006,1,8,false,11,20,9,41.88268,-87.63252
13353,1,8,false,20,15,-5,41.88283,-87.6612
654,1,8,false,17,6,-11,41.88307,-87.65698
13409,1,8,false,14,9,-5,41.8831,-87.6511
KA1503000072,1,8,false,10,35,25,41.88317,-87.63693
WL-012,1,8,false,20,36,16,41.88337,-87.6412
13053,1,8,false,17,27,10,41.88365,-87.64863
13001,1,8,false,40,33,-7,41.88397,-87.62459
18062,1,8,false,11,13,2,41.88412,-87.65427
81,1,8,false,2,15,13,41.88417,-87.6296
TA1306000010,1,8,false,11,24,13,41.88419,-87.62961
TA1305000030,1,8,false,22,41,19,41.88459,-87.63178
15535,1,8,false,14,16,2,41.8846,-87.64455
TA1305000029,1,8,false,19,23,4,41.88466,-87.62787
13263,1,8,false,20,21,1,41.88467,-87.61952
TA1306000015,1,8,false,25,42,17,41.88549,-87.65232
13021,1,8,false,32,42,10,41.88559,-87.64184
TA1307000111,1,8,false,13,52,39,41.88582,-87.63548
13073,1,8,false,7,12,5,41.88592,-87.66717
KA17018054,1,8,false,2,14,12,41.88595,-87.67701
KA1503000012,1,8,false,25,27,2,41.88599,-87.63089
TA1305000011,1,8,false,52,47,-5,41.886,-87.62418
15534,1,8,false,23,6,-17,41.88627,-87.61749
13197,1,8,false,5,30,25,41.8866,-87.65816
TA1308000029,1,8,false,59,15,-44,41.88673,-87.62225
TA1307000131,1,8,false,20,17,-3,41.88688,-87.62606
KA1503000064,1,8,false,14,8,-6,41.88697,-87.61281
TA1305000022,1,8,false,34,59,25,41.88817,-87.63656
TA1306000003,1,8,false,37,10,-27,41.88867,-87.64442
KA1503000043,1,8,false,59,41,-18,41.88918,-87.63851
13050,1,8,false,15,36,21,41.88919,-87.62775
13432,1,8,false,4,11,7,41.88989,-87.67149
TA1307000151,1,8,false,37,45,8,41.88993,-87.63427
212,1,8,false,3,11,8,41.88995,-87.63427
636,1,8,false,13,12,-1,41.88997,-87.63662
KA1503000044,1,8,false,27,21,-6,41.89018,-87.6262
13427,1,8,false,22,23,1,41.89054,-87.62205
13430,1,8,false,24,32,8,41.89077,-87.63169
TA1306000013,1,8,false,33,22,-11,41.89083,-87.61852
RN-,1,8,false,24,30,6,41.89102,-87.63546
TA1308000006,1,8,false,11,9,-2,41.89128,-87.67686
TA1307000117,1,8,false,51,50,-1,41.89144,-87.62675
13033,1,8,false,11,24,13,41.8916,-87.64835
13194,1,8,false,12,8,-4,41.8918,-87.65878
TA1305000003,1,8,false,21,25,4,41.89187,-87.62061
13022,1,8,false,48,56,8,41.89227,-87.61205
TA1306000029,1,8,false,29,22,-7,41.89256,-87.61449
13265,1,8,false,28,14,-14,41.89383,-87.64172
13045,1,8,false,47,32,-15,41.89403,-87.62931
13016,1,8,false,42,58,16,41.89431,-87.62277
KA1503000041,1,8,false,46,29,-17,41.89452,-87.61798
13196,1,8,false,22,8,-14,41.89455,-87.65345
TA1307000062,1,8,false,21,15,-6,41.89466,-87.63839
TA1306000012,1,8,false,58,39,-19,41.89475,-87.63438
KP1705001026,1,8,false,20,27,7,41.89483,-87.6323
13132,1,8,false,12,12,0,41.89573,-87.67718
15530,1,8,false,35,26,-9,41.89575,-87.62596
18003,1,8,false,9,13,4,41.89575,-87.62011
13247,1,8,false,8,12,4,41.89597,-87.66775
TA1305000020,1,8,false,23,13,-10,41.89636,-87.65406
13289,1,8,false,12,3,-9,41.89638,-87.661
86,1,8,false,11,1,-10,41.89639,-87.661
13303,1,8,false,19,13,-6,41.89672,-87.63088
13017,1,8,false,38,22,-16,41.89676,-87.6357
13338,1,8,false,32,15,-17,41.89697,-87.62173
TA1307000061,1,8,false,15,15,0,41.89745,-87.62873
13034,1,8,false,18,18,0,41.89754,-87.62352
TA1306000009,1,8,false,21,27,6,41.89772,-87.64299
620,1,8,false,13,17,4,41.89817,-87.63754
15529,1,8,false,19,13,-6,41.89858,-87.62206
TA1307000128,1,8,false,27,43,16,41.89896,-87.6299
657,1,8,false,18,3,-15,41.89918,-87.6722
13248,1,8,false,11,5,-6,41.89964,-87.66788
TA1306000011,1,8,false,11,6,-5,41.89994,-87.63443
KA1504000116,1,8,false,17,6,-11,41.90023,-87.64299
13290,1,8,false,10,9,-1,41.90069,-87.66259
13042,1,8,false,53,54,1,41.90097,-87.62377
TA1307000070,1,8,false,10,2,-8,41.90133,-87.67742
KA1504000133,1,8,false,18,13,-5,41.90234,-87.62773
176,1,8,false,20,7,-13,41.90291,-87.63141
TA1307000039,1,8,false,41,25,-16,41.90294,-87.63137
TA1305000034,1,8,false,13,7,-6,41.90313,-87.67391
KA1504000135,1,8,false,32,26,-6,41.90319,-87.63439
13061,1,8,false,30,28,-2,41.90342,-87.66779
KA1504000079,1,8,false,15,16,1,41.9035,-87.64334
TA1307000115,1,8,false,8,10,2,41.9046,-87.64056
291,1,8,false,10,5,-5,41.90672,-87.63494
TA1308000049,1,8,false,34,24,-10,41.90672,-87.6349
KA1504000134,1,8,false,12,16,4,41.90687,-87.6262
13224,1,8,false,13,7,-6,41.90706,-87.66725
TA1307000143,1,8,false,15,4,-11,41.90762,-87.63854
13221,1,8,false,16,13,-3,41.90765,-87.67254
TA1309000024,1,8,false,24,23,-1,41.908,-87.63152
TA1305000041,1,8,false,16,21,5,41.9094,-87.67769
331,1,8,false,22,19,-3,41.90965,-87.64812
TA1305000037,1,8,false,12,6,-6,41.91018,-87.67003
TA1306000008,1,8,false,11,6,-5,41.9102,-87.6435
TA1308000005,1,8,false,11,6,-5,41.91042,-87.68238
13257,1,8,false,14,4,-10,41.91054,-87.68956
13154,1,8,false,14,11,-3,41.91054,-87.65312
13058,1,8,false,18,10,-8,41.91059,-87.64942
TA1307000038,1,8,false,22,6,-16,41.91138,-87.63868
LF-005,1,8,false,17,24,7,41.91172,-87.62681
13128,1,8,false,19,11,-8,41.91197,-87.63197
TA1308000050,1,8,false,27,49,22,41.91211,-87.6347
13243,1,8,false,9,15,6,41.91262,-87.6814
TA1306000032,1,8,false,13,13,0,41.9137,-87.65285
TA1307000166,1,8,false,17,7,-10,41.91386,-87.64877
15655,1,8,false,11,4,-7,41.91401,-87.70514
13068,1,8,false,12,11,-1,41.91554,-87.68703
13179,1,8,false,27,18,-9,41.9157,-87.63461
TA1305000039,1,8,false,24,11,-13,41.9163,-87.66749
15651,1,8,false,6,11,5,41.91752,-87.70181
TA1309000006,1,8,false,13,8,-5,41.91809,-87.64375
TA1307000163,1,8,false,8,12,4,41.91821,-87.65696
13146,1,8,false,14,25,11,41.91831,-87.63629
13059,1,8,false,22,24,2,41.91845,-87.65222
13192,1,8,false,8,20,12,41.91995,-87.64884
TA1309000030,1,8,false,10,8,-2,41.92077,-87.66372
13292,1,8,false,18,5,-13,41.92152,-87.70733
TA1309000033,1,8,false,12,8,-4,41.92158,-87.65381
13193,1,8,false,26,26,0,41.92182,-87.64412
144,1,8,false,11,1,-10,41.92182,-87.64411
13191,1,8,false,25,14,-11,41.92217,-87.63891
13084,1,8,false,8,10,2,41.92268,-87.69715
LP-,1,8,false,11,8,-3,41.92396,-87.63584
TA1307000001,1,8,false,16,16,0,41.92535,-87.66581
TA1306000026,1,8,false,17,10,-7,41.92558,-87.65842
TA1306000016,1,8,false,12,28,16,41.9256,-87.65371
TA1309000019,1,8,false,38,22,-16,41.92586,-87.63897
TA1309000058,1,8,false,37,20,-17,41.92591,-87.64927
TA1308000001,1,8,false,23,13,-10,41.92627,-87.63086
TA1309000023,1,8,false,22,10,-12,41.9287,-87.65383
TA1307000113,1,8,false,14,12,-2,41.92878,-87.66391
13296,1,8,false,11,2,-9,41.92883,-87.66852
TA1309000059,1,8,false,10,13,3,41.92889,-87.65898
TA1309000061,1,8,false,27,11,-16,41.92915,-87.64909
TA1305000014,1,8,false,27,36,9,41.92956,-87.64313
13085,1,8,false,21,9,-12,41.92958,-87.70789
TA1307000142,1,8,false,28,19,-9,41.93125,-87.64432
13276,1,8,false,25,28,3,41.93132,-87.63874
TA1307000064,1,8,false,18,25,7,41.93222,-87.65864
TA1306000014,1,8,false,14,31,17,41.93242,-87.65271
TA1309000039,1,8,false,13,9,-4,41.93258,-87.63642
TA1309000036,1,8,false,21,17,-4,41.93313,-87.64776
15644,1,8,false,10,1,-9,41.93534,-87.71687
TA1307000006,1,8,false,13,19,6,41.93571,-87.6636
13268,1,8,false,10,6,-4,41.93588,-87.67843
TA1307000052,1,8,false,14,26,12,41.93628,-87.65266
TA1307000136,1,8,false,20,13,-7,41.9365,-87.64755
TA1307000041,1,8,false,26,20,-6,41.93669,-87.63683
13137,1,8,false,30,19,-11,41.9376,-87.6441
13229,1,8,false,11,7,-4,41.93946,-87.66376
TA1308000019,1,8,false,21,8,-13,41.93973,-87.65886
13277,1,8,false,14,9,-5,41.9401,-87.64546
TA1307000134,1,8,false,17,21,4,41.94016,-87.65303
TA1309000049,1,8,false,34,25,-9,41.94077,-87.63919
13071,1,8,false,16,18,2,41.94373,-87.66401
632,1,8,false,15,16,1,41.94453,-87.6547
13278,1,8,false,27,28,1,41.94553,-87.64644
13235,1,8,false,25,11,-14,41.94814,-87.66396
13325,1,8,false,28,23,-5,41.94907,-87.64863
TA1307000126,1,8,false,14,18,4,41.94936,-87.65451
TA1307000150,1,8,false,21,19,-2,41.94945,-87.64646
13319,1,8,false,10,9,-1,41.95069,-87.6687
TA1307000127,1,8,false,6,11,5,41.9508,-87.65918
13323,1,8,false,21,25,4,41.95282,-87.65
13063,1,8,false,6,10,4,41.95424,-87.65441
TA1308000022,1,8,false,22,4,-18,41.95438,-87.64805
13249,1,8,false,4,11,7,41.95606,-87.66885
13379,1,8,false,13,8,-5,41.95786,-87.6495
TA1309000027,1,8,false,19,11,-8,41.9585,-87.65499
13389,1,8,false,16,1,-15,41.961,-87.64958
TA1307000107,1,8,false,18,12,-6,41.96164,-87.65464
TA1309000014,1,8,false,16,6,-10,41.96709,-87.66744
TA1307000119,1,8,false,12,7,-5,41.96796,-87.65
TA1309000066,1,8,false,7,24,17,41.9691,-87.67423
TA1309000035,1,8,false,9,17,8,41.97335,-87.66785
KA1504000152,1,8,false,9,10,1,41.98403,-87.65231
604,1,8,false,2,16,14,42.05824,-87.67744
KA1503000014,1,8,true,99,34,-65,41.7851,-87.60108
426,1,8,true,13,10,-3,41.7851,-87.60108
KA1503000070,1,8,true,27,8,-19,41.78794,-87.58831
328,1,8,true,8,14,6,41.78872,-87.6013
TA1309000011,1,8,true,15,66,51,41.78873,-87.60131
423,1,8,true,5,10,5,41.79148,-87.59988
KA1503000071,1,8,true,8,99,91,41.79148,-87.59988
KA1503000074,1,8,true,16,7,-9,41.79174,-87.58395
TA1309000063,1,8,true,26,20,-6,41.79325,-87.5878
KA1504000076,1,8,true,50,97,47,41.7943,-87.60145
TA1308000009,1,8,true,43,12,-31,41.79522,-87.58075
TA1307000164,1,8,true,11,19,8,41.79527,-87.59647
KA1503000052,1,8,true,26,22,-4,41.79935,-87.60097
KA1503000059,1,8,true,20,10,-10,41.79952,-87.58643
TA1309000037,1,8,true,48,19,-29,41.79957,-87.59474
KA1503000007,1,8,true,26,10,-16,41.80242,-87.58689
13398,1,8,true,29,9,-20,41.80256,-87.59035
TA1308000035,1,8,true,6,15,9,41.80944,-87.59188
TA1308000002,1,8,true,19,4,-15,41.80983,-87.59937
KA1503000027,1,8,true,4,14,10,41.81666,-87.61942
KA1503000068,1,8,true,26,2,-24,41.82878,-87.68062
TA1308000045,1,8,true,15,6,-9,41.83062,-87.64129
TA1307000129,1,8,true,5,88,83,41.83104,-87.62683
13345,1,8,true,17,3,-14,41.83138,-87.61803
13216,1,8,true,17,56,39,41.83473,-87.62581
13217,1,8,true,18,5,-13,41.83488,-87.61792
13215,1,8,true,14,6,-8,41.83634,-87.6135
TA1308000046,1,8,true,27,4,-23,41.83779,-87.65115
TA1309000055,1,8,true,13,5,-8,41.8382,-87.64514
KA1503000038,1,8,true,10,11,1,41.83845,-87.6354
TA1307000048,1,8,true,15,29,14,41.83855,-87.60821
TA1308000036,1,8,true,25,10,-15,41.83883,-87.62186
TA1307000139,1,8,true,44,7,-37,41.84205,-87.61698
147,1,8,true,4,15,11,41.84569,-87.62251
TA1307000005,1,8,true,20,41,21,41.84569,-87.6225
15689,1,8,true,12,1,-11,41.84912,-87.69515
13075,1,8,true,4,13,9,41.8531,-87.63192
13096,1,8,true,3,10,7,41.8538,-87.69577
15546,1,8,true,21,2,-19,41.85416,-87.61916
13307,1,8,true,15,5,-10,41.85489,-87.66359
13089,1,8,true,11,21,10,41.85497,-87.67567
13331,1,8,true,28,5,-23,41.85515,-87.65414
15545,1,8,true,25,25,0,41.85627,-87.61334
SL-013,1,8,true,15,6,-9,41.85659,-87.62755
SL-006,1,8,true,10,1,-9,41.8568,-87.63387
13135,1,8,true,31,11,-20,41.85753,-87.66157
338,1,8,true,13,2,-11,41.85758,-87.61956
13102,1,8,true,72,16,-56,41.85762,-87.61942
13150,1,8,true,73,23,-50,41.85783,-87.62455
273,1,8,true,16,6,-10,41.85783,-87.62455
13099,1,8,true,15,13,-2,41.85784,-87.64627
TA1307000159,1,8,true,19,5,-14,41.8579,-87.6687
TA1307000044,1,8,true,13,6,-7,41.85794,-87.64083
13163,1,8,true,33,11,-22,41.85808,-87.65108
13164,1,8,true,40,5,-35,41.85818,-87.65648
15,1,8,true,14,1,-13,41.85819,-87.65648
SL-012,1,8,true,66,19,-47,41.86038,-87.62581
72,1,8,true,24,8,-16,41.86039,-87.62581
13304,1,8,true,14,7,-7,41.86126,-87.65659
KA1504000109,1,8,true,5,18,13,41.86192,-87.69347
TA1306000002,1,8,true,21,21,0,41.86238,-87.65108
TA1307000124,1,8,true,68,44,-24,41.86411,-87.62372
168,1,8,true,13,3,-10,41.86415,-87.62372
TA1309000001,1,8,true,19,15,-4,41.86488,-87.64708
13431,1,8,true,29,25,-4,41.8661,-87.60728
WL-008,1,8,true,10,13,3,41.86712,-87.64108
TA1305000002,1,8,true,103,51,-52,41.86721,-87.62597
59,1,8,true,11,12,1,41.86721,-87.62597
15544,1,8,true,32,26,-6,41.86723,-87.61536
TA1305000017,1,8,true,16,18,2,41.86734,-87.64863
KA1706005007,1,8,true,11,4,-7,41.86749,-87.63219
SL-005,1,8,true,126,47,-79,41.8679,-87.62304
255,1,8,true,27,3,-24,41.86791,-87.62304
644,1,8,true,24,9,-15,41.86859,-87.68625
13139,1,8,true,20,4,-16,41.86893,-87.65913
13285,1,8,true,15,125,110,41.86928,-87.67372
13160,1,8,true,32,6,-26,41.86947,-87.65548
15550,1,8,true,19,21,2,41.87024,-87.63947
TA1309000010,1,8,true,81,37,-44,41.87074,-87.62574
SL-009,1,8,true,48,8,-40,41.87081,-87.63121
342,1,8,true,8,44,36,41.87127,-87.6737
TA1309000064,1,8,true,13,120,107,41.87127,-87.67369
261,1,8,true,5,17,12,41.87151,-87.6699
TA1307000130,1,8,true,39,42,3,41.87178,-87.65103
108,1,8,true,11,15,4,41.87183,-87.64664
TA1307000121,1,8,true,22,84,62,41.87184,-87.64664
41,1,8,true,30,7,-23,41.87209,-87.62957
SL-008,1,8,true,165,55,-110,41.87209,-87.62956
13332,1,8,true,88,34,-54,41.87219,-87.6615
175,1,8,true,22,2,-20,41.87255,-87.63359
SL-011,1,8,true,86,22,-64,41.87256,-87.63356
623,1,8,true,51,29,-22,41.87272,-87.62399
KA1504000104,1,8,true,20,180,160,41.87296,-87.66912
383,1,8,true,2,29,27,41.87297,-87.66912
320,1,8,true,23,12,-11,41.87327,-87.66402
5,1,8,true,2,11,9,41.87403,-87.6277
SL-007,1,8,true,56,29,-27,41.87404,-87.6277
13326,1,8,true,10,32,22,41.87425,-87.63958
321,1,8,true,24,13,-11,41.87427,-87.63257
TA1306000025,1,8,true,14,25,11,41.87464,-87.65703
15668,1,8,true,12,7,-5,41.87471,-87.68642
13028,1,8,true,17,40,23,41.87475,-87.64981
13081,1,8,true,14,21,7,41.87501,-87.67326
SL-010,1,8,true,68,26,-42,41.87501,-87.63309
15541,1,8,true,16,3,-13,41.8758,-87.62086
13037,1,8,true,12,18,6,41.87588,-87.64078
TA1305000009,1,8,true,26,36,10,41.87593,-87.63068
317,1,8,true,9,15,6,41.87603,-87.68195
TA1305000010,1,8,true,12,38,26,41.87623,-87.62444
624,1,8,true,35,37,2,41.87626,-87.62923
33,1,8,true,13,12,-1,41.87715,-87.62786
TA1305000035,1,8,true,29,66,37,41.87716,-87.62787
13138,1,8,true,55,107,52,41.87723,-87.63941
75,1,8,true,8,10,2,41.87724,-87.63937
631,1,8,true,1,21,20,41.87761,-87.6739
15539,1,8,true,46,64,18,41.87763,-87.64405
13158,1,8,true,116,68,-48,41.87764,-87.64957
134,1,8,true,20,8,-12,41.87764,-87.64954
13157,1,8,true,45,15,-30,41.87773,-87.6548
TA1305000025,1,8,true,61,244,183,41.87773,-87.63528
36,1,8,true,13,48,35,41.87776,-87.63525
TA1309000002,1,8,true,31,34,3,41.87784,-87.62408
13206,1,8,true,42,39,-3,41.87794,-87.66201
283,1,8,true,12,53,41,41.87809,-87.63183
TA1309000004,1,8,true,49,176,127,41.87811,-87.63184
107,1,8,true,14,23,9,41.87822,-87.644
638,1,8,true,119,135,16,41.87827,-87.64078
37,1,8,true,3,32,29,41.87921,-87.62975
TA1305000005,1,8,true,15,128,113,41.87924,-87.62975
286,1,8,true,3,12,9,41.8793,-87.6355
13011,1,8,true,156,136,-20,41.87931,-87.63993
TA1309000008,1,8,true,21,89,68,41.87933,-87.6355
192,1,8,true,23,30,7,41.87935,-87.63997
KA1503000034,1,8,true,11,106,95,41.87938,-87.63197
39,1,8,true,7,13,6,41.87948,-87.62571
KA1503000015,1,8,true,44,112,68,41.87948,-87.6257
287,1,8,true,5,56,51,41.88017,-87.63527
TA1309000007,1,8,true,46,292,246,41.88022,-87.63526
WL-011,1,8,true,47,26,-21,41.88034,-87.64273
73,1,8,true,10,5,-5,41.8804,-87.64273
80,1,8,true,14,24,10,41.88042,-87.65556
13156,1,8,true,68,63,-5,41.88042,-87.65554
13300,1,8,true,31,45,14,41.88097,-87.61675
13008,1,8,true,18,84,66,41.88105,-87.62408
90,1,8,true,4,14,10,41.88107,-87.62409
49,1,8,true,7,93,86,41.88116,-87.62963
TA1305000006,1,8,true,39,382,343,41.88122,-87.6296
13134,1,8,true,9,14,5,41.88138,-87.67493
13056,1,8,true,88,88,0,41.88168,-87.63951
191,1,8,true,15,14,-1,41.88169,-87.63951
198,1,8,true,16,12,-4,41.88187,-87.6488
TA1307000120,1,8,true,96,63,-33,41.88188,-87.64879
13341,1,8,true,87,121,34,41.88208,-87.63985
174,1,8,true,3,14,11,41.88208,-87.63984
197,1,8,true,16,15,-1,41.88208,-87.62513
13036,1,8,true,44,93,49,41.8821,-87.62513
77,1,8,true,51,33,-18,41.88214,-87.64108
TA1305000032,1,8,true,260,139,-121,41.88218,-87.64109
98,1,8,true,4,25,21,41.88266,-87.63251
13006,1,8,true,24,164,140,41.88268,-87.63252
13353,1,8,true,67,35,-32,41.88283,-87.6612
654,1,8,true,39,37,-2,41.88307,-87.65698
13409,1,8,true,46,20,-26,41.8831,-87.6511
18,1,8,true,8,34,26,41.88317,-87.63735
KA1503000072,1,8,true,52,125,73,41.88317,-87.63693
91,1,8,true,38,37,-1,41.88336,-87.64122
WL-012,1,8,true,242,186,-56,41.88337,-87.6412
112,1,8,true,4,27,23,41.88362,-87.6486
13053,1,8,true,42,41,-1,41.88365,-87.64863
43,1,8,true,9,22,13,41.88396,-87.62455
13001,1,8,true,86,156,70,41.88397,-87.62459
13155,1,8,true,8,26,18,41.88407,-87.65689
18062,1,8,true,44,56,12,41.88412,-87.65427
81,1,8,true,12,44,32,41.88417,-87.6296
TA1306000010,1,8,true,58,204,146,41.88419,-87.62961
TA1305000030,1,8,true,60,355,295,41.88459,-87.63178
15535,1,8,true,38,37,-1,41.8846,-87.64455
51,1,8,true,6,68,62,41.88462,-87.63176
TA1305000029,1,8,true,59,94,35,41.88466,-87.62787
195,1,8,true,67,7,-60,41.88466,-87.61952
13263,1,8,true,157,67,-90,41.88467,-87.61952
44,1,8,true,10,13,3,41.88468,-87.62782
TA1306000015,1,8,true,59,154,95,41.88549,-87.65232
71,1,8,true,11,20,9,41.8855,-87.65233
66,1,8,true,13,50,37,41.88557,-87.64186
13021,1,8,true,99,214,115,41.88559,-87.64184
TA1307000111,1,8,true,34,185,151,41.88582,-87.63548
164,1,8,true,2,30,28,41.88583,-87.63547
13073,1,8,true,10,16,6,41.88592,-87.66717
KA17018054,1,8,true,7,28,21,41.88595,-87.67701
38,1,8,true,13,47,34,41.88599,-87.63089
KA1503000012,1,8,true,94,141,47,41.88599,-87.63089
52,1,8,true,16,41,25,41.886,-87.62421
TA1305000011,1,8,true,84,211,127,41.886,-87.62418
7,1,8,true,14,10,-4,41.88627,-87.61751
15534,1,8,true,80,23,-57,41.88627,-87.61749
217,1,8,true,7,15,8,41.8866,-87.65821
13197,1,8,true,34,39,5,41.8866,-87.65816
264,1,8,true,11,19,8,41.8867,-87.62224
TA1308000029,1,8,true,66,72,6,41.88673,-87.62225
194,1,8,true,1,10,9,41.88688,-87.62606
TA1307000131,1,8,true,18,84,66,41.88688,-87.62606
KA1503000064,1,8,true,10,28,18,41.88697,-87.61281
100,1,8,true,17,13,-4,41.88814,-87.63657
TA1305000022,1,8,true,72,166,94,41.88817,-87.63656
56,1,8,true,34,26,-8,41.88866,-87.64442
TA1306000003,1,8,true,128,101,-27,41.88867,-87.64442
133,1,8,true,66,60,-6,41.88918,-87.63851
KA1503000043,1,8,true,210,229,19,41.88918,-87.63851
13050,1,8,true,67,208,141,41.88919,-87.62775
47,1,8,true,12,37,25,41.88921,-87.62775
13432,1,8,true,31,37,6,41.88989,-87.67149
TA1307000151,1,8,true,117,164,47,41.88993,-87.63427
212,1,8,true,21,43,22,41.88995,-87.63427
636,1,8,true,49,129,80,41.88997,-87.63662
125,1,8,true,9,24,15,41.89018,-87.62621
KA1503000044,1,8,true,41,92,51,41.89018,-87.6262
196,1,8,true,44,15,-29,41.89053,-87.62205
13427,1,8,true,66,72,6,41.89054,-87.62205
26,1,8,true,21,16,-5,41.89057,-87.61798
13430,1,8,true,41,79,38,41.89077,-87.63169
181,1,8,true,4,13,9,41.89077,-87.63168
TA1306000013,1,8,true,77,62,-15,41.89083,-87.61852
RN-,1,8,true,53,87,34,41.89102,-87.63546
672,1,8,true,13,17,4,41.89102,-87.63545
13434,1,8,true,27,15,-12,41.89108,-87.66663
TA1308000006,1,8,true,20,25,5,41.89128,-87.67686
199,1,8,true,18,24,6,41.89143,-87.62676
TA1307000117,1,8,true,91,90,-1,41.89144,-87.62675
13033,1,8,true,90,75,-15,41.8916,-87.64835
214,1,8,true,1,11,10,41.89161,-87.67688
84,1,8,true,10,2,-8,41.89161,-87.64833
186,1,8,true,8,15,7,41.8918,-87.65879
13194,1,8,true,37,35,-2,41.8918,-87.65878
TA1305000003,1,8,true,78,85,7,41.89187,-87.62061
24,1,8,true,21,17,-4,41.8919,-87.62063
643,1,8,true,14,11,-3,41.89203,-87.68939
35,1,8,true,17,1,-16,41.89227,-87.61206
13022,1,8,true,108,36,-72,41.89227,-87.61205
99,1,8,true,12,6,-6,41.89255,-87.61449
TA1306000029,1,8,true,67,63,-4,41.89256,-87.61449
13265,1,8,true,88,64,-24,41.89383,-87.64172
74,1,8,true,21,11,-10,41.89384,-87.64173
13045,1,8,true,142,137,-5,41.89403,-87.62931
110,1,8,true,34,30,-4,41.89406,-87.6293
13016,1,8,true,76,245,169,41.89431,-87.62277
211,1,8,true,13,108,95,41.89439,-87.62267
KA1503000041,1,8,true,109,163,54,41.89452,-87.61798
142,1,8,true,16,37,21,41.89453,-87.61806
92,1,8,true,11,18,7,41.89455,-87.65346
13196,1,8,true,62,29,-33,41.89455,-87.65345
TA1307000062,1,8,true,87,114,27,41.89466,-87.63839
111,1,8,true,11,28,17,41.89466,-87.63837
TA1306000012,1,8,true,160,146,-14,41.89475,-87.63438
53,1,8,true,33,45,12,41.89476,-87.63439
KP1705001026,1,8,true,51,44,-7,41.89483,-87.6323
18058,1,8,true,19,7,-12,41.8955,-87.68201
637,1,8,true,66,14,-52,41.89563,-87.67209
13132,1,8,true,51,17,-34,41.89573,-87.67718
161,1,8,true,13,15,2,41.89574,-87.62599
15530,1,8,true,107,154,47,41.89575,-87.62596
18003,1,8,true,30,59,29,41.89575,-87.62011
13247,1,8,true,54,15,-39,41.89597,-87.66775
TA1305000020,1,8,true,37,48,11,41.89636,-87.65406
54,1,8,true,10,5,-5,41.89637,-87.65407
13289,1,8,true,62,10,-52,41.89638,-87.661
13303,1,8,true,46,30,-16,41.89672,-87.63088
13017,1,8,true,96,103,7,41.89676,-87.6357
31,1,8,true,11,22,11,41.89677,-87.63572
13338,1,8,true,72,117,45,41.89697,-87.62173
173,1,8,true,12,26,14,41.89704,-87.62173
TA1307000061,1,8,true,54,39,-15,41.89745,-87.62873
106,1,8,true,7,12,5,41.89746,-87.62874
25,1,8,true,8,13,5,41.89751,-87.62354
13034,1,8,true,19,49,30,41.89754,-87.62352
48,1,8,true,26,23,-3,41.89772,-87.64302
TA1306000009,1,8,true,74,204,130,41.89772,-87.64299
620,1,8,true,49,24,-25,41.89817,-87.63754
KA1504000103,1,8,true,37,16,-21,41.89842,-87.68659
374,1,8,true,12,2,-10,41.89842,-87.68659
145,1,8,true,13,18,5,41.89856,-87.62211
15529,1,8,true,70,73,3,41.89858,-87.62206
140,1,8,true,18,10,-8,41.89895,-87.6299
TA1307000128,1,8,true,89,64,-25,41.89896,-87.6299
657,1,8,true,66,18,-48,41.89918,-87.6722
KA1504000117,1,8,true,11,23,12,41.89936,-87.64848
13248,1,8,true,57,23,-34,41.89964,-87.66788
46,1,8,true,23,9,-14,41.89994,-87.63444
TA1306000011,1,8,true,47,10,-37,41.89994,-87.63443
KA1504000116,1,8,true,62,32,-30,41.90023,-87.64299
364,1,8,true,14,7,-7,41.90023,-87.64299
17660,1,8,true,12,2,-10,41.90036,-87.69671
13290,1,8,true,57,21,-36,41.90069,-87.66259
29,1,8,true,15,10,-5,41.90069,-87.66259
13042,1,8,true,78,93,15,41.90097,-87.62377
85,1,8,true,7,12,5,41.90098,-87.62375
TA1307000070,1,8,true,53,4,-49,41.90133,-87.67742
KA1504000133,1,8,true,63,49,-14,41.90234,-87.62773
13241,1,8,true,25,20,-5,41.9029,-87.68731
176,1,8,true,49,15,-34,41.90291,-87.63141
TA1306000006,1,8,true,34,9,-25,41.90292,-87.63772
23,1,8,true,10,2,-8,41.90292,-87.63772
TA1307000039,1,8,true,157,92,-65,41.90294,-87.63137
658,1,8,true,26,82,56,41.903,-87.6838
216,1,8,true,13,6,-7,41.90302,-87.69749
13256,1,8,true,8,11,3,41.90302,-87.69749
TA1305000034,1,8,true,25,12,-13,41.90313,-87.67391
182,1,8,true,34,15,-19,41.90317,-87.63442
KA1504000135,1,8,true,96,54,-42,41.90319,-87.63439
13136,1,8,true,62,29,-33,41.90326,-87.67845
210,1,8,true,21,14,-7,41.90342,-87.66781
13061,1,8,true,102,63,-39,41.90342,-87.66779
KA1504000079,1,8,true,42,40,-2,41.9035,-87.64334
138,1,8,true,20,4,-16,41.9046,-87.64057
TA1307000115,1,8,true,52,15,-37,41.9046,-87.64056
291,1,8,true,17,18,1,41.90672,-87.63494
TA1308000049,1,8,true,43,47,4,41.90672,-87.6349
KA1504000134,1,8,true,32,17,-15,41.90687,-87.6262
180,1,8,true,13,7,-6,41.90687,-87.62618
13224,1,8,true,40,21,-19,41.90706,-87.66725
333,1,8,true,20,2,-18,41.90706,-87.66725
18069,1,8,true,7,21,14,41.90722,-87.65563
TA1307000143,1,8,true,38,10,-28,41.90762,-87.63854
13221,1,8,true,37,15,-22,41.90765,-87.67254
301,1,8,true,33,18,-15,41.90796,-87.63203
TA1309000024,1,8,true,117,60,-57,41.908,-87.63152
TA1305000041,1,8,true,59,50,-9,41.9094,-87.67769
331,1,8,true,81,66,-15,41.90965,-87.64812
15653,1,8,true,18,11,-7,41.90979,-87.7053
TA1305000037,1,8,true,71,28,-43,41.91018,-87.67003
TA1306000008,1,8,true,35,12,-23,41.9102,-87.6435
16,1,8,true,15,13,-2,41.91035,-87.67008
213,1,8,true,18,8,-10,41.91037,-87.68237
TA1308000005,1,8,true,37,22,-15,41.91042,-87.68238
13258,1,8,true,14,23,9,41.91043,-87.69718
13257,1,8,true,30,2,-28,41.91054,-87.68956
13154,1,8,true,75,57,-18,41.91054,-87.65312
20,1,8,true,14,18,4,41.91055,-87.65313
13058,1,8,true,53,17,-36,41.91059,-87.64942
TA1307000038,1,8,true,60,41,-19,41.91138,-87.63868
118,1,8,true,12,7,-5,41.91138,-87.63868
LF-005,1,8,true,56,23,-33,41.91172,-87.62681
268,1,8,true,22,3,-19,41.91172,-87.62681
126,1,8,true,15,8,-7,41.91196,-87.63197
13128,1,8,true,44,28,-16,41.91197,-87.63197
289,1,8,true,36,21,-15,41.91209,-87.63472
TA1308000050,1,8,true,111,109,-2,41.91211,-87.6347
13243,1,8,true,47,20,-27,41.91262,-87.6814
TA1309000032,1,8,true,4,18,14,41.91293,-87.66417
TA1306000032,1,8,true,49,33,-16,41.9137,-87.65285
93,1,8,true,6,14,8,41.91371,-87.65285
TA1307000166,1,8,true,41,17,-24,41.91386,-87.64877
224,1,8,true,8,12,4,41.91386,-87.64877
15655,1,8,true,23,8,-15,41.91401,-87.70514
18017,1,8,true,12,1,-11,41.91416,-87.71676
18067,1,8,true,15,5,-10,41.9146,-87.66796
TA1306000007,1,8,true,36,17,-19,41.91469,-87.64333
13068,1,8,true,17,16,-1,41.91554,-87.68703
13179,1,8,true,72,35,-37,41.9157,-87.63461
141,1,8,true,13,13,0,41.91571,-87.63461
13133,1,8,true,46,13,-33,41.91598,-87.67733
58,1,8,true,11,3,-8,41.91602,-87.66894
TA1305000039,1,8,true,45,73,28,41.9163,-87.66749
15650,1,8,true,12,3,-9,41.91711,-87.71023
15651,1,8,true,18,16,-2,41.91752,-87.70181
13266,1,8,true,12,10,-2,41.91774,-87.69142
TA1309000029,1,8,true,35,26,-9,41.9178,-87.68245
309,1,8,true,13,9,-4,41.91789,-87.6865
TA1309000006,1,8,true,51,25,-26,41.91809,-87.64375
288,1,8,true,10,10,0,41.91809,-87.64375
TA1307000163,1,8,true,39,91,52,41.91821,-87.65696
94,1,8,true,33,32,-1,41.91831,-87.6363
13146,1,8,true,111,68,-43,41.91831,-87.63629
13059,1,8,true,52,59,7,41.91845,-87.65222
113,1,8,true,12,23,11,41.91846,-87.65222
13259,1,8,true,18,7,-11,41.91852,-87.69744
13192,1,8,true,59,46,-13,41.91995,-87.64884
225,1,8,true,24,14,-10,41.91995,-87.64884
13288,1,8,true,26,7,-19,41.92008,-87.67788
TA1309000030,1,8,true,39,29,-10,41.92077,-87.66372
13292,1,8,true,26,2,-24,41.92152,-87.70733
TA1309000033,1,8,true,47,38,-9,41.92158,-87.65381
13193,1,8,true,84,92,8,41.92182,-87.64412
144,1,8,true,22,26,4,41.92182,-87.64411
13191,1,8,true,58,39,-19,41.92217,-87.63891
143,1,8,true,20,12,-8,41.92217,-87.63891
327,1,8,true,17,3,-14,41.92225,-87.65783
13084,1,8,true,29,30,1,41.92268,-87.69715
LP-,1,8,true,39,13,-26,41.92396,-87.63584
KA1504000140,1,8,true,8,11,3,41.92409,-87.67646
15648,1,8,true,19,4,-15,41.92464,-87.68931
KA1504000090,1,8,true,10,8,-2,41.92483,-87.7145
TA1307000001,1,8,true,24,24,0,41.92535,-87.66581
TA1306000026,1,8,true,57,48,-9,41.92558,-87.65842
TA1306000016,1,8,true,65,73,8,41.9256,-87.65371
313,1,8,true,20,20,0,41.9257,-87.64246
TA1309000019,1,8,true,90,33,-57,41.92586,-87.63897
TA1309000058,1,8,true,92,66,-26,41.92591,-87.64927
127,1,8,true,20,10,-10,41.92592,-87.64927
TA1308000001,1,8,true,54,38,-16,41.92627,-87.63086
15646,1,8,true,29,6,-23,41.92668,-87.6977
13124,1,8,true,9,12,3,41.92675,-87.63444
TA1309000023,1,8,true,30,26,-4,41.9287,-87.65383
TA1307000113,1,8,true,26,11,-15,41.92878,-87.66391
13296,1,8,true,32,14,-18,41.92883,-87.66852
TA1309000059,1,8,true,47,30,-17,41.92889,-87.65898
349,1,8,true,20,13,-7,41.92915,-87.6491
TA1309000061,1,8,true,44,52,8,41.92915,-87.64909
TA1305000014,1,8,true,91,65,-26,41.92956,-87.64313
340,1,8,true,21,13,-8,41.92956,-87.64313
13085,1,8,true,12,15,3,41.92958,-87.70789
15643,1,8,true,9,12,3,41.93057,-87.7238
TA1307000142,1,8,true,52,43,-9,41.93125,-87.64432
220,1,8,true,18,9,-9,41.93125,-87.64431
13276,1,8,true,71,37,-34,41.93132,-87.63874
324,1,8,true,33,11,-22,41.93173,-87.64179
13271,1,8,true,20,18,-2,41.93192,-87.67784
152,1,8,true,21,5,-16,41.93221,-87.65864
TA1307000064,1,8,true,78,42,-36,41.93222,-87.65864
13,1,8,true,14,11,-3,41.93242,-87.65271
TA1306000014,1,8,true,63,62,-1,41.93242,-87.65271
TA1309000039,1,8,true,78,30,-48,41.93258,-87.63642
329,1,8,true,10,5,-5,41.93258,-87.63642
13294,1,8,true,23,14,-9,41.9326,-87.66595
TA1309000036,1,8,true,50,22,-28,41.93313,-87.64776
TA1307000006,1,8,true,40,23,-17,41.93571,-87.6636
250,1,8,true,11,2,-9,41.93609,-87.66984
13269,1,8,true,26,20,-6,41.93609,-87.66983
115,1,8,true,19,16,-3,41.93628,-87.65266
TA1307000052,1,8,true,74,90,16,41.93628,-87.65266
156,1,8,true,16,10,-6,41.9365,-87.64756
TA1307000136,1,8,true,68,56,-12,41.9365,-87.64755
TA1307000041,1,8,true,70,43,-27,41.93669,-87.63683
157,1,8,true,29,7,-22,41.9367,-87.63683
13137,1,8,true,100,67,-33,41.9376,-87.6441
300,1,8,true,23,18,-5,41.93761,-87.6441
154,1,8,true,11,5,-6,41.93912,-87.66384
TA1309000042,1,8,true,39,24,-15,41.93937,-87.66836
131,1,8,true,18,2,-16,41.93937,-87.66835
13229,1,8,true,34,14,-20,41.93946,-87.66376
TA1308000019,1,8,true,45,26,-19,41.93973,-87.65886
13277,1,8,true,54,25,-29,41.9401,-87.64546
296,1,8,true,15,2,-13,41.9401,-87.64546
TA1307000134,1,8,true,57,66,9,41.94016,-87.65303
117,1,8,true,13,11,-2,41.94016,-87.65302
TA1309000049,1,8,true,75,53,-22,41.94077,-87.63919
15634,1,8,true,11,4,-7,41.94304,-87.68729
TA1307000138,1,8,true,39,34,-5,41.94334,-87.67094
230,1,8,true,13,7,-6,41.94335,-87.67093
13144,1,8,true,48,13,-35,41.9434,-87.67964
299,1,8,true,15,4,-11,41.94368,-87.64894
TA1309000025,1,8,true,34,27,-7,41.94368,-87.64894
229,1,8,true,10,11,1,41.94372,-87.66401
13071,1,8,true,51,39,-12,41.94373,-87.66401
632,1,8,true,52,34,-18,41.94453,-87.6547
13278,1,8,true,54,29,-25,41.94553,-87.64644
15632,1,8,true,4,23,19,41.94664,-87.69463
KA1504000143,1,8,true,12,4,-8,41.94664,-87.68337
227,1,8,true,15,16,1,41.94813,-87.66397
13235,1,8,true,55,68,13,41.94814,-87.66396
304,1,8,true,16,18,2,41.94878,-87.64922
13253,1,8,true,17,16,-1,41.9488,-87.67527
13325,1,8,true,64,62,-2,41.94907,-87.64863
TA1307000126,1,8,true,30,36,6,41.94936,-87.65451
232,1,8,true,14,11,-3,41.94943,-87.64645
TA1307000150,1,8,true,60,44,-16,41.94945,-87.64646
13319,1,8,true,21,14,-7,41.95069,-87.6687
TA1307000127,1,8,true,26,33,7,41.9508,-87.65918
318,1,8,true,11,4,-7,41.95254,-87.6735
256,1,8,true,10,9,-1,41.95282,-87.65
13323,1,8,true,37,37,0,41.95282,-87.65
TA1309000043,1,8,true,18,33,15,41.95417,-87.66434
13063,1,8,true,32,55,23,41.95424,-87.65441
486,1,8,true,10,3,-7,41.95431,-87.68607
KA1504000158,1,8,true,13,4,-9,41.95432,-87.68607
TA1308000022,1,8,true,40,27,-13,41.95438,-87.64805
244,1,8,true,5,10,5,41.95466,-87.67391
TA1307000149,1,8,true,19,48,29,41.95467,-87.67392
TA1309000026,1,8,true,16,17,1,41.95601,-87.6802
13379,1,8,true,80,25,-55,41.95786,-87.6495
TA1309000018,1,8,true,22,43,21,41.95791,-87.67357
TA1309000027,1,8,true,41,16,-25,41.9585,-87.65499
13389,1,8,true,51,35,-16,41.961,-87.64958
245,1,8,true,16,5,-11,41.96101,-87.64958
15622,1,8,true,12,8,-4,41.96108,-87.69544
TA1307000144,1,8,true,22,12,-10,41.96142,-87.6762
15623,1,8,true,24,7,-17,41.96154,-87.69117
482,1,8,true,10,1,-9,41.96154,-87.69117
KA1503000022,1,8,true,17,12,-5,41.96158,-87.66609
TA1307000107,1,8,true,37,35,-2,41.96164,-87.65464
TA1307000156,1,8,true,22,19,-3,41.96301,-87.68479
TA1309000012,1,8,true,8,12,4,41.96325,-87.67928
293,1,8,true,1,12,11,41.96521,-87.65822
13074,1,8,true,17,46,29,41.96521,-87.6582
639,1,8,true,18,19,1,41.96584,-87.64538
KA1504000127,1,8,true,20,6,-14,41.96587,-87.70083
KA1504000093,1,8,true,14,19,5,41.96587,-87.69365
TA1307000140,1,8,true,20,20,0,41.96643,-87.68865
TA1309000014,1,8,true,25,22,-3,41.96709,-87.66744
TA1307000158,1,8,true,24,22,-2,41.9671,-87.67904
TA1307000119,1,8,true,39,17,-22,41.96796,-87.65
TA1308000021,1,8,true,21,5,-16,41.96883,-87.65765
KA1504000080,1,8,true,15,8,-7,41.96887,-87.69609
TA1309000015,1,8,true,11,5,-6,41.96889,-87.68401
TA1309000066,1,8,true,52,41,-11,41.9691,-87.67423
344,1,8,true,8,17,9,41.9691,-87.67423
TA1309000041,1,8,true,12,18,6,41.96951,-87.65471
KA1504000171,1,8,true,27,23,-4,41.97161,-87.65016
TA1309000035,1,8,true,31,10,-21,41.97335,-87.66785
13108,1,8,true,25,18,-7,41.97379,-87.65971
KA1504000078,1,8,true,11,2,-9,41.97491,-87.69258
KA1504000149,1,8,true,12,14,2,41.97562,-87.67945
KA1504000146,1,8,true,18,25,7,41.978,-87.66805
13109,1,8,true,26,16,-10,41.97835,-87.65976
KA1504000147,1,8,true,13,2,-11,41.97976,-87.67754
655,1,8,true,6,19,13,41.97987,-87.68194
KA1504000151,1,8,true,9,40,31,41.98359,-87.66916
459,1,8,true,8,11,3,41.98403,-87.65231
KA1504000152,1,8,true,32,44,12,41.98403,-87.65231
15578,1,8,true,19,13,-6,41.98405,-87.66027
15575,1,8,true,53,17,-36,41.98975,-87.66014
KA1504000148,1,8,true,14,7,-7,41.99086,-87.66971
15571,1,8,true,53,18,-35,41.99478,-87.66028
KA1504000156,1,8,true,5,17,12,41.99925,-87.67137
RP-009,1,8,true,20,24,4,42.00107,-87.66122
RP-008,1,8,true,12,2,-10,42.00446,-87.6724
660,1,8,true,26,9,-17,42.00458,-87.66143
KA1504000175,1,8,true,13,11,-2,42.00797,-87.66549
KA1504000162,1,8,true,4,32,28,42.00907,-87.67422
KA1504000159,1,8,true,17,3,-14,42.01059,-87.66241
525,1,8,true,16,5,-11,42.01272,-87.66605
520,1,8,true,10,7,-3,42.01597,-87.66859
523,1,8,true,13,3,-10,42.02089,-87.66505
E002,1,8,true,42,10,-32,42.03256,-87.67912
596,1,8,true,26,18,-8,42.04822,-87.68348
E008,1,8,true,11,9,-2,42.05049,-87.67782
605,1,8,true,1,43,42,42.05294,-87.67342
604,1,8,true,2,32,30,42.05824,-87.67744
E007,1,8,true,3,21,18,42.06431,-87.68615
15491,1,12,false,15,12,-3,41.78096,-87.57624
KA1503000014,1,12,false,29,25,-4,41.7851,-87.60108
TA1309000011,1,12,false,9,25,16,41.78873,-87.60131
KA1503000071,1,12,false,29,27,-2,41.79148,-87.59988
KA1503000074,1,12,false,14,18,4,41.79174,-87.58395
TA1309000063,1,12,false,14,14,0,41.79325,-87.5878
KA1504000076,1,12,false,21,23,2,41.7943,-87.60145
TA1308000009,1,12,false,41,34,-7,41.79522,-87.58075
TA1307000164,1,12,false,10,11,1,41.79527,-87.59647
KA1503000052,1,12,false,8,11,3,41.79935,-87.60097
KA1503000059,1,12,false,38,17,-21,41.79952,-87.58643
TA1309000037,1,12,false,22,28,6,41.79957,-87.59474
KA1503000007,1,12,false,16,11,-5,41.80242,-87.58689
13398,1,12,false,15,3,-12,41.80256,-87.59035
TA1308000035,1,12,false,15,8,-7,41.80944,-87.59188
TA1308000002,1,12,false,15,10,-5,41.80983,-87.59937
KA1503000004,1,12,false,9,11,2,41.83127,-87.6088
13216,1,12,false,12,5,-7,41.83473,-87.62581
13215,1,12,false,19,11,-8,41.83634,-87.6135
TA1309000055,1,12,false,7,10,3,41.8382,-87.64514
TA1307000048,1,12,false,49,52,3,41.83855,-87.60821
TA1307000139,1,12,false,6,11,5,41.84205,-87.61698
TA1305000004,1,12,false,21,13,-8,41.8514,-87.61884
TA1305000001,1,12,false,20,14,-6,41.85262,-87.6265
13075,1,12,false,25,35,10,41.8531,-87.63192
13162,1,12,false,10,3,-7,41.85378,-87.64659
15546,1,12,false,10,8,-2,41.85416,-87.61916
13331,1,12,false,10,7,-3,41.85515,-87.65414
15545,1,12,false,35,50,15,41.85627,-87.61334
SL-013,1,12,false,13,8,-5,41.85659,-87.62755
SL-006,1,12,false,6,28,22,41.8568,-87.63387
13102,1,12,false,26,16,-10,41.85762,-87.61942
13150,1,12,false,18,36,18,41.85783,-87.62455
13099,1,12,false,10,6,-4,41.85784,-87.64627
TA1307000159,1,12,false,13,11,-2,41.8579,-87.6687
13163,1,12,false,11,6,-5,41.85808,-87.65108
13164,1,12,false,17,15,-2,41.85818,-87.65648
SL-012,1,12,false,25,17,-8,41.86038,-87.62581
TA1307000124,1,12,false,28,23,-5,41.86411,-87.62372
TA1309000001,1,12,false,21,9,-12,41.86488,-87.64708
97,1,12,false,3,10,7,41.86531,-87.6179
13029,1,12,false,50,61,11,41.86531,-87.6179
341,1,12,false,14,12,-2,41.86608,-87.60733
13431,1,12,false,70,60,-10,41.8661,-87.60728
WL-008,1,12,false,23,25,2,41.86712,-87.64108
TA1305000002,1,12,false,56,50,-6,41.86721,-87.62597
59,1,12,false,10,6,-4,41.86721,-87.62597
15544,1,12,false,359,333,-26,41.86723,-87.61536
3,1,12,false,20,15,-5,41.86723,-87.61536
TA1305000017,1,12,false,16,5,-11,41.86734,-87.64863
KA1706005007,1,12,false,25,12,-13,41.86749,-87.63219
SL-005,1,12,false,98,113,15,41.8679,-87.62304
255,1,12,false,17,6,-11,41.86791,-87.62304
13160,1,12,false,12,15,3,41.86947,-87.65548
15550,1,12,false,15,21,6,41.87024,-87.63947
TA1309000010,1,12,false,48,56,8,41.87074,-87.62574
SL-009,1,12,false,17,15,-2,41.87081,-87.63121
TA1309000064,1,12,false,11,9,-2,41.87127,-87.67369
TA1307000130,1,12,false,19,9,-10,41.87178,-87.65103
TA1307000121,1,12,false,12,17,5,41.87184,-87.64664
SL-008,1,12,false,36,33,-3,41.87209,-87.62956
13332,1,12,false,17,10,-7,41.87219,-87.6615
SL-011,1,12,false,32,15,-17,41.87256,-87.63356
623,1,12,false,77,72,-5,41.87272,-87.62399
KA1504000104,1,12,false,12,16,4,41.87296,-87.66912
SL-007,1,12,false,36,22,-14,41.87404,-87.6277
321,1,12,false,12,7,-5,41.87427,-87.63257
TA1306000025,1,12,false,12,17,5,41.87464,-87.65703
15668,1,12,false,11,7,-4,41.87471,-87.68642
13028,1,12,false,15,13,-2,41.87475,-87.64981
SL-010,1,12,false,12,4,-8,41.87501,-87.63309
15541,1,12,false,115,80,-35,41.8758,-87.62086
TA1305000009,1,12,false,7,12,5,41.87593,-87.63068
TA1305000010,1,12,false,52,37,-15,41.87623,-87.62444
624,1,12,false,22,21,-1,41.87626,-87.62923
TA1305000035,1,12,false,19,18,-1,41.87716,-87.62787
13138,1,12,false,15,6,-9,41.87723,-87.63941
15539,1,12,false,12,14,2,41.87763,-87.64405
13158,1,12,false,21,35,14,41.87764,-87.64957
13157,1,12,false,25,17,-8,41.87773,-87.6548
TA1305000025,1,12,false,76,63,-13,41.87773,-87.63528
TA1309000002,1,12,false,61,72,11,41.87784,-87.62408
13206,1,12,false,10,10,0,41.87794,-87.66201
TA1309000004,1,12,false,44,17,-27,41.87811,-87.63184
638,1,12,false,38,16,-22,41.87827,-87.64078
TA1305000005,1,12,false,42,26,-16,41.87924,-87.62975
13011,1,12,false,30,26,-4,41.87931,-87.63993
TA1309000008,1,12,false,56,41,-15,41.87933,-87.6355
KA1503000034,1,12,false,29,22,-7,41.87938,-87.63197
KA1503000015,1,12,false,38,35,-3,41.87948,-87.6257
TA1309000007,1,12,false,35,32,-3,41.88022,-87.63526
13156,1,12,false,14,37,23,41.88042,-87.65554
13300,1,12,false,349,296,-53,41.88097,-87.61675
76,1,12,false,17,23,6,41.88098,-87.61675
13008,1,12,false,261,278,17,41.88105,-87.62408
90,1,12,false,24,23,-1,41.88107,-87.62409
TA1305000006,1,12,false,81,56,-25,41.88122,-87.6296
13134,1,12,false,6,13,7,41.88138,-87.67493
13056,1,12,false,15,19,4,41.88168,-87.63951
TA1307000120,1,12,false,47,40,-7,41.88188,-87.64879
13341,1,12,false,24,20,-4,41.88208,-87.63985
13036,1,12,false,42,45,3,41.8821,-87.62513
77,1,12,false,3,15,12,41.88214,-87.64108
TA1305000032,1,12,false,45,19,-26,41.88218,-87.64109
13006,1,12,false,31,20,-11,41.88268,-87.63252
13353,1,12,false,14,10,-4,41.88283,-87.6612
654,1,12,false,10,9,-1,41.88307,-87.65698
13409,1,12,false,17,13,-4,41.8831,-87.6511
KA1503000072,1,12,false,35,8,-27,41.88317,-87.63693
WL-012,1,12,false,31,35,4,41.88337,-87.6412
13053,1,12,false,40,49,9,41.88365,-87.64863
13001,1,12,false,116,126,10,41.88397,-87.62459
13155,1,12,false,11,5,-6,41.88407,-87.65689
18062,1,12,false,29,16,-13,41.88412,-87.65427
TA1306000010,1,12,false,50,37,-13,41.88419,-87.62961
TA1305000030,1,12,false,54,33,-21,41.88459,-87.63178
15535,1,12,false,25,28,3,41.8846,-87.64455
TA1305000029,1,12,false,80,55,-25,41.88466,-87.62787
13263,1,12,false,87,49,-38,41.88467,-87.61952
TA1306000015,1,12,false,43,42,-1,41.88549,-87.65232
13021,1,12,false,25,16,-9,41.88559,-87.64184
TA1307000111,1,12,false,48,37,-11,41.88582,-87.63548
KA1503000012,1,12,false,33,29,-4,41.88599,-87.63089
52,1,12,false,10,6,-4,41.886,-87.62421
TA1305000011,1,12,false,101,91,-10,41.886,-87.62418
15534,1,12,false,28,27,-1,41.88627,-87.61749
TA1308000029,1,12,false,29,35,6,41.88673,-87.62225
TA1307000131,1,12,false,94,81,-13,41.88688,-87.62606
KA1503000064,1,12,false,118,124,6,41.88697,-87.61281
TA1305000022,1,12,false,29,21,-8,41.88817,-87.63656
TA1306000003,1,12,false,37,40,3,41.88867,-87.64442
KA1503000043,1,12,false,57,48,-9,41.88918,-87.63851
13050,1,12,false,56,54,-2,41.88919,-87.62775
13432,1,12,false,13,7,-6,41.88989,-87.67149
TA1307000151,1,12,false,50,34,-16,41.88993,-87.63427
212,1,12,false,13,3,-10,41.88995,-87.63427
636,1,12,false,14,14,0,41.88997,-87.63662
KA1503000044,1,12,false,32,33,1,41.89018,-87.6262
13427,1,12,false,27,35,8,41.89054,-87.62205
13430,1,12,false,81,58,-23,41.89077,-87.63169
TA1306000013,1,12,false,89,61,-28,41.89083,-87.61852
RN-,1,12,false,36,34,-2,41.89102,-87.63546
13434,1,12,false,9,10,1,41.89108,-87.66663
TA1308000006,1,12,false,14,11,-3,41.89128,-87.67686
199,1,12,false,10,8,-2,41.89143,-87.62676
TA1307000117,1,12,false,98,105,7,41.89144,-87.62675
13033,1,12,false,31,22,-9,41.8916,-87.64835
13194,1,12,false,15,14,-1,41.8918,-87.65878
TA1305000003,1,12,false,70,82,12,41.89187,-87.62061
35,1,12,false,12,16,4,41.89227,-87.61206
13022,1,12,false,557,632,75,41.89227,-87.61205
TA1306000029,1,12,false,85,81,-4,41.89256,-87.61449
13265,1,12,false,31,34,3,41.89383,-87.64172
13045,1,12,false,66,78,12,41.89403,-87.62931
110,1,12,false,11,7,-4,41.89406,-87.6293
13016,1,12,false,114,91,-23,41.89431,-87.62277
KA1503000041,1,12,false,49,31,-18,41.89452,-87.61798
13196,1,12,false,27,21,-6,41.89455,-87.65345
TA1307000062,1,12,false,16,12,-4,41.89466,-87.63839
TA1306000012,1,12,false,67,59,-8,41.89475,-87.63438
KP1705001026,1,12,false,30,37,7,41.89483,-87.6323
18058,1,12,false,8,10,2,41.8955,-87.68201
637,1,12,false,5,11,6,41.89563,-87.67209
13132,1,12,false,22,17,-5,41.89573,-87.67718
15530,1,12,false,83,60,-23,41.89575,-87.62596
18003,1,12,false,26,15,-11,41.89575,-87.62011
13247,1,12,false,20,14,-6,41.89597,-87.66775
TA1305000020,1,12,false,20,19,-1,41.89636,-87.65406
13289,1,12,false,14,11,-3,41.89638,-87.661
13303,1,12,false,23,25,2,41.89672,-87.63088
13017,1,12,false,19,19,0,41.89676,-87.6357
13338,1,12,false,61,34,-27,41.89697,-87.62173
TA1307000061,1,12,false,28,28,0,41.89745,-87.62873
25,1,12,false,11,6,-5,41.89751,-87.62354
13034,1,12,false,85,58,-27,41.89754,-87.62352
TA1306000009,1,12,false,36,23,-13,41.89772,-87.64299
620,1,12,false,18,14,-4,41.89817,-87.63754
KA1504000103,1,12,false,18,14,-4,41.89842,-87.68659
15529,1,12,false,58,49,-9,41.89858,-87.62206
TA1307000128,1,12,false,37,44,7,41.89896,-87.6299
657,1,12,false,16,8,-8,41.89918,-87.6722
TA1306000011,1,12,false,16,15,-1,41.89994,-87.63443
17660,1,12,false,15,2,-13,41.90036,-87.69671
13290,1,12,false,14,8,-6,41.90069,-87.66259
13042,1,12,false,246,232,-14,41.90097,-87.62377
85,1,12,false,16,12,-4,41.90098,-87.62375
TA1307000070,1,12,false,15,12,-3,41.90133,-87.67742
KA1504000133,1,12,false,56,60,4,41.90234,-87.62773
13241,1,12,false,18,10,-8,41.9029,-87.68731
TA1307000039,1,12,false,75,54,-21,41.90294,-87.63137
13256,1,12,false,7,17,10,41.90302,-87.69749
TA1305000034,1,12,false,36,22,-14,41.90313,-87.67391
KA1504000135,1,12,false,50,59,9,41.90319,-87.63439
13136,1,12,false,27,28,1,41.90326,-87.67845
13061,1,12,false,38,28,-10,41.90342,-87.66779
KA1504000079,1,12,false,26,24,-2,41.9035,-87.64334
TA1307000115,1,12,false,8,12,4,41.9046,-87.64056
TA1308000049,1,12,false,48,41,-7,41.90672,-87.6349
KA1504000134,1,12,false,17,19,2,41.90687,-87.6262
13224,1,12,false,19,16,-3,41.90706,-87.66725
13221,1,12,false,28,40,12,41.90765,-87.67254
TA1309000024,1,12,false,27,27,0,41.908,-87.63152
TA1305000041,1,12,false,45,45,0,41.9094,-87.67769
331,1,12,false,35,30,-5,41.90965,-87.64812
15653,1,12,false,20,7,-13,41.90979,-87.7053
TA1305000037,1,12,false,20,15,-5,41.91018,-87.67003
TA1308000005,1,12,false,12,15,3,41.91042,-87.68238
13258,1,12,false,12,7,-5,41.91043,-87.69718
13257,1,12,false,10,8,-2,41.91054,-87.68956
13154,1,12,false,25,31,6,41.91054,-87.65312
13058,1,12,false,22,26,4,41.91059,-87.64942
TA1307000038,1,12,false,34,42,8,41.91138,-87.63868
268,1,12,false,19,7,-12,41.91172,-87.62681
LF-005,1,12,false,189,229,40,41.91172,-87.62681
126,1,12,false,6,14,8,41.91196,-87.63197
13128,1,12,false,47,53,6,41.91197,-87.63197
TA1308000050,1,12,false,74,72,-2,41.91211,-87.6347
13243,1,12,false,18,24,6,41.91262,-87.6814
TA1306000032,1,12,false,17,25,8,41.9137,-87.65285
TA1307000166,1,12,false,15,18,3,41.91386,-87.64877
15655,1,12,false,22,5,-17,41.91401,-87.70514
18017,1,12,false,18,14,-4,41.91416,-87.71676
18067,1,12,false,21,36,15,41.9146,-87.66796
13068,1,12,false,14,16,2,41.91554,-87.68703
13179,1,12,false,67,75,8,41.9157,-87.63461
13133,1,12,false,27,24,-3,41.91598,-87.67733
TA1305000039,1,12,false,10,8,-2,41.9163,-87.66749
15651,1,12,false,7,18,11,41.91752,-87.70181
TA1309000029,1,12,false,13,4,-9,41.9178,-87.68245
TA1309000006,1,12,false,14,15,1,41.91809,-87.64375
TA1307000163,1,12,false,18,13,-5,41.91821,-87.65696
13146,1,12,false,79,70,-9,41.91831,-87.63629
13059,1,12,false,31,43,12,41.91845,-87.65222
13259,1,12,false,13,6,-7,41.91852,-87.69744
13192,1,12,false,31,33,2,41.91995,-87.64884
13288,1,12,false,14,10,-4,41.92008,-87.67788
TA1309000030,1,12,false,30,32,2,41.92077,-87.66372
TA1309000033,1,12,false,32,25,-7,41.92158,-87.65381
13193,1,12,false,46,34,-12,41.92182,-87.64412
13191,1,12,false,35,17,-18,41.92217,-87.63891
13084,1,12,false,15,14,-1,41.92268,-87.69715
LP-,1,12,false,91,114,23,41.92396,-87.63584
673,1,12,false,12,5,-7,41.92398,-87.63585
KA1504000090,1,12,false,11,2,-9,41.92483,-87.7145
TA1307000001,1,12,false,25,20,-5,41.92535,-87.66581
TA1306000026,1,12,false,18,28,10,41.92558,-87.65842
TA1306000016,1,12,false,35,23,-12,41.9256,-87.65371
TA1309000019,1,12,false,57,48,-9,41.92586,-87.63897
TA1309000058,1,12,false,38,33,-5,41.92591,-87.64927
177,1,12,false,7,10,3,41.92627,-87.63086
TA1308000001,1,12,false,109,170,61,41.92627,-87.63086
15646,1,12,false,8,11,3,41.92668,-87.6977
13124,1,12,false,50,35,-15,41.92675,-87.63444
TA1309000023,1,12,false,25,28,3,41.9287,-87.65383
TA1307000113,1,12,false,15,19,4,41.92878,-87.66391
13296,1,12,false,23,8,-15,41.92883,-87.66852
TA1309000059,1,12,false,13,9,-4,41.92889,-87.65898
TA1309000061,1,12,false,32,15,-17,41.92915,-87.64909
TA1308000031,1,12,false,16,15,-1,41.92946,-87.68417
TA1305000014,1,12,false,67,55,-12,41.92956,-87.64313
13085,1,12,false,31,24,-7,41.92958,-87.70789
TA1307000142,1,12,false,50,32,-18,41.93125,-87.64432
13276,1,12,false,42,33,-9,41.93132,-87.63874
13271,1,12,false,17,6,-11,41.93192,-87.67784
TA1307000064,1,12,false,26,29,3,41.93222,-87.65864
TA1306000014,1,12,false,38,26,-12,41.93242,-87.65271
TA1309000039,1,12,false,111,78,-33,41.93258,-87.63642
13294,1,12,false,21,11,-10,41.9326,-87.66595
TA1309000036,1,12,false,36,22,-14,41.93313,-87.64776
TA1307000006,1,12,false,14,24,10,41.93571,-87.6636
13268,1,12,false,11,7,-4,41.93588,-87.67843
13269,1,12,false,12,9,-3,41.93609,-87.66983
TA1307000052,1,12,false,38,24,-14,41.93628,-87.65266
TA1307000136,1,12,false,30,34,4,41.9365,-87.64755
TA1307000041,1,12,false,69,67,-2,41.93669,-87.63683
13137,1,12,false,62,49,-13,41.9376,-87.6441
300,1,12,false,10,4,-6,41.93761,-87.6441
KA17018068,1,12,false,11,7,-4,41.93935,-87.68327
TA1309000042,1,12,false,20,16,-4,41.93937,-87.66836
13229,1,12,false,30,20,-10,41.93946,-87.66376
TA1308000019,1,12,false,21,29,8,41.93973,-87.65886
13277,1,12,false,40,37,-3,41.9401,-87.64546
TA1307000134,1,12,false,57,59,2,41.94016,-87.65303
117,1,12,false,7,10,3,41.94016,-87.65302
TA1309000049,1,12,false,71,64,-7,41.94077,-87.63919
TA1307000138,1,12,false,16,15,-1,41.94334,-87.67094
13144,1,12,false,8,15,7,41.9434,-87.67964
TA1309000025,1,12,false,33,45,12,41.94368,-87.64894
13071,1,12,false,42,32,-10,41.94373,-87.66401
632,1,12,false,52,46,-6,41.94453,-87.6547
13278,1,12,false,37,32,-5,41.94553,-87.64644
KA1504000143,1,12,false,12,2,-10,41.94664,-87.68337
13235,1,12,false,32,47,15,41.94814,-87.66396
13325,1,12,false,43,42,-1,41.94907,-87.64863
TA1307000126,1,12,false,50,97,47,41.94936,-87.65451
TA1307000150,1,12,false,49,37,-12,41.94945,-87.64646
18016,1,12,false,11,8,-3,41.94993,-87.71395
13319,1,12,false,14,16,2,41.95069,-87.6687
TA1307000127,1,12,false,44,67,23,41.9508,-87.65918
13323,1,12,false,37,33,-4,41.95282,-87.65
TA1309000043,1,12,false,18,14,-4,41.95417,-87.66434
13063,1,12,false,42,34,-8,41.95424,-87.65441
TA1308000022,1,12,false,17,37,20,41.95438,-87.64805
13379,1,12,false,31,27,-4,41.95786,-87.6495
TA1309000027,1,12,false,32,15,-17,41.9585,-87.65499
13389,1,12,false,22,18,-4,41.961,-87.64958
KA1503000022,1,12,false,16,3,-13,41.96158,-87.66609
TA1307000107,1,12,false,38,27,-11,41.96164,-87.65464
TA1307000156,1,12,false,6,13,7,41.96301,-87.68479
TA1308000012,1,12,false,74,110,36,41.96398,-87.63818
13074,1,12,false,19,19,0,41.96521,-87.6582
639,1,12,false,53,37,-16,41.96584,-87.64538
TA1307000140,1,12,false,10,18,8,41.96643,-87.68865
TA1309000014,1,12,false,18,13,-5,41.96709,-87.66744
TA1307000158,1,12,false,15,7,-8,41.9671,-87.67904
TA1307000119,1,12,false,10,13,3,41.96796,-87.65
TA1308000021,1,12,false,15,8,-7,41.96883,-87.65765
TA1309000066,1,12,false,33,16,-17,41.9691,-87.67423
TA1309000041,1,12,false,20,12,-8,41.96951,-87.65471
KA1504000171,1,12,false,32,19,-13,41.97161,-87.65016
TA1309000035,1,12,false,35,29,-6,41.97335,-87.66785
13108,1,12,false,15,22,7,41.97379,-87.65971
KA1504000078,1,12,false,15,8,-7,41.97491,-87.69258
KA1504000160,1,12,false,11,9,-2,41.97564,-87.70143
KA1504000146,1,12,false,18,22,4,41.978,-87.66805
13109,1,12,false,20,16,-4,41.97835,-87.65976
KA1504000151,1,12,false,15,20,5,41.98359,-87.66916
KA1504000152,1,12,false,49,58,9,41.98403,-87.65231
15578,1,12,false,35,9,-26,41.98405,-87.66027
15575,1,12,false,13,14,1,41.98975,-87.66014
15571,1,12,false,24,12,-12,41.99478,-87.66028
RP-009,1,12,false,22,10,-12,42.00107,-87.66122
660,1,12,false,13,4,-9,42.00458,-87.66143
KA1504000159,1,12,false,8,10,2,42.01059,-87.66241
E002,1,12,false,10,8,-2,42.03256,-87.67912
596,1,12,false,30,17,-13,42.04822,-87.68348
E008,1,12,false,31,24,-7,42.05049,-87.67782
605,1,12,false,13,20,7,42.05294,-87.67342
604,1,12,false,24,26,2,42.05824,-87.67744
KA1503000002,1,12,true,10,9,-1,41.76641,-87.5657
KA1503000029,1,12,true,11,7,-4,41.77364,-87.56747
15491,1,12,true,11,8,-3,41.78096,-87.57624
KA1503000014,1,12,true,87,59,-28,41.7851,-87.60108
426,1,12,true,12,13,1,41.7851,-87.60108
KA1503000070,1,12,true,10,12,2,41.78794,-87.58831
328,1,12,true,10,4,-6,41.78872,-87.6013
TA1309000011,1,12,true,38,58,20,41.78873,-87.60131
423,1,12,true,8,17,9,41.79148,-87.59988
KA1503000071,1,12,true,56,67,11,41.79148,-87.59988
KA1503000074,1,12,true,16,19,3,41.79174,-87.58395
TA1309000063,1,12,true,11,17,6,41.79325,-87.5878
420,1,12,true,5,13,8,41.79429,-87.60145
KA1504000076,1,12,true,43,62,19,41.7943,-87.60145
TA1308000009,1,12,true,33,27,-6,41.79522,-87.58075
TA1307000164,1,12,true,27,24,-3,41.79527,-87.59647
248,1,12,true,4,13,9,41.79528,-87.59647
KA1503000052,1,12,true,26,23,-3,41.79935,-87.60097
418,1,12,true,13,10,-3,41.79936,-87.60097
KA1503000059,1,12,true,23,19,-4,41.79952,-87.58643
TA1309000037,1,12,true,39,49,10,41.79957,-87.59474
KA1503000007,1,12,true,15,13,-2,41.80242,-87.58689
13398,1,12,true,18,5,-13,41.80256,-87.59035
322,1,12,true,12,6,-6,41.80321,-87.59849
TA1308000035,1,12,true,11,15,4,41.80944,-87.59188
TA1308000002,1,12,true,10,4,-6,41.80983,-87.59937
KA1503000065,1,12,true,13,3,-10,41.81409,-87.59701
TA1308000045,1,12,true,15,14,-1,41.83062,-87.64129
TA1308000043,1,12,true,12,3,-9,41.83066,-87.64715
TA1307000129,1,12,true,24,22,-2,41.83104,-87.62683
13345,1,12,true,6,14,8,41.83138,-87.61803
15445,1,12,true,11,8,-3,41.83453,-87.63183
13216,1,12,true,73,75,2,41.83473,-87.62581
148,1,12,true,12,13,1,41.83474,-87.62581
149,1,12,true,2,10,8,41.83486,-87.61791
13217,1,12,true,34,38,4,41.83488,-87.61792
13215,1,12,true,24,13,-11,41.83634,-87.6135
TA1309000055,1,12,true,33,40,7,41.8382,-87.64514
KA1503000038,1,12,true,23,13,-10,41.83845,-87.6354
TA1307000048,1,12,true,15,14,-1,41.83855,-87.60821
TA1308000036,1,12,true,35,16,-19,41.83883,-87.62186
TA1307000139,1,12,true,39,27,-12,41.84205,-87.61698
15443,1,12,true,11,6,-5,41.84275,-87.63549
TA1307000005,1,12,true,10,15,5,41.84569,-87.6225
TA1308000026,1,12,true,19,7,-12,41.85008,-87.63214
TA1305000001,1,12,true,9,13,4,41.85262,-87.6265
13075,1,12,true,12,24,12,41.8531,-87.63192
15546,1,12,true,12,9,-3,41.85416,-87.61916
13089,1,12,true,6,13,7,41.85497,-87.67567
13331,1,12,true,6,11,5,41.85515,-87.65414
15545,1,12,true,51,57,6,41.85627,-87.61334
SL-006,1,12,true,2,14,12,41.8568,-87.63387
13135,1,12,true,17,19,2,41.85753,-87.66157
13102,1,12,true,41,44,3,41.85762,-87.61942
13150,1,12,true,32,25,-7,41.85783,-87.62455
273,1,12,true,10,6,-4,41.85783,-87.62455
13099,1,12,true,7,10,3,41.85784,-87.64627
TA1307000159,1,12,true,13,24,11,41.8579,-87.6687
TA1307000044,1,12,true,15,18,3,41.85794,-87.64083
13163,1,12,true,13,15,2,41.85808,-87.65108
13164,1,12,true,16,19,3,41.85818,-87.65648
SL-012,1,12,true,30,33,3,41.86038,-87.62581
72,1,12,true,10,7,-3,41.86039,-87.62581
TA1306000002,1,12,true,28,30,2,41.86238,-87.65108
TA1307000124,1,12,true,69,46,-23,41.86411,-87.62372
168,1,12,true,16,14,-2,41.86415,-87.62372
TA1309000001,1,12,true,35,40,5,41.86488,-87.64708
13354,1,12,true,14,14,0,41.86524,-87.66651
13029,1,12,true,10,13,3,41.86531,-87.6179
13431,1,12,true,16,18,2,41.8661,-87.60728
WL-008,1,12,true,31,37,6,41.86712,-87.64108
TA1305000002,1,12,true,70,66,-4,41.86721,-87.62597
59,1,12,true,20,18,-2,41.86721,-87.62597
15544,1,12,true,42,36,-6,41.86723,-87.61536
TA1305000017,1,12,true,26,26,0,41.86734,-87.64863
55,1,12,true,3,11,8,41.86735,-87.64863
KA1706005007,1,12,true,18,25,7,41.86749,-87.63219
SL-005,1,12,true,54,59,5,41.8679,-87.62304
255,1,12,true,9,12,3,41.86791,-87.62304
644,1,12,true,39,18,-21,41.86859,-87.68625
19,1,12,true,12,8,-4,41.86892,-87.65913
13139,1,12,true,43,43,0,41.86893,-87.65913
13285,1,12,true,33,30,-3,41.86928,-87.67372
13160,1,12,true,43,44,1,41.86947,-87.65548
15550,1,12,true,31,30,-1,41.87024,-87.63947
TA1309000010,1,12,true,54,55,1,41.87074,-87.62574
SL-009,1,12,true,22,20,-2,41.87081,-87.63121
342,1,12,true,11,19,8,41.87127,-87.6737
TA1309000064,1,12,true,72,50,-22,41.87127,-87.67369
15542,1,12,true,3,10,7,41.87146,-87.64095
TA1307000130,1,12,true,75,70,-5,41.87178,-87.65103
241,1,12,true,17,10,-7,41.8718,-87.65102
108,1,12,true,12,12,0,41.87183,-87.64664
TA1307000121,1,12,true,55,60,5,41.87184,-87.64664
41,1,12,true,11,19,8,41.87209,-87.62957
SL-008,1,12,true,61,80,19,41.87209,-87.62956
13332,1,12,true,88,79,-9,41.87219,-87.6615
SL-011,1,12,true,38,29,-9,41.87256,-87.63356
623,1,12,true,40,19,-21,41.87272,-87.62399
KA1504000104,1,12,true,44,54,10,41.87296,-87.66912
383,1,12,true,6,10,4,41.87297,-87.66912
320,1,12,true,19,16,-3,41.87327,-87.66402
SL-007,1,12,true,20,24,4,41.87404,-87.6277
13326,1,12,true,28,20,-8,41.87425,-87.63958
321,1,12,true,11,11,0,41.87427,-87.63257
TA1306000025,1,12,true,25,29,4,41.87464,-87.65703
13028,1,12,true,29,34,5,41.87475,-87.64981
13081,1,12,true,6,10,4,41.87501,-87.67326
SL-010,1,12,true,19,18,-1,41.87501,-87.63309
15541,1,12,true,15,16,1,41.8758,-87.62086
13037,1,12,true,13,6,-7,41.87588,-87.64078
TA1305000009,1,12,true,13,17,4,41.87593,-87.63068
TA1305000010,1,12,true,18,32,14,41.87623,-87.62444
624,1,12,true,31,21,-10,41.87626,-87.62923
TA1305000035,1,12,true,36,49,13,41.87716,-87.62787
13138,1,12,true,41,28,-13,41.87723,-87.63941
15539,1,12,true,43,44,1,41.87763,-87.64405
13158,1,12,true,69,85,16,41.87764,-87.64957
134,1,12,true,9,15,6,41.87764,-87.64954
21,1,12,true,16,12,-4,41.87773,-87.6548
13157,1,12,true,54,67,13,41.87773,-87.6548
TA1305000025,1,12,true,63,43,-20,41.87773,-87.63528
TA1309000002,1,12,true,8,25,17,41.87784,-87.62408
13206,1,12,true,33,29,-4,41.87794,-87.66201
TA1309000004,1,12,true,58,36,-22,41.87811,-87.63184
107,1,12,true,10,9,-1,41.87822,-87.644
638,1,12,true,40,37,-3,41.87827,-87.64078
TA1305000005,1,12,true,35,54,19,41.87924,-87.62975
13011,1,12,true,59,68,9,41.87931,-87.63993
TA1309000008,1,12,true,45,40,-5,41.87933,-87.6355
192,1,12,true,14,9,-5,41.87935,-87.63997
KA1503000034,1,12,true,37,18,-19,41.87938,-87.63197
39,1,12,true,6,10,4,41.87948,-87.62571
KA1503000015,1,12,true,27,29,2,41.87948,-87.6257
287,1,12,true,13,8,-5,41.88017,-87.63527
TA1309000007,1,12,true,64,51,-13,41.88022,-87.63526
WL-011,1,12,true,37,30,-7,41.88034,-87.64273
73,1,12,true,6,10,4,41.8804,-87.64273
13156,1,12,true,33,26,-7,41.88042,-87.65554
13300,1,12,true,65,63,-2,41.88097,-87.61675
76,1,12,true,15,7,-8,41.88098,-87.61675
13008,1,12,true,36,46,10,41.88105,-87.62408
90,1,12,true,8,10,2,41.88107,-87.62409
49,1,12,true,15,13,-2,41.88116,-87.62963
TA1305000006,1,12,true,68,58,-10,41.88122,-87.6296
13134,1,12,true,13,8,-5,41.88138,-87.67493
13056,1,12,true,34,15,-19,41.88168,-87.63951
198,1,12,true,15,9,-6,41.88187,-87.6488
TA1307000120,1,12,true,101,90,-11,41.88188,-87.64879
13341,1,12,true,26,31,5,41.88208,-87.63985
197,1,12,true,9,16,7,41.88208,-87.62513
13036,1,12,true,46,61,15,41.8821,-87.62513
77,1,12,true,15,18,3,41.88214,-87.64108
TA1305000032,1,12,true,82,74,-8,41.88218,-87.64109
98,1,12,true,23,14,-9,41.88266,-87.63251
13006,1,12,true,82,60,-22,41.88268,-87.63252
13353,1,12,true,29,30,1,41.88283,-87.6612
654,1,12,true,14,36,22,41.88307,-87.65698
13409,1,12,true,36,52,16,41.8831,-87.6511
KA1503000072,1,12,true,29,28,-1,41.88317,-87.63693
91,1,12,true,7,15,8,41.88336,-87.64122
WL-012,1,12,true,49,90,41,41.88337,-87.6412
112,1,12,true,11,10,-1,41.88362,-87.6486
13053,1,12,true,56,43,-13,41.88365,-87.64863
43,1,12,true,15,14,-1,41.88396,-87.62455
13001,1,12,true,66,72,6,41.88397,-87.62459
13155,1,12,true,10,16,6,41.88407,-87.65689
18062,1,12,true,26,34,8,41.88412,-87.65427
81,1,12,true,6,10,4,41.88417,-87.6296
TA1306000010,1,12,true,63,72,9,41.88419,-87.62961
TA1305000030,1,12,true,83,78,-5,41.88459,-87.63178
15535,1,12,true,30,31,1,41.8846,-87.64455
96,1,12,true,6,10,4,41.8846,-87.64455
51,1,12,true,10,14,4,41.88462,-87.63176
TA1305000029,1,12,true,52,49,-3,41.88466,-87.62787
195,1,12,true,19,19,0,41.88466,-87.61952
13263,1,12,true,59,63,4,41.88467,-87.61952
44,1,12,true,8,10,2,41.88468,-87.62782
TA1306000015,1,12,true,56,69,13,41.88549,-87.65232
71,1,12,true,11,7,-4,41.8855,-87.65233
13021,1,12,true,84,64,-20,41.88559,-87.64184
TA1307000111,1,12,true,41,52,11,41.88582,-87.63548
KA17018054,1,12,true,19,18,-1,41.88595,-87.67701
KA1503000012,1,12,true,54,40,-14,41.88599,-87.63089
38,1,12,true,17,9,-8,41.88599,-87.63089
52,1,12,true,24,13,-11,41.886,-87.62421
TA1305000011,1,12,true,59,42,-17,41.886,-87.62418
15534,1,12,true,42,37,-5,41.88627,-87.61749
13197,1,12,true,15,20,5,41.8866,-87.65816
TA1308000029,1,12,true,37,53,16,41.88673,-87.62225
TA1307000131,1,12,true,26,25,-1,41.88688,-87.62606
KA1503000064,1,12,true,41,37,-4,41.88697,-87.61281
16905,1,12,true,1,10,9,41.88767,-87.76547
100,1,12,true,6,16,10,41.88814,-87.63657
TA1305000022,1,12,true,62,83,21,41.88817,-87.63656
56,1,12,true,29,26,-3,41.88866,-87.64442
TA1306000003,1,12,true,81,78,-3,41.88867,-87.64442
133,1,12,true,16,40,24,41.88918,-87.63851
KA1503000043,1,12,true,120,167,47,41.88918,-87.63851
13050,1,12,true,40,39,-1,41.88919,-87.62775
47,1,12,true,9,14,5,41.88921,-87.62775
TA1307000151,1,12,true,71,52,-19,41.88993,-87.63427
212,1,12,true,14,11,-3,41.88995,-87.63427
636,1,12,true,49,30,-19,41.88997,-87.63662
KA1503000044,1,12,true,26,31,5,41.89018,-87.6262
13427,1,12,true,31,20,-11,41.89054,-87.62205
26,1,12,true,14,8,-6,41.89057,-87.61798
13430,1,12,true,61,60,-1,41.89077,-87.63169
181,1,12,true,11,13,2,41.89077,-87.63168
TA1306000013,1,12,true,38,48,10,41.89083,-87.61852
RN-,1,12,true,42,62,20,41.89102,-87.63546
672,1,12,true,11,12,1,41.89102,-87.63545
13434,1,12,true,12,17,5,41.89108,-87.66663
TA1308000006,1,12,true,17,9,-8,41.89128,-87.67686
199,1,12,true,15,22,7,41.89143,-87.62676
TA1307000117,1,12,true,60,88,28,41.89144,-87.62675
13033,1,12,true,44,56,12,41.8916,-87.64835
84,1,12,true,9,11,2,41.89161,-87.64833
13194,1,12,true,45,65,20,41.8918,-87.65878
TA1305000003,1,12,true,62,61,-1,41.89187,-87.62061
24,1,12,true,15,15,0,41.8919,-87.62063
35,1,12,true,14,10,-4,41.89227,-87.61206
13022,1,12,true,97,83,-14,41.89227,-87.61205
99,1,12,true,12,12,0,41.89255,-87.61449
TA1306000029,1,12,true,46,46,0,41.89256,-87.61449
13265,1,12,true,70,76,6,41.89383,-87.64172
74,1,12,true,31,22,-9,41.89384,-87.64173
13045,1,12,true,101,119,18,41.89403,-87.62931
110,1,12,true,27,26,-1,41.89406,-87.6293
13016,1,12,true,100,87,-13,41.89431,-87.62277
211,1,12,true,22,24,2,41.89439,-87.62267
KA1503000041,1,12,true,82,60,-22,41.89452,-87.61798
142,1,12,true,12,22,10,41.89453,-87.61806
13196,1,12,true,30,26,-4,41.89455,-87.65345
TA1307000062,1,12,true,60,43,-17,41.89466,-87.63839
111,1,12,true,14,11,-3,41.89466,-87.63837
TA1306000012,1,12,true,99,89,-10,41.89475,-87.63438
53,1,12,true,22,8,-14,41.89476,-87.63439
627,1,12,true,8,11,3,41.8948,-87.63231
KP1705001026,1,12,true,41,37,-4,41.89483,-87.6323
16920,1,12,true,23,19,-4,41.89495,-87.76491
18058,1,12,true,16,17,1,41.8955,-87.68201
637,1,12,true,21,16,-5,41.89563,-87.67209
128,1,12,true,9,19,10,41.89571,-87.67716
13132,1,12,true,61,60,-1,41.89573,-87.67718
15530,1,12,true,41,43,2,41.89575,-87.62596
18003,1,12,true,55,34,-21,41.89575,-87.62011
13247,1,12,true,35,35,0,41.89597,-87.66775
350,1,12,true,11,12,1,41.89597,-87.66774
TA1305000020,1,12,true,47,39,-8,41.89636,-87.65406
13289,1,12,true,31,34,3,41.89638,-87.661
337,1,12,true,11,8,-3,41.89659,-87.63096
13303,1,12,true,41,30,-11,41.89672,-87.63088
13017,1,12,true,44,40,-4,41.89676,-87.6357
31,1,12,true,11,9,-2,41.89677,-87.63572
13338,1,12,true,63,45,-18,41.89697,-87.62173
TA1307000061,1,12,true,26,35,9,41.89745,-87.62873
106,1,12,true,10,10,0,41.89746,-87.62874
13034,1,12,true,30,31,1,41.89754,-87.62352
TA1306000009,1,12,true,59,52,-7,41.89772,-87.64299
620,1,12,true,31,28,-3,41.89817,-87.63754
KA1504000103,1,12,true,28,24,-4,41.89842,-87.68659
145,1,12,true,24,16,-8,41.89856,-87.62211
15529,1,12,true,78,39,-39,41.89858,-87.62206
140,1,12,true,13,14,1,41.89895,-87.6299
TA1307000128,1,12,true,62,60,-2,41.89896,-87.6299
657,1,12,true,18,19,1,41.89918,-87.6722
13248,1,12,true,34,20,-14,41.89964,-87.66788
TA1306000011,1,12,true,13,17,4,41.89994,-87.63443
KA1504000116,1,12,true,32,25,-7,41.90023,-87.64299
17660,1,12,true,22,18,-4,41.90036,-87.69671
13290,1,12,true,22,16,-6,41.90069,-87.66259
13042,1,12,true,71,85,14,41.90097,-87.62377
85,1,12,true,13,15,2,41.90098,-87.62375
TA1307000070,1,12,true,18,15,-3,41.90133,-87.67742
KA1504000133,1,12,true,51,54,3,41.90234,-87.62773
172,1,12,true,9,14,5,41.90236,-87.62774
13241,1,12,true,15,13,-2,41.9029,-87.68731
176,1,12,true,19,32,13,41.90291,-87.63141
TA1306000006,1,12,true,16,9,-7,41.90292,-87.63772
TA1307000039,1,12,true,94,126,32,41.90294,-87.63137
658,1,12,true,13,11,-2,41.903,-87.6838
13256,1,12,true,19,6,-13,41.90302,-87.69749
TA1305000034,1,12,true,25,36,11,41.90313,-87.67391
182,1,12,true,17,19,2,41.90317,-87.63442
KA1504000135,1,12,true,59,80,21,41.90319,-87.63439
13136,1,12,true,23,36,13,41.90326,-87.67845
130,1,12,true,6,13,7,41.90327,-87.67846
210,1,12,true,14,9,-5,41.90342,-87.66781
13061,1,12,true,55,44,-11,41.90342,-87.66779
KA1504000079,1,12,true,37,30,-7,41.9035,-87.64334
359,1,12,true,10,13,3,41.90458,-87.6497
TA1307000115,1,12,true,20,22,2,41.9046,-87.64056
291,1,12,true,11,5,-6,41.90672,-87.63494
TA1308000049,1,12,true,52,60,8,41.90672,-87.6349
KA1504000134,1,12,true,34,23,-11,41.90687,-87.6262
13224,1,12,true,37,35,-2,41.90706,-87.66725
13221,1,12,true,26,33,7,41.90765,-87.67254
301,1,12,true,17,13,-4,41.90796,-87.63203
TA1309000024,1,12,true,45,49,4,41.908,-87.63152
69,1,12,true,21,8,-13,41.90939,-87.6777
TA1305000041,1,12,true,48,49,1,41.9094,-87.67769
331,1,12,true,61,69,8,41.90965,-87.64812
TA1305000037,1,12,true,31,27,-4,41.91018,-87.67003
TA1306000008,1,12,true,17,7,-10,41.9102,-87.6435
TA1308000005,1,12,true,13,21,8,41.91042,-87.68238
13258,1,12,true,15,11,-4,41.91043,-87.69718
13257,1,12,true,10,6,-4,41.91054,-87.68956
13154,1,12,true,65,71,6,41.91054,-87.65312
20,1,12,true,15,20,5,41.91055,-87.65313
13058,1,12,true,37,55,18,41.91059,-87.64942
TA1307000038,1,12,true,41,27,-14,41.91138,-87.63868
LF-005,1,12,true,109,82,-27,41.91172,-87.62681
126,1,12,true,10,4,-6,41.91196,-87.63197
13128,1,12,true,34,39,5,41.91197,-87.63197
289,1,12,true,10,17,7,41.91209,-87.63472
TA1308000050,1,12,true,89,104,15,41.91211,-87.6347
13243,1,12,true,51,52,1,41.91262,-87.6814
158,1,12,true,8,13,5,41.91262,-87.6814
TA1309000032,1,12,true,8,12,4,41.91293,-87.66417
TA1306000032,1,12,true,43,59,16,41.9137,-87.65285
93,1,12,true,12,8,-4,41.91371,-87.65285
TA1307000166,1,12,true,32,39,7,41.91386,-87.64877
15655,1,12,true,14,4,-10,41.91401,-87.70514
18017,1,12,true,8,13,5,41.91416,-87.71676
18067,1,12,true,28,39,11,41.9146,-87.66796
TA1306000007,1,12,true,17,11,-6,41.91469,-87.64333
13068,1,12,true,22,42,20,41.91554,-87.68703
116,1,12,true,4,11,7,41.91555,-87.68703
13179,1,12,true,60,66,6,41.9157,-87.63461
141,1,12,true,12,11,-1,41.91571,-87.63461
13133,1,12,true,36,31,-5,41.91598,-87.67733
TA1305000039,1,12,true,28,24,-4,41.9163,-87.66749
15650,1,12,true,13,8,-5,41.91711,-87.71023
15651,1,12,true,18,16,-2,41.91752,-87.70181
13266,1,12,true,12,9,-3,41.91774,-87.69142
TA1309000029,1,12,true,17,9,-8,41.9178,-87.68245
TA1309000006,1,12,true,28,25,-3,41.91809,-87.64375
TA1307000163,1,12,true,37,38,1,41.91821,-87.65696
94,1,12,true,10,10,0,41.91831,-87.6363
13146,1,12,true,79,66,-13,41.91831,-87.63629
13059,1,12,true,53,65,12,41.91845,-87.65222
113,1,12,true,13,11,-2,41.91846,-87.65222
13259,1,12,true,8,22,14,41.91852,-87.69744
13192,1,12,true,39,63,24,41.91995,-87.64884
13288,1,12,true,20,19,-1,41.92008,-87.67788
13242,1,12,true,10,6,-4,41.92021,-87.69266
TA1309000030,1,12,true,30,43,13,41.92077,-87.66372
13292,1,12,true,14,14,0,41.92152,-87.70733
TA1309000033,1,12,true,56,38,-18,41.92158,-87.65381
13193,1,12,true,61,106,45,41.92182,-87.64412
144,1,12,true,13,26,13,41.92182,-87.64411
13191,1,12,true,36,30,-6,41.92217,-87.63891
327,1,12,true,9,13,4,41.92225,-87.65783
13084,1,12,true,31,28,-3,41.92268,-87.69715
LP-,1,12,true,43,26,-17,41.92396,-87.63584
673,1,12,true,10,3,-7,41.92398,-87.63585
KA1504000140,1,12,true,10,15,5,41.92409,-87.67646
15648,1,12,true,8,13,5,41.92464,-87.68931
KA1504000090,1,12,true,10,6,-4,41.92483,-87.7145
TA1307000001,1,12,true,39,42,3,41.92535,-87.66581
188,1,12,true,11,4,-7,41.92536,-87.66581
TA1306000026,1,12,true,40,42,2,41.92558,-87.65842
87,1,12,true,9,13,4,41.92559,-87.65843
TA1306000016,1,12,true,66,53,-13,41.9256,-87.65371
67,1,12,true,7,12,5,41.9256,-87.65371
313,1,12,true,11,16,5,41.9257,-87.64246
TA1309000019,1,12,true,77,68,-9,41.92586,-87.63897
TA1309000058,1,12,true,60,79,19,41.92591,-87.64927
127,1,12,true,10,13,3,41.92592,-87.64927
177,1,12,true,10,9,-1,41.92627,-87.63086
TA1308000001,1,12,true,91,95,4,41.92627,-87.63086
13124,1,12,true,15,24,9,41.92675,-87.63444
302,1,12,true,15,8,-7,41.92859,-87.65421
TA1309000023,1,12,true,33,23,-10,41.9287,-87.65383
TA1307000113,1,12,true,28,29,1,41.92878,-87.66391
13296,1,12,true,16,13,-3,41.92883,-87.66852
TA1309000059,1,12,true,23,20,-3,41.92889,-87.65898
TA1309000061,1,12,true,74,44,-30,41.92915,-87.64909
TA1308000031,1,12,true,13,15,2,41.92946,-87.68417
340,1,12,true,14,17,3,41.92956,-87.64313
TA1305000014,1,12,true,65,90,25,41.92956,-87.64313
13085,1,12,true,20,22,2,41.92958,-87.70789
TA1307000142,1,12,true,75,70,-5,41.93125,-87.64432
220,1,12,true,20,23,3,41.93125,-87.64431
13276,1,12,true,40,58,18,41.93132,-87.63874
324,1,12,true,2,17,15,41.93173,-87.64179
15645,1,12,true,8,10,2,41.93191,-87.70121
13271,1,12,true,15,17,2,41.93192,-87.67784
TA1307000064,1,12,true,43,42,-1,41.93222,-87.65864
TA1306000014,1,12,true,49,46,-3,41.93242,-87.65271
13,1,12,true,12,12,0,41.93242,-87.65271
TA1309000039,1,12,true,48,50,2,41.93258,-87.63642
13294,1,12,true,17,12,-5,41.9326,-87.66595
332,1,12,true,10,9,-1,41.93313,-87.64776
TA1309000036,1,12,true,48,64,16,41.93313,-87.64776
TA1307000006,1,12,true,42,28,-14,41.93571,-87.6636
13268,1,12,true,20,8,-12,41.93588,-87.67843
13269,1,12,true,31,20,-11,41.93609,-87.66983
115,1,12,true,8,17,9,41.93628,-87.65266
TA1307000052,1,12,true,52,65,13,41.93628,-87.65266
156,1,12,true,11,17,6,41.9365,-87.64756
TA1307000136,1,12,true,80,69,-11,41.9365,-87.64755
TA1307000041,1,12,true,77,72,-5,41.93669,-87.63683
157,1,12,true,13,15,2,41.9367,-87.63683
13137,1,12,true,113,96,-17,41.9376,-87.6441
300,1,12,true,20,19,-1,41.93761,-87.6441
154,1,12,true,12,9,-3,41.93912,-87.66384
KA17018068,1,12,true,15,11,-4,41.93935,-87.68327
TA1309000042,1,12,true,45,44,-1,41.93937,-87.66836
131,1,12,true,10,5,-5,41.93937,-87.66835
15640,1,12,true,11,4,-7,41.93941,-87.72357
13229,1,12,true,35,29,-6,41.93946,-87.66376
TA1308000019,1,12,true,41,30,-11,41.93973,-87.65886
13277,1,12,true,50,47,-3,41.9401,-87.64546
296,1,12,true,9,13,4,41.9401,-87.64546
TA1307000134,1,12,true,52,94,42,41.94016,-87.65303
117,1,12,true,15,24,9,41.94016,-87.65302
334,1,12,true,13,3,-10,41.94076,-87.63919
TA1309000049,1,12,true,55,78,23,41.94077,-87.63919
TA1307000138,1,12,true,35,50,15,41.94334,-87.67094
13144,1,12,true,28,26,-2,41.9434,-87.67964
299,1,12,true,8,11,3,41.94368,-87.64894
TA1309000025,1,12,true,50,63,13,41.94368,-87.64894
229,1,12,true,13,12,-1,41.94372,-87.66401
13071,1,12,true,59,61,2,41.94373,-87.66401
632,1,12,true,66,62,-4,41.94453,-87.6547
303,1,12,true,15,20,5,41.94522,-87.64702
13278,1,12,true,64,48,-16,41.94553,-87.64644
TA1309000050,1,12,true,7,11,4,41.94618,-87.67331
15632,1,12,true,12,7,-5,41.94664,-87.69463
KA1504000143,1,12,true,10,13,3,41.94664,-87.68337
227,1,12,true,8,10,2,41.94813,-87.66397
13235,1,12,true,59,63,4,41.94814,-87.66396
304,1,12,true,16,22,6,41.94878,-87.64922
13253,1,12,true,21,31,10,41.9488,-87.67527
13325,1,12,true,91,81,-10,41.94907,-87.64863
TA1307000126,1,12,true,63,64,1,41.94936,-87.65451
232,1,12,true,17,17,0,41.94943,-87.64645
TA1307000150,1,12,true,98,59,-39,41.94945,-87.64646
13319,1,12,true,21,17,-4,41.95069,-87.6687
TA1307000127,1,12,true,40,51,11,41.9508,-87.65918
13323,1,12,true,59,54,-5,41.95282,-87.65
TA1309000043,1,12,true,35,27,-8,41.95417,-87.66434
240,1,12,true,11,8,-3,41.95424,-87.65441
13063,1,12,true,36,54,18,41.95424,-87.65441
KA1504000158,1,12,true,6,11,5,41.95432,-87.68607
254,1,12,true,15,9,-6,41.95438,-87.64806
TA1308000022,1,12,true,63,36,-27,41.95438,-87.64805
TA1307000149,1,12,true,30,13,-17,41.95467,-87.67392
TA1309000026,1,12,true,24,21,-3,41.95601,-87.6802
312,1,12,true,10,6,-4,41.95637,-87.6563
TA1308000047,1,12,true,10,15,5,41.95709,-87.6642
13379,1,12,true,50,55,5,41.95786,-87.6495
TA1309000018,1,12,true,5,11,6,41.95791,-87.67357
306,1,12,true,8,17,9,41.9585,-87.655
TA1309000027,1,12,true,41,38,-3,41.9585,-87.65499
13389,1,12,true,41,44,3,41.961,-87.64958
15622,1,12,true,12,9,-3,41.96108,-87.69544
TA1307000144,1,12,true,15,13,-2,41.96142,-87.6762
TA1309000021,1,12,true,20,19,-1,41.9615,-87.6714
15623,1,12,true,11,12,1,41.96154,-87.69117
234,1,12,true,10,3,-7,41.96158,-87.6661
KA1503000022,1,12,true,8,19,11,41.96158,-87.66609
231,1,12,true,8,11,3,41.96163,-87.65464
TA1307000107,1,12,true,58,56,-2,41.96164,-87.65464
TA1307000156,1,12,true,18,26,8,41.96301,-87.68479
TA1309000012,1,12,true,14,9,-5,41.96325,-87.67928
249,1,12,true,10,9,-1,41.96398,-87.63818
TA1308000012,1,12,true,41,50,9,41.96398,-87.63818
293,1,12,true,19,12,-7,41.96521,-87.65822
13074,1,12,true,33,34,1,41.96521,-87.6582
639,1,12,true,43,45,2,41.96584,-87.64538
TA1307000140,1,12,true,22,19,-3,41.96643,-87.68865
326,1,12,true,10,14,4,41.96665,-87.67113
TA1309000014,1,12,true,48,25,-23,41.96709,-87.66744
TA1307000158,1,12,true,35,24,-11,41.9671,-87.67904
TA1307000119,1,12,true,21,15,-6,41.96796,-87.65
TA1308000021,1,12,true,18,16,-2,41.96883,-87.65765
KA1504000080,1,12,true,7,14,7,41.96887,-87.69609
344,1,12,true,11,7,-4,41.9691,-87.67423
TA1309000066,1,12,true,53,50,-3,41.9691,-87.67423
TA1309000041,1,12,true,22,23,1,41.96951,-87.65471
KA1504000171,1,12,true,32,29,-3,41.97161,-87.65016
TA1309000035,1,12,true,52,44,-8,41.97335,-87.66785
13108,1,12,true,31,23,-8,41.97379,-87.65971
KA1504000149,1,12,true,22,14,-8,41.97562,-87.67945
KA1504000146,1,12,true,30,28,-2,41.978,-87.66805
294,1,12,true,10,7,-3,41.97835,-87.65976
13109,1,12,true,26,42,16,41.97835,-87.65976
655,1,12,true,12,6,-6,41.97987,-87.68194
KA1504000151,1,12,true,24,22,-2,41.98359,-87.66916
459,1,12,true,10,9,-1,41.98403,-87.65231
KA1504000152,1,12,true,67,84,17,41.98403,-87.65231
15578,1,12,true,20,20,0,41.98405,-87.66027
15575,1,12,true,18,21,3,41.98975,-87.66014
KA1504000148,1,12,true,14,12,-2,41.99086,-87.66971
15571,1,12,true,21,27,6,41.99478,-87.66028
KA1504000156,1,12,true,23,12,-11,41.99925,-87.67137
RP-009,1,12,true,21,7,-14,42.00107,-87.66122
RP-008,1,12,true,14,10,-4,42.00446,-87.6724
660,1,12,true,17,17,0,42.00458,-87.66143
KA1504000175,1,12,true,15,23,8,42.00797,-87.66549
520,1,12,true,28,15,-13,42.01597,-87.66859
515,1,12,true,7,27,20,42.01915,-87.67356
523,1,12,true,10,9,-1,42.02089,-87.66505
E002,1,12,true,18,15,-3,42.03256,-87.67912
596,1,12,true,22,22,0,42.04822,-87.68348
E008,1,12,true,13,22,9,42.05049,-87.67782
605,1,12,true,12,13,1,42.05294,-87.67342
604,1,12,true,21,28,7,42.05824,-87.67744
KA1503000002,1,16,false,16,14,-2,41.76641,-87.5657
KA1503000029,1,16,false,7,10,3,41.77364,-87.56747
15491,1,16,false,22,18,-4,41.78096,-87.57624
KA1503000014,1,16,false,24,20,-4,41.7851,-87.60108
426,1,16,false,9,10,1,41.7851,-87.60108
KA1503000070,1,16,false,11,13,2,41.78794,-87.58831
TA1309000011,1,16,false,19,20,1,41.78873,-87.60131
KA1503000071,1,16,false,44,31,-13,41.79148,-87.59988
KA1503000074,1,16,false,16,12,-4,41.79174,-87.58395
TA1309000063,1,16,false,26,23,-3,41.79325,-87.5878
KA1504000076,1,16,false,30,11,-19,41.7943,-87.60145
247,1,16,false,9,10,1,41.79522,-87.58077
TA1308000009,1,16,false,68,81,13,41.79522,-87.58075
TA1307000164,1,16,false,18,25,7,41.79527,-87.59647
248,1,16,false,5,11,6,41.79528,-87.59647
KA1503000052,1,16,false,13,19,6,41.79935,-87.60097
KA1503000059,1,16,false,40,31,-9,41.79952,-87.58643
TA1309000037,1,16,false,26,32,6,41.79957,-87.59474
KA1503000007,1,16,false,28,32,4,41.80242,-87.58689
13398,1,16,false,17,12,-5,41.80256,-87.59035
TA1308000035,1,16,false,24,10,-14,41.80944,-87.59188
TA1309000053,1,16,false,1,10,9,41.80985,-87.60675
KA1503000065,1,16,false,10,16,6,41.81409,-87.59701
TA1308000023,1,16,false,10,1,-9,41.81649,-87.60659
TA1308000038,1,16,false,8,13,5,41.82298,-87.6071
KA1503000066,1,16,false,10,4,-6,41.83011,-87.67031
15446,1,16,false,10,2,-8,41.83068,-87.65603
TA1307000129,1,16,false,10,3,-7,41.83104,-87.62683
KA1503000004,1,16,false,23,11,-12,41.83127,-87.6088
13216,1,16,false,15,27,12,41.83473,-87.62581
13215,1,16,false,11,15,4,41.83634,-87.6135
TA1307000048,1,16,false,53,35,-18,41.83855,-87.60821
TA1307000139,1,16,false,10,10,0,41.84205,-87.61698
15443,1,16,false,11,9,-2,41.84275,-87.63549
TA1307000005,1,16,false,10,6,-4,41.84569,-87.6225
TA1308000013,1,16,false,10,7,-3,41.84719,-87.64681
TA1308000026,1,16,false,16,9,-7,41.85008,-87.63214
TA1305000004,1,16,false,17,31,14,41.8514,-87.61884
TA1305000001,1,16,false,10,12,2,41.85262,-87.6265
13075,1,16,false,37,50,13,41.8531,-87.63192
15546,1,16,false,13,13,0,41.85416,-87.61916
13307,1,16,false,9,11,2,41.85489,-87.66359
13089,1,16,false,11,18,7,41.85497,-87.67567
15545,1,16,false,54,33,-21,41.85627,-87.61334
SL-013,1,16,false,6,10,4,41.85659,-87.62755
SL-006,1,16,false,10,9,-1,41.8568,-87.63387
13102,1,16,false,20,21,1,41.85762,-87.61942
13150,1,16,false,21,28,7,41.85783,-87.62455
13099,1,16,false,13,7,-6,41.85784,-87.64627
TA1307000159,1,16,false,14,8,-6,41.8579,-87.6687
TA1307000044,1,16,false,9,11,2,41.85794,-87.64083
13163,1,16,false,16,17,1,41.85808,-87.65108
13164,1,16,false,11,25,14,41.85818,-87.65648
SL-012,1,16,false,13,27,14,41.86038,-87.62581
TA1306000002,1,16,false,10,8,-2,41.86238,-87.65108
TA1307000124,1,16,false,42,45,3,41.86411,-87.62372
TA1309000001,1,16,false,27,25,-2,41.86488,-87.64708
13354,1,16,false,5,10,5,41.86524,-87.66651
13029,1,16,false,110,42,-68,41.86531,-87.6179
13431,1,16,false,146,107,-39,41.8661,-87.60728
WL-008,1,16,false,27,30,3,41.86712,-87.64108
59,1,16,false,5,11,6,41.86721,-87.62597
TA1305000002,1,16,false,56,74,18,41.86721,-87.62597
15544,1,16,false,241,170,-71,41.86723,-87.61536
3,1,16,false,27,8,-19,41.86723,-87.61536
TA1305000017,1,16,false,20,6,-14,41.86734,-87.64863
KA1706005007,1,16,false,20,23,3,41.86749,-87.63219
SL-005,1,16,false,178,132,-46,41.8679,-87.62304
255,1,16,false,20,16,-4,41.86791,-87.62304
13139,1,16,false,11,16,5,41.86893,-87.65913
13285,1,16,false,29,6,-23,41.86928,-87.67372
13160,1,16,false,13,21,8,41.86947,-87.65548
15550,1,16,false,30,33,3,41.87024,-87.63947
TA1309000010,1,16,false,79,90,11,41.87074,-87.62574
SL-009,1,16,false,26,22,-4,41.87081,-87.63121
TA1309000064,1,16,false,33,9,-24,41.87127,-87.67369
TA1307000130,1,16,false,7,20,13,41.87178,-87.65103
TA1307000121,1,16,false,19,8,-11,41.87184,-87.64664
41,1,16,false,4,16,12,41.87209,-87.62957
SL-008,1,16,false,52,37,-15,41.87209,-87.62956
13332,1,16,false,24,18,-6,41.87219,-87.6615
SL-011,1,16,false,39,50,11,41.87256,-87.63356
623,1,16,false,95,126,31,41.87272,-87.62399
KA1504000104,1,16,false,43,5,-38,41.87296,-87.66912
383,1,16,false,10,1,-9,41.87297,-87.66912
SL-007,1,16,false,38,44,6,41.87404,-87.6277
13326,1,16,false,12,5,-7,41.87425,-87.63958
TA1306000025,1,16,false,12,10,-2,41.87464,-87.65703
13028,1,16,false,20,15,-5,41.87475,-87.64981
SL-010,1,16,false,26,16,-10,41.87501,-87.63309
15541,1,16,false,158,116,-42,41.8758,-87.62086
13037,1,16,false,7,10,3,41.87588,-87.64078
TA1305000009,1,16,false,5,10,5,41.87593,-87.63068
TA1305000010,1,16,false,44,44,0,41.87623,-87.62444
624,1,16,false,29,44,15,41.87626,-87.62923
TA1305000035,1,16,false,28,43,15,41.87716,-87.62787
13138,1,16,false,21,8,-13,41.87723,-87.63941
631,1,16,false,12,8,-4,41.87761,-87.6739
15539,1,16,false,27,19,-8,41.87763,-87.64405
13158,1,16,false,38,23,-15,41.87764,-87.64957
13157,1,16,false,28,24,-4,41.87773,-87.6548
TA1305000025,1,16,false,91,40,-51,41.87773,-87.63528
TA1309000002,1,16,false,105,87,-18,41.87784,-87.62408
13206,1,16,false,11,17,6,41.87794,-87.66201
TA1309000004,1,16,false,47,21,-26,41.87811,-87.63184
638,1,16,false,47,32,-15,41.87827,-87.64078
TA1305000005,1,16,false,36,27,-9,41.87924,-87.62975
13011,1,16,false,45,53,8,41.87931,-87.63993
TA1309000008,1,16,false,58,49,-9,41.87933,-87.6355
KA1503000034,1,16,false,31,25,-6,41.87938,-87.63197
KA1503000015,1,16,false,53,41,-12,41.87948,-87.6257
TA1309000007,1,16,false,82,40,-42,41.88022,-87.63526
WL-011,1,16,false,27,22,-5,41.88034,-87.64273
13156,1,16,false,30,26,-4,41.88042,-87.65554
13300,1,16,false,317,331,14,41.88097,-87.61675
76,1,16,false,11,19,8,41.88098,-87.61675
13008,1,16,false,395,398,3,41.88105,-87.62408
90,1,16,false,26,17,-9,41.88107,-87.62409
TA1305000006,1,16,false,101,43,-58,41.88122,-87.6296
13134,1,16,false,7,16,9,41.88138,-87.67493
13056,1,16,false,29,26,-3,41.88168,-87.63951
TA1307000120,1,16,false,62,108,46,41.88188,-87.64879
13341,1,16,false,51,61,10,41.88208,-87.63985
174,1,16,false,10,2,-8,41.88208,-87.63984
13036,1,16,false,66,71,5,41.8821,-87.62513
TA1305000032,1,16,false,82,57,-25,41.88218,-87.64109
13006,1,16,false,38,22,-16,41.88268,-87.63252
13353,1,16,false,13,28,15,41.88283,-87.6612
654,1,16,false,17,17,0,41.88307,-87.65698
13409,1,16,false,20,32,12,41.8831,-87.6511
18,1,16,false,10,1,-9,41.88317,-87.63735
KA1503000072,1,16,false,44,16,-28,41.88317,-87.63693
WL-012,1,16,false,67,56,-11,41.88337,-87.6412
13053,1,16,false,68,53,-15,41.88365,-87.64863
43,1,16,false,10,18,8,41.88396,-87.62455
13001,1,16,false,155,121,-34,41.88397,-87.62459
13155,1,16,false,19,15,-4,41.88407,-87.65689
18062,1,16,false,23,22,-1,41.88412,-87.65427
81,1,16,false,12,6,-6,41.88417,-87.6296
TA1306000010,1,16,false,35,43,8,41.88419,-87.62961
TA1305000030,1,16,false,86,46,-40,41.88459,-87.63178
96,1,16,false,10,3,-7,41.8846,-87.64455
15535,1,16,false,41,39,-2,41.8846,-87.64455
TA1305000029,1,16,false,99,99,0,41.88466,-87.62787
13263,1,16,false,75,71,-4,41.88467,-87.61952
44,1,16,false,20,10,-10,41.88468,-87.62782
TA1306000015,1,16,false,55,54,-1,41.88549,-87.65232
13021,1,16,false,41,16,-25,41.88559,-87.64184
TA1307000111,1,16,false,72,30,-42,41.88582,-87.63548
164,1,16,false,10,3,-7,41.88583,-87.63547
13073,1,16,false,12,17,5,41.88592,-87.66717
KA17018054,1,16,false,15,2,-13,41.88595,-87.67701
KA1503000012,1,16,false,60,51,-9,41.88599,-87.63089
52,1,16,false,18,13,-5,41.886,-87.62421
TA1305000011,1,16,false,129,163,34,41.886,-87.62418
15534,1,16,false,33,33,0,41.88627,-87.61749
13197,1,16,false,25,5,-20,41.8866,-87.65816
TA1308000029,1,16,false,26,35,9,41.88673,-87.62225
TA1307000131,1,16,false,89,116,27,41.88688,-87.62606
KA1503000064,1,16,false,130,122,-8,41.88697,-87.61281
TA1305000022,1,16,false,67,30,-37,41.88817,-87.63656
TA1306000003,1,16,false,79,65,-14,41.88867,-87.64442
KA1503000043,1,16,false,88,79,-9,41.88918,-87.63851
13050,1,16,false,64,71,7,41.88919,-87.62775
47,1,16,false,11,4,-7,41.88921,-87.62775
13432,1,16,false,13,9,-4,41.88989,-87.67149
TA1307000151,1,16,false,83,59,-24,41.88993,-87.63427
212,1,16,false,10,6,-4,41.88995,-87.63427
636,1,16,false,41,19,-22,41.88997,-87.63662
KA1503000044,1,16,false,61,34,-27,41.89018,-87.6262
13427,1,16,false,50,62,12,41.89054,-87.62205
13430,1,16,false,70,82,12,41.89077,-87.63169
TA1306000013,1,16,false,114,130,16,41.89083,-87.61852
RN-,1,16,false,57,68,11,41.89102,-87.63546
13434,1,16,false,13,11,-2,41.89108,-87.66663
TA1308000006,1,16,false,10,18,8,41.89128,-87.67686
199,1,16,false,10,16,6,41.89143,-87.62676
TA1307000117,1,16,false,119,148,29,41.89144,-87.62675
13033,1,16,false,50,66,16,41.8916,-87.64835
13194,1,16,false,36,28,-8,41.8918,-87.65878
TA1305000003,1,16,false,83,101,18,41.89187,-87.62061
643,1,16,false,11,20,9,41.89203,-87.68939
35,1,16,false,14,16,2,41.89227,-87.61206
13022,1,16,false,768,812,44,41.89227,-87.61205
99,1,16,false,11,9,-2,41.89255,-87.61449
TA1306000029,1,16,false,109,121,12,41.89256,-87.61449
13265,1,16,false,49,48,-1,41.89383,-87.64172
74,1,16,false,5,20,15,41.89384,-87.64173
13045,1,16,false,78,78,0,41.89403,-87.62931
110,1,16,false,10,15,5,41.89406,-87.6293
13016,1,16,false,103,74,-29,41.89431,-87.62277
KA1503000041,1,16,false,45,53,8,41.89452,-87.61798
142,1,16,false,10,7,-3,41.89453,-87.61806
13196,1,16,false,33,18,-15,41.89455,-87.65345
TA1307000062,1,16,false,38,28,-10,41.89466,-87.63839
TA1306000012,1,16,false,94,80,-14,41.89475,-87.63438
627,1,16,false,4,10,6,41.8948,-87.63231
KP1705001026,1,16,false,38,61,23,41.89483,-87.6323
18058,1,16,false,10,4,-6,41.8955,-87.68201
637,1,16,false,19,22,3,41.89563,-87.67209
13132,1,16,false,18,34,16,41.89573,-87.67718
15530,1,16,false,93,74,-19,41.89575,-87.62596
18003,1,16,false,23,34,11,41.89575,-87.62011
13247,1,16,false,17,18,1,41.89597,-87.66775
TA1305000020,1,16,false,26,28,2,41.89636,-87.65406
13289,1,16,false,20,31,11,41.89638,-87.661
13303,1,16,false,48,39,-9,41.89672,-87.63088
13017,1,16,false,28,40,12,41.89676,-87.6357
13338,1,16,false,47,65,18,41.89697,-87.62173
TA1307000061,1,16,false,32,42,10,41.89745,-87.62873
13034,1,16,false,81,86,5,41.89754,-87.62352
TA1306000009,1,16,false,45,24,-21,41.89772,-87.64299
620,1,16,false,31,54,23,41.89817,-87.63754
KA1504000103,1,16,false,19,18,-1,41.89842,-87.68659
15529,1,16,false,83,79,-4,41.89858,-87.62206
140,1,16,false,11,13,2,41.89895,-87.6299
TA1307000128,1,16,false,77,84,7,41.89896,-87.6299
657,1,16,false,20,8,-12,41.89918,-87.6722
KA1504000117,1,16,false,15,5,-10,41.89936,-87.64848
13248,1,16,false,9,13,4,41.89964,-87.66788
TA1306000011,1,16,false,33,33,0,41.89994,-87.63443
KA1504000116,1,16,false,11,14,3,41.90023,-87.64299
17660,1,16,false,20,19,-1,41.90036,-87.69671
13290,1,16,false,18,31,13,41.90069,-87.66259
13042,1,16,false,264,328,64,41.90097,-87.62377
85,1,16,false,18,23,5,41.90098,-87.62375
TA1307000070,1,16,false,16,22,6,41.90133,-87.67742
KA1504000133,1,16,false,92,72,-20,41.90234,-87.62773
172,1,16,false,10,14,4,41.90236,-87.62774
13241,1,16,false,17,20,3,41.9029,-87.68731
176,1,16,false,10,11,1,41.90291,-87.63141
TA1307000039,1,16,false,116,129,13,41.90294,-87.63137
658,1,16,false,13,9,-4,41.903,-87.6838
13256,1,16,false,21,16,-5,41.90302,-87.69749
TA1305000034,1,16,false,34,48,14,41.90313,-87.67391
KA1504000135,1,16,false,87,93,6,41.90319,-87.63439
13136,1,16,false,18,24,6,41.90326,-87.67845
13061,1,16,false,64,67,3,41.90342,-87.66779
KA1504000079,1,16,false,44,41,-3,41.9035,-87.64334
TA1307000115,1,16,false,15,22,7,41.9046,-87.64056
291,1,16,false,5,11,6,41.90672,-87.63494
TA1308000049,1,16,false,83,79,-4,41.90672,-87.6349
KA1504000134,1,16,false,53,43,-10,41.90687,-87.6262
13224,1,16,false,34,35,1,41.90706,-87.66725
18069,1,16,false,11,1,-10,41.90722,-87.65563
TA1307000143,1,16,false,15,14,-1,41.90762,-87.63854
13221,1,16,false,44,63,19,41.90765,-87.67254
TA1309000024,1,16,false,64,63,-1,41.908,-87.63152
TA1305000041,1,16,false,67,59,-8,41.9094,-87.67769
331,1,16,false,63,87,24,41.90965,-87.64812
15653,1,16,false,11,13,2,41.90979,-87.7053
TA1305000037,1,16,false,27,25,-2,41.91018,-87.67003
TA1306000008,1,16,false,25,22,-3,41.9102,-87.6435
TA1308000005,1,16,false,19,17,-2,41.91042,-87.68238
13258,1,16,false,33,19,-14,41.91043,-87.69718
13257,1,16,false,16,26,10,41.91054,-87.68956
13154,1,16,false,34,48,14,41.91054,-87.65312
13058,1,16,false,32,30,-2,41.91059,-87.64942
TA1307000038,1,16,false,44,52,8,41.91138,-87.63868
LF-005,1,16,false,256,206,-50,41.91172,-87.62681
268,1,16,false,7,11,4,41.91172,-87.62681
13128,1,16,false,51,47,-4,41.91197,-87.63197
289,1,16,false,8,17,9,41.91209,-87.63472
TA1308000050,1,16,false,91,130,39,41.91211,-87.6347
13243,1,16,false,39,31,-8,41.91262,-87.6814
TA1309000032,1,16,false,15,7,-8,41.91293,-87.66417
TA1306000032,1,16,false,36,41,5,41.9137,-87.65285
TA1307000166,1,16,false,26,31,5,41.91386,-87.64877
15655,1,16,false,21,27,6,41.91401,-87.70514
18017,1,16,false,18,6,-12,41.91416,-87.71676
18067,1,16,false,27,23,-4,41.9146,-87.66796
TA1306000007,1,16,false,16,13,-3,41.91469,-87.64333
13068,1,16,false,20,22,2,41.91554,-87.68703
13179,1,16,false,110,109,-1,41.9157,-87.63461
13133,1,16,false,27,20,-7,41.91598,-87.67733
TA1305000039,1,16,false,31,36,5,41.9163,-87.66749
15650,1,16,false,10,21,11,41.91711,-87.71023
15651,1,16,false,27,29,2,41.91752,-87.70181
13266,1,16,false,14,12,-2,41.91774,-87.69142
TA1309000029,1,16,false,14,14,0,41.9178,-87.68245
TA1309000006,1,16,false,20,23,3,41.91809,-87.64375
TA1307000163,1,16,false,42,31,-11,41.91821,-87.65696
13146,1,16,false,103,112,9,41.91831,-87.63629
13059,1,16,false,72,71,-1,41.91845,-87.65222
113,1,16,false,7,14,7,41.91846,-87.65222
13259,1,16,false,18,11,-7,41.91852,-87.69744
13192,1,16,false,38,51,13,41.91995,-87.64884
13288,1,16,false,13,22,9,41.92008,-87.67788
13242,1,16,false,10,11,1,41.92021,-87.69266
TA1309000030,1,16,false,25,33,8,41.92077,-87.66372
13292,1,16,false,15,9,-6,41.92152,-87.70733
TA1309000033,1,16,false,36,28,-8,41.92158,-87.65381
13193,1,16,false,62,99,37,41.92182,-87.64412
144,1,16,false,11,12,1,41.92182,-87.64411
13191,1,16,false,52,48,-4,41.92217,-87.63891
13084,1,16,false,29,29,0,41.92268,-87.69715
LP-,1,16,false,109,58,-51,41.92396,-87.63584
KA1504000140,1,16,false,9,12,3,41.92409,-87.67646
KA1504000090,1,16,false,6,15,9,41.92483,-87.7145
TA1307000001,1,16,false,30,35,5,41.92535,-87.66581
TA1306000026,1,16,false,38,18,-20,41.92558,-87.65842
TA1306000016,1,16,false,44,32,-12,41.9256,-87.65371
313,1,16,false,11,9,-2,41.9257,-87.64246
TA1309000019,1,16,false,88,95,7,41.92586,-87.63897
TA1309000058,1,16,false,62,67,5,41.92591,-87.64927
TA1308000001,1,16,false,243,231,-12,41.92627,-87.63086
177,1,16,false,15,11,-4,41.92627,-87.63086
15646,1,16,false,12,16,4,41.92668,-87.6977
13124,1,16,false,74,50,-24,41.92675,-87.63444
TA1309000023,1,16,false,40,31,-9,41.9287,-87.65383
TA1307000113,1,16,false,30,28,-2,41.92878,-87.66391
13296,1,16,false,10,18,8,41.92883,-87.66852
TA1309000059,1,16,false,19,17,-2,41.92889,-87.65898
TA1309000061,1,16,false,41,52,11,41.92915,-87.64909
TA1308000031,1,16,false,16,34,18,41.92946,-87.68417
TA1305000014,1,16,false,77,48,-29,41.92956,-87.64313
340,1,16,false,12,9,-3,41.92956,-87.64313
13085,1,16,false,29,42,13,41.92958,-87.70789
15643,1,16,false,7,14,7,41.93057,-87.7238
TA1307000142,1,16,false,63,48,-15,41.93125,-87.64432
220,1,16,false,12,14,2,41.93125,-87.64431
13276,1,16,false,62,78,16,41.93132,-87.63874
13271,1,16,false,15,19,4,41.93192,-87.67784
TA1307000064,1,16,false,28,30,2,41.93222,-87.65864
13,1,16,false,12,6,-6,41.93242,-87.65271
TA1306000014,1,16,false,44,51,7,41.93242,-87.65271
TA1309000039,1,16,false,114,104,-10,41.93258,-87.63642
13294,1,16,false,14,20,6,41.9326,-87.66595
TA1309000036,1,16,false,36,35,-1,41.93313,-87.64776
TA1307000006,1,16,false,33,14,-19,41.93571,-87.6636
13268,1,16,false,25,17,-8,41.93588,-87.67843
13269,1,16,false,14,12,-2,41.93609,-87.66983
TA1307000052,1,16,false,34,35,1,41.93628,-87.65266
TA1307000136,1,16,false,46,54,8,41.9365,-87.64755
TA1307000041,1,16,false,102,103,1,41.93669,-87.63683
13137,1,16,false,84,93,9,41.9376,-87.6441
300,1,16,false,10,17,7,41.93761,-87.6441
KA17018068,1,16,false,14,7,-7,41.93935,-87.68327
TA1309000042,1,16,false,30,30,0,41.93937,-87.66836
13229,1,16,false,26,18,-8,41.93946,-87.66376
TA1308000019,1,16,false,37,36,-1,41.93973,-87.65886
13277,1,16,false,43,51,8,41.9401,-87.64546
TA1307000134,1,16,false,63,52,-11,41.94016,-87.65303
117,1,16,false,11,14,3,41.94016,-87.65302
13143,1,16,false,7,15,8,41.94059,-87.67853
334,1,16,false,7,10,3,41.94076,-87.63919
TA1309000049,1,16,false,114,123,9,41.94077,-87.63919
TA1307000138,1,16,false,18,33,15,41.94334,-87.67094
13144,1,16,false,8,18,10,41.9434,-87.67964
TA1309000025,1,16,false,62,59,-3,41.94368,-87.64894
13071,1,16,false,51,64,13,41.94373,-87.66401
632,1,16,false,58,78,20,41.94453,-87.6547
13278,1,16,false,50,52,2,41.94553,-87.64644
TA1309000050,1,16,false,12,12,0,41.94618,-87.67331
227,1,16,false,10,15,5,41.94813,-87.66397
13235,1,16,false,51,43,-8,41.94814,-87.66396
13253,1,16,false,6,14,8,41.9488,-87.67527
13325,1,16,false,54,56,2,41.94907,-87.64863
114,1,16,false,13,3,-10,41.94935,-87.65451
TA1307000126,1,16,false,117,100,-17,41.94936,-87.65451
TA1307000150,1,16,false,80,57,-23,41.94945,-87.64646
13319,1,16,false,9,19,10,41.95069,-87.6687
TA1307000127,1,16,false,72,72,0,41.9508,-87.65918
13323,1,16,false,30,29,-1,41.95282,-87.65
15624,1,16,false,11,8,-3,41.95339,-87.73199
TA1309000043,1,16,false,8,20,12,41.95417,-87.66434
13063,1,16,false,31,31,0,41.95424,-87.65441
KA1504000158,1,16,false,2,17,15,41.95432,-87.68607
TA1308000022,1,16,false,49,58,9,41.95438,-87.64805
TA1307000149,1,16,false,13,4,-9,41.95467,-87.67392
TA1309000026,1,16,false,5,17,12,41.95601,-87.6802
13249,1,16,false,6,12,6,41.95606,-87.66885
13379,1,16,false,39,31,-8,41.95786,-87.6495
TA1309000018,1,16,false,14,8,-6,41.95791,-87.67357
TA1309000027,1,16,false,21,32,11,41.9585,-87.65499
13389,1,16,false,31,31,0,41.961,-87.64958
15622,1,16,false,4,19,15,41.96108,-87.69544
TA1307000144,1,16,false,15,11,-4,41.96142,-87.6762
KA1503000022,1,16,false,11,8,-3,41.96158,-87.66609
231,1,16,false,13,9,-4,41.96163,-87.65464
TA1307000107,1,16,false,54,40,-14,41.96164,-87.65464
TA1307000156,1,16,false,12,15,3,41.96301,-87.68479
TA1308000012,1,16,false,141,116,-25,41.96398,-87.63818
13074,1,16,false,24,23,-1,41.96521,-87.6582
639,1,16,false,53,63,10,41.96584,-87.64538
TA1307000140,1,16,false,23,17,-6,41.96643,-87.68865
TA1309000014,1,16,false,18,16,-2,41.96709,-87.66744
TA1307000158,1,16,false,8,10,2,41.9671,-87.67904
TA1307000119,1,16,false,28,15,-13,41.96796,-87.65
TA1308000021,1,16,false,10,14,4,41.96883,-87.65765
KA1504000080,1,16,false,8,15,7,41.96887,-87.69609
TA1309000066,1,16,false,21,21,0,41.9691,-87.67423
TA1309000041,1,16,false,13,12,-1,41.96951,-87.65471
KA1504000171,1,16,false,35,28,-7,41.97161,-87.65016
TA1309000035,1,16,false,34,35,1,41.97335,-87.66785
13108,1,16,false,25,33,8,41.97379,-87.65971
KA1504000078,1,16,false,11,16,5,41.97491,-87.69258
KA1504000160,1,16,false,18,6,-12,41.97564,-87.70143
KA1504000146,1,16,false,23,30,7,41.978,-87.66805
13109,1,16,false,18,21,3,41.97835,-87.65976
KA1504000151,1,16,false,18,18,0,41.98359,-87.66916
15585,1,16,false,10,8,-2,41.98367,-87.69642
KA1504000152,1,16,false,101,104,3,41.98403,-87.65231
459,1,16,false,5,10,5,41.98403,-87.65231
15578,1,16,false,18,14,-4,41.98405,-87.66027
15575,1,16,false,25,19,-6,41.98975,-87.66014
KA1504000148,1,16,false,11,5,-6,41.99086,-87.66971
15571,1,16,false,29,23,-6,41.99478,-87.66028
RP-009,1,16,false,15,26,11,42.00107,-87.66122
RP-001,1,16,false,15,18,3,42.00179,-87.68883
660,1,16,false,15,17,2,42.00458,-87.66143
KA1504000175,1,16,false,14,10,-4,42.00797,-87.66549
520,1,16,false,7,10,3,42.01597,-87.66859
523,1,16,false,8,12,4,42.02089,-87.66505
E002,1,16,false,11,15,4,42.03256,-87.67912
596,1,16,false,24,32,8,42.04822,-87.68348
E008,1,16,false,21,34,13,42.05049,-87.67782
605,1,16,false,20,16,-4,42.05294,-87.67342
661,1,16,false,6,13,7,42.05704,-87.68657
604,1,16,false,40,22,-18,42.05824,-87.67744
426,1,16,true,27,13,-14,41.7851,-87.60108
KA1503000014,1,16,true,52,63,11,41.7851,-87.60108
KA1503000070,1,16,true,15,21,6,41.78794,-87.58831
328,1,16,true,21,6,-15,41.78872,-87.6013
TA1309000011,1,16,true,90,11,-79,41.78873,-87.60131
KA1503000071,1,16,true,127,47,-80,41.79148,-87.59988
423,1,16,true,30,7,-23,41.79148,-87.59988
KA1503000074,1,16,true,14,17,3,41.79174,-87.58395
TA1309000063,1,16,true,36,44,8,41.79325,-87.5878
345,1,16,true,8,14,6,41.79326,-87.5878
420,1,16,true,20,25,5,41.79429,-87.60145
KA1504000076,1,16,true,52,47,-5,41.7943,-87.60145
247,1,16,true,7,14,7,41.79522,-87.58077
TA1308000009,1,16,true,59,75,16,41.79522,-87.58075
TA1307000164,1,16,true,35,45,10,41.79527,-87.59647
KA1503000052,1,16,true,36,43,7,41.79935,-87.60097
KA1503000059,1,16,true,21,34,13,41.79952,-87.58643
TA1309000037,1,16,true,44,84,40,41.79957,-87.59474
417,1,16,true,7,14,7,41.80242,-87.5869
KA1503000007,1,16,true,27,40,13,41.80242,-87.58689
121,1,16,true,2,11,9,41.80256,-87.59035
13398,1,16,true,14,25,11,41.80256,-87.59035
TA1308000035,1,16,true,24,14,-10,41.80944,-87.59188
TA1308000002,1,16,true,7,10,3,41.80983,-87.59937
TA1308000038,1,16,true,10,8,-2,41.82298,-87.6071
546,1,16,true,10,2,-8,41.82319,-87.67661
KA1503000068,1,16,true,9,29,20,41.82878,-87.68062
TA1308000045,1,16,true,16,17,1,41.83062,-87.64129
TA1308000043,1,16,true,19,14,-5,41.83066,-87.64715
KA1503000005,1,16,true,9,11,2,41.83079,-87.6325
TA1307000129,1,16,true,64,9,-55,41.83104,-87.62683
13345,1,16,true,14,7,-7,41.83138,-87.61803
15445,1,16,true,15,7,-8,41.83453,-87.63183
13216,1,16,true,79,48,-31,41.83473,-87.62581
148,1,16,true,13,17,4,41.83474,-87.62581
149,1,16,true,12,6,-6,41.83486,-87.61791
13217,1,16,true,27,52,25,41.83488,-87.61792
13215,1,16,true,11,22,11,41.83634,-87.6135
TA1308000046,1,16,true,13,16,3,41.83779,-87.65115
TA1309000055,1,16,true,39,53,14,41.8382,-87.64514
KA1503000038,1,16,true,23,15,-8,41.83845,-87.6354
TA1307000048,1,16,true,41,36,-5,41.83855,-87.60821
TA1308000036,1,16,true,21,24,3,41.83883,-87.62186
15442,1,16,true,12,6,-6,41.83918,-87.66562
237,1,16,true,12,16,4,41.84204,-87.61697
TA1307000139,1,16,true,44,38,-6,41.84205,-87.61698
15443,1,16,true,10,12,2,41.84275,-87.63549
TA1307000153,1,16,true,12,47,35,41.84358,-87.64538
147,1,16,true,12,5,-7,41.84569,-87.62251
TA1307000005,1,16,true,45,17,-28,41.84569,-87.6225
TA1308000014,1,16,true,10,8,-2,41.84953,-87.64059
TA1305000001,1,16,true,5,35,30,41.85262,-87.6265
13075,1,16,true,23,35,12,41.8531,-87.63192
13091,1,16,true,20,6,-14,41.85409,-87.68585
15546,1,16,true,14,12,-2,41.85416,-87.61916
13089,1,16,true,7,12,5,41.85497,-87.67567
13331,1,16,true,14,15,1,41.85515,-87.65414
4,1,16,true,16,14,-2,41.85627,-87.61334
15545,1,16,true,87,89,2,41.85627,-87.61334
SL-013,1,16,true,12,18,6,41.85659,-87.62755
13135,1,16,true,35,23,-12,41.85753,-87.66157
13102,1,16,true,46,84,38,41.85762,-87.61942
13150,1,16,true,70,65,-5,41.85783,-87.62455
273,1,16,true,13,12,-1,41.85783,-87.62455
13099,1,16,true,8,20,12,41.85784,-87.64627
TA1307000159,1,16,true,19,26,7,41.8579,-87.6687
TA1307000044,1,16,true,29,15,-14,41.85794,-87.64083
13163,1,16,true,16,32,16,41.85808,-87.65108
13164,1,16,true,55,35,-20,41.85818,-87.65648
SL-012,1,16,true,32,85,53,41.86038,-87.62581
72,1,16,true,3,15,12,41.86039,-87.62581
13304,1,16,true,12,9,-3,41.86126,-87.65659
KA1504000109,1,16,true,23,2,-21,41.86192,-87.69347
TA1306000002,1,16,true,39,54,15,41.86238,-87.65108
TA1307000124,1,16,true,54,96,42,41.86411,-87.62372
168,1,16,true,11,17,6,41.86415,-87.62372
TA1309000001,1,16,true,38,45,7,41.86488,-87.64708
275,1,16,true,12,3,-9,41.86524,-87.66651
13354,1,16,true,20,23,3,41.86524,-87.66651
13029,1,16,true,18,5,-13,41.86531,-87.6179
341,1,16,true,11,7,-4,41.86608,-87.60733
13431,1,16,true,67,43,-24,41.8661,-87.60728
KA1504000101,1,16,true,13,8,-5,41.86651,-87.68466
WL-008,1,16,true,46,55,9,41.86712,-87.64108
57,1,16,true,7,13,6,41.86712,-87.64107
59,1,16,true,30,38,8,41.86721,-87.62597
TA1305000002,1,16,true,108,146,38,41.86721,-87.62597
15544,1,16,true,42,40,-2,41.86723,-87.61536
TA1305000017,1,16,true,22,14,-8,41.86734,-87.64863
KA1706005007,1,16,true,22,38,16,41.86749,-87.63219
SL-005,1,16,true,111,182,71,41.8679,-87.62304
255,1,16,true,12,24,12,41.86791,-87.62304
644,1,16,true,50,41,-9,41.86859,-87.68625
13139,1,16,true,31,46,15,41.86893,-87.65913
13285,1,16,true,202,22,-180,41.86928,-87.67372
13160,1,16,true,62,66,4,41.86947,-87.65548
22,1,16,true,9,14,5,41.86947,-87.65548
15550,1,16,true,20,40,20,41.87024,-87.63947
TA1309000010,1,16,true,59,90,31,41.87074,-87.62574
SL-009,1,16,true,33,42,9,41.87081,-87.63121
342,1,16,true,51,4,-47,41.87127,-87.6737
TA1309000064,1,16,true,173,33,-140,41.87127,-87.67369
15542,1,16,true,11,7,-4,41.87146,-87.64095
261,1,16,true,17,3,-14,41.87151,-87.6699
TA1307000130,1,16,true,91,60,-31,41.87178,-87.65103
241,1,16,true,14,13,-1,41.8718,-87.65102
108,1,16,true,19,27,8,41.87183,-87.64664
TA1307000121,1,16,true,67,65,-2,41.87184,-87.64664
41,1,16,true,18,28,10,41.87209,-87.62957
SL-008,1,16,true,107,139,32,41.87209,-87.62956
13332,1,16,true,122,124,2,41.87219,-87.6615
394,1,16,true,3,10,7,41.87226,-87.63484
175,1,16,true,17,12,-5,41.87255,-87.63359
SL-011,1,16,true,60,90,30,41.87256,-87.63356
623,1,16,true,49,60,11,41.87272,-87.62399
KA1504000104,1,16,true,242,18,-224,41.87296,-87.66912
383,1,16,true,37,7,-30,41.87297,-87.66912
320,1,16,true,22,22,0,41.87327,-87.66402
SL-007,1,16,true,37,43,6,41.87404,-87.6277
13326,1,16,true,33,14,-19,41.87425,-87.63958
321,1,16,true,13,17,4,41.87427,-87.63257
TA1306000025,1,16,true,56,37,-19,41.87464,-87.65703
15668,1,16,true,15,25,10,41.87471,-87.68642
13028,1,16,true,41,40,-1,41.87475,-87.64981
13081,1,16,true,33,10,-23,41.87501,-87.67326
89,1,16,true,7,17,10,41.87501,-87.6331
SL-010,1,16,true,30,122,92,41.87501,-87.63309
15541,1,16,true,12,10,-2,41.8758,-87.62086
13037,1,16,true,20,17,-3,41.87588,-87.64078
TA1305000009,1,16,true,32,74,42,41.87593,-87.63068
317,1,16,true,33,2,-31,41.87603,-87.68195
TA1305000010,1,16,true,27,18,-9,41.87623,-87.62444
624,1,16,true,42,56,14,41.87626,-87.62923
33,1,16,true,10,10,0,41.87715,-87.62786
TA1305000035,1,16,true,61,17,-44,41.87716,-87.62787
13138,1,16,true,83,71,-12,41.87723,-87.63941
75,1,16,true,11,2,-9,41.87724,-87.63937
631,1,16,true,35,5,-30,41.87761,-87.6739
15539,1,16,true,73,47,-26,41.87763,-87.64405
13158,1,16,true,102,124,22,41.87764,-87.64957
134,1,16,true,14,22,8,41.87764,-87.64954
13157,1,16,true,88,46,-42,41.87773,-87.6548
21,1,16,true,23,14,-9,41.87773,-87.6548
TA1305000025,1,16,true,134,54,-80,41.87773,-87.63528
36,1,16,true,16,13,-3,41.87776,-87.63525
TA1309000002,1,16,true,39,31,-8,41.87784,-87.62408
13206,1,16,true,41,56,15,41.87794,-87.66201
283,1,16,true,42,16,-26,41.87809,-87.63183
TA1309000004,1,16,true,150,93,-57,41.87811,-87.63184
107,1,16,true,14,16,2,41.87822,-87.644
638,1,16,true,177,182,5,41.87827,-87.64078
37,1,16,true,26,10,-16,41.87921,-87.62975
TA1305000005,1,16,true,123,43,-80,41.87924,-87.62975
286,1,16,true,12,1,-11,41.8793,-87.6355
13011,1,16,true,144,211,67,41.87931,-87.63993
TA1309000008,1,16,true,110,34,-76,41.87933,-87.6355
192,1,16,true,20,30,10,41.87935,-87.63997
KA1503000034,1,16,true,80,9,-71,41.87938,-87.63197
39,1,16,true,18,10,-8,41.87948,-87.62571
KA1503000015,1,16,true,110,45,-65,41.87948,-87.6257
15667,1,16,true,9,13,4,41.8798,-87.68609
287,1,16,true,48,12,-36,41.88017,-87.63527
TA1309000007,1,16,true,292,57,-235,41.88022,-87.63526
WL-011,1,16,true,45,42,-3,41.88034,-87.64273
73,1,16,true,11,14,3,41.8804,-87.64273
80,1,16,true,9,12,3,41.88042,-87.65556
13156,1,16,true,48,92,44,41.88042,-87.65554
13300,1,16,true,118,127,9,41.88097,-87.61675
76,1,16,true,17,15,-2,41.88098,-87.61675
13008,1,16,true,102,79,-23,41.88105,-87.62408
90,1,16,true,12,10,-2,41.88107,-87.62409
49,1,16,true,40,9,-31,41.88116,-87.62963
TA1305000006,1,16,true,287,54,-233,41.88122,-87.6296
13134,1,16,true,13,7,-6,41.88138,-87.67493
13056,1,16,true,84,44,-40,41.88168,-87.63951
198,1,16,true,18,26,8,41.88187,-87.6488
TA1307000120,1,16,true,113,154,41,41.88188,-87.64879
13341,1,16,true,135,83,-52,41.88208,-87.63985
174,1,16,true,15,9,-6,41.88208,-87.63984
197,1,16,true,16,14,-2,41.88208,-87.62513
13036,1,16,true,99,40,-59,41.8821,-87.62513
77,1,16,true,23,28,5,41.88214,-87.64108
TA1305000032,1,16,true,176,180,4,41.88218,-87.64109
98,1,16,true,24,7,-17,41.88266,-87.63251
13006,1,16,true,136,51,-85,41.88268,-87.63252
13353,1,16,true,39,74,35,41.88283,-87.6612
346,1,16,true,4,16,12,41.88284,-87.6612
654,1,16,true,27,39,12,41.88307,-87.65698
13409,1,16,true,56,38,-18,41.8831,-87.6511
18,1,16,true,12,10,-2,41.88317,-87.63735
KA1503000072,1,16,true,108,29,-79,41.88317,-87.63693
91,1,16,true,7,31,24,41.88336,-87.64122
WL-012,1,16,true,136,299,163,41.88337,-87.6412
112,1,16,true,12,9,-3,41.88362,-87.6486
13053,1,16,true,54,63,9,41.88365,-87.64863
43,1,16,true,16,14,-2,41.88396,-87.62455
13001,1,16,true,133,76,-57,41.88397,-87.62459
13155,1,16,true,30,21,-9,41.88407,-87.65689
18062,1,16,true,55,54,-1,41.88412,-87.65427
81,1,16,true,26,21,-5,41.88417,-87.6296
TA1306000010,1,16,true,131,68,-63,41.88419,-87.62961
TA1305000030,1,16,true,186,56,-130,41.88459,-87.63178
15535,1,16,true,41,45,4,41.8846,-87.64455
51,1,16,true,23,5,-18,41.88462,-87.63176
TA1305000029,1,16,true,107,88,-19,41.88466,-87.62787
195,1,16,true,17,21,4,41.88466,-87.61952
13263,1,16,true,120,122,2,41.88467,-87.61952
44,1,16,true,17,12,-5,41.88468,-87.62782
TA1306000015,1,16,true,121,89,-32,41.88549,-87.65232
71,1,16,true,10,9,-1,41.8855,-87.65233
66,1,16,true,24,19,-5,41.88557,-87.64186
13021,1,16,true,136,102,-34,41.88559,-87.64184
TA1307000111,1,16,true,184,53,-131,41.88582,-87.63548
164,1,16,true,30,17,-13,41.88583,-87.63547
13073,1,16,true,17,15,-2,41.88592,-87.66717
KA17018054,1,16,true,14,10,-4,41.88595,-87.67701
KA1503000012,1,16,true,85,68,-17,41.88599,-87.63089
38,1,16,true,17,11,-6,41.88599,-87.63089
52,1,16,true,22,16,-6,41.886,-87.62421
TA1305000011,1,16,true,156,83,-73,41.886,-87.62418
7,1,16,true,16,12,-4,41.88627,-87.61751
15534,1,16,true,73,81,8,41.88627,-87.61749
13197,1,16,true,45,24,-21,41.8866,-87.65816
264,1,16,true,28,3,-25,41.8867,-87.62224
TA1308000029,1,16,true,62,26,-36,41.88673,-87.62225
TA1307000131,1,16,true,90,30,-60,41.88688,-87.62606
194,1,16,true,21,2,-19,41.88688,-87.62606
KA1503000064,1,16,true,40,49,9,41.88697,-87.61281
100,1,16,true,45,10,-35,41.88814,-87.63657
TA1305000022,1,16,true,169,74,-95,41.88817,-87.63656
56,1,16,true,38,28,-10,41.88866,-87.64442
TA1306000003,1,16,true,136,126,-10,41.88867,-87.64442
133,1,16,true,34,49,15,41.88918,-87.63851
KA1503000043,1,16,true,239,266,27,41.88918,-87.63851
13050,1,16,true,135,69,-66,41.88919,-87.62775
47,1,16,true,33,17,-16,41.88921,-87.62775
15664,1,16,true,8,34,26,41.8895,-87.68821
13432,1,16,true,21,28,7,41.88989,-87.67149
TA1307000151,1,16,true,107,110,3,41.88993,-87.63427
212,1,16,true,23,16,-7,41.88995,-87.63427
636,1,16,true,57,69,12,41.88997,-87.63662
125,1,16,true,15,6,-9,41.89018,-87.62621
KA1503000044,1,16,true,70,33,-37,41.89018,-87.6262
196,1,16,true,10,15,5,41.89053,-87.62205
13427,1,16,true,46,66,20,41.89054,-87.62205
26,1,16,true,15,15,0,41.89057,-87.61798
13430,1,16,true,98,83,-15,41.89077,-87.63169
181,1,16,true,18,9,-9,41.89077,-87.63168
TA1306000013,1,16,true,79,81,2,41.89083,-87.61852
RN-,1,16,true,73,71,-2,41.89102,-87.63546
672,1,16,true,15,17,2,41.89102,-87.63545
13434,1,16,true,15,40,25,41.89108,-87.66663
TA1308000006,1,16,true,26,31,5,41.89128,-87.67686
199,1,16,true,23,22,-1,41.89143,-87.62676
TA1307000117,1,16,true,152,117,-35,41.89144,-87.62675
13033,1,16,true,89,109,20,41.8916,-87.64835
84,1,16,true,8,10,2,41.89161,-87.64833
186,1,16,true,10,12,2,41.8918,-87.65879
13194,1,16,true,61,64,3,41.8918,-87.65878
TA1305000003,1,16,true,152,96,-56,41.89187,-87.62061
24,1,16,true,24,24,0,41.8919,-87.62063
643,1,16,true,5,17,12,41.89203,-87.68939
35,1,16,true,15,23,8,41.89227,-87.61206
13022,1,16,true,128,106,-22,41.89227,-87.61205
99,1,16,true,10,18,8,41.89255,-87.61449
TA1306000029,1,16,true,100,91,-9,41.89256,-87.61449
13265,1,16,true,121,117,-4,41.89383,-87.64172
74,1,16,true,22,23,1,41.89384,-87.64173
13045,1,16,true,160,170,10,41.89403,-87.62931
110,1,16,true,36,31,-5,41.89406,-87.6293
13016,1,16,true,452,61,-391,41.89431,-87.62277
211,1,16,true,115,13,-102,41.89439,-87.62267
KA1503000041,1,16,true,266,61,-205,41.89452,-87.61798
142,1,16,true,83,9,-74,41.89453,-87.61806
13196,1,16,true,41,56,15,41.89455,-87.65345
TA1307000062,1,16,true,99,56,-43,41.89466,-87.63839
111,1,16,true,15,8,-7,41.89466,-87.63837
TA1306000012,1,16,true,107,142,35,41.89475,-87.63438
53,1,16,true,22,38,16,41.89476,-87.63439
627,1,16,true,14,14,0,41.8948,-87.63231
KP1705001026,1,16,true,89,62,-27,41.89483,-87.6323
18058,1,16,true,15,30,15,41.8955,-87.68201
637,1,16,true,21,78,57,41.89563,-87.67209
128,1,16,true,5,12,7,41.89571,-87.67716
13132,1,16,true,37,69,32,41.89573,-87.67718
161,1,16,true,29,7,-22,41.89574,-87.62599
15530,1,16,true,127,77,-50,41.89575,-87.62596
18003,1,16,true,110,34,-76,41.89575,-87.62011
635,1,16,true,31,6,-25,41.89576,-87.62012
13247,1,16,true,32,73,41,41.89597,-87.66775
350,1,16,true,8,12,4,41.89597,-87.66774
TA1305000020,1,16,true,43,50,7,41.89636,-87.65406
54,1,16,true,10,12,2,41.89637,-87.65407
13289,1,16,true,34,72,38,41.89638,-87.661
337,1,16,true,29,17,-12,41.89659,-87.63096
13303,1,16,true,58,69,11,41.89672,-87.63088
13017,1,16,true,87,87,0,41.89676,-87.6357
31,1,16,true,21,17,-4,41.89677,-87.63572
13338,1,16,true,130,38,-92,41.89697,-87.62173
173,1,16,true,41,17,-24,41.89704,-87.62173
TA1307000061,1,16,true,70,40,-30,41.89745,-87.62873
106,1,16,true,14,7,-7,41.89746,-87.62874
13034,1,16,true,88,35,-53,41.89754,-87.62352
48,1,16,true,29,6,-23,41.89772,-87.64302
TA1306000009,1,16,true,174,50,-124,41.89772,-87.64299
620,1,16,true,68,44,-24,41.89817,-87.63754
KA1504000103,1,16,true,29,43,14,41.89842,-87.68659
145,1,16,true,22,14,-8,41.89856,-87.62211
15529,1,16,true,118,60,-58,41.89858,-87.62206
140,1,16,true,30,29,-1,41.89895,-87.6299
TA1307000128,1,16,true,110,126,16,41.89896,-87.6299
657,1,16,true,28,53,25,41.89918,-87.6722
KA1504000117,1,16,true,19,8,-11,41.89936,-87.64848
13248,1,16,true,22,43,21,41.89964,-87.66788
46,1,16,true,12,14,2,41.89994,-87.63444
TA1306000011,1,16,true,41,40,-1,41.89994,-87.63443
KA1504000116,1,16,true,56,60,4,41.90023,-87.64299
364,1,16,true,3,12,9,41.90023,-87.64299
17660,1,16,true,16,15,-1,41.90036,-87.69671
13290,1,16,true,39,46,7,41.90069,-87.66259
13042,1,16,true,166,123,-43,41.90097,-87.62377
85,1,16,true,23,13,-10,41.90098,-87.62375
TA1307000070,1,16,true,28,43,15,41.90133,-87.67742
KA1504000133,1,16,true,90,113,23,41.90234,-87.62773
172,1,16,true,12,18,6,41.90236,-87.62774
13241,1,16,true,20,21,1,41.9029,-87.68731
176,1,16,true,30,50,20,41.90291,-87.63141
TA1306000006,1,16,true,21,27,6,41.90292,-87.63772
TA1307000039,1,16,true,158,301,143,41.90294,-87.63137
658,1,16,true,65,17,-48,41.903,-87.6838
13256,1,16,true,23,18,-5,41.90302,-87.69749
TA1305000034,1,16,true,37,38,1,41.90313,-87.67391
182,1,16,true,29,30,1,41.90317,-87.63442
KA1504000135,1,16,true,124,182,58,41.90319,-87.63439
13136,1,16,true,33,33,0,41.90326,-87.67845
210,1,16,true,14,11,-3,41.90342,-87.66781
13061,1,16,true,108,103,-5,41.90342,-87.66779
KA1504000079,1,16,true,59,63,4,41.9035,-87.64334
359,1,16,true,12,15,3,41.90458,-87.6497
138,1,16,true,11,20,9,41.9046,-87.64057
TA1307000115,1,16,true,47,60,13,41.9046,-87.64056
291,1,16,true,7,15,8,41.90672,-87.63494
TA1308000049,1,16,true,80,81,1,41.90672,-87.6349
KA1504000134,1,16,true,49,92,43,41.90687,-87.6262
333,1,16,true,7,22,15,41.90706,-87.66725
13224,1,16,true,42,61,19,41.90706,-87.66725
18069,1,16,true,17,1,-16,41.90722,-87.65563
TA1307000143,1,16,true,11,21,10,41.90762,-87.63854
61,1,16,true,10,15,5,41.90764,-87.67254
13221,1,16,true,49,82,33,41.90765,-87.67254
13245,1,16,true,12,10,-2,41.90777,-87.68586
301,1,16,true,17,16,-1,41.90796,-87.63203
TA1309000024,1,16,true,95,132,37,41.908,-87.63152
69,1,16,true,12,10,-2,41.90939,-87.6777
TA1305000041,1,16,true,56,68,12,41.9094,-87.67769
331,1,16,true,112,151,39,41.90965,-87.64812
TA1305000037,1,16,true,42,61,19,41.91018,-87.67003
27,1,16,true,6,11,5,41.91019,-87.6435
TA1306000008,1,16,true,38,36,-2,41.9102,-87.6435
16,1,16,true,14,16,2,41.91035,-87.67008
TA1308000005,1,16,true,36,27,-9,41.91042,-87.68238
13258,1,16,true,20,29,9,41.91043,-87.69718
13257,1,16,true,18,22,4,41.91054,-87.68956
13154,1,16,true,91,119,28,41.91054,-87.65312
20,1,16,true,11,25,14,41.91055,-87.65313
60,1,16,true,22,8,-14,41.91059,-87.64942
13058,1,16,true,75,67,-8,41.91059,-87.64942
118,1,16,true,11,12,1,41.91138,-87.63868
TA1307000038,1,16,true,69,72,3,41.91138,-87.63868
LF-005,1,16,true,143,119,-24,41.91172,-87.62681
268,1,16,true,12,16,4,41.91172,-87.62681
13128,1,16,true,57,53,-4,41.91197,-87.63197
289,1,16,true,23,33,10,41.91209,-87.63472
TA1308000050,1,16,true,146,201,55,41.91211,-87.6347
158,1,16,true,10,14,4,41.91262,-87.6814
13243,1,16,true,43,70,27,41.91262,-87.6814
TA1309000032,1,16,true,17,16,-1,41.91293,-87.66417
TA1306000032,1,16,true,82,93,11,41.9137,-87.65285
93,1,16,true,4,20,16,41.91371,-87.65285
TA1307000166,1,16,true,50,51,1,41.91386,-87.64877
15655,1,16,true,21,29,8,41.91401,-87.70514
18017,1,16,true,9,17,8,41.91416,-87.71676
18067,1,16,true,35,23,-12,41.9146,-87.66796
TA1306000007,1,16,true,34,26,-8,41.91469,-87.64333
28,1,16,true,8,11,3,41.91469,-87.64333
13068,1,16,true,54,37,-17,41.91554,-87.68703
13179,1,16,true,119,102,-17,41.9157,-87.63461
141,1,16,true,14,8,-6,41.91571,-87.63461
219,1,16,true,7,10,3,41.91598,-87.67733
13133,1,16,true,48,75,27,41.91598,-87.67733
58,1,16,true,3,10,7,41.91602,-87.66894
TA1305000039,1,16,true,41,69,28,41.9163,-87.66749
15650,1,16,true,10,12,2,41.91711,-87.71023
15651,1,16,true,9,26,17,41.91752,-87.70181
13266,1,16,true,18,29,11,41.91774,-87.69142
TA1309000029,1,16,true,22,21,-1,41.9178,-87.68245
288,1,16,true,13,5,-8,41.91809,-87.64375
TA1309000006,1,16,true,38,43,5,41.91809,-87.64375
223,1,16,true,8,12,4,41.91821,-87.65698
TA1307000163,1,16,true,68,95,27,41.91821,-87.65696
94,1,16,true,22,28,6,41.91831,-87.6363
13146,1,16,true,80,115,35,41.91831,-87.63629
13059,1,16,true,86,92,6,41.91845,-87.65222
113,1,16,true,26,11,-15,41.91846,-87.65222
13259,1,16,true,18,10,-8,41.91852,-87.69744
225,1,16,true,10,17,7,41.91995,-87.64884
13192,1,16,true,55,77,22,41.91995,-87.64884
13288,1,16,true,25,19,-6,41.92008,-87.67788
13242,1,16,true,15,15,0,41.92021,-87.69266
307,1,16,true,4,11,7,41.92077,-87.66373
TA1309000030,1,16,true,49,70,21,41.92077,-87.66372
13292,1,16,true,14,23,9,41.92152,-87.70733
TA1309000033,1,16,true,61,88,27,41.92158,-87.65381
13193,1,16,true,97,130,33,41.92182,-87.64412
144,1,16,true,16,20,4,41.92182,-87.64411
143,1,16,true,11,4,-7,41.92217,-87.63891
13191,1,16,true,67,67,0,41.92217,-87.63891
327,1,16,true,9,13,4,41.92225,-87.65783
13084,1,16,true,35,39,4,41.92268,-87.69715
LP-,1,16,true,38,47,9,41.92396,-87.63584
KA1504000140,1,16,true,23,16,-7,41.92409,-87.67646
15648,1,16,true,19,16,-3,41.92464,-87.68931
TA1307000001,1,16,true,70,60,-10,41.92535,-87.66581
TA1306000026,1,16,true,92,65,-27,41.92558,-87.65842
87,1,16,true,11,9,-2,41.92559,-87.65843
TA1306000016,1,16,true,104,68,-36,41.9256,-87.65371
67,1,16,true,17,13,-4,41.9256,-87.65371
313,1,16,true,19,18,-1,41.9257,-87.64246
TA1309000019,1,16,true,120,125,5,41.92586,-87.63897
TA1309000058,1,16,true,110,134,24,41.92591,-87.64927
127,1,16,true,13,30,17,41.92592,-87.64927
TA1308000001,1,16,true,165,132,-33,41.92627,-87.63086
177,1,16,true,28,25,-3,41.92627,-87.63086
15646,1,16,true,12,18,6,41.92668,-87.6977
34,1,16,true,10,2,-8,41.92675,-87.63444
13124,1,16,true,34,36,2,41.92675,-87.63444
302,1,16,true,10,7,-3,41.92859,-87.65421
TA1309000023,1,16,true,45,61,16,41.9287,-87.65383
TA1307000113,1,16,true,35,38,3,41.92878,-87.66391
190,1,16,true,12,3,-9,41.92878,-87.6639
13296,1,16,true,23,34,11,41.92883,-87.66852
TA1309000059,1,16,true,44,33,-11,41.92889,-87.65898
349,1,16,true,16,13,-3,41.92915,-87.6491
TA1309000061,1,16,true,60,61,1,41.92915,-87.64909
TA1308000031,1,16,true,22,30,8,41.92946,-87.68417
TA1305000014,1,16,true,115,97,-18,41.92956,-87.64313
340,1,16,true,21,16,-5,41.92956,-87.64313
260,1,16,true,12,4,-8,41.92958,-87.70791
13085,1,16,true,22,38,16,41.92958,-87.70789
TA1307000142,1,16,true,109,116,7,41.93125,-87.64432
220,1,16,true,23,23,0,41.93125,-87.64431
13276,1,16,true,70,85,15,41.93132,-87.63874
324,1,16,true,16,16,0,41.93173,-87.64179
15645,1,16,true,5,10,5,41.93191,-87.70121
13271,1,16,true,29,38,9,41.93192,-87.67784
152,1,16,true,14,8,-6,41.93221,-87.65864
TA1307000064,1,16,true,59,65,6,41.93222,-87.65864
13,1,16,true,14,12,-2,41.93242,-87.65271
TA1306000014,1,16,true,59,102,43,41.93242,-87.65271
329,1,16,true,16,11,-5,41.93258,-87.63642
TA1309000039,1,16,true,108,116,8,41.93258,-87.63642
13294,1,16,true,25,46,21,41.9326,-87.66595
332,1,16,true,5,13,8,41.93313,-87.64776
TA1309000036,1,16,true,48,79,31,41.93313,-87.64776
15644,1,16,true,4,10,6,41.93534,-87.71687
TA1307000006,1,16,true,48,50,2,41.93571,-87.6636
153,1,16,true,11,5,-6,41.93575,-87.66364
13268,1,16,true,16,23,7,41.93588,-87.67843
250,1,16,true,7,11,4,41.93609,-87.66984
13269,1,16,true,38,49,11,41.93609,-87.66983
TA1307000052,1,16,true,103,58,-45,41.93628,-87.65266
115,1,16,true,22,16,-6,41.93628,-87.65266
156,1,16,true,17,11,-6,41.9365,-87.64756
TA1307000136,1,16,true,94,108,14,41.9365,-87.64755
TA1307000041,1,16,true,112,102,-10,41.93669,-87.63683
157,1,16,true,17,29,12,41.9367,-87.63683
13137,1,16,true,117,149,32,41.9376,-87.6441
300,1,16,true,19,44,25,41.93761,-87.6441
15642,1,16,true,16,16,0,41.93843,-87.69801
154,1,16,true,10,7,-3,41.93912,-87.66384
KA17018068,1,16,true,24,18,-6,41.93935,-87.68327
TA1309000042,1,16,true,40,50,10,41.93937,-87.66836
131,1,16,true,9,15,6,41.93937,-87.66835
13229,1,16,true,30,45,15,41.93946,-87.66376
TA1308000019,1,16,true,44,48,4,41.93973,-87.65886
296,1,16,true,15,23,8,41.9401,-87.64546
13277,1,16,true,66,81,15,41.9401,-87.64546
TA1307000134,1,16,true,108,91,-17,41.94016,-87.65303
117,1,16,true,33,18,-15,41.94016,-87.65302
13143,1,16,true,11,21,10,41.94059,-87.67853
334,1,16,true,11,21,10,41.94076,-87.63919
TA1309000049,1,16,true,79,94,15,41.94077,-87.63919
15634,1,16,true,11,5,-6,41.94304,-87.68729
TA1307000138,1,16,true,70,51,-19,41.94334,-87.67094
230,1,16,true,14,17,3,41.94335,-87.67093
13144,1,16,true,22,19,-3,41.9434,-87.67964
299,1,16,true,14,14,0,41.94368,-87.64894
TA1309000025,1,16,true,85,101,16,41.94368,-87.64894
229,1,16,true,18,18,0,41.94372,-87.66401
13071,1,16,true,101,93,-8,41.94373,-87.66401
632,1,16,true,71,90,19,41.94453,-87.6547
303,1,16,true,20,26,6,41.94522,-87.64702
15631,1,16,true,10,8,-2,41.94524,-87.70665
13278,1,16,true,107,94,-13,41.94553,-87.64644
TA1309000050,1,16,true,13,16,3,41.94618,-87.67331
15632,1,16,true,30,7,-23,41.94664,-87.69463
KA1504000143,1,16,true,11,8,-3,41.94664,-87.68337
227,1,16,true,13,11,-2,41.94813,-87.66397
13235,1,16,true,79,80,1,41.94814,-87.66396
304,1,16,true,23,37,14,41.94878,-87.64922
13253,1,16,true,28,33,5,41.9488,-87.67527
13325,1,16,true,105,112,7,41.94907,-87.64863
114,1,16,true,7,11,4,41.94935,-87.65451
TA1307000126,1,16,true,72,78,6,41.94936,-87.65451
232,1,16,true,12,24,12,41.94943,-87.64645
TA1307000150,1,16,true,82,114,32,41.94945,-87.64646
13319,1,16,true,30,43,13,41.95069,-87.6687
TA1307000127,1,16,true,50,48,-2,41.9508,-87.65918
165,1,16,true,12,12,0,41.95081,-87.65918
15628,1,16,true,24,8,-16,41.95216,-87.69806
256,1,16,true,15,8,-7,41.95282,-87.65
13323,1,16,true,47,54,7,41.95282,-87.65
KA1504000096,1,16,true,5,11,6,41.95361,-87.70932
590,1,16,true,10,2,-8,41.95374,-87.74056
TA1309000043,1,16,true,51,44,-7,41.95417,-87.66434
13063,1,16,true,58,57,-1,41.95424,-87.65441
240,1,16,true,11,16,5,41.95424,-87.65441
KA1504000158,1,16,true,17,31,14,41.95432,-87.68607
254,1,16,true,15,18,3,41.95438,-87.64806
TA1308000022,1,16,true,71,107,36,41.95438,-87.64805
TA1307000149,1,16,true,33,30,-3,41.95467,-87.67392
TA1309000026,1,16,true,27,48,21,41.95601,-87.6802
13249,1,16,true,11,11,0,41.95606,-87.66885
312,1,16,true,17,19,2,41.95637,-87.6563
TA1308000047,1,16,true,12,14,2,41.95709,-87.6642
13379,1,16,true,64,89,25,41.95786,-87.6495
TA1309000018,1,16,true,33,22,-11,41.95791,-87.67357
306,1,16,true,7,10,3,41.9585,-87.655
TA1309000027,1,16,true,39,48,9,41.9585,-87.65499
13389,1,16,true,70,65,-5,41.961,-87.64958
245,1,16,true,15,6,-9,41.96101,-87.64958
15621,1,16,true,21,22,1,41.96103,-87.70586
15622,1,16,true,6,16,10,41.96108,-87.69544
TA1307000144,1,16,true,30,20,-10,41.96142,-87.6762
TA1309000021,1,16,true,10,12,2,41.9615,-87.6714
15623,1,16,true,18,22,4,41.96154,-87.69117
KA1503000022,1,16,true,35,21,-14,41.96158,-87.66609
231,1,16,true,6,21,15,41.96163,-87.65464
TA1307000107,1,16,true,78,91,13,41.96164,-87.65464
TA1307000156,1,16,true,29,36,7,41.96301,-87.68479
TA1309000012,1,16,true,32,20,-12,41.96325,-87.67928
TA1308000012,1,16,true,81,64,-17,41.96398,-87.63818
249,1,16,true,15,13,-2,41.96398,-87.63818
13074,1,16,true,48,32,-16,41.96521,-87.6582
639,1,16,true,48,41,-7,41.96584,-87.64538
KA1504000093,1,16,true,13,52,39,41.96587,-87.69365
TA1307000140,1,16,true,22,36,14,41.96643,-87.68865
326,1,16,true,10,6,-4,41.96665,-87.67113
KA1504000126,1,16,true,10,5,-5,41.96668,-87.70807
TA1309000014,1,16,true,57,48,-9,41.96709,-87.66744
TA1307000158,1,16,true,36,28,-8,41.9671,-87.67904
251,1,16,true,11,5,-6,41.96796,-87.65
TA1307000119,1,16,true,36,38,2,41.96796,-87.65
15615,1,16,true,12,5,-7,41.96835,-87.71183
TA1308000021,1,16,true,25,28,3,41.96883,-87.65765
KA1504000080,1,16,true,19,28,9,41.96887,-87.69609
TA1309000066,1,16,true,67,55,-12,41.9691,-87.67423
344,1,16,true,13,12,-1,41.9691,-87.67423
TA1309000041,1,16,true,39,17,-22,41.96951,-87.65471
465,1,16,true,6,12,6,41.97161,-87.65016
KA1504000171,1,16,true,50,58,8,41.97161,-87.65016
325,1,16,true,5,11,6,41.9728,-87.67186
TA1309000035,1,16,true,57,64,7,41.97335,-87.66785
13108,1,16,true,40,48,8,41.97379,-87.65971
KA1504000078,1,16,true,9,10,1,41.97491,-87.69258
KA1504000149,1,16,true,20,18,-2,41.97562,-87.67945
KA1504000160,1,16,true,19,7,-12,41.97564,-87.70143
KA1504000146,1,16,true,35,35,0,41.978,-87.66805
294,1,16,true,11,13,2,41.97835,-87.65976
13109,1,16,true,37,40,3,41.97835,-87.65976
KA1504000147,1,16,true,14,17,3,41.97976,-87.67754
655,1,16,true,14,11,-3,41.97987,-87.68194
460,1,16,true,6,13,7,41.98358,-87.66916
KA1504000151,1,16,true,47,37,-10,41.98359,-87.66916
459,1,16,true,17,17,0,41.98403,-87.65231
KA1504000152,1,16,true,102,119,17,41.98403,-87.65231
15578,1,16,true,31,30,-1,41.98405,-87.66027
461,1,16,true,6,11,5,41.98405,-87.66027
15575,1,16,true,47,32,-15,41.98975,-87.66014
KA1504000148,1,16,true,11,11,0,41.99086,-87.66971
15571,1,16,true,31,30,-1,41.99478,-87.66028
454,1,16,true,12,6,-6,41.99478,-87.66027
KA1504000156,1,16,true,11,9,-2,41.99925,-87.67137
RP-009,1,16,true,27,19,-8,42.00107,-87.66122
660,1,16,true,20,32,12,42.00458,-87.66143
KA1504000175,1,16,true,18,46,28,42.00797,-87.66549
RP-005,1,16,true,10,2,-8,42.0086,-87.69047
KA1504000162,1,16,true,25,12,-13,42.00907,-87.67422
KA1504000159,1,16,true,3,16,13,42.01059,-87.66241
525,1,16,true,8,10,2,42.01272,-87.66605
517,1,16,true,10,4,-6,42.01597,-87.675
520,1,16,true,22,31,9,42.01597,-87.66859
515,1,16,true,15,13,-2,42.01915,-87.67356
523,1,16,true,24,24,0,42.02089,-87.66505
E002,1,16,true,14,43,29,42.03256,-87.67912
599,1,16,true,16,1,-15,42.03972,-87.69942
596,1,16,true,39,35,-4,42.04822,-87.68348
E008,1,16,true,21,19,-2,42.05049,-87.67782
605,1,16,true,23,12,-11,42.05294,-87.67342
604,1,16,true,39,18,-21,42.05824,-87.67744
E007,1,16,true,13,3,-10,42.06431,-87.68615
E014,1,16,true,2,15,13,42.06483,-87.71531
KA1503000014,2,8,false,10,17,7,41.7851,-87.60108
TA1309000011,2,8,false,4,15,11,41.78873,-87.60131
KA1503000071,2,8,false,8,23,15,41.79148,-87.59988
TA1309000063,2,8,false,11,7,-4,41.79325,-87.5878
TA1308000009,2,8,false,18,10,-8,41.79522,-87.58075
KA1503000052,2,8,false,10,4,-6,41.79935,-87.60097
KA1503000059,2,8,false,14,7,-7,41.79952,-87.58643
TA1309000037,2,8,false,15,6,-9,41.79957,-87.59474
KA1503000007,2,8,false,16,7,-9,41.80242,-87.58689
KA1503000038,2,8,false,12,4,-8,41.83845,-87.6354
TA1307000048,2,8,false,19,10,-9,41.83855,-87.60821
15443,2,8,false,11,1,-10,41.84275,-87.63549
TA1305000004,2,8,false,16,14,-2,41.8514,-87.61884
15545,2,8,false,10,10,0,41.85627,-87.61334
13135,2,8,false,10,2,-8,41.85753,-87.66157
13102,2,8,false,15,2,-13,41.85762,-87.61942
13150,2,8,false,15,9,-6,41.85783,-87.62455
13163,2,8,false,10,6,-4,41.85808,-87.65108
13164,2,8,false,10,3,-7,41.85818,-87.65648
SL-012,2,8,false,23,9,-14,41.86038,-87.62581
TA1307000124,2,8,false,12,15,3,41.86411,-87.62372
TA1305000002,2,8,false,40,14,-26,41.86721,-87.62597
15544,2,8,false,9,16,7,41.86723,-87.61536
SL-005,2,8,false,40,20,-20,41.8679,-87.62304
15550,2,8,false,10,10,0,41.87024,-87.63947
TA1309000010,2,8,false,23,10,-13,41.87074,-87.62574
TA1309000064,2,8,false,7,18,11,41.87127,-87.67369
TA1307000121,2,8,false,3,10,7,41.87184,-87.64664
SL-008,2,8,false,34,11,-23,41.87209,-87.62956
13332,2,8,false,16,1,-15,41.87219,-87.6615
SL-011,2,8,false,21,11,-10,41.87256,-87.63356
623,2,8,false,44,24,-20,41.87272,-87.62399
KA1504000104,2,8,false,13,10,-3,41.87296,-87.66912
SL-007,2,8,false,16,10,-6,41.87404,-87.6277
13028,2,8,false,14,8,-6,41.87475,-87.64981
SL-010,2,8,false,6,26,20,41.87501,-87.63309
15541,2,8,false,15,2,-13,41.8758,-87.62086
TA1305000009,2,8,false,13,13,0,41.87593,-87.63068
TA1305000010,2,8,false,13,7,-6,41.87623,-87.62444
624,2,8,false,14,4,-10,41.87626,-87.62923
TA1305000035,2,8,false,15,17,2,41.87716,-87.62787
13138,2,8,false,8,15,7,41.87723,-87.63941
15539,2,8,false,22,12,-10,41.87763,-87.64405
13158,2,8,false,13,39,26,41.87764,-87.64957
13157,2,8,false,10,9,-1,41.87773,-87.6548
TA1305000025,2,8,false,27,65,38,41.87773,-87.63528
TA1309000002,2,8,false,13,13,0,41.87784,-87.62408
TA1309000004,2,8,false,8,50,42,41.87811,-87.63184
638,2,8,false,8,22,14,41.87827,-87.64078
TA1305000005,2,8,false,7,37,30,41.87924,-87.62975
13011,2,8,false,44,65,21,41.87931,-87.63993
TA1309000008,2,8,false,6,19,13,41.87933,-87.6355
KA1503000034,2,8,false,7,29,22,41.87938,-87.63197
KA1503000015,2,8,false,4,19,15,41.87948,-87.6257
287,2,8,false,1,11,10,41.88017,-87.63527
TA1309000007,2,8,false,9,73,64,41.88022,-87.63526
WL-011,2,8,false,11,16,5,41.88034,-87.64273
13156,2,8,false,11,9,-2,41.88042,-87.65554
13300,2,8,false,27,22,-5,41.88097,-87.61675
13008,2,8,false,32,33,1,41.88105,-87.62408
TA1305000006,2,8,false,9,70,61,41.88122,-87.6296
13056,2,8,false,15,33,18,41.88168,-87.63951
TA1307000120,2,8,false,27,26,-1,41.88188,-87.64879
13341,2,8,false,36,35,-1,41.88208,-87.63985
13036,2,8,false,10,28,18,41.8821,-87.62513
TA1305000032,2,8,false,40,57,17,41.88218,-87.64109
13006,2,8,false,8,20,12,41.88268,-87.63252
13353,2,8,false,20,10,-10,41.88283,-87.6612
654,2,8,false,13,12,-1,41.88307,-87.65698
13409,2,8,false,23,18,-5,41.8831,-87.6511
18,2,8,false,1,16,15,41.88317,-87.63735
KA1503000072,2,8,false,24,44,20,41.88317,-87.63693
WL-012,2,8,false,35,54,19,41.88337,-87.6412
13053,2,8,false,28,20,-8,41.88365,-87.64863
13001,2,8,false,31,32,1,41.88397,-87.62459
13155,2,8,false,15,12,-3,41.88407,-87.65689
18062,2,8,false,21,34,13,41.88412,-87.65427
81,2,8,false,4,12,8,41.88417,-87.6296
TA1306000010,2,8,false,13,31,18,41.88419,-87.62961
TA1305000030,2,8,false,34,88,54,41.88459,-87.63178
15535,2,8,false,13,17,4,41.8846,-87.64455
TA1305000029,2,8,false,16,16,0,41.88466,-87.62787
13263,2,8,false,26,24,-2,41.88467,-87.61952
TA1306000015,2,8,false,19,63,44,41.88549,-87.65232
66,2,8,false,2,14,12,41.88557,-87.64186
13021,2,8,false,38,55,17,41.88559,-87.64184
TA1307000111,2,8,false,22,50,28,41.88582,-87.63548
164,2,8,false,1,14,13,41.88583,-87.63547
KA17018054,2,8,false,1,22,21,41.88595,-87.67701
KA1503000012,2,8,false,18,45,27,41.88599,-87.63089
TA1305000011,2,8,false,36,66,30,41.886,-87.62418
15534,2,8,false,20,18,-2,41.88627,-87.61749
13197,2,8,false,10,22,12,41.8866,-87.65816
TA1308000029,2,8,false,33,11,-22,41.88673,-87.62225
TA1307000131,2,8,false,27,16,-11,41.88688,-87.62606
KA1503000064,2,8,false,13,16,3,41.88697,-87.61281
TA1305000022,2,8,false,31,50,19,41.88817,-87.63656
TA1306000003,2,8,false,40,24,-16,41.88867,-87.64442
KA1503000043,2,8,false,66,52,-14,41.88918,-87.63851
133,2,8,false,15,9,-6,41.88918,-87.63851
13050,2,8,false,21,55,34,41.88919,-87.62775
13432,2,8,false,7,12,5,41.88989,-87.67149
TA1307000151,2,8,false,43,76,33,41.88993,-87.63427
212,2,8,false,8,17,9,41.88995,-87.63427
636,2,8,false,12,28,16,41.88997,-87.63662
KA1503000044,2,8,false,20,35,15,41.89018,-87.6262
13427,2,8,false,24,27,3,41.89054,-87.62205
13430,2,8,false,25,39,14,41.89077,-87.63169
TA1306000013,2,8,false,31,27,-4,41.89083,-87.61852
RN-,2,8,false,30,36,6,41.89102,-87.63546
199,2,8,false,8,11,3,41.89143,-87.62676
TA1307000117,2,8,false,44,53,9,41.89144,-87.62675
13033,2,8,false,22,39,17,41.8916,-87.64835
13194,2,8,false,17,6,-11,41.8918,-87.65878
TA1305000003,2,8,false,32,32,0,41.89187,-87.62061
13022,2,8,false,38,36,-2,41.89227,-87.61205
TA1306000029,2,8,false,28,17,-11,41.89256,-87.61449
13265,2,8,false,38,31,-7,41.89383,-87.64172
13045,2,8,false,42,29,-13,41.89403,-87.62931
13016,2,8,false,38,47,9,41.89431,-87.62277
211,2,8,false,3,14,11,41.89439,-87.62267
KA1503000041,2,8,false,61,29,-32,41.89452,-87.61798
13196,2,8,false,27,10,-17,41.89455,-87.65345
TA1307000062,2,8,false,33,30,-3,41.89466,-87.63839
TA1306000012,2,8,false,46,60,14,41.89475,-87.63438
KP1705001026,2,8,false,25,16,-9,41.89483,-87.6323
637,2,8,false,14,3,-11,41.89563,-87.67209
13132,2,8,false,11,7,-4,41.89573,-87.67718
15530,2,8,false,31,21,-10,41.89575,-87.62596
18003,2,8,false,12,15,3,41.89575,-87.62011
13247,2,8,false,6,10,4,41.89597,-87.66775
TA1305000020,2,8,false,24,16,-8,41.89636,-87.65406
13289,2,8,false,16,4,-12,41.89638,-87.661
13303,2,8,false,12,12,0,41.89672,-87.63088
13017,2,8,false,39,17,-22,41.89676,-87.6357
13338,2,8,false,32,26,-6,41.89697,-87.62173
TA1307000061,2,8,false,22,15,-7,41.89745,-87.62873
13034,2,8,false,23,9,-14,41.89754,-87.62352
TA1306000009,2,8,false,26,43,17,41.89772,-87.64299
620,2,8,false,24,8,-16,41.89817,-87.63754
KA1504000103,2,8,false,15,3,-12,41.89842,-87.68659
15529,2,8,false,20,13,-7,41.89858,-87.62206
TA1307000128,2,8,false,39,33,-6,41.89896,-87.6299
657,2,8,false,15,6,-9,41.89918,-87.6722
KA1504000117,2,8,false,12,5,-7,41.89936,-87.64848
13248,2,8,false,14,5,-9,41.89964,-87.66788
TA1306000011,2,8,false,32,6,-26,41.89994,-87.63443
KA1504000116,2,8,false,15,8,-7,41.90023,-87.64299
13290,2,8,false,8,13,5,41.90069,-87.66259
13042,2,8,false,61,63,2,41.90097,-87.62377
TA1307000070,2,8,false,12,4,-8,41.90133,-87.67742
KA1504000133,2,8,false,12,15,3,41.90234,-87.62773
13241,2,8,false,12,2,-10,41.9029,-87.68731
176,2,8,false,13,2,-11,41.90291,-87.63141
TA1306000006,2,8,false,12,2,-10,41.90292,-87.63772
TA1307000039,2,8,false,65,24,-41,41.90294,-87.63137
658,2,8,false,14,8,-6,41.903,-87.6838
TA1305000034,2,8,false,17,15,-2,41.90313,-87.67391
KA1504000135,2,8,false,31,22,-9,41.90319,-87.63439
13136,2,8,false,9,14,5,41.90326,-87.67845
13061,2,8,false,45,38,-7,41.90342,-87.66779
KA1504000079,2,8,false,21,5,-16,41.9035,-87.64334
TA1307000115,2,8,false,17,6,-11,41.9046,-87.64056
TA1308000049,2,8,false,25,23,-2,41.90672,-87.6349
KA1504000134,2,8,false,34,25,-9,41.90687,-87.6262
13224,2,8,false,17,9,-8,41.90706,-87.66725
TA1307000143,2,8,false,12,6,-6,41.90762,-87.63854
13221,2,8,false,7,17,10,41.90765,-87.67254
TA1309000024,2,8,false,9,10,1,41.908,-87.63152
TA1305000041,2,8,false,17,28,11,41.9094,-87.67769
331,2,8,false,30,35,5,41.90965,-87.64812
TA1305000037,2,8,false,15,8,-7,41.91018,-87.67003
TA1306000008,2,8,false,16,8,-8,41.9102,-87.6435
13257,2,8,false,21,5,-16,41.91054,-87.68956
13154,2,8,false,14,11,-3,41.91054,-87.65312
13058,2,8,false,21,21,0,41.91059,-87.64942
TA1307000038,2,8,false,20,20,0,41.91138,-87.63868
LF-005,2,8,false,43,32,-11,41.91172,-87.62681
13128,2,8,false,17,13,-4,41.91197,-87.63197
TA1308000050,2,8,false,42,39,-3,41.91211,-87.6347
TA1306000032,2,8,false,9,12,3,41.9137,-87.65285
TA1307000166,2,8,false,10,7,-3,41.91386,-87.64877
TA1306000007,2,8,false,11,5,-6,41.91469,-87.64333
13068,2,8,false,10,6,-4,41.91554,-87.68703
13179,2,8,false,23,18,-5,41.9157,-87.63461
13133,2,8,false,10,10,0,41.91598,-87.67733
TA1305000039,2,8,false,21,11,-10,41.9163,-87.66749
15651,2,8,false,10,3,-7,41.91752,-87.70181
TA1309000006,2,8,false,13,8,-5,41.91809,-87.64375
TA1307000163,2,8,false,12,14,2,41.91821,-87.65696
94,2,8,false,1,11,10,41.91831,-87.6363
13146,2,8,false,16,35,19,41.91831,-87.63629
13059,2,8,false,27,22,-5,41.91845,-87.65222
13192,2,8,false,7,15,8,41.91995,-87.64884
13288,2,8,false,10,6,-4,41.92008,-87.67788
TA1309000030,2,8,false,8,20,12,41.92077,-87.66372
13292,2,8,false,13,4,-9,41.92152,-87.70733
TA1309000033,2,8,false,21,12,-9,41.92158,-87.65381
13193,2,8,false,34,25,-9,41.92182,-87.64412
13191,2,8,false,23,17,-6,41.92217,-87.63891
13084,2,8,false,10,12,2,41.92268,-87.69715
LP-,2,8,false,15,5,-10,41.92396,-87.63584
TA1307000001,2,8,false,16,22,6,41.92535,-87.66581
TA1306000026,2,8,false,18,15,-3,41.92558,-87.65842
TA1306000016,2,8,false,13,40,27,41.9256,-87.65371
TA1309000019,2,8,false,37,20,-17,41.92586,-87.63897
TA1309000058,2,8,false,44,28,-16,41.92591,-87.64927
TA1308000001,2,8,false,31,20,-11,41.92627,-87.63086
TA1309000023,2,8,false,18,9,-9,41.9287,-87.65383
TA1307000113,2,8,false,15,16,1,41.92878,-87.66391
13296,2,8,false,18,3,-15,41.92883,-87.66852
TA1309000059,2,8,false,13,11,-2,41.92889,-87.65898
TA1309000061,2,8,false,28,10,-18,41.92915,-87.64909
TA1305000014,2,8,false,23,25,2,41.92956,-87.64313
13085,2,8,false,16,12,-4,41.92958,-87.70789
TA1307000142,2,8,false,41,18,-23,41.93125,-87.64432
13276,2,8,false,16,23,7,41.93132,-87.63874
15645,2,8,false,12,6,-6,41.93191,-87.70121
TA1307000064,2,8,false,31,22,-9,41.93222,-87.65864
TA1306000014,2,8,false,25,18,-7,41.93242,-87.65271
TA1309000039,2,8,false,23,16,-7,41.93258,-87.63642
13294,2,8,false,10,5,-5,41.9326,-87.66595
TA1309000036,2,8,false,18,6,-12,41.93313,-87.64776
TA1307000006,2,8,false,8,22,14,41.93571,-87.6636
TA1307000052,2,8,false,20,19,-1,41.93628,-87.65266
TA1307000136,2,8,false,16,16,0,41.9365,-87.64755
TA1307000041,2,8,false,25,18,-7,41.93669,-87.63683
13137,2,8,false,27,28,1,41.9376,-87.6441
TA1309000042,2,8,false,8,11,3,41.93937,-87.66836
13229,2,8,false,11,19,8,41.93946,-87.66376
TA1308000019,2,8,false,13,7,-6,41.93973,-87.65886
13277,2,8,false,18,7,-11,41.9401,-87.64546
TA1307000134,2,8,false,22,26,4,41.94016,-87.65303
TA1309000049,2,8,false,24,23,-1,41.94077,-87.63919
TA1309000025,2,8,false,15,10,-5,41.94368,-87.64894
13071,2,8,false,10,19,9,41.94373,-87.66401
632,2,8,false,16,12,-4,41.94453,-87.6547
13278,2,8,false,25,16,-9,41.94553,-87.64644
13235,2,8,false,13,14,1,41.94814,-87.66396
13325,2,8,false,28,8,-20,41.94907,-87.64863
TA1307000126,2,8,false,16,13,-3,41.94936,-87.65451
TA1307000150,2,8,false,24,17,-7,41.94945,-87.64646
13323,2,8,false,20,24,4,41.95282,-87.65
13063,2,8,false,18,13,-5,41.95424,-87.65441
TA1308000022,2,8,false,22,13,-9,41.95438,-87.64805
13249,2,8,false,5,13,8,41.95606,-87.66885
TA1308000047,2,8,false,10,2,-8,41.95709,-87.6642
13379,2,8,false,8,10,2,41.95786,-87.6495
TA1309000027,2,8,false,21,10,-11,41.9585,-87.65499
13389,2,8,false,16,10,-6,41.961,-87.64958
TA1307000144,2,8,false,2,11,9,41.96142,-87.6762
TA1307000107,2,8,false,14,10,-4,41.96164,-87.65464
13074,2,8,false,14,7,-7,41.96521,-87.6582
639,2,8,false,12,4,-8,41.96584,-87.64538
TA1309000014,2,8,false,16,7,-9,41.96709,-87.66744
TA1309000066,2,8,false,12,17,5,41.9691,-87.67423
TA1309000035,2,8,false,12,11,-1,41.97335,-87.66785
13108,2,8,false,15,2,-13,41.97379,-87.65971
KA1504000146,2,8,false,12,7,-5,41.978,-87.66805
13109,2,8,false,6,13,7,41.97835,-87.65976
KA1504000152,2,8,false,13,13,0,41.98403,-87.65231
15571,2,8,false,14,5,-9,41.99478,-87.66028
596,2,8,false,12,10,-2,42.04822,-87.68348
604,2,8,false,3,17,14,42.05824,-87.67744
KA1503000014,2,8,true,63,37,-26,41.7851,-87.60108
426,2,8,true,12,2,-10,41.7851,-87.60108
KA1503000070,2,8,true,27,14,-13,41.78794,-87.58831
TA1309000011,2,8,true,5,59,54,41.78873,-87.60131
423,2,8,true,3,10,7,41.79148,-87.59988
KA1503000071,2,8,true,12,104,92,41.79148,-87.59988
KA1503000074,2,8,true,14,6,-8,41.79174,-87.58395
TA1309000063,2,8,true,41,13,-28,41.79325,-87.5878
420,2,8,true,7,11,4,41.79429,-87.60145
KA1504000076,2,8,true,37,83,46,41.7943,-87.60145
TA1308000009,2,8,true,49,9,-40,41.79522,-87.58075
TA1307000164,2,8,true,18,19,1,41.79527,-87.59647
KA1503000052,2,8,true,31,17,-14,41.79935,-87.60097
KA1503000059,2,8,true,25,11,-14,41.79952,-87.58643
TA1309000037,2,8,true,61,12,-49,41.79957,-87.59474
KA1503000007,2,8,true,38,24,-14,41.80242,-87.58689
13398,2,8,true,28,12,-16,41.80256,-87.59035
KA1503000027,2,8,true,4,18,14,41.81666,-87.61942
KA1503000068,2,8,true,24,4,-20,41.82878,-87.68062
TA1308000045,2,8,true,14,5,-9,41.83062,-87.64129
TA1307000129,2,8,true,5,103,98,41.83104,-87.62683
13345,2,8,true,19,3,-16,41.83138,-87.61803
13216,2,8,true,16,65,49,41.83473,-87.62581
13217,2,8,true,19,3,-16,41.83488,-87.61792
13215,2,8,true,28,4,-24,41.83634,-87.6135
TA1308000046,2,8,true,23,5,-18,41.83779,-87.65115
TA1309000055,2,8,true,18,7,-11,41.8382,-87.64514
KA1503000038,2,8,true,4,13,9,41.83845,-87.6354
TA1307000048,2,8,true,20,21,1,41.83855,-87.60821
TA1308000036,2,8,true,21,11,-10,41.83883,-87.62186
TA1307000139,2,8,true,38,13,-25,41.84205,-87.61698
TA1307000153,2,8,true,17,1,-16,41.84358,-87.64538
147,2,8,true,1,13,12,41.84569,-87.62251
TA1307000005,2,8,true,26,53,27,41.84569,-87.6225
15689,2,8,true,32,3,-29,41.84912,-87.69515
TA1305000004,2,8,true,15,3,-12,41.8514,-87.61884
13075,2,8,true,4,14,10,41.8531,-87.63192
13096,2,8,true,7,23,16,41.8538,-87.69577
15546,2,8,true,27,5,-22,41.85416,-87.61916
13307,2,8,true,14,3,-11,41.85489,-87.66359
13089,2,8,true,9,20,11,41.85497,-87.67567
13331,2,8,true,20,4,-16,41.85515,-87.65414
15545,2,8,true,33,32,-1,41.85627,-87.61334
SL-013,2,8,true,14,5,-9,41.85659,-87.62755
13135,2,8,true,36,10,-26,41.85753,-87.66157
338,2,8,true,17,3,-14,41.85758,-87.61956
13102,2,8,true,86,21,-65,41.85762,-87.61942
13150,2,8,true,74,21,-53,41.85783,-87.62455
273,2,8,true,15,7,-8,41.85783,-87.62455
13099,2,8,true,26,6,-20,41.85784,-87.64627
TA1307000159,2,8,true,24,7,-17,41.8579,-87.6687
13163,2,8,true,34,14,-20,41.85808,-87.65108
13164,2,8,true,52,5,-47,41.85818,-87.65648
15,2,8,true,13,2,-11,41.85819,-87.65648
SL-012,2,8,true,114,14,-100,41.86038,-87.62581
72,2,8,true,21,2,-19,41.86039,-87.62581
13304,2,8,true,15,7,-8,41.86126,-87.65659
KA1504000109,2,8,true,4,21,17,41.86192,-87.69347
TA1306000002,2,8,true,43,20,-23,41.86238,-87.65108
TA1307000124,2,8,true,106,44,-62,41.86411,-87.62372
168,2,8,true,29,11,-18,41.86415,-87.62372
TA1309000001,2,8,true,35,23,-12,41.86488,-87.64708
13354,2,8,true,3,18,15,41.86524,-87.66651
13431,2,8,true,26,30,4,41.8661,-87.60728
WL-008,2,8,true,12,11,-1,41.86712,-87.64108
TA1305000002,2,8,true,136,82,-54,41.86721,-87.62597
59,2,8,true,12,27,15,41.86721,-87.62597
15544,2,8,true,24,29,5,41.86723,-87.61536
TA1305000017,2,8,true,20,32,12,41.86734,-87.64863
KA1706005007,2,8,true,18,9,-9,41.86749,-87.63219
SL-005,2,8,true,164,36,-128,41.8679,-87.62304
255,2,8,true,17,2,-15,41.86791,-87.62304
644,2,8,true,24,5,-19,41.86859,-87.68625
13139,2,8,true,19,10,-9,41.86893,-87.65913
13285,2,8,true,16,119,103,41.86928,-87.67372
13160,2,8,true,40,17,-23,41.86947,-87.65548
22,2,8,true,10,3,-7,41.86947,-87.65548
15550,2,8,true,33,36,3,41.87024,-87.63947
TA1309000010,2,8,true,91,51,-40,41.87074,-87.62574
SL-009,2,8,true,70,12,-58,41.87081,-87.63121
342,2,8,true,2,46,44,41.87127,-87.6737
TA1309000064,2,8,true,9,160,151,41.87127,-87.67369
261,2,8,true,6,17,11,41.87151,-87.6699
TA1307000130,2,8,true,42,54,12,41.87178,-87.65103
241,2,8,true,4,11,7,41.8718,-87.65102
108,2,8,true,11,7,-4,41.87183,-87.64664
TA1307000121,2,8,true,25,88,63,41.87184,-87.64664
41,2,8,true,20,8,-12,41.87209,-87.62957
SL-008,2,8,true,131,49,-82,41.87209,-87.62956
13332,2,8,true,109,26,-83,41.87219,-87.6615
175,2,8,true,17,3,-14,41.87255,-87.63359
SL-011,2,8,true,101,18,-83,41.87256,-87.63356
623,2,8,true,73,36,-37,41.87272,-87.62399
KA1504000104,2,8,true,35,210,175,41.87296,-87.66912
383,2,8,true,8,39,31,41.87297,-87.66912
320,2,8,true,24,11,-13,41.87327,-87.66402
SL-007,2,8,true,40,31,-9,41.87404,-87.6277
13326,2,8,true,17,42,25,41.87425,-87.63958
321,2,8,true,10,7,-3,41.87427,-87.63257
TA1306000025,2,8,true,25,25,0,41.87464,-87.65703
15668,2,8,true,17,8,-9,41.87471,-87.68642
13028,2,8,true,25,61,36,41.87475,-87.64981
13081,2,8,true,11,40,29,41.87501,-87.67326
SL-010,2,8,true,74,44,-30,41.87501,-87.63309
15541,2,8,true,13,9,-4,41.8758,-87.62086
13037,2,8,true,12,41,29,41.87588,-87.64078
TA1305000009,2,8,true,49,40,-9,41.87593,-87.63068
317,2,8,true,8,28,20,41.87603,-87.68195
TA1305000010,2,8,true,13,28,15,41.87623,-87.62444
624,2,8,true,54,52,-2,41.87626,-87.62923
TA1305000035,2,8,true,40,87,47,41.87716,-87.62787
13138,2,8,true,81,149,68,41.87723,-87.63941
75,2,8,true,4,10,6,41.87724,-87.63937
631,2,8,true,1,30,29,41.87761,-87.6739
15539,2,8,true,84,103,19,41.87763,-87.64405
13158,2,8,true,134,82,-52,41.87764,-87.64957
134,2,8,true,13,6,-7,41.87764,-87.64954
13157,2,8,true,59,27,-32,41.87773,-87.6548
TA1305000025,2,8,true,87,314,227,41.87773,-87.63528
36,2,8,true,14,34,20,41.87776,-87.63525
TA1309000002,2,8,true,39,46,7,41.87784,-87.62408
13206,2,8,true,48,29,-19,41.87794,-87.66201
283,2,8,true,8,44,36,41.87809,-87.63183
TA1309000004,2,8,true,60,221,161,41.87811,-87.63184
107,2,8,true,12,22,10,41.87822,-87.644
638,2,8,true,159,163,4,41.87827,-87.64078
37,2,8,true,8,44,36,41.87921,-87.62975
TA1305000005,2,8,true,25,215,190,41.87924,-87.62975
286,2,8,true,1,10,9,41.8793,-87.6355
13011,2,8,true,182,190,8,41.87931,-87.63993
TA1309000008,2,8,true,34,86,52,41.87933,-87.6355
192,2,8,true,21,30,9,41.87935,-87.63997
KA1503000034,2,8,true,11,175,164,41.87938,-87.63197
40,2,8,true,2,22,20,41.87944,-87.63197
39,2,8,true,6,18,12,41.87948,-87.62571
KA1503000015,2,8,true,68,131,63,41.87948,-87.6257
287,2,8,true,4,53,49,41.88017,-87.63527
TA1309000007,2,8,true,37,320,283,41.88022,-87.63526
WL-011,2,8,true,67,36,-31,41.88034,-87.64273
73,2,8,true,10,6,-4,41.8804,-87.64273
80,2,8,true,22,6,-16,41.88042,-87.65556
13156,2,8,true,106,45,-61,41.88042,-87.65554
13300,2,8,true,17,25,8,41.88097,-87.61675
13008,2,8,true,27,112,85,41.88105,-87.62408
90,2,8,true,5,21,16,41.88107,-87.62409
49,2,8,true,3,89,86,41.88116,-87.62963
TA1305000006,2,8,true,46,404,358,41.88122,-87.6296
13134,2,8,true,9,16,7,41.88138,-87.67493
13056,2,8,true,131,112,-19,41.88168,-87.63951
191,2,8,true,11,9,-2,41.88169,-87.63951
198,2,8,true,25,18,-7,41.88187,-87.6488
TA1307000120,2,8,true,146,86,-60,41.88188,-87.64879
13341,2,8,true,187,168,-19,41.88208,-87.63985
174,2,8,true,10,13,3,41.88208,-87.63984
197,2,8,true,11,24,13,41.88208,-87.62513
13036,2,8,true,55,101,46,41.8821,-87.62513
77,2,8,true,25,16,-9,41.88214,-87.64108
TA1305000032,2,8,true,299,187,-112,41.88218,-87.64109
98,2,8,true,6,39,33,41.88266,-87.63251
13006,2,8,true,22,200,178,41.88268,-87.63252
13353,2,8,true,90,37,-53,41.88283,-87.6612
346,2,8,true,13,5,-8,41.88284,-87.6612
654,2,8,true,35,40,5,41.88307,-87.65698
13409,2,8,true,72,52,-20,41.8831,-87.6511
18,2,8,true,5,28,23,41.88317,-87.63735
KA1503000072,2,8,true,73,165,92,41.88317,-87.63693
91,2,8,true,42,32,-10,41.88336,-87.64122
WL-012,2,8,true,302,256,-46,41.88337,-87.6412
112,2,8,true,4,13,9,41.88362,-87.6486
13053,2,8,true,48,60,12,41.88365,-87.64863
43,2,8,true,12,23,11,41.88396,-87.62455
13001,2,8,true,95,167,72,41.88397,-87.62459
88,2,8,true,13,8,-5,41.88407,-87.65691
13155,2,8,true,37,42,5,41.88407,-87.65689
18062,2,8,true,65,93,28,41.88412,-87.65427
81,2,8,true,17,30,13,41.88417,-87.6296
TA1306000010,2,8,true,84,330,246,41.88419,-87.62961
TA1305000030,2,8,true,76,493,417,41.88459,-87.63178
15535,2,8,true,57,58,1,41.8846,-87.64455
96,2,8,true,5,11,6,41.8846,-87.64455
51,2,8,true,9,61,52,41.88462,-87.63176
TA1305000029,2,8,true,55,102,47,41.88466,-87.62787
195,2,8,true,56,11,-45,41.88466,-87.61952
13263,2,8,true,183,84,-99,41.88467,-87.61952
44,2,8,true,9,23,14,41.88468,-87.62782
TA1306000015,2,8,true,80,194,114,41.88549,-87.65232
71,2,8,true,10,26,16,41.8855,-87.65233
66,2,8,true,11,37,26,41.88557,-87.64186
13021,2,8,true,154,239,85,41.88559,-87.64184
TA1307000111,2,8,true,44,194,150,41.88582,-87.63548
164,2,8,true,4,37,33,41.88583,-87.63547
13073,2,8,true,17,10,-7,41.88592,-87.66717
KA17018054,2,8,true,6,36,30,41.88595,-87.67701
38,2,8,true,9,43,34,41.88599,-87.63089
KA1503000012,2,8,true,86,196,110,41.88599,-87.63089
52,2,8,true,13,42,29,41.886,-87.62421
TA1305000011,2,8,true,90,292,202,41.886,-87.62418
15534,2,8,true,81,38,-43,41.88627,-87.61749
217,2,8,true,4,11,7,41.8866,-87.65821
13197,2,8,true,28,56,28,41.8866,-87.65816
264,2,8,true,8,20,12,41.8867,-87.62224
TA1308000029,2,8,true,95,134,39,41.88673,-87.62225
194,2,8,true,2,21,19,41.88688,-87.62606
TA1307000131,2,8,true,14,112,98,41.88688,-87.62606
KA1503000064,2,8,true,10,32,22,41.88697,-87.61281
100,2,8,true,17,15,-2,41.88814,-87.63657
TA1305000022,2,8,true,82,232,150,41.88817,-87.63656
56,2,8,true,44,15,-29,41.88866,-87.64442
TA1306000003,2,8,true,155,105,-50,41.88867,-87.64442
133,2,8,true,30,49,19,41.88918,-87.63851
KA1503000043,2,8,true,225,298,73,41.88918,-87.63851
13050,2,8,true,72,252,180,41.88919,-87.62775
47,2,8,true,12,33,21,41.88921,-87.62775
15664,2,8,true,43,3,-40,41.8895,-87.68821
285,2,8,true,11,3,-8,41.88989,-87.67149
13432,2,8,true,44,44,0,41.88989,-87.67149
TA1307000151,2,8,true,164,290,126,41.88993,-87.63427
212,2,8,true,13,33,20,41.88995,-87.63427
636,2,8,true,66,179,113,41.88997,-87.63662
125,2,8,true,16,21,5,41.89018,-87.62621
KA1503000044,2,8,true,72,150,78,41.89018,-87.6262
196,2,8,true,31,11,-20,41.89053,-87.62205
13427,2,8,true,92,83,-9,41.89054,-87.62205
26,2,8,true,25,11,-14,41.89057,-87.61798
13430,2,8,true,56,82,26,41.89077,-87.63169
181,2,8,true,4,11,7,41.89077,-87.63168
TA1306000013,2,8,true,98,58,-40,41.89083,-87.61852
RN-,2,8,true,60,100,40,41.89102,-87.63546
672,2,8,true,9,16,7,41.89102,-87.63545
13434,2,8,true,33,13,-20,41.89108,-87.66663
TA1308000006,2,8,true,39,24,-15,41.89128,-87.67686
199,2,8,true,8,19,11,41.89143,-87.62676
TA1307000117,2,8,true,77,118,41,41.89144,-87.62675
13033,2,8,true,85,80,-5,41.8916,-87.64835
84,2,8,true,14,5,-9,41.89161,-87.64833
186,2,8,true,7,10,3,41.8918,-87.65879
13194,2,8,true,66,44,-22,41.8918,-87.65878
TA1305000003,2,8,true,97,117,20,41.89187,-87.62061
24,2,8,true,21,15,-6,41.8919,-87.62063
643,2,8,true,13,6,-7,41.89203,-87.68939
35,2,8,true,19,4,-15,41.89227,-87.61206
13022,2,8,true,96,57,-39,41.89227,-87.61205
99,2,8,true,10,4,-6,41.89255,-87.61449
TA1306000029,2,8,true,68,34,-34,41.89256,-87.61449
13265,2,8,true,95,78,-17,41.89383,-87.64172
74,2,8,true,29,9,-20,41.89384,-87.64173
13045,2,8,true,159,141,-18,41.89403,-87.62931
110,2,8,true,27,26,-1,41.89406,-87.6293
13016,2,8,true,83,278,195,41.89431,-87.62277
211,2,8,true,17,87,70,41.89439,-87.62267
KA1503000041,2,8,true,112,163,51,41.89452,-87.61798
142,2,8,true,21,28,7,41.89453,-87.61806
92,2,8,true,14,15,1,41.89455,-87.65346
13196,2,8,true,67,36,-31,41.89455,-87.65345
TA1307000062,2,8,true,123,147,24,41.89466,-87.63839
111,2,8,true,11,20,9,41.89466,-87.63837
TA1306000012,2,8,true,182,159,-23,41.89475,-87.63438
53,2,8,true,25,32,7,41.89476,-87.63439
627,2,8,true,3,12,9,41.8948,-87.63231
KP1705001026,2,8,true,62,62,0,41.89483,-87.6323
18058,2,8,true,26,8,-18,41.8955,-87.68201
659,2,8,true,14,2,-12,41.8955,-87.68201
637,2,8,true,52,20,-32,41.89563,-87.67209
13132,2,8,true,64,33,-31,41.89573,-87.67718
161,2,8,true,10,19,9,41.89574,-87.62599
15530,2,8,true,114,131,17,41.89575,-87.62596
18003,2,8,true,37,85,48,41.89575,-87.62011
635,2,8,true,4,14,10,41.89576,-87.62012
13247,2,8,true,58,23,-35,41.89597,-87.66775
350,2,8,true,12,5,-7,41.89597,-87.66774
TA1305000020,2,8,true,54,86,32,41.89636,-87.65406
54,2,8,true,8,11,3,41.89637,-87.65407
13289,2,8,true,75,14,-61,41.89638,-87.661
13303,2,8,true,47,41,-6,41.89672,-87.63088
13017,2,8,true,122,103,-19,41.89676,-87.6357
31,2,8,true,18,10,-8,41.89677,-87.63572
13338,2,8,true,98,141,43,41.89697,-87.62173
173,2,8,true,12,26,14,41.89704,-87.62173
TA1307000061,2,8,true,73,40,-33,41.89745,-87.62873
25,2,8,true,5,13,8,41.89751,-87.62354
13034,2,8,true,23,102,79,41.89754,-87.62352
48,2,8,true,26,31,5,41.89772,-87.64302
TA1306000009,2,8,true,150,389,239,41.89772,-87.64299
620,2,8,true,91,46,-45,41.89817,-87.63754
374,2,8,true,13,2,-11,41.89842,-87.68659
KA1504000103,2,8,true,31,20,-11,41.89842,-87.68659
15529,2,8,true,75,94,19,41.89858,-87.62206
140,2,8,true,18,14,-4,41.89895,-87.6299
TA1307000128,2,8,true,120,71,-49,41.89896,-87.6299
657,2,8,true,66,17,-49,41.89918,-87.6722
KA1504000117,2,8,true,14,30,16,41.89936,-87.64848
13248,2,8,true,90,25,-65,41.89964,-87.66788
TA1306000011,2,8,true,85,23,-62,41.89994,-87.63443
KA1504000116,2,8,true,70,54,-16,41.90023,-87.64299
364,2,8,true,12,9,-3,41.90023,-87.64299
17660,2,8,true,26,4,-22,41.90036,-87.69671
13290,2,8,true,111,40,-71,41.90069,-87.66259
13042,2,8,true,82,84,2,41.90097,-87.62377
85,2,8,true,5,17,12,41.90098,-87.62375
TA1307000070,2,8,true,67,29,-38,41.90133,-87.67742
KA1504000133,2,8,true,98,62,-36,41.90234,-87.62773
172,2,8,true,14,7,-7,41.90236,-87.62774
15654,2,8,true,10,5,-5,41.90271,-87.70923
13241,2,8,true,20,26,6,41.9029,-87.68731
176,2,8,true,37,14,-23,41.90291,-87.63141
TA1306000006,2,8,true,72,5,-67,41.90292,-87.63772
23,2,8,true,10,2,-8,41.90292,-87.63772
TA1307000039,2,8,true,205,85,-120,41.90294,-87.63137
658,2,8,true,30,57,27,41.903,-87.6838
TA1305000034,2,8,true,34,21,-13,41.90313,-87.67391
182,2,8,true,37,21,-16,41.90317,-87.63442
KA1504000135,2,8,true,149,100,-49,41.90319,-87.63439
13136,2,8,true,73,32,-41,41.90326,-87.67845
210,2,8,true,19,15,-4,41.90342,-87.66781
13061,2,8,true,115,67,-48,41.90342,-87.66779
KA1504000079,2,8,true,55,38,-17,41.9035,-87.64334
359,2,8,true,14,5,-9,41.90458,-87.6497
138,2,8,true,12,3,-9,41.9046,-87.64057
TA1307000115,2,8,true,83,27,-56,41.9046,-87.64056
291,2,8,true,24,8,-16,41.90672,-87.63494
TA1308000049,2,8,true,87,64,-23,41.90672,-87.6349
KA1504000134,2,8,true,41,17,-24,41.90687,-87.6262
180,2,8,true,22,4,-18,41.90687,-87.62618
13224,2,8,true,62,34,-28,41.90706,-87.66725
333,2,8,true,19,2,-17,41.90706,-87.66725
18069,2,8,true,1,41,40,41.90722,-87.65563
TA1307000143,2,8,true,45,13,-32,41.90762,-87.63854
13221,2,8,true,42,17,-25,41.90765,-87.67254
301,2,8,true,36,12,-24,41.90796,-87.63203
TA1309000024,2,8,true,104,62,-42,41.908,-87.63152
TA1305000041,2,8,true,59,60,1,41.9094,-87.67769
331,2,8,true,86,89,3,41.90965,-87.64812
15653,2,8,true,10,6,-4,41.90979,-87.7053
TA1305000037,2,8,true,79,35,-44,41.91018,-87.67003
TA1306000008,2,8,true,36,14,-22,41.9102,-87.6435
16,2,8,true,14,14,0,41.91035,-87.67008
TA1308000005,2,8,true,45,13,-32,41.91042,-87.68238
13258,2,8,true,22,6,-16,41.91043,-87.69718
13257,2,8,true,29,4,-25,41.91054,-87.68956
13154,2,8,true,91,94,3,41.91054,-87.65312
20,2,8,true,17,19,2,41.91055,-87.65313
13058,2,8,true,52,34,-18,41.91059,-87.64942
TA1307000038,2,8,true,77,64,-13,41.91138,-87.63868
118,2,8,true,14,9,-5,41.91138,-87.63868
LF-005,2,8,true,86,31,-55,41.91172,-87.62681
268,2,8,true,10,2,-8,41.91172,-87.62681
126,2,8,true,8,11,3,41.91196,-87.63197
13128,2,8,true,48,29,-19,41.91197,-87.63197
289,2,8,true,37,21,-16,41.91209,-87.63472
TA1308000050,2,8,true,156,106,-50,41.91211,-87.6347
13243,2,8,true,60,24,-36,41.91262,-87.6814
TA1309000032,2,8,true,15,22,7,41.91293,-87.66417
TA1306000032,2,8,true,66,41,-25,41.9137,-87.65285
TA1307000166,2,8,true,47,39,-8,41.91386,-87.64877
224,2,8,true,8,11,3,41.91386,-87.64877
15655,2,8,true,13,4,-9,41.91401,-87.70514
18017,2,8,true,21,3,-18,41.91416,-87.71676
18067,2,8,true,45,17,-28,41.9146,-87.66796
TA1306000007,2,8,true,40,15,-25,41.91469,-87.64333
13068,2,8,true,25,29,4,41.91554,-87.68703
13179,2,8,true,87,44,-43,41.9157,-87.63461
141,2,8,true,17,4,-13,41.91571,-87.63461
13133,2,8,true,45,34,-11,41.91598,-87.67733
58,2,8,true,13,3,-10,41.91602,-87.66894
TA1305000039,2,8,true,60,62,2,41.9163,-87.66749
15650,2,8,true,18,8,-10,41.91711,-87.71023
15651,2,8,true,23,15,-8,41.91752,-87.70181
13266,2,8,true,23,6,-17,41.91774,-87.69142
TA1309000029,2,8,true,47,33,-14,41.9178,-87.68245
TA1309000006,2,8,true,69,38,-31,41.91809,-87.64375
TA1307000163,2,8,true,71,75,4,41.91821,-87.65696
94,2,8,true,22,20,-2,41.91831,-87.6363
13146,2,8,true,124,90,-34,41.91831,-87.63629
13059,2,8,true,66,72,6,41.91845,-87.65222
113,2,8,true,11,18,7,41.91846,-87.65222
13259,2,8,true,19,4,-15,41.91852,-87.69744
13192,2,8,true,79,60,-19,41.91995,-87.64884
225,2,8,true,16,10,-6,41.91995,-87.64884
13288,2,8,true,39,7,-32,41.92008,-87.67788
13242,2,8,true,18,20,2,41.92021,-87.69266
TA1309000030,2,8,true,35,38,3,41.92077,-87.66372
13292,2,8,true,21,2,-19,41.92152,-87.70733
TA1309000033,2,8,true,52,41,-11,41.92158,-87.65381
13193,2,8,true,93,80,-13,41.92182,-87.64412
144,2,8,true,18,21,3,41.92182,-87.64411
13191,2,8,true,74,47,-27,41.92217,-87.63891
143,2,8,true,15,10,-5,41.92217,-87.63891
327,2,8,true,13,5,-8,41.92225,-87.65783
13084,2,8,true,31,43,12,41.92268,-87.69715
LP-,2,8,true,63,20,-43,41.92396,-87.63584
KA1504000140,2,8,true,13,9,-4,41.92409,-87.67646
15648,2,8,true,13,3,-10,41.92464,-87.68931
TA1307000001,2,8,true,32,26,-6,41.92535,-87.66581
TA1306000026,2,8,true,55,62,7,41.92558,-87.65842
87,2,8,true,10,9,-1,41.92559,-87.65843
TA1306000016,2,8,true,53,109,56,41.9256,-87.65371
313,2,8,true,10,14,4,41.9257,-87.64246
TA1309000019,2,8,true,102,48,-54,41.92586,-87.63897
TA1309000058,2,8,true,116,71,-45,41.92591,-87.64927
127,2,8,true,23,13,-10,41.92592,-87.64927
TA1308000001,2,8,true,56,42,-14,41.92627,-87.63086
177,2,8,true,13,14,1,41.92627,-87.63086
15646,2,8,true,20,4,-16,41.92668,-87.6977
13124,2,8,true,8,25,17,41.92675,-87.63444
TA1309000023,2,8,true,50,25,-25,41.9287,-87.65383
TA1307000113,2,8,true,37,15,-22,41.92878,-87.66391
13296,2,8,true,30,26,-4,41.92883,-87.66852
TA1309000059,2,8,true,70,40,-30,41.92889,-87.65898
349,2,8,true,18,7,-11,41.92915,-87.6491
TA1309000061,2,8,true,56,66,10,41.92915,-87.64909
TA1308000031,2,8,true,17,10,-7,41.92946,-87.68417
TA1305000014,2,8,true,100,68,-32,41.92956,-87.64313
340,2,8,true,28,12,-16,41.92956,-87.64313
13085,2,8,true,12,9,-3,41.92958,-87.70789
15643,2,8,true,10,10,0,41.93057,-87.7238
TA1307000142,2,8,true,94,51,-43,41.93125,-87.64432
220,2,8,true,21,9,-12,41.93125,-87.64431
13276,2,8,true,87,45,-42,41.93132,-87.63874
324,2,8,true,23,9,-14,41.93173,-87.64179
13271,2,8,true,20,13,-7,41.93192,-87.67784
152,2,8,true,23,9,-14,41.93221,-87.65864
TA1307000064,2,8,true,105,67,-38,41.93222,-87.65864
13,2,8,true,16,8,-8,41.93242,-87.65271
TA1306000014,2,8,true,73,85,12,41.93242,-87.65271
TA1309000039,2,8,true,86,39,-47,41.93258,-87.63642
13294,2,8,true,34,11,-23,41.9326,-87.66595
TA1309000036,2,8,true,69,38,-31,41.93313,-87.64776
TA1307000006,2,8,true,44,37,-7,41.93571,-87.6636
13268,2,8,true,29,18,-11,41.93588,-87.67843
13269,2,8,true,42,14,-28,41.93609,-87.66983
115,2,8,true,17,17,0,41.93628,-87.65266
TA1307000052,2,8,true,59,110,51,41.93628,-87.65266
156,2,8,true,21,17,-4,41.9365,-87.64756
TA1307000136,2,8,true,88,73,-15,41.9365,-87.64755
TA1307000041,2,8,true,104,66,-38,41.93669,-87.63683
157,2,8,true,15,6,-9,41.9367,-87.63683
13137,2,8,true,114,75,-39,41.9376,-87.6441
300,2,8,true,19,11,-8,41.93761,-87.6441
KA17018068,2,8,true,15,8,-7,41.93935,-87.68327
TA1309000042,2,8,true,42,18,-24,41.93937,-87.66836
131,2,8,true,14,6,-8,41.93937,-87.66835
13229,2,8,true,53,29,-24,41.93946,-87.66376
TA1308000019,2,8,true,28,26,-2,41.93973,-87.65886
13277,2,8,true,51,35,-16,41.9401,-87.64546
TA1307000134,2,8,true,66,93,27,41.94016,-87.65303
117,2,8,true,15,9,-6,41.94016,-87.65302
334,2,8,true,22,10,-12,41.94076,-87.63919
TA1309000049,2,8,true,71,64,-7,41.94077,-87.63919
15634,2,8,true,24,4,-20,41.94304,-87.68729
TA1307000138,2,8,true,34,61,27,41.94334,-87.67094
230,2,8,true,11,13,2,41.94335,-87.67093
13144,2,8,true,44,6,-38,41.9434,-87.67964
TA1309000025,2,8,true,56,38,-18,41.94368,-87.64894
299,2,8,true,14,4,-10,41.94368,-87.64894
229,2,8,true,10,8,-2,41.94372,-87.66401
13071,2,8,true,61,72,11,41.94373,-87.66401
632,2,8,true,62,35,-27,41.94453,-87.6547
13278,2,8,true,56,36,-20,41.94553,-87.64644
15632,2,8,true,4,27,23,41.94664,-87.69463
KA1504000143,2,8,true,19,9,-10,41.94664,-87.68337
227,2,8,true,12,12,0,41.94813,-87.66397
13235,2,8,true,80,90,10,41.94814,-87.66396
304,2,8,true,18,14,-4,41.94878,-87.64922
13253,2,8,true,25,15,-10,41.9488,-87.67527
13325,2,8,true,74,60,-14,41.94907,-87.64863
TA1307000126,2,8,true,52,52,0,41.94936,-87.65451
232,2,8,true,12,21,9,41.94943,-87.64645
TA1307000150,2,8,true,74,54,-20,41.94945,-87.64646
13319,2,8,true,39,19,-20,41.95069,-87.6687
TA1307000127,2,8,true,56,45,-11,41.9508,-87.65918
318,2,8,true,12,2,-10,41.95254,-87.6735
13323,2,8,true,51,29,-22,41.95282,-87.65
TA1309000043,2,8,true,25,34,9,41.95417,-87.66434
13063,2,8,true,58,59,1,41.95424,-87.65441
KA1504000158,2,8,true,12,10,-2,41.95432,-87.68607
254,2,8,true,8,10,2,41.95438,-87.64806
TA1308000022,2,8,true,59,49,-10,41.95438,-87.64805
244,2,8,true,5,12,7,41.95466,-87.67391
TA1307000149,2,8,true,13,51,38,41.95467,-87.67392
TA1309000026,2,8,true,15,21,6,41.95601,-87.6802
312,2,8,true,15,6,-9,41.95637,-87.6563
TA1308000047,2,8,true,14,6,-8,41.95709,-87.6642
13379,2,8,true,69,23,-46,41.95786,-87.6495
TA1309000018,2,8,true,22,51,29,41.95791,-87.67357
TA1309000027,2,8,true,48,15,-33,41.9585,-87.65499
13389,2,8,true,53,45,-8,41.961,-87.64958
245,2,8,true,10,8,-2,41.96101,-87.64958
15622,2,8,true,19,9,-10,41.96108,-87.69544
KA1504000097,2,8,true,17,6,-11,41.96116,-87.71658
TA1307000144,2,8,true,28,17,-11,41.96142,-87.6762
TA1309000021,2,8,true,11,8,-3,41.9615,-87.6714
15623,2,8,true,24,6,-18,41.96154,-87.69117
KA1503000022,2,8,true,14,14,0,41.96158,-87.66609
TA1307000107,2,8,true,42,37,-5,41.96164,-87.65464
TA1307000156,2,8,true,25,15,-10,41.96301,-87.68479
TA1309000012,2,8,true,14,9,-5,41.96325,-87.67928
TA1308000012,2,8,true,17,11,-6,41.96398,-87.63818
13074,2,8,true,15,49,34,41.96521,-87.6582
639,2,8,true,27,20,-7,41.96584,-87.64538
KA1504000127,2,8,true,24,3,-21,41.96587,-87.70083
KA1504000093,2,8,true,13,23,10,41.96587,-87.69365
TA1307000140,2,8,true,28,33,5,41.96643,-87.68865
239,2,8,true,17,2,-15,41.9665,-87.68843
TA1309000014,2,8,true,44,38,-6,41.96709,-87.66744
TA1307000158,2,8,true,36,29,-7,41.9671,-87.67904
TA1307000119,2,8,true,50,22,-28,41.96796,-87.65
251,2,8,true,4,11,7,41.96796,-87.65
15615,2,8,true,2,16,14,41.96835,-87.71183
TA1308000021,2,8,true,16,5,-11,41.96883,-87.65765
TA1309000015,2,8,true,12,4,-8,41.96889,-87.68401
TA1309000066,2,8,true,67,52,-15,41.9691,-87.67423
344,2,8,true,12,17,5,41.9691,-87.67423
TA1309000041,2,8,true,21,24,3,41.96951,-87.65471
KA1504000171,2,8,true,26,24,-2,41.97161,-87.65016
TA1309000035,2,8,true,52,22,-30,41.97335,-87.66785
13108,2,8,true,31,19,-12,41.97379,-87.65971
KA1504000149,2,8,true,10,19,9,41.97562,-87.67945
KA1504000160,2,8,true,6,13,7,41.97564,-87.70143
KA1504000146,2,8,true,19,19,0,41.978,-87.66805
13109,2,8,true,33,18,-15,41.97835,-87.65976
KA1504000147,2,8,true,13,2,-11,41.97976,-87.67754
655,2,8,true,1,19,18,41.97987,-87.68194
KA1504000151,2,8,true,19,30,11,41.98359,-87.66916
KA1504000152,2,8,true,36,45,9,41.98403,-87.65231
15578,2,8,true,17,21,4,41.98405,-87.66027
15575,2,8,true,36,14,-22,41.98975,-87.66014
KA1504000148,2,8,true,11,5,-6,41.99086,-87.66971
15571,2,8,true,44,15,-29,41.99478,-87.66028
RP-009,2,8,true,19,29,10,42.00107,-87.66122
RP-008,2,8,true,18,1,-17,42.00446,-87.6724
660,2,8,true,25,14,-11,42.00458,-87.66143
KA1504000175,2,8,true,14,10,-4,42.00797,-87.66549
KA1504000162,2,8,true,6,17,11,42.00907,-87.67422
KA1504000159,2,8,true,13,2,-11,42.01059,-87.66241
525,2,8,true,11,2,-9,42.01272,-87.66605
520,2,8,true,13,5,-8,42.01597,-87.66859
515,2,8,true,10,9,-1,42.01915,-87.67356
598,2,8,true,22,4,-18,42.02578,-87.68411
E002,2,8,true,22,18,-4,42.03256,-87.67912
596,2,8,true,29,23,-6,42.04822,-87.68348
E008,2,8,true,11,10,-1,42.05049,-87.67782
KA1503000029,2,12,false,9,10,1,41.77364,-87.56747
15491,2,12,false,5,15,10,41.78096,-87.57624
KA1503000014,2,12,false,29,24,-5,41.7851,-87.60108
TA1309000011,2,12,false,14,17,3,41.78873,-87.60131
KA1503000071,2,12,false,19,31,12,41.79148,-87.59988
KA1503000074,2,12,false,30,45,15,41.79174,-87.58395
TA1309000063,2,12,false,7,13,6,41.79325,-87.5878
KA1504000076,2,12,false,14,22,8,41.7943,-87.60145
TA1308000009,2,12,false,15,25,10,41.79522,-87.58075
TA1307000164,2,12,false,17,5,-12,41.79527,-87.59647
KA1503000052,2,12,false,17,15,-2,41.79935,-87.60097
KA1503000059,2,12,false,23,13,-10,41.79952,-87.58643
TA1309000037,2,12,false,28,31,3,41.79957,-87.59474
KA1503000007,2,12,false,22,11,-11,41.80242,-87.58689
KA1503000004,2,12,false,15,10,-5,41.83127,-87.6088
13216,2,12,false,12,9,-3,41.83473,-87.62581
TA1307000048,2,12,false,31,24,-7,41.83855,-87.60821
TA1307000139,2,12,false,11,12,1,41.84205,-87.61698
TA1305000004,2,12,false,21,19,-2,41.8514,-87.61884
TA1305000001,2,12,false,8,13,5,41.85262,-87.6265
13075,2,12,false,22,22,0,41.8531,-87.63192
15546,2,12,false,14,8,-6,41.85416,-87.61916
13331,2,12,false,11,7,-4,41.85515,-87.65414
15545,2,12,false,30,30,0,41.85627,-87.61334
13135,2,12,false,12,18,6,41.85753,-87.66157
13102,2,12,false,21,15,-6,41.85762,-87.61942
13150,2,12,false,25,20,-5,41.85783,-87.62455
273,2,12,false,10,10,0,41.85783,-87.62455
13099,2,12,false,7,14,7,41.85784,-87.64627
13163,2,12,false,11,8,-3,41.85808,-87.65108
SL-012,2,12,false,20,14,-6,41.86038,-87.62581
TA1307000124,2,12,false,15,22,7,41.86411,-87.62372
TA1309000001,2,12,false,10,18,8,41.86488,-87.64708
13029,2,12,false,30,28,-2,41.86531,-87.6179
13431,2,12,false,36,34,-2,41.8661,-87.60728
WL-008,2,12,false,19,12,-7,41.86712,-87.64108
TA1305000002,2,12,false,42,30,-12,41.86721,-87.62597
3,2,12,false,19,18,-1,41.86723,-87.61536
15544,2,12,false,200,248,48,41.86723,-87.61536
TA1305000017,2,12,false,24,6,-18,41.86734,-87.64863
KA1706005007,2,12,false,12,20,8,41.86749,-87.63219
SL-005,2,12,false,59,72,13,41.8679,-87.62304
255,2,12,false,10,7,-3,41.86791,-87.62304
13139,2,12,false,12,3,-9,41.86893,-87.65913
13160,2,12,false,11,22,11,41.86947,-87.65548
15550,2,12,false,17,21,4,41.87024,-87.63947
TA1309000010,2,12,false,33,41,8,41.87074,-87.62574
SL-009,2,12,false,8,11,3,41.87081,-87.63121
TA1309000064,2,12,false,13,5,-8,41.87127,-87.67369
TA1307000130,2,12,false,16,11,-5,41.87178,-87.65103
TA1307000121,2,12,false,12,15,3,41.87184,-87.64664
SL-008,2,12,false,36,30,-6,41.87209,-87.62956
13332,2,12,false,12,12,0,41.87219,-87.6615
SL-011,2,12,false,26,17,-9,41.87256,-87.63356
623,2,12,false,75,49,-26,41.87272,-87.62399
KA1504000104,2,12,false,10,14,4,41.87296,-87.66912
SL-007,2,12,false,15,24,9,41.87404,-87.6277
TA1306000025,2,12,false,10,14,4,41.87464,-87.65703
13028,2,12,false,17,20,3,41.87475,-87.64981
15541,2,12,false,54,48,-6,41.8758,-87.62086
TA1305000010,2,12,false,33,23,-10,41.87623,-87.62444
624,2,12,false,30,19,-11,41.87626,-87.62923
TA1305000035,2,12,false,18,13,-5,41.87716,-87.62787
13138,2,12,false,5,10,5,41.87723,-87.63941
15539,2,12,false,22,17,-5,41.87763,-87.64405
13158,2,12,false,28,21,-7,41.87764,-87.64957
13157,2,12,false,18,14,-4,41.87773,-87.6548
TA1305000025,2,12,false,64,56,-8,41.87773,-87.63528
TA1309000002,2,12,false,49,24,-25,41.87784,-87.62408
TA1309000004,2,12,false,38,15,-23,41.87811,-87.63184
638,2,12,false,15,21,6,41.87827,-87.64078
TA1305000005,2,12,false,60,36,-24,41.87924,-87.62975
13011,2,12,false,21,32,11,41.87931,-87.63993
TA1309000008,2,12,false,55,23,-32,41.87933,-87.6355
KA1503000034,2,12,false,24,13,-11,41.87938,-87.63197
KA1503000015,2,12,false,31,16,-15,41.87948,-87.6257
TA1309000007,2,12,false,38,23,-15,41.88022,-87.63526
WL-011,2,12,false,12,11,-1,41.88034,-87.64273
13156,2,12,false,10,13,3,41.88042,-87.65554
13300,2,12,false,225,180,-45,41.88097,-87.61675
76,2,12,false,18,31,13,41.88098,-87.61675
13008,2,12,false,184,196,12,41.88105,-87.62408
90,2,12,false,21,28,7,41.88107,-87.62409
TA1305000006,2,12,false,82,68,-14,41.88122,-87.6296
13134,2,12,false,9,11,2,41.88138,-87.67493
13056,2,12,false,14,16,2,41.88168,-87.63951
198,2,12,false,11,10,-1,41.88187,-87.6488
TA1307000120,2,12,false,49,39,-10,41.88188,-87.64879
13341,2,12,false,17,18,1,41.88208,-87.63985
13036,2,12,false,39,30,-9,41.8821,-87.62513
TA1305000032,2,12,false,27,25,-2,41.88218,-87.64109
13006,2,12,false,22,19,-3,41.88268,-87.63252
13353,2,12,false,12,6,-6,41.88283,-87.6612
654,2,12,false,20,12,-8,41.88307,-87.65698
13409,2,12,false,15,17,2,41.8831,-87.6511
KA1503000072,2,12,false,32,21,-11,41.88317,-87.63693
WL-012,2,12,false,23,26,3,41.88337,-87.6412
13053,2,12,false,24,39,15,41.88365,-87.64863
43,2,12,false,11,15,4,41.88396,-87.62455
13001,2,12,false,102,82,-20,41.88397,-87.62459
13155,2,12,false,10,12,2,41.88407,-87.65689
18062,2,12,false,17,15,-2,41.88412,-87.65427
81,2,12,false,11,7,-4,41.88417,-87.6296
TA1306000010,2,12,false,42,35,-7,41.88419,-87.62961
TA1305000030,2,12,false,46,38,-8,41.88459,-87.63178
15535,2,12,false,14,21,7,41.8846,-87.64455
TA1305000029,2,12,false,47,50,3,41.88466,-87.62787
13263,2,12,false,57,45,-12,41.88467,-87.61952
TA1306000015,2,12,false,41,36,-5,41.88549,-87.65232
13021,2,12,false,34,30,-4,41.88559,-87.64184
TA1307000111,2,12,false,33,24,-9,41.88582,-87.63548
KA1503000012,2,12,false,27,26,-1,41.88599,-87.63089
52,2,12,false,9,11,2,41.886,-87.62421
TA1305000011,2,12,false,117,72,-45,41.886,-87.62418
15534,2,12,false,26,23,-3,41.88627,-87.61749
13197,2,12,false,11,11,0,41.8866,-87.65816
TA1308000029,2,12,false,30,24,-6,41.88673,-87.62225
TA1307000131,2,12,false,45,40,-5,41.88688,-87.62606
KA1503000064,2,12,false,87,53,-34,41.88697,-87.61281
TA1305000022,2,12,false,28,33,5,41.88817,-87.63656
56,2,12,false,6,10,4,41.88866,-87.64442
TA1306000003,2,12,false,31,28,-3,41.88867,-87.64442
KA1503000043,2,12,false,52,54,2,41.88918,-87.63851
13050,2,12,false,37,46,9,41.88919,-87.62775
13432,2,12,false,10,14,4,41.88989,-87.67149
TA1307000151,2,12,false,44,38,-6,41.88993,-87.63427
212,2,12,false,10,9,-1,41.88995,-87.63427
636,2,12,false,16,15,-1,41.88997,-87.63662
KA1503000044,2,12,false,25,28,3,41.89018,-87.6262
13427,2,12,false,42,28,-14,41.89054,-87.62205
13430,2,12,false,64,42,-22,41.89077,-87.63169
TA1306000013,2,12,false,57,39,-18,41.89083,-87.61852
RN-,2,12,false,31,29,-2,41.89102,-87.63546
13434,2,12,false,10,13,3,41.89108,-87.66663
TA1308000006,2,12,false,15,13,-2,41.89128,-87.67686
199,2,12,false,11,5,-6,41.89143,-87.62676
TA1307000117,2,12,false,74,55,-19,41.89144,-87.62675
13033,2,12,false,24,26,2,41.8916,-87.64835
13194,2,12,false,17,12,-5,41.8918,-87.65878
TA1305000003,2,12,false,47,48,1,41.89187,-87.62061
35,2,12,false,18,10,-8,41.89227,-87.61206
13022,2,12,false,327,404,77,41.89227,-87.61205
TA1306000029,2,12,false,59,43,-16,41.89256,-87.61449
13265,2,12,false,21,23,2,41.89383,-87.64172
13045,2,12,false,59,67,8,41.89403,-87.62931
110,2,12,false,7,13,6,41.89406,-87.6293
13016,2,12,false,72,73,1,41.89431,-87.62277
211,2,12,false,9,11,2,41.89439,-87.62267
KA1503000041,2,12,false,38,34,-4,41.89452,-87.61798
13196,2,12,false,20,21,1,41.89455,-87.65345
TA1307000062,2,12,false,29,31,2,41.89466,-87.63839
TA1306000012,2,12,false,39,49,10,41.89475,-87.63438
53,2,12,false,13,6,-7,41.89476,-87.63439
KP1705001026,2,12,false,33,21,-12,41.89483,-87.6323
637,2,12,false,12,6,-6,41.89563,-87.67209
13132,2,12,false,23,18,-5,41.89573,-87.67718
161,2,12,false,8,11,3,41.89574,-87.62599
15530,2,12,false,35,34,-1,41.89575,-87.62596
18003,2,12,false,29,19,-10,41.89575,-87.62011
13247,2,12,false,16,18,2,41.89597,-87.66775
TA1305000020,2,12,false,20,7,-13,41.89636,-87.65406
13289,2,12,false,21,15,-6,41.89638,-87.661
13303,2,12,false,20,30,10,41.89672,-87.63088
13017,2,12,false,20,24,4,41.89676,-87.6357
13338,2,12,false,66,41,-25,41.89697,-87.62173
TA1307000061,2,12,false,22,25,3,41.89745,-87.62873
13034,2,12,false,59,44,-15,41.89754,-87.62352
TA1306000009,2,12,false,28,16,-12,41.89772,-87.64299
620,2,12,false,25,27,2,41.89817,-87.63754
15529,2,12,false,46,40,-6,41.89858,-87.62206
TA1307000128,2,12,false,40,39,-1,41.89896,-87.6299
TA1306000011,2,12,false,13,6,-7,41.89994,-87.63443
KA1504000116,2,12,false,12,5,-7,41.90023,-87.64299
17660,2,12,false,11,13,2,41.90036,-87.69671
13290,2,12,false,16,21,5,41.90069,-87.66259
13042,2,12,false,169,174,5,41.90097,-87.62377
85,2,12,false,8,11,3,41.90098,-87.62375
TA1307000070,2,12,false,13,7,-6,41.90133,-87.67742
KA1504000133,2,12,false,34,51,17,41.90234,-87.62773
13241,2,12,false,19,12,-7,41.9029,-87.68731
176,2,12,false,11,9,-2,41.90291,-87.63141
TA1306000006,2,12,false,10,10,0,41.90292,-87.63772
TA1307000039,2,12,false,38,55,17,41.90294,-87.63137
TA1305000034,2,12,false,20,13,-7,41.90313,-87.67391
KA1504000135,2,12,false,51,36,-15,41.90319,-87.63439
13136,2,12,false,13,13,0,41.90326,-87.67845
13061,2,12,false,40,47,7,41.90342,-87.66779
KA1504000079,2,12,false,28,22,-6,41.9035,-87.64334
TA1307000115,2,12,false,11,8,-3,41.9046,-87.64056
TA1308000049,2,12,false,22,37,15,41.90672,-87.6349
KA1504000134,2,12,false,24,16,-8,41.90687,-87.6262
13224,2,12,false,11,16,5,41.90706,-87.66725
13221,2,12,false,21,35,14,41.90765,-87.67254
TA1309000024,2,12,false,22,28,6,41.908,-87.63152
69,2,12,false,10,5,-5,41.90939,-87.6777
TA1305000041,2,12,false,37,34,-3,41.9094,-87.67769
331,2,12,false,41,38,-3,41.90965,-87.64812
TA1305000037,2,12,false,8,17,9,41.91018,-87.67003
TA1306000008,2,12,false,7,14,7,41.9102,-87.6435
TA1308000005,2,12,false,7,12,5,41.91042,-87.68238
13257,2,12,false,11,10,-1,41.91054,-87.68956
13154,2,12,false,22,32,10,41.91054,-87.65312
13058,2,12,false,26,19,-7,41.91059,-87.64942
TA1307000038,2,12,false,36,50,14,41.91138,-87.63868
LF-005,2,12,false,108,164,56,41.91172,-87.62681
126,2,12,false,11,5,-6,41.91196,-87.63197
13128,2,12,false,28,31,3,41.91197,-87.63197
289,2,12,false,2,10,8,41.91209,-87.63472
TA1308000050,2,12,false,56,76,20,41.91211,-87.6347
13243,2,12,false,28,20,-8,41.91262,-87.6814
TA1309000032,2,12,false,11,5,-6,41.91293,-87.66417
TA1306000032,2,12,false,19,16,-3,41.9137,-87.65285
TA1307000166,2,12,false,14,10,-4,41.91386,-87.64877
15655,2,12,false,5,11,6,41.91401,-87.70514
18017,2,12,false,11,12,1,41.91416,-87.71676
18067,2,12,false,7,11,4,41.9146,-87.66796
13068,2,12,false,18,12,-6,41.91554,-87.68703
13179,2,12,false,41,71,30,41.9157,-87.63461
13133,2,12,false,21,17,-4,41.91598,-87.67733
TA1305000039,2,12,false,21,9,-12,41.9163,-87.66749
15650,2,12,false,18,12,-6,41.91711,-87.71023
15651,2,12,false,12,9,-3,41.91752,-87.70181
13266,2,12,false,10,11,1,41.91774,-87.69142
TA1309000029,2,12,false,15,2,-13,41.9178,-87.68245
TA1309000006,2,12,false,11,10,-1,41.91809,-87.64375
TA1307000163,2,12,false,11,8,-3,41.91821,-87.65696
13146,2,12,false,32,92,60,41.91831,-87.63629
13059,2,12,false,23,38,15,41.91845,-87.65222
13192,2,12,false,25,28,3,41.91995,-87.64884
13288,2,12,false,12,7,-5,41.92008,-87.67788
13242,2,12,false,6,10,4,41.92021,-87.69266
TA1309000030,2,12,false,18,22,4,41.92077,-87.66372
TA1309000033,2,12,false,27,13,-14,41.92158,-87.65381
13193,2,12,false,41,36,-5,41.92182,-87.64412
13191,2,12,false,19,25,6,41.92217,-87.63891
13084,2,12,false,15,14,-1,41.92268,-87.69715
LP-,2,12,false,55,49,-6,41.92396,-87.63584
15648,2,12,false,11,4,-7,41.92464,-87.68931
TA1307000001,2,12,false,20,21,1,41.92535,-87.66581
TA1306000026,2,12,false,17,16,-1,41.92558,-87.65842
TA1306000016,2,12,false,35,25,-10,41.9256,-87.65371
TA1309000019,2,12,false,35,37,2,41.92586,-87.63897
TA1309000058,2,12,false,29,40,11,41.92591,-87.64927
127,2,12,false,13,11,-2,41.92592,-87.64927
177,2,12,false,13,14,1,41.92627,-87.63086
TA1308000001,2,12,false,98,116,18,41.92627,-87.63086
15646,2,12,false,17,9,-8,41.92668,-87.6977
13124,2,12,false,40,25,-15,41.92675,-87.63444
TA1309000023,2,12,false,21,23,2,41.9287,-87.65383
TA1307000113,2,12,false,13,5,-8,41.92878,-87.66391
13296,2,12,false,12,13,1,41.92883,-87.66852
TA1309000059,2,12,false,8,13,5,41.92889,-87.65898
TA1309000061,2,12,false,12,20,8,41.92915,-87.64909
TA1308000031,2,12,false,6,15,9,41.92946,-87.68417
TA1305000014,2,12,false,36,31,-5,41.92956,-87.64313
13085,2,12,false,15,25,10,41.92958,-87.70789
TA1307000142,2,12,false,49,45,-4,41.93125,-87.64432
13276,2,12,false,33,16,-17,41.93132,-87.63874
13271,2,12,false,13,19,6,41.93192,-87.67784
TA1307000064,2,12,false,19,11,-8,41.93222,-87.65864
TA1306000014,2,12,false,40,38,-2,41.93242,-87.65271
TA1309000039,2,12,false,48,39,-9,41.93258,-87.63642
13294,2,12,false,11,11,0,41.9326,-87.66595
TA1309000036,2,12,false,21,22,1,41.93313,-87.64776
TA1307000006,2,12,false,14,16,2,41.93571,-87.6636
13268,2,12,false,15,6,-9,41.93588,-87.67843
13269,2,12,false,10,16,6,41.93609,-87.66983
TA1307000052,2,12,false,28,15,-13,41.93628,-87.65266
TA1307000136,2,12,false,22,32,10,41.9365,-87.64755
TA1307000041,2,12,false,45,45,0,41.93669,-87.63683
13137,2,12,false,58,46,-12,41.9376,-87.6441
15642,2,12,false,10,2,-8,41.93843,-87.69801
TA1309000042,2,12,false,11,19,8,41.93937,-87.66836
13229,2,12,false,22,11,-11,41.93946,-87.66376
TA1308000019,2,12,false,15,19,4,41.93973,-87.65886
13277,2,12,false,35,35,0,41.9401,-87.64546
TA1307000134,2,12,false,37,40,3,41.94016,-87.65303
TA1309000049,2,12,false,64,55,-9,41.94077,-87.63919
TA1307000138,2,12,false,17,13,-4,41.94334,-87.67094
TA1309000025,2,12,false,28,41,13,41.94368,-87.64894
13071,2,12,false,30,27,-3,41.94373,-87.66401
632,2,12,false,26,35,9,41.94453,-87.6547
303,2,12,false,10,1,-9,41.94522,-87.64702
13278,2,12,false,26,21,-5,41.94553,-87.64644
13235,2,12,false,25,32,7,41.94814,-87.66396
13325,2,12,false,31,32,1,41.94907,-87.64863
TA1307000126,2,12,false,40,38,-2,41.94936,-87.65451
TA1307000150,2,12,false,49,33,-16,41.94945,-87.64646
13319,2,12,false,11,9,-2,41.95069,-87.6687
TA1307000127,2,12,false,46,42,-4,41.9508,-87.65918
13323,2,12,false,31,15,-16,41.95282,-87.65
TA1309000043,2,12,false,10,5,-5,41.95417,-87.66434
13063,2,12,false,36,19,-17,41.95424,-87.65441
TA1308000022,2,12,false,21,24,3,41.95438,-87.64805
TA1307000149,2,12,false,13,6,-7,41.95467,-87.67392
TA1309000026,2,12,false,7,11,4,41.95601,-87.6802
13379,2,12,false,20,13,-7,41.95786,-87.6495
TA1309000027,2,12,false,25,16,-9,41.9585,-87.65499
13389,2,12,false,13,11,-2,41.961,-87.64958
KA1503000022,2,12,false,12,4,-8,41.96158,-87.66609
TA1307000107,2,12,false,24,22,-2,41.96164,-87.65464
TA1308000012,2,12,false,46,78,32,41.96398,-87.63818
13074,2,12,false,29,10,-19,41.96521,-87.6582
639,2,12,false,33,21,-12,41.96584,-87.64538
TA1307000140,2,12,false,12,8,-4,41.96643,-87.68865
TA1309000014,2,12,false,25,18,-7,41.96709,-87.66744
TA1307000158,2,12,false,10,7,-3,41.9671,-87.67904
TA1308000021,2,12,false,18,7,-11,41.96883,-87.65765
TA1309000066,2,12,false,25,17,-8,41.9691,-87.67423
TA1309000041,2,12,false,12,3,-9,41.96951,-87.65471
KA1504000171,2,12,false,13,8,-5,41.97161,-87.65016
TA1309000035,2,12,false,23,22,-1,41.97335,-87.66785
13108,2,12,false,12,12,0,41.97379,-87.65971
KA1504000146,2,12,false,21,24,3,41.978,-87.66805
13109,2,12,false,8,11,3,41.97835,-87.65976
KA1504000151,2,12,false,9,19,10,41.98359,-87.66916
KA1504000152,2,12,false,54,39,-15,41.98403,-87.65231
15578,2,12,false,9,12,3,41.98405,-87.66027
15575,2,12,false,15,12,-3,41.98975,-87.66014
KA1504000148,2,12,false,14,6,-8,41.99086,-87.66971
15571,2,12,false,26,21,-5,41.99478,-87.66028
RP-009,2,12,false,19,16,-3,42.00107,-87.66122
660,2,12,false,11,11,0,42.00458,-87.66143
RP-004,2,12,false,1,14,13,42.01234,-87.68825
E002,2,12,false,8,12,4,42.03256,-87.67912
599,2,12,false,17,3,-14,42.03972,-87.69942
596,2,12,false,12,20,8,42.04822,-87.68348
E008,2,12,false,17,18,1,42.05049,-87.67782
605,2,12,false,7,18,11,42.05294,-87.67342
604,2,12,false,22,11,-11,42.05824,-87.67744
KA1503000014,2,12,true,85,65,-20,41.7851,-87.60108
426,2,12,true,5,11,6,41.7851,-87.60108
KA1503000070,2,12,true,15,9,-6,41.78794,-87.58831
TA1309000011,2,12,true,23,47,24,41.78873,-87.60131
423,2,12,true,12,17,5,41.79148,-87.59988
KA1503000071,2,12,true,65,80,15,41.79148,-87.59988
KA1503000074,2,12,true,16,9,-7,41.79174,-87.58395
TA1309000063,2,12,true,28,24,-4,41.79325,-87.5878
KA1504000076,2,12,true,61,66,5,41.7943,-87.60145
247,2,12,true,14,6,-8,41.79522,-87.58077
TA1308000009,2,12,true,21,20,-1,41.79522,-87.58075
TA1307000164,2,12,true,25,27,2,41.79527,-87.59647
KA1503000052,2,12,true,32,28,-4,41.79935,-87.60097
KA1503000059,2,12,true,27,21,-6,41.79952,-87.58643
TA1309000037,2,12,true,49,50,1,41.79957,-87.59474
KA1503000007,2,12,true,19,14,-5,41.80242,-87.58689
13398,2,12,true,24,14,-10,41.80256,-87.59035
322,2,12,true,12,2,-10,41.80321,-87.59849
KA1503000065,2,12,true,14,3,-11,41.81409,-87.59701
TA1308000045,2,12,true,13,10,-3,41.83062,-87.64129
TA1307000129,2,12,true,21,30,9,41.83104,-87.62683
15445,2,12,true,10,14,4,41.83453,-87.63183
13216,2,12,true,109,70,-39,41.83473,-87.62581
148,2,12,true,15,11,-4,41.83474,-87.62581
13217,2,12,true,25,40,15,41.83488,-87.61792
13215,2,12,true,26,12,-14,41.83634,-87.6135
TA1309000055,2,12,true,22,23,1,41.8382,-87.64514
KA1503000038,2,12,true,17,9,-8,41.83845,-87.6354
TA1307000048,2,12,true,25,26,1,41.83855,-87.60821
272,2,12,true,5,10,5,41.83882,-87.62186
TA1308000036,2,12,true,23,19,-4,41.83883,-87.62186
TA1307000139,2,12,true,32,45,13,41.84205,-87.61698
TA1307000005,2,12,true,19,21,2,41.84569,-87.6225
13075,2,12,true,16,24,8,41.8531,-87.63192
15546,2,12,true,13,6,-7,41.85416,-87.61916
13089,2,12,true,11,12,1,41.85497,-87.67567
13331,2,12,true,10,8,-2,41.85515,-87.65414
4,2,12,true,13,12,-1,41.85627,-87.61334
15545,2,12,true,39,42,3,41.85627,-87.61334
SL-013,2,12,true,8,12,4,41.85659,-87.62755
13135,2,12,true,29,22,-7,41.85753,-87.66157
13102,2,12,true,37,34,-3,41.85762,-87.61942
13150,2,12,true,33,33,0,41.85783,-87.62455
273,2,12,true,7,10,3,41.85783,-87.62455
13099,2,12,true,12,9,-3,41.85784,-87.64627
TA1307000159,2,12,true,16,25,9,41.8579,-87.6687
TA1307000044,2,12,true,7,21,14,41.85794,-87.64083
13163,2,12,true,10,11,1,41.85808,-87.65108
13164,2,12,true,34,19,-15,41.85818,-87.65648
SL-012,2,12,true,43,39,-4,41.86038,-87.62581
72,2,12,true,13,7,-6,41.86039,-87.62581
TA1306000002,2,12,true,25,19,-6,41.86238,-87.65108
TA1307000124,2,12,true,57,49,-8,41.86411,-87.62372
168,2,12,true,11,8,-3,41.86415,-87.62372
TA1309000001,2,12,true,25,34,9,41.86488,-87.64708
13354,2,12,true,12,12,0,41.86524,-87.66651
13029,2,12,true,11,5,-6,41.86531,-87.6179
13431,2,12,true,24,19,-5,41.8661,-87.60728
WL-008,2,12,true,20,40,20,41.86712,-87.64108
TA1305000002,2,12,true,72,71,-1,41.86721,-87.62597
59,2,12,true,17,20,3,41.86721,-87.62597
15544,2,12,true,39,37,-2,41.86723,-87.61536
TA1305000017,2,12,true,31,23,-8,41.86734,-87.64863
KA1706005007,2,12,true,19,18,-1,41.86749,-87.63219
SL-005,2,12,true,60,42,-18,41.8679,-87.62304
255,2,12,true,12,14,2,41.86791,-87.62304
644,2,12,true,32,13,-19,41.86859,-87.68625
19,2,12,true,10,5,-5,41.86892,-87.65913
13139,2,12,true,43,42,-1,41.86893,-87.65913
13285,2,12,true,37,47,10,41.86928,-87.67372
13160,2,12,true,47,43,-4,41.86947,-87.65548
22,2,12,true,12,11,-1,41.86947,-87.65548
15550,2,12,true,24,33,9,41.87024,-87.63947
TA1309000010,2,12,true,57,60,3,41.87074,-87.62574
SL-009,2,12,true,12,12,0,41.87081,-87.63121
342,2,12,true,11,10,-1,41.87127,-87.6737
TA1309000064,2,12,true,78,52,-26,41.87127,-87.67369
15542,2,12,true,4,18,14,41.87146,-87.64095
TA1307000130,2,12,true,66,59,-7,41.87178,-87.65103
241,2,12,true,14,5,-9,41.8718,-87.65102
108,2,12,true,14,23,9,41.87183,-87.64664
TA1307000121,2,12,true,60,50,-10,41.87184,-87.64664
41,2,12,true,13,8,-5,41.87209,-87.62957
SL-008,2,12,true,65,84,19,41.87209,-87.62956
13332,2,12,true,68,82,14,41.87219,-87.6615
175,2,12,true,12,4,-8,41.87255,-87.63359
SL-011,2,12,true,39,31,-8,41.87256,-87.63356
623,2,12,true,37,25,-12,41.87272,-87.62399
KA1504000104,2,12,true,51,41,-10,41.87296,-87.66912
383,2,12,true,10,11,1,41.87297,-87.66912
320,2,12,true,12,13,1,41.87327,-87.66402
SL-007,2,12,true,17,26,9,41.87404,-87.6277
13326,2,12,true,22,13,-9,41.87425,-87.63958
321,2,12,true,14,20,6,41.87427,-87.63257
TA1306000025,2,12,true,18,29,11,41.87464,-87.65703
13028,2,12,true,39,46,7,41.87475,-87.64981
13081,2,12,true,7,13,6,41.87501,-87.67326
SL-010,2,12,true,14,16,2,41.87501,-87.63309
15541,2,12,true,11,12,1,41.8758,-87.62086
13037,2,12,true,27,22,-5,41.87588,-87.64078
TA1305000010,2,12,true,15,33,18,41.87623,-87.62444
624,2,12,true,35,27,-8,41.87626,-87.62923
TA1305000035,2,12,true,49,57,8,41.87716,-87.62787
13138,2,12,true,39,37,-2,41.87723,-87.63941
631,2,12,true,10,4,-6,41.87761,-87.6739
15539,2,12,true,69,47,-22,41.87763,-87.64405
13158,2,12,true,73,114,41,41.87764,-87.64957
134,2,12,true,12,26,14,41.87764,-87.64954
21,2,12,true,8,10,2,41.87773,-87.6548
13157,2,12,true,53,55,2,41.87773,-87.6548
TA1305000025,2,12,true,87,67,-20,41.87773,-87.63528
36,2,12,true,8,11,3,41.87776,-87.63525
TA1309000002,2,12,true,27,22,-5,41.87784,-87.62408
13206,2,12,true,34,33,-1,41.87794,-87.66201
TA1309000004,2,12,true,46,45,-1,41.87811,-87.63184
107,2,12,true,17,14,-3,41.87822,-87.644
638,2,12,true,42,49,7,41.87827,-87.64078
TA1305000005,2,12,true,48,49,1,41.87924,-87.62975
13011,2,12,true,46,51,5,41.87931,-87.63993
TA1309000008,2,12,true,59,33,-26,41.87933,-87.6355
192,2,12,true,16,5,-11,41.87935,-87.63997
KA1503000034,2,12,true,39,26,-13,41.87938,-87.63197
KA1503000015,2,12,true,40,31,-9,41.87948,-87.6257
287,2,12,true,17,12,-5,41.88017,-87.63527
TA1309000007,2,12,true,94,67,-27,41.88022,-87.63526
WL-011,2,12,true,33,43,10,41.88034,-87.64273
13156,2,12,true,33,33,0,41.88042,-87.65554
13300,2,12,true,50,36,-14,41.88097,-87.61675
13008,2,12,true,35,56,21,41.88105,-87.62408
49,2,12,true,11,17,6,41.88116,-87.62963
TA1305000006,2,12,true,99,77,-22,41.88122,-87.6296
13134,2,12,true,4,13,9,41.88138,-87.67493
13056,2,12,true,22,25,3,41.88168,-87.63951
198,2,12,true,18,11,-7,41.88187,-87.6488
TA1307000120,2,12,true,92,94,2,41.88188,-87.64879
13341,2,12,true,32,37,5,41.88208,-87.63985
174,2,12,true,5,10,5,41.88208,-87.63984
197,2,12,true,6,16,10,41.88208,-87.62513
13036,2,12,true,40,53,13,41.8821,-87.62513
77,2,12,true,11,10,-1,41.88214,-87.64108
TA1305000032,2,12,true,66,68,2,41.88218,-87.64109
98,2,12,true,14,13,-1,41.88266,-87.63251
13006,2,12,true,74,49,-25,41.88268,-87.63252
13353,2,12,true,23,24,1,41.88283,-87.6612
654,2,12,true,19,20,1,41.88307,-87.65698
233,2,12,true,6,17,11,41.88309,-87.6511
13409,2,12,true,28,51,23,41.8831,-87.6511
KA1503000072,2,12,true,38,37,-1,41.88317,-87.63693
WL-012,2,12,true,40,71,31,41.88337,-87.6412
112,2,12,true,8,11,3,41.88362,-87.6486
13053,2,12,true,47,57,10,41.88365,-87.64863
43,2,12,true,14,11,-3,41.88396,-87.62455
13001,2,12,true,55,69,14,41.88397,-87.62459
13155,2,12,true,15,19,4,41.88407,-87.65689
18062,2,12,true,28,33,5,41.88412,-87.65427
81,2,12,true,12,23,11,41.88417,-87.6296
TA1306000010,2,12,true,60,86,26,41.88419,-87.62961
TA1305000030,2,12,true,80,85,5,41.88459,-87.63178
15535,2,12,true,42,34,-8,41.8846,-87.64455
51,2,12,true,9,12,3,41.88462,-87.63176
TA1305000029,2,12,true,61,71,10,41.88466,-87.62787
195,2,12,true,12,20,8,41.88466,-87.61952
13263,2,12,true,60,83,23,41.88467,-87.61952
44,2,12,true,11,14,3,41.88468,-87.62782
TA1306000015,2,12,true,56,80,24,41.88549,-87.65232
71,2,12,true,7,18,11,41.8855,-87.65233
66,2,12,true,16,8,-8,41.88557,-87.64186
13021,2,12,true,79,46,-33,41.88559,-87.64184
TA1307000111,2,12,true,67,69,2,41.88582,-87.63548
164,2,12,true,10,10,0,41.88583,-87.63547
KA17018054,2,12,true,20,18,-2,41.88595,-87.67701
KA1503000012,2,12,true,56,52,-4,41.88599,-87.63089
38,2,12,true,15,14,-1,41.88599,-87.63089
52,2,12,true,18,12,-6,41.886,-87.62421
TA1305000011,2,12,true,90,79,-11,41.886,-87.62418
15534,2,12,true,32,42,10,41.88627,-87.61749
13197,2,12,true,19,16,-3,41.8866,-87.65816
TA1308000029,2,12,true,42,47,5,41.88673,-87.62225
TA1307000131,2,12,true,42,25,-17,41.88688,-87.62606
6,2,12,true,14,7,-7,41.88697,-87.61281
KA1503000064,2,12,true,16,27,11,41.88697,-87.61281
100,2,12,true,8,18,10,41.88814,-87.63657
TA1305000022,2,12,true,68,78,10,41.88817,-87.63656
56,2,12,true,21,18,-3,41.88866,-87.64442
TA1306000003,2,12,true,81,70,-11,41.88867,-87.64442
133,2,12,true,20,24,4,41.88918,-87.63851
KA1503000043,2,12,true,112,141,29,41.88918,-87.63851
13050,2,12,true,44,46,2,41.88919,-87.62775
47,2,12,true,10,7,-3,41.88921,-87.62775
13432,2,12,true,11,5,-6,41.88989,-87.67149
TA1307000151,2,12,true,101,83,-18,41.88993,-87.63427
212,2,12,true,22,13,-9,41.88995,-87.63427
636,2,12,true,42,48,6,41.88997,-87.63662
KA1503000044,2,12,true,20,26,6,41.89018,-87.6262
196,2,12,true,12,11,-1,41.89053,-87.62205
13427,2,12,true,35,20,-15,41.89054,-87.62205
13430,2,12,true,61,71,10,41.89077,-87.63169
181,2,12,true,18,23,5,41.89077,-87.63168
TA1306000013,2,12,true,48,61,13,41.89083,-87.61852
RN-,2,12,true,63,59,-4,41.89102,-87.63546
672,2,12,true,11,6,-5,41.89102,-87.63545
13434,2,12,true,15,9,-6,41.89108,-87.66663
TA1308000006,2,12,true,22,20,-2,41.89128,-87.67686
199,2,12,true,20,24,4,41.89143,-87.62676
TA1307000117,2,12,true,81,101,20,41.89144,-87.62675
13033,2,12,true,56,66,10,41.8916,-87.64835
84,2,12,true,15,16,1,41.89161,-87.64833
13194,2,12,true,40,35,-5,41.8918,-87.65878
TA1305000003,2,12,true,73,48,-25,41.89187,-87.62061
24,2,12,true,14,16,2,41.8919,-87.62063
13022,2,12,true,61,83,22,41.89227,-87.61205
99,2,12,true,13,10,-3,41.89255,-87.61449
TA1306000029,2,12,true,35,47,12,41.89256,-87.61449
13265,2,12,true,81,64,-17,41.89383,-87.64172
74,2,12,true,25,18,-7,41.89384,-87.64173
13045,2,12,true,128,126,-2,41.89403,-87.62931
110,2,12,true,25,24,-1,41.89406,-87.6293
13016,2,12,true,131,144,13,41.89431,-87.62277
211,2,12,true,24,31,7,41.89439,-87.62267
KA1503000041,2,12,true,62,64,2,41.89452,-87.61798
142,2,12,true,18,10,-8,41.89453,-87.61806
13196,2,12,true,27,31,4,41.89455,-87.65345
TA1307000062,2,12,true,59,50,-9,41.89466,-87.63839
111,2,12,true,15,12,-3,41.89466,-87.63837
TA1306000012,2,12,true,122,99,-23,41.89475,-87.63438
53,2,12,true,32,13,-19,41.89476,-87.63439
627,2,12,true,11,9,-2,41.8948,-87.63231
KP1705001026,2,12,true,71,48,-23,41.89483,-87.6323
16920,2,12,true,19,21,2,41.89495,-87.76491
18058,2,12,true,18,11,-7,41.8955,-87.68201
637,2,12,true,26,17,-9,41.89563,-87.67209
13132,2,12,true,47,49,2,41.89573,-87.67718
161,2,12,true,12,9,-3,41.89574,-87.62599
15530,2,12,true,59,57,-2,41.89575,-87.62596
18003,2,12,true,52,53,1,41.89575,-87.62011
635,2,12,true,7,12,5,41.89576,-87.62012
13247,2,12,true,29,30,1,41.89597,-87.66775
TA1305000020,2,12,true,33,24,-9,41.89636,-87.65406
13289,2,12,true,25,18,-7,41.89638,-87.661
337,2,12,true,9,10,1,41.89659,-87.63096
13303,2,12,true,35,41,6,41.89672,-87.63088
13017,2,12,true,40,39,-1,41.89676,-87.6357
31,2,12,true,11,8,-3,41.89677,-87.63572
13338,2,12,true,69,50,-19,41.89697,-87.62173
173,2,12,true,5,13,8,41.89704,-87.62173
TA1307000061,2,12,true,42,48,6,41.89745,-87.62873
13034,2,12,true,29,33,4,41.89754,-87.62352
48,2,12,true,8,12,4,41.89772,-87.64302
TA1306000009,2,12,true,73,52,-21,41.89772,-87.64299
620,2,12,true,31,16,-15,41.89817,-87.63754
KA1504000103,2,12,true,22,17,-5,41.89842,-87.68659
145,2,12,true,13,13,0,41.89856,-87.62211
15529,2,12,true,73,60,-13,41.89858,-87.62206
140,2,12,true,14,15,1,41.89895,-87.6299
TA1307000128,2,12,true,59,78,19,41.89896,-87.6299
657,2,12,true,19,12,-7,41.89918,-87.6722
13248,2,12,true,36,25,-11,41.89964,-87.66788
TA1306000011,2,12,true,22,24,2,41.89994,-87.63443
KA1504000116,2,12,true,20,24,4,41.90023,-87.64299
17660,2,12,true,9,14,5,41.90036,-87.69671
13290,2,12,true,25,31,6,41.90069,-87.66259
29,2,12,true,4,11,7,41.90069,-87.66259
13042,2,12,true,79,75,-4,41.90097,-87.62377
85,2,12,true,11,17,6,41.90098,-87.62375
TA1307000070,2,12,true,8,14,6,41.90133,-87.67742
KA1504000133,2,12,true,63,73,10,41.90234,-87.62773
13241,2,12,true,25,17,-8,41.9029,-87.68731
176,2,12,true,22,31,9,41.90291,-87.63141
TA1306000006,2,12,true,11,14,3,41.90292,-87.63772
TA1307000039,2,12,true,101,101,0,41.90294,-87.63137
658,2,12,true,16,19,3,41.903,-87.6838
13256,2,12,true,19,9,-10,41.90302,-87.69749
TA1305000034,2,12,true,38,22,-16,41.90313,-87.67391
182,2,12,true,13,14,1,41.90317,-87.63442
KA1504000135,2,12,true,65,97,32,41.90319,-87.63439
13136,2,12,true,29,57,28,41.90326,-87.67845
210,2,12,true,7,11,4,41.90342,-87.66781
13061,2,12,true,60,58,-2,41.90342,-87.66779
KA1504000079,2,12,true,25,30,5,41.9035,-87.64334
TA1307000115,2,12,true,31,20,-11,41.9046,-87.64056
291,2,12,true,10,8,-2,41.90672,-87.63494
TA1308000049,2,12,true,53,45,-8,41.90672,-87.6349
KA1504000134,2,12,true,38,32,-6,41.90687,-87.6262
180,2,12,true,10,7,-3,41.90687,-87.62618
13224,2,12,true,33,21,-12,41.90706,-87.66725
333,2,12,true,9,11,2,41.90706,-87.66725
18069,2,12,true,15,4,-11,41.90722,-87.65563
TA1307000143,2,12,true,7,15,8,41.90762,-87.63854
13221,2,12,true,29,46,17,41.90765,-87.67254
13245,2,12,true,7,10,3,41.90777,-87.68586
301,2,12,true,18,10,-8,41.90796,-87.63203
TA1309000024,2,12,true,50,42,-8,41.908,-87.63152
69,2,12,true,11,4,-7,41.90939,-87.6777
TA1305000041,2,12,true,63,56,-7,41.9094,-87.67769
331,2,12,true,80,65,-15,41.90965,-87.64812
15653,2,12,true,11,9,-2,41.90979,-87.7053
TA1305000037,2,12,true,28,29,1,41.91018,-87.67003
TA1306000008,2,12,true,19,17,-2,41.9102,-87.6435
TA1308000005,2,12,true,20,17,-3,41.91042,-87.68238
13258,2,12,true,12,11,-1,41.91043,-87.69718
13257,2,12,true,19,10,-9,41.91054,-87.68956
13154,2,12,true,82,82,0,41.91054,-87.65312
20,2,12,true,16,15,-1,41.91055,-87.65313
60,2,12,true,6,10,4,41.91059,-87.64942
13058,2,12,true,38,42,4,41.91059,-87.64942
TA1307000038,2,12,true,21,36,15,41.91138,-87.63868
LF-005,2,12,true,82,58,-24,41.91172,-87.62681
268,2,12,true,11,6,-5,41.91172,-87.62681
13128,2,12,true,26,32,6,41.91197,-87.63197
289,2,12,true,18,23,5,41.91209,-87.63472
TA1308000050,2,12,true,110,124,14,41.91211,-87.6347
13243,2,12,true,43,42,-1,41.91262,-87.6814
158,2,12,true,15,23,8,41.91262,-87.6814
TA1306000032,2,12,true,68,55,-13,41.9137,-87.65285
93,2,12,true,8,16,8,41.91371,-87.65285
TA1307000166,2,12,true,37,31,-6,41.91386,-87.64877
15655,2,12,true,13,7,-6,41.91401,-87.70514
18017,2,12,true,12,9,-3,41.91416,-87.71676
18067,2,12,true,22,21,-1,41.9146,-87.66796
628,2,12,true,8,11,3,41.9146,-87.66796
28,2,12,true,13,9,-4,41.91469,-87.64333
TA1306000007,2,12,true,22,20,-2,41.91469,-87.64333
13068,2,12,true,37,40,3,41.91554,-87.68703
13179,2,12,true,54,58,4,41.9157,-87.63461
141,2,12,true,13,8,-5,41.91571,-87.63461
13133,2,12,true,42,28,-14,41.91598,-87.67733
TA1305000039,2,12,true,13,19,6,41.9163,-87.66749
15650,2,12,true,12,9,-3,41.91711,-87.71023
15651,2,12,true,13,19,6,41.91752,-87.70181
13266,2,12,true,12,15,3,41.91774,-87.69142
TA1309000029,2,12,true,15,16,1,41.9178,-87.68245
TA1309000006,2,12,true,23,27,4,41.91809,-87.64375
223,2,12,true,7,10,3,41.91821,-87.65698
TA1307000163,2,12,true,34,34,0,41.91821,-87.65696
94,2,12,true,9,15,6,41.91831,-87.6363
13146,2,12,true,56,62,6,41.91831,-87.63629
13059,2,12,true,40,72,32,41.91845,-87.65222
113,2,12,true,11,5,-6,41.91846,-87.65222
13259,2,12,true,9,17,8,41.91852,-87.69744
225,2,12,true,9,13,4,41.91995,-87.64884
13192,2,12,true,58,74,16,41.91995,-87.64884
13288,2,12,true,12,7,-5,41.92008,-87.67788
13242,2,12,true,11,8,-3,41.92021,-87.69266
TA1309000030,2,12,true,21,28,7,41.92077,-87.66372
TA1309000033,2,12,true,51,62,11,41.92158,-87.65381
13193,2,12,true,67,90,23,41.92182,-87.64412
144,2,12,true,17,12,-5,41.92182,-87.64411
13191,2,12,true,48,40,-8,41.92217,-87.63891
327,2,12,true,4,17,13,41.92225,-87.65783
13084,2,12,true,31,21,-10,41.92268,-87.69715
LP-,2,12,true,32,28,-4,41.92396,-87.63584
KA1504000140,2,12,true,7,12,5,41.92409,-87.67646
15648,2,12,true,5,12,7,41.92464,-87.68931
TA1307000001,2,12,true,53,51,-2,41.92535,-87.66581
TA1306000026,2,12,true,46,55,9,41.92558,-87.65842
TA1306000016,2,12,true,77,52,-25,41.9256,-87.65371
313,2,12,true,9,27,18,41.9257,-87.64246
TA1309000019,2,12,true,77,59,-18,41.92586,-87.63897
TA1309000058,2,12,true,66,80,14,41.92591,-87.64927
127,2,12,true,15,17,2,41.92592,-87.64927
177,2,12,true,14,16,2,41.92627,-87.63086
TA1308000001,2,12,true,83,99,16,41.92627,-87.63086
15646,2,12,true,13,12,-1,41.92668,-87.6977
13124,2,12,true,19,19,0,41.92675,-87.63444
TA1309000023,2,12,true,31,23,-8,41.9287,-87.65383
TA1307000113,2,12,true,17,27,10,41.92878,-87.66391
13296,2,12,true,22,13,-9,41.92883,-87.66852
TA1309000059,2,12,true,19,17,-2,41.92889,-87.65898
TA1309000061,2,12,true,63,56,-7,41.92915,-87.64909
TA1308000031,2,12,true,13,23,10,41.92946,-87.68417
340,2,12,true,8,11,3,41.92956,-87.64313
TA1305000014,2,12,true,61,73,12,41.92956,-87.64313
13085,2,12,true,22,15,-7,41.92958,-87.70789
TA1307000142,2,12,true,78,81,3,41.93125,-87.64432
220,2,12,true,14,16,2,41.93125,-87.64431
13276,2,12,true,39,32,-7,41.93132,-87.63874
324,2,12,true,4,11,7,41.93173,-87.64179
13271,2,12,true,12,18,6,41.93192,-87.67784
TA1307000064,2,12,true,49,39,-10,41.93222,-87.65864
TA1306000014,2,12,true,71,57,-14,41.93242,-87.65271
13,2,12,true,14,7,-7,41.93242,-87.65271
TA1309000039,2,12,true,63,44,-19,41.93258,-87.63642
13294,2,12,true,33,18,-15,41.9326,-87.66595
332,2,12,true,8,10,2,41.93313,-87.64776
TA1309000036,2,12,true,56,65,9,41.93313,-87.64776
TA1307000006,2,12,true,29,23,-6,41.93571,-87.6636
13268,2,12,true,35,15,-20,41.93588,-87.67843
13269,2,12,true,19,26,7,41.93609,-87.66983
TA1307000052,2,12,true,55,58,3,41.93628,-87.65266
115,2,12,true,9,13,4,41.93628,-87.65266
156,2,12,true,9,12,3,41.9365,-87.64756
TA1307000136,2,12,true,78,80,2,41.9365,-87.64755
TA1307000041,2,12,true,73,59,-14,41.93669,-87.63683
157,2,12,true,12,14,2,41.9367,-87.63683
13137,2,12,true,117,99,-18,41.9376,-87.6441
300,2,12,true,21,23,2,41.93761,-87.6441
154,2,12,true,7,10,3,41.93912,-87.66384
KA17018068,2,12,true,16,7,-9,41.93935,-87.68327
TA1309000042,2,12,true,32,46,14,41.93937,-87.66836
KA150400009X,2,12,true,3,11,8,41.9394,-87.71159
13229,2,12,true,21,29,8,41.93946,-87.66376
226,2,12,true,11,12,1,41.93972,-87.65886
TA1308000019,2,12,true,29,37,8,41.93973,-87.65886
13277,2,12,true,59,54,-5,41.9401,-87.64546
296,2,12,true,9,11,2,41.9401,-87.64546
TA1307000134,2,12,true,70,77,7,41.94016,-87.65303
117,2,12,true,19,13,-6,41.94016,-87.65302
13143,2,12,true,16,9,-7,41.94059,-87.67853
TA1309000049,2,12,true,75,60,-15,41.94077,-87.63919
TA1307000138,2,12,true,40,30,-10,41.94334,-87.67094
230,2,12,true,4,15,11,41.94335,-87.67093
13144,2,12,true,17,23,6,41.9434,-87.67964
299,2,12,true,11,7,-4,41.94368,-87.64894
TA1309000025,2,12,true,41,53,12,41.94368,-87.64894
13071,2,12,true,60,65,5,41.94373,-87.66401
632,2,12,true,62,64,2,41.94453,-87.6547
303,2,12,true,16,12,-4,41.94522,-87.64702
13278,2,12,true,67,59,-8,41.94553,-87.64644
TA1309000050,2,12,true,10,7,-3,41.94618,-87.67331
15632,2,12,true,23,8,-15,41.94664,-87.69463
13235,2,12,true,64,75,11,41.94814,-87.66396
304,2,12,true,26,17,-9,41.94878,-87.64922
13253,2,12,true,17,20,3,41.9488,-87.67527
13325,2,12,true,84,68,-16,41.94907,-87.64863
114,2,12,true,8,11,3,41.94935,-87.65451
TA1307000126,2,12,true,53,42,-11,41.94936,-87.65451
232,2,12,true,17,12,-5,41.94943,-87.64645
TA1307000150,2,12,true,78,51,-27,41.94945,-87.64646
13319,2,12,true,20,12,-8,41.95069,-87.6687
TA1307000127,2,12,true,55,39,-16,41.9508,-87.65918
15628,2,12,true,11,8,-3,41.95216,-87.69806
318,2,12,true,8,12,4,41.95254,-87.6735
13323,2,12,true,34,45,11,41.95282,-87.65
TA1309000043,2,12,true,30,23,-7,41.95417,-87.66434
13063,2,12,true,48,35,-13,41.95424,-87.65441
240,2,12,true,7,13,6,41.95424,-87.65441
254,2,12,true,13,16,3,41.95438,-87.64806
TA1308000022,2,12,true,47,50,3,41.95438,-87.64805
TA1307000149,2,12,true,17,23,6,41.95467,-87.67392
TA1309000026,2,12,true,14,27,13,41.95601,-87.6802
13249,2,12,true,12,10,-2,41.95606,-87.66885
13379,2,12,true,42,44,2,41.95786,-87.6495
TA1309000018,2,12,true,12,5,-7,41.95791,-87.67357
306,2,12,true,15,3,-12,41.9585,-87.655
TA1309000027,2,12,true,37,44,7,41.9585,-87.65499
13389,2,12,true,34,31,-3,41.961,-87.64958
15621,2,12,true,10,8,-2,41.96103,-87.70586
15622,2,12,true,9,10,1,41.96108,-87.69544
TA1307000144,2,12,true,15,24,9,41.96142,-87.6762
TA1309000021,2,12,true,23,16,-7,41.9615,-87.6714
15623,2,12,true,13,15,2,41.96154,-87.69117
KA1503000022,2,12,true,28,20,-8,41.96158,-87.66609
TA1307000107,2,12,true,48,56,8,41.96164,-87.65464
TA1307000156,2,12,true,19,26,7,41.96301,-87.68479
TA1309000012,2,12,true,8,14,6,41.96325,-87.67928
249,2,12,true,10,12,2,41.96398,-87.63818
TA1308000012,2,12,true,36,45,9,41.96398,-87.63818
13074,2,12,true,32,35,3,41.96521,-87.6582
639,2,12,true,31,27,-4,41.96584,-87.64538
KA1504000093,2,12,true,11,5,-6,41.96587,-87.69365
TA1307000140,2,12,true,24,25,1,41.96643,-87.68865
239,2,12,true,10,13,3,41.9665,-87.68843
326,2,12,true,13,15,2,41.96665,-87.67113
TA1309000014,2,12,true,42,38,-4,41.96709,-87.66744
TA1307000158,2,12,true,24,21,-3,41.9671,-87.67904
TA1307000119,2,12,true,22,15,-7,41.96796,-87.65
TA1308000021,2,12,true,18,24,6,41.96883,-87.65765
KA1504000080,2,12,true,10,14,4,41.96887,-87.69609
TA1309000015,2,12,true,15,10,-5,41.96889,-87.68401
344,2,12,true,8,11,3,41.9691,-87.67423
TA1309000066,2,12,true,32,39,7,41.9691,-87.67423
TA1309000041,2,12,true,11,20,9,41.96951,-87.65471
KA1504000171,2,12,true,26,33,7,41.97161,-87.65016
325,2,12,true,11,5,-6,41.9728,-87.67186
TA1309000035,2,12,true,33,37,4,41.97335,-87.66785
13108,2,12,true,34,24,-10,41.97379,-87.65971
KA1504000149,2,12,true,16,15,-1,41.97562,-87.67945
463,2,12,true,10,5,-5,41.978,-87.66805
KA1504000146,2,12,true,28,41,13,41.978,-87.66805
13109,2,12,true,37,36,-1,41.97835,-87.65976
KA1504000151,2,12,true,29,21,-8,41.98359,-87.66916
KA1504000152,2,12,true,51,41,-10,41.98403,-87.65231
459,2,12,true,12,10,-2,41.98403,-87.65231
15578,2,12,true,22,23,1,41.98405,-87.66027
15575,2,12,true,14,16,2,41.98975,-87.66014
KA1504000148,2,12,true,15,13,-2,41.99086,-87.66971
15571,2,12,true,15,12,-3,41.99478,-87.66028
KA1504000156,2,12,true,15,11,-4,41.99925,-87.67137
RP-009,2,12,true,34,26,-8,42.00107,-87.66122
RP-008,2,12,true,11,8,-3,42.00446,-87.6724
660,2,12,true,20,8,-12,42.00458,-87.66143
KA1504000175,2,12,true,13,11,-2,42.00797,-87.66549
KA1504000162,2,12,true,11,5,-6,42.00907,-87.67422
520,2,12,true,18,17,-1,42.01597,-87.66859
523,2,12,true,13,10,-3,42.02089,-87.66505
E002,2,12,true,14,12,-2,42.03256,-87.67912
596,2,12,true,33,22,-11,42.04822,-87.68348
E008,2,12,true,9,14,5,42.05049,-87.67782
605,2,12,true,18,19,1,42.05294,-87.67342
604,2,12,true,24,31,7,42.05824,-87.67744
E014,2,12,true,13,5,-8,42.06483,-87.71531
KA1503000002,2,16,false,8,14,6,41.76641,-87.5657
15491,2,16,false,19,11,-8,41.78096,-87.57624
KA1503000014,2,16,false,31,29,-2,41.7851,-87.60108
KA1503000070,2,16,false,5,11,6,41.78794,-87.58831
TA1309000011,2,16,false,26,9,-17,41.78873,-87.60131
KA1503000071,2,16,false,53,30,-23,41.79148,-87.59988
KA1503000074,2,16,false,33,25,-8,41.79174,-87.58395
TA1309000063,2,16,false,25,28,3,41.79325,-87.5878
KA1504000076,2,16,false,20,9,-11,41.7943,-87.60145
247,2,16,false,11,6,-5,41.79522,-87.58077
TA1308000009,2,16,false,75,61,-14,41.79522,-87.58075
TA1307000164,2,16,false,19,16,-3,41.79527,-87.59647
248,2,16,false,3,10,7,41.79528,-87.59647
KA1503000052,2,16,false,17,11,-6,41.79935,-87.60097
KA1503000059,2,16,false,25,16,-9,41.79952,-87.58643
TA1309000037,2,16,false,38,33,-5,41.79957,-87.59474
KA1503000007,2,16,false,33,28,-5,41.80242,-87.58689
13398,2,16,false,16,20,4,41.80256,-87.59035
TA1308000035,2,16,false,17,12,-5,41.80944,-87.59188
TA1308000002,2,16,false,7,11,4,41.80983,-87.59937
TA1308000007,2,16,false,16,4,-12,41.80984,-87.61628
KA1503000065,2,16,false,8,17,9,41.81409,-87.59701
TA1308000023,2,16,false,12,5,-7,41.81649,-87.60659
TA1308000038,2,16,false,10,10,0,41.82298,-87.6071
KA1503000066,2,16,false,10,1,-9,41.83011,-87.67031
KA1503000004,2,16,false,27,18,-9,41.83127,-87.6088
13345,2,16,false,3,17,14,41.83138,-87.61803
13216,2,16,false,16,11,-5,41.83473,-87.62581
TA1309000055,2,16,false,7,12,5,41.8382,-87.64514
TA1307000048,2,16,false,48,57,9,41.83855,-87.60821
TA1307000139,2,16,false,17,6,-11,41.84205,-87.61698
15443,2,16,false,10,10,0,41.84275,-87.63549
TA1307000005,2,16,false,4,11,7,41.84569,-87.6225
TA1308000026,2,16,false,14,6,-8,41.85008,-87.63214
TA1305000004,2,16,false,15,17,2,41.8514,-87.61884
TA1305000001,2,16,false,16,24,8,41.85262,-87.6265
13075,2,16,false,36,40,4,41.8531,-87.63192
15546,2,16,false,5,13,8,41.85416,-87.61916
15545,2,16,false,33,37,4,41.85627,-87.61334
SL-013,2,16,false,14,7,-7,41.85659,-87.62755
SL-006,2,16,false,15,9,-6,41.8568,-87.63387
13135,2,16,false,16,17,1,41.85753,-87.66157
13102,2,16,false,13,20,7,41.85762,-87.61942
13150,2,16,false,25,34,9,41.85783,-87.62455
13099,2,16,false,11,8,-3,41.85784,-87.64627
TA1307000159,2,16,false,13,15,2,41.8579,-87.6687
13163,2,16,false,8,23,15,41.85808,-87.65108
13164,2,16,false,16,28,12,41.85818,-87.65648
SL-012,2,16,false,17,28,11,41.86038,-87.62581
TA1306000002,2,16,false,11,6,-5,41.86238,-87.65108
TA1307000124,2,16,false,47,41,-6,41.86411,-87.62372
TA1309000001,2,16,false,17,26,9,41.86488,-87.64708
13165,2,16,false,8,11,3,41.86505,-87.65697
13029,2,16,false,81,16,-65,41.86531,-87.6179
13431,2,16,false,97,81,-16,41.8661,-87.60728
WL-008,2,16,false,22,26,4,41.86712,-87.64108
59,2,16,false,9,11,2,41.86721,-87.62597
TA1305000002,2,16,false,54,92,38,41.86721,-87.62597
15544,2,16,false,240,110,-130,41.86723,-87.61536
3,2,16,false,28,11,-17,41.86723,-87.61536
TA1305000017,2,16,false,13,5,-8,41.86734,-87.64863
KA1706005007,2,16,false,11,23,12,41.86749,-87.63219
SL-005,2,16,false,161,130,-31,41.8679,-87.62304
255,2,16,false,11,20,9,41.86791,-87.62304
644,2,16,false,10,10,0,41.86859,-87.68625
13139,2,16,false,5,13,8,41.86893,-87.65913
13285,2,16,false,26,4,-22,41.86928,-87.67372
13160,2,16,false,14,19,5,41.86947,-87.65548
15550,2,16,false,14,15,1,41.87024,-87.63947
TA1309000010,2,16,false,58,47,-11,41.87074,-87.62574
SL-009,2,16,false,15,20,5,41.87081,-87.63121
TA1309000064,2,16,false,37,11,-26,41.87127,-87.67369
15542,2,16,false,2,11,9,41.87146,-87.64095
TA1307000130,2,16,false,8,18,10,41.87178,-87.65103
TA1307000121,2,16,false,37,21,-16,41.87184,-87.64664
41,2,16,false,6,13,7,41.87209,-87.62957
SL-008,2,16,false,48,63,15,41.87209,-87.62956
13332,2,16,false,13,22,9,41.87219,-87.6615
394,2,16,false,3,10,7,41.87226,-87.63484
SL-011,2,16,false,35,59,24,41.87256,-87.63356
623,2,16,false,95,107,12,41.87272,-87.62399
KA1504000104,2,16,false,34,7,-27,41.87296,-87.66912
383,2,16,false,12,2,-10,41.87297,-87.66912
SL-007,2,16,false,34,33,-1,41.87404,-87.6277
13326,2,16,false,13,10,-3,41.87425,-87.63958
321,2,16,false,11,6,-5,41.87427,-87.63257
13028,2,16,false,22,12,-10,41.87475,-87.64981
SL-010,2,16,false,26,17,-9,41.87501,-87.63309
15541,2,16,false,103,69,-34,41.8758,-87.62086
13037,2,16,false,18,11,-7,41.87588,-87.64078
TA1305000009,2,16,false,17,14,-3,41.87593,-87.63068
TA1305000010,2,16,false,26,40,14,41.87623,-87.62444
624,2,16,false,42,38,-4,41.87626,-87.62923
2,2,16,false,10,7,-3,41.87649,-87.62051
TA1305000035,2,16,false,39,30,-9,41.87716,-87.62787
13138,2,16,false,29,6,-23,41.87723,-87.63941
15539,2,16,false,27,19,-8,41.87763,-87.64405
13158,2,16,false,44,24,-20,41.87764,-87.64957
13157,2,16,false,22,22,0,41.87773,-87.6548
TA1305000025,2,16,false,88,30,-58,41.87773,-87.63528
TA1309000002,2,16,false,45,50,5,41.87784,-87.62408
13206,2,16,false,16,11,-5,41.87794,-87.66201
TA1309000004,2,16,false,38,20,-18,41.87811,-87.63184
638,2,16,false,37,44,7,41.87827,-87.64078
TA1305000005,2,16,false,46,20,-26,41.87924,-87.62975
13011,2,16,false,65,58,-7,41.87931,-87.63993
TA1309000008,2,16,false,35,37,2,41.87933,-87.6355
KA1503000034,2,16,false,52,12,-40,41.87938,-87.63197
KA1503000015,2,16,false,48,31,-17,41.87948,-87.6257
287,2,16,false,17,1,-16,41.88017,-87.63527
TA1309000007,2,16,false,82,38,-44,41.88022,-87.63526
WL-011,2,16,false,30,36,6,41.88034,-87.64273
13156,2,16,false,21,31,10,41.88042,-87.65554
13300,2,16,false,232,241,9,41.88097,-87.61675
76,2,16,false,13,30,17,41.88098,-87.61675
13008,2,16,false,187,205,18,41.88105,-87.62408
90,2,16,false,27,19,-8,41.88107,-87.62409
49,2,16,false,12,8,-4,41.88116,-87.62963
TA1305000006,2,16,false,95,32,-63,41.88122,-87.6296
13134,2,16,false,15,13,-2,41.88138,-87.67493
13056,2,16,false,39,29,-10,41.88168,-87.63951
TA1307000120,2,16,false,65,75,10,41.88188,-87.64879
13341,2,16,false,70,47,-23,41.88208,-87.63985
13036,2,16,false,61,48,-13,41.8821,-87.62513
77,2,16,false,11,5,-6,41.88214,-87.64108
TA1305000032,2,16,false,90,45,-45,41.88218,-87.64109
13006,2,16,false,40,18,-22,41.88268,-87.63252
13353,2,16,false,20,24,4,41.88283,-87.6612
654,2,16,false,11,17,6,41.88307,-87.65698
13409,2,16,false,30,34,4,41.8831,-87.6511
18,2,16,false,11,1,-10,41.88317,-87.63735
KA1503000072,2,16,false,66,15,-51,41.88317,-87.63693
WL-012,2,16,false,88,64,-24,41.88337,-87.6412
13053,2,16,false,43,52,9,41.88365,-87.64863
43,2,16,false,11,6,-5,41.88396,-87.62455
13001,2,16,false,105,105,0,41.88397,-87.62459
13155,2,16,false,25,13,-12,41.88407,-87.65689
18062,2,16,false,32,37,5,41.88412,-87.65427
81,2,16,false,19,9,-10,41.88417,-87.6296
TA1306000010,2,16,false,71,61,-10,41.88419,-87.62961
TA1305000030,2,16,false,66,38,-28,41.88459,-87.63178
15535,2,16,false,38,40,2,41.8846,-87.64455
TA1305000029,2,16,false,73,87,14,41.88466,-87.62787
13263,2,16,false,97,75,-22,41.88467,-87.61952
44,2,16,false,10,10,0,41.88468,-87.62782
TA1306000015,2,16,false,63,61,-2,41.88549,-87.65232
13021,2,16,false,44,32,-12,41.88559,-87.64184
TA1307000111,2,16,false,79,41,-38,41.88582,-87.63548
13073,2,16,false,16,18,2,41.88592,-87.66717
KA17018054,2,16,false,16,6,-10,41.88595,-87.67701
38,2,16,false,10,2,-8,41.88599,-87.63089
KA1503000012,2,16,false,56,56,0,41.88599,-87.63089
52,2,16,false,15,16,1,41.886,-87.62421
TA1305000011,2,16,false,110,104,-6,41.886,-87.62418
15534,2,16,false,47,46,-1,41.88627,-87.61749
217,2,16,false,11,1,-10,41.8866,-87.65821
13197,2,16,false,26,10,-16,41.8866,-87.65816
TA1308000029,2,16,false,32,30,-2,41.88673,-87.62225
TA1307000131,2,16,false,88,108,20,41.88688,-87.62606
KA1503000064,2,16,false,108,111,3,41.88697,-87.61281
TA1305000022,2,16,false,71,36,-35,41.88817,-87.63656
56,2,16,false,7,10,3,41.88866,-87.64442
TA1306000003,2,16,false,65,81,16,41.88867,-87.64442
133,2,16,false,10,4,-6,41.88918,-87.63851
KA1503000043,2,16,false,81,80,-1,41.88918,-87.63851
13050,2,16,false,67,46,-21,41.88919,-87.62775
47,2,16,false,18,16,-2,41.88921,-87.62775
15664,2,16,false,12,3,-9,41.8895,-87.68821
13432,2,16,false,10,11,1,41.88989,-87.67149
TA1307000151,2,16,false,80,66,-14,41.88993,-87.63427
636,2,16,false,23,23,0,41.88997,-87.63662
KA1503000044,2,16,false,47,23,-24,41.89018,-87.6262
196,2,16,false,5,10,5,41.89053,-87.62205
13427,2,16,false,62,63,1,41.89054,-87.62205
26,2,16,false,9,10,1,41.89057,-87.61798
13430,2,16,false,63,91,28,41.89077,-87.63169
181,2,16,false,11,11,0,41.89077,-87.63168
TA1306000013,2,16,false,88,97,9,41.89083,-87.61852
RN-,2,16,false,43,45,2,41.89102,-87.63546
13434,2,16,false,23,13,-10,41.89108,-87.66663
TA1308000006,2,16,false,16,10,-6,41.89128,-87.67686
199,2,16,false,15,12,-3,41.89143,-87.62676
TA1307000117,2,16,false,92,90,-2,41.89144,-87.62675
13033,2,16,false,60,66,6,41.8916,-87.64835
13194,2,16,false,22,26,4,41.8918,-87.65878
TA1305000003,2,16,false,66,76,10,41.89187,-87.62061
35,2,16,false,34,36,2,41.89227,-87.61206
13022,2,16,false,526,576,50,41.89227,-87.61205
99,2,16,false,23,4,-19,41.89255,-87.61449
TA1306000029,2,16,false,80,90,10,41.89256,-87.61449
13265,2,16,false,65,62,-3,41.89383,-87.64172
13045,2,16,false,71,82,11,41.89403,-87.62931
110,2,16,false,7,11,4,41.89406,-87.6293
13016,2,16,false,83,69,-14,41.89431,-87.62277
211,2,16,false,15,5,-10,41.89439,-87.62267
KA1503000041,2,16,false,43,38,-5,41.89452,-87.61798
13196,2,16,false,32,33,1,41.89455,-87.65345
TA1307000062,2,16,false,37,23,-14,41.89466,-87.63839
TA1306000012,2,16,false,74,78,4,41.89475,-87.63438
53,2,16,false,13,13,0,41.89476,-87.63439
KP1705001026,2,16,false,45,40,-5,41.89483,-87.6323
18058,2,16,false,15,15,0,41.8955,-87.68201
637,2,16,false,17,28,11,41.89563,-87.67209
13132,2,16,false,20,28,8,41.89573,-87.67718
161,2,16,false,11,5,-6,41.89574,-87.62599
15530,2,16,false,58,53,-5,41.89575,-87.62596
18003,2,16,false,36,16,-20,41.89575,-87.62011
13247,2,16,false,24,40,16,41.89597,-87.66775
TA1305000020,2,16,false,28,33,5,41.89636,-87.65406
13289,2,16,false,36,27,-9,41.89638,-87.661
13303,2,16,false,44,35,-9,41.89672,-87.63088
13017,2,16,false,44,29,-15,41.89676,-87.6357
31,2,16,false,7,10,3,41.89677,-87.63572
13338,2,16,false,43,50,7,41.89697,-87.62173
TA1307000061,2,16,false,20,15,-5,41.89745,-87.62873
13034,2,16,false,92,63,-29,41.89754,-87.62352
TA1306000009,2,16,false,53,37,-16,41.89772,-87.64299
620,2,16,false,36,41,5,41.89817,-87.63754
KA1504000103,2,16,false,20,23,3,41.89842,-87.68659
145,2,16,false,19,5,-14,41.89856,-87.62211
15529,2,16,false,57,56,-1,41.89858,-87.62206
140,2,16,false,10,18,8,41.89895,-87.6299
TA1307000128,2,16,false,88,89,1,41.89896,-87.6299
657,2,16,false,26,16,-10,41.89918,-87.6722
KA1504000117,2,16,false,10,6,-4,41.89936,-87.64848
13248,2,16,false,20,21,1,41.89964,-87.66788
TA1306000011,2,16,false,11,14,3,41.89994,-87.63443
KA1504000116,2,16,false,27,23,-4,41.90023,-87.64299
17660,2,16,false,15,15,0,41.90036,-87.69671
13290,2,16,false,27,20,-7,41.90069,-87.66259
13042,2,16,false,218,269,51,41.90097,-87.62377
85,2,16,false,15,26,11,41.90098,-87.62375
TA1307000070,2,16,false,24,13,-11,41.90133,-87.67742
KA1504000133,2,16,false,60,80,20,41.90234,-87.62773
172,2,16,false,11,6,-5,41.90236,-87.62774
13241,2,16,false,15,19,4,41.9029,-87.68731
176,2,16,false,13,19,6,41.90291,-87.63141
TA1306000006,2,16,false,9,11,2,41.90292,-87.63772
TA1307000039,2,16,false,103,139,36,41.90294,-87.63137
658,2,16,false,16,7,-9,41.903,-87.6838
13256,2,16,false,18,10,-8,41.90302,-87.69749
TA1305000034,2,16,false,35,30,-5,41.90313,-87.67391
182,2,16,false,10,12,2,41.90317,-87.63442
KA1504000135,2,16,false,115,106,-9,41.90319,-87.63439
13136,2,16,false,17,27,10,41.90326,-87.67845
13061,2,16,false,80,68,-12,41.90342,-87.66779
KA1504000079,2,16,false,38,46,8,41.9035,-87.64334
TA1307000115,2,16,false,12,21,9,41.9046,-87.64056
291,2,16,false,11,19,8,41.90672,-87.63494
TA1308000049,2,16,false,76,69,-7,41.90672,-87.6349
KA1504000134,2,16,false,59,42,-17,41.90687,-87.6262
13224,2,16,false,42,26,-16,41.90706,-87.66725
18069,2,16,false,19,7,-12,41.90722,-87.65563
TA1307000143,2,16,false,16,9,-7,41.90762,-87.63854
13221,2,16,false,40,54,14,41.90765,-87.67254
13245,2,16,false,10,7,-3,41.90777,-87.68586
TA1309000024,2,16,false,59,56,-3,41.908,-87.63152
TA1305000041,2,16,false,36,48,12,41.9094,-87.67769
331,2,16,false,57,56,-1,41.90965,-87.64812
15653,2,16,false,8,13,5,41.90979,-87.7053
TA1305000037,2,16,false,41,28,-13,41.91018,-87.67003
TA1306000008,2,16,false,14,14,0,41.9102,-87.6435
TA1308000005,2,16,false,22,18,-4,41.91042,-87.68238
13258,2,16,false,10,11,1,41.91043,-87.69718
13257,2,16,false,11,21,10,41.91054,-87.68956
13154,2,16,false,43,41,-2,41.91054,-87.65312
13058,2,16,false,30,23,-7,41.91059,-87.64942
118,2,16,false,10,7,-3,41.91138,-87.63868
TA1307000038,2,16,false,41,39,-2,41.91138,-87.63868
LF-005,2,16,false,186,170,-16,41.91172,-87.62681
268,2,16,false,11,10,-1,41.91172,-87.62681
13128,2,16,false,48,28,-20,41.91197,-87.63197
289,2,16,false,9,13,4,41.91209,-87.63472
TA1308000050,2,16,false,92,108,16,41.91211,-87.6347
13243,2,16,false,41,33,-8,41.91262,-87.6814
TA1309000032,2,16,false,15,5,-10,41.91293,-87.66417
TA1306000032,2,16,false,23,28,5,41.9137,-87.65285
TA1307000166,2,16,false,27,26,-1,41.91386,-87.64877
15655,2,16,false,13,18,5,41.91401,-87.70514
18017,2,16,false,11,19,8,41.91416,-87.71676
18067,2,16,false,24,16,-8,41.9146,-87.66796
13068,2,16,false,20,19,-1,41.91554,-87.68703
13179,2,16,false,107,88,-19,41.9157,-87.63461
13133,2,16,false,26,20,-6,41.91598,-87.67733
TA1305000039,2,16,false,29,40,11,41.9163,-87.66749
15650,2,16,false,10,11,1,41.91711,-87.71023
15651,2,16,false,31,17,-14,41.91752,-87.70181
13266,2,16,false,11,8,-3,41.91774,-87.69142
TA1309000029,2,16,false,10,17,7,41.9178,-87.68245
TA1309000006,2,16,false,25,31,6,41.91809,-87.64375
TA1307000163,2,16,false,30,38,8,41.91821,-87.65696
94,2,16,false,20,11,-9,41.91831,-87.6363
13146,2,16,false,115,81,-34,41.91831,-87.63629
13059,2,16,false,45,54,9,41.91845,-87.65222
113,2,16,false,7,11,4,41.91846,-87.65222
13192,2,16,false,32,63,31,41.91995,-87.64884
13288,2,16,false,11,17,6,41.92008,-87.67788
13242,2,16,false,14,13,-1,41.92021,-87.69266
TA1309000030,2,16,false,26,21,-5,41.92077,-87.66372
13292,2,16,false,14,11,-3,41.92152,-87.70733
TA1309000033,2,16,false,37,29,-8,41.92158,-87.65381
13193,2,16,false,83,67,-16,41.92182,-87.64412
144,2,16,false,7,19,12,41.92182,-87.64411
13191,2,16,false,56,34,-22,41.92217,-87.63891
13084,2,16,false,33,25,-8,41.92268,-87.69715
LP-,2,16,false,67,45,-22,41.92396,-87.63584
KA1504000140,2,16,false,12,23,11,41.92409,-87.67646
15648,2,16,false,13,3,-10,41.92464,-87.68931
KA1504000090,2,16,false,11,11,0,41.92483,-87.7145
TA1307000001,2,16,false,48,48,0,41.92535,-87.66581
TA1306000026,2,16,false,22,35,13,41.92558,-87.65842
TA1306000016,2,16,false,47,40,-7,41.9256,-87.65371
313,2,16,false,4,13,9,41.9257,-87.64246
TA1309000019,2,16,false,76,71,-5,41.92586,-87.63897
TA1309000058,2,16,false,43,66,23,41.92591,-87.64927
177,2,16,false,28,18,-10,41.92627,-87.63086
TA1308000001,2,16,false,152,160,8,41.92627,-87.63086
15646,2,16,false,7,12,5,41.92668,-87.6977
13124,2,16,false,42,37,-5,41.92675,-87.63444
TA1309000023,2,16,false,44,34,-10,41.9287,-87.65383
TA1307000113,2,16,false,15,19,4,41.92878,-87.66391
13296,2,16,false,22,18,-4,41.92883,-87.66852
TA1309000059,2,16,false,22,12,-10,41.92889,-87.65898
349,2,16,false,12,4,-8,41.92915,-87.6491
TA1309000061,2,16,false,44,41,-3,41.92915,-87.64909
TA1308000031,2,16,false,13,26,13,41.92946,-87.68417
TA1305000014,2,16,false,71,65,-6,41.92956,-87.64313
13085,2,16,false,39,38,-1,41.92958,-87.70789
15643,2,16,false,7,11,4,41.93057,-87.7238
TA1307000142,2,16,false,62,48,-14,41.93125,-87.64432
220,2,16,false,10,15,5,41.93125,-87.64431
13276,2,16,false,54,45,-9,41.93132,-87.63874
324,2,16,false,7,10,3,41.93173,-87.64179
13271,2,16,false,15,12,-3,41.93192,-87.67784
TA1307000064,2,16,false,44,34,-10,41.93222,-87.65864
13,2,16,false,5,14,9,41.93242,-87.65271
TA1306000014,2,16,false,46,64,18,41.93242,-87.65271
329,2,16,false,12,11,-1,41.93258,-87.63642
TA1309000039,2,16,false,87,93,6,41.93258,-87.63642
13294,2,16,false,20,22,2,41.9326,-87.66595
TA1309000036,2,16,false,30,41,11,41.93313,-87.64776
TA1307000006,2,16,false,28,21,-7,41.93571,-87.6636
13268,2,16,false,16,7,-9,41.93588,-87.67843
13269,2,16,false,12,13,1,41.93609,-87.66983
TA1307000052,2,16,false,49,45,-4,41.93628,-87.65266
156,2,16,false,16,7,-9,41.9365,-87.64756
TA1307000136,2,16,false,50,43,-7,41.9365,-87.64755
TA1307000041,2,16,false,78,79,1,41.93669,-87.63683
13137,2,16,false,61,83,22,41.9376,-87.6441
300,2,16,false,13,10,-3,41.93761,-87.6441
15642,2,16,false,8,15,7,41.93843,-87.69801
KA17018068,2,16,false,13,9,-4,41.93935,-87.68327
TA1309000042,2,16,false,30,39,9,41.93937,-87.66836
13229,2,16,false,31,19,-12,41.93946,-87.66376
TA1308000019,2,16,false,29,26,-3,41.93973,-87.65886
13277,2,16,false,22,35,13,41.9401,-87.64546
TA1307000134,2,16,false,74,43,-31,41.94016,-87.65303
117,2,16,false,12,5,-7,41.94016,-87.65302
13143,2,16,false,15,9,-6,41.94059,-87.67853
334,2,16,false,11,11,0,41.94076,-87.63919
TA1309000049,2,16,false,73,80,7,41.94077,-87.63919
15634,2,16,false,9,12,3,41.94304,-87.68729
TA1307000138,2,16,false,31,25,-6,41.94334,-87.67094
13144,2,16,false,19,9,-10,41.9434,-87.67964
TA1309000025,2,16,false,53,56,3,41.94368,-87.64894
229,2,16,false,5,11,6,41.94372,-87.66401
13071,2,16,false,37,49,12,41.94373,-87.66401
632,2,16,false,67,74,7,41.94453,-87.6547
303,2,16,false,7,15,8,41.94522,-87.64702
13278,2,16,false,59,52,-7,41.94553,-87.64644
TA1309000050,2,16,false,11,6,-5,41.94618,-87.67331
13235,2,16,false,46,43,-3,41.94814,-87.66396
304,2,16,false,4,14,10,41.94878,-87.64922
13253,2,16,false,11,13,2,41.9488,-87.67527
13325,2,16,false,49,66,17,41.94907,-87.64863
TA1307000126,2,16,false,44,86,42,41.94936,-87.65451
TA1307000150,2,16,false,41,56,15,41.94945,-87.64646
13319,2,16,false,14,21,7,41.95069,-87.6687
TA1307000127,2,16,false,39,51,12,41.9508,-87.65918
15628,2,16,false,10,5,-5,41.95216,-87.69806
13323,2,16,false,34,20,-14,41.95282,-87.65
TA1309000043,2,16,false,9,20,11,41.95417,-87.66434
13063,2,16,false,22,36,14,41.95424,-87.65441
254,2,16,false,4,12,8,41.95438,-87.64806
TA1308000022,2,16,false,44,42,-2,41.95438,-87.64805
TA1309000026,2,16,false,16,11,-5,41.95601,-87.6802
13249,2,16,false,10,6,-4,41.95606,-87.66885
13379,2,16,false,29,36,7,41.95786,-87.6495
TA1309000027,2,16,false,18,13,-5,41.9585,-87.65499
13389,2,16,false,29,34,5,41.961,-87.64958
TA1307000144,2,16,false,11,4,-7,41.96142,-87.6762
KA1503000022,2,16,false,19,9,-10,41.96158,-87.66609
231,2,16,false,11,8,-3,41.96163,-87.65464
TA1307000107,2,16,false,41,43,2,41.96164,-87.65464
TA1309000012,2,16,false,10,7,-3,41.96325,-87.67928
TA1308000012,2,16,false,91,85,-6,41.96398,-87.63818
249,2,16,false,10,7,-3,41.96398,-87.63818
13074,2,16,false,29,23,-6,41.96521,-87.6582
639,2,16,false,29,34,5,41.96584,-87.64538
TA1307000140,2,16,false,8,12,4,41.96643,-87.68865
TA1309000014,2,16,false,18,21,3,41.96709,-87.66744
TA1307000158,2,16,false,11,7,-4,41.9671,-87.67904
TA1307000119,2,16,false,22,25,3,41.96796,-87.65
TA1308000021,2,16,false,20,15,-5,41.96883,-87.65765
KA1504000080,2,16,false,9,10,1,41.96887,-87.69609
TA1309000066,2,16,false,26,18,-8,41.9691,-87.67423
TA1309000041,2,16,false,15,15,0,41.96951,-87.65471
KA1504000171,2,16,false,58,37,-21,41.97161,-87.65016
TA1309000035,2,16,false,30,25,-5,41.97335,-87.66785
13108,2,16,false,28,28,0,41.97379,-87.65971
KA1504000078,2,16,false,10,7,-3,41.97491,-87.69258
KA1504000146,2,16,false,32,22,-10,41.978,-87.66805
13109,2,16,false,18,22,4,41.97835,-87.65976
KA1504000151,2,16,false,22,24,2,41.98359,-87.66916
15585,2,16,false,12,2,-10,41.98367,-87.69642
KA1504000152,2,16,false,70,57,-13,41.98403,-87.65231
459,2,16,false,12,12,0,41.98403,-87.65231
15578,2,16,false,25,19,-6,41.98405,-87.66027
15575,2,16,false,21,21,0,41.98975,-87.66014
15571,2,16,false,34,20,-14,41.99478,-87.66028
RP-009,2,16,false,17,17,0,42.00107,-87.66122
660,2,16,false,17,16,-1,42.00458,-87.66143
520,2,16,false,12,4,-8,42.01597,-87.66859
E002,2,16,false,13,11,-2,42.03256,-87.67912
596,2,16,false,13,31,18,42.04822,-87.68348
E008,2,16,false,23,13,-10,42.05049,-87.67782
605,2,16,false,10,14,4,42.05294,-87.67342
661,2,16,false,9,13,4,42.05704,-87.68657
604,2,16,false,24,18,-6,42.05824,-87.67744
426,2,16,true,21,22,1,41.7851,-87.60108
KA1503000014,2,16,true,67,120,53,41.7851,-87.60108
KA1503000070,2,16,true,17,16,-1,41.78794,-87.58831
328,2,16,true,21,9,-12,41.78872,-87.6013
TA1309000011,2,16,true,78,20,-58,41.78873,-87.60131
KA1503000071,2,16,true,166,53,-113,41.79148,-87.59988
423,2,16,true,16,9,-7,41.79148,-87.59988
KA1503000074,2,16,true,16,28,12,41.79174,-87.58395
TA1309000063,2,16,true,34,56,22,41.79325,-87.5878
345,2,16,true,11,10,-1,41.79326,-87.5878
420,2,16,true,9,19,10,41.79429,-87.60145
KA1504000076,2,16,true,93,54,-39,41.7943,-87.60145
TA1307000160,2,16,true,4,13,9,41.79485,-87.61873
247,2,16,true,17,18,1,41.79522,-87.58077
TA1308000009,2,16,true,58,62,4,41.79522,-87.58075
TA1307000164,2,16,true,30,43,13,41.79527,-87.59647
248,2,16,true,10,14,4,41.79528,-87.59647
KA1503000052,2,16,true,23,45,22,41.79935,-87.60097
KA1503000059,2,16,true,19,36,17,41.79952,-87.58643
TA1309000037,2,16,true,58,72,14,41.79957,-87.59474
15470,2,16,true,10,2,-8,41.80228,-87.61807
417,2,16,true,4,10,6,41.80242,-87.5869
KA1503000007,2,16,true,32,45,13,41.80242,-87.58689
13398,2,16,true,26,24,-2,41.80256,-87.59035
322,2,16,true,16,17,1,41.80321,-87.59849
TA1308000035,2,16,true,11,12,1,41.80944,-87.59188
TA1308000002,2,16,true,12,14,2,41.80983,-87.59937
KA1503000032,2,16,true,12,12,0,41.81912,-87.64328
KA1503000068,2,16,true,7,34,27,41.82878,-87.68062
TA1308000045,2,16,true,17,18,1,41.83062,-87.64129
TA1308000043,2,16,true,12,12,0,41.83066,-87.64715
15446,2,16,true,10,10,0,41.83068,-87.65603
184,2,16,true,16,1,-15,41.83104,-87.62684
TA1307000129,2,16,true,72,12,-60,41.83104,-87.62683
KA1503000004,2,16,true,10,10,0,41.83127,-87.6088
13345,2,16,true,10,11,1,41.83138,-87.61803
15445,2,16,true,10,12,2,41.83453,-87.63183
13216,2,16,true,85,48,-37,41.83473,-87.62581
148,2,16,true,10,5,-5,41.83474,-87.62581
149,2,16,true,10,5,-5,41.83486,-87.61791
13217,2,16,true,33,33,0,41.83488,-87.61792
13215,2,16,true,14,11,-3,41.83634,-87.6135
TA1308000046,2,16,true,15,24,9,41.83779,-87.65115
TA1309000055,2,16,true,27,37,10,41.8382,-87.64514
KA1503000038,2,16,true,17,14,-3,41.83845,-87.6354
TA1307000048,2,16,true,39,31,-8,41.83855,-87.60821
TA1308000036,2,16,true,7,25,18,41.83883,-87.62186
15442,2,16,true,15,10,-5,41.83918,-87.66562
TA1307000139,2,16,true,52,42,-10,41.84205,-87.61698
15443,2,16,true,10,2,-8,41.84275,-87.63549
TA1307000153,2,16,true,7,52,45,41.84358,-87.64538
147,2,16,true,13,9,-4,41.84569,-87.62251
TA1307000005,2,16,true,39,35,-4,41.84569,-87.6225
TA1308000013,2,16,true,13,12,-1,41.84719,-87.64681
15689,2,16,true,4,17,13,41.84912,-87.69515
TA1308000014,2,16,true,12,3,-9,41.84953,-87.64059
TA1308000026,2,16,true,16,7,-9,41.85008,-87.63214
TA1305000001,2,16,true,11,20,9,41.85262,-87.6265
13075,2,16,true,35,36,1,41.8531,-87.63192
15546,2,16,true,26,23,-3,41.85416,-87.61916
13307,2,16,true,12,11,-1,41.85489,-87.66359
13331,2,16,true,21,20,-1,41.85515,-87.65414
15545,2,16,true,85,77,-8,41.85627,-87.61334
4,2,16,true,12,10,-2,41.85627,-87.61334
SL-013,2,16,true,19,28,9,41.85659,-87.62755
SL-006,2,16,true,10,9,-1,41.8568,-87.63387
13135,2,16,true,29,35,6,41.85753,-87.66157
338,2,16,true,8,19,11,41.85758,-87.61956
13102,2,16,true,42,66,24,41.85762,-87.61942
13150,2,16,true,66,68,2,41.85783,-87.62455
273,2,16,true,9,14,5,41.85783,-87.62455
13099,2,16,true,15,16,1,41.85784,-87.64627
TA1307000159,2,16,true,14,29,15,41.8579,-87.6687
TA1307000044,2,16,true,17,9,-8,41.85794,-87.64083
13163,2,16,true,12,39,27,41.85808,-87.65108
13164,2,16,true,51,44,-7,41.85818,-87.65648
SL-012,2,16,true,71,70,-1,41.86038,-87.62581
72,2,16,true,5,14,9,41.86039,-87.62581
13304,2,16,true,12,14,2,41.86126,-87.65659
KA1504000109,2,16,true,35,1,-34,41.86192,-87.69347
TA1306000002,2,16,true,36,31,-5,41.86238,-87.65108
TA1307000124,2,16,true,62,113,51,41.86411,-87.62372
168,2,16,true,10,18,8,41.86415,-87.62372
TA1309000001,2,16,true,31,60,29,41.86488,-87.64708
275,2,16,true,13,8,-5,41.86524,-87.66651
13354,2,16,true,28,33,5,41.86524,-87.66651
13029,2,16,true,17,7,-10,41.86531,-87.6179
341,2,16,true,12,10,-2,41.86608,-87.60733
13431,2,16,true,33,43,10,41.8661,-87.60728
WL-008,2,16,true,53,62,9,41.86712,-87.64108
57,2,16,true,2,12,10,41.86712,-87.64107
59,2,16,true,36,37,1,41.86721,-87.62597
TA1305000002,2,16,true,113,190,77,41.86721,-87.62597
3,2,16,true,13,4,-9,41.86723,-87.61536
15544,2,16,true,28,31,3,41.86723,-87.61536
TA1305000017,2,16,true,49,19,-30,41.86734,-87.64863
KA1706005007,2,16,true,27,37,10,41.86749,-87.63219
SL-005,2,16,true,112,175,63,41.8679,-87.62304
255,2,16,true,15,22,7,41.86791,-87.62304
644,2,16,true,32,29,-3,41.86859,-87.68625
19,2,16,true,13,11,-2,41.86892,-87.65913
13139,2,16,true,37,46,9,41.86893,-87.65913
13285,2,16,true,243,26,-217,41.86928,-87.67372
22,2,16,true,12,15,3,41.86947,-87.65548
13160,2,16,true,54,69,15,41.86947,-87.65548
414,2,16,true,7,10,3,41.87023,-87.63947
15550,2,16,true,30,45,15,41.87024,-87.63947
TA1309000010,2,16,true,48,106,58,41.87074,-87.62574
SL-009,2,16,true,27,52,25,41.87081,-87.63121
342,2,16,true,47,3,-44,41.87127,-87.6737
TA1309000064,2,16,true,209,35,-174,41.87127,-87.67369
261,2,16,true,20,2,-18,41.87151,-87.6699
TA1307000130,2,16,true,88,60,-28,41.87178,-87.65103
108,2,16,true,8,19,11,41.87183,-87.64664
TA1307000121,2,16,true,85,70,-15,41.87184,-87.64664
41,2,16,true,22,23,1,41.87209,-87.62957
SL-008,2,16,true,82,133,51,41.87209,-87.62956
13332,2,16,true,103,133,30,41.87219,-87.6615
SL-011,2,16,true,72,94,22,41.87256,-87.63356
623,2,16,true,54,77,23,41.87272,-87.62399
KA1504000104,2,16,true,264,22,-242,41.87296,-87.66912
383,2,16,true,46,11,-35,41.87297,-87.66912
320,2,16,true,17,31,14,41.87327,-87.66402
5,2,16,true,13,11,-2,41.87403,-87.6277
SL-007,2,16,true,42,48,6,41.87404,-87.6277
13326,2,16,true,31,8,-23,41.87425,-87.63958
321,2,16,true,15,21,6,41.87427,-87.63257
TA1306000025,2,16,true,51,42,-9,41.87464,-87.65703
15668,2,16,true,10,21,11,41.87471,-87.68642
13028,2,16,true,48,42,-6,41.87475,-87.64981
13081,2,16,true,41,6,-35,41.87501,-87.67326
89,2,16,true,7,14,7,41.87501,-87.6331
SL-010,2,16,true,50,139,89,41.87501,-87.63309
15541,2,16,true,13,9,-4,41.8758,-87.62086
13037,2,16,true,31,11,-20,41.87588,-87.64078
50,2,16,true,10,4,-6,41.87592,-87.6307
TA1305000009,2,16,true,41,89,48,41.87593,-87.63068
317,2,16,true,27,4,-23,41.87603,-87.68195
TA1305000010,2,16,true,39,25,-14,41.87623,-87.62444
45,2,16,true,17,6,-11,41.87623,-87.62444
624,2,16,true,39,33,-6,41.87626,-87.62923
33,2,16,true,13,4,-9,41.87715,-87.62786
TA1305000035,2,16,true,65,21,-44,41.87716,-87.62787
13138,2,16,true,99,70,-29,41.87723,-87.63941
75,2,16,true,11,3,-8,41.87724,-87.63937
631,2,16,true,34,8,-26,41.87761,-87.6739
15539,2,16,true,100,59,-41,41.87763,-87.64405
13158,2,16,true,113,110,-3,41.87764,-87.64957
134,2,16,true,15,15,0,41.87764,-87.64954
13157,2,16,true,75,62,-13,41.87773,-87.6548
21,2,16,true,25,19,-6,41.87773,-87.6548
TA1305000025,2,16,true,163,60,-103,41.87773,-87.63528
36,2,16,true,28,14,-14,41.87776,-87.63525
TA1309000002,2,16,true,43,28,-15,41.87784,-87.62408
13206,2,16,true,28,69,41,41.87794,-87.66201
283,2,16,true,46,12,-34,41.87809,-87.63183
TA1309000004,2,16,true,291,104,-187,41.87811,-87.63184
107,2,16,true,25,15,-10,41.87822,-87.644
638,2,16,true,213,218,5,41.87827,-87.64078
37,2,16,true,29,7,-22,41.87921,-87.62975
TA1305000005,2,16,true,141,36,-105,41.87924,-87.62975
286,2,16,true,18,3,-15,41.8793,-87.6355
13011,2,16,true,164,332,168,41.87931,-87.63993
TA1309000008,2,16,true,109,31,-78,41.87933,-87.6355
192,2,16,true,29,38,9,41.87935,-87.63997
KA1503000034,2,16,true,114,15,-99,41.87938,-87.63197
40,2,16,true,16,2,-14,41.87944,-87.63197
39,2,16,true,19,7,-12,41.87948,-87.62571
KA1503000015,2,16,true,112,39,-73,41.87948,-87.6257
15667,2,16,true,16,12,-4,41.8798,-87.68609
287,2,16,true,51,5,-46,41.88017,-87.63527
TA1309000007,2,16,true,323,43,-280,41.88022,-87.63526
WL-011,2,16,true,55,48,-7,41.88034,-87.64273
73,2,16,true,13,11,-2,41.8804,-87.64273
80,2,16,true,4,12,8,41.88042,-87.65556
13156,2,16,true,58,130,72,41.88042,-87.65554
13300,2,16,true,84,97,13,41.88097,-87.61675
76,2,16,true,13,14,1,41.88098,-87.61675
13008,2,16,true,85,51,-34,41.88105,-87.62408
90,2,16,true,19,9,-10,41.88107,-87.62409
49,2,16,true,44,7,-37,41.88116,-87.62963
TA1305000006,2,16,true,331,67,-264,41.88122,-87.6296
13134,2,16,true,19,13,-6,41.88138,-87.67493
13056,2,16,true,105,65,-40,41.88168,-87.63951
198,2,16,true,27,33,6,41.88187,-87.6488
TA1307000120,2,16,true,102,127,25,41.88188,-87.64879
13341,2,16,true,158,121,-37,41.88208,-87.63985
174,2,16,true,17,10,-7,41.88208,-87.63984
197,2,16,true,9,12,3,41.88208,-87.62513
13036,2,16,true,81,63,-18,41.8821,-87.62513
77,2,16,true,24,25,1,41.88214,-87.64108
TA1305000032,2,16,true,200,226,26,41.88218,-87.64109
98,2,16,true,33,8,-25,41.88266,-87.63251
13006,2,16,true,146,54,-92,41.88268,-87.63252
13353,2,16,true,49,107,58,41.88283,-87.6612
346,2,16,true,4,12,8,41.88284,-87.6612
654,2,16,true,23,23,0,41.88307,-87.65698
13409,2,16,true,46,44,-2,41.8831,-87.6511
18,2,16,true,14,5,-9,41.88317,-87.63735
KA1503000072,2,16,true,152,38,-114,41.88317,-87.63693
91,2,16,true,10,54,44,41.88336,-87.64122
WL-012,2,16,true,166,418,252,41.88337,-87.6412
112,2,16,true,16,8,-8,41.88362,-87.6486
13053,2,16,true,57,78,21,41.88365,-87.64863
43,2,16,true,24,15,-9,41.88396,-87.62455
13001,2,16,true,134,81,-53,41.88397,-87.62459
13155,2,16,true,26,19,-7,41.88407,-87.65689
18062,2,16,true,38,63,25,41.88412,-87.65427
81,2,16,true,22,24,2,41.88417,-87.6296
TA1306000010,2,16,true,203,79,-124,41.88419,-87.62961
TA1305000030,2,16,true,239,71,-168,41.88459,-87.63178
15535,2,16,true,42,62,20,41.8846,-87.64455
51,2,16,true,27,11,-16,41.88462,-87.63176
TA1305000029,2,16,true,122,98,-24,41.88466,-87.62787
195,2,16,true,13,22,9,41.88466,-87.61952
13263,2,16,true,138,102,-36,41.88467,-87.61952
44,2,16,true,23,13,-10,41.88468,-87.62782
TA1306000015,2,16,true,131,77,-54,41.88549,-87.65232
71,2,16,true,5,10,5,41.8855,-87.65233
66,2,16,true,28,16,-12,41.88557,-87.64186
13021,2,16,true,142,120,-22,41.88559,-87.64184
TA1307000111,2,16,true,233,52,-181,41.88582,-87.63548
164,2,16,true,33,13,-20,41.88583,-87.63547
13073,2,16,true,25,28,3,41.88592,-87.66717
KA17018054,2,16,true,34,9,-25,41.88595,-87.67701
KA1503000012,2,16,true,102,73,-29,41.88599,-87.63089
38,2,16,true,24,14,-10,41.88599,-87.63089
52,2,16,true,27,9,-18,41.886,-87.62421
TA1305000011,2,16,true,199,61,-138,41.886,-87.62418
7,2,16,true,16,27,11,41.88627,-87.61751
15534,2,16,true,80,72,-8,41.88627,-87.61749
13197,2,16,true,56,19,-37,41.8866,-87.65816
264,2,16,true,19,4,-15,41.8867,-87.62224
TA1308000029,2,16,true,93,28,-65,41.88673,-87.62225
TA1307000131,2,16,true,138,50,-88,41.88688,-87.62606
194,2,16,true,20,4,-16,41.88688,-87.62606
KA1503000064,2,16,true,34,57,23,41.88697,-87.61281
100,2,16,true,31,19,-12,41.88814,-87.63657
TA1305000022,2,16,true,200,90,-110,41.88817,-87.63656
56,2,16,true,43,37,-6,41.88866,-87.64442
TA1306000003,2,16,true,163,169,6,41.88867,-87.64442
KA1503000043,2,16,true,267,292,25,41.88918,-87.63851
133,2,16,true,23,55,32,41.88918,-87.63851
13050,2,16,true,133,53,-80,41.88919,-87.62775
47,2,16,true,30,16,-14,41.88921,-87.62775
15664,2,16,true,9,34,25,41.8895,-87.68821
13432,2,16,true,37,44,7,41.88989,-87.67149
TA1307000151,2,16,true,167,98,-69,41.88993,-87.63427
212,2,16,true,16,17,1,41.88995,-87.63427
636,2,16,true,92,87,-5,41.88997,-87.63662
125,2,16,true,16,10,-6,41.89018,-87.62621
KA1503000044,2,16,true,100,49,-51,41.89018,-87.6262
196,2,16,true,13,20,7,41.89053,-87.62205
13427,2,16,true,51,64,13,41.89054,-87.62205
26,2,16,true,20,20,0,41.89057,-87.61798
13430,2,16,true,115,97,-18,41.89077,-87.63169
181,2,16,true,30,6,-24,41.89077,-87.63168
TA1306000013,2,16,true,96,97,1,41.89083,-87.61852
RN-,2,16,true,79,78,-1,41.89102,-87.63546
672,2,16,true,12,12,0,41.89102,-87.63545
13434,2,16,true,20,45,25,41.89108,-87.66663
TA1308000006,2,16,true,36,36,0,41.89128,-87.67686
199,2,16,true,30,19,-11,41.89143,-87.62676
TA1307000117,2,16,true,164,114,-50,41.89144,-87.62675
13033,2,16,true,104,129,25,41.8916,-87.64835
84,2,16,true,13,10,-3,41.89161,-87.64833
186,2,16,true,16,22,6,41.8918,-87.65879
13194,2,16,true,70,74,4,41.8918,-87.65878
TA1305000003,2,16,true,140,102,-38,41.89187,-87.62061
24,2,16,true,28,26,-2,41.8919,-87.62063
643,2,16,true,4,17,13,41.89203,-87.68939
35,2,16,true,17,15,-2,41.89227,-87.61206
13022,2,16,true,109,129,20,41.89227,-87.61205
99,2,16,true,12,15,3,41.89255,-87.61449
TA1306000029,2,16,true,89,89,0,41.89256,-87.61449
13265,2,16,true,137,128,-9,41.89383,-87.64172
74,2,16,true,21,26,5,41.89384,-87.64173
13045,2,16,true,201,146,-55,41.89403,-87.62931
110,2,16,true,40,31,-9,41.89406,-87.6293
13016,2,16,true,543,81,-462,41.89431,-87.62277
211,2,16,true,120,13,-107,41.89439,-87.62267
KA1503000041,2,16,true,240,62,-178,41.89452,-87.61798
142,2,16,true,62,9,-53,41.89453,-87.61806
92,2,16,true,7,15,8,41.89455,-87.65346
13196,2,16,true,55,79,24,41.89455,-87.65345
TA1307000062,2,16,true,112,97,-15,41.89466,-87.63839
111,2,16,true,25,18,-7,41.89466,-87.63837
TA1306000012,2,16,true,152,168,16,41.89475,-87.63438
53,2,16,true,23,30,7,41.89476,-87.63439
627,2,16,true,15,13,-2,41.8948,-87.63231
KP1705001026,2,16,true,72,74,2,41.89483,-87.6323
KA1504000114,2,16,true,10,2,-8,41.89547,-87.70614
659,2,16,true,2,12,10,41.8955,-87.68201
18058,2,16,true,11,27,16,41.8955,-87.68201
637,2,16,true,31,63,32,41.89563,-87.67209
128,2,16,true,5,10,5,41.89571,-87.67716
13132,2,16,true,58,70,12,41.89573,-87.67718
161,2,16,true,27,11,-16,41.89574,-87.62599
15530,2,16,true,139,77,-62,41.89575,-87.62596
18003,2,16,true,126,39,-87,41.89575,-87.62011
635,2,16,true,26,10,-16,41.89576,-87.62012
13247,2,16,true,29,63,34,41.89597,-87.66775
350,2,16,true,6,16,10,41.89597,-87.66774
TA1305000020,2,16,true,58,52,-6,41.89636,-87.65406
54,2,16,true,11,15,4,41.89637,-87.65407
13289,2,16,true,50,72,22,41.89638,-87.661
86,2,16,true,11,21,10,41.89639,-87.661
337,2,16,true,27,14,-13,41.89659,-87.63096
13303,2,16,true,79,72,-7,41.89672,-87.63088
13017,2,16,true,97,106,9,41.89676,-87.6357
31,2,16,true,20,19,-1,41.89677,-87.63572
13338,2,16,true,170,58,-112,41.89697,-87.62173
173,2,16,true,28,9,-19,41.89704,-87.62173
TA1307000061,2,16,true,82,68,-14,41.89745,-87.62873
106,2,16,true,20,5,-15,41.89746,-87.62874
25,2,16,true,22,5,-17,41.89751,-87.62354
13034,2,16,true,97,39,-58,41.89754,-87.62352
48,2,16,true,37,20,-17,41.89772,-87.64302
TA1306000009,2,16,true,272,67,-205,41.89772,-87.64299
620,2,16,true,61,89,28,41.89817,-87.63754
KA1504000103,2,16,true,27,30,3,41.89842,-87.68659
145,2,16,true,21,11,-10,41.89856,-87.62211
15529,2,16,true,124,75,-49,41.89858,-87.62206
140,2,16,true,29,43,14,41.89895,-87.6299
TA1307000128,2,16,true,147,171,24,41.89896,-87.6299
657,2,16,true,26,38,12,41.89918,-87.6722
KA1504000117,2,16,true,48,12,-36,41.89936,-87.64848
365,2,16,true,10,2,-8,41.89936,-87.64848
30,2,16,true,5,10,5,41.89964,-87.66789
13248,2,16,true,23,40,17,41.89964,-87.66788
46,2,16,true,8,10,2,41.89994,-87.63444
TA1306000011,2,16,true,42,48,6,41.89994,-87.63443
KA1504000116,2,16,true,55,56,1,41.90023,-87.64299
364,2,16,true,10,14,4,41.90023,-87.64299
17660,2,16,true,30,21,-9,41.90036,-87.69671
13290,2,16,true,51,56,5,41.90069,-87.66259
13042,2,16,true,158,99,-59,41.90097,-87.62377
85,2,16,true,29,11,-18,41.90098,-87.62375
TA1307000070,2,16,true,14,31,17,41.90133,-87.67742
KA1504000133,2,16,true,103,98,-5,41.90234,-87.62773
172,2,16,true,17,17,0,41.90236,-87.62774
15654,2,16,true,11,7,-4,41.90271,-87.70923
13241,2,16,true,26,20,-6,41.9029,-87.68731
176,2,16,true,30,49,19,41.90291,-87.63141
TA1306000006,2,16,true,24,27,3,41.90292,-87.63772
TA1307000039,2,16,true,146,289,143,41.90294,-87.63137
658,2,16,true,52,13,-39,41.903,-87.6838
13256,2,16,true,18,10,-8,41.90302,-87.69749
17,2,16,true,7,14,7,41.90313,-87.67391
TA1305000034,2,16,true,39,62,23,41.90313,-87.67391
182,2,16,true,23,43,20,41.90317,-87.63442
KA1504000135,2,16,true,145,213,68,41.90319,-87.63439
13136,2,16,true,49,40,-9,41.90326,-87.67845
210,2,16,true,18,20,2,41.90342,-87.66781
13061,2,16,true,115,123,8,41.90342,-87.66779
KA1504000079,2,16,true,76,86,10,41.9035,-87.64334
359,2,16,true,13,18,5,41.90458,-87.6497
138,2,16,true,13,25,12,41.9046,-87.64057
TA1307000115,2,16,true,63,64,1,41.9046,-87.64056
291,2,16,true,12,30,18,41.90672,-87.63494
TA1308000049,2,16,true,77,121,44,41.90672,-87.6349
KA1504000134,2,16,true,71,92,21,41.90687,-87.6262
180,2,16,true,18,12,-6,41.90687,-87.62618
333,2,16,true,14,11,-3,41.90706,-87.66725
13224,2,16,true,49,60,11,41.90706,-87.66725
18069,2,16,true,25,3,-22,41.90722,-87.65563
TA1307000143,2,16,true,24,30,6,41.90762,-87.63854
61,2,16,true,12,22,10,41.90764,-87.67254
13221,2,16,true,47,93,46,41.90765,-87.67254
13245,2,16,true,14,9,-5,41.90777,-87.68586
301,2,16,true,17,30,13,41.90796,-87.63203
TA1309000024,2,16,true,96,163,67,41.908,-87.63152
69,2,16,true,13,19,6,41.90939,-87.6777
TA1305000041,2,16,true,87,74,-13,41.9094,-87.67769
331,2,16,true,159,143,-16,41.90965,-87.64812
15653,2,16,true,7,12,5,41.90979,-87.7053
TA1305000037,2,16,true,60,81,21,41.91018,-87.67003
TA1306000008,2,16,true,24,33,9,41.9102,-87.6435
16,2,16,true,13,19,6,41.91035,-87.67008
TA1308000005,2,16,true,32,33,1,41.91042,-87.68238
13258,2,16,true,25,26,1,41.91043,-87.69718
13257,2,16,true,12,30,18,41.91054,-87.68956
13154,2,16,true,67,123,56,41.91054,-87.65312
20,2,16,true,14,23,9,41.91055,-87.65313
13058,2,16,true,72,53,-19,41.91059,-87.64942
60,2,16,true,21,18,-3,41.91059,-87.64942
118,2,16,true,10,14,4,41.91138,-87.63868
TA1307000038,2,16,true,75,79,4,41.91138,-87.63868
LF-005,2,16,true,109,97,-12,41.91172,-87.62681
268,2,16,true,16,18,2,41.91172,-87.62681
13128,2,16,true,43,44,1,41.91197,-87.63197
289,2,16,true,26,35,9,41.91209,-87.63472
TA1308000050,2,16,true,171,225,54,41.91211,-87.6347
158,2,16,true,8,13,5,41.91262,-87.6814
13243,2,16,true,61,85,24,41.91262,-87.6814
TA1309000032,2,16,true,14,10,-4,41.91293,-87.66417
TA1306000032,2,16,true,69,80,11,41.9137,-87.65285
93,2,16,true,12,14,2,41.91371,-87.65285
224,2,16,true,14,7,-7,41.91386,-87.64877
TA1307000166,2,16,true,61,83,22,41.91386,-87.64877
15655,2,16,true,24,45,21,41.91401,-87.70514
18017,2,16,true,9,26,17,41.91416,-87.71676
18067,2,16,true,38,30,-8,41.9146,-87.66796
TA1306000007,2,16,true,19,29,10,41.91469,-87.64333
13068,2,16,true,53,46,-7,41.91554,-87.68703
13179,2,16,true,91,104,13,41.9157,-87.63461
141,2,16,true,16,13,-3,41.91571,-87.63461
219,2,16,true,14,22,8,41.91598,-87.67733
13133,2,16,true,64,88,24,41.91598,-87.67733
58,2,16,true,13,6,-7,41.91602,-87.66894
TA1305000039,2,16,true,58,42,-16,41.9163,-87.66749
15650,2,16,true,18,15,-3,41.91711,-87.71023
15651,2,16,true,12,29,17,41.91752,-87.70181
13266,2,16,true,32,18,-14,41.91774,-87.69142
TA1309000029,2,16,true,8,25,17,41.9178,-87.68245
288,2,16,true,10,6,-4,41.91809,-87.64375
TA1309000006,2,16,true,45,46,1,41.91809,-87.64375
223,2,16,true,17,13,-4,41.91821,-87.65698
TA1307000163,2,16,true,56,93,37,41.91821,-87.65696
94,2,16,true,19,22,3,41.91831,-87.6363
13146,2,16,true,90,130,40,41.91831,-87.63629
13059,2,16,true,96,87,-9,41.91845,-87.65222
113,2,16,true,19,19,0,41.91846,-87.65222
13259,2,16,true,10,22,12,41.91852,-87.69744
225,2,16,true,11,21,10,41.91995,-87.64884
13192,2,16,true,44,91,47,41.91995,-87.64884
13288,2,16,true,19,34,15,41.92008,-87.67788
13242,2,16,true,10,16,6,41.92021,-87.69266
TA1309000030,2,16,true,41,62,21,41.92077,-87.66372
13292,2,16,true,13,19,6,41.92152,-87.70733
TA1309000033,2,16,true,68,64,-4,41.92158,-87.65381
13193,2,16,true,97,133,36,41.92182,-87.64412
144,2,16,true,22,31,9,41.92182,-87.64411
143,2,16,true,9,19,10,41.92217,-87.63891
13191,2,16,true,71,89,18,41.92217,-87.63891
327,2,16,true,13,12,-1,41.92225,-87.65783
13084,2,16,true,36,42,6,41.92268,-87.69715
LP-,2,16,true,51,48,-3,41.92396,-87.63584
673,2,16,true,10,5,-5,41.92398,-87.63585
KA1504000140,2,16,true,28,26,-2,41.92409,-87.67646
15648,2,16,true,7,20,13,41.92464,-87.68931
KA1504000090,2,16,true,5,11,6,41.92483,-87.7145
TA1307000001,2,16,true,72,67,-5,41.92535,-87.66581
188,2,16,true,15,7,-8,41.92536,-87.66581
TA1306000026,2,16,true,76,47,-29,41.92558,-87.65842
TA1306000016,2,16,true,105,74,-31,41.9256,-87.65371
67,2,16,true,9,11,2,41.9256,-87.65371
313,2,16,true,16,16,0,41.9257,-87.64246
TA1309000019,2,16,true,103,126,23,41.92586,-87.63897
TA1309000058,2,16,true,110,112,2,41.92591,-87.64927
127,2,16,true,16,29,13,41.92592,-87.64927
TA1308000001,2,16,true,109,103,-6,41.92627,-87.63086
177,2,16,true,18,21,3,41.92627,-87.63086
15646,2,16,true,15,15,0,41.92668,-87.6977
13124,2,16,true,22,19,-3,41.92675,-87.63444
TA1309000023,2,16,true,50,58,8,41.9287,-87.65383
TA1307000113,2,16,true,34,43,9,41.92878,-87.66391
190,2,16,true,10,5,-5,41.92878,-87.6639
13296,2,16,true,19,37,18,41.92883,-87.66852
TA1309000059,2,16,true,32,33,1,41.92889,-87.65898
343,2,16,true,5,10,5,41.92889,-87.65898
349,2,16,true,12,14,2,41.92915,-87.6491
TA1309000061,2,16,true,57,59,2,41.92915,-87.64909
TA1308000031,2,16,true,13,32,19,41.92946,-87.68417
340,2,16,true,20,19,-1,41.92956,-87.64313
TA1305000014,2,16,true,108,138,30,41.92956,-87.64313
13085,2,16,true,17,27,10,41.92958,-87.70789
15643,2,16,true,3,10,7,41.93057,-87.7238
TA1307000142,2,16,true,97,151,54,41.93125,-87.64432
220,2,16,true,26,20,-6,41.93125,-87.64431
13276,2,16,true,70,105,35,41.93132,-87.63874
324,2,16,true,11,21,10,41.93173,-87.64179
15645,2,16,true,7,14,7,41.93191,-87.70121
13271,2,16,true,31,35,4,41.93192,-87.67784
152,2,16,true,14,10,-4,41.93221,-87.65864
TA1307000064,2,16,true,61,64,3,41.93222,-87.65864
13,2,16,true,21,13,-8,41.93242,-87.65271
TA1306000014,2,16,true,68,87,19,41.93242,-87.65271
329,2,16,true,13,18,5,41.93258,-87.63642
TA1309000039,2,16,true,79,128,49,41.93258,-87.63642
13294,2,16,true,29,82,53,41.9326,-87.66595
319,2,16,true,2,10,8,41.93292,-87.67217
332,2,16,true,7,16,9,41.93313,-87.64776
TA1309000036,2,16,true,67,93,26,41.93313,-87.64776
15644,2,16,true,13,7,-6,41.93534,-87.71687
TA1307000006,2,16,true,63,52,-11,41.93571,-87.6636
153,2,16,true,11,5,-6,41.93575,-87.66364
13268,2,16,true,21,20,-1,41.93588,-87.67843
13269,2,16,true,31,44,13,41.93609,-87.66983
TA1307000052,2,16,true,119,67,-52,41.93628,-87.65266
115,2,16,true,15,19,4,41.93628,-87.65266
156,2,16,true,17,19,2,41.9365,-87.64756
TA1307000136,2,16,true,96,95,-1,41.9365,-87.64755
TA1307000041,2,16,true,114,97,-17,41.93669,-87.63683
157,2,16,true,23,21,-2,41.9367,-87.63683
13137,2,16,true,134,168,34,41.9376,-87.6441
300,2,16,true,27,34,7,41.93761,-87.6441
154,2,16,true,14,12,-2,41.93912,-87.66384
KA17018068,2,16,true,19,23,4,41.93935,-87.68327
TA1309000042,2,16,true,52,57,5,41.93937,-87.66836
131,2,16,true,13,17,4,41.93937,-87.66835
13229,2,16,true,41,43,2,41.93946,-87.66376
TA1308000019,2,16,true,60,40,-20,41.93973,-87.65886
296,2,16,true,18,28,10,41.9401,-87.64546
13277,2,16,true,62,80,18,41.9401,-87.64546
TA1307000134,2,16,true,98,99,1,41.94016,-87.65303
117,2,16,true,31,19,-12,41.94016,-87.65302
13143,2,16,true,13,14,1,41.94059,-87.67853
334,2,16,true,14,22,8,41.94076,-87.63919
TA1309000049,2,16,true,91,89,-2,41.94077,-87.63919
15634,2,16,true,23,12,-11,41.94304,-87.68729
TA1307000138,2,16,true,42,64,22,41.94334,-87.67094
230,2,16,true,10,13,3,41.94335,-87.67093
13144,2,16,true,29,27,-2,41.9434,-87.67964
299,2,16,true,21,17,-4,41.94368,-87.64894
TA1309000025,2,16,true,73,97,24,41.94368,-87.64894
229,2,16,true,16,11,-5,41.94372,-87.66401
13071,2,16,true,105,73,-32,41.94373,-87.66401
632,2,16,true,73,118,45,41.94453,-87.6547
303,2,16,true,23,34,11,41.94522,-87.64702
15631,2,16,true,10,6,-4,41.94524,-87.70665
13278,2,16,true,98,111,13,41.94553,-87.64644
TA1309000050,2,16,true,11,11,0,41.94618,-87.67331
15632,2,16,true,31,5,-26,41.94664,-87.69463
KA1504000143,2,16,true,5,22,17,41.94664,-87.68337
227,2,16,true,6,14,8,41.94813,-87.66397
13235,2,16,true,91,96,5,41.94814,-87.66396
304,2,16,true,27,30,3,41.94878,-87.64922
257,2,16,true,10,5,-5,41.9488,-87.67527
13253,2,16,true,31,28,-3,41.9488,-87.67527
13325,2,16,true,118,118,0,41.94907,-87.64863
114,2,16,true,9,18,9,41.94935,-87.65451
TA1307000126,2,16,true,57,68,11,41.94936,-87.65451
232,2,16,true,21,26,5,41.94943,-87.64645
TA1307000150,2,16,true,101,158,57,41.94945,-87.64646
18016,2,16,true,8,10,2,41.94993,-87.71395
347,2,16,true,10,1,-9,41.95068,-87.6687
13319,2,16,true,79,30,-49,41.95069,-87.6687
TA1307000127,2,16,true,44,58,14,41.9508,-87.65918
165,2,16,true,17,14,-3,41.95081,-87.65918
15628,2,16,true,16,12,-4,41.95216,-87.69806
256,2,16,true,13,12,-1,41.95282,-87.65
13323,2,16,true,44,45,1,41.95282,-87.65
590,2,16,true,15,3,-12,41.95374,-87.74056
TA1309000043,2,16,true,49,33,-16,41.95417,-87.66434
13063,2,16,true,72,78,6,41.95424,-87.65441
240,2,16,true,10,18,8,41.95424,-87.65441
KA1504000158,2,16,true,16,27,11,41.95432,-87.68607
254,2,16,true,16,16,0,41.95438,-87.64806
TA1308000022,2,16,true,76,85,9,41.95438,-87.64805
TA1307000149,2,16,true,33,23,-10,41.95467,-87.67392
298,2,16,true,3,10,7,41.95601,-87.68021
TA1309000026,2,16,true,32,43,11,41.95601,-87.6802
13249,2,16,true,15,11,-4,41.95606,-87.66885
312,2,16,true,12,16,4,41.95637,-87.6563
TA1308000047,2,16,true,14,13,-1,41.95709,-87.6642
13379,2,16,true,81,90,9,41.95786,-87.6495
TA1309000018,2,16,true,29,24,-5,41.95791,-87.67357
306,2,16,true,17,5,-12,41.9585,-87.655
TA1309000027,2,16,true,39,60,21,41.9585,-87.65499
13389,2,16,true,62,50,-12,41.961,-87.64958
245,2,16,true,15,10,-5,41.96101,-87.64958
15621,2,16,true,10,25,15,41.96103,-87.70586
15622,2,16,true,17,4,-13,41.96108,-87.69544
TA1307000144,2,16,true,40,34,-6,41.96142,-87.6762
TA1309000021,2,16,true,16,18,2,41.9615,-87.6714
15623,2,16,true,15,22,7,41.96154,-87.69117
KA1503000022,2,16,true,29,23,-6,41.96158,-87.66609
TA1307000107,2,16,true,77,99,22,41.96164,-87.65464
TA1307000156,2,16,true,14,30,16,41.96301,-87.68479
TA1309000012,2,16,true,17,14,-3,41.96325,-87.67928
249,2,16,true,18,14,-4,41.96398,-87.63818
TA1308000012,2,16,true,80,82,2,41.96398,-87.63818
293,2,16,true,11,10,-1,41.96521,-87.65822
13074,2,16,true,49,34,-15,41.96521,-87.6582
639,2,16,true,52,52,0,41.96584,-87.64538
KA1504000127,2,16,true,11,13,2,41.96587,-87.70083
KA1504000093,2,16,true,15,40,25,41.96587,-87.69365
TA1307000140,2,16,true,27,41,14,41.96643,-87.68865
326,2,16,true,17,16,-1,41.96665,-87.67113
TA1309000014,2,16,true,66,34,-32,41.96709,-87.66744
TA1307000158,2,16,true,57,17,-40,41.9671,-87.67904
242,2,16,true,11,6,-5,41.9671,-87.67904
251,2,16,true,12,10,-2,41.96796,-87.65
TA1307000119,2,16,true,31,45,14,41.96796,-87.65
15615,2,16,true,11,4,-7,41.96835,-87.71183
323,2,16,true,2,10,8,41.96869,-87.66034
TA1308000021,2,16,true,42,28,-14,41.96883,-87.65765
KA1504000080,2,16,true,19,27,8,41.96887,-87.69609
TA1309000015,2,16,true,15,11,-4,41.96889,-87.68401
TA1309000066,2,16,true,85,46,-39,41.9691,-87.67423
344,2,16,true,9,14,5,41.9691,-87.67423
TA1309000041,2,16,true,46,24,-22,41.96951,-87.65471
465,2,16,true,14,8,-6,41.97161,-87.65016
KA1504000171,2,16,true,46,41,-5,41.97161,-87.65016
325,2,16,true,8,11,3,41.9728,-87.67186
TA1309000035,2,16,true,53,72,19,41.97335,-87.66785
13108,2,16,true,52,42,-10,41.97379,-87.65971
KA1504000078,2,16,true,9,12,3,41.97491,-87.69258
KA1504000149,2,16,true,14,16,2,41.97562,-87.67945
KA1504000160,2,16,true,22,4,-18,41.97564,-87.70143
KA1504000146,2,16,true,32,39,7,41.978,-87.66805
13109,2,16,true,43,43,0,41.97835,-87.65976
655,2,16,true,20,6,-14,41.97987,-87.68194
460,2,16,true,6,12,6,41.98358,-87.66916
KA1504000151,2,16,true,39,32,-7,41.98359,-87.66916
459,2,16,true,24,22,-2,41.98403,-87.65231
KA1504000152,2,16,true,94,105,11,41.98403,-87.65231
15578,2,16,true,35,34,-1,41.98405,-87.66027
15575,2,16,true,26,49,23,41.98975,-87.66014
KA1504000148,2,16,true,15,13,-2,41.99086,-87.66971
15571,2,16,true,28,45,17,41.99478,-87.66028
KA1504000156,2,16,true,15,12,-3,41.99925,-87.67137
RP-009,2,16,true,28,18,-10,42.00107,-87.66122
RP-008,2,16,true,8,20,12,42.00446,-87.6724
660,2,16,true,14,27,13,42.00458,-87.66143
KA1504000175,2,16,true,19,35,16,42.00797,-87.66549
447,2,16,true,6,11,5,42.00797,-87.66548
RP-005,2,16,true,15,11,-4,42.0086,-87.69047
KA1504000162,2,16,true,22,6,-16,42.00907,-87.67422
KA1504000159,2,16,true,6,16,10,42.01059,-87.66241
RP-006,2,16,true,5,12,7,42.01213,-87.68292
520,2,16,true,12,29,17,42.01597,-87.66859
515,2,16,true,16,14,-2,42.01915,-87.67356
523,2,16,true,21,24,3,42.02089,-87.66505
E002,2,16,true,28,23,-5,42.03256,-87.67912
599,2,16,true,20,10,-10,42.03972,-87.69942
596,2,16,true,36,39,3,42.04822,-87.68348
E008,2,16,true,21,9,-12,42.05049,-87.67782
605,2,16,true,19,9,-10,42.05294,-87.67342
604,2,16,true,50,22,-28,42.05824,-87.67744
E006,2,16,true,12,5,-7,42.06367,-87.69871
E007,2,16,true,13,7,-6,42.06431,-87.68615
E014,2,16,true,2,17,15,42.06483,-87.71531
KA1503000014,3,8,false,13,19,6,41.7851,-87.60108
TA1309000011,3,8,false,2,20,18,41.78873,-87.60131
KA1503000071,3,8,false,4,15,11,41.79148,-87.59988
TA1309000063,3,8,false,19,4,-15,41.79325,-87.5878
KA1504000076,3,8,false,9,12,3,41.7943,-87.60145
TA1308000009,3,8,false,21,10,-11,41.79522,-87.58075
TA1307000164,3,8,false,14,6,-8,41.79527,-87.59647
KA1503000052,3,8,false,11,3,-8,41.79935,-87.60097
KA1503000059,3,8,false,14,14,0,41.79952,-87.58643
TA1309000037,3,8,false,21,11,-10,41.79957,-87.59474
KA1503000007,3,8,false,13,8,-5,41.80242,-87.58689
13398,3,8,false,15,6,-9,41.80256,-87.59035
TA1308000035,3,8,false,4,13,9,41.80944,-87.59188
KA1503000032,3,8,false,11,1,-10,41.81912,-87.64328
15443,3,8,false,14,1,-13,41.84275,-87.63549
TA1305000004,3,8,false,10,12,2,41.8514,-87.61884
13102,3,8,false,10,5,-5,41.85762,-87.61942
13150,3,8,false,10,9,-1,41.85783,-87.62455
13164,3,8,false,14,5,-9,41.85818,-87.65648
SL-012,3,8,false,15,7,-8,41.86038,-87.62581
13304,3,8,false,11,2,-9,41.86126,-87.65659
TA1307000124,3,8,false,15,8,-7,41.86411,-87.62372
TA1305000002,3,8,false,41,14,-27,41.86721,-87.62597
15544,3,8,false,9,15,6,41.86723,-87.61536
SL-005,3,8,false,42,22,-20,41.8679,-87.62304
13285,3,8,false,3,15,12,41.86928,-87.67372
TA1309000010,3,8,false,21,9,-12,41.87074,-87.62574
SL-009,3,8,false,16,5,-11,41.87081,-87.63121
TA1309000064,3,8,false,6,11,5,41.87127,-87.67369
TA1307000121,3,8,false,2,18,16,41.87184,-87.64664
SL-008,3,8,false,25,17,-8,41.87209,-87.62956
13332,3,8,false,11,2,-9,41.87219,-87.6615
SL-011,3,8,false,22,11,-11,41.87256,-87.63356
623,3,8,false,36,14,-22,41.87272,-87.62399
KA1504000104,3,8,false,8,18,10,41.87296,-87.66912
SL-007,3,8,false,14,9,-5,41.87404,-87.6277
13028,3,8,false,4,11,7,41.87475,-87.64981
SL-010,3,8,false,12,23,11,41.87501,-87.63309
TA1305000009,3,8,false,5,12,7,41.87593,-87.63068
TA1305000010,3,8,false,11,7,-4,41.87623,-87.62444
624,3,8,false,9,25,16,41.87626,-87.62923
TA1305000035,3,8,false,13,6,-7,41.87716,-87.62787
13138,3,8,false,9,18,9,41.87723,-87.63941
15539,3,8,false,15,6,-9,41.87763,-87.64405
13158,3,8,false,16,26,10,41.87764,-87.64957
13157,3,8,false,10,2,-8,41.87773,-87.6548
TA1305000025,3,8,false,14,84,70,41.87773,-87.63528
TA1309000002,3,8,false,15,5,-10,41.87784,-87.62408
TA1309000004,3,8,false,9,57,48,41.87811,-87.63184
638,3,8,false,23,37,14,41.87827,-87.64078
TA1305000005,3,8,false,5,36,31,41.87924,-87.62975
13011,3,8,false,26,55,29,41.87931,-87.63993
TA1309000008,3,8,false,16,29,13,41.87933,-87.6355
KA1503000034,3,8,false,6,26,20,41.87938,-87.63197
KA1503000015,3,8,false,6,12,6,41.87948,-87.6257
287,3,8,false,2,11,9,41.88017,-87.63527
TA1309000007,3,8,false,8,50,42,41.88022,-87.63526
WL-011,3,8,false,16,25,9,41.88034,-87.64273
13156,3,8,false,21,9,-12,41.88042,-87.65554
13300,3,8,false,19,22,3,41.88097,-87.61675
13008,3,8,false,24,28,4,41.88105,-87.62408
TA1305000006,3,8,false,15,73,58,41.88122,-87.6296
13056,3,8,false,11,20,9,41.88168,-87.63951
TA1307000120,3,8,false,33,21,-12,41.88188,-87.64879
13341,3,8,false,33,37,4,41.88208,-87.63985
13036,3,8,false,13,18,5,41.8821,-87.62513
TA1305000032,3,8,false,30,77,47,41.88218,-87.64109
13006,3,8,false,10,25,15,41.88268,-87.63252
13353,3,8,false,14,14,0,41.88283,-87.6612
654,3,8,false,8,13,5,41.88307,-87.65698
13409,3,8,false,20,20,0,41.8831,-87.6511
18,3,8,false,2,11,9,41.88317,-87.63735
KA1503000072,3,8,false,21,54,33,41.88317,-87.63693
WL-012,3,8,false,36,40,4,41.88337,-87.6412
13053,3,8,false,22,32,10,41.88365,-87.64863
13001,3,8,false,37,26,-11,41.88397,-87.62459
13155,3,8,false,12,18,6,41.88407,-87.65689
18062,3,8,false,21,34,13,41.88412,-87.65427
81,3,8,false,1,12,11,41.88417,-87.6296
TA1306000010,3,8,false,15,35,20,41.88419,-87.62961
TA1305000030,3,8,false,29,86,57,41.88459,-87.63178
15535,3,8,false,14,21,7,41.8846,-87.64455
51,3,8,false,3,10,7,41.88462,-87.63176
TA1305000029,3,8,false,20,17,-3,41.88466,-87.62787
13263,3,8,false,27,44,17,41.88467,-87.61952
TA1306000015,3,8,false,31,53,22,41.88549,-87.65232
66,3,8,false,2,11,9,41.88557,-87.64186
13021,3,8,false,33,50,17,41.88559,-87.64184
TA1307000111,3,8,false,19,69,50,41.88582,-87.63548
13073,3,8,false,11,17,6,41.88592,-87.66717
KA17018054,3,8,false,2,24,22,41.88595,-87.67701
KA1503000012,3,8,false,19,51,32,41.88599,-87.63089
TA1305000011,3,8,false,38,68,30,41.886,-87.62418
15534,3,8,false,16,11,-5,41.88627,-87.61749
13197,3,8,false,13,26,13,41.8866,-87.65816
TA1308000029,3,8,false,26,19,-7,41.88673,-87.62225
TA1307000131,3,8,false,30,20,-10,41.88688,-87.62606
KA1503000064,3,8,false,16,18,2,41.88697,-87.61281
TA1305000022,3,8,false,39,50,11,41.88817,-87.63656
TA1306000003,3,8,false,38,11,-27,41.88867,-87.64442
KA1503000043,3,8,false,51,62,11,41.88918,-87.63851
13050,3,8,false,18,41,23,41.88919,-87.62775
13432,3,8,false,6,13,7,41.88989,-87.67149
TA1307000151,3,8,false,33,73,40,41.88993,-87.63427
212,3,8,false,6,11,5,41.88995,-87.63427
636,3,8,false,23,18,-5,41.88997,-87.63662
KA1503000044,3,8,false,29,36,7,41.89018,-87.6262
13427,3,8,false,19,19,0,41.89054,-87.62205
13430,3,8,false,21,27,6,41.89077,-87.63169
TA1306000013,3,8,false,40,22,-18,41.89083,-87.61852
RN-,3,8,false,19,43,24,41.89102,-87.63546
13434,3,8,false,14,3,-11,41.89108,-87.66663
TA1308000006,3,8,false,13,15,2,41.89128,-87.67686
199,3,8,false,5,12,7,41.89143,-87.62676
TA1307000117,3,8,false,28,59,31,41.89144,-87.62675
13033,3,8,false,22,22,0,41.8916,-87.64835
13194,3,8,false,20,8,-12,41.8918,-87.65878
TA1305000003,3,8,false,37,39,2,41.89187,-87.62061
13022,3,8,false,34,28,-6,41.89227,-87.61205
13265,3,8,false,23,25,2,41.89383,-87.64172
13045,3,8,false,56,23,-33,41.89403,-87.62931
13016,3,8,false,33,52,19,41.89431,-87.62277
211,3,8,false,3,10,7,41.89439,-87.62267
KA1503000041,3,8,false,58,22,-36,41.89452,-87.61798
13196,3,8,false,31,9,-22,41.89455,-87.65345
TA1307000062,3,8,false,30,27,-3,41.89466,-87.63839
TA1306000012,3,8,false,64,45,-19,41.89475,-87.63438
53,3,8,false,12,13,1,41.89476,-87.63439
KP1705001026,3,8,false,24,33,9,41.89483,-87.6323
18058,3,8,false,10,5,-5,41.8955,-87.68201
637,3,8,false,24,5,-19,41.89563,-87.67209
13132,3,8,false,26,22,-4,41.89573,-87.67718
15530,3,8,false,24,16,-8,41.89575,-87.62596
18003,3,8,false,18,12,-6,41.89575,-87.62011
13247,3,8,false,21,15,-6,41.89597,-87.66775
TA1305000020,3,8,false,26,17,-9,41.89636,-87.65406
13289,3,8,false,23,8,-15,41.89638,-87.661
13303,3,8,false,22,22,0,41.89672,-87.63088
13017,3,8,false,29,27,-2,41.89676,-87.6357
13338,3,8,false,31,10,-21,41.89697,-87.62173
TA1307000061,3,8,false,24,18,-6,41.89745,-87.62873
13034,3,8,false,25,20,-5,41.89754,-87.62352
TA1306000009,3,8,false,40,57,17,41.89772,-87.64299
620,3,8,false,25,16,-9,41.89817,-87.63754
KA1504000103,3,8,false,27,7,-20,41.89842,-87.68659
15529,3,8,false,23,18,-5,41.89858,-87.62206
TA1307000128,3,8,false,24,20,-4,41.89896,-87.6299
657,3,8,false,11,7,-4,41.89918,-87.6722
TA1306000011,3,8,false,18,8,-10,41.89994,-87.63443
KA1504000116,3,8,false,12,7,-5,41.90023,-87.64299
17660,3,8,false,10,3,-7,41.90036,-87.69671
13290,3,8,false,23,17,-6,41.90069,-87.66259
13042,3,8,false,43,42,-1,41.90097,-87.62377
TA1307000070,3,8,false,13,5,-8,41.90133,-87.67742
KA1504000133,3,8,false,21,26,5,41.90234,-87.62773
176,3,8,false,16,4,-12,41.90291,-87.63141
TA1306000006,3,8,false,18,2,-16,41.90292,-87.63772
TA1307000039,3,8,false,65,32,-33,41.90294,-87.63137
TA1305000034,3,8,false,18,10,-8,41.90313,-87.67391
182,3,8,false,10,5,-5,41.90317,-87.63442
KA1504000135,3,8,false,35,45,10,41.90319,-87.63439
13136,3,8,false,13,10,-3,41.90326,-87.67845
13061,3,8,false,40,50,10,41.90342,-87.66779
KA1504000079,3,8,false,13,10,-3,41.9035,-87.64334
TA1308000049,3,8,false,34,23,-11,41.90672,-87.6349
KA1504000134,3,8,false,20,17,-3,41.90687,-87.6262
13224,3,8,false,22,6,-16,41.90706,-87.66725
18069,3,8,false,1,10,9,41.90722,-87.65563
13221,3,8,false,19,11,-8,41.90765,-87.67254
TA1309000024,3,8,false,22,14,-8,41.908,-87.63152
TA1305000041,3,8,false,26,30,4,41.9094,-87.67769
331,3,8,false,28,31,3,41.90965,-87.64812
TA1305000037,3,8,false,28,10,-18,41.91018,-87.67003
TA1306000008,3,8,false,18,6,-12,41.9102,-87.6435
13257,3,8,false,19,2,-17,41.91054,-87.68956
13154,3,8,false,15,19,4,41.91054,-87.65312
13058,3,8,false,11,15,4,41.91059,-87.64942
TA1307000038,3,8,false,23,17,-6,41.91138,-87.63868
LF-005,3,8,false,32,24,-8,41.91172,-87.62681
13128,3,8,false,11,14,3,41.91197,-87.63197
TA1308000050,3,8,false,43,45,2,41.91211,-87.6347
13243,3,8,false,15,25,10,41.91262,-87.6814
TA1309000032,3,8,false,5,12,7,41.91293,-87.66417
TA1306000032,3,8,false,7,16,9,41.9137,-87.65285
18067,3,8,false,18,13,-5,41.9146,-87.66796
TA1306000007,3,8,false,11,2,-9,41.91469,-87.64333
13068,3,8,false,13,9,-4,41.91554,-87.68703
13179,3,8,false,38,35,-3,41.9157,-87.63461
TA1305000039,3,8,false,19,17,-2,41.9163,-87.66749
13266,3,8,false,11,2,-9,41.91774,-87.69142
TA1309000029,3,8,false,16,3,-13,41.9178,-87.68245
TA1309000006,3,8,false,13,8,-5,41.91809,-87.64375
TA1307000163,3,8,false,20,16,-4,41.91821,-87.65696
13146,3,8,false,28,28,0,41.91831,-87.63629
13059,3,8,false,24,25,1,41.91845,-87.65222
13192,3,8,false,15,17,2,41.91995,-87.64884
TA1309000030,3,8,false,14,16,2,41.92077,-87.66372
13292,3,8,false,20,12,-8,41.92152,-87.70733
TA1309000033,3,8,false,12,7,-5,41.92158,-87.65381
13193,3,8,false,44,26,-18,41.92182,-87.64412
13191,3,8,false,22,24,2,41.92217,-87.63891
13084,3,8,false,8,24,16,41.92268,-87.69715
LP-,3,8,false,20,8,-12,41.92396,-87.63584
TA1307000001,3,8,false,23,22,-1,41.92535,-87.66581
TA1306000026,3,8,false,14,28,14,41.92558,-87.65842
TA1306000016,3,8,false,19,44,25,41.9256,-87.65371
313,3,8,false,11,5,-6,41.9257,-87.64246
TA1309000019,3,8,false,34,24,-10,41.92586,-87.63897
TA1309000058,3,8,false,40,14,-26,41.92591,-87.64927
TA1308000001,3,8,false,19,13,-6,41.92627,-87.63086
13124,3,8,false,6,10,4,41.92675,-87.63444
TA1309000023,3,8,false,11,8,-3,41.9287,-87.65383
TA1307000113,3,8,false,30,19,-11,41.92878,-87.66391
13296,3,8,false,15,7,-8,41.92883,-87.66852
TA1309000059,3,8,false,6,10,4,41.92889,-87.65898
TA1309000061,3,8,false,19,19,0,41.92915,-87.64909
TA1305000014,3,8,false,31,31,0,41.92956,-87.64313
13085,3,8,false,25,14,-11,41.92958,-87.70789
TA1307000142,3,8,false,38,17,-21,41.93125,-87.64432
13276,3,8,false,30,25,-5,41.93132,-87.63874
TA1307000064,3,8,false,18,18,0,41.93222,-87.65864
TA1306000014,3,8,false,22,27,5,41.93242,-87.65271
TA1309000039,3,8,false,25,7,-18,41.93258,-87.63642
13294,3,8,false,11,9,-2,41.9326,-87.66595
TA1309000036,3,8,false,16,11,-5,41.93313,-87.64776
TA1307000006,3,8,false,11,14,3,41.93571,-87.6636
13269,3,8,false,7,11,4,41.93609,-87.66983
TA1307000052,3,8,false,19,30,11,41.93628,-87.65266
TA1307000136,3,8,false,18,13,-5,41.9365,-87.64755
TA1307000041,3,8,false,24,20,-4,41.93669,-87.63683
13137,3,8,false,30,32,2,41.9376,-87.6441
13229,3,8,false,13,20,7,41.93946,-87.66376
TA1308000019,3,8,false,12,10,-2,41.93973,-87.65886
13277,3,8,false,13,11,-2,41.9401,-87.64546
TA1307000134,3,8,false,41,25,-16,41.94016,-87.65303
TA1309000049,3,8,false,38,22,-16,41.94077,-87.63919
TA1309000025,3,8,false,16,18,2,41.94368,-87.64894
13071,3,8,false,10,12,2,41.94373,-87.66401
632,3,8,false,14,9,-5,41.94453,-87.6547
13278,3,8,false,21,22,1,41.94553,-87.64644
13235,3,8,false,16,11,-5,41.94814,-87.66396
13325,3,8,false,29,23,-6,41.94907,-87.64863
TA1307000126,3,8,false,15,18,3,41.94936,-87.65451
TA1307000150,3,8,false,25,6,-19,41.94945,-87.64646
13319,3,8,false,13,11,-2,41.95069,-87.6687
TA1307000127,3,8,false,9,12,3,41.9508,-87.65918
13323,3,8,false,22,17,-5,41.95282,-87.65
TA1309000043,3,8,false,11,12,1,41.95417,-87.66434
13063,3,8,false,9,17,8,41.95424,-87.65441
TA1308000022,3,8,false,19,6,-13,41.95438,-87.64805
13379,3,8,false,14,4,-10,41.95786,-87.6495
TA1309000027,3,8,false,30,10,-20,41.9585,-87.65499
13389,3,8,false,18,5,-13,41.961,-87.64958
TA1307000144,3,8,false,4,14,10,41.96142,-87.6762
TA1307000107,3,8,false,9,14,5,41.96164,-87.65464
TA1309000014,3,8,false,12,8,-4,41.96709,-87.66744
TA1309000066,3,8,false,14,21,7,41.9691,-87.67423
TA1309000035,3,8,false,10,16,6,41.97335,-87.66785
13108,3,8,false,11,8,-3,41.97379,-87.65971
KA1504000146,3,8,false,13,6,-7,41.978,-87.66805
KA1504000152,3,8,false,11,6,-5,41.98403,-87.65231
525,3,8,false,12,3,-9,42.01272,-87.66605
661,3,8,false,10,2,-8,42.05704,-87.68657
604,3,8,false,2,22,20,42.05824,-87.67744
KA1503000014,3,8,true,86,37,-49,41.7851,-87.60108
KA1503000070,3,8,true,34,16,-18,41.78794,-87.58831
328,3,8,true,4,14,10,41.78872,-87.6013
TA1309000011,3,8,true,4,81,77,41.78873,-87.60131
423,3,8,true,2,11,9,41.79148,-87.59988
KA1503000071,3,8,true,12,96,84,41.79148,-87.59988
KA1503000074,3,8,true,20,15,-5,41.79174,-87.58395
TA1309000063,3,8,true,38,20,-18,41.79325,-87.5878
420,3,8,true,5,10,5,41.79429,-87.60145
KA1504000076,3,8,true,56,98,42,41.7943,-87.60145
TA1308000009,3,8,true,48,15,-33,41.79522,-87.58075
TA1307000164,3,8,true,15,25,10,41.79527,-87.59647
KA1503000052,3,8,true,36,22,-14,41.79935,-87.60097
KA1503000059,3,8,true,29,13,-16,41.79952,-87.58643
TA1309000037,3,8,true,50,14,-36,41.79957,-87.59474
KA1503000007,3,8,true,42,15,-27,41.80242,-87.58689
13398,3,8,true,32,16,-16,41.80256,-87.59035
TA1308000035,3,8,true,12,15,3,41.80944,-87.59188
TA1308000002,3,8,true,12,5,-7,41.80983,-87.59937
KA1503000065,3,8,true,20,3,-17,41.81409,-87.59701
KA1503000027,3,8,true,4,11,7,41.81666,-87.61942
KA1503000068,3,8,true,29,1,-28,41.82878,-87.68062
TA1308000045,3,8,true,11,3,-8,41.83062,-87.64129
15446,3,8,true,1,11,10,41.83068,-87.65603
184,3,8,true,1,25,24,41.83104,-87.62684
TA1307000129,3,8,true,8,108,100,41.83104,-87.62683
13216,3,8,true,20,63,43,41.83473,-87.62581
13217,3,8,true,25,5,-20,41.83488,-87.61792
13215,3,8,true,17,1,-16,41.83634,-87.6135
TA1308000046,3,8,true,24,3,-21,41.83779,-87.65115
TA1309000055,3,8,true,28,5,-23,41.8382,-87.64514
KA1503000038,3,8,true,6,13,7,41.83845,-87.6354
TA1307000048,3,8,true,19,26,7,41.83855,-87.60821
TA1308000036,3,8,true,31,12,-19,41.83883,-87.62186
TA1307000139,3,8,true,25,14,-11,41.84205,-87.61698
TA1307000153,3,8,true,13,2,-11,41.84358,-87.64538
147,3,8,true,2,12,10,41.84569,-87.62251
TA1307000005,3,8,true,8,51,43,41.84569,-87.6225
15689,3,8,true,22,2,-20,41.84912,-87.69515
TA1305000001,3,8,true,12,13,1,41.85262,-87.6265
13096,3,8,true,5,19,14,41.8538,-87.69577
13091,3,8,true,7,13,6,41.85409,-87.68585
15546,3,8,true,23,4,-19,41.85416,-87.61916
13307,3,8,true,17,3,-14,41.85489,-87.66359
13089,3,8,true,12,5,-7,41.85497,-87.67567
15545,3,8,true,26,21,-5,41.85627,-87.61334
4,3,8,true,10,10,0,41.85627,-87.61334
SL-013,3,8,true,11,4,-7,41.85659,-87.62755
SL-006,3,8,true,11,4,-7,41.8568,-87.63387
13135,3,8,true,39,16,-23,41.85753,-87.66157
338,3,8,true,10,3,-7,41.85758,-87.61956
13102,3,8,true,98,26,-72,41.85762,-87.61942
13150,3,8,true,116,30,-86,41.85783,-87.62455
273,3,8,true,12,6,-6,41.85783,-87.62455
13099,3,8,true,21,11,-10,41.85784,-87.64627
TA1307000159,3,8,true,17,8,-9,41.8579,-87.6687
TA1307000044,3,8,true,13,11,-2,41.85794,-87.64083
13163,3,8,true,40,5,-35,41.85808,-87.65108
13164,3,8,true,40,7,-33,41.85818,-87.65648
SL-012,3,8,true,93,20,-73,41.86038,-87.62581
72,3,8,true,13,6,-7,41.86039,-87.62581
13304,3,8,true,16,3,-13,41.86126,-87.65659
KA1504000109,3,8,true,6,12,6,41.86192,-87.69347
TA1306000002,3,8,true,30,23,-7,41.86238,-87.65108
TA1307000124,3,8,true,102,52,-50,41.86411,-87.62372
168,3,8,true,24,13,-11,41.86415,-87.62372
TA1309000001,3,8,true,27,25,-2,41.86488,-87.64708
13029,3,8,true,4,10,6,41.86531,-87.6179
13431,3,8,true,29,31,2,41.8661,-87.60728
WL-008,3,8,true,14,13,-1,41.86712,-87.64108
TA1305000002,3,8,true,119,66,-53,41.86721,-87.62597
59,3,8,true,15,22,7,41.86721,-87.62597
15544,3,8,true,26,25,-1,41.86723,-87.61536
TA1305000017,3,8,true,8,34,26,41.86734,-87.64863
KA1706005007,3,8,true,16,7,-9,41.86749,-87.63219
SL-005,3,8,true,151,41,-110,41.8679,-87.62304
255,3,8,true,23,6,-17,41.86791,-87.62304
644,3,8,true,23,3,-20,41.86859,-87.68625
13139,3,8,true,25,10,-15,41.86893,-87.65913
13285,3,8,true,9,135,126,41.86928,-87.67372
13160,3,8,true,35,14,-21,41.86947,-87.65548
22,3,8,true,11,2,-9,41.86947,-87.65548
15550,3,8,true,19,24,5,41.87024,-87.63947
TA1309000010,3,8,true,102,68,-34,41.87074,-87.62574
SL-009,3,8,true,63,10,-53,41.87081,-87.63121
342,3,8,true,2,26,24,41.87127,-87.6737
TA1309000064,3,8,true,19,132,113,41.87127,-87.67369
261,3,8,true,3,16,13,41.87151,-87.6699
TA1307000130,3,8,true,49,52,3,41.87178,-87.65103
TA1307000121,3,8,true,33,58,25,41.87184,-87.64664
41,3,8,true,27,7,-20,41.87209,-87.62957
SL-008,3,8,true,161,59,-102,41.87209,-87.62956
13332,3,8,true,93,26,-67,41.87219,-87.6615
175,3,8,true,26,4,-22,41.87255,-87.63359
SL-011,3,8,true,106,28,-78,41.87256,-87.63356
623,3,8,true,63,35,-28,41.87272,-87.62399
KA1504000104,3,8,true,32,198,166,41.87296,-87.66912
383,3,8,true,6,33,27,41.87297,-87.66912
320,3,8,true,31,8,-23,41.87327,-87.66402
SL-007,3,8,true,60,32,-28,41.87404,-87.6277
13326,3,8,true,12,43,31,41.87425,-87.63958
321,3,8,true,19,8,-11,41.87427,-87.63257
32,3,8,true,13,1,-12,41.87464,-87.65703
TA1306000025,3,8,true,40,35,-5,41.87464,-87.65703
13028,3,8,true,26,37,11,41.87475,-87.64981
13081,3,8,true,20,32,12,41.87501,-87.67326
SL-010,3,8,true,81,38,-43,41.87501,-87.63309
15541,3,8,true,14,7,-7,41.8758,-87.62086
13037,3,8,true,8,33,25,41.87588,-87.64078
TA1305000009,3,8,true,45,46,1,41.87593,-87.63068
317,3,8,true,9,34,25,41.87603,-87.68195
TA1305000010,3,8,true,16,29,13,41.87623,-87.62444
624,3,8,true,55,63,8,41.87626,-87.62923
33,3,8,true,7,11,4,41.87715,-87.62786
TA1305000035,3,8,true,44,106,62,41.87716,-87.62787
13138,3,8,true,76,143,67,41.87723,-87.63941
631,3,8,true,9,21,12,41.87761,-87.6739
15539,3,8,true,57,78,21,41.87763,-87.64405
13158,3,8,true,137,89,-48,41.87764,-87.64957
134,3,8,true,20,13,-7,41.87764,-87.64954
13157,3,8,true,64,20,-44,41.87773,-87.6548
21,3,8,true,11,4,-7,41.87773,-87.6548
TA1305000025,3,8,true,101,290,189,41.87773,-87.63528
36,3,8,true,15,37,22,41.87776,-87.63525
TA1309000002,3,8,true,24,51,27,41.87784,-87.62408
13206,3,8,true,43,25,-18,41.87794,-87.66201
283,3,8,true,3,50,47,41.87809,-87.63183
TA1309000004,3,8,true,96,254,158,41.87811,-87.63184
107,3,8,true,12,19,7,41.87822,-87.644
638,3,8,true,166,161,-5,41.87827,-87.64078
37,3,8,true,2,30,28,41.87921,-87.62975
TA1305000005,3,8,true,23,220,197,41.87924,-87.62975
286,3,8,true,1,16,15,41.8793,-87.6355
13011,3,8,true,203,172,-31,41.87931,-87.63993
TA1309000008,3,8,true,55,127,72,41.87933,-87.6355
192,3,8,true,17,29,12,41.87935,-87.63997
KA1503000034,3,8,true,12,185,173,41.87938,-87.63197
39,3,8,true,6,18,12,41.87948,-87.62571
KA1503000015,3,8,true,42,132,90,41.87948,-87.6257
287,3,8,true,1,63,62,41.88017,-87.63527
TA1309000007,3,8,true,40,333,293,41.88022,-87.63526
WL-011,3,8,true,61,44,-17,41.88034,-87.64273
80,3,8,true,19,10,-9,41.88042,-87.65556
13156,3,8,true,99,44,-55,41.88042,-87.65554
13300,3,8,true,27,25,-2,41.88097,-87.61675
13008,3,8,true,26,75,49,41.88105,-87.62408
90,3,8,true,7,16,9,41.88107,-87.62409
49,3,8,true,3,78,75,41.88116,-87.62963
TA1305000006,3,8,true,41,420,379,41.88122,-87.6296
13134,3,8,true,14,12,-2,41.88138,-87.67493
13056,3,8,true,130,117,-13,41.88168,-87.63951
191,3,8,true,10,10,0,41.88169,-87.63951
198,3,8,true,14,18,4,41.88187,-87.6488
TA1307000120,3,8,true,117,86,-31,41.88188,-87.64879
13341,3,8,true,154,145,-9,41.88208,-87.63985
174,3,8,true,8,13,5,41.88208,-87.63984
197,3,8,true,7,18,11,41.88208,-87.62513
13036,3,8,true,48,128,80,41.8821,-87.62513
77,3,8,true,21,27,6,41.88214,-87.64108
TA1305000032,3,8,true,235,187,-48,41.88218,-87.64109
98,3,8,true,5,39,34,41.88266,-87.63251
13006,3,8,true,58,253,195,41.88268,-87.63252
13353,3,8,true,94,40,-54,41.88283,-87.6612
346,3,8,true,14,6,-8,41.88284,-87.6612
654,3,8,true,50,33,-17,41.88307,-87.65698
13409,3,8,true,47,54,7,41.8831,-87.6511
18,3,8,true,5,34,29,41.88317,-87.63735
KA1503000072,3,8,true,100,185,85,41.88317,-87.63693
91,3,8,true,25,44,19,41.88336,-87.64122
WL-012,3,8,true,238,237,-1,41.88337,-87.6412
112,3,8,true,7,32,25,41.88362,-87.6486
13053,3,8,true,70,83,13,41.88365,-87.64863
43,3,8,true,10,18,8,41.88396,-87.62455
13001,3,8,true,112,193,81,41.88397,-87.62459
13155,3,8,true,21,35,14,41.88407,-87.65689
621,3,8,true,11,6,-5,41.88412,-87.65427
18062,3,8,true,67,80,13,41.88412,-87.65427
81,3,8,true,13,42,29,41.88417,-87.6296
TA1306000010,3,8,true,68,257,189,41.88419,-87.62961
TA1305000030,3,8,true,72,476,404,41.88459,-87.63178
15535,3,8,true,55,37,-18,41.8846,-87.64455
51,3,8,true,4,61,57,41.88462,-87.63176
TA1305000029,3,8,true,53,86,33,41.88466,-87.62787
195,3,8,true,50,6,-44,41.88466,-87.61952
13263,3,8,true,236,94,-142,41.88467,-87.61952
44,3,8,true,10,9,-1,41.88468,-87.62782
TA1306000015,3,8,true,72,212,140,41.88549,-87.65232
71,3,8,true,14,20,6,41.8855,-87.65233
66,3,8,true,15,42,27,41.88557,-87.64186
13021,3,8,true,170,260,90,41.88559,-87.64184
TA1307000111,3,8,true,50,277,227,41.88582,-87.63548
164,3,8,true,4,29,25,41.88583,-87.63547
13073,3,8,true,23,12,-11,41.88592,-87.66717
KA17018054,3,8,true,11,26,15,41.88595,-87.67701
38,3,8,true,11,38,27,41.88599,-87.63089
KA1503000012,3,8,true,78,204,126,41.88599,-87.63089
52,3,8,true,15,33,18,41.886,-87.62421
TA1305000011,3,8,true,88,306,218,41.886,-87.62418
7,3,8,true,8,11,3,41.88627,-87.61751
15534,3,8,true,67,37,-30,41.88627,-87.61749
217,3,8,true,6,17,11,41.8866,-87.65821
13197,3,8,true,38,63,25,41.8866,-87.65816
264,3,8,true,10,9,-1,41.8867,-87.62224
TA1308000029,3,8,true,80,77,-3,41.88673,-87.62225
194,3,8,true,1,21,20,41.88688,-87.62606
TA1307000131,3,8,true,33,139,106,41.88688,-87.62606
KA1503000064,3,8,true,21,37,16,41.88697,-87.61281
100,3,8,true,17,19,2,41.88814,-87.63657
TA1305000022,3,8,true,95,200,105,41.88817,-87.63656
56,3,8,true,31,20,-11,41.88866,-87.64442
TA1306000003,3,8,true,142,118,-24,41.88867,-87.64442
133,3,8,true,50,46,-4,41.88918,-87.63851
KA1503000043,3,8,true,233,265,32,41.88918,-87.63851
13050,3,8,true,77,260,183,41.88919,-87.62775
47,3,8,true,7,43,36,41.88921,-87.62775
15664,3,8,true,38,5,-33,41.8895,-87.68821
285,3,8,true,13,2,-11,41.88989,-87.67149
13432,3,8,true,64,59,-5,41.88989,-87.67149
TA1307000151,3,8,true,163,282,119,41.88993,-87.63427
212,3,8,true,18,33,15,41.88995,-87.63427
636,3,8,true,69,174,105,41.88997,-87.63662
125,3,8,true,19,24,5,41.89018,-87.62621
KA1503000044,3,8,true,87,121,34,41.89018,-87.6262
196,3,8,true,39,9,-30,41.89053,-87.62205
13427,3,8,true,96,92,-4,41.89054,-87.62205
26,3,8,true,23,16,-7,41.89057,-87.61798
13430,3,8,true,63,106,43,41.89077,-87.63169
181,3,8,true,1,11,10,41.89077,-87.63168
TA1306000013,3,8,true,90,66,-24,41.89083,-87.61852
RN-,3,8,true,57,85,28,41.89102,-87.63546
672,3,8,true,17,27,10,41.89102,-87.63545
13434,3,8,true,28,18,-10,41.89108,-87.66663
TA1308000006,3,8,true,38,19,-19,41.89128,-87.67686
199,3,8,true,8,21,13,41.89143,-87.62676
TA1307000117,3,8,true,83,119,36,41.89144,-87.62675
13033,3,8,true,73,76,3,41.8916,-87.64835
186,3,8,true,13,12,-1,41.8918,-87.65879
13194,3,8,true,59,66,7,41.8918,-87.65878
TA1305000003,3,8,true,119,113,-6,41.89187,-87.62061
24,3,8,true,16,19,3,41.8919,-87.62063
643,3,8,true,26,11,-15,41.89203,-87.68939
35,3,8,true,13,6,-7,41.89227,-87.61206
13022,3,8,true,110,28,-82,41.89227,-87.61205
99,3,8,true,12,4,-8,41.89255,-87.61449
TA1306000029,3,8,true,58,51,-7,41.89256,-87.61449
13265,3,8,true,117,71,-46,41.89383,-87.64172
74,3,8,true,27,10,-17,41.89384,-87.64173
13045,3,8,true,143,177,34,41.89403,-87.62931
110,3,8,true,39,30,-9,41.89406,-87.6293
13016,3,8,true,106,308,202,41.89431,-87.62277
211,3,8,true,11,73,62,41.89439,-87.62267
KA1503000041,3,8,true,142,186,44,41.89452,-87.61798
142,3,8,true,15,21,6,41.89453,-87.61806
92,3,8,true,9,18,9,41.89455,-87.65346
13196,3,8,true,61,22,-39,41.89455,-87.65345
TA1307000062,3,8,true,122,123,1,41.89466,-87.63839
111,3,8,true,9,29,20,41.89466,-87.63837
TA1306000012,3,8,true,179,181,2,41.89475,-87.63438
53,3,8,true,30,42,12,41.89476,-87.63439
KP1705001026,3,8,true,53,53,0,41.89483,-87.6323
18058,3,8,true,38,13,-25,41.8955,-87.68201
637,3,8,true,61,20,-41,41.89563,-87.67209
128,3,8,true,14,1,-13,41.89571,-87.67716
13132,3,8,true,59,22,-37,41.89573,-87.67718
161,3,8,true,15,17,2,41.89574,-87.62599
15530,3,8,true,132,177,45,41.89575,-87.62596
18003,3,8,true,30,77,47,41.89575,-87.62011
635,3,8,true,5,11,6,41.89576,-87.62012
13247,3,8,true,46,23,-23,41.89597,-87.66775
TA1305000020,3,8,true,60,68,8,41.89636,-87.65406
54,3,8,true,16,14,-2,41.89637,-87.65407
13289,3,8,true,72,21,-51,41.89638,-87.661
337,3,8,true,9,10,1,41.89659,-87.63096
13303,3,8,true,65,37,-28,41.89672,-87.63088
13017,3,8,true,125,121,-4,41.89676,-87.6357
31,3,8,true,16,25,9,41.89677,-87.63572
13338,3,8,true,96,127,31,41.89697,-87.62173
173,3,8,true,16,29,13,41.89704,-87.62173
TA1307000061,3,8,true,80,63,-17,41.89745,-87.62873
106,3,8,true,13,3,-10,41.89746,-87.62874
25,3,8,true,2,20,18,41.89751,-87.62354
13034,3,8,true,26,78,52,41.89754,-87.62352
48,3,8,true,16,26,10,41.89772,-87.64302
TA1306000009,3,8,true,118,394,276,41.89772,-87.64299
620,3,8,true,66,32,-34,41.89817,-87.63754
KA1504000103,3,8,true,40,22,-18,41.89842,-87.68659
145,3,8,true,15,7,-8,41.89856,-87.62211
15529,3,8,true,77,69,-8,41.89858,-87.62206
140,3,8,true,21,15,-6,41.89895,-87.6299
TA1307000128,3,8,true,104,64,-40,41.89896,-87.6299
657,3,8,true,71,17,-54,41.89918,-87.6722
KA1504000117,3,8,true,8,38,30,41.89936,-87.64848
13248,3,8,true,80,27,-53,41.89964,-87.66788
46,3,8,true,19,6,-13,41.89994,-87.63444
TA1306000011,3,8,true,85,18,-67,41.89994,-87.63443
364,3,8,true,13,8,-5,41.90023,-87.64299
KA1504000116,3,8,true,59,54,-5,41.90023,-87.64299
17660,3,8,true,32,8,-24,41.90036,-87.69671
13290,3,8,true,107,23,-84,41.90069,-87.66259
29,3,8,true,11,4,-7,41.90069,-87.66259
13042,3,8,true,84,121,37,41.90097,-87.62377
85,3,8,true,4,11,7,41.90098,-87.62375
TA1307000070,3,8,true,67,19,-48,41.90133,-87.67742
KA1504000133,3,8,true,81,66,-15,41.90234,-87.62773
172,3,8,true,15,15,0,41.90236,-87.62774
13241,3,8,true,34,15,-19,41.9029,-87.68731
176,3,8,true,40,28,-12,41.90291,-87.63141
TA1306000006,3,8,true,62,5,-57,41.90292,-87.63772
23,3,8,true,12,2,-10,41.90292,-87.63772
TA1307000039,3,8,true,192,110,-82,41.90294,-87.63137
658,3,8,true,41,61,20,41.903,-87.6838
13256,3,8,true,12,6,-6,41.90302,-87.69749
TA1305000034,3,8,true,33,24,-9,41.90313,-87.67391
17,3,8,true,11,16,5,41.90313,-87.67391
182,3,8,true,41,16,-25,41.90317,-87.63442
KA1504000135,3,8,true,174,93,-81,41.90319,-87.63439
13136,3,8,true,69,42,-27,41.90326,-87.67845
210,3,8,true,19,19,0,41.90342,-87.66781
13061,3,8,true,136,65,-71,41.90342,-87.66779
KA1504000079,3,8,true,51,25,-26,41.9035,-87.64334
359,3,8,true,13,4,-9,41.90458,-87.6497
138,3,8,true,24,12,-12,41.9046,-87.64057
TA1307000115,3,8,true,77,27,-50,41.9046,-87.64056
291,3,8,true,19,13,-6,41.90672,-87.63494
TA1308000049,3,8,true,78,59,-19,41.90672,-87.6349
KA1504000134,3,8,true,54,23,-31,41.90687,-87.6262
180,3,8,true,15,5,-10,41.90687,-87.62618
13224,3,8,true,70,27,-43,41.90706,-87.66725
333,3,8,true,23,3,-20,41.90706,-87.66725
18069,3,8,true,3,37,34,41.90722,-87.65563
TA1307000143,3,8,true,45,3,-42,41.90762,-87.63854
13221,3,8,true,49,21,-28,41.90765,-87.67254
13245,3,8,true,6,16,10,41.90777,-87.68586
301,3,8,true,42,16,-26,41.90796,-87.63203
TA1309000024,3,8,true,124,72,-52,41.908,-87.63152
TA1305000041,3,8,true,56,73,17,41.9094,-87.67769
331,3,8,true,96,83,-13,41.90965,-87.64812
TA1305000037,3,8,true,80,40,-40,41.91018,-87.67003
27,3,8,true,11,1,-10,41.91019,-87.6435
TA1306000008,3,8,true,40,11,-29,41.9102,-87.6435
16,3,8,true,12,12,0,41.91035,-87.67008
213,3,8,true,14,3,-11,41.91037,-87.68237
TA1308000005,3,8,true,47,5,-42,41.91042,-87.68238
13258,3,8,true,14,6,-8,41.91043,-87.69718
13257,3,8,true,34,5,-29,41.91054,-87.68956
13154,3,8,true,86,69,-17,41.91054,-87.65312
20,3,8,true,17,14,-3,41.91055,-87.65313
13058,3,8,true,48,26,-22,41.91059,-87.64942
TA1307000038,3,8,true,71,58,-13,41.91138,-87.63868
118,3,8,true,15,7,-8,41.91138,-87.63868
LF-005,3,8,true,76,38,-38,41.91172,-87.62681
268,3,8,true,14,4,-10,41.91172,-87.62681
13128,3,8,true,36,38,2,41.91197,-87.63197
289,3,8,true,34,29,-5,41.91209,-87.63472
TA1308000050,3,8,true,119,100,-19,41.91211,-87.6347
13243,3,8,true,84,25,-59,41.91262,-87.6814
158,3,8,true,12,5,-7,41.91262,-87.6814
TA1309000032,3,8,true,5,23,18,41.91293,-87.66417
TA1306000032,3,8,true,55,30,-25,41.9137,-87.65285
93,3,8,true,10,13,3,41.91371,-87.65285
TA1307000166,3,8,true,54,44,-10,41.91386,-87.64877
15655,3,8,true,19,3,-16,41.91401,-87.70514
18017,3,8,true,15,2,-13,41.91416,-87.71676
18067,3,8,true,18,11,-7,41.9146,-87.66796
TA1306000007,3,8,true,70,27,-43,41.91469,-87.64333
13068,3,8,true,17,26,9,41.91554,-87.68703
13179,3,8,true,142,79,-63,41.9157,-87.63461
13133,3,8,true,52,35,-17,41.91598,-87.67733
58,3,8,true,11,12,1,41.91602,-87.66894
TA1305000039,3,8,true,49,79,30,41.9163,-87.66749
15650,3,8,true,18,8,-10,41.91711,-87.71023
15651,3,8,true,20,18,-2,41.91752,-87.70181
13266,3,8,true,23,12,-11,41.91774,-87.69142
TA1309000029,3,8,true,41,25,-16,41.9178,-87.68245
TA1309000006,3,8,true,77,40,-37,41.91809,-87.64375
288,3,8,true,12,8,-4,41.91809,-87.64375
TA1307000163,3,8,true,74,77,3,41.91821,-87.65696
94,3,8,true,29,17,-12,41.91831,-87.6363
13146,3,8,true,168,89,-79,41.91831,-87.63629
13059,3,8,true,51,75,24,41.91845,-87.65222
113,3,8,true,11,12,1,41.91846,-87.65222
13259,3,8,true,27,3,-24,41.91852,-87.69744
259,3,8,true,11,4,-7,41.91853,-87.69745
13192,3,8,true,79,59,-20,41.91995,-87.64884
225,3,8,true,21,10,-11,41.91995,-87.64884
13288,3,8,true,33,4,-29,41.92008,-87.67788
13242,3,8,true,8,14,6,41.92021,-87.69266
TA1309000030,3,8,true,49,39,-10,41.92077,-87.66372
290,3,8,true,10,5,-5,41.92152,-87.70734
13292,3,8,true,31,10,-21,41.92152,-87.70733
TA1309000033,3,8,true,55,49,-6,41.92158,-87.65381
13193,3,8,true,132,100,-32,41.92182,-87.64412
144,3,8,true,14,21,7,41.92182,-87.64411
13191,3,8,true,80,48,-32,41.92217,-87.63891
143,3,8,true,14,9,-5,41.92217,-87.63891
327,3,8,true,12,7,-5,41.92225,-87.65783
13084,3,8,true,29,37,8,41.92268,-87.69715
LP-,3,8,true,65,25,-40,41.92396,-87.63584
KA1504000140,3,8,true,12,6,-6,41.92409,-87.67646
16010,3,8,true,12,6,-6,41.92458,-87.72787
15648,3,8,true,16,6,-10,41.92464,-87.68931
KA1504000090,3,8,true,17,2,-15,41.92483,-87.7145
TA1307000001,3,8,true,36,35,-1,41.92535,-87.66581
TA1306000026,3,8,true,82,65,-17,41.92558,-87.65842
87,3,8,true,18,6,-12,41.92559,-87.65843
TA1306000016,3,8,true,57,141,84,41.9256,-87.65371
313,3,8,true,13,12,-1,41.9257,-87.64246
TA1309000019,3,8,true,127,39,-88,41.92586,-87.63897
TA1309000058,3,8,true,89,92,3,41.92591,-87.64927
127,3,8,true,17,20,3,41.92592,-87.64927
TA1308000001,3,8,true,69,49,-20,41.92627,-87.63086
177,3,8,true,10,10,0,41.92627,-87.63086
15646,3,8,true,41,8,-33,41.92668,-87.6977
13124,3,8,true,11,14,3,41.92675,-87.63444
302,3,8,true,8,10,2,41.92859,-87.65421
TA1309000023,3,8,true,53,44,-9,41.9287,-87.65383
TA1307000113,3,8,true,32,15,-17,41.92878,-87.66391
13296,3,8,true,35,25,-10,41.92883,-87.66852
TA1309000059,3,8,true,81,40,-41,41.92889,-87.65898
349,3,8,true,14,4,-10,41.92915,-87.6491
TA1309000061,3,8,true,56,44,-12,41.92915,-87.64909
TA1305000014,3,8,true,117,64,-53,41.92956,-87.64313
340,3,8,true,19,15,-4,41.92956,-87.64313
13085,3,8,true,39,20,-19,41.92958,-87.70789
15643,3,8,true,15,17,2,41.93057,-87.7238
TA1307000142,3,8,true,78,50,-28,41.93125,-87.64432
220,3,8,true,14,11,-3,41.93125,-87.64431
13276,3,8,true,88,48,-40,41.93132,-87.63874
324,3,8,true,21,8,-13,41.93173,-87.64179
13271,3,8,true,15,11,-4,41.93192,-87.67784
152,3,8,true,27,14,-13,41.93221,-87.65864
TA1307000064,3,8,true,123,55,-68,41.93222,-87.65864
TA1306000014,3,8,true,56,69,13,41.93242,-87.65271
TA1309000039,3,8,true,96,46,-50,41.93258,-87.63642
329,3,8,true,13,9,-4,41.93258,-87.63642
13294,3,8,true,16,17,1,41.9326,-87.66595
TA1309000036,3,8,true,27,28,1,41.93313,-87.64776
TA1307000006,3,8,true,52,27,-25,41.93571,-87.6636
153,3,8,true,8,12,4,41.93575,-87.66364
13268,3,8,true,14,11,-3,41.93588,-87.67843
13269,3,8,true,19,14,-5,41.93609,-87.66983
115,3,8,true,20,15,-5,41.93628,-87.65266
TA1307000052,3,8,true,97,101,4,41.93628,-87.65266
156,3,8,true,17,14,-3,41.9365,-87.64756
TA1307000136,3,8,true,95,87,-8,41.9365,-87.64755
TA1307000041,3,8,true,106,60,-46,41.93669,-87.63683
157,3,8,true,23,10,-13,41.9367,-87.63683
13137,3,8,true,133,94,-39,41.9376,-87.6441
300,3,8,true,23,17,-6,41.93761,-87.6441
KA17018068,3,8,true,10,7,-3,41.93935,-87.68327
TA1309000042,3,8,true,46,18,-28,41.93937,-87.66836
131,3,8,true,10,5,-5,41.93937,-87.66835
KA150400009X,3,8,true,2,10,8,41.9394,-87.71159
13229,3,8,true,57,30,-27,41.93946,-87.66376
TA1308000019,3,8,true,48,36,-12,41.93973,-87.65886
13277,3,8,true,63,29,-34,41.9401,-87.64546
296,3,8,true,16,5,-11,41.9401,-87.64546
TA1307000134,3,8,true,73,82,9,41.94016,-87.65303
117,3,8,true,11,16,5,41.94016,-87.65302
TA1309000049,3,8,true,76,79,3,41.94077,-87.63919
15634,3,8,true,26,4,-22,41.94304,-87.68729
TA1307000138,3,8,true,52,59,7,41.94334,-87.67094
230,3,8,true,18,4,-14,41.94335,-87.67093
13144,3,8,true,42,20,-22,41.9434,-87.67964
TA1309000025,3,8,true,58,36,-22,41.94368,-87.64894
299,3,8,true,15,6,-9,41.94368,-87.64894
13071,3,8,true,38,66,28,41.94373,-87.66401
632,3,8,true,51,46,-5,41.94453,-87.6547
303,3,8,true,11,10,-1,41.94522,-87.64702
13278,3,8,true,49,45,-4,41.94553,-87.64644
TA1309000050,3,8,true,20,17,-3,41.94618,-87.67331
KA1504000143,3,8,true,11,14,3,41.94664,-87.68337
227,3,8,true,13,9,-4,41.94813,-87.66397
13235,3,8,true,58,88,30,41.94814,-87.66396
304,3,8,true,15,12,-3,41.94878,-87.64922
13253,3,8,true,39,13,-26,41.9488,-87.67527
13325,3,8,true,88,69,-19,41.94907,-87.64863
TA1307000126,3,8,true,42,40,-2,41.94936,-87.65451
232,3,8,true,11,11,0,41.94943,-87.64645
TA1307000150,3,8,true,55,35,-20,41.94945,-87.64646
13319,3,8,true,35,25,-10,41.95069,-87.6687
TA1307000127,3,8,true,45,37,-8,41.9508,-87.65918
318,3,8,true,13,4,-9,41.95254,-87.6735
13323,3,8,true,66,34,-32,41.95282,-87.65
TA1309000043,3,8,true,41,34,-7,41.95417,-87.66434
13063,3,8,true,46,70,24,41.95424,-87.65441
KA1504000158,3,8,true,11,3,-8,41.95432,-87.68607
TA1308000022,3,8,true,67,46,-21,41.95438,-87.64805
TA1307000149,3,8,true,12,65,53,41.95467,-87.67392
TA1309000026,3,8,true,24,14,-10,41.95601,-87.6802
13249,3,8,true,14,2,-12,41.95606,-87.66885
312,3,8,true,10,6,-4,41.95637,-87.6563
TA1308000047,3,8,true,9,12,3,41.95709,-87.6642
13379,3,8,true,88,26,-62,41.95786,-87.6495
TA1309000018,3,8,true,17,39,22,41.95791,-87.67357
316,3,8,true,5,11,6,41.95841,-87.69401
TA1309000027,3,8,true,53,38,-15,41.9585,-87.65499
13389,3,8,true,73,26,-47,41.961,-87.64958
245,3,8,true,16,9,-7,41.96101,-87.64958
15622,3,8,true,15,5,-10,41.96108,-87.69544
TA1307000144,3,8,true,13,25,12,41.96142,-87.6762
TA1309000021,3,8,true,17,11,-6,41.9615,-87.6714
15623,3,8,true,21,4,-17,41.96154,-87.69117
482,3,8,true,10,2,-8,41.96154,-87.69117
KA1503000022,3,8,true,11,24,13,41.96158,-87.66609
TA1307000107,3,8,true,45,33,-12,41.96164,-87.65464
TA1307000156,3,8,true,31,17,-14,41.96301,-87.68479
TA1309000012,3,8,true,17,13,-4,41.96325,-87.67928
TA1308000012,3,8,true,11,8,-3,41.96398,-87.63818
293,3,8,true,9,15,6,41.96521,-87.65822
13074,3,8,true,15,51,36,41.96521,-87.6582
639,3,8,true,19,19,0,41.96584,-87.64538
KA1504000127,3,8,true,14,5,-9,41.96587,-87.70083
KA1504000093,3,8,true,14,19,5,41.96587,-87.69365
TA1307000140,3,8,true,30,17,-13,41.96643,-87.68865
TA1309000014,3,8,true,44,30,-14,41.96709,-87.66744
TA1307000158,3,8,true,29,22,-7,41.9671,-87.67904
251,3,8,true,5,10,5,41.96796,-87.65
TA1307000119,3,8,true,12,21,9,41.96796,-87.65
15615,3,8,true,1,10,9,41.96835,-87.71183
TA1308000021,3,8,true,36,7,-29,41.96883,-87.65765
KA1504000080,3,8,true,13,1,-12,41.96887,-87.69609
TA1309000066,3,8,true,80,57,-23,41.9691,-87.67423
344,3,8,true,6,11,5,41.9691,-87.67423
TA1309000041,3,8,true,13,19,6,41.96951,-87.65471
KA1504000171,3,8,true,28,25,-3,41.97161,-87.65016
TA1309000035,3,8,true,46,23,-23,41.97335,-87.66785
13108,3,8,true,25,26,1,41.97379,-87.65971
KA1504000149,3,8,true,9,17,8,41.97562,-87.67945
KA1504000160,3,8,true,11,9,-2,41.97564,-87.70143
KA1504000146,3,8,true,17,23,6,41.978,-87.66805
13109,3,8,true,26,15,-11,41.97835,-87.65976
KA1504000147,3,8,true,25,10,-15,41.97976,-87.67754
655,3,8,true,2,27,25,41.97987,-87.68194
KA1504000151,3,8,true,25,40,15,41.98359,-87.66916
459,3,8,true,15,12,-3,41.98403,-87.65231
KA1504000152,3,8,true,38,40,2,41.98403,-87.65231
15578,3,8,true,18,10,-8,41.98405,-87.66027
15575,3,8,true,42,13,-29,41.98975,-87.66014
KA1504000148,3,8,true,10,3,-7,41.99086,-87.66971
15571,3,8,true,41,16,-25,41.99478,-87.66028
KA1504000156,3,8,true,6,18,12,41.99925,-87.67137
RP-009,3,8,true,23,39,16,42.00107,-87.66122
RP-008,3,8,true,21,7,-14,42.00446,-87.6724
660,3,8,true,29,6,-23,42.00458,-87.66143
KA1504000175,3,8,true,18,5,-13,42.00797,-87.66549
KA1504000162,3,8,true,2,20,18,42.00907,-87.67422
KA1504000159,3,8,true,19,4,-15,42.01059,-87.66241
520,3,8,true,11,9,-2,42.01597,-87.66859
523,3,8,true,15,4,-11,42.02089,-87.66505
598,3,8,true,12,2,-10,42.02578,-87.68411
E002,3,8,true,45,14,-31,42.03256,-87.67912
596,3,8,true,40,24,-16,42.04822,-87.68348
600,3,8,true,10,1,-9,42.04831,-87.6983
E008,3,8,true,14,6,-8,42.05049,-87.67782
605,3,8,true,2,46,44,42.05294,-87.67342
604,3,8,true,8,53,45,42.05824,-87.67744
E014,3,8,true,10,3,-7,42.06483,-87.71531
15491,3,12,false,15,9,-6,41.78096,-87.57624
426,3,12,false,12,3,-9,41.7851,-87.60108
KA1503000014,3,12,false,27,21,-6,41.7851,-87.60108
TA1309000011,3,12,false,28,20,-8,41.78873,-87.60131
KA1503000071,3,12,false,24,18,-6,41.79148,-87.59988
KA1503000074,3,12,false,23,33,10,41.79174,-87.58395
TA1309000063,3,12,false,8,15,7,41.79325,-87.5878
KA1504000076,3,12,false,18,18,0,41.7943,-87.60145
TA1308000009,3,12,false,34,28,-6,41.79522,-87.58075
TA1307000164,3,12,false,15,8,-7,41.79527,-87.59647
KA1503000052,3,12,false,17,11,-6,41.79935,-87.60097
KA1503000059,3,12,false,24,17,-7,41.79952,-87.58643
TA1309000037,3,12,false,30,28,-2,41.79957,-87.59474
KA1503000007,3,12,false,17,18,1,41.80242,-87.58689
13398,3,12,false,6,11,5,41.80256,-87.59035
TA1308000035,3,12,false,12,6,-6,41.80944,-87.59188
TA1308000002,3,12,false,10,5,-5,41.80983,-87.59937
KA1503000065,3,12,false,10,4,-6,41.81409,-87.59701
KA1503000027,3,12,false,11,7,-4,41.81666,-87.61942
TA1308000038,3,12,false,15,6,-9,41.82298,-87.6071
13216,3,12,false,16,9,-7,41.83473,-87.62581
TA1307000048,3,12,false,22,32,10,41.83855,-87.60821
TA1305000004,3,12,false,24,12,-12,41.8514,-87.61884
TA1305000001,3,12,false,11,14,3,41.85262,-87.6265
13075,3,12,false,20,32,12,41.8531,-87.63192
15546,3,12,false,14,10,-4,41.85416,-87.61916
15545,3,12,false,27,29,2,41.85627,-87.61334
13135,3,12,false,10,13,3,41.85753,-87.66157
13102,3,12,false,20,13,-7,41.85762,-87.61942
13150,3,12,false,24,17,-7,41.85783,-87.62455
273,3,12,false,10,7,-3,41.85783,-87.62455
SL-012,3,12,false,21,14,-7,41.86038,-87.62581
TA1307000124,3,12,false,13,12,-1,41.86411,-87.62372
TA1309000001,3,12,false,14,13,-1,41.86488,-87.64708
13029,3,12,false,34,34,0,41.86531,-87.6179
13431,3,12,false,42,42,0,41.8661,-87.60728
WL-008,3,12,false,19,29,10,41.86712,-87.64108
59,3,12,false,11,10,-1,41.86721,-87.62597
TA1305000002,3,12,false,32,34,2,41.86721,-87.62597
15544,3,12,false,220,158,-62,41.86723,-87.61536
3,3,12,false,19,9,-10,41.86723,-87.61536
TA1305000017,3,12,false,11,6,-5,41.86734,-87.64863
KA1706005007,3,12,false,14,21,7,41.86749,-87.63219
SL-005,3,12,false,64,72,8,41.8679,-87.62304
255,3,12,false,11,14,3,41.86791,-87.62304
13160,3,12,false,11,11,0,41.86947,-87.65548
TA1309000010,3,12,false,29,26,-3,41.87074,-87.62574
SL-009,3,12,false,22,17,-5,41.87081,-87.63121
TA1309000064,3,12,false,23,10,-13,41.87127,-87.67369
TA1307000130,3,12,false,16,13,-3,41.87178,-87.65103
TA1307000121,3,12,false,13,7,-6,41.87184,-87.64664
SL-008,3,12,false,27,31,4,41.87209,-87.62956
13332,3,12,false,13,10,-3,41.87219,-87.6615
SL-011,3,12,false,23,19,-4,41.87256,-87.63356
623,3,12,false,79,47,-32,41.87272,-87.62399
KA1504000104,3,12,false,17,6,-11,41.87296,-87.66912
SL-007,3,12,false,23,26,3,41.87404,-87.6277
13028,3,12,false,10,8,-2,41.87475,-87.64981
SL-010,3,12,false,13,5,-8,41.87501,-87.63309
15541,3,12,false,81,63,-18,41.8758,-87.62086
TA1305000009,3,12,false,18,6,-12,41.87593,-87.63068
TA1305000010,3,12,false,31,12,-19,41.87623,-87.62444
624,3,12,false,29,10,-19,41.87626,-87.62923
TA1305000035,3,12,false,28,8,-20,41.87716,-87.62787
13138,3,12,false,12,12,0,41.87723,-87.63941
15539,3,12,false,21,15,-6,41.87763,-87.64405
13158,3,12,false,22,21,-1,41.87764,-87.64957
13157,3,12,false,16,16,0,41.87773,-87.6548
TA1305000025,3,12,false,57,33,-24,41.87773,-87.63528
TA1309000002,3,12,false,33,30,-3,41.87784,-87.62408
TA1309000004,3,12,false,29,15,-14,41.87811,-87.63184
638,3,12,false,17,21,4,41.87827,-87.64078
TA1305000005,3,12,false,37,20,-17,41.87924,-87.62975
13011,3,12,false,16,31,15,41.87931,-87.63993
TA1309000008,3,12,false,49,23,-26,41.87933,-87.6355
KA1503000034,3,12,false,15,10,-5,41.87938,-87.63197
KA1503000015,3,12,false,40,13,-27,41.87948,-87.6257
TA1309000007,3,12,false,53,31,-22,41.88022,-87.63526
WL-011,3,12,false,11,10,-1,41.88034,-87.64273
13156,3,12,false,12,16,4,41.88042,-87.65554
13300,3,12,false,142,147,5,41.88097,-87.61675
76,3,12,false,28,16,-12,41.88098,-87.61675
13008,3,12,false,109,149,40,41.88105,-87.62408
90,3,12,false,6,18,12,41.88107,-87.62409
TA1305000006,3,12,false,69,54,-15,41.88122,-87.6296
13056,3,12,false,19,8,-11,41.88168,-87.63951
TA1307000120,3,12,false,39,38,-1,41.88188,-87.64879
13341,3,12,false,14,19,5,41.88208,-87.63985
13036,3,12,false,44,39,-5,41.8821,-87.62513
TA1305000032,3,12,false,40,30,-10,41.88218,-87.64109
13006,3,12,false,12,25,13,41.88268,-87.63252
13353,3,12,false,6,12,6,41.88283,-87.6612
654,3,12,false,8,13,5,41.88307,-87.65698
13409,3,12,false,23,22,-1,41.8831,-87.6511
KA1503000072,3,12,false,31,19,-12,41.88317,-87.63693
WL-012,3,12,false,20,20,0,41.88337,-87.6412
13053,3,12,false,34,40,6,41.88365,-87.64863
13001,3,12,false,82,51,-31,41.88397,-87.62459
18062,3,12,false,11,11,0,41.88412,-87.65427
TA1306000010,3,12,false,48,41,-7,41.88419,-87.62961
TA1305000030,3,12,false,44,36,-8,41.88459,-87.63178
15535,3,12,false,25,24,-1,41.8846,-87.64455
TA1305000029,3,12,false,53,50,-3,41.88466,-87.62787
13263,3,12,false,56,26,-30,41.88467,-87.61952
TA1306000015,3,12,false,35,40,5,41.88549,-87.65232
518,3,12,false,13,4,-9,41.8855,-87.71686
13021,3,12,false,25,14,-11,41.88559,-87.64184
TA1307000111,3,12,false,33,40,7,41.88582,-87.63548
KA1503000012,3,12,false,34,17,-17,41.88599,-87.63089
52,3,12,false,6,11,5,41.886,-87.62421
TA1305000011,3,12,false,80,41,-39,41.886,-87.62418
15534,3,12,false,23,20,-3,41.88627,-87.61749
13197,3,12,false,7,11,4,41.8866,-87.65816
TA1308000029,3,12,false,22,27,5,41.88673,-87.62225
TA1307000131,3,12,false,45,62,17,41.88688,-87.62606
KA1503000064,3,12,false,66,55,-11,41.88697,-87.61281
TA1305000022,3,12,false,39,26,-13,41.88817,-87.63656
56,3,12,false,16,7,-9,41.88866,-87.64442
TA1306000003,3,12,false,29,36,7,41.88867,-87.64442
KA1503000043,3,12,false,43,48,5,41.88918,-87.63851
13050,3,12,false,28,32,4,41.88919,-87.62775
TA1307000151,3,12,false,53,40,-13,41.88993,-87.63427
636,3,12,false,8,24,16,41.88997,-87.63662
KA1503000044,3,12,false,29,16,-13,41.89018,-87.6262
13427,3,12,false,26,30,4,41.89054,-87.62205
13430,3,12,false,58,53,-5,41.89077,-87.63169
181,3,12,false,11,11,0,41.89077,-87.63168
TA1306000013,3,12,false,45,71,26,41.89083,-87.61852
RN-,3,12,false,36,27,-9,41.89102,-87.63546
13434,3,12,false,10,8,-2,41.89108,-87.66663
TA1308000006,3,12,false,13,10,-3,41.89128,-87.67686
199,3,12,false,7,10,3,41.89143,-87.62676
TA1307000117,3,12,false,68,58,-10,41.89144,-87.62675
13033,3,12,false,16,33,17,41.8916,-87.64835
13194,3,12,false,17,16,-1,41.8918,-87.65878
TA1305000003,3,12,false,43,53,10,41.89187,-87.62061
24,3,12,false,8,11,3,41.8919,-87.62063
35,3,12,false,18,17,-1,41.89227,-87.61206
13022,3,12,false,258,380,122,41.89227,-87.61205
TA1306000029,3,12,false,46,48,2,41.89256,-87.61449
13265,3,12,false,25,29,4,41.89383,-87.64172
13045,3,12,false,44,60,16,41.89403,-87.62931
110,3,12,false,11,14,3,41.89406,-87.6293
13016,3,12,false,61,54,-7,41.89431,-87.62277
KA1503000041,3,12,false,38,23,-15,41.89452,-87.61798
13196,3,12,false,12,16,4,41.89455,-87.65345
TA1307000062,3,12,false,30,28,-2,41.89466,-87.63839
TA1306000012,3,12,false,27,42,15,41.89475,-87.63438
KP1705001026,3,12,false,23,40,17,41.89483,-87.6323
637,3,12,false,10,10,0,41.89563,-87.67209
13132,3,12,false,24,20,-4,41.89573,-87.67718
15530,3,12,false,46,37,-9,41.89575,-87.62596
18003,3,12,false,18,11,-7,41.89575,-87.62011
13247,3,12,false,5,10,5,41.89597,-87.66775
TA1305000020,3,12,false,20,10,-10,41.89636,-87.65406
13289,3,12,false,10,12,2,41.89638,-87.661
13303,3,12,false,18,35,17,41.89672,-87.63088
13017,3,12,false,24,18,-6,41.89676,-87.6357
13338,3,12,false,54,36,-18,41.89697,-87.62173
TA1307000061,3,12,false,28,26,-2,41.89745,-87.62873
13034,3,12,false,60,48,-12,41.89754,-87.62352
TA1306000009,3,12,false,35,21,-14,41.89772,-87.64299
620,3,12,false,16,16,0,41.89817,-87.63754
KA1504000103,3,12,false,15,11,-4,41.89842,-87.68659
15529,3,12,false,31,25,-6,41.89858,-87.62206
TA1307000128,3,12,false,33,44,11,41.89896,-87.6299
657,3,12,false,9,11,2,41.89918,-87.6722
TA1306000011,3,12,false,19,6,-13,41.89994,-87.63443
KA1504000116,3,12,false,12,4,-8,41.90023,-87.64299
17660,3,12,false,13,13,0,41.90036,-87.69671
13290,3,12,false,11,7,-4,41.90069,-87.66259
13042,3,12,false,148,115,-33,41.90097,-87.62377
85,3,12,false,16,15,-1,41.90098,-87.62375
KA1504000133,3,12,false,38,51,13,41.90234,-87.62773
13241,3,12,false,12,3,-9,41.9029,-87.68731
176,3,12,false,17,5,-12,41.90291,-87.63141
TA1307000039,3,12,false,39,43,4,41.90294,-87.63137
658,3,12,false,16,3,-13,41.903,-87.6838
TA1305000034,3,12,false,20,23,3,41.90313,-87.67391
KA1504000135,3,12,false,37,54,17,41.90319,-87.63439
13136,3,12,false,13,20,7,41.90326,-87.67845
210,3,12,false,5,10,5,41.90342,-87.66781
13061,3,12,false,42,41,-1,41.90342,-87.66779
KA1504000079,3,12,false,30,26,-4,41.9035,-87.64334
TA1307000115,3,12,false,11,6,-5,41.9046,-87.64056
TA1308000049,3,12,false,16,29,13,41.90672,-87.6349
KA1504000134,3,12,false,19,12,-7,41.90687,-87.6262
13224,3,12,false,10,13,3,41.90706,-87.66725
13221,3,12,false,19,26,7,41.90765,-87.67254
TA1309000024,3,12,false,30,29,-1,41.908,-87.63152
TA1305000041,3,12,false,35,32,-3,41.9094,-87.67769
331,3,12,false,33,29,-4,41.90965,-87.64812
TA1305000037,3,12,false,13,13,0,41.91018,-87.67003
TA1308000005,3,12,false,10,3,-7,41.91042,-87.68238
13257,3,12,false,14,12,-2,41.91054,-87.68956
13154,3,12,false,22,27,5,41.91054,-87.65312
13058,3,12,false,18,19,1,41.91059,-87.64942
TA1307000038,3,12,false,19,32,13,41.91138,-87.63868
LF-005,3,12,false,87,94,7,41.91172,-87.62681
13128,3,12,false,36,38,2,41.91197,-87.63197
TA1308000050,3,12,false,60,55,-5,41.91211,-87.6347
13243,3,12,false,24,26,2,41.91262,-87.6814
TA1306000032,3,12,false,21,20,-1,41.9137,-87.65285
TA1307000166,3,12,false,14,9,-5,41.91386,-87.64877
15655,3,12,false,11,11,0,41.91401,-87.70514
18017,3,12,false,12,10,-2,41.91416,-87.71676
18067,3,12,false,19,7,-12,41.9146,-87.66796
13068,3,12,false,5,10,5,41.91554,-87.68703
13179,3,12,false,57,78,21,41.9157,-87.63461
13133,3,12,false,13,16,3,41.91598,-87.67733
TA1305000039,3,12,false,12,15,3,41.9163,-87.66749
TA1309000029,3,12,false,12,5,-7,41.9178,-87.68245
TA1309000006,3,12,false,14,13,-1,41.91809,-87.64375
TA1307000163,3,12,false,11,12,1,41.91821,-87.65696
13146,3,12,false,61,61,0,41.91831,-87.63629
13059,3,12,false,40,30,-10,41.91845,-87.65222
13259,3,12,false,12,13,1,41.91852,-87.69744
13192,3,12,false,19,17,-2,41.91995,-87.64884
13288,3,12,false,11,6,-5,41.92008,-87.67788
TA1309000030,3,12,false,16,16,0,41.92077,-87.66372
TA1309000033,3,12,false,27,19,-8,41.92158,-87.65381
13193,3,12,false,28,34,6,41.92182,-87.64412
13191,3,12,false,25,19,-6,41.92217,-87.63891
13084,3,12,false,15,20,5,41.92268,-87.69715
LP-,3,12,false,31,52,21,41.92396,-87.63584
KA1504000140,3,12,false,12,7,-5,41.92409,-87.67646
TA1307000001,3,12,false,20,15,-5,41.92535,-87.66581
TA1306000026,3,12,false,25,21,-4,41.92558,-87.65842
TA1306000016,3,12,false,28,26,-2,41.9256,-87.65371
TA1309000019,3,12,false,55,33,-22,41.92586,-87.63897
TA1309000058,3,12,false,30,32,2,41.92591,-87.64927
177,3,12,false,8,12,4,41.92627,-87.63086
TA1308000001,3,12,false,68,107,39,41.92627,-87.63086
13124,3,12,false,30,29,-1,41.92675,-87.63444
TA1309000023,3,12,false,24,24,0,41.9287,-87.65383
TA1307000113,3,12,false,17,9,-8,41.92878,-87.66391
13296,3,12,false,22,14,-8,41.92883,-87.66852
TA1309000059,3,12,false,18,10,-8,41.92889,-87.65898
TA1309000061,3,12,false,15,23,8,41.92915,-87.64909
TA1308000031,3,12,false,13,14,1,41.92946,-87.68417
TA1305000014,3,12,false,37,45,8,41.92956,-87.64313
13085,3,12,false,18,21,3,41.92958,-87.70789
15643,3,12,false,4,12,8,41.93057,-87.7238
TA1307000142,3,12,false,44,43,-1,41.93125,-87.64432
13276,3,12,false,39,26,-13,41.93132,-87.63874
324,3,12,false,4,12,8,41.93173,-87.64179
TA1307000064,3,12,false,27,17,-10,41.93222,-87.65864
TA1306000014,3,12,false,34,28,-6,41.93242,-87.65271
329,3,12,false,10,4,-6,41.93258,-87.63642
TA1309000039,3,12,false,47,46,-1,41.93258,-87.63642
TA1309000036,3,12,false,12,31,19,41.93313,-87.64776
TA1307000006,3,12,false,18,11,-7,41.93571,-87.6636
13269,3,12,false,8,11,3,41.93609,-87.66983
TA1307000052,3,12,false,23,25,2,41.93628,-87.65266
TA1307000136,3,12,false,24,21,-3,41.9365,-87.64755
TA1307000041,3,12,false,38,35,-3,41.93669,-87.63683
13137,3,12,false,51,52,1,41.9376,-87.6441
15642,3,12,false,10,6,-4,41.93843,-87.69801
TA1309000042,3,12,false,30,21,-9,41.93937,-87.66836
13229,3,12,false,17,13,-4,41.93946,-87.66376
TA1308000019,3,12,false,14,24,10,41.93973,-87.65886
13277,3,12,false,33,27,-6,41.9401,-87.64546
TA1307000134,3,12,false,45,39,-6,41.94016,-87.65303
TA1309000049,3,12,false,46,41,-5,41.94077,-87.63919
TA1307000138,3,12,false,20,17,-3,41.94334,-87.67094
13144,3,12,false,16,11,-5,41.9434,-87.67964
TA1309000025,3,12,false,30,23,-7,41.94368,-87.64894
13071,3,12,false,28,33,5,41.94373,-87.66401
632,3,12,false,25,39,14,41.94453,-87.6547
13278,3,12,false,34,28,-6,41.94553,-87.64644
13235,3,12,false,17,28,11,41.94814,-87.66396
13253,3,12,false,20,7,-13,41.9488,-87.67527
13325,3,12,false,41,24,-17,41.94907,-87.64863
TA1307000126,3,12,false,37,60,23,41.94936,-87.65451
TA1307000150,3,12,false,26,20,-6,41.94945,-87.64646
TA1307000127,3,12,false,40,46,6,41.9508,-87.65918
13323,3,12,false,44,10,-34,41.95282,-87.65
TA1309000043,3,12,false,10,8,-2,41.95417,-87.66434
13063,3,12,false,32,29,-3,41.95424,-87.65441
TA1308000022,3,12,false,23,29,6,41.95438,-87.64805
TA1309000026,3,12,false,12,6,-6,41.95601,-87.6802
13249,3,12,false,4,10,6,41.95606,-87.66885
13379,3,12,false,17,19,2,41.95786,-87.6495
TA1309000027,3,12,false,19,20,1,41.9585,-87.65499
13389,3,12,false,18,20,2,41.961,-87.64958
TA1307000144,3,12,false,12,4,-8,41.96142,-87.6762
KA1503000022,3,12,false,11,6,-5,41.96158,-87.66609
TA1307000107,3,12,false,33,16,-17,41.96164,-87.65464
TA1308000012,3,12,false,44,55,11,41.96398,-87.63818
13074,3,12,false,13,9,-4,41.96521,-87.6582
639,3,12,false,26,30,4,41.96584,-87.64538
TA1309000014,3,12,false,9,10,1,41.96709,-87.66744
TA1307000119,3,12,false,24,14,-10,41.96796,-87.65
TA1308000021,3,12,false,4,16,12,41.96883,-87.65765
TA1309000066,3,12,false,25,11,-14,41.9691,-87.67423
KA1504000171,3,12,false,16,7,-9,41.97161,-87.65016
TA1309000035,3,12,false,16,10,-6,41.97335,-87.66785
13108,3,12,false,12,24,12,41.97379,-87.65971
KA1504000149,3,12,false,6,10,4,41.97562,-87.67945
KA1504000146,3,12,false,21,29,8,41.978,-87.66805
13109,3,12,false,10,9,-1,41.97835,-87.65976
KA1504000151,3,12,false,13,6,-7,41.98359,-87.66916
KA1504000152,3,12,false,44,41,-3,41.98403,-87.65231
15578,3,12,false,21,14,-7,41.98405,-87.66027
15575,3,12,false,19,12,-7,41.98975,-87.66014
15571,3,12,false,12,12,0,41.99478,-87.66028
RP-009,3,12,false,9,11,2,42.00107,-87.66122
E002,3,12,false,7,10,3,42.03256,-87.67912
596,3,12,false,15,11,-4,42.04822,-87.68348
E008,3,12,false,11,15,4,42.05049,-87.67782
661,3,12,false,8,12,4,42.05704,-87.68657
604,3,12,false,16,14,-2,42.05824,-87.67744
KA1503000029,3,12,true,11,2,-9,41.77364,-87.56747
KA1503000014,3,12,true,74,52,-22,41.7851,-87.60108
426,3,12,true,25,16,-9,41.7851,-87.60108
KA1503000070,3,12,true,14,6,-8,41.78794,-87.58831
328,3,12,true,12,4,-8,41.78872,-87.6013
TA1309000011,3,12,true,30,24,-6,41.78873,-87.60131
423,3,12,true,15,41,26,41.79148,-87.59988
KA1503000071,3,12,true,38,93,55,41.79148,-87.59988
KA1503000074,3,12,true,16,9,-7,41.79174,-87.58395
TA1309000063,3,12,true,26,28,2,41.79325,-87.5878
420,3,12,true,20,12,-8,41.79429,-87.60145
KA1504000076,3,12,true,55,76,21,41.7943,-87.60145
TA1308000009,3,12,true,33,19,-14,41.79522,-87.58075
TA1307000164,3,12,true,22,19,-3,41.79527,-87.59647
KA1503000052,3,12,true,34,19,-15,41.79935,-87.60097
KA1503000059,3,12,true,22,23,1,41.79952,-87.58643
TA1309000037,3,12,true,41,31,-10,41.79957,-87.59474
417,3,12,true,13,11,-2,41.80242,-87.5869
KA1503000007,3,12,true,19,23,4,41.80242,-87.58689
13398,3,12,true,23,15,-8,41.80256,-87.59035
322,3,12,true,13,8,-5,41.80321,-87.59849
TA1308000035,3,12,true,12,15,3,41.80944,-87.59188
KA1503000065,3,12,true,14,5,-9,41.81409,-87.59701
TA1308000045,3,12,true,21,10,-11,41.83062,-87.64129
TA1307000129,3,12,true,12,23,11,41.83104,-87.62683
15445,3,12,true,9,14,5,41.83453,-87.63183
13216,3,12,true,81,74,-7,41.83473,-87.62581
148,3,12,true,18,9,-9,41.83474,-87.62581
149,3,12,true,2,11,9,41.83486,-87.61791
13217,3,12,true,33,35,2,41.83488,-87.61792
13215,3,12,true,17,7,-10,41.83634,-87.6135
TA1308000046,3,12,true,16,9,-7,41.83779,-87.65115
TA1309000055,3,12,true,22,21,-1,41.8382,-87.64514
KA1503000038,3,12,true,19,18,-1,41.83845,-87.6354
TA1307000048,3,12,true,13,16,3,41.83855,-87.60821
TA1308000036,3,12,true,26,25,-1,41.83883,-87.62186
TA1307000139,3,12,true,36,29,-7,41.84205,-87.61698
TA1307000153,3,12,true,15,8,-7,41.84358,-87.64538
TA1307000005,3,12,true,16,17,1,41.84569,-87.6225
TA1305000001,3,12,true,16,13,-3,41.85262,-87.6265
13075,3,12,true,16,16,0,41.8531,-87.63192
13096,3,12,true,11,6,-5,41.8538,-87.69577
15546,3,12,true,12,5,-7,41.85416,-87.61916
15545,3,12,true,39,33,-6,41.85627,-87.61334
SL-013,3,12,true,14,13,-1,41.85659,-87.62755
13135,3,12,true,19,30,11,41.85753,-87.66157
13102,3,12,true,41,31,-10,41.85762,-87.61942
13150,3,12,true,33,23,-10,41.85783,-87.62455
273,3,12,true,10,4,-6,41.85783,-87.62455
13099,3,12,true,5,10,5,41.85784,-87.64627
TA1307000159,3,12,true,14,13,-1,41.8579,-87.6687
TA1307000044,3,12,true,7,17,10,41.85794,-87.64083
13163,3,12,true,9,12,3,41.85808,-87.65108
13164,3,12,true,28,13,-15,41.85818,-87.65648
SL-012,3,12,true,53,45,-8,41.86038,-87.62581
13304,3,12,true,12,8,-4,41.86126,-87.65659
TA1306000002,3,12,true,26,22,-4,41.86238,-87.65108
TA1307000124,3,12,true,57,33,-24,41.86411,-87.62372
168,3,12,true,19,13,-6,41.86415,-87.62372
TA1309000001,3,12,true,48,37,-11,41.86488,-87.64708
13354,3,12,true,11,14,3,41.86524,-87.66651
13431,3,12,true,19,19,0,41.8661,-87.60728
WL-008,3,12,true,25,43,18,41.86712,-87.64108
TA1305000002,3,12,true,94,85,-9,41.86721,-87.62597
59,3,12,true,12,23,11,41.86721,-87.62597
15544,3,12,true,26,29,3,41.86723,-87.61536
TA1305000017,3,12,true,27,16,-11,41.86734,-87.64863
55,3,12,true,3,12,9,41.86735,-87.64863
KA1706005007,3,12,true,23,12,-11,41.86749,-87.63219
SL-005,3,12,true,60,61,1,41.8679,-87.62304
255,3,12,true,11,8,-3,41.86791,-87.62304
644,3,12,true,41,15,-26,41.86859,-87.68625
19,3,12,true,20,7,-13,41.86892,-87.65913
13139,3,12,true,74,34,-40,41.86893,-87.65913
13285,3,12,true,40,40,0,41.86928,-87.67372
22,3,12,true,19,13,-6,41.86947,-87.65548
13160,3,12,true,41,42,1,41.86947,-87.65548
15550,3,12,true,17,16,-1,41.87024,-87.63947
TA1309000010,3,12,true,51,57,6,41.87074,-87.62574
SL-009,3,12,true,14,21,7,41.87081,-87.63121
342,3,12,true,12,14,2,41.87127,-87.6737
TA1309000064,3,12,true,77,68,-9,41.87127,-87.67369
15542,3,12,true,2,14,12,41.87146,-87.64095
TA1307000130,3,12,true,88,108,20,41.87178,-87.65103
241,3,12,true,11,9,-2,41.8718,-87.65102
108,3,12,true,12,18,6,41.87183,-87.64664
TA1307000121,3,12,true,57,94,37,41.87184,-87.64664
41,3,12,true,8,15,7,41.87209,-87.62957
SL-008,3,12,true,71,88,17,41.87209,-87.62956
13332,3,12,true,104,86,-18,41.87219,-87.6615
SL-011,3,12,true,38,27,-11,41.87256,-87.63356
623,3,12,true,27,18,-9,41.87272,-87.62399
KA1504000104,3,12,true,68,58,-10,41.87296,-87.66912
320,3,12,true,17,15,-2,41.87327,-87.66402
SL-007,3,12,true,16,27,11,41.87404,-87.6277
13326,3,12,true,22,11,-11,41.87425,-87.63958
321,3,12,true,2,11,9,41.87427,-87.63257
TA1306000025,3,12,true,33,32,-1,41.87464,-87.65703
15668,3,12,true,15,8,-7,41.87471,-87.68642
109,3,12,true,4,12,8,41.87475,-87.64981
13028,3,12,true,41,52,11,41.87475,-87.64981
SL-010,3,12,true,18,16,-2,41.87501,-87.63309
13037,3,12,true,16,9,-7,41.87588,-87.64078
TA1305000009,3,12,true,19,18,-1,41.87593,-87.63068
TA1305000010,3,12,true,23,32,9,41.87623,-87.62444
624,3,12,true,33,36,3,41.87626,-87.62923
TA1305000035,3,12,true,55,75,20,41.87716,-87.62787
13138,3,12,true,32,32,0,41.87723,-87.63941
15539,3,12,true,60,49,-11,41.87763,-87.64405
13158,3,12,true,74,94,20,41.87764,-87.64957
134,3,12,true,9,15,6,41.87764,-87.64954
21,3,12,true,9,12,3,41.87773,-87.6548
13157,3,12,true,53,57,4,41.87773,-87.6548
TA1305000025,3,12,true,75,89,14,41.87773,-87.63528
36,3,12,true,12,14,2,41.87776,-87.63525
TA1309000002,3,12,true,20,14,-6,41.87784,-87.62408
13206,3,12,true,28,22,-6,41.87794,-87.66201
TA1309000004,3,12,true,55,39,-16,41.87811,-87.63184
107,3,12,true,13,9,-4,41.87822,-87.644
638,3,12,true,35,60,25,41.87827,-87.64078
TA1305000005,3,12,true,33,46,13,41.87924,-87.62975
13011,3,12,true,62,87,25,41.87931,-87.63993
TA1309000008,3,12,true,38,37,-1,41.87933,-87.6355
192,3,12,true,12,8,-4,41.87935,-87.63997
KA1503000034,3,12,true,51,25,-26,41.87938,-87.63197
39,3,12,true,10,6,-4,41.87948,-87.62571
KA1503000015,3,12,true,49,29,-20,41.87948,-87.6257
15667,3,12,true,12,11,-1,41.8798,-87.68609
287,3,12,true,12,10,-2,41.88017,-87.63527
TA1309000007,3,12,true,82,58,-24,41.88022,-87.63526
WL-011,3,12,true,31,36,5,41.88034,-87.64273
13156,3,12,true,38,39,1,41.88042,-87.65554
13300,3,12,true,39,39,0,41.88097,-87.61675
76,3,12,true,12,9,-3,41.88098,-87.61675
13008,3,12,true,31,47,16,41.88105,-87.62408
49,3,12,true,10,8,-2,41.88116,-87.62963
TA1305000006,3,12,true,100,72,-28,41.88122,-87.6296
13134,3,12,true,8,10,2,41.88138,-87.67493
13056,3,12,true,21,20,-1,41.88168,-87.63951
198,3,12,true,6,13,7,41.88187,-87.6488
TA1307000120,3,12,true,89,93,4,41.88188,-87.64879
13341,3,12,true,36,44,8,41.88208,-87.63985
197,3,12,true,12,10,-2,41.88208,-87.62513
13036,3,12,true,49,60,11,41.8821,-87.62513
77,3,12,true,8,12,4,41.88214,-87.64108
TA1305000032,3,12,true,73,96,23,41.88218,-87.64109
98,3,12,true,13,7,-6,41.88266,-87.63251
13006,3,12,true,77,64,-13,41.88268,-87.63252
13353,3,12,true,32,41,9,41.88283,-87.6612
654,3,12,true,25,33,8,41.88307,-87.65698
13409,3,12,true,31,50,19,41.8831,-87.6511
KA1503000072,3,12,true,48,33,-15,41.88317,-87.63693
91,3,12,true,6,16,10,41.88336,-87.64122
WL-012,3,12,true,48,67,19,41.88337,-87.6412
112,3,12,true,7,12,5,41.88362,-87.6486
13053,3,12,true,71,73,2,41.88365,-87.64863
43,3,12,true,13,10,-3,41.88396,-87.62455
13001,3,12,true,72,96,24,41.88397,-87.62459
13155,3,12,true,18,25,7,41.88407,-87.65689
18062,3,12,true,33,38,5,41.88412,-87.65427
81,3,12,true,12,25,13,41.88417,-87.6296
TA1306000010,3,12,true,78,94,16,41.88419,-87.62961
TA1305000030,3,12,true,94,80,-14,41.88459,-87.63178
15535,3,12,true,44,22,-22,41.8846,-87.64455
51,3,12,true,10,14,4,41.88462,-87.63176
TA1305000029,3,12,true,87,57,-30,41.88466,-87.62787
195,3,12,true,23,21,-2,41.88466,-87.61952
13263,3,12,true,63,68,5,41.88467,-87.61952
44,3,12,true,11,9,-2,41.88468,-87.62782
TA1306000015,3,12,true,64,66,2,41.88549,-87.65232
71,3,12,true,15,11,-4,41.8855,-87.65233
66,3,12,true,11,9,-2,41.88557,-87.64186
13021,3,12,true,89,82,-7,41.88559,-87.64184
TA1307000111,3,12,true,81,85,4,41.88582,-87.63548
164,3,12,true,15,14,-1,41.88583,-87.63547
KA17018054,3,12,true,13,12,-1,41.88595,-87.67701
38,3,12,true,9,12,3,41.88599,-87.63089
KA1503000012,3,12,true,48,55,7,41.88599,-87.63089
52,3,12,true,11,11,0,41.886,-87.62421
TA1305000011,3,12,true,85,91,6,41.886,-87.62418
15534,3,12,true,27,30,3,41.88627,-87.61749
13197,3,12,true,17,22,5,41.8866,-87.65816
TA1308000029,3,12,true,27,49,22,41.88673,-87.62225
TA1307000131,3,12,true,36,36,0,41.88688,-87.62606
KA1503000064,3,12,true,16,21,5,41.88697,-87.61281
TA1305000022,3,12,true,90,78,-12,41.88817,-87.63656
56,3,12,true,28,22,-6,41.88866,-87.64442
TA1306000003,3,12,true,95,89,-6,41.88867,-87.64442
KA1503000043,3,12,true,125,131,6,41.88918,-87.63851
133,3,12,true,15,23,8,41.88918,-87.63851
13050,3,12,true,45,54,9,41.88919,-87.62775
47,3,12,true,10,8,-2,41.88921,-87.62775
13432,3,12,true,12,8,-4,41.88989,-87.67149
TA1307000151,3,12,true,90,90,0,41.88993,-87.63427
212,3,12,true,12,14,2,41.88995,-87.63427
636,3,12,true,43,53,10,41.88997,-87.63662
KA1503000044,3,12,true,27,43,16,41.89018,-87.6262
196,3,12,true,13,8,-5,41.89053,-87.62205
13427,3,12,true,39,33,-6,41.89054,-87.62205
26,3,12,true,9,11,2,41.89057,-87.61798
13430,3,12,true,72,71,-1,41.89077,-87.63169
181,3,12,true,16,12,-4,41.89077,-87.63168
TA1306000013,3,12,true,50,57,7,41.89083,-87.61852
RN-,3,12,true,51,53,2,41.89102,-87.63546
672,3,12,true,11,17,6,41.89102,-87.63545
13434,3,12,true,17,14,-3,41.89108,-87.66663
TA1308000006,3,12,true,16,10,-6,41.89128,-87.67686
199,3,12,true,21,30,9,41.89143,-87.62676
TA1307000117,3,12,true,81,118,37,41.89144,-87.62675
13033,3,12,true,54,53,-1,41.8916,-87.64835
84,3,12,true,14,11,-3,41.89161,-87.64833
13194,3,12,true,44,44,0,41.8918,-87.65878
TA1305000003,3,12,true,86,68,-18,41.89187,-87.62061
24,3,12,true,19,16,-3,41.8919,-87.62063
643,3,12,true,9,11,2,41.89203,-87.68939
35,3,12,true,8,13,5,41.89227,-87.61206
13022,3,12,true,76,74,-2,41.89227,-87.61205
99,3,12,true,13,5,-8,41.89255,-87.61449
TA1306000029,3,12,true,38,36,-2,41.89256,-87.61449
13265,3,12,true,77,82,5,41.89383,-87.64172
74,3,12,true,16,21,5,41.89384,-87.64173
13045,3,12,true,141,124,-17,41.89403,-87.62931
110,3,12,true,24,26,2,41.89406,-87.6293
13016,3,12,true,142,141,-1,41.89431,-87.62277
211,3,12,true,18,23,5,41.89439,-87.62267
KA1503000041,3,12,true,82,61,-21,41.89452,-87.61798
142,3,12,true,14,12,-2,41.89453,-87.61806
13196,3,12,true,25,31,6,41.89455,-87.65345
TA1307000062,3,12,true,51,57,6,41.89466,-87.63839
111,3,12,true,10,7,-3,41.89466,-87.63837
TA1306000012,3,12,true,120,76,-44,41.89475,-87.63438
53,3,12,true,22,13,-9,41.89476,-87.63439
627,3,12,true,10,11,1,41.8948,-87.63231
KP1705001026,3,12,true,52,49,-3,41.89483,-87.6323
16920,3,12,true,18,20,2,41.89495,-87.76491
18058,3,12,true,12,7,-5,41.8955,-87.68201
637,3,12,true,14,18,4,41.89563,-87.67209
128,3,12,true,10,14,4,41.89571,-87.67716
13132,3,12,true,42,43,1,41.89573,-87.67718
161,3,12,true,9,10,1,41.89574,-87.62599
15530,3,12,true,62,63,1,41.89575,-87.62596
18003,3,12,true,45,34,-11,41.89575,-87.62011
635,3,12,true,12,5,-7,41.89576,-87.62012
13247,3,12,true,28,21,-7,41.89597,-87.66775
TA1305000020,3,12,true,21,31,10,41.89636,-87.65406
13289,3,12,true,16,23,7,41.89638,-87.661
13303,3,12,true,32,33,1,41.89672,-87.63088
13017,3,12,true,40,46,6,41.89676,-87.6357
31,3,12,true,13,9,-4,41.89677,-87.63572
13338,3,12,true,55,59,4,41.89697,-87.62173
173,3,12,true,13,10,-3,41.89704,-87.62173
TA1307000061,3,12,true,54,60,6,41.89745,-87.62873
106,3,12,true,9,13,4,41.89746,-87.62874
13034,3,12,true,32,25,-7,41.89754,-87.62352
48,3,12,true,10,7,-3,41.89772,-87.64302
TA1306000009,3,12,true,61,53,-8,41.89772,-87.64299
620,3,12,true,51,40,-11,41.89817,-87.63754
KA1504000103,3,12,true,22,22,0,41.89842,-87.68659
145,3,12,true,6,10,4,41.89856,-87.62211
15529,3,12,true,67,50,-17,41.89858,-87.62206
140,3,12,true,7,11,4,41.89895,-87.6299
TA1307000128,3,12,true,53,79,26,41.89896,-87.6299
657,3,12,true,19,18,-1,41.89918,-87.6722
13248,3,12,true,27,20,-7,41.89964,-87.66788
TA1306000011,3,12,true,19,21,2,41.89994,-87.63443
KA1504000116,3,12,true,33,30,-3,41.90023,-87.64299
17660,3,12,true,14,19,5,41.90036,-87.69671
13290,3,12,true,26,25,-1,41.90069,-87.66259
13042,3,12,true,68,84,16,41.90097,-87.62377
85,3,12,true,13,12,-1,41.90098,-87.62375
TA1307000070,3,12,true,33,21,-12,41.90133,-87.67742
KA1504000133,3,12,true,60,58,-2,41.90234,-87.62773
305,3,12,true,11,4,-7,41.9028,-87.69005
13241,3,12,true,18,16,-2,41.9029,-87.68731
176,3,12,true,21,24,3,41.90291,-87.63141
TA1306000006,3,12,true,14,14,0,41.90292,-87.63772
TA1307000039,3,12,true,98,103,5,41.90294,-87.63137
658,3,12,true,20,20,0,41.903,-87.6838
TA1305000034,3,12,true,30,43,13,41.90313,-87.67391
182,3,12,true,10,10,0,41.90317,-87.63442
KA1504000135,3,12,true,85,95,10,41.90319,-87.63439
13136,3,12,true,27,33,6,41.90326,-87.67845
210,3,12,true,15,13,-2,41.90342,-87.66781
13061,3,12,true,55,50,-5,41.90342,-87.66779
KA1504000079,3,12,true,41,41,0,41.9035,-87.64334
359,3,12,true,8,12,4,41.90458,-87.6497
TA1307000115,3,12,true,24,35,11,41.9046,-87.64056
TA1308000049,3,12,true,44,41,-3,41.90672,-87.6349
KA1504000134,3,12,true,38,38,0,41.90687,-87.6262
180,3,12,true,7,12,5,41.90687,-87.62618
333,3,12,true,12,7,-5,41.90706,-87.66725
13224,3,12,true,25,20,-5,41.90706,-87.66725
18069,3,12,true,14,8,-6,41.90722,-87.65563
13221,3,12,true,40,40,0,41.90765,-87.67254
13245,3,12,true,17,7,-10,41.90777,-87.68586
TA1309000024,3,12,true,55,59,4,41.908,-87.63152
69,3,12,true,12,11,-1,41.90939,-87.6777
TA1305000041,3,12,true,34,54,20,41.9094,-87.67769
331,3,12,true,87,63,-24,41.90965,-87.64812
TA1305000037,3,12,true,24,45,21,41.91018,-87.67003
TA1306000008,3,12,true,23,21,-2,41.9102,-87.6435
TA1308000005,3,12,true,22,23,1,41.91042,-87.68238
13258,3,12,true,11,4,-7,41.91043,-87.69718
13257,3,12,true,21,18,-3,41.91054,-87.68956
13154,3,12,true,70,72,2,41.91054,-87.65312
20,3,12,true,15,12,-3,41.91055,-87.65313
13058,3,12,true,40,54,14,41.91059,-87.64942
118,3,12,true,13,9,-4,41.91138,-87.63868
TA1307000038,3,12,true,35,41,6,41.91138,-87.63868
LF-005,3,12,true,82,58,-24,41.91172,-87.62681
268,3,12,true,14,9,-5,41.91172,-87.62681
126,3,12,true,13,6,-7,41.91196,-87.63197
13128,3,12,true,36,29,-7,41.91197,-87.63197
289,3,12,true,23,26,3,41.91209,-87.63472
TA1308000050,3,12,true,90,101,11,41.91211,-87.6347
158,3,12,true,8,13,5,41.91262,-87.6814
13243,3,12,true,46,58,12,41.91262,-87.6814
TA1306000032,3,12,true,59,58,-1,41.9137,-87.65285
93,3,12,true,12,14,2,41.91371,-87.65285
TA1307000166,3,12,true,43,48,5,41.91386,-87.64877
18067,3,12,true,22,26,4,41.9146,-87.66796
TA1306000007,3,12,true,17,14,-3,41.91469,-87.64333
13068,3,12,true,29,31,2,41.91554,-87.68703
13179,3,12,true,84,75,-9,41.9157,-87.63461
141,3,12,true,12,8,-4,41.91571,-87.63461
13133,3,12,true,28,25,-3,41.91598,-87.67733
TA1305000039,3,12,true,26,21,-5,41.9163,-87.66749
15651,3,12,true,9,11,2,41.91752,-87.70181
13266,3,12,true,11,8,-3,41.91774,-87.69142
TA1309000029,3,12,true,19,14,-5,41.9178,-87.68245
TA1309000006,3,12,true,26,33,7,41.91809,-87.64375
TA1307000163,3,12,true,37,49,12,41.91821,-87.65696
94,3,12,true,16,11,-5,41.91831,-87.6363
13146,3,12,true,72,45,-27,41.91831,-87.63629
13059,3,12,true,62,79,17,41.91845,-87.65222
113,3,12,true,17,5,-12,41.91846,-87.65222
13259,3,12,true,11,15,4,41.91852,-87.69744
13192,3,12,true,64,57,-7,41.91995,-87.64884
225,3,12,true,18,18,0,41.91995,-87.64884
13288,3,12,true,24,17,-7,41.92008,-87.67788
TA1309000030,3,12,true,21,39,18,41.92077,-87.66372
13292,3,12,true,11,12,1,41.92152,-87.70733
TA1309000033,3,12,true,59,56,-3,41.92158,-87.65381
13193,3,12,true,72,93,21,41.92182,-87.64412
144,3,12,true,12,17,5,41.92182,-87.64411
143,3,12,true,12,8,-4,41.92217,-87.63891
13191,3,12,true,43,48,5,41.92217,-87.63891
327,3,12,true,11,18,7,41.92225,-87.65783
13084,3,12,true,25,29,4,41.92268,-87.69715
LP-,3,12,true,27,25,-2,41.92396,-87.63584
KA1504000140,3,12,true,16,12,-4,41.92409,-87.67646
TA1307000001,3,12,true,48,49,1,41.92535,-87.66581
TA1306000026,3,12,true,56,56,0,41.92558,-87.65842
67,3,12,true,13,6,-7,41.9256,-87.65371
TA1306000016,3,12,true,65,64,-1,41.9256,-87.65371
313,3,12,true,14,27,13,41.9257,-87.64246
TA1309000019,3,12,true,72,75,3,41.92586,-87.63897
TA1309000058,3,12,true,76,87,11,41.92591,-87.64927
127,3,12,true,15,12,-3,41.92592,-87.64927
177,3,12,true,18,17,-1,41.92627,-87.63086
TA1308000001,3,12,true,69,73,4,41.92627,-87.63086
15646,3,12,true,10,12,2,41.92668,-87.6977
13124,3,12,true,27,10,-17,41.92675,-87.63444
TA1309000023,3,12,true,32,36,4,41.9287,-87.65383
TA1307000113,3,12,true,36,35,-1,41.92878,-87.66391
13296,3,12,true,25,19,-6,41.92883,-87.66852
TA1309000059,3,12,true,21,19,-2,41.92889,-87.65898
TA1309000061,3,12,true,71,51,-20,41.92915,-87.64909
TA1308000031,3,12,true,25,12,-13,41.92946,-87.68417
340,3,12,true,21,19,-2,41.92956,-87.64313
TA1305000014,3,12,true,53,76,23,41.92956,-87.64313
13085,3,12,true,19,15,-4,41.92958,-87.70789
TA1307000142,3,12,true,89,68,-21,41.93125,-87.64432
220,3,12,true,13,25,12,41.93125,-87.64431
13276,3,12,true,36,47,11,41.93132,-87.63874
324,3,12,true,7,11,4,41.93173,-87.64179
13271,3,12,true,19,19,0,41.93192,-87.67784
TA1307000064,3,12,true,47,52,5,41.93222,-87.65864
13,3,12,true,12,10,-2,41.93242,-87.65271
TA1306000014,3,12,true,49,56,7,41.93242,-87.65271
TA1309000039,3,12,true,47,37,-10,41.93258,-87.63642
329,3,12,true,14,10,-4,41.93258,-87.63642
13294,3,12,true,19,18,-1,41.9326,-87.66595
TA1309000036,3,12,true,50,41,-9,41.93313,-87.64776
332,3,12,true,11,13,2,41.93313,-87.64776
TA1307000006,3,12,true,44,33,-11,41.93571,-87.6636
153,3,12,true,4,10,6,41.93575,-87.66364
13268,3,12,true,30,15,-15,41.93588,-87.67843
13269,3,12,true,33,30,-3,41.93609,-87.66983
TA1307000052,3,12,true,73,64,-9,41.93628,-87.65266
115,3,12,true,16,13,-3,41.93628,-87.65266
156,3,12,true,8,16,8,41.9365,-87.64756
TA1307000136,3,12,true,84,63,-21,41.9365,-87.64755
TA1307000041,3,12,true,56,56,0,41.93669,-87.63683
157,3,12,true,15,14,-1,41.9367,-87.63683
13137,3,12,true,103,84,-19,41.9376,-87.6441
300,3,12,true,22,19,-3,41.93761,-87.6441
15642,3,12,true,11,9,-2,41.93843,-87.69801
KA17018068,3,12,true,16,13,-3,41.93935,-87.68327
TA1309000042,3,12,true,35,53,18,41.93937,-87.66836
13229,3,12,true,31,31,0,41.93946,-87.66376
226,3,12,true,13,12,-1,41.93972,-87.65886
TA1308000019,3,12,true,31,26,-5,41.93973,-87.65886
13277,3,12,true,75,61,-14,41.9401,-87.64546
296,3,12,true,17,7,-10,41.9401,-87.64546
TA1307000134,3,12,true,64,66,2,41.94016,-87.65303
117,3,12,true,20,15,-5,41.94016,-87.65302
13143,3,12,true,6,12,6,41.94059,-87.67853
334,3,12,true,11,5,-6,41.94076,-87.63919
TA1309000049,3,12,true,55,52,-3,41.94077,-87.63919
TA1307000138,3,12,true,42,49,7,41.94334,-87.67094
230,3,12,true,7,12,5,41.94335,-87.67093
13144,3,12,true,15,30,15,41.9434,-87.67964
299,3,12,true,14,14,0,41.94368,-87.64894
TA1309000025,3,12,true,62,76,14,41.94368,-87.64894
229,3,12,true,16,12,-4,41.94372,-87.66401
13071,3,12,true,51,67,16,41.94373,-87.66401
632,3,12,true,58,73,15,41.94453,-87.6547
303,3,12,true,15,18,3,41.94522,-87.64702
13278,3,12,true,71,77,6,41.94553,-87.64644
TA1309000050,3,12,true,8,16,8,41.94618,-87.67331
13235,3,12,true,50,53,3,41.94814,-87.66396
304,3,12,true,14,13,-1,41.94878,-87.64922
13253,3,12,true,22,27,5,41.9488,-87.67527
13325,3,12,true,88,93,5,41.94907,-87.64863
TA1307000126,3,12,true,51,67,16,41.94936,-87.65451
232,3,12,true,17,7,-10,41.94943,-87.64645
TA1307000150,3,12,true,95,56,-39,41.94945,-87.64646
13319,3,12,true,16,26,10,41.95069,-87.6687
TA1307000127,3,12,true,51,47,-4,41.9508,-87.65918
13323,3,12,true,56,41,-15,41.95282,-87.65
256,3,12,true,13,5,-8,41.95282,-87.65
TA1309000043,3,12,true,41,21,-20,41.95417,-87.66434
240,3,12,true,9,10,1,41.95424,-87.65441
13063,3,12,true,37,42,5,41.95424,-87.65441
254,3,12,true,7,15,8,41.95438,-87.64806
TA1308000022,3,12,true,63,46,-17,41.95438,-87.64805
TA1307000149,3,12,true,33,27,-6,41.95467,-87.67392
TA1309000026,3,12,true,17,25,8,41.95601,-87.6802
TA1308000047,3,12,true,11,20,9,41.95709,-87.6642
13379,3,12,true,55,51,-4,41.95786,-87.6495
TA1309000018,3,12,true,11,10,-1,41.95791,-87.67357
306,3,12,true,8,10,2,41.9585,-87.655
TA1309000027,3,12,true,35,27,-8,41.9585,-87.65499
13389,3,12,true,57,37,-20,41.961,-87.64958
TA1307000144,3,12,true,15,12,-3,41.96142,-87.6762
TA1309000021,3,12,true,14,11,-3,41.9615,-87.6714
15623,3,12,true,25,16,-9,41.96154,-87.69117
KA1503000022,3,12,true,26,17,-9,41.96158,-87.66609
231,3,12,true,7,13,6,41.96163,-87.65464
TA1307000107,3,12,true,60,52,-8,41.96164,-87.65464
TA1307000156,3,12,true,12,18,6,41.96301,-87.68479
243,3,12,true,9,10,1,41.96302,-87.68479
TA1309000012,3,12,true,19,7,-12,41.96325,-87.67928
249,3,12,true,6,10,4,41.96398,-87.63818
TA1308000012,3,12,true,35,43,8,41.96398,-87.63818
293,3,12,true,14,10,-4,41.96521,-87.65822
13074,3,12,true,32,31,-1,41.96521,-87.6582
639,3,12,true,35,30,-5,41.96584,-87.64538
KA1504000093,3,12,true,13,11,-2,41.96587,-87.69365
TA1307000140,3,12,true,17,39,22,41.96643,-87.68865
TA1309000014,3,12,true,41,27,-14,41.96709,-87.66744
TA1307000158,3,12,true,32,13,-19,41.9671,-87.67904
TA1307000119,3,12,true,33,25,-8,41.96796,-87.65
TA1308000021,3,12,true,20,14,-6,41.96883,-87.65765
KA1504000080,3,12,true,12,13,1,41.96887,-87.69609
TA1309000015,3,12,true,7,11,4,41.96889,-87.68401
344,3,12,true,12,13,1,41.9691,-87.67423
TA1309000066,3,12,true,30,48,18,41.9691,-87.67423
TA1309000041,3,12,true,14,18,4,41.96951,-87.65471
KA1504000171,3,12,true,34,29,-5,41.97161,-87.65016
TA1309000035,3,12,true,40,48,8,41.97335,-87.66785
295,3,12,true,11,10,-1,41.97378,-87.65972
13108,3,12,true,30,33,3,41.97379,-87.65971
KA1504000149,3,12,true,11,5,-6,41.97562,-87.67945
KA1504000160,3,12,true,12,2,-10,41.97564,-87.70143
KA1504000146,3,12,true,37,24,-13,41.978,-87.66805
13109,3,12,true,36,31,-5,41.97835,-87.65976
294,3,12,true,6,10,4,41.97835,-87.65976
KA1504000151,3,12,true,27,35,8,41.98359,-87.66916
459,3,12,true,14,11,-3,41.98403,-87.65231
KA1504000152,3,12,true,55,66,11,41.98403,-87.65231
15578,3,12,true,27,26,-1,41.98405,-87.66027
15575,3,12,true,16,21,5,41.98975,-87.66014
15571,3,12,true,20,16,-4,41.99478,-87.66028
RP-009,3,12,true,24,12,-12,42.00107,-87.66122
660,3,12,true,17,9,-8,42.00458,-87.66143
KA1504000175,3,12,true,17,18,1,42.00797,-87.66549
520,3,12,true,25,9,-16,42.01597,-87.66859
523,3,12,true,16,11,-5,42.02089,-87.66505
598,3,12,true,14,2,-12,42.02578,-87.68411
E002,3,12,true,16,15,-1,42.03256,-87.67912
596,3,12,true,26,30,4,42.04822,-87.68348
E008,3,12,true,13,17,4,42.05049,-87.67782
605,3,12,true,16,15,-1,42.05294,-87.67342
604,3,12,true,25,24,-1,42.05824,-87.67744
E014,3,12,true,10,10,0,42.06483,-87.71531
15491,3,16,false,17,18,1,41.78096,-87.57624
KA1503000014,3,16,false,25,20,-5,41.7851,-87.60108
426,3,16,false,11,16,5,41.7851,-87.60108
TA1309000011,3,16,false,29,6,-23,41.78873,-87.60131
KA1503000071,3,16,false,49,23,-26,41.79148,-87.59988
KA1503000074,3,16,false,51,17,-34,41.79174,-87.58395
424,3,16,false,11,2,-9,41.79174,-87.58395
TA1309000063,3,16,false,17,27,10,41.79325,-87.5878
KA1504000076,3,16,false,27,14,-13,41.7943,-87.60145
247,3,16,false,16,14,-2,41.79522,-87.58077
TA1308000009,3,16,false,49,37,-12,41.79522,-87.58075
TA1307000164,3,16,false,10,19,9,41.79527,-87.59647
KA1503000052,3,16,false,11,23,12,41.79935,-87.60097
KA1503000059,3,16,false,33,24,-9,41.79952,-87.58643
TA1309000037,3,16,false,25,39,14,41.79957,-87.59474
KA1503000007,3,16,false,17,30,13,41.80242,-87.58689
13398,3,16,false,13,10,-3,41.80256,-87.59035
TA1308000002,3,16,false,10,8,-2,41.80983,-87.59937
KA1503000065,3,16,false,8,11,3,41.81409,-87.59701
KA1503000027,3,16,false,12,4,-8,41.81666,-87.61942
TA1308000038,3,16,false,13,13,0,41.82298,-87.6071
TA1307000129,3,16,false,8,10,2,41.83104,-87.62683
KA1503000004,3,16,false,16,26,10,41.83127,-87.6088
13345,3,16,false,7,17,10,41.83138,-87.61803
13216,3,16,false,15,6,-9,41.83473,-87.62581
KA1503000038,3,16,false,6,10,4,41.83845,-87.6354
150,3,16,false,11,9,-2,41.83855,-87.60821
TA1307000048,3,16,false,50,51,1,41.83855,-87.60821
15443,3,16,false,3,10,7,41.84275,-87.63549
TA1307000005,3,16,false,13,9,-4,41.84569,-87.6225
TA1305000004,3,16,false,11,5,-6,41.8514,-87.61884
TA1305000001,3,16,false,16,9,-7,41.85262,-87.6265
13075,3,16,false,27,24,-3,41.8531,-87.63192
13162,3,16,false,12,8,-4,41.85378,-87.64659
13307,3,16,false,4,11,7,41.85489,-87.66359
13089,3,16,false,9,17,8,41.85497,-87.67567
13331,3,16,false,3,11,8,41.85515,-87.65414
15545,3,16,false,39,38,-1,41.85627,-87.61334
SL-013,3,16,false,12,11,-1,41.85659,-87.62755
SL-006,3,16,false,12,4,-8,41.8568,-87.63387
13135,3,16,false,13,15,2,41.85753,-87.66157
13102,3,16,false,18,22,4,41.85762,-87.61942
13150,3,16,false,26,25,-1,41.85783,-87.62455
13099,3,16,false,9,10,1,41.85784,-87.64627
TA1307000159,3,16,false,14,13,-1,41.8579,-87.6687
TA1307000044,3,16,false,6,11,5,41.85794,-87.64083
13163,3,16,false,15,30,15,41.85808,-87.65108
13164,3,16,false,18,17,-1,41.85818,-87.65648
SL-012,3,16,false,17,30,13,41.86038,-87.62581
13304,3,16,false,11,11,0,41.86126,-87.65659
KA1504000109,3,16,false,12,1,-11,41.86192,-87.69347
TA1307000124,3,16,false,55,32,-23,41.86411,-87.62372
TA1309000001,3,16,false,30,24,-6,41.86488,-87.64708
13029,3,16,false,82,40,-42,41.86531,-87.6179
97,3,16,false,11,2,-9,41.86531,-87.6179
341,3,16,false,10,14,4,41.86608,-87.60733
13431,3,16,false,88,68,-20,41.8661,-87.60728
WL-008,3,16,false,21,32,11,41.86712,-87.64108
TA1305000002,3,16,false,69,52,-17,41.86721,-87.62597
59,3,16,false,19,13,-6,41.86721,-87.62597
15544,3,16,false,204,159,-45,41.86723,-87.61536
3,3,16,false,15,13,-2,41.86723,-87.61536
KA1706005007,3,16,false,26,44,18,41.86749,-87.63219
SL-005,3,16,false,127,102,-25,41.8679,-87.62304
255,3,16,false,19,31,12,41.86791,-87.62304
13139,3,16,false,9,16,7,41.86893,-87.65913
13285,3,16,false,27,3,-24,41.86928,-87.67372
13160,3,16,false,21,27,6,41.86947,-87.65548
15550,3,16,false,19,18,-1,41.87024,-87.63947
TA1309000010,3,16,false,50,52,2,41.87074,-87.62574
SL-009,3,16,false,17,30,13,41.87081,-87.63121
TA1309000064,3,16,false,32,5,-27,41.87127,-87.67369
TA1307000130,3,16,false,12,19,7,41.87178,-87.65103
TA1307000121,3,16,false,31,9,-22,41.87184,-87.64664
41,3,16,false,10,6,-4,41.87209,-87.62957
SL-008,3,16,false,46,60,14,41.87209,-87.62956
13332,3,16,false,25,25,0,41.87219,-87.6615
SL-011,3,16,false,32,62,30,41.87256,-87.63356
623,3,16,false,98,111,13,41.87272,-87.62399
KA1504000104,3,16,false,42,7,-35,41.87296,-87.66912
SL-007,3,16,false,17,25,8,41.87404,-87.6277
321,3,16,false,10,8,-2,41.87427,-87.63257
TA1306000025,3,16,false,11,3,-8,41.87464,-87.65703
15668,3,16,false,10,8,-2,41.87471,-87.68642
13028,3,16,false,18,16,-2,41.87475,-87.64981
SL-010,3,16,false,11,17,6,41.87501,-87.63309
15541,3,16,false,86,110,24,41.8758,-87.62086
13037,3,16,false,10,11,1,41.87588,-87.64078
TA1305000010,3,16,false,33,29,-4,41.87623,-87.62444
624,3,16,false,31,26,-5,41.87626,-87.62923
2,3,16,false,8,11,3,41.87649,-87.62051
TA1305000035,3,16,false,33,19,-14,41.87716,-87.62787
13138,3,16,false,21,6,-15,41.87723,-87.63941
631,3,16,false,9,11,2,41.87761,-87.6739
15539,3,16,false,27,18,-9,41.87763,-87.64405
13158,3,16,false,36,33,-3,41.87764,-87.64957
13157,3,16,false,21,28,7,41.87773,-87.6548
TA1305000025,3,16,false,104,36,-68,41.87773,-87.63528
TA1309000002,3,16,false,38,31,-7,41.87784,-87.62408
13206,3,16,false,11,10,-1,41.87794,-87.66201
283,3,16,false,10,3,-7,41.87809,-87.63183
TA1309000004,3,16,false,58,25,-33,41.87811,-87.63184
638,3,16,false,53,47,-6,41.87827,-87.64078
TA1305000005,3,16,false,43,17,-26,41.87924,-87.62975
13011,3,16,false,68,50,-18,41.87931,-87.63993
TA1309000008,3,16,false,33,33,0,41.87933,-87.6355
KA1503000034,3,16,false,32,23,-9,41.87938,-87.63197
KA1503000015,3,16,false,62,22,-40,41.87948,-87.6257
287,3,16,false,11,4,-7,41.88017,-87.63527
TA1309000007,3,16,false,110,26,-84,41.88022,-87.63526
WL-011,3,16,false,36,15,-21,41.88034,-87.64273
73,3,16,false,13,9,-4,41.8804,-87.64273
13156,3,16,false,28,39,11,41.88042,-87.65554
13300,3,16,false,181,199,18,41.88097,-87.61675
76,3,16,false,24,15,-9,41.88098,-87.61675
13008,3,16,false,209,263,54,41.88105,-87.62408
90,3,16,false,23,43,20,41.88107,-87.62409
49,3,16,false,12,6,-6,41.88116,-87.62963
TA1305000006,3,16,false,116,23,-93,41.88122,-87.6296
13134,3,16,false,9,10,1,41.88138,-87.67493
13056,3,16,false,54,21,-33,41.88168,-87.63951
198,3,16,false,9,10,1,41.88187,-87.6488
TA1307000120,3,16,false,61,74,13,41.88188,-87.64879
13341,3,16,false,62,52,-10,41.88208,-87.63985
13036,3,16,false,45,37,-8,41.8821,-87.62513
TA1305000032,3,16,false,103,58,-45,41.88218,-87.64109
13006,3,16,false,46,12,-34,41.88268,-87.63252
13353,3,16,false,22,22,0,41.88283,-87.6612
654,3,16,false,17,21,4,41.88307,-87.65698
13409,3,16,false,24,40,16,41.8831,-87.6511
18,3,16,false,11,3,-8,41.88317,-87.63735
KA1503000072,3,16,false,56,11,-45,41.88317,-87.63693
WL-012,3,16,false,67,51,-16,41.88337,-87.6412
13053,3,16,false,46,71,25,41.88365,-87.64863
43,3,16,false,13,10,-3,41.88396,-87.62455
13001,3,16,false,115,115,0,41.88397,-87.62459
13155,3,16,false,21,17,-4,41.88407,-87.65689
18062,3,16,false,35,20,-15,41.88412,-87.65427
81,3,16,false,15,9,-6,41.88417,-87.6296
TA1306000010,3,16,false,64,37,-27,41.88419,-87.62961
TA1305000030,3,16,false,70,24,-46,41.88459,-87.63178
15535,3,16,false,25,51,26,41.8846,-87.64455
TA1305000029,3,16,false,89,90,1,41.88466,-87.62787
13263,3,16,false,55,51,-4,41.88467,-87.61952
TA1306000015,3,16,false,67,67,0,41.88549,-87.65232
518,3,16,false,10,4,-6,41.8855,-87.71686
66,3,16,false,10,3,-7,41.88557,-87.64186
13021,3,16,false,49,46,-3,41.88559,-87.64184
TA1307000111,3,16,false,94,35,-59,41.88582,-87.63548
13073,3,16,false,8,18,10,41.88592,-87.66717
KA17018054,3,16,false,13,6,-7,41.88595,-87.67701
KA1503000012,3,16,false,60,58,-2,41.88599,-87.63089
52,3,16,false,10,2,-8,41.886,-87.62421
TA1305000011,3,16,false,104,101,-3,41.886,-87.62418
15534,3,16,false,41,50,9,41.88627,-87.61749
13197,3,16,false,28,15,-13,41.8866,-87.65816
TA1308000029,3,16,false,34,35,1,41.88673,-87.62225
TA1307000131,3,16,false,67,55,-12,41.88688,-87.62606
KA1503000064,3,16,false,98,93,-5,41.88697,-87.61281
6,3,16,false,9,10,1,41.88697,-87.61281
TA1305000022,3,16,false,72,42,-30,41.88817,-87.63656
56,3,16,false,17,11,-6,41.88866,-87.64442
TA1306000003,3,16,false,47,42,-5,41.88867,-87.64442
133,3,16,false,11,9,-2,41.88918,-87.63851
KA1503000043,3,16,false,77,81,4,41.88918,-87.63851
13050,3,16,false,72,53,-19,41.88919,-87.62775
47,3,16,false,12,8,-4,41.88921,-87.62775
13432,3,16,false,19,9,-10,41.88989,-87.67149
TA1307000151,3,16,false,53,49,-4,41.88993,-87.63427
212,3,16,false,10,9,-1,41.88995,-87.63427
636,3,16,false,45,24,-21,41.88997,-87.63662
KA1503000044,3,16,false,38,34,-4,41.89018,-87.6262
13427,3,16,false,49,59,10,41.89054,-87.62205
26,3,16,false,5,15,10,41.89057,-87.61798
13430,3,16,false,85,76,-9,41.89077,-87.63169
181,3,16,false,12,7,-5,41.89077,-87.63168
TA1306000013,3,16,false,89,124,35,41.89083,-87.61852
RN-,3,16,false,63,54,-9,41.89102,-87.63546
13434,3,16,false,28,19,-9,41.89108,-87.66663
TA1308000006,3,16,false,21,21,0,41.89128,-87.67686
199,3,16,false,17,13,-4,41.89143,-87.62676
TA1307000117,3,16,false,69,108,39,41.89144,-87.62675
13033,3,16,false,66,73,7,41.8916,-87.64835
13194,3,16,false,34,39,5,41.8918,-87.65878
TA1305000003,3,16,false,76,78,2,41.89187,-87.62061
24,3,16,false,10,7,-3,41.8919,-87.62063
643,3,16,false,6,14,8,41.89203,-87.68939
35,3,16,false,26,36,10,41.89227,-87.61206
13022,3,16,false,490,505,15,41.89227,-87.61205
TA1306000029,3,16,false,77,94,17,41.89256,-87.61449
13265,3,16,false,47,65,18,41.89383,-87.64172
74,3,16,false,6,19,13,41.89384,-87.64173
13045,3,16,false,74,91,17,41.89403,-87.62931
110,3,16,false,10,13,3,41.89406,-87.6293
13016,3,16,false,97,64,-33,41.89431,-87.62277
211,3,16,false,12,3,-9,41.89439,-87.62267
KA1503000041,3,16,false,55,42,-13,41.89452,-87.61798
13196,3,16,false,29,29,0,41.89455,-87.65345
TA1307000062,3,16,false,23,19,-4,41.89466,-87.63839
TA1306000012,3,16,false,97,65,-32,41.89475,-87.63438
53,3,16,false,13,14,1,41.89476,-87.63439
627,3,16,false,12,4,-8,41.8948,-87.63231
KP1705001026,3,16,false,51,47,-4,41.89483,-87.6323
637,3,16,false,19,33,14,41.89563,-87.67209
13132,3,16,false,30,46,16,41.89573,-87.67718
15530,3,16,false,70,69,-1,41.89575,-87.62596
18003,3,16,false,37,25,-12,41.89575,-87.62011
13247,3,16,false,32,28,-4,41.89597,-87.66775
TA1305000020,3,16,false,31,33,2,41.89636,-87.65406
13289,3,16,false,19,29,10,41.89638,-87.661
13303,3,16,false,28,52,24,41.89672,-87.63088
13017,3,16,false,25,41,16,41.89676,-87.6357
31,3,16,false,3,12,9,41.89677,-87.63572
13338,3,16,false,44,33,-11,41.89697,-87.62173
TA1307000061,3,16,false,29,23,-6,41.89745,-87.62873
13034,3,16,false,63,69,6,41.89754,-87.62352
TA1306000009,3,16,false,94,26,-68,41.89772,-87.64299
620,3,16,false,46,48,2,41.89817,-87.63754
KA1504000103,3,16,false,15,9,-6,41.89842,-87.68659
15529,3,16,false,45,48,3,41.89858,-87.62206
140,3,16,false,16,21,5,41.89895,-87.6299
TA1307000128,3,16,false,77,86,9,41.89896,-87.6299
657,3,16,false,15,19,4,41.89918,-87.6722
13248,3,16,false,23,22,-1,41.89964,-87.66788
TA1306000011,3,16,false,27,21,-6,41.89994,-87.63443
KA1504000116,3,16,false,24,20,-4,41.90023,-87.64299
17660,3,16,false,20,17,-3,41.90036,-87.69671
13290,3,16,false,35,23,-12,41.90069,-87.66259
13042,3,16,false,189,190,1,41.90097,-87.62377
85,3,16,false,25,23,-2,41.90098,-87.62375
TA1307000070,3,16,false,24,14,-10,41.90133,-87.67742
KA1504000133,3,16,false,69,62,-7,41.90234,-87.62773
172,3,16,false,11,10,-1,41.90236,-87.62774
13241,3,16,false,12,12,0,41.9029,-87.68731
176,3,16,false,19,23,4,41.90291,-87.63141
TA1307000039,3,16,false,105,141,36,41.90294,-87.63137
658,3,16,false,15,6,-9,41.903,-87.6838
13256,3,16,false,18,19,1,41.90302,-87.69749
TA1305000034,3,16,false,35,32,-3,41.90313,-87.67391
182,3,16,false,11,10,-1,41.90317,-87.63442
KA1504000135,3,16,false,116,110,-6,41.90319,-87.63439
13136,3,16,false,26,37,11,41.90326,-87.67845
210,3,16,false,11,5,-6,41.90342,-87.66781
13061,3,16,false,57,58,1,41.90342,-87.66779
KA1504000079,3,16,false,25,50,25,41.9035,-87.64334
TA1307000115,3,16,false,14,21,7,41.9046,-87.64056
TA1308000049,3,16,false,79,61,-18,41.90672,-87.6349
KA1504000134,3,16,false,51,40,-11,41.90687,-87.6262
13224,3,16,false,34,20,-14,41.90706,-87.66725
18069,3,16,false,17,3,-14,41.90722,-87.65563
TA1307000143,3,16,false,20,15,-5,41.90762,-87.63854
61,3,16,false,8,13,5,41.90764,-87.67254
13221,3,16,false,35,49,14,41.90765,-87.67254
13245,3,16,false,4,11,7,41.90777,-87.68586
301,3,16,false,13,5,-8,41.90796,-87.63203
TA1309000024,3,16,false,75,65,-10,41.908,-87.63152
69,3,16,false,12,8,-4,41.90939,-87.6777
TA1305000041,3,16,false,67,50,-17,41.9094,-87.67769
331,3,16,false,80,62,-18,41.90965,-87.64812
TA1305000037,3,16,false,44,17,-27,41.91018,-87.67003
TA1306000008,3,16,false,15,17,2,41.9102,-87.6435
TA1308000005,3,16,false,23,11,-12,41.91042,-87.68238
13258,3,16,false,22,17,-5,41.91043,-87.69718
13257,3,16,false,16,29,13,41.91054,-87.68956
13154,3,16,false,37,41,4,41.91054,-87.65312
13058,3,16,false,31,35,4,41.91059,-87.64942
TA1307000038,3,16,false,44,41,-3,41.91138,-87.63868
268,3,16,false,18,21,3,41.91172,-87.62681
LF-005,3,16,false,175,192,17,41.91172,-87.62681
126,3,16,false,10,3,-7,41.91196,-87.63197
13128,3,16,false,37,36,-1,41.91197,-87.63197
289,3,16,false,12,11,-1,41.91209,-87.63472
TA1308000050,3,16,false,101,108,7,41.91211,-87.6347
13243,3,16,false,36,34,-2,41.91262,-87.6814
TA1309000032,3,16,false,12,6,-6,41.91293,-87.66417
TA1306000032,3,16,false,25,32,7,41.9137,-87.65285
TA1307000166,3,16,false,25,20,-5,41.91386,-87.64877
15655,3,16,false,18,16,-2,41.91401,-87.70514
18017,3,16,false,18,16,-2,41.91416,-87.71676
18067,3,16,false,25,18,-7,41.9146,-87.66796
13068,3,16,false,19,15,-4,41.91554,-87.68703
13179,3,16,false,71,71,0,41.9157,-87.63461
141,3,16,false,4,13,9,41.91571,-87.63461
13133,3,16,false,28,28,0,41.91598,-87.67733
TA1305000039,3,16,false,36,38,2,41.9163,-87.66749
15650,3,16,false,12,14,2,41.91711,-87.71023
15651,3,16,false,14,13,-1,41.91752,-87.70181
13266,3,16,false,14,14,0,41.91774,-87.69142
TA1309000029,3,16,false,6,16,10,41.9178,-87.68245
TA1309000006,3,16,false,35,21,-14,41.91809,-87.64375
TA1307000163,3,16,false,37,31,-6,41.91821,-87.65696
94,3,16,false,12,8,-4,41.91831,-87.6363
13146,3,16,false,90,89,-1,41.91831,-87.63629
13059,3,16,false,47,79,32,41.91845,-87.65222
113,3,16,false,13,9,-4,41.91846,-87.65222
13259,3,16,false,15,13,-2,41.91852,-87.69744
225,3,16,false,4,10,6,41.91995,-87.64884
13192,3,16,false,24,37,13,41.91995,-87.64884
13288,3,16,false,9,13,4,41.92008,-87.67788
13242,3,16,false,15,17,2,41.92021,-87.69266
TA1309000030,3,16,false,32,28,-4,41.92077,-87.66372
13292,3,16,false,16,13,-3,41.92152,-87.70733
TA1309000033,3,16,false,32,30,-2,41.92158,-87.65381
13193,3,16,false,64,94,30,41.92182,-87.64412
144,3,16,false,12,21,9,41.92182,-87.64411
13191,3,16,false,52,37,-15,41.92217,-87.63891
143,3,16,false,12,2,-10,41.92217,-87.63891
13084,3,16,false,40,36,-4,41.92268,-87.69715
123,3,16,false,3,10,7,41.92268,-87.69714
LP-,3,16,false,90,47,-43,41.92396,-87.63584
KA1504000140,3,16,false,13,13,0,41.92409,-87.67646
15648,3,16,false,8,16,8,41.92464,-87.68931
KA1504000090,3,16,false,10,15,5,41.92483,-87.7145
TA1307000001,3,16,false,41,42,1,41.92535,-87.66581
TA1306000026,3,16,false,25,41,16,41.92558,-87.65842
TA1306000016,3,16,false,65,47,-18,41.9256,-87.65371
313,3,16,false,16,7,-9,41.9257,-87.64246
TA1309000019,3,16,false,83,87,4,41.92586,-87.63897
TA1309000058,3,16,false,62,49,-13,41.92591,-87.64927
177,3,16,false,25,16,-9,41.92627,-87.63086
TA1308000001,3,16,false,127,125,-2,41.92627,-87.63086
15646,3,16,false,8,12,4,41.92668,-87.6977
34,3,16,false,11,4,-7,41.92675,-87.63444
13124,3,16,false,36,36,0,41.92675,-87.63444
TA1309000023,3,16,false,41,43,2,41.9287,-87.65383
TA1307000113,3,16,false,20,16,-4,41.92878,-87.66391
13296,3,16,false,23,24,1,41.92883,-87.66852
TA1309000059,3,16,false,18,19,1,41.92889,-87.65898
TA1309000061,3,16,false,44,35,-9,41.92915,-87.64909
TA1308000031,3,16,false,26,27,1,41.92946,-87.68417
TA1305000014,3,16,false,62,56,-6,41.92956,-87.64313
340,3,16,false,10,10,0,41.92956,-87.64313
13085,3,16,false,29,27,-2,41.92958,-87.70789
TA1307000142,3,16,false,77,59,-18,41.93125,-87.64432
220,3,16,false,8,14,6,41.93125,-87.64431
13276,3,16,false,61,41,-20,41.93132,-87.63874
324,3,16,false,8,15,7,41.93173,-87.64179
13271,3,16,false,17,14,-3,41.93192,-87.67784
152,3,16,false,10,1,-9,41.93221,-87.65864
TA1307000064,3,16,false,32,28,-4,41.93222,-87.65864
13,3,16,false,14,14,0,41.93242,-87.65271
TA1306000014,3,16,false,43,55,12,41.93242,-87.65271
TA1309000039,3,16,false,73,64,-9,41.93258,-87.63642
329,3,16,false,12,11,-1,41.93258,-87.63642
13294,3,16,false,24,21,-3,41.9326,-87.66595
TA1309000036,3,16,false,31,49,18,41.93313,-87.64776
15644,3,16,false,10,6,-4,41.93534,-87.71687
TA1307000006,3,16,false,50,22,-28,41.93571,-87.6636
13268,3,16,false,16,14,-2,41.93588,-87.67843
13269,3,16,false,18,10,-8,41.93609,-87.66983
TA1307000052,3,16,false,39,43,4,41.93628,-87.65266
156,3,16,false,14,5,-9,41.9365,-87.64756
TA1307000136,3,16,false,41,40,-1,41.9365,-87.64755
TA1307000041,3,16,false,60,73,13,41.93669,-87.63683
157,3,16,false,12,21,9,41.9367,-87.63683
13137,3,16,false,70,96,26,41.9376,-87.6441
300,3,16,false,7,12,5,41.93761,-87.6441
15642,3,16,false,12,15,3,41.93843,-87.69801
KA17018068,3,16,false,10,8,-2,41.93935,-87.68327
TA1309000042,3,16,false,48,44,-4,41.93937,-87.66836
13229,3,16,false,29,18,-11,41.93946,-87.66376
TA1308000019,3,16,false,30,33,3,41.93973,-87.65886
13277,3,16,false,28,42,14,41.9401,-87.64546
TA1307000134,3,16,false,73,41,-32,41.94016,-87.65303
117,3,16,false,11,9,-2,41.94016,-87.65302
13143,3,16,false,16,12,-4,41.94059,-87.67853
334,3,16,false,12,11,-1,41.94076,-87.63919
TA1309000049,3,16,false,69,65,-4,41.94077,-87.63919
15634,3,16,false,5,10,5,41.94304,-87.68729
TA1307000138,3,16,false,25,19,-6,41.94334,-87.67094
13144,3,16,false,17,18,1,41.9434,-87.67964
TA1309000025,3,16,false,55,57,2,41.94368,-87.64894
13071,3,16,false,75,61,-14,41.94373,-87.66401
632,3,16,false,59,55,-4,41.94453,-87.6547
15631,3,16,false,13,10,-3,41.94524,-87.70665
13278,3,16,false,35,47,12,41.94553,-87.64644
KA1504000143,3,16,false,7,14,7,41.94664,-87.68337
13235,3,16,false,46,45,-1,41.94814,-87.66396
304,3,16,false,12,6,-6,41.94878,-87.64922
13253,3,16,false,12,4,-8,41.9488,-87.67527
13325,3,16,false,63,45,-18,41.94907,-87.64863
TA1307000126,3,16,false,59,70,11,41.94936,-87.65451
TA1307000150,3,16,false,72,61,-11,41.94945,-87.64646
13319,3,16,false,18,15,-3,41.95069,-87.6687
TA1307000127,3,16,false,51,62,11,41.9508,-87.65918
13323,3,16,false,37,34,-3,41.95282,-87.65
TA1309000043,3,16,false,16,13,-3,41.95417,-87.66434
13063,3,16,false,36,31,-5,41.95424,-87.65441
KA1504000158,3,16,false,9,13,4,41.95432,-87.68607
254,3,16,false,14,6,-8,41.95438,-87.64806
TA1308000022,3,16,false,36,37,1,41.95438,-87.64805
TA1307000149,3,16,false,13,7,-6,41.95467,-87.67392
TA1309000026,3,16,false,13,22,9,41.95601,-87.6802
13249,3,16,false,12,11,-1,41.95606,-87.66885
13379,3,16,false,39,45,6,41.95786,-87.6495
TA1309000018,3,16,false,13,14,1,41.95791,-87.67357
TA1309000027,3,16,false,15,12,-3,41.9585,-87.65499
13389,3,16,false,34,23,-11,41.961,-87.64958
TA1307000144,3,16,false,17,14,-3,41.96142,-87.6762
KA1503000022,3,16,false,11,11,0,41.96158,-87.66609
231,3,16,false,12,7,-5,41.96163,-87.65464
TA1307000107,3,16,false,41,32,-9,41.96164,-87.65464
TA1307000156,3,16,false,9,17,8,41.96301,-87.68479
TA1309000012,3,16,false,5,13,8,41.96325,-87.67928
TA1308000012,3,16,false,62,79,17,41.96398,-87.63818
13074,3,16,false,24,20,-4,41.96521,-87.6582
639,3,16,false,32,35,3,41.96584,-87.64538
TA1307000140,3,16,false,12,20,8,41.96643,-87.68865
TA1309000014,3,16,false,16,25,9,41.96709,-87.66744
TA1307000158,3,16,false,18,6,-12,41.9671,-87.67904
TA1307000119,3,16,false,20,15,-5,41.96796,-87.65
TA1308000021,3,16,false,16,18,2,41.96883,-87.65765
KA1504000080,3,16,false,10,9,-1,41.96887,-87.69609
TA1309000066,3,16,false,31,30,-1,41.9691,-87.67423
TA1309000041,3,16,false,16,10,-6,41.96951,-87.65471
KA1504000171,3,16,false,25,15,-10,41.97161,-87.65016
TA1309000035,3,16,false,23,26,3,41.97335,-87.66785
13108,3,16,false,38,18,-20,41.97379,-87.65971
KA1504000078,3,16,false,8,14,6,41.97491,-87.69258
KA1504000149,3,16,false,7,10,3,41.97562,-87.67945
KA1504000160,3,16,false,16,5,-11,41.97564,-87.70143
KA1504000146,3,16,false,25,34,9,41.978,-87.66805
13109,3,16,false,26,27,1,41.97835,-87.65976
KA1504000151,3,16,false,26,13,-13,41.98359,-87.66916
459,3,16,false,13,13,0,41.98403,-87.65231
KA1504000152,3,16,false,40,57,17,41.98403,-87.65231
15578,3,16,false,22,15,-7,41.98405,-87.66027
15575,3,16,false,23,24,1,41.98975,-87.66014
15571,3,16,false,24,35,11,41.99478,-87.66028
RP-009,3,16,false,11,16,5,42.00107,-87.66122
660,3,16,false,15,16,1,42.00458,-87.66143
KA1504000175,3,16,false,6,12,6,42.00797,-87.66549
E002,3,16,false,11,6,-5,42.03256,-87.67912
596,3,16,false,26,30,4,42.04822,-87.68348
E008,3,16,false,14,21,7,42.05049,-87.67782
605,3,16,false,18,5,-13,42.05294,-87.67342
661,3,16,false,5,10,5,42.05704,-87.68657
604,3,16,false,16,9,-7,42.05824,-87.67744
KA1503000029,3,16,true,3,10,7,41.77364,-87.56747
KA1503000014,3,16,true,79,67,-12,41.7851,-87.60108
426,3,16,true,26,17,-9,41.7851,-87.60108
KA1503000070,3,16,true,16,16,0,41.78794,-87.58831
328,3,16,true,21,10,-11,41.78872,-87.6013
TA1309000011,3,16,true,86,19,-67,41.78873,-87.60131
KA1503000071,3,16,true,149,60,-89,41.79148,-87.59988
423,3,16,true,19,7,-12,41.79148,-87.59988
KA1503000074,3,16,true,20,18,-2,41.79174,-87.58395
TA1309000063,3,16,true,31,54,23,41.79325,-87.5878
345,3,16,true,9,11,2,41.79326,-87.5878
420,3,16,true,12,25,13,41.79429,-87.60145
KA1504000076,3,16,true,71,77,6,41.7943,-87.60145
247,3,16,true,8,15,7,41.79522,-87.58077
TA1308000009,3,16,true,47,66,19,41.79522,-87.58075
TA1307000164,3,16,true,28,30,2,41.79527,-87.59647
248,3,16,true,2,10,8,41.79528,-87.59647
KA1503000052,3,16,true,29,35,6,41.79935,-87.60097
418,3,16,true,10,9,-1,41.79936,-87.60097
KA1503000059,3,16,true,28,38,10,41.79952,-87.58643
TA1309000037,3,16,true,45,78,33,41.79957,-87.59474
417,3,16,true,13,11,-2,41.80242,-87.5869
KA1503000007,3,16,true,28,41,13,41.80242,-87.58689
13398,3,16,true,14,27,13,41.80256,-87.59035
322,3,16,true,18,11,-7,41.80321,-87.59849
TA1308000035,3,16,true,13,10,-3,41.80944,-87.59188
TA1308000002,3,16,true,6,21,15,41.80983,-87.59937
KA1503000068,3,16,true,8,33,25,41.82878,-87.68062
TA1308000045,3,16,true,29,22,-7,41.83062,-87.64129
TA1308000043,3,16,true,18,13,-5,41.83066,-87.64715
15446,3,16,true,10,6,-4,41.83068,-87.65603
184,3,16,true,11,3,-8,41.83104,-87.62684
TA1307000129,3,16,true,69,15,-54,41.83104,-87.62683
KA1503000004,3,16,true,14,13,-1,41.83127,-87.6088
13345,3,16,true,13,6,-7,41.83138,-87.61803
15445,3,16,true,17,10,-7,41.83453,-87.63183
13216,3,16,true,94,41,-53,41.83473,-87.62581
13217,3,16,true,30,53,23,41.83488,-87.61792
13215,3,16,true,19,17,-2,41.83634,-87.6135
TA1308000046,3,16,true,14,30,16,41.83779,-87.65115
TA1309000055,3,16,true,50,53,3,41.8382,-87.64514
KA1503000038,3,16,true,11,25,14,41.83845,-87.6354
TA1307000048,3,16,true,31,31,0,41.83855,-87.60821
TA1308000036,3,16,true,16,28,12,41.83883,-87.62186
TA1307000139,3,16,true,46,44,-2,41.84205,-87.61698
TA1307000153,3,16,true,13,54,41,41.84358,-87.64538
147,3,16,true,10,5,-5,41.84569,-87.62251
TA1307000005,3,16,true,45,28,-17,41.84569,-87.6225
TA1308000013,3,16,true,13,9,-4,41.84719,-87.64681
TA1308000026,3,16,true,9,11,2,41.85008,-87.63214
TA1305000001,3,16,true,19,25,6,41.85262,-87.6265
13075,3,16,true,39,34,-5,41.8531,-87.63192
120,3,16,true,10,8,-2,41.8531,-87.63191
13162,3,16,true,10,5,-5,41.85378,-87.64659
13091,3,16,true,13,8,-5,41.85409,-87.68585
15546,3,16,true,22,14,-8,41.85416,-87.61916
13307,3,16,true,11,14,3,41.85489,-87.66359
13089,3,16,true,3,10,7,41.85497,-87.67567
15545,3,16,true,70,62,-8,41.85627,-87.61334
4,3,16,true,26,24,-2,41.85627,-87.61334
SL-013,3,16,true,24,38,14,41.85659,-87.62755
SL-006,3,16,true,16,11,-5,41.8568,-87.63387
13135,3,16,true,16,31,15,41.85753,-87.66157
13102,3,16,true,53,86,33,41.85762,-87.61942
13150,3,16,true,97,83,-14,41.85783,-87.62455
273,3,16,true,19,6,-13,41.85783,-87.62455
13099,3,16,true,11,23,12,41.85784,-87.64627
205,3,16,true,10,7,-3,41.8579,-87.6687
TA1307000159,3,16,true,19,22,3,41.8579,-87.6687
TA1307000044,3,16,true,13,13,0,41.85794,-87.64083
13163,3,16,true,21,37,16,41.85808,-87.65108
13164,3,16,true,37,37,0,41.85818,-87.65648
SL-012,3,16,true,42,80,38,41.86038,-87.62581
72,3,16,true,15,17,2,41.86039,-87.62581
13304,3,16,true,9,19,10,41.86126,-87.65659
KA1504000109,3,16,true,28,2,-26,41.86192,-87.69347
TA1306000002,3,16,true,38,37,-1,41.86238,-87.65108
TA1307000124,3,16,true,67,106,39,41.86411,-87.62372
168,3,16,true,16,18,2,41.86415,-87.62372
282,3,16,true,10,13,3,41.86487,-87.64708
TA1309000001,3,16,true,38,58,20,41.86488,-87.64708
13354,3,16,true,22,26,4,41.86524,-87.66651
13029,3,16,true,19,13,-6,41.86531,-87.6179
341,3,16,true,9,12,3,41.86608,-87.60733
13431,3,16,true,37,37,0,41.8661,-87.60728
KA1504000101,3,16,true,12,8,-4,41.86651,-87.68466
KA1504000102,3,16,true,16,2,-14,41.86664,-87.69453
WL-008,3,16,true,36,66,30,41.86712,-87.64108
57,3,16,true,12,20,8,41.86712,-87.64107
59,3,16,true,15,34,19,41.86721,-87.62597
TA1305000002,3,16,true,119,160,41,41.86721,-87.62597
15544,3,16,true,43,26,-17,41.86723,-87.61536
3,3,16,true,19,5,-14,41.86723,-87.61536
TA1305000017,3,16,true,39,15,-24,41.86734,-87.64863
626,3,16,true,14,9,-5,41.86749,-87.63219
KA1706005007,3,16,true,47,44,-3,41.86749,-87.63219
SL-005,3,16,true,118,205,87,41.8679,-87.62304
255,3,16,true,30,32,2,41.86791,-87.62304
644,3,16,true,54,42,-12,41.86859,-87.68625
13139,3,16,true,40,61,21,41.86893,-87.65913
13285,3,16,true,214,21,-193,41.86928,-87.67372
13160,3,16,true,61,62,1,41.86947,-87.65548
22,3,16,true,11,16,5,41.86947,-87.65548
15550,3,16,true,30,44,14,41.87024,-87.63947
TA1309000010,3,16,true,57,102,45,41.87074,-87.62574
SL-009,3,16,true,27,51,24,41.87081,-87.63121
342,3,16,true,45,2,-43,41.87127,-87.6737
TA1309000064,3,16,true,209,31,-178,41.87127,-87.67369
261,3,16,true,27,2,-25,41.87151,-87.6699
TA1307000130,3,16,true,114,61,-53,41.87178,-87.65103
241,3,16,true,29,14,-15,41.8718,-87.65102
108,3,16,true,22,17,-5,41.87183,-87.64664
TA1307000121,3,16,true,87,80,-7,41.87184,-87.64664
41,3,16,true,14,19,5,41.87209,-87.62957
SL-008,3,16,true,109,153,44,41.87209,-87.62956
13332,3,16,true,112,151,39,41.87219,-87.6615
175,3,16,true,20,7,-13,41.87255,-87.63359
SL-011,3,16,true,62,79,17,41.87256,-87.63356
623,3,16,true,59,92,33,41.87272,-87.62399
KA1504000104,3,16,true,233,17,-216,41.87296,-87.66912
383,3,16,true,34,3,-31,41.87297,-87.66912
320,3,16,true,20,38,18,41.87327,-87.66402
5,3,16,true,6,12,6,41.87403,-87.6277
SL-007,3,16,true,55,44,-11,41.87404,-87.6277
13326,3,16,true,32,8,-24,41.87425,-87.63958
321,3,16,true,24,18,-6,41.87427,-87.63257
TA1306000025,3,16,true,44,35,-9,41.87464,-87.65703
15668,3,16,true,10,17,7,41.87471,-87.68642
13028,3,16,true,50,54,4,41.87475,-87.64981
13081,3,16,true,45,12,-33,41.87501,-87.67326
89,3,16,true,11,11,0,41.87501,-87.6331
SL-010,3,16,true,44,128,84,41.87501,-87.63309
15541,3,16,true,21,22,1,41.8758,-87.62086
13037,3,16,true,29,16,-13,41.87588,-87.64078
50,3,16,true,6,11,5,41.87592,-87.6307
TA1305000009,3,16,true,37,59,22,41.87593,-87.63068
317,3,16,true,26,2,-24,41.87603,-87.68195
TA1305000010,3,16,true,30,24,-6,41.87623,-87.62444
624,3,16,true,32,51,19,41.87626,-87.62923
33,3,16,true,18,4,-14,41.87715,-87.62786
TA1305000035,3,16,true,79,28,-51,41.87716,-87.62787
13138,3,16,true,85,80,-5,41.87723,-87.63941
631,3,16,true,24,4,-20,41.87761,-87.6739
15539,3,16,true,114,65,-49,41.87763,-87.64405
13158,3,16,true,117,120,3,41.87764,-87.64957
134,3,16,true,14,20,6,41.87764,-87.64954
13157,3,16,true,92,65,-27,41.87773,-87.6548
21,3,16,true,13,17,4,41.87773,-87.6548
TA1305000025,3,16,true,187,79,-108,41.87773,-87.63528
36,3,16,true,26,16,-10,41.87776,-87.63525
TA1309000002,3,16,true,35,35,0,41.87784,-87.62408
13206,3,16,true,35,65,30,41.87794,-87.66201
283,3,16,true,44,15,-29,41.87809,-87.63183
TA1309000004,3,16,true,262,74,-188,41.87811,-87.63184
107,3,16,true,27,16,-11,41.87822,-87.644
638,3,16,true,200,222,22,41.87827,-87.64078
37,3,16,true,25,5,-20,41.87921,-87.62975
TA1305000005,3,16,true,164,37,-127,41.87924,-87.62975
13011,3,16,true,165,373,208,41.87931,-87.63993
TA1309000008,3,16,true,135,35,-100,41.87933,-87.6355
192,3,16,true,25,40,15,41.87935,-87.63997
KA1503000034,3,16,true,137,18,-119,41.87938,-87.63197
39,3,16,true,21,8,-13,41.87948,-87.62571
KA1503000015,3,16,true,115,35,-80,41.87948,-87.6257
15667,3,16,true,13,12,-1,41.8798,-87.68609
287,3,16,true,46,10,-36,41.88017,-87.63527
TA1309000007,3,16,true,303,38,-265,41.88022,-87.63526
WL-011,3,16,true,61,55,-6,41.88034,-87.64273
73,3,16,true,12,10,-2,41.8804,-87.64273
80,3,16,true,17,17,0,41.88042,-87.65556
13156,3,16,true,54,146,92,41.88042,-87.65554
13300,3,16,true,64,77,13,41.88097,-87.61675
76,3,16,true,21,20,-1,41.88098,-87.61675
13008,3,16,true,82,65,-17,41.88105,-87.62408
90,3,16,true,16,10,-6,41.88107,-87.62409
49,3,16,true,50,7,-43,41.88116,-87.62963
TA1305000006,3,16,true,360,62,-298,41.88122,-87.6296
13134,3,16,true,11,18,7,41.88138,-87.67493
13056,3,16,true,115,63,-52,41.88168,-87.63951
191,3,16,true,11,3,-8,41.88169,-87.63951
198,3,16,true,20,27,7,41.88187,-87.6488
TA1307000120,3,16,true,115,163,48,41.88188,-87.64879
13341,3,16,true,151,128,-23,41.88208,-87.63985
174,3,16,true,20,8,-12,41.88208,-87.63984
197,3,16,true,15,12,-3,41.88208,-87.62513
13036,3,16,true,91,66,-25,41.8821,-87.62513
77,3,16,true,23,28,5,41.88214,-87.64108
TA1305000032,3,16,true,199,219,20,41.88218,-87.64109
98,3,16,true,27,12,-15,41.88266,-87.63251
13006,3,16,true,158,73,-85,41.88268,-87.63252
13353,3,16,true,64,107,43,41.88283,-87.6612
346,3,16,true,7,26,19,41.88284,-87.6612
654,3,16,true,29,52,23,41.88307,-87.65698
13409,3,16,true,60,67,7,41.8831,-87.6511
18,3,16,true,15,5,-10,41.88317,-87.63735
KA1503000072,3,16,true,132,33,-99,41.88317,-87.63693
91,3,16,true,21,48,27,41.88336,-87.64122
WL-012,3,16,true,201,430,229,41.88337,-87.6412
112,3,16,true,14,14,0,41.88362,-87.6486
13053,3,16,true,72,59,-13,41.88365,-87.64863
43,3,16,true,13,7,-6,41.88396,-87.62455
13001,3,16,true,159,98,-61,41.88397,-87.62459
13155,3,16,true,29,20,-9,41.88407,-87.65689
621,3,16,true,2,15,13,41.88412,-87.65427
18062,3,16,true,53,69,16,41.88412,-87.65427
81,3,16,true,28,19,-9,41.88417,-87.6296
TA1306000010,3,16,true,196,98,-98,41.88419,-87.62961
TA1305000030,3,16,true,243,70,-173,41.88459,-87.63178
96,3,16,true,11,6,-5,41.8846,-87.64455
15535,3,16,true,59,65,6,41.8846,-87.64455
51,3,16,true,28,17,-11,41.88462,-87.63176
TA1305000029,3,16,true,112,106,-6,41.88466,-87.62787
195,3,16,true,33,27,-6,41.88466,-87.61952
13263,3,16,true,145,124,-21,41.88467,-87.61952
44,3,16,true,23,17,-6,41.88468,-87.62782
TA1306000015,3,16,true,140,92,-48,41.88549,-87.65232
71,3,16,true,20,15,-5,41.8855,-87.65233
66,3,16,true,17,21,4,41.88557,-87.64186
13021,3,16,true,155,121,-34,41.88559,-87.64184
TA1307000111,3,16,true,244,60,-184,41.88582,-87.63548
164,3,16,true,31,18,-13,41.88583,-87.63547
13073,3,16,true,28,22,-6,41.88592,-87.66717
KA17018054,3,16,true,17,3,-14,41.88595,-87.67701
KA1503000012,3,16,true,121,66,-55,41.88599,-87.63089
38,3,16,true,13,18,5,41.88599,-87.63089
52,3,16,true,31,11,-20,41.886,-87.62421
TA1305000011,3,16,true,206,54,-152,41.886,-87.62418
7,3,16,true,20,18,-2,41.88627,-87.61751
15534,3,16,true,85,85,0,41.88627,-87.61749
13197,3,16,true,45,20,-25,41.8866,-87.65816
264,3,16,true,16,7,-9,41.8867,-87.62224
TA1308000029,3,16,true,72,52,-20,41.88673,-87.62225
TA1307000131,3,16,true,122,30,-92,41.88688,-87.62606
194,3,16,true,26,5,-21,41.88688,-87.62606
6,3,16,true,11,12,1,41.88697,-87.61281
KA1503000064,3,16,true,53,77,24,41.88697,-87.61281
100,3,16,true,41,11,-30,41.88814,-87.63657
TA1305000022,3,16,true,219,79,-140,41.88817,-87.63656
56,3,16,true,34,30,-4,41.88866,-87.64442
TA1306000003,3,16,true,125,143,18,41.88867,-87.64442
KA1503000043,3,16,true,281,276,-5,41.88918,-87.63851
133,3,16,true,28,49,21,41.88918,-87.63851
13050,3,16,true,178,95,-83,41.88919,-87.62775
47,3,16,true,29,20,-9,41.88921,-87.62775
15664,3,16,true,5,44,39,41.8895,-87.68821
13432,3,16,true,33,45,12,41.88989,-87.67149
TA1307000151,3,16,true,167,95,-72,41.88993,-87.63427
212,3,16,true,32,27,-5,41.88995,-87.63427
636,3,16,true,73,71,-2,41.88997,-87.63662
125,3,16,true,11,5,-6,41.89018,-87.62621
KA1503000044,3,16,true,95,36,-59,41.89018,-87.6262
196,3,16,true,12,11,-1,41.89053,-87.62205
13427,3,16,true,41,60,19,41.89054,-87.62205
26,3,16,true,14,15,1,41.89057,-87.61798
13430,3,16,true,106,104,-2,41.89077,-87.63169
181,3,16,true,32,14,-18,41.89077,-87.63168
TA1306000013,3,16,true,94,90,-4,41.89083,-87.61852
RN-,3,16,true,80,80,0,41.89102,-87.63546
672,3,16,true,11,20,9,41.89102,-87.63545
13434,3,16,true,18,40,22,41.89108,-87.66663
TA1308000006,3,16,true,36,47,11,41.89128,-87.67686
199,3,16,true,30,26,-4,41.89143,-87.62676
TA1307000117,3,16,true,166,113,-53,41.89144,-87.62675
13033,3,16,true,119,131,12,41.8916,-87.64835
214,3,16,true,9,12,3,41.89161,-87.67688
84,3,16,true,14,20,6,41.89161,-87.64833
186,3,16,true,6,18,12,41.8918,-87.65879
13194,3,16,true,70,74,4,41.8918,-87.65878
TA1305000003,3,16,true,170,107,-63,41.89187,-87.62061
24,3,16,true,37,24,-13,41.8919,-87.62063
643,3,16,true,11,37,26,41.89203,-87.68939
35,3,16,true,27,27,0,41.89227,-87.61206
13022,3,16,true,131,125,-6,41.89227,-87.61205
99,3,16,true,10,11,1,41.89255,-87.61449
TA1306000029,3,16,true,101,72,-29,41.89256,-87.61449
13265,3,16,true,145,170,25,41.89383,-87.64172
74,3,16,true,31,41,10,41.89384,-87.64173
13045,3,16,true,197,181,-16,41.89403,-87.62931
110,3,16,true,42,37,-5,41.89406,-87.6293
13016,3,16,true,553,82,-471,41.89431,-87.62277
211,3,16,true,126,9,-117,41.89439,-87.62267
KA1503000041,3,16,true,235,77,-158,41.89452,-87.61798
142,3,16,true,46,9,-37,41.89453,-87.61806
92,3,16,true,12,6,-6,41.89455,-87.65346
13196,3,16,true,51,51,0,41.89455,-87.65345
TA1307000062,3,16,true,109,57,-52,41.89466,-87.63839
111,3,16,true,16,16,0,41.89466,-87.63837
TA1306000012,3,16,true,161,181,20,41.89475,-87.63438
53,3,16,true,41,21,-20,41.89476,-87.63439
627,3,16,true,10,10,0,41.8948,-87.63231
KP1705001026,3,16,true,73,74,1,41.89483,-87.6323
KA1504000114,3,16,true,6,10,4,41.89547,-87.70614
659,3,16,true,3,17,14,41.8955,-87.68201
18058,3,16,true,22,53,31,41.8955,-87.68201
637,3,16,true,40,75,35,41.89563,-87.67209
128,3,16,true,14,20,6,41.89571,-87.67716
13132,3,16,true,47,73,26,41.89573,-87.67718
161,3,16,true,30,23,-7,41.89574,-87.62599
15530,3,16,true,166,98,-68,41.89575,-87.62596
18003,3,16,true,114,37,-77,41.89575,-87.62011
635,3,16,true,24,5,-19,41.89576,-87.62012
13247,3,16,true,37,65,28,41.89597,-87.66775
TA1305000020,3,16,true,54,63,9,41.89636,-87.65406
54,3,16,true,15,12,-3,41.89637,-87.65407
13289,3,16,true,42,67,25,41.89638,-87.661
86,3,16,true,6,16,10,41.89639,-87.661
337,3,16,true,26,11,-15,41.89659,-87.63096
13303,3,16,true,81,87,6,41.89672,-87.63088
13017,3,16,true,124,85,-39,41.89676,-87.6357
31,3,16,true,16,15,-1,41.89677,-87.63572
13338,3,16,true,159,52,-107,41.89697,-87.62173
173,3,16,true,38,20,-18,41.89704,-87.62173
TA1307000061,3,16,true,66,66,0,41.89745,-87.62873
106,3,16,true,23,9,-14,41.89746,-87.62874
25,3,16,true,18,8,-10,41.89751,-87.62354
13034,3,16,true,92,49,-43,41.89754,-87.62352
48,3,16,true,30,12,-18,41.89772,-87.64302
TA1306000009,3,16,true,323,63,-260,41.89772,-87.64299
620,3,16,true,63,72,9,41.89817,-87.63754
374,3,16,true,11,2,-9,41.89842,-87.68659
KA1504000103,3,16,true,27,48,21,41.89842,-87.68659
145,3,16,true,33,11,-22,41.89856,-87.62211
15529,3,16,true,167,76,-91,41.89858,-87.62206
140,3,16,true,24,31,7,41.89895,-87.6299
TA1307000128,3,16,true,173,155,-18,41.89896,-87.6299
657,3,16,true,49,47,-2,41.89918,-87.6722
KA1504000117,3,16,true,13,13,0,41.89936,-87.64848
13248,3,16,true,30,44,14,41.89964,-87.66788
46,3,16,true,16,12,-4,41.89994,-87.63444
TA1306000011,3,16,true,53,52,-1,41.89994,-87.63443
364,3,16,true,9,14,5,41.90023,-87.64299
KA1504000116,3,16,true,65,81,16,41.90023,-87.64299
17660,3,16,true,15,22,7,41.90036,-87.69671
13290,3,16,true,56,56,0,41.90069,-87.66259
13042,3,16,true,158,116,-42,41.90097,-87.62377
85,3,16,true,20,19,-1,41.90098,-87.62375
TA1307000070,3,16,true,23,35,12,41.90133,-87.67742
KA1504000133,3,16,true,100,98,-2,41.90234,-87.62773
172,3,16,true,18,15,-3,41.90236,-87.62774
13241,3,16,true,16,23,7,41.9029,-87.68731
176,3,16,true,38,40,2,41.90291,-87.63141
TA1306000006,3,16,true,20,28,8,41.90292,-87.63772
TA1307000039,3,16,true,226,224,-2,41.90294,-87.63137
658,3,16,true,59,13,-46,41.903,-87.6838
13256,3,16,true,28,16,-12,41.90302,-87.69749
17,3,16,true,10,6,-4,41.90313,-87.67391
TA1305000034,3,16,true,54,69,15,41.90313,-87.67391
182,3,16,true,35,47,12,41.90317,-87.63442
KA1504000135,3,16,true,149,219,70,41.90319,-87.63439
13136,3,16,true,44,44,0,41.90326,-87.67845
210,3,16,true,23,25,2,41.90342,-87.66781
13061,3,16,true,109,152,43,41.90342,-87.66779
KA1504000079,3,16,true,68,78,10,41.9035,-87.64334
359,3,16,true,24,20,-4,41.90458,-87.6497
138,3,16,true,4,12,8,41.9046,-87.64057
TA1307000115,3,16,true,41,35,-6,41.9046,-87.64056
291,3,16,true,12,31,19,41.90672,-87.63494
TA1308000049,3,16,true,66,109,43,41.90672,-87.6349
KA1504000134,3,16,true,47,81,34,41.90687,-87.6262
180,3,16,true,14,15,1,41.90687,-87.62618
333,3,16,true,8,18,10,41.90706,-87.66725
13224,3,16,true,42,55,13,41.90706,-87.66725
18069,3,16,true,25,7,-18,41.90722,-87.65563
TA1307000143,3,16,true,21,35,14,41.90762,-87.63854
61,3,16,true,13,16,3,41.90764,-87.67254
13221,3,16,true,57,98,41,41.90765,-87.67254
13245,3,16,true,10,13,3,41.90777,-87.68586
301,3,16,true,16,27,11,41.90796,-87.63203
TA1309000024,3,16,true,82,133,51,41.908,-87.63152
69,3,16,true,12,11,-1,41.90939,-87.6777
TA1305000041,3,16,true,96,64,-32,41.9094,-87.67769
331,3,16,true,148,147,-1,41.90965,-87.64812
15653,3,16,true,10,8,-2,41.90979,-87.7053
TA1305000037,3,16,true,52,71,19,41.91018,-87.67003
TA1306000008,3,16,true,33,45,12,41.9102,-87.6435
16,3,16,true,13,13,0,41.91035,-87.67008
TA1308000005,3,16,true,41,29,-12,41.91042,-87.68238
276,3,16,true,10,6,-4,41.91043,-87.69718
13258,3,16,true,20,31,11,41.91043,-87.69718
13257,3,16,true,23,27,4,41.91054,-87.68956
13154,3,16,true,84,97,13,41.91054,-87.65312
20,3,16,true,17,23,6,41.91055,-87.65313
13058,3,16,true,86,73,-13,41.91059,-87.64942
60,3,16,true,18,12,-6,41.91059,-87.64942
TA1307000038,3,16,true,72,70,-2,41.91138,-87.63868
118,3,16,true,6,21,15,41.91138,-87.63868
268,3,16,true,33,22,-11,41.91172,-87.62681
LF-005,3,16,true,124,122,-2,41.91172,-87.62681
13128,3,16,true,44,56,12,41.91197,-87.63197
289,3,16,true,26,43,17,41.91209,-87.63472
TA1308000050,3,16,true,141,258,117,41.91211,-87.6347
158,3,16,true,16,17,1,41.91262,-87.6814
13243,3,16,true,54,62,8,41.91262,-87.6814
TA1309000032,3,16,true,16,12,-4,41.91293,-87.66417
TA1306000032,3,16,true,66,96,30,41.9137,-87.65285
93,3,16,true,14,20,6,41.91371,-87.65285
224,3,16,true,6,14,8,41.91386,-87.64877
TA1307000166,3,16,true,61,88,27,41.91386,-87.64877
15655,3,16,true,19,26,7,41.91401,-87.70514
18017,3,16,true,11,17,6,41.91416,-87.71676
628,3,16,true,13,15,2,41.9146,-87.66796
18067,3,16,true,26,34,8,41.9146,-87.66796
TA1306000007,3,16,true,24,36,12,41.91469,-87.64333
13068,3,16,true,61,63,2,41.91554,-87.68703
116,3,16,true,9,11,2,41.91555,-87.68703
13179,3,16,true,89,88,-1,41.9157,-87.63461
141,3,16,true,24,22,-2,41.91571,-87.63461
13133,3,16,true,64,61,-3,41.91598,-87.67733
219,3,16,true,9,15,6,41.91598,-87.67733
58,3,16,true,10,15,5,41.91602,-87.66894
TA1305000039,3,16,true,37,45,8,41.9163,-87.66749
15650,3,16,true,8,12,4,41.91711,-87.71023
15651,3,16,true,19,44,25,41.91752,-87.70181
13266,3,16,true,13,31,18,41.91774,-87.69142
TA1309000029,3,16,true,17,13,-4,41.9178,-87.68245
288,3,16,true,13,8,-5,41.91809,-87.64375
TA1309000006,3,16,true,42,44,2,41.91809,-87.64375
223,3,16,true,12,12,0,41.91821,-87.65698
TA1307000163,3,16,true,38,86,48,41.91821,-87.65696
94,3,16,true,20,30,10,41.91831,-87.6363
13146,3,16,true,118,125,7,41.91831,-87.63629
13059,3,16,true,91,105,14,41.91845,-87.65222
113,3,16,true,22,23,1,41.91846,-87.65222
13259,3,16,true,8,11,3,41.91852,-87.69744
225,3,16,true,15,18,3,41.91995,-87.64884
13192,3,16,true,62,92,30,41.91995,-87.64884
13288,3,16,true,27,26,-1,41.92008,-87.67788
13242,3,16,true,29,17,-12,41.92021,-87.69266
TA1309000030,3,16,true,47,64,17,41.92077,-87.66372
13292,3,16,true,11,21,10,41.92152,-87.70733
TA1309000033,3,16,true,81,75,-6,41.92158,-87.65381
13193,3,16,true,80,114,34,41.92182,-87.64412
144,3,16,true,28,31,3,41.92182,-87.64411
143,3,16,true,13,22,9,41.92217,-87.63891
13191,3,16,true,73,101,28,41.92217,-87.63891
327,3,16,true,8,11,3,41.92225,-87.65783
13084,3,16,true,35,43,8,41.92268,-87.69715
123,3,16,true,11,9,-2,41.92268,-87.69714
LP-,3,16,true,54,53,-1,41.92396,-87.63584
KA1504000140,3,16,true,23,28,5,41.92409,-87.67646
15648,3,16,true,17,16,-1,41.92464,-87.68931
KA1504000090,3,16,true,10,13,3,41.92483,-87.7145
TA1307000001,3,16,true,74,68,-6,41.92535,-87.66581
188,3,16,true,13,12,-1,41.92536,-87.66581
TA1306000026,3,16,true,78,70,-8,41.92558,-87.65842
87,3,16,true,9,12,3,41.92559,-87.65843
TA1306000016,3,16,true,129,63,-66,41.9256,-87.65371
67,3,16,true,20,12,-8,41.9256,-87.65371
313,3,16,true,21,22,1,41.9257,-87.64246
TA1309000019,3,16,true,104,113,9,41.92586,-87.63897
TA1309000058,3,16,true,102,124,22,41.92591,-87.64927
127,3,16,true,22,28,6,41.92592,-87.64927
177,3,16,true,31,30,-1,41.92627,-87.63086
TA1308000001,3,16,true,110,110,0,41.92627,-87.63086
15646,3,16,true,12,19,7,41.92668,-87.6977
13124,3,16,true,17,18,1,41.92675,-87.63444
302,3,16,true,8,16,8,41.92859,-87.65421
TA1309000023,3,16,true,45,58,13,41.9287,-87.65383
TA1307000113,3,16,true,44,43,-1,41.92878,-87.66391
190,3,16,true,11,9,-2,41.92878,-87.6639
13296,3,16,true,27,45,18,41.92883,-87.66852
343,3,16,true,9,11,2,41.92889,-87.65898
TA1309000059,3,16,true,33,49,16,41.92889,-87.65898
349,3,16,true,15,13,-2,41.92915,-87.6491
TA1309000061,3,16,true,76,77,1,41.92915,-87.64909
TA1308000031,3,16,true,23,28,5,41.92946,-87.68417
TA1305000014,3,16,true,123,99,-24,41.92956,-87.64313
340,3,16,true,26,35,9,41.92956,-87.64313
260,3,16,true,10,5,-5,41.92958,-87.70791
13085,3,16,true,31,41,10,41.92958,-87.70789
15643,3,16,true,6,11,5,41.93057,-87.7238
TA1307000142,3,16,true,103,122,19,41.93125,-87.64432
220,3,16,true,21,26,5,41.93125,-87.64431
13276,3,16,true,67,104,37,41.93132,-87.63874
324,3,16,true,23,18,-5,41.93173,-87.64179
163,3,16,true,9,13,4,41.93191,-87.67784
13271,3,16,true,28,43,15,41.93192,-87.67784
152,3,16,true,17,20,3,41.93221,-87.65864
TA1307000064,3,16,true,78,62,-16,41.93222,-87.65864
13,3,16,true,18,26,8,41.93242,-87.65271
TA1306000014,3,16,true,80,108,28,41.93242,-87.65271
329,3,16,true,18,22,4,41.93258,-87.63642
TA1309000039,3,16,true,80,96,16,41.93258,-87.63642
13294,3,16,true,41,47,6,41.9326,-87.66595
332,3,16,true,10,16,6,41.93313,-87.64776
TA1309000036,3,16,true,41,74,33,41.93313,-87.64776
15644,3,16,true,5,14,9,41.93534,-87.71687
TA1307000006,3,16,true,66,48,-18,41.93571,-87.6636
153,3,16,true,13,12,-1,41.93575,-87.66364
13268,3,16,true,21,15,-6,41.93588,-87.67843
13269,3,16,true,34,38,4,41.93609,-87.66983
TA1307000052,3,16,true,114,72,-42,41.93628,-87.65266
115,3,16,true,21,20,-1,41.93628,-87.65266
156,3,16,true,30,23,-7,41.9365,-87.64756
TA1307000136,3,16,true,102,106,4,41.9365,-87.64755
TA1307000041,3,16,true,97,101,4,41.93669,-87.63683
157,3,16,true,23,25,2,41.9367,-87.63683
13137,3,16,true,125,141,16,41.9376,-87.6441
300,3,16,true,27,38,11,41.93761,-87.6441
15642,3,16,true,10,11,1,41.93843,-87.69801
KA17018068,3,16,true,19,20,1,41.93935,-87.68327
TA1309000042,3,16,true,52,65,13,41.93937,-87.66836
131,3,16,true,10,14,4,41.93937,-87.66835
KA150400009X,3,16,true,15,13,-2,41.9394,-87.71159
13229,3,16,true,37,48,11,41.93946,-87.66376
226,3,16,true,12,4,-8,41.93972,-87.65886
TA1308000019,3,16,true,53,47,-6,41.93973,-87.65886
296,3,16,true,21,25,4,41.9401,-87.64546
13277,3,16,true,48,81,33,41.9401,-87.64546
TA1307000134,3,16,true,124,107,-17,41.94016,-87.65303
117,3,16,true,34,18,-16,41.94016,-87.65302
13143,3,16,true,13,17,4,41.94059,-87.67853
334,3,16,true,22,38,16,41.94076,-87.63919
TA1309000049,3,16,true,94,87,-7,41.94077,-87.63919
15634,3,16,true,21,7,-14,41.94304,-87.68729
TA1307000138,3,16,true,55,60,5,41.94334,-87.67094
230,3,16,true,13,19,6,41.94335,-87.67093
13144,3,16,true,23,22,-1,41.9434,-87.67964
299,3,16,true,21,13,-8,41.94368,-87.64894
TA1309000025,3,16,true,78,90,12,41.94368,-87.64894
229,3,16,true,17,9,-8,41.94372,-87.66401
13071,3,16,true,103,79,-24,41.94373,-87.66401
632,3,16,true,75,100,25,41.94453,-87.6547
303,3,16,true,30,34,4,41.94522,-87.64702
13278,3,16,true,94,98,4,41.94553,-87.64644
TA1309000050,3,16,true,15,13,-2,41.94618,-87.67331
15632,3,16,true,40,8,-32,41.94664,-87.69463
KA1504000143,3,16,true,10,16,6,41.94664,-87.68337
227,3,16,true,17,21,4,41.94813,-87.66397
13235,3,16,true,97,93,-4,41.94814,-87.66396
304,3,16,true,24,32,8,41.94878,-87.64922
13253,3,16,true,23,35,12,41.9488,-87.67527
13325,3,16,true,98,120,22,41.94907,-87.64863
114,3,16,true,10,20,10,41.94935,-87.65451
TA1307000126,3,16,true,65,79,14,41.94936,-87.65451
232,3,16,true,17,22,5,41.94943,-87.64645
TA1307000150,3,16,true,107,100,-7,41.94945,-87.64646
347,3,16,true,10,2,-8,41.95068,-87.6687
13319,3,16,true,41,21,-20,41.95069,-87.6687
TA1307000127,3,16,true,83,50,-33,41.9508,-87.65918
165,3,16,true,19,16,-3,41.95081,-87.65918
15628,3,16,true,5,11,6,41.95216,-87.69806
318,3,16,true,11,6,-5,41.95254,-87.6735
13323,3,16,true,74,54,-20,41.95282,-87.65
256,3,16,true,12,13,1,41.95282,-87.65
KA1504000139,3,16,true,4,10,6,41.954,-87.71909
TA1309000043,3,16,true,33,39,6,41.95417,-87.66434
13063,3,16,true,73,63,-10,41.95424,-87.65441
240,3,16,true,8,16,8,41.95424,-87.65441
486,3,16,true,2,11,9,41.95431,-87.68607
KA1504000158,3,16,true,6,42,36,41.95432,-87.68607
254,3,16,true,17,25,8,41.95438,-87.64806
TA1308000022,3,16,true,84,77,-7,41.95438,-87.64805
TA1307000149,3,16,true,33,33,0,41.95467,-87.67392
TA1309000026,3,16,true,24,52,28,41.95601,-87.6802
13249,3,16,true,17,13,-4,41.95606,-87.66885
312,3,16,true,18,18,0,41.95637,-87.6563
TA1308000047,3,16,true,20,16,-4,41.95709,-87.6642
13379,3,16,true,81,89,8,41.95786,-87.6495
TA1309000018,3,16,true,20,19,-1,41.95791,-87.67357
306,3,16,true,12,14,2,41.9585,-87.655
TA1309000027,3,16,true,46,47,1,41.9585,-87.65499
13389,3,16,true,55,53,-2,41.961,-87.64958
245,3,16,true,17,10,-7,41.96101,-87.64958
15621,3,16,true,17,38,21,41.96103,-87.70586
15622,3,16,true,10,8,-2,41.96108,-87.69544
TA1307000144,3,16,true,43,20,-23,41.96142,-87.6762
TA1309000021,3,16,true,14,16,2,41.9615,-87.6714
15623,3,16,true,16,27,11,41.96154,-87.69117
234,3,16,true,12,7,-5,41.96158,-87.6661
KA1503000022,3,16,true,35,30,-5,41.96158,-87.66609
231,3,16,true,22,25,3,41.96163,-87.65464
TA1307000107,3,16,true,80,83,3,41.96164,-87.65464
TA1307000156,3,16,true,23,20,-3,41.96301,-87.68479
TA1309000012,3,16,true,21,13,-8,41.96325,-87.67928
249,3,16,true,19,21,2,41.96398,-87.63818
TA1308000012,3,16,true,51,75,24,41.96398,-87.63818
293,3,16,true,12,12,0,41.96521,-87.65822
13074,3,16,true,59,47,-12,41.96521,-87.6582
639,3,16,true,51,52,1,41.96584,-87.64538
KA1504000127,3,16,true,14,15,1,41.96587,-87.70083
KA1504000093,3,16,true,14,45,31,41.96587,-87.69365
TA1307000140,3,16,true,20,40,20,41.96643,-87.68865
239,3,16,true,10,14,4,41.9665,-87.68843
326,3,16,true,15,14,-1,41.96665,-87.67113
TA1309000014,3,16,true,55,49,-6,41.96709,-87.66744
TA1307000158,3,16,true,55,18,-37,41.9671,-87.67904
242,3,16,true,12,2,-10,41.9671,-87.67904
251,3,16,true,20,6,-14,41.96796,-87.65
TA1307000119,3,16,true,37,27,-10,41.96796,-87.65
TA1308000021,3,16,true,32,30,-2,41.96883,-87.65765
KA1504000080,3,16,true,21,28,7,41.96887,-87.69609
TA1309000015,3,16,true,9,15,6,41.96889,-87.68401
TA1309000066,3,16,true,88,58,-30,41.9691,-87.67423
344,3,16,true,20,20,0,41.9691,-87.67423
TA1309000041,3,16,true,36,20,-16,41.96951,-87.65471
KA1504000171,3,16,true,40,31,-9,41.97161,-87.65016
465,3,16,true,10,8,-2,41.97161,-87.65016
325,3,16,true,10,12,2,41.9728,-87.67186
TA1309000035,3,16,true,66,86,20,41.97335,-87.66785
13108,3,16,true,54,35,-19,41.97379,-87.65971
KA1504000078,3,16,true,12,20,8,41.97491,-87.69258
KA1504000149,3,16,true,32,25,-7,41.97562,-87.67945
KA1504000160,3,16,true,18,10,-8,41.97564,-87.70143
463,3,16,true,10,7,-3,41.978,-87.66805
KA1504000146,3,16,true,36,38,2,41.978,-87.66805
13109,3,16,true,49,33,-16,41.97835,-87.65976
294,3,16,true,13,8,-5,41.97835,-87.65976
KA1504000147,3,16,true,19,14,-5,41.97976,-87.67754
655,3,16,true,19,8,-11,41.97987,-87.68194
KA1504000151,3,16,true,46,39,-7,41.98359,-87.66916
459,3,16,true,29,23,-6,41.98403,-87.65231
KA1504000152,3,16,true,70,90,20,41.98403,-87.65231
15578,3,16,true,27,36,9,41.98405,-87.66027
15575,3,16,true,27,21,-6,41.98975,-87.66014
458,3,16,true,10,10,0,41.98975,-87.66013
KA1504000148,3,16,true,14,20,6,41.99086,-87.66971
15571,3,16,true,34,66,32,41.99478,-87.66028
KA1504000156,3,16,true,18,9,-9,41.99925,-87.67137
RP-009,3,16,true,28,17,-11,42.00107,-87.66122
RP-008,3,16,true,9,19,10,42.00446,-87.6724
660,3,16,true,25,29,4,42.00458,-87.66143
KA1504000175,3,16,true,20,32,12,42.00797,-87.66549
RP-005,3,16,true,12,5,-7,42.0086,-87.69047
KA1504000162,3,16,true,26,9,-17,42.00907,-87.67422
KA1504000159,3,16,true,9,12,3,42.01059,-87.66241
525,3,16,true,15,13,-2,42.01272,-87.66605
520,3,16,true,14,24,10,42.01597,-87.66859
515,3,16,true,20,5,-15,42.01915,-87.67356
523,3,16,true,16,14,-2,42.02089,-87.66505
E002,3,16,true,16,35,19,42.03256,-87.67912
599,3,16,true,19,4,-15,42.03972,-87.69942
596,3,16,true,37,39,2,42.04822,-87.68348
E008,3,16,true,18,7,-11,42.05049,-87.67782
605,3,16,true,28,10,-18,42.05294,-87.67342
604,3,16,true,45,17,-28,42.05824,-87.67744
KA1503000014,4,8,false,15,11,-4,41.7851,-87.60108
TA1309000011,4,8,false,1,16,15,41.78873,-87.60131
KA1503000071,4,8,false,11,28,17,41.79148,-87.59988
TA1309000063,4,8,false,20,7,-13,41.79325,-87.5878
KA1504000076,4,8,false,5,14,9,41.7943,-87.60145
TA1308000009,4,8,false,30,13,-17,41.79522,-87.58075
TA1309000037,4,8,false,25,6,-19,41.79957,-87.59474
KA1503000007,4,8,false,11,6,-5,41.80242,-87.58689
13398,4,8,false,15,3,-12,41.80256,-87.59035
TA1307000048,4,8,false,16,1,-15,41.83855,-87.60821
TA1305000004,4,8,false,11,9,-2,41.8514,-87.61884
13135,4,8,false,10,2,-8,41.85753,-87.66157
13150,4,8,false,15,13,-2,41.85783,-87.62455
13164,4,8,false,10,6,-4,41.85818,-87.65648
SL-012,4,8,false,15,3,-12,41.86038,-87.62581
TA1307000124,4,8,false,22,5,-17,41.86411,-87.62372
TA1309000001,4,8,false,4,10,6,41.86488,-87.64708
WL-008,4,8,false,11,5,-6,41.86712,-87.64108
TA1305000002,4,8,false,25,15,-10,41.86721,-87.62597
15544,4,8,false,5,23,18,41.86723,-87.61536
SL-005,4,8,false,51,15,-36,41.8679,-87.62304
13285,4,8,false,3,11,8,41.86928,-87.67372
15550,4,8,false,9,11,2,41.87024,-87.63947
TA1309000010,4,8,false,22,10,-12,41.87074,-87.62574
SL-009,4,8,false,11,5,-6,41.87081,-87.63121
TA1307000121,4,8,false,3,10,7,41.87184,-87.64664
SL-008,4,8,false,39,7,-32,41.87209,-87.62956
13332,4,8,false,19,4,-15,41.87219,-87.6615
SL-011,4,8,false,12,7,-5,41.87256,-87.63356
623,4,8,false,43,13,-30,41.87272,-87.62399
KA1504000104,4,8,false,5,11,6,41.87296,-87.66912
SL-007,4,8,false,16,10,-6,41.87404,-87.6277
13028,4,8,false,12,7,-5,41.87475,-87.64981
SL-010,4,8,false,9,19,10,41.87501,-87.63309
15541,4,8,false,12,9,-3,41.8758,-87.62086
13037,4,8,false,5,11,6,41.87588,-87.64078
TA1305000010,4,8,false,13,9,-4,41.87623,-87.62444
624,4,8,false,10,11,1,41.87626,-87.62923
TA1305000035,4,8,false,10,10,0,41.87716,-87.62787
13138,4,8,false,11,28,17,41.87723,-87.63941
15539,4,8,false,16,4,-12,41.87763,-87.64405
13158,4,8,false,18,26,8,41.87764,-87.64957
13157,4,8,false,14,3,-11,41.87773,-87.6548
TA1305000025,4,8,false,24,59,35,41.87773,-87.63528
TA1309000002,4,8,false,11,12,1,41.87784,-87.62408
TA1309000004,4,8,false,8,42,34,41.87811,-87.63184
638,4,8,false,19,32,13,41.87827,-87.64078
TA1305000005,4,8,false,3,16,13,41.87924,-87.62975
13011,4,8,false,31,47,16,41.87931,-87.63993
TA1309000008,4,8,false,12,12,0,41.87933,-87.6355
KA1503000034,4,8,false,10,34,24,41.87938,-87.63197
KA1503000015,4,8,false,9,16,7,41.87948,-87.6257
TA1309000007,4,8,false,9,75,66,41.88022,-87.63526
WL-011,4,8,false,12,14,2,41.88034,-87.64273
13300,4,8,false,20,19,-1,41.88097,-87.61675
13008,4,8,false,24,33,9,41.88105,-87.62408
49,4,8,false,2,12,10,41.88116,-87.62963
TA1305000006,4,8,false,8,76,68,41.88122,-87.6296
13056,4,8,false,21,27,6,41.88168,-87.63951
TA1307000120,4,8,false,33,29,-4,41.88188,-87.64879
13341,4,8,false,34,41,7,41.88208,-87.63985
13036,4,8,false,7,19,12,41.8821,-87.62513
TA1305000032,4,8,false,37,62,25,41.88218,-87.64109
13006,4,8,false,7,24,17,41.88268,-87.63252
13353,4,8,false,17,10,-7,41.88283,-87.6612
654,4,8,false,10,10,0,41.88307,-87.65698
13409,4,8,false,13,17,4,41.8831,-87.6511
KA1503000072,4,8,false,20,54,34,41.88317,-87.63693
WL-012,4,8,false,40,41,1,41.88337,-87.6412
13053,4,8,false,29,25,-4,41.88365,-87.64863
13001,4,8,false,23,35,12,41.88397,-87.62459
13155,4,8,false,15,10,-5,41.88407,-87.65689
18062,4,8,false,28,34,6,41.88412,-87.65427
81,4,8,false,4,12,8,41.88417,-87.6296
TA1306000010,4,8,false,10,32,22,41.88419,-87.62961
TA1305000030,4,8,false,43,62,19,41.88459,-87.63178
15535,4,8,false,25,19,-6,41.8846,-87.64455
TA1305000029,4,8,false,25,24,-1,41.88466,-87.62787
13263,4,8,false,40,30,-10,41.88467,-87.61952
TA1306000015,4,8,false,48,57,9,41.88549,-87.65232
13021,4,8,false,29,54,25,41.88559,-87.64184
TA1307000111,4,8,false,21,74,53,41.88582,-87.63548
164,4,8,false,2,13,11,41.88583,-87.63547
13073,4,8,false,11,22,11,41.88592,-87.66717
KA17018054,4,8,false,2,23,21,41.88595,-87.67701
38,4,8,false,7,11,4,41.88599,-87.63089
KA1503000012,4,8,false,19,39,20,41.88599,-87.63089
52,4,8,false,3,11,8,41.886,-87.62421
TA1305000011,4,8,false,34,59,25,41.886,-87.62418
15534,4,8,false,14,5,-9,41.88627,-87.61749
13197,4,8,false,8,30,22,41.8866,-87.65816
TA1308000029,4,8,false,20,17,-3,41.88673,-87.62225
TA1307000131,4,8,false,19,15,-4,41.88688,-87.62606
KA1503000064,4,8,false,11,12,1,41.88697,-87.61281
TA1305000022,4,8,false,28,50,22,41.88817,-87.63656
TA1306000003,4,8,false,43,12,-31,41.88867,-87.64442
KA1503000043,4,8,false,68,61,-7,41.88918,-87.63851
13050,4,8,false,12,37,25,41.88919,-87.62775
13432,4,8,false,2,10,8,41.88989,-87.67149
TA1307000151,4,8,false,47,68,21,41.88993,-87.63427
636,4,8,false,14,23,9,41.88997,-87.63662
KA1503000044,4,8,false,24,21,-3,41.89018,-87.6262
13427,4,8,false,24,17,-7,41.89054,-87.62205
13430,4,8,false,25,37,12,41.89077,-87.63169
181,4,8,false,2,11,9,41.89077,-87.63168
TA1306000013,4,8,false,34,24,-10,41.89083,-87.61852
RN-,4,8,false,30,35,5,41.89102,-87.63546
13434,4,8,false,12,13,1,41.89108,-87.66663
TA1308000006,4,8,false,18,14,-4,41.89128,-87.67686
TA1307000117,4,8,false,25,48,23,41.89144,-87.62675
13033,4,8,false,29,20,-9,41.8916,-87.64835
84,4,8,false,10,5,-5,41.89161,-87.64833
13194,4,8,false,20,8,-12,41.8918,-87.65878
TA1305000003,4,8,false,33,40,7,41.89187,-87.62061
13022,4,8,false,40,25,-15,41.89227,-87.61205
TA1306000029,4,8,false,29,14,-15,41.89256,-87.61449
13265,4,8,false,29,25,-4,41.89383,-87.64172
13045,4,8,false,54,35,-19,41.89403,-87.62931
13016,4,8,false,25,62,37,41.89431,-87.62277
211,4,8,false,4,14,10,41.89439,-87.62267
KA1503000041,4,8,false,39,40,1,41.89452,-87.61798
13196,4,8,false,25,8,-17,41.89455,-87.65345
TA1307000062,4,8,false,32,31,-1,41.89466,-87.63839
TA1306000012,4,8,false,49,33,-16,41.89475,-87.63438
KP1705001026,4,8,false,17,27,10,41.89483,-87.6323
637,4,8,false,17,2,-15,41.89563,-87.67209
13132,4,8,false,19,10,-9,41.89573,-87.67718
15530,4,8,false,45,19,-26,41.89575,-87.62596
18003,4,8,false,19,16,-3,41.89575,-87.62011
13247,4,8,false,14,6,-8,41.89597,-87.66775
TA1305000020,4,8,false,14,11,-3,41.89636,-87.65406
13289,4,8,false,20,8,-12,41.89638,-87.661
13303,4,8,false,17,18,1,41.89672,-87.63088
13017,4,8,false,39,20,-19,41.89676,-87.6357
13338,4,8,false,24,17,-7,41.89697,-87.62173
TA1307000061,4,8,false,25,19,-6,41.89745,-87.62873
13034,4,8,false,11,10,-1,41.89754,-87.62352
TA1306000009,4,8,false,42,47,5,41.89772,-87.64299
620,4,8,false,12,6,-6,41.89817,-87.63754
KA1504000103,4,8,false,16,12,-4,41.89842,-87.68659
15529,4,8,false,29,11,-18,41.89858,-87.62206
TA1307000128,4,8,false,26,23,-3,41.89896,-87.6299
657,4,8,false,12,8,-4,41.89918,-87.6722
KA1504000117,4,8,false,6,16,10,41.89936,-87.64848
TA1306000011,4,8,false,13,7,-6,41.89994,-87.63443
KA1504000116,4,8,false,17,14,-3,41.90023,-87.64299
17660,4,8,false,10,2,-8,41.90036,-87.69671
13290,4,8,false,12,9,-3,41.90069,-87.66259
13042,4,8,false,43,46,3,41.90097,-87.62377
TA1307000070,4,8,false,19,4,-15,41.90133,-87.67742
KA1504000133,4,8,false,28,24,-4,41.90234,-87.62773
13241,4,8,false,16,1,-15,41.9029,-87.68731
176,4,8,false,12,6,-6,41.90291,-87.63141
TA1306000006,4,8,false,10,1,-9,41.90292,-87.63772
TA1307000039,4,8,false,59,27,-32,41.90294,-87.63137
TA1305000034,4,8,false,12,8,-4,41.90313,-87.67391
182,4,8,false,14,6,-8,41.90317,-87.63442
KA1504000135,4,8,false,43,34,-9,41.90319,-87.63439
13136,4,8,false,3,11,8,41.90326,-87.67845
13061,4,8,false,38,43,5,41.90342,-87.66779
KA1504000079,4,8,false,19,16,-3,41.9035,-87.64334
TA1307000115,4,8,false,11,2,-9,41.9046,-87.64056
TA1308000049,4,8,false,28,24,-4,41.90672,-87.6349
KA1504000134,4,8,false,25,17,-8,41.90687,-87.6262
13224,4,8,false,20,8,-12,41.90706,-87.66725
TA1307000143,4,8,false,14,9,-5,41.90762,-87.63854
13221,4,8,false,17,12,-5,41.90765,-87.67254
TA1309000024,4,8,false,21,18,-3,41.908,-87.63152
TA1305000041,4,8,false,19,31,12,41.9094,-87.67769
331,4,8,false,35,27,-8,41.90965,-87.64812
TA1305000037,4,8,false,18,3,-15,41.91018,-87.67003
TA1306000008,4,8,false,12,5,-7,41.9102,-87.6435
13257,4,8,false,15,8,-7,41.91054,-87.68956
13154,4,8,false,11,15,4,41.91054,-87.65312
13058,4,8,false,13,12,-1,41.91059,-87.64942
TA1307000038,4,8,false,21,22,1,41.91138,-87.63868
LF-005,4,8,false,25,22,-3,41.91172,-87.62681
13128,4,8,false,15,15,0,41.91197,-87.63197
TA1308000050,4,8,false,39,46,7,41.91211,-87.6347
13243,4,8,false,19,15,-4,41.91262,-87.6814
TA1306000032,4,8,false,13,21,8,41.9137,-87.65285
TA1307000166,4,8,false,8,14,6,41.91386,-87.64877
13068,4,8,false,15,11,-4,41.91554,-87.68703
13179,4,8,false,21,23,2,41.9157,-87.63461
13133,4,8,false,14,4,-10,41.91598,-87.67733
TA1305000039,4,8,false,24,13,-11,41.9163,-87.66749
TA1309000029,4,8,false,13,4,-9,41.9178,-87.68245
TA1309000006,4,8,false,15,9,-6,41.91809,-87.64375
TA1307000163,4,8,false,11,10,-1,41.91821,-87.65696
13146,4,8,false,22,40,18,41.91831,-87.63629
13059,4,8,false,19,21,2,41.91845,-87.65222
13192,4,8,false,8,23,15,41.91995,-87.64884
13288,4,8,false,15,2,-13,41.92008,-87.67788
TA1309000030,4,8,false,9,11,2,41.92077,-87.66372
13292,4,8,false,11,4,-7,41.92152,-87.70733
TA1309000033,4,8,false,13,6,-7,41.92158,-87.65381
13193,4,8,false,44,22,-22,41.92182,-87.64412
13191,4,8,false,20,17,-3,41.92217,-87.63891
13084,4,8,false,10,20,10,41.92268,-87.69715
LP-,4,8,false,23,7,-16,41.92396,-87.63584
TA1307000001,4,8,false,18,13,-5,41.92535,-87.66581
TA1306000026,4,8,false,21,16,-5,41.92558,-87.65842
TA1306000016,4,8,false,15,44,29,41.9256,-87.65371
313,4,8,false,17,6,-11,41.9257,-87.64246
TA1309000019,4,8,false,36,14,-22,41.92586,-87.63897
TA1309000058,4,8,false,42,23,-19,41.92591,-87.64927
TA1308000001,4,8,false,16,20,4,41.92627,-87.63086
TA1309000023,4,8,false,16,10,-6,41.9287,-87.65383
TA1307000113,4,8,false,14,21,7,41.92878,-87.66391
13296,4,8,false,18,6,-12,41.92883,-87.66852
TA1309000059,4,8,false,13,22,9,41.92889,-87.65898
TA1309000061,4,8,false,20,10,-10,41.92915,-87.64909
TA1308000031,4,8,false,8,11,3,41.92946,-87.68417
TA1305000014,4,8,false,18,24,6,41.92956,-87.64313
13085,4,8,false,14,13,-1,41.92958,-87.70789
TA1307000142,4,8,false,40,18,-22,41.93125,-87.64432
13276,4,8,false,26,21,-5,41.93132,-87.63874
TA1307000064,4,8,false,23,22,-1,41.93222,-87.65864
TA1306000014,4,8,false,17,27,10,41.93242,-87.65271
TA1309000039,4,8,false,29,20,-9,41.93258,-87.63642
13294,4,8,false,15,7,-8,41.9326,-87.66595
TA1309000036,4,8,false,14,14,0,41.93313,-87.64776
15644,4,8,false,10,5,-5,41.93534,-87.71687
TA1307000006,4,8,false,17,14,-3,41.93571,-87.6636
13268,4,8,false,12,9,-3,41.93588,-87.67843
TA1307000052,4,8,false,17,18,1,41.93628,-87.65266
TA1307000136,4,8,false,21,20,-1,41.9365,-87.64755
TA1307000041,4,8,false,23,26,3,41.93669,-87.63683
13137,4,8,false,40,38,-2,41.9376,-87.6441
TA1309000042,4,8,false,14,8,-6,41.93937,-87.66836
15640,4,8,false,10,1,-9,41.93941,-87.72357
13229,4,8,false,11,14,3,41.93946,-87.66376
TA1308000019,4,8,false,16,20,4,41.93973,-87.65886
13277,4,8,false,21,10,-11,41.9401,-87.64546
TA1307000134,4,8,false,30,38,8,41.94016,-87.65303
TA1309000049,4,8,false,27,20,-7,41.94077,-87.63919
TA1307000138,4,8,false,9,19,10,41.94334,-87.67094
13144,4,8,false,12,4,-8,41.9434,-87.67964
TA1309000025,4,8,false,18,13,-5,41.94368,-87.64894
13071,4,8,false,7,22,15,41.94373,-87.66401
632,4,8,false,19,18,-1,41.94453,-87.6547
13278,4,8,false,27,22,-5,41.94553,-87.64644
13235,4,8,false,26,23,-3,41.94814,-87.66396
13325,4,8,false,19,11,-8,41.94907,-87.64863
TA1307000126,4,8,false,17,17,0,41.94936,-87.65451
TA1307000150,4,8,false,37,17,-20,41.94945,-87.64646
13323,4,8,false,19,10,-9,41.95282,-87.65
TA1309000043,4,8,false,10,4,-6,41.95417,-87.66434
13063,4,8,false,20,9,-11,41.95424,-87.65441
TA1308000022,4,8,false,23,14,-9,41.95438,-87.64805
13249,4,8,false,7,15,8,41.95606,-87.66885
TA1308000047,4,8,false,10,1,-9,41.95709,-87.6642
13379,4,8,false,13,8,-5,41.95786,-87.6495
TA1309000027,4,8,false,23,5,-18,41.9585,-87.65499
13389,4,8,false,27,11,-16,41.961,-87.64958
TA1307000107,4,8,false,14,18,4,41.96164,-87.65464
TA1308000012,4,8,false,12,10,-2,41.96398,-87.63818
13074,4,8,false,11,10,-1,41.96521,-87.6582
TA1309000014,4,8,false,20,11,-9,41.96709,-87.66744
TA1307000119,4,8,false,16,7,-9,41.96796,-87.65
TA1309000066,4,8,false,14,19,5,41.9691,-87.67423
TA1309000035,4,8,false,9,14,5,41.97335,-87.66785
KA1504000146,4,8,false,9,13,4,41.978,-87.66805
13109,4,8,false,9,14,5,41.97835,-87.65976
KA1504000152,4,8,false,11,12,1,41.98403,-87.65231
15571,4,8,false,5,10,5,41.99478,-87.66028
E002,4,8,false,3,10,7,42.03256,-87.67912
661,4,8,false,10,1,-9,42.05704,-87.68657
604,4,8,false,2,16,14,42.05824,-87.67744
KA1503000014,4,8,true,64,26,-38,41.7851,-87.60108
KA1503000070,4,8,true,25,17,-8,41.78794,-87.58831
328,4,8,true,3,21,18,41.78872,-87.6013
TA1309000011,4,8,true,12,69,57,41.78873,-87.60131
KA1503000071,4,8,true,9,89,80,41.79148,-87.59988
KA1503000074,4,8,true,12,6,-6,41.79174,-87.58395
TA1309000063,4,8,true,39,27,-12,41.79325,-87.5878
KA1504000076,4,8,true,39,93,54,41.7943,-87.60145
TA1308000009,4,8,true,47,8,-39,41.79522,-87.58075
TA1307000164,4,8,true,21,18,-3,41.79527,-87.59647
KA1503000052,4,8,true,25,17,-8,41.79935,-87.60097
KA1503000059,4,8,true,18,7,-11,41.79952,-87.58643
TA1309000037,4,8,true,41,19,-22,41.79957,-87.59474
KA1503000007,4,8,true,19,12,-7,41.80242,-87.58689
13398,4,8,true,38,6,-32,41.80256,-87.59035
TA1308000002,4,8,true,21,6,-15,41.80983,-87.59937
KA1503000027,4,8,true,2,11,9,41.81666,-87.61942
184,4,8,true,3,18,15,41.83104,-87.62684
TA1307000129,4,8,true,5,93,88,41.83104,-87.62683
13216,4,8,true,12,89,77,41.83473,-87.62581
148,4,8,true,3,17,14,41.83474,-87.62581
13217,4,8,true,29,3,-26,41.83488,-87.61792
13215,4,8,true,24,5,-19,41.83634,-87.6135
TA1308000046,4,8,true,21,4,-17,41.83779,-87.65115
339,4,8,true,10,2,-8,41.83817,-87.64523
TA1309000055,4,8,true,34,8,-26,41.8382,-87.64514
KA1503000038,4,8,true,7,14,7,41.83845,-87.6354
TA1307000048,4,8,true,20,20,0,41.83855,-87.60821
TA1308000036,4,8,true,39,8,-31,41.83883,-87.62186
TA1307000139,4,8,true,39,11,-28,41.84205,-87.61698
TA1307000153,4,8,true,16,2,-14,41.84358,-87.64538
147,4,8,true,3,15,12,41.84569,-87.62251
TA1307000005,4,8,true,28,46,18,41.84569,-87.6225
15689,4,8,true,22,1,-21,41.84912,-87.69515
TA1305000001,4,8,true,14,14,0,41.85262,-87.6265
13075,4,8,true,4,14,10,41.8531,-87.63192
13096,4,8,true,8,13,5,41.8538,-87.69577
13091,4,8,true,4,11,7,41.85409,-87.68585
15546,4,8,true,28,5,-23,41.85416,-87.61916
13307,4,8,true,19,3,-16,41.85489,-87.66359
13089,4,8,true,15,16,1,41.85497,-87.67567
13331,4,8,true,17,7,-10,41.85515,-87.65414
15545,4,8,true,36,33,-3,41.85627,-87.61334
4,4,8,true,7,11,4,41.85627,-87.61334
129,4,8,true,13,2,-11,41.85752,-87.66158
13135,4,8,true,35,3,-32,41.85753,-87.66157
13102,4,8,true,80,11,-69,41.85762,-87.61942
13150,4,8,true,83,22,-61,41.85783,-87.62455
273,4,8,true,12,6,-6,41.85783,-87.62455
13099,4,8,true,12,8,-4,41.85784,-87.64627
TA1307000159,4,8,true,16,4,-12,41.8579,-87.6687
14,4,8,true,11,2,-9,41.85808,-87.65109
13163,4,8,true,55,7,-48,41.85808,-87.65108
13164,4,8,true,43,8,-35,41.85818,-87.65648
15,4,8,true,12,1,-11,41.85819,-87.65648
SL-012,4,8,true,103,14,-89,41.86038,-87.62581
72,4,8,true,20,7,-13,41.86039,-87.62581
13304,4,8,true,19,7,-12,41.86126,-87.65659
KA1504000109,4,8,true,3,24,21,41.86192,-87.69347
TA1306000002,4,8,true,33,21,-12,41.86238,-87.65108
TA1307000124,4,8,true,97,37,-60,41.86411,-87.62372
168,4,8,true,20,8,-12,41.86415,-87.62372
TA1309000001,4,8,true,29,26,-3,41.86488,-87.64708
13354,4,8,true,1,15,14,41.86524,-87.66651
13431,4,8,true,22,20,-2,41.8661,-87.60728
WL-008,4,8,true,10,13,3,41.86712,-87.64108
57,4,8,true,3,13,10,41.86712,-87.64107
TA1305000002,4,8,true,128,58,-70,41.86721,-87.62597
59,4,8,true,18,17,-1,41.86721,-87.62597
15544,4,8,true,22,33,11,41.86723,-87.61536
TA1305000017,4,8,true,19,28,9,41.86734,-87.64863
KA1706005007,4,8,true,16,8,-8,41.86749,-87.63219
SL-005,4,8,true,118,42,-76,41.8679,-87.62304
255,4,8,true,29,3,-26,41.86791,-87.62304
644,4,8,true,25,4,-21,41.86859,-87.68625
13139,4,8,true,34,10,-24,41.86893,-87.65913
13285,4,8,true,9,112,103,41.86928,-87.67372
13160,4,8,true,29,11,-18,41.86947,-87.65548
22,4,8,true,11,2,-9,41.86947,-87.65548
414,4,8,true,12,8,-4,41.87023,-87.63947
15550,4,8,true,12,25,13,41.87024,-87.63947
TA1309000010,4,8,true,73,30,-43,41.87074,-87.62574
SL-009,4,8,true,75,7,-68,41.87081,-87.63121
342,4,8,true,4,47,43,41.87127,-87.6737
TA1309000064,4,8,true,15,166,151,41.87127,-87.67369
261,4,8,true,4,17,13,41.87151,-87.6699
TA1307000130,4,8,true,41,58,17,41.87178,-87.65103
108,4,8,true,10,6,-4,41.87183,-87.64664
TA1307000121,4,8,true,29,58,29,41.87184,-87.64664
41,4,8,true,21,4,-17,41.87209,-87.62957
SL-008,4,8,true,128,62,-66,41.87209,-87.62956
13332,4,8,true,114,28,-86,41.87219,-87.6615
175,4,8,true,21,5,-16,41.87255,-87.63359
SL-011,4,8,true,83,18,-65,41.87256,-87.63356
623,4,8,true,76,21,-55,41.87272,-87.62399
KA1504000104,4,8,true,28,179,151,41.87296,-87.66912
383,4,8,true,3,32,29,41.87297,-87.66912
320,4,8,true,17,13,-4,41.87327,-87.66402
SL-007,4,8,true,38,29,-9,41.87404,-87.6277
13326,4,8,true,25,34,9,41.87425,-87.63958
321,4,8,true,22,5,-17,41.87427,-87.63257
TA1306000025,4,8,true,35,28,-7,41.87464,-87.65703
15668,4,8,true,4,10,6,41.87471,-87.68642
13028,4,8,true,11,53,42,41.87475,-87.64981
13081,4,8,true,12,31,19,41.87501,-87.67326
89,4,8,true,10,9,-1,41.87501,-87.6331
SL-010,4,8,true,73,36,-37,41.87501,-87.63309
15541,4,8,true,19,5,-14,41.8758,-87.62086
13037,4,8,true,9,30,21,41.87588,-87.64078
50,4,8,true,3,10,7,41.87592,-87.6307
TA1305000009,4,8,true,43,36,-7,41.87593,-87.63068
317,4,8,true,6,20,14,41.87603,-87.68195
TA1305000010,4,8,true,12,34,22,41.87623,-87.62444
624,4,8,true,40,41,1,41.87626,-87.62923
TA1305000035,4,8,true,44,99,55,41.87716,-87.62787
13138,4,8,true,77,136,59,41.87723,-87.63941
75,4,8,true,3,14,11,41.87724,-87.63937
631,4,8,true,3,24,21,41.87761,-87.6739
15539,4,8,true,63,101,38,41.87763,-87.64405
13158,4,8,true,130,87,-43,41.87764,-87.64957
134,4,8,true,20,16,-4,41.87764,-87.64954
13157,4,8,true,47,23,-24,41.87773,-87.6548
TA1305000025,4,8,true,83,274,191,41.87773,-87.63528
36,4,8,true,22,36,14,41.87776,-87.63525
TA1309000002,4,8,true,38,33,-5,41.87784,-87.62408
13206,4,8,true,55,39,-16,41.87794,-87.66201
283,4,8,true,4,45,41,41.87809,-87.63183
TA1309000004,4,8,true,62,245,183,41.87811,-87.63184
107,4,8,true,11,17,6,41.87822,-87.644
638,4,8,true,118,174,56,41.87827,-87.64078
37,4,8,true,2,34,32,41.87921,-87.62975
TA1305000005,4,8,true,20,184,164,41.87924,-87.62975
286,4,8,true,3,13,10,41.8793,-87.6355
13011,4,8,true,171,158,-13,41.87931,-87.63993
TA1309000008,4,8,true,49,106,57,41.87933,-87.6355
192,4,8,true,12,32,20,41.87935,-87.63997
KA1503000034,4,8,true,3,206,203,41.87938,-87.63197
40,4,8,true,1,43,42,41.87944,-87.63197
39,4,8,true,3,24,21,41.87948,-87.62571
KA1503000015,4,8,true,53,142,89,41.87948,-87.6257
287,4,8,true,3,49,46,41.88017,-87.63527
TA1309000007,4,8,true,23,357,334,41.88022,-87.63526
WL-011,4,8,true,58,48,-10,41.88034,-87.64273
80,4,8,true,13,11,-2,41.88042,-87.65556
13156,4,8,true,78,29,-49,41.88042,-87.65554
13300,4,8,true,17,27,10,41.88097,-87.61675
13008,4,8,true,22,104,82,41.88105,-87.62408
90,4,8,true,5,19,14,41.88107,-87.62409
49,4,8,true,9,88,79,41.88116,-87.62963
TA1305000006,4,8,true,30,394,364,41.88122,-87.6296
13134,4,8,true,15,18,3,41.88138,-87.67493
13056,4,8,true,124,104,-20,41.88168,-87.63951
191,4,8,true,14,13,-1,41.88169,-87.63951
198,4,8,true,19,13,-6,41.88187,-87.6488
TA1307000120,4,8,true,104,63,-41,41.88188,-87.64879
13341,4,8,true,172,128,-44,41.88208,-87.63985
174,4,8,true,13,12,-1,41.88208,-87.63984
197,4,8,true,11,8,-3,41.88208,-87.62513
13036,4,8,true,41,90,49,41.8821,-87.62513
77,4,8,true,40,21,-19,41.88214,-87.64108
TA1305000032,4,8,true,284,186,-98,41.88218,-87.64109
98,4,8,true,12,47,35,41.88266,-87.63251
13006,4,8,true,30,219,189,41.88268,-87.63252
13353,4,8,true,79,45,-34,41.88283,-87.6612
346,4,8,true,13,15,2,41.88284,-87.6612
654,4,8,true,38,32,-6,41.88307,-87.65698
13409,4,8,true,48,18,-30,41.8831,-87.6511
18,4,8,true,6,34,28,41.88317,-87.63735
KA1503000072,4,8,true,85,184,99,41.88317,-87.63693
91,4,8,true,21,30,9,41.88336,-87.64122
WL-012,4,8,true,245,232,-13,41.88337,-87.6412
112,4,8,true,5,27,22,41.88362,-87.6486
13053,4,8,true,47,74,27,41.88365,-87.64863
43,4,8,true,17,15,-2,41.88396,-87.62455
13001,4,8,true,132,203,71,41.88397,-87.62459
13155,4,8,true,18,28,10,41.88407,-87.65689
18062,4,8,true,55,60,5,41.88412,-87.65427
81,4,8,true,14,30,16,41.88417,-87.6296
TA1306000010,4,8,true,97,264,167,41.88419,-87.62961
TA1305000030,4,8,true,72,457,385,41.88459,-87.63178
15535,4,8,true,63,40,-23,41.8846,-87.64455
96,4,8,true,12,17,5,41.8846,-87.64455
51,4,8,true,3,71,68,41.88462,-87.63176
TA1305000029,4,8,true,54,90,36,41.88466,-87.62787
195,4,8,true,61,20,-41,41.88466,-87.61952
13263,4,8,true,180,85,-95,41.88467,-87.61952
44,4,8,true,5,21,16,41.88468,-87.62782
TA1306000015,4,8,true,88,192,104,41.88549,-87.65232
71,4,8,true,16,28,12,41.8855,-87.65233
66,4,8,true,16,35,19,41.88557,-87.64186
13021,4,8,true,162,214,52,41.88559,-87.64184
TA1307000111,4,8,true,55,274,219,41.88582,-87.63548
164,4,8,true,2,26,24,41.88583,-87.63547
13073,4,8,true,23,7,-16,41.88592,-87.66717
KA17018054,4,8,true,7,56,49,41.88595,-87.67701
38,4,8,true,12,42,30,41.88599,-87.63089
KA1503000012,4,8,true,85,167,82,41.88599,-87.63089
52,4,8,true,20,50,30,41.886,-87.62421
TA1305000011,4,8,true,71,271,200,41.886,-87.62418
7,4,8,true,16,10,-6,41.88627,-87.61751
15534,4,8,true,59,29,-30,41.88627,-87.61749
217,4,8,true,6,14,8,41.8866,-87.65821
13197,4,8,true,29,79,50,41.8866,-87.65816
264,4,8,true,15,13,-2,41.8867,-87.62224
TA1308000029,4,8,true,80,104,24,41.88673,-87.62225
194,4,8,true,1,25,24,41.88688,-87.62606
TA1307000131,4,8,true,26,132,106,41.88688,-87.62606
KA1503000064,4,8,true,15,22,7,41.88697,-87.61281
100,4,8,true,17,19,2,41.88814,-87.63657
TA1305000022,4,8,true,81,177,96,41.88817,-87.63656
56,4,8,true,36,25,-11,41.88866,-87.64442
TA1306000003,4,8,true,151,91,-60,41.88867,-87.64442
133,4,8,true,26,42,16,41.88918,-87.63851
KA1503000043,4,8,true,200,252,52,41.88918,-87.63851
13050,4,8,true,72,226,154,41.88919,-87.62775
47,4,8,true,13,42,29,41.88921,-87.62775
15664,4,8,true,26,1,-25,41.8895,-87.68821
285,4,8,true,15,4,-11,41.88989,-87.67149
13432,4,8,true,47,54,7,41.88989,-87.67149
TA1307000151,4,8,true,143,267,124,41.88993,-87.63427
212,4,8,true,17,39,22,41.88995,-87.63427
636,4,8,true,73,172,99,41.88997,-87.63662
125,4,8,true,17,25,8,41.89018,-87.62621
KA1503000044,4,8,true,84,120,36,41.89018,-87.6262
196,4,8,true,35,15,-20,41.89053,-87.62205
13427,4,8,true,98,97,-1,41.89054,-87.62205
26,4,8,true,21,9,-12,41.89057,-87.61798
13430,4,8,true,65,120,55,41.89077,-87.63169
181,4,8,true,6,19,13,41.89077,-87.63168
TA1306000013,4,8,true,91,48,-43,41.89083,-87.61852
RN-,4,8,true,61,75,14,41.89102,-87.63546
672,4,8,true,8,16,8,41.89102,-87.63545
277,4,8,true,12,7,-5,41.89108,-87.66665
13434,4,8,true,22,10,-12,41.89108,-87.66663
TA1308000006,4,8,true,31,25,-6,41.89128,-87.67686
199,4,8,true,9,21,12,41.89143,-87.62676
TA1307000117,4,8,true,95,123,28,41.89144,-87.62675
13033,4,8,true,77,81,4,41.8916,-87.64835
214,4,8,true,5,10,5,41.89161,-87.67688
84,4,8,true,11,12,1,41.89161,-87.64833
186,4,8,true,10,10,0,41.8918,-87.65879
13194,4,8,true,66,64,-2,41.8918,-87.65878
TA1305000003,4,8,true,100,97,-3,41.89187,-87.62061
24,4,8,true,19,23,4,41.8919,-87.62063
643,4,8,true,21,6,-15,41.89203,-87.68939
35,4,8,true,17,8,-9,41.89227,-87.61206
13022,4,8,true,79,40,-39,41.89227,-87.61205
TA1306000029,4,8,true,57,33,-24,41.89256,-87.61449
13265,4,8,true,101,57,-44,41.89383,-87.64172
74,4,8,true,22,12,-10,41.89384,-87.64173
13045,4,8,true,149,146,-3,41.89403,-87.62931
110,4,8,true,39,17,-22,41.89406,-87.6293
13016,4,8,true,122,284,162,41.89431,-87.62277
211,4,8,true,13,96,83,41.89439,-87.62267
KA1503000041,4,8,true,121,177,56,41.89452,-87.61798
142,4,8,true,17,35,18,41.89453,-87.61806
92,4,8,true,15,15,0,41.89455,-87.65346
13196,4,8,true,57,26,-31,41.89455,-87.65345
TA1307000062,4,8,true,149,145,-4,41.89466,-87.63839
111,4,8,true,15,19,4,41.89466,-87.63837
TA1306000012,4,8,true,165,167,2,41.89475,-87.63438
53,4,8,true,29,27,-2,41.89476,-87.63439
627,4,8,true,12,14,2,41.8948,-87.63231
KP1705001026,4,8,true,68,54,-14,41.89483,-87.6323
18058,4,8,true,41,11,-30,41.8955,-87.68201
637,4,8,true,57,15,-42,41.89563,-87.67209
13132,4,8,true,84,32,-52,41.89573,-87.67718
161,4,8,true,14,14,0,41.89574,-87.62599
15530,4,8,true,142,167,25,41.89575,-87.62596
18003,4,8,true,35,81,46,41.89575,-87.62011
635,4,8,true,2,17,15,41.89576,-87.62012
13247,4,8,true,56,24,-32,41.89597,-87.66775
TA1305000020,4,8,true,53,78,25,41.89636,-87.65406
13289,4,8,true,64,17,-47,41.89638,-87.661
86,4,8,true,10,10,0,41.89639,-87.661
337,4,8,true,13,10,-3,41.89659,-87.63096
13303,4,8,true,48,35,-13,41.89672,-87.63088
13017,4,8,true,120,112,-8,41.89676,-87.6357
31,4,8,true,17,25,8,41.89677,-87.63572
13338,4,8,true,91,130,39,41.89697,-87.62173
173,4,8,true,9,19,10,41.89704,-87.62173
TA1307000061,4,8,true,67,48,-19,41.89745,-87.62873
106,4,8,true,12,15,3,41.89746,-87.62874
25,4,8,true,3,13,10,41.89751,-87.62354
13034,4,8,true,24,58,34,41.89754,-87.62352
48,4,8,true,33,34,1,41.89772,-87.64302
TA1306000009,4,8,true,92,385,293,41.89772,-87.64299
620,4,8,true,62,30,-32,41.89817,-87.63754
KA1504000103,4,8,true,41,14,-27,41.89842,-87.68659
374,4,8,true,14,1,-13,41.89842,-87.68659
145,4,8,true,14,11,-3,41.89856,-87.62211
15529,4,8,true,62,85,23,41.89858,-87.62206
140,4,8,true,19,15,-4,41.89895,-87.6299
TA1307000128,4,8,true,110,79,-31,41.89896,-87.6299
657,4,8,true,56,22,-34,41.89918,-87.6722
KA1504000117,4,8,true,12,29,17,41.89936,-87.64848
13248,4,8,true,82,20,-62,41.89964,-87.66788
46,4,8,true,14,8,-6,41.89994,-87.63444
TA1306000011,4,8,true,59,16,-43,41.89994,-87.63443
KA1504000116,4,8,true,54,44,-10,41.90023,-87.64299
364,4,8,true,14,11,-3,41.90023,-87.64299
17660,4,8,true,26,4,-22,41.90036,-87.69671
13290,4,8,true,82,33,-49,41.90069,-87.66259
29,4,8,true,13,2,-11,41.90069,-87.66259
13042,4,8,true,85,84,-1,41.90097,-87.62377
85,4,8,true,13,19,6,41.90098,-87.62375
183,4,8,true,10,8,-2,41.90133,-87.67744
TA1307000070,4,8,true,62,17,-45,41.90133,-87.67742
KA1504000133,4,8,true,74,47,-27,41.90234,-87.62773
172,4,8,true,16,8,-8,41.90236,-87.62774
15654,4,8,true,17,5,-12,41.90271,-87.70923
13241,4,8,true,26,32,6,41.9029,-87.68731
176,4,8,true,58,20,-38,41.90291,-87.63141
TA1306000006,4,8,true,60,5,-55,41.90292,-87.63772
TA1307000039,4,8,true,204,118,-86,41.90294,-87.63137
658,4,8,true,37,62,25,41.903,-87.6838
13256,4,8,true,15,5,-10,41.90302,-87.69749
TA1305000034,4,8,true,29,20,-9,41.90313,-87.67391
182,4,8,true,39,14,-25,41.90317,-87.63442
KA1504000135,4,8,true,131,78,-53,41.90319,-87.63439
13136,4,8,true,72,43,-29,41.90326,-87.67845
130,4,8,true,14,3,-11,41.90327,-87.67846
210,4,8,true,13,22,9,41.90342,-87.66781
13061,4,8,true,131,72,-59,41.90342,-87.66779
KA1504000079,4,8,true,66,27,-39,41.9035,-87.64334
138,4,8,true,17,5,-12,41.9046,-87.64057
TA1307000115,4,8,true,82,13,-69,41.9046,-87.64056
291,4,8,true,24,18,-6,41.90672,-87.63494
TA1308000049,4,8,true,58,68,10,41.90672,-87.6349
KA1504000134,4,8,true,64,23,-41,41.90687,-87.6262
180,4,8,true,20,4,-16,41.90687,-87.62618
13224,4,8,true,48,21,-27,41.90706,-87.66725
333,4,8,true,27,2,-25,41.90706,-87.66725
18069,4,8,true,3,34,31,41.90722,-87.65563
TA1307000143,4,8,true,59,7,-52,41.90762,-87.63854
13221,4,8,true,50,18,-32,41.90765,-87.67254
13245,4,8,true,10,22,12,41.90777,-87.68586
301,4,8,true,37,7,-30,41.90796,-87.63203
TA1309000024,4,8,true,105,56,-49,41.908,-87.63152
TA1305000041,4,8,true,58,63,5,41.9094,-87.67769
331,4,8,true,92,76,-16,41.90965,-87.64812
TA1305000037,4,8,true,84,17,-67,41.91018,-87.67003
TA1306000008,4,8,true,54,18,-36,41.9102,-87.6435
16,4,8,true,24,16,-8,41.91035,-87.67008
213,4,8,true,11,1,-10,41.91037,-87.68237
TA1308000005,4,8,true,63,17,-46,41.91042,-87.68238
13258,4,8,true,22,16,-6,41.91043,-87.69718
160,4,8,true,10,1,-9,41.91054,-87.68957
13257,4,8,true,38,10,-28,41.91054,-87.68956
13154,4,8,true,81,66,-15,41.91054,-87.65312
20,4,8,true,11,8,-3,41.91055,-87.65313
13058,4,8,true,30,34,4,41.91059,-87.64942
TA1307000038,4,8,true,67,57,-10,41.91138,-87.63868
118,4,8,true,12,8,-4,41.91138,-87.63868
LF-005,4,8,true,91,23,-68,41.91172,-87.62681
268,4,8,true,13,3,-10,41.91172,-87.62681
126,4,8,true,21,14,-7,41.91196,-87.63197
13128,4,8,true,57,31,-26,41.91197,-87.63197
289,4,8,true,32,22,-10,41.91209,-87.63472
TA1308000050,4,8,true,159,126,-33,41.91211,-87.6347
13243,4,8,true,52,26,-26,41.91262,-87.6814
158,4,8,true,15,8,-7,41.91262,-87.6814
TA1309000032,4,8,true,12,21,9,41.91293,-87.66417
TA1306000032,4,8,true,86,35,-51,41.9137,-87.65285
TA1307000166,4,8,true,48,35,-13,41.91386,-87.64877
224,4,8,true,11,9,-2,41.91386,-87.64877
15655,4,8,true,22,9,-13,41.91401,-87.70514
18067,4,8,true,27,17,-10,41.9146,-87.66796
TA1306000007,4,8,true,61,15,-46,41.91469,-87.64333
13068,4,8,true,24,24,0,41.91554,-87.68703
13179,4,8,true,66,35,-31,41.9157,-87.63461
141,4,8,true,13,13,0,41.91571,-87.63461
13133,4,8,true,44,19,-25,41.91598,-87.67733
58,4,8,true,12,5,-7,41.91602,-87.66894
TA1305000039,4,8,true,49,62,13,41.9163,-87.66749
15650,4,8,true,20,17,-3,41.91711,-87.71023
15651,4,8,true,18,12,-6,41.91752,-87.70181
13266,4,8,true,21,9,-12,41.91774,-87.69142
TA1309000029,4,8,true,42,24,-18,41.9178,-87.68245
309,4,8,true,15,9,-6,41.91789,-87.6865
TA1309000006,4,8,true,78,30,-48,41.91809,-87.64375
TA1307000163,4,8,true,72,53,-19,41.91821,-87.65696
94,4,8,true,39,22,-17,41.91831,-87.6363
13146,4,8,true,130,79,-51,41.91831,-87.63629
13059,4,8,true,54,69,15,41.91845,-87.65222
113,4,8,true,14,22,8,41.91846,-87.65222
13259,4,8,true,21,7,-14,41.91852,-87.69744
13192,4,8,true,82,45,-37,41.91995,-87.64884
225,4,8,true,18,17,-1,41.91995,-87.64884
13288,4,8,true,27,13,-14,41.92008,-87.67788
13242,4,8,true,18,12,-6,41.92021,-87.69266
TA1309000030,4,8,true,32,28,-4,41.92077,-87.66372
13292,4,8,true,21,6,-15,41.92152,-87.70733
TA1309000033,4,8,true,44,64,20,41.92158,-87.65381
13193,4,8,true,111,101,-10,41.92182,-87.64412
144,4,8,true,20,23,3,41.92182,-87.64411
13191,4,8,true,109,36,-73,41.92217,-87.63891
143,4,8,true,16,8,-8,41.92217,-87.63891
327,4,8,true,10,6,-4,41.92225,-87.65783
13084,4,8,true,14,35,21,41.92268,-87.69715
LP-,4,8,true,74,22,-52,41.92396,-87.63584
673,4,8,true,12,6,-6,41.92398,-87.63585
KA1504000140,4,8,true,13,9,-4,41.92409,-87.67646
15648,4,8,true,11,6,-5,41.92464,-87.68931
KA1504000090,4,8,true,15,3,-12,41.92483,-87.7145
TA1307000001,4,8,true,26,18,-8,41.92535,-87.66581
TA1306000026,4,8,true,87,55,-32,41.92558,-87.65842
87,4,8,true,20,9,-11,41.92559,-87.65843
TA1306000016,4,8,true,58,125,67,41.9256,-87.65371
313,4,8,true,25,13,-12,41.9257,-87.64246
TA1309000019,4,8,true,115,34,-81,41.92586,-87.63897
TA1309000058,4,8,true,95,73,-22,41.92591,-87.64927
127,4,8,true,13,16,3,41.92592,-87.64927
TA1308000001,4,8,true,41,34,-7,41.92627,-87.63086
177,4,8,true,9,11,2,41.92627,-87.63086
15646,4,8,true,26,6,-20,41.92668,-87.6977
302,4,8,true,8,12,4,41.92859,-87.65421
TA1309000023,4,8,true,43,47,4,41.9287,-87.65383
TA1307000113,4,8,true,37,13,-24,41.92878,-87.66391
13296,4,8,true,25,26,1,41.92883,-87.66852
TA1309000059,4,8,true,76,43,-33,41.92889,-87.65898
349,4,8,true,14,7,-7,41.92915,-87.6491
TA1309000061,4,8,true,60,68,8,41.92915,-87.64909
TA1308000031,4,8,true,9,20,11,41.92946,-87.68417
TA1305000014,4,8,true,129,65,-64,41.92956,-87.64313
340,4,8,true,28,20,-8,41.92956,-87.64313
13085,4,8,true,11,20,9,41.92958,-87.70789
TA1307000142,4,8,true,65,43,-22,41.93125,-87.64432
220,4,8,true,23,15,-8,41.93125,-87.64431
13276,4,8,true,103,51,-52,41.93132,-87.63874
324,4,8,true,28,9,-19,41.93173,-87.64179
13271,4,8,true,11,14,3,41.93192,-87.67784
152,4,8,true,22,12,-10,41.93221,-87.65864
TA1307000064,4,8,true,114,54,-60,41.93222,-87.65864
TA1306000014,4,8,true,67,65,-2,41.93242,-87.65271
13,4,8,true,9,13,4,41.93242,-87.65271
TA1309000039,4,8,true,86,34,-52,41.93258,-87.63642
329,4,8,true,13,11,-2,41.93258,-87.63642
13294,4,8,true,24,40,16,41.9326,-87.66595
TA1309000036,4,8,true,66,36,-30,41.93313,-87.64776
TA1307000006,4,8,true,67,43,-24,41.93571,-87.6636
153,4,8,true,9,13,4,41.93575,-87.66364
13268,4,8,true,19,13,-6,41.93588,-87.67843
250,4,8,true,13,4,-9,41.93609,-87.66984
13269,4,8,true,37,15,-22,41.93609,-87.66983
115,4,8,true,15,18,3,41.93628,-87.65266
TA1307000052,4,8,true,72,100,28,41.93628,-87.65266
156,4,8,true,18,13,-5,41.9365,-87.64756
TA1307000136,4,8,true,82,76,-6,41.9365,-87.64755
TA1307000041,4,8,true,73,45,-28,41.93669,-87.63683
157,4,8,true,21,7,-14,41.9367,-87.63683
13137,4,8,true,102,79,-23,41.9376,-87.6441
300,4,8,true,26,21,-5,41.93761,-87.6441
KA17018068,4,8,true,10,5,-5,41.93935,-87.68327
TA1309000042,4,8,true,44,28,-16,41.93937,-87.66836
13229,4,8,true,41,29,-12,41.93946,-87.66376
TA1308000019,4,8,true,37,38,1,41.93973,-87.65886
13277,4,8,true,61,34,-27,41.9401,-87.64546
296,4,8,true,10,5,-5,41.9401,-87.64546
TA1307000134,4,8,true,43,90,47,41.94016,-87.65303
117,4,8,true,7,11,4,41.94016,-87.65302
13143,4,8,true,10,11,1,41.94059,-87.67853
TA1309000049,4,8,true,64,56,-8,41.94077,-87.63919
15634,4,8,true,24,9,-15,41.94304,-87.68729
TA1307000138,4,8,true,59,53,-6,41.94334,-87.67094
230,4,8,true,12,8,-4,41.94335,-87.67093
13144,4,8,true,36,12,-24,41.9434,-87.67964
TA1309000025,4,8,true,49,36,-13,41.94368,-87.64894
299,4,8,true,11,4,-7,41.94368,-87.64894
229,4,8,true,12,5,-7,41.94372,-87.66401
13071,4,8,true,46,58,12,41.94373,-87.66401
632,4,8,true,55,34,-21,41.94453,-87.6547
303,4,8,true,17,8,-9,41.94522,-87.64702
13278,4,8,true,66,23,-43,41.94553,-87.64644
TA1309000050,4,8,true,11,7,-4,41.94618,-87.67331
KA1504000143,4,8,true,16,13,-3,41.94664,-87.68337
227,4,8,true,14,6,-8,41.94813,-87.66397
13235,4,8,true,67,81,14,41.94814,-87.66396
304,4,8,true,16,9,-7,41.94878,-87.64922
13253,4,8,true,25,20,-5,41.9488,-87.67527
13325,4,8,true,56,49,-7,41.94907,-87.64863
114,4,8,true,11,5,-6,41.94935,-87.65451
TA1307000126,4,8,true,43,54,11,41.94936,-87.65451
232,4,8,true,20,16,-4,41.94943,-87.64645
TA1307000150,4,8,true,97,39,-58,41.94945,-87.64646
13319,4,8,true,31,22,-9,41.95069,-87.6687
TA1307000127,4,8,true,46,36,-10,41.9508,-87.65918
318,4,8,true,11,3,-8,41.95254,-87.6735
13323,4,8,true,62,50,-12,41.95282,-87.65
256,4,8,true,2,11,9,41.95282,-87.65
TA1309000043,4,8,true,28,48,20,41.95417,-87.66434
13063,4,8,true,45,77,32,41.95424,-87.65441
KA1504000158,4,8,true,11,5,-6,41.95432,-87.68607
TA1308000022,4,8,true,47,40,-7,41.95438,-87.64805
244,4,8,true,7,12,5,41.95466,-87.67391
TA1307000149,4,8,true,17,71,54,41.95467,-87.67392
TA1309000026,4,8,true,22,11,-11,41.95601,-87.6802
13249,4,8,true,10,4,-6,41.95606,-87.66885
TA1308000047,4,8,true,11,10,-1,41.95709,-87.6642
13379,4,8,true,51,29,-22,41.95786,-87.6495
TA1309000018,4,8,true,26,52,26,41.95791,-87.67357
TA1309000027,4,8,true,44,33,-11,41.9585,-87.65499
13389,4,8,true,60,29,-31,41.961,-87.64958
245,4,8,true,16,8,-8,41.96101,-87.64958
15622,4,8,true,14,8,-6,41.96108,-87.69544
KA1504000097,4,8,true,7,10,3,41.96116,-87.71658
TA1307000144,4,8,true,16,34,18,41.96142,-87.6762
TA1309000021,4,8,true,13,13,0,41.9615,-87.6714
15623,4,8,true,24,8,-16,41.96154,-87.69117
TA1307000107,4,8,true,48,28,-20,41.96164,-87.65464
TA1307000156,4,8,true,31,19,-12,41.96301,-87.68479
TA1309000012,4,8,true,9,18,9,41.96325,-87.67928
TA1308000012,4,8,true,13,10,-3,41.96398,-87.63818
13074,4,8,true,15,57,42,41.96521,-87.6582
639,4,8,true,23,30,7,41.96584,-87.64538
KA1504000127,4,8,true,22,6,-16,41.96587,-87.70083
KA1504000093,4,8,true,16,22,6,41.96587,-87.69365
TA1307000140,4,8,true,21,17,-4,41.96643,-87.68865
326,4,8,true,6,12,6,41.96665,-87.67113
TA1309000014,4,8,true,46,28,-18,41.96709,-87.66744
TA1307000158,4,8,true,21,32,11,41.9671,-87.67904
TA1307000119,4,8,true,47,22,-25,41.96796,-87.65
TA1308000021,4,8,true,26,7,-19,41.96883,-87.65765
TA1309000015,4,8,true,13,2,-11,41.96889,-87.68401
TA1309000066,4,8,true,57,72,15,41.9691,-87.67423
344,4,8,true,5,22,17,41.9691,-87.67423
TA1309000041,4,8,true,13,12,-1,41.96951,-87.65471
KA1504000171,4,8,true,26,20,-6,41.97161,-87.65016
TA1309000035,4,8,true,60,24,-36,41.97335,-87.66785
13108,4,8,true,35,35,0,41.97379,-87.65971
KA1504000078,4,8,true,6,12,6,41.97491,-87.69258
KA1504000149,4,8,true,20,11,-9,41.97562,-87.67945
KA1504000160,4,8,true,8,10,2,41.97564,-87.70143
KA1504000146,4,8,true,25,17,-8,41.978,-87.66805
13109,4,8,true,27,19,-8,41.97835,-87.65976
655,4,8,true,7,18,11,41.97987,-87.68194
KA1504000151,4,8,true,23,25,2,41.98359,-87.66916
KA1504000152,4,8,true,34,30,-4,41.98403,-87.65231
459,4,8,true,10,8,-2,41.98403,-87.65231
15578,4,8,true,12,20,8,41.98405,-87.66027
15575,4,8,true,52,26,-26,41.98975,-87.66014
KA1504000148,4,8,true,14,3,-11,41.99086,-87.66971
15571,4,8,true,49,23,-26,41.99478,-87.66028
KA1504000156,4,8,true,6,13,7,41.99925,-87.67137
RP-009,4,8,true,17,36,19,42.00107,-87.66122
RP-008,4,8,true,20,3,-17,42.00446,-87.6724
660,4,8,true,37,21,-16,42.00458,-87.66143
KA1504000175,4,8,true,15,9,-6,42.00797,-87.66549
KA1504000162,4,8,true,4,22,18,42.00907,-87.67422
525,4,8,true,18,3,-15,42.01272,-87.66605
520,4,8,true,12,3,-9,42.01597,-87.66859
515,4,8,true,7,16,9,42.01915,-87.67356
523,4,8,true,13,6,-7,42.02089,-87.66505
598,4,8,true,13,3,-10,42.02578,-87.68411
E002,4,8,true,35,14,-21,42.03256,-87.67912
596,4,8,true,34,26,-8,42.04822,-87.68348
E008,4,8,true,14,6,-8,42.05049,-87.67782
605,4,8,true,2,39,37,42.05294,-87.67342
604,4,8,true,3,54,51,42.05824,-87.67744
15491,4,12,false,12,14,2,41.78096,-87.57624
KA1503000014,4,12,false,19,26,7,41.7851,-87.60108
TA1309000011,4,12,false,22,17,-5,41.78873,-87.60131
KA1503000071,4,12,false,23,18,-5,41.79148,-87.59988
KA1503000074,4,12,false,13,38,25,41.79174,-87.58395
TA1309000063,4,12,false,9,15,6,41.79325,-87.5878
KA1504000076,4,12,false,18,24,6,41.7943,-87.60145
TA1308000009,4,12,false,15,16,1,41.79522,-87.58075
TA1307000164,4,12,false,15,20,5,41.79527,-87.59647
KA1503000052,4,12,false,22,6,-16,41.79935,-87.60097
KA1503000059,4,12,false,28,21,-7,41.79952,-87.58643
TA1309000037,4,12,false,13,22,9,41.79957,-87.59474
KA1503000007,4,12,false,16,16,0,41.80242,-87.58689
TA1308000035,4,12,false,10,6,-4,41.80944,-87.59188
TA1308000002,4,12,false,13,5,-8,41.80983,-87.59937
TA1308000038,4,12,false,6,10,4,41.82298,-87.6071
KA1503000004,4,12,false,13,4,-9,41.83127,-87.6088
13216,4,12,false,11,6,-5,41.83473,-87.62581
TA1307000048,4,12,false,25,19,-6,41.83855,-87.60821
TA1307000139,4,12,false,6,15,9,41.84205,-87.61698
TA1305000004,4,12,false,15,8,-7,41.8514,-87.61884
TA1305000001,4,12,false,12,16,4,41.85262,-87.6265
13075,4,12,false,10,21,11,41.8531,-87.63192
15546,4,12,false,18,4,-14,41.85416,-87.61916
13331,4,12,false,14,5,-9,41.85515,-87.65414
15545,4,12,false,20,16,-4,41.85627,-87.61334
13135,4,12,false,15,9,-6,41.85753,-87.66157
13102,4,12,false,28,19,-9,41.85762,-87.61942
273,4,12,false,10,7,-3,41.85783,-87.62455
13150,4,12,false,13,15,2,41.85783,-87.62455
TA1307000159,4,12,false,11,4,-7,41.8579,-87.6687
13164,4,12,false,12,9,-3,41.85818,-87.65648
SL-012,4,12,false,22,21,-1,41.86038,-87.62581
13304,4,12,false,4,10,6,41.86126,-87.65659
TA1307000124,4,12,false,26,22,-4,41.86411,-87.62372
TA1309000001,4,12,false,17,14,-3,41.86488,-87.64708
13029,4,12,false,46,30,-16,41.86531,-87.6179
13431,4,12,false,30,27,-3,41.8661,-87.60728
WL-008,4,12,false,16,23,7,41.86712,-87.64108
TA1305000002,4,12,false,39,29,-10,41.86721,-87.62597
59,4,12,false,13,10,-3,41.86721,-87.62597
3,4,12,false,21,21,0,41.86723,-87.61536
15544,4,12,false,179,198,19,41.86723,-87.61536
TA1305000017,4,12,false,10,5,-5,41.86734,-87.64863
KA1706005007,4,12,false,22,14,-8,41.86749,-87.63219
SL-005,4,12,false,56,48,-8,41.8679,-87.62304
255,4,12,false,16,12,-4,41.86791,-87.62304
644,4,12,false,11,2,-9,41.86859,-87.68625
13285,4,12,false,13,4,-9,41.86928,-87.67372
13160,4,12,false,13,18,5,41.86947,-87.65548
15550,4,12,false,18,21,3,41.87024,-87.63947
TA1309000010,4,12,false,25,36,11,41.87074,-87.62574
SL-009,4,12,false,8,10,2,41.87081,-87.63121
TA1309000064,4,12,false,15,15,0,41.87127,-87.67369
TA1307000130,4,12,false,20,20,0,41.87178,-87.65103
TA1307000121,4,12,false,13,17,4,41.87184,-87.64664
SL-008,4,12,false,36,20,-16,41.87209,-87.62956
13332,4,12,false,11,12,1,41.87219,-87.6615
SL-011,4,12,false,15,23,8,41.87256,-87.63356
623,4,12,false,56,54,-2,41.87272,-87.62399
KA1504000104,4,12,false,22,13,-9,41.87296,-87.66912
SL-007,4,12,false,16,12,-4,41.87404,-87.6277
321,4,12,false,6,12,6,41.87427,-87.63257
TA1306000025,4,12,false,4,10,6,41.87464,-87.65703
13028,4,12,false,15,16,1,41.87475,-87.64981
15541,4,12,false,52,35,-17,41.8758,-87.62086
TA1305000009,4,12,false,12,9,-3,41.87593,-87.63068
TA1305000010,4,12,false,18,19,1,41.87623,-87.62444
624,4,12,false,25,19,-6,41.87626,-87.62923
TA1305000035,4,12,false,15,12,-3,41.87716,-87.62787
15539,4,12,false,11,16,5,41.87763,-87.64405
13158,4,12,false,29,30,1,41.87764,-87.64957
13157,4,12,false,13,18,5,41.87773,-87.6548
TA1305000025,4,12,false,54,33,-21,41.87773,-87.63528
284,4,12,false,10,10,0,41.87784,-87.62408
TA1309000002,4,12,false,39,46,7,41.87784,-87.62408
13206,4,12,false,12,7,-5,41.87794,-87.66201
TA1309000004,4,12,false,39,20,-19,41.87811,-87.63184
638,4,12,false,23,24,1,41.87827,-87.64078
TA1305000005,4,12,false,56,34,-22,41.87924,-87.62975
13011,4,12,false,31,35,4,41.87931,-87.63993
TA1309000008,4,12,false,23,27,4,41.87933,-87.6355
KA1503000034,4,12,false,20,16,-4,41.87938,-87.63197
KA1503000015,4,12,false,38,32,-6,41.87948,-87.6257
287,4,12,false,12,5,-7,41.88017,-87.63527
TA1309000007,4,12,false,45,40,-5,41.88022,-87.63526
WL-011,4,12,false,14,16,2,41.88034,-87.64273
13156,4,12,false,19,16,-3,41.88042,-87.65554
13300,4,12,false,197,138,-59,41.88097,-87.61675
76,4,12,false,27,29,2,41.88098,-87.61675
13008,4,12,false,151,198,47,41.88105,-87.62408
90,4,12,false,33,20,-13,41.88107,-87.62409
TA1305000006,4,12,false,79,52,-27,41.88122,-87.6296
13056,4,12,false,23,18,-5,41.88168,-87.63951
198,4,12,false,6,10,4,41.88187,-87.6488
TA1307000120,4,12,false,49,36,-13,41.88188,-87.64879
13341,4,12,false,25,15,-10,41.88208,-87.63985
13036,4,12,false,65,48,-17,41.8821,-87.62513
TA1305000032,4,12,false,32,30,-2,41.88218,-87.64109
13006,4,12,false,27,12,-15,41.88268,-87.63252
13353,4,12,false,20,11,-9,41.88283,-87.6612
654,4,12,false,11,16,5,41.88307,-87.65698
13409,4,12,false,15,22,7,41.8831,-87.6511
KA1503000072,4,12,false,24,17,-7,41.88317,-87.63693
WL-012,4,12,false,17,27,10,41.88337,-87.6412
13053,4,12,false,50,60,10,41.88365,-87.64863
43,4,12,false,8,13,5,41.88396,-87.62455
13001,4,12,false,67,99,32,41.88397,-87.62459
18062,4,12,false,10,24,14,41.88412,-87.65427
81,4,12,false,5,12,7,41.88417,-87.6296
TA1306000010,4,12,false,57,54,-3,41.88419,-87.62961
TA1305000030,4,12,false,35,30,-5,41.88459,-87.63178
15535,4,12,false,25,19,-6,41.8846,-87.64455
TA1305000029,4,12,false,45,42,-3,41.88466,-87.62787
13263,4,12,false,49,43,-6,41.88467,-87.61952
44,4,12,false,14,6,-8,41.88468,-87.62782
TA1306000015,4,12,false,38,43,5,41.88549,-87.65232
13021,4,12,false,25,19,-6,41.88559,-87.64184
TA1307000111,4,12,false,66,38,-28,41.88582,-87.63548
KA1503000012,4,12,false,29,37,8,41.88599,-87.63089
52,4,12,false,15,11,-4,41.886,-87.62421
TA1305000011,4,12,false,71,60,-11,41.886,-87.62418
15534,4,12,false,22,23,1,41.88627,-87.61749
13197,4,12,false,11,10,-1,41.8866,-87.65816
TA1308000029,4,12,false,28,24,-4,41.88673,-87.62225
TA1307000131,4,12,false,51,42,-9,41.88688,-87.62606
KA1503000064,4,12,false,54,65,11,41.88697,-87.61281
TA1305000022,4,12,false,58,49,-9,41.88817,-87.63656
TA1306000003,4,12,false,25,27,2,41.88867,-87.64442
KA1503000043,4,12,false,35,50,15,41.88918,-87.63851
13050,4,12,false,26,39,13,41.88919,-87.62775
47,4,12,false,5,11,6,41.88921,-87.62775
13432,4,12,false,10,6,-4,41.88989,-87.67149
TA1307000151,4,12,false,46,29,-17,41.88993,-87.63427
212,4,12,false,13,9,-4,41.88995,-87.63427
636,4,12,false,12,19,7,41.88997,-87.63662
KA1503000044,4,12,false,21,21,0,41.89018,-87.6262
13427,4,12,false,23,37,14,41.89054,-87.62205
13430,4,12,false,58,60,2,41.89077,-87.63169
TA1306000013,4,12,false,62,44,-18,41.89083,-87.61852
RN-,4,12,false,33,29,-4,41.89102,-87.63546
13434,4,12,false,7,12,5,41.89108,-87.66663
TA1308000006,4,12,false,16,12,-4,41.89128,-87.67686
199,4,12,false,12,8,-4,41.89143,-87.62676
TA1307000117,4,12,false,78,69,-9,41.89144,-87.62675
13033,4,12,false,28,27,-1,41.8916,-87.64835
13194,4,12,false,17,20,3,41.8918,-87.65878
TA1305000003,4,12,false,43,65,22,41.89187,-87.62061
24,4,12,false,6,11,5,41.8919,-87.62063
35,4,12,false,19,15,-4,41.89227,-87.61206
13022,4,12,false,264,392,128,41.89227,-87.61205
TA1306000029,4,12,false,32,28,-4,41.89256,-87.61449
13265,4,12,false,18,34,16,41.89383,-87.64172
13045,4,12,false,29,48,19,41.89403,-87.62931
110,4,12,false,15,11,-4,41.89406,-87.6293
13016,4,12,false,74,56,-18,41.89431,-87.62277
211,4,12,false,4,17,13,41.89439,-87.62267
KA1503000041,4,12,false,39,34,-5,41.89452,-87.61798
142,4,12,false,14,4,-10,41.89453,-87.61806
13196,4,12,false,17,12,-5,41.89455,-87.65345
TA1307000062,4,12,false,21,16,-5,41.89466,-87.63839
TA1306000012,4,12,false,55,55,0,41.89475,-87.63438
53,4,12,false,10,13,3,41.89476,-87.63439
KP1705001026,4,12,false,41,34,-7,41.89483,-87.6323
637,4,12,false,12,18,6,41.89563,-87.67209
13132,4,12,false,18,20,2,41.89573,-87.67718
15530,4,12,false,38,42,4,41.89575,-87.62596
18003,4,12,false,34,17,-17,41.89575,-87.62011
13247,4,12,false,11,14,3,41.89597,-87.66775
TA1305000020,4,12,false,18,9,-9,41.89636,-87.65406
13289,4,12,false,8,17,9,41.89638,-87.661
13303,4,12,false,25,29,4,41.89672,-87.63088
13017,4,12,false,16,21,5,41.89676,-87.6357
13338,4,12,false,55,27,-28,41.89697,-87.62173
TA1307000061,4,12,false,22,25,3,41.89745,-87.62873
13034,4,12,false,43,38,-5,41.89754,-87.62352
TA1306000009,4,12,false,29,20,-9,41.89772,-87.64299
620,4,12,false,21,29,8,41.89817,-87.63754
15529,4,12,false,37,33,-4,41.89858,-87.62206
TA1307000128,4,12,false,38,42,4,41.89896,-87.6299
657,4,12,false,8,12,4,41.89918,-87.6722
TA1306000011,4,12,false,23,13,-10,41.89994,-87.63443
KA1504000116,4,12,false,12,5,-7,41.90023,-87.64299
13290,4,12,false,14,9,-5,41.90069,-87.66259
13042,4,12,false,148,169,21,41.90097,-87.62377
85,4,12,false,9,14,5,41.90098,-87.62375
TA1307000070,4,12,false,15,10,-5,41.90133,-87.67742
KA1504000133,4,12,false,53,61,8,41.90234,-87.62773
13241,4,12,false,13,6,-7,41.9029,-87.68731
176,4,12,false,13,15,2,41.90291,-87.63141
TA1307000039,4,12,false,44,49,5,41.90294,-87.63137
13256,4,12,false,9,14,5,41.90302,-87.69749
TA1305000034,4,12,false,13,11,-2,41.90313,-87.67391
KA1504000135,4,12,false,44,56,12,41.90319,-87.63439
13061,4,12,false,39,32,-7,41.90342,-87.66779
KA1504000079,4,12,false,28,21,-7,41.9035,-87.64334
TA1308000049,4,12,false,29,36,7,41.90672,-87.6349
KA1504000134,4,12,false,15,16,1,41.90687,-87.6262
13224,4,12,false,19,17,-2,41.90706,-87.66725
TA1307000143,4,12,false,5,12,7,41.90762,-87.63854
13221,4,12,false,24,25,1,41.90765,-87.67254
TA1309000024,4,12,false,28,43,15,41.908,-87.63152
TA1305000041,4,12,false,27,40,13,41.9094,-87.67769
331,4,12,false,35,44,9,41.90965,-87.64812
TA1305000037,4,12,false,18,6,-12,41.91018,-87.67003
TA1306000008,4,12,false,15,6,-9,41.9102,-87.6435
TA1308000005,4,12,false,11,10,-1,41.91042,-87.68238
13258,4,12,false,7,10,3,41.91043,-87.69718
13257,4,12,false,6,12,6,41.91054,-87.68956
13154,4,12,false,21,36,15,41.91054,-87.65312
13058,4,12,false,29,30,1,41.91059,-87.64942
TA1307000038,4,12,false,16,31,15,41.91138,-87.63868
LF-005,4,12,false,70,103,33,41.91172,-87.62681
13128,4,12,false,27,22,-5,41.91197,-87.63197
TA1308000050,4,12,false,59,59,0,41.91211,-87.6347
13243,4,12,false,16,17,1,41.91262,-87.6814
TA1306000032,4,12,false,21,21,0,41.9137,-87.65285
TA1307000166,4,12,false,21,16,-5,41.91386,-87.64877
15655,4,12,false,16,10,-6,41.91401,-87.70514
18017,4,12,false,15,8,-7,41.91416,-87.71676
18067,4,12,false,16,5,-11,41.9146,-87.66796
13068,4,12,false,17,16,-1,41.91554,-87.68703
13179,4,12,false,24,48,24,41.9157,-87.63461
141,4,12,false,6,11,5,41.91571,-87.63461
13133,4,12,false,26,19,-7,41.91598,-87.67733
TA1305000039,4,12,false,14,13,-1,41.9163,-87.66749
15650,4,12,false,10,4,-6,41.91711,-87.71023
15651,4,12,false,9,12,3,41.91752,-87.70181
TA1309000029,4,12,false,19,9,-10,41.9178,-87.68245
TA1309000006,4,12,false,12,9,-3,41.91809,-87.64375
TA1307000163,4,12,false,18,19,1,41.91821,-87.65696
13146,4,12,false,42,50,8,41.91831,-87.63629
13059,4,12,false,27,42,15,41.91845,-87.65222
13192,4,12,false,28,21,-7,41.91995,-87.64884
13288,4,12,false,14,8,-6,41.92008,-87.67788
TA1309000030,4,12,false,10,28,18,41.92077,-87.66372
13292,4,12,false,11,10,-1,41.92152,-87.70733
TA1309000033,4,12,false,30,25,-5,41.92158,-87.65381
13193,4,12,false,32,43,11,41.92182,-87.64412
13191,4,12,false,29,21,-8,41.92217,-87.63891
13084,4,12,false,17,16,-1,41.92268,-87.69715
LP-,4,12,false,61,55,-6,41.92396,-87.63584
KA1504000140,4,12,false,10,13,3,41.92409,-87.67646
TA1307000001,4,12,false,24,18,-6,41.92535,-87.66581
TA1306000026,4,12,false,27,20,-7,41.92558,-87.65842
TA1306000016,4,12,false,27,44,17,41.9256,-87.65371
TA1309000019,4,12,false,38,52,14,41.92586,-87.63897
TA1309000058,4,12,false,29,32,3,41.92591,-87.64927
177,4,12,false,5,16,11,41.92627,-87.63086
TA1308000001,4,12,false,92,109,17,41.92627,-87.63086
15646,4,12,false,3,17,14,41.92668,-87.6977
13124,4,12,false,31,18,-13,41.92675,-87.63444
TA1309000023,4,12,false,32,28,-4,41.9287,-87.65383
TA1307000113,4,12,false,13,11,-2,41.92878,-87.66391
13296,4,12,false,15,13,-2,41.92883,-87.66852
TA1309000061,4,12,false,33,21,-12,41.92915,-87.64909
TA1308000031,4,12,false,15,17,2,41.92946,-87.68417
TA1305000014,4,12,false,32,44,12,41.92956,-87.64313
13085,4,12,false,30,33,3,41.92958,-87.70789
TA1307000142,4,12,false,45,43,-2,41.93125,-87.64432
220,4,12,false,5,12,7,41.93125,-87.64431
13276,4,12,false,45,31,-14,41.93132,-87.63874
324,4,12,false,10,5,-5,41.93173,-87.64179
13271,4,12,false,10,7,-3,41.93192,-87.67784
TA1307000064,4,12,false,40,26,-14,41.93222,-87.65864
TA1306000014,4,12,false,32,24,-8,41.93242,-87.65271
TA1309000039,4,12,false,60,43,-17,41.93258,-87.63642
329,4,12,false,11,8,-3,41.93258,-87.63642
13294,4,12,false,18,6,-12,41.9326,-87.66595
TA1309000036,4,12,false,16,20,4,41.93313,-87.64776
15644,4,12,false,10,4,-6,41.93534,-87.71687
TA1307000006,4,12,false,14,13,-1,41.93571,-87.6636
13269,4,12,false,9,13,4,41.93609,-87.66983
TA1307000052,4,12,false,19,19,0,41.93628,-87.65266
TA1307000136,4,12,false,33,38,5,41.9365,-87.64755
TA1307000041,4,12,false,48,27,-21,41.93669,-87.63683
13137,4,12,false,65,41,-24,41.9376,-87.6441
KA17018068,4,12,false,12,7,-5,41.93935,-87.68327
TA1309000042,4,12,false,11,17,6,41.93937,-87.66836
13229,4,12,false,15,18,3,41.93946,-87.66376
TA1308000019,4,12,false,27,21,-6,41.93973,-87.65886
13277,4,12,false,27,29,2,41.9401,-87.64546
TA1307000134,4,12,false,36,52,16,41.94016,-87.65303
13143,4,12,false,12,4,-8,41.94059,-87.67853
TA1309000049,4,12,false,53,32,-21,41.94077,-87.63919
TA1307000138,4,12,false,15,11,-4,41.94334,-87.67094
13144,4,12,false,14,7,-7,41.9434,-87.67964
TA1309000025,4,12,false,24,31,7,41.94368,-87.64894
13071,4,12,false,35,26,-9,41.94373,-87.66401
632,4,12,false,33,36,3,41.94453,-87.6547
13278,4,12,false,32,32,0,41.94553,-87.64644
13235,4,12,false,31,37,6,41.94814,-87.66396
13253,4,12,false,7,12,5,41.9488,-87.67527
13325,4,12,false,32,24,-8,41.94907,-87.64863
TA1307000126,4,12,false,36,80,44,41.94936,-87.65451
TA1307000150,4,12,false,34,28,-6,41.94945,-87.64646
TA1307000127,4,12,false,34,55,21,41.9508,-87.65918
13323,4,12,false,30,11,-19,41.95282,-87.65
TA1309000043,4,12,false,16,14,-2,41.95417,-87.66434
13063,4,12,false,29,18,-11,41.95424,-87.65441
TA1308000022,4,12,false,20,18,-2,41.95438,-87.64805
TA1309000026,4,12,false,14,10,-4,41.95601,-87.6802
13379,4,12,false,28,13,-15,41.95786,-87.6495
TA1309000027,4,12,false,14,13,-1,41.9585,-87.65499
13389,4,12,false,26,14,-12,41.961,-87.64958
15622,4,12,false,11,5,-6,41.96108,-87.69544
KA1503000022,4,12,false,10,4,-6,41.96158,-87.66609
TA1307000107,4,12,false,27,28,1,41.96164,-87.65464
TA1308000012,4,12,false,48,58,10,41.96398,-87.63818
13074,4,12,false,21,15,-6,41.96521,-87.6582
639,4,12,false,17,13,-4,41.96584,-87.64538
TA1307000140,4,12,false,15,11,-4,41.96643,-87.68865
TA1309000014,4,12,false,19,10,-9,41.96709,-87.66744
TA1307000119,4,12,false,16,14,-2,41.96796,-87.65
TA1308000021,4,12,false,14,10,-4,41.96883,-87.65765
TA1309000066,4,12,false,28,17,-11,41.9691,-87.67423
KA1504000171,4,12,false,13,6,-7,41.97161,-87.65016
TA1309000035,4,12,false,22,22,0,41.97335,-87.66785
13108,4,12,false,14,20,6,41.97379,-87.65971
KA1504000160,4,12,false,11,5,-6,41.97564,-87.70143
KA1504000146,4,12,false,23,29,6,41.978,-87.66805
13109,4,12,false,18,14,-4,41.97835,-87.65976
KA1504000151,4,12,false,17,20,3,41.98359,-87.66916
KA1504000152,4,12,false,41,34,-7,41.98403,-87.65231
15578,4,12,false,13,8,-5,41.98405,-87.66027
15575,4,12,false,16,10,-6,41.98975,-87.66014
15571,4,12,false,21,16,-5,41.99478,-87.66028
RP-009,4,12,false,22,9,-13,42.00107,-87.66122
660,4,12,false,10,8,-2,42.00458,-87.66143
KA1504000175,4,12,false,2,13,11,42.00797,-87.66549
523,4,12,false,10,3,-7,42.02089,-87.66505
596,4,12,false,19,17,-2,42.04822,-87.68348
E008,4,12,false,19,23,4,42.05049,-87.67782
604,4,12,false,21,19,-2,42.05824,-87.67744
E007,4,12,false,11,6,-5,42.06431,-87.68615
KA1503000029,4,12,true,11,1,-10,41.77364,-87.56747
KA1503000014,4,12,true,87,68,-19,41.7851,-87.60108
TA1309000011,4,12,true,20,38,18,41.78873,-87.60131
423,4,12,true,15,24,9,41.79148,-87.59988
KA1503000071,4,12,true,53,71,18,41.79148,-87.59988
KA1503000074,4,12,true,17,8,-9,41.79174,-87.58395
TA1309000063,4,12,true,17,17,0,41.79325,-87.5878
420,4,12,true,9,13,4,41.79429,-87.60145
KA1504000076,4,12,true,57,80,23,41.7943,-87.60145
247,4,12,true,16,6,-10,41.79522,-87.58077
TA1308000009,4,12,true,32,17,-15,41.79522,-87.58075
TA1307000164,4,12,true,33,21,-12,41.79527,-87.59647
KA1503000052,4,12,true,18,14,-4,41.79935,-87.60097
KA1503000059,4,12,true,29,17,-12,41.79952,-87.58643
TA1309000037,4,12,true,36,40,4,41.79957,-87.59474
KA1503000007,4,12,true,31,15,-16,41.80242,-87.58689
13398,4,12,true,7,10,3,41.80256,-87.59035
322,4,12,true,17,8,-9,41.80321,-87.59849
TA1308000045,4,12,true,16,8,-8,41.83062,-87.64129
TA1307000129,4,12,true,31,32,1,41.83104,-87.62683
13345,4,12,true,10,10,0,41.83138,-87.61803
15445,4,12,true,12,24,12,41.83453,-87.63183
13216,4,12,true,85,78,-7,41.83473,-87.62581
148,4,12,true,7,11,4,41.83474,-87.62581
149,4,12,true,3,10,7,41.83486,-87.61791
13217,4,12,true,32,32,0,41.83488,-87.61792
13215,4,12,true,14,9,-5,41.83634,-87.6135
TA1308000046,4,12,true,11,7,-4,41.83779,-87.65115
TA1309000055,4,12,true,32,25,-7,41.8382,-87.64514
KA1503000038,4,12,true,14,19,5,41.83845,-87.6354
TA1307000048,4,12,true,17,14,-3,41.83855,-87.60821
TA1308000036,4,12,true,20,20,0,41.83883,-87.62186
237,4,12,true,12,5,-7,41.84204,-87.61697
TA1307000139,4,12,true,49,40,-9,41.84205,-87.61698
TA1307000153,4,12,true,11,7,-4,41.84358,-87.64538
TA1307000005,4,12,true,14,13,-1,41.84569,-87.6225
TA1305000001,4,12,true,14,10,-4,41.85262,-87.6265
13075,4,12,true,18,16,-2,41.8531,-87.63192
13091,4,12,true,10,11,1,41.85409,-87.68585
15546,4,12,true,10,10,0,41.85416,-87.61916
13089,4,12,true,10,8,-2,41.85497,-87.67567
13331,4,12,true,11,9,-2,41.85515,-87.65414
15545,4,12,true,44,37,-7,41.85627,-87.61334
4,4,12,true,11,12,1,41.85627,-87.61334
SL-013,4,12,true,12,12,0,41.85659,-87.62755
13135,4,12,true,22,32,10,41.85753,-87.66157
338,4,12,true,12,6,-6,41.85758,-87.61956
13102,4,12,true,26,33,7,41.85762,-87.61942
13150,4,12,true,34,40,6,41.85783,-87.62455
273,4,12,true,3,10,7,41.85783,-87.62455
13099,4,12,true,11,6,-5,41.85784,-87.64627
TA1307000159,4,12,true,16,20,4,41.8579,-87.6687
TA1307000044,4,12,true,5,20,15,41.85794,-87.64083
13163,4,12,true,9,23,14,41.85808,-87.65108
13164,4,12,true,23,26,3,41.85818,-87.65648
SL-012,4,12,true,35,36,1,41.86038,-87.62581
72,4,12,true,9,10,1,41.86039,-87.62581
TA1306000002,4,12,true,28,26,-2,41.86238,-87.65108
TA1307000124,4,12,true,80,52,-28,41.86411,-87.62372
168,4,12,true,14,6,-8,41.86415,-87.62372
TA1309000001,4,12,true,22,31,9,41.86488,-87.64708
13354,4,12,true,8,11,3,41.86524,-87.66651
13029,4,12,true,12,8,-4,41.86531,-87.6179
13431,4,12,true,18,17,-1,41.8661,-87.60728
WL-008,4,12,true,30,35,5,41.86712,-87.64108
57,4,12,true,7,11,4,41.86712,-87.64107
TA1305000002,4,12,true,84,69,-15,41.86721,-87.62597
59,4,12,true,31,19,-12,41.86721,-87.62597
3,4,12,true,10,4,-6,41.86723,-87.61536
15544,4,12,true,29,36,7,41.86723,-87.61536
TA1305000017,4,12,true,21,19,-2,41.86734,-87.64863
KA1706005007,4,12,true,17,12,-5,41.86749,-87.63219
SL-005,4,12,true,62,47,-15,41.8679,-87.62304
255,4,12,true,15,23,8,41.86791,-87.62304
644,4,12,true,21,15,-6,41.86859,-87.68625
19,4,12,true,13,8,-5,41.86892,-87.65913
13139,4,12,true,70,35,-35,41.86893,-87.65913
13285,4,12,true,38,55,17,41.86928,-87.67372
22,4,12,true,14,7,-7,41.86947,-87.65548
13160,4,12,true,45,39,-6,41.86947,-87.65548
15550,4,12,true,26,36,10,41.87024,-87.63947
TA1309000010,4,12,true,51,53,2,41.87074,-87.62574
SL-009,4,12,true,12,18,6,41.87081,-87.63121
342,4,12,true,16,25,9,41.87127,-87.6737
TA1309000064,4,12,true,87,75,-12,41.87127,-87.67369
15542,4,12,true,4,13,9,41.87146,-87.64095
261,4,12,true,9,12,3,41.87151,-87.6699
TA1307000130,4,12,true,60,59,-1,41.87178,-87.65103
241,4,12,true,7,18,11,41.8718,-87.65102
108,4,12,true,11,10,-1,41.87183,-87.64664
TA1307000121,4,12,true,63,76,13,41.87184,-87.64664
41,4,12,true,11,21,10,41.87209,-87.62957
SL-008,4,12,true,64,73,9,41.87209,-87.62956
13332,4,12,true,99,84,-15,41.87219,-87.6615
SL-011,4,12,true,41,42,1,41.87256,-87.63356
623,4,12,true,46,32,-14,41.87272,-87.62399
KA1504000104,4,12,true,60,60,0,41.87296,-87.66912
383,4,12,true,8,10,2,41.87297,-87.66912
320,4,12,true,20,14,-6,41.87327,-87.66402
5,4,12,true,3,12,9,41.87403,-87.6277
SL-007,4,12,true,22,18,-4,41.87404,-87.6277
13326,4,12,true,27,15,-12,41.87425,-87.63958
321,4,12,true,8,17,9,41.87427,-87.63257
32,4,12,true,11,1,-10,41.87464,-87.65703
TA1306000025,4,12,true,28,27,-1,41.87464,-87.65703
15668,4,12,true,12,13,1,41.87471,-87.68642
13028,4,12,true,41,51,10,41.87475,-87.64981
SL-010,4,12,true,24,20,-4,41.87501,-87.63309
13037,4,12,true,33,13,-20,41.87588,-87.64078
TA1305000009,4,12,true,11,21,10,41.87593,-87.63068
TA1305000010,4,12,true,25,26,1,41.87623,-87.62444
624,4,12,true,42,24,-18,41.87626,-87.62923
TA1305000035,4,12,true,61,67,6,41.87716,-87.62787
13138,4,12,true,35,35,0,41.87723,-87.63941
15539,4,12,true,57,52,-5,41.87763,-87.64405
13158,4,12,true,66,92,26,41.87764,-87.64957
134,4,12,true,12,25,13,41.87764,-87.64954
21,4,12,true,17,23,6,41.87773,-87.6548
13157,4,12,true,50,67,17,41.87773,-87.6548
TA1305000025,4,12,true,72,63,-9,41.87773,-87.63528
36,4,12,true,9,14,5,41.87776,-87.63525
TA1309000002,4,12,true,21,35,14,41.87784,-87.62408
13206,4,12,true,16,27,11,41.87794,-87.66201
TA1309000004,4,12,true,60,38,-22,41.87811,-87.63184
107,4,12,true,18,11,-7,41.87822,-87.644
638,4,12,true,54,58,4,41.87827,-87.64078
TA1305000005,4,12,true,63,55,-8,41.87924,-87.62975
13011,4,12,true,51,77,26,41.87931,-87.63993
TA1309000008,4,12,true,48,56,8,41.87933,-87.6355
192,4,12,true,11,4,-7,41.87935,-87.63997
KA1503000034,4,12,true,62,28,-34,41.87938,-87.63197
KA1503000015,4,12,true,37,29,-8,41.87948,-87.6257
15667,4,12,true,10,5,-5,41.8798,-87.68609
287,4,12,true,9,13,4,41.88017,-87.63527
TA1309000007,4,12,true,103,67,-36,41.88022,-87.63526
WL-011,4,12,true,31,34,3,41.88034,-87.64273
80,4,12,true,11,6,-5,41.88042,-87.65556
13156,4,12,true,49,37,-12,41.88042,-87.65554
13300,4,12,true,47,48,1,41.88097,-87.61675
76,4,12,true,11,8,-3,41.88098,-87.61675
13008,4,12,true,38,52,14,41.88105,-87.62408
49,4,12,true,22,17,-5,41.88116,-87.62963
TA1305000006,4,12,true,92,87,-5,41.88122,-87.6296
13134,4,12,true,13,13,0,41.88138,-87.67493
13056,4,12,true,36,32,-4,41.88168,-87.63951
198,4,12,true,11,21,10,41.88187,-87.6488
TA1307000120,4,12,true,85,89,4,41.88188,-87.64879
13341,4,12,true,36,52,16,41.88208,-87.63985
197,4,12,true,10,8,-2,41.88208,-87.62513
13036,4,12,true,34,43,9,41.8821,-87.62513
77,4,12,true,17,13,-4,41.88214,-87.64108
TA1305000032,4,12,true,74,79,5,41.88218,-87.64109
98,4,12,true,14,16,2,41.88266,-87.63251
13006,4,12,true,89,85,-4,41.88268,-87.63252
13353,4,12,true,33,29,-4,41.88283,-87.6612
346,4,12,true,12,9,-3,41.88284,-87.6612
654,4,12,true,26,33,7,41.88307,-87.65698
13409,4,12,true,36,54,18,41.8831,-87.6511
KA1503000072,4,12,true,42,37,-5,41.88317,-87.63693
91,4,12,true,5,15,10,41.88336,-87.64122
WL-012,4,12,true,45,63,18,41.88337,-87.6412
112,4,12,true,12,14,2,41.88362,-87.6486
13053,4,12,true,73,89,16,41.88365,-87.64863
43,4,12,true,14,27,13,41.88396,-87.62455
13001,4,12,true,70,63,-7,41.88397,-87.62459
13155,4,12,true,14,31,17,41.88407,-87.65689
18062,4,12,true,31,46,15,41.88412,-87.65427
81,4,12,true,21,25,4,41.88417,-87.6296
TA1306000010,4,12,true,85,115,30,41.88419,-87.62961
TA1305000030,4,12,true,94,78,-16,41.88459,-87.63178
96,4,12,true,11,5,-6,41.8846,-87.64455
15535,4,12,true,32,57,25,41.8846,-87.64455
51,4,12,true,8,16,8,41.88462,-87.63176
TA1305000029,4,12,true,54,65,11,41.88466,-87.62787
195,4,12,true,27,24,-3,41.88466,-87.61952
13263,4,12,true,67,75,8,41.88467,-87.61952
TA1306000015,4,12,true,71,73,2,41.88549,-87.65232
71,4,12,true,13,23,10,41.8855,-87.65233
66,4,12,true,14,9,-5,41.88557,-87.64186
13021,4,12,true,74,83,9,41.88559,-87.64184
TA1307000111,4,12,true,59,72,13,41.88582,-87.63548
164,4,12,true,12,5,-7,41.88583,-87.63547
KA17018054,4,12,true,20,17,-3,41.88595,-87.67701
38,4,12,true,11,12,1,41.88599,-87.63089
KA1503000012,4,12,true,45,50,5,41.88599,-87.63089
52,4,12,true,13,18,5,41.886,-87.62421
TA1305000011,4,12,true,70,69,-1,41.886,-87.62418
7,4,12,true,11,7,-4,41.88627,-87.61751
15534,4,12,true,44,29,-15,41.88627,-87.61749
13197,4,12,true,18,16,-2,41.8866,-87.65816
TA1308000029,4,12,true,23,24,1,41.88673,-87.62225
TA1307000131,4,12,true,43,33,-10,41.88688,-87.62606
KA1503000064,4,12,true,29,24,-5,41.88697,-87.61281
100,4,12,true,12,10,-2,41.88814,-87.63657
TA1305000022,4,12,true,78,78,0,41.88817,-87.63656
56,4,12,true,21,27,6,41.88866,-87.64442
TA1306000003,4,12,true,73,87,14,41.88867,-87.64442
133,4,12,true,26,33,7,41.88918,-87.63851
KA1503000043,4,12,true,122,135,13,41.88918,-87.63851
13050,4,12,true,44,60,16,41.88919,-87.62775
47,4,12,true,7,16,9,41.88921,-87.62775
13432,4,12,true,12,14,2,41.88989,-87.67149
TA1307000151,4,12,true,88,79,-9,41.88993,-87.63427
212,4,12,true,12,21,9,41.88995,-87.63427
636,4,12,true,44,51,7,41.88997,-87.63662
KA1503000044,4,12,true,25,35,10,41.89018,-87.6262
196,4,12,true,10,5,-5,41.89053,-87.62205
13427,4,12,true,23,38,15,41.89054,-87.62205
26,4,12,true,17,8,-9,41.89057,-87.61798
13430,4,12,true,62,89,27,41.89077,-87.63169
181,4,12,true,16,14,-2,41.89077,-87.63168
TA1306000013,4,12,true,45,79,34,41.89083,-87.61852
RN-,4,12,true,60,46,-14,41.89102,-87.63546
13434,4,12,true,18,16,-2,41.89108,-87.66663
TA1308000006,4,12,true,19,14,-5,41.89128,-87.67686
199,4,12,true,26,27,1,41.89143,-87.62676
TA1307000117,4,12,true,88,106,18,41.89144,-87.62675
13033,4,12,true,52,71,19,41.8916,-87.64835
84,4,12,true,19,20,1,41.89161,-87.64833
13194,4,12,true,51,45,-6,41.8918,-87.65878
TA1305000003,4,12,true,58,68,10,41.89187,-87.62061
24,4,12,true,14,15,1,41.8919,-87.62063
643,4,12,true,13,10,-3,41.89203,-87.68939
13022,4,12,true,79,74,-5,41.89227,-87.61205
99,4,12,true,7,15,8,41.89255,-87.61449
TA1306000029,4,12,true,36,46,10,41.89256,-87.61449
13265,4,12,true,77,62,-15,41.89383,-87.64172
74,4,12,true,14,21,7,41.89384,-87.64173
13045,4,12,true,130,114,-16,41.89403,-87.62931
110,4,12,true,34,27,-7,41.89406,-87.6293
13016,4,12,true,154,128,-26,41.89431,-87.62277
211,4,12,true,29,26,-3,41.89439,-87.62267
KA1503000041,4,12,true,87,77,-10,41.89452,-87.61798
142,4,12,true,15,17,2,41.89453,-87.61806
13196,4,12,true,31,28,-3,41.89455,-87.65345
TA1307000062,4,12,true,70,49,-21,41.89466,-87.63839
111,4,12,true,14,14,0,41.89466,-87.63837
TA1306000012,4,12,true,113,115,2,41.89475,-87.63438
53,4,12,true,22,15,-7,41.89476,-87.63439
627,4,12,true,15,9,-6,41.8948,-87.63231
KP1705001026,4,12,true,48,52,4,41.89483,-87.6323
16920,4,12,true,20,27,7,41.89495,-87.76491
18058,4,12,true,11,10,-1,41.8955,-87.68201
637,4,12,true,26,19,-7,41.89563,-87.67209
128,4,12,true,9,13,4,41.89571,-87.67716
13132,4,12,true,51,43,-8,41.89573,-87.67718
161,4,12,true,14,16,2,41.89574,-87.62599
15530,4,12,true,52,55,3,41.89575,-87.62596
18003,4,12,true,53,48,-5,41.89575,-87.62011
13247,4,12,true,33,30,-3,41.89597,-87.66775
350,4,12,true,10,4,-6,41.89597,-87.66774
TA1305000020,4,12,true,42,34,-8,41.89636,-87.65406
13289,4,12,true,43,28,-15,41.89638,-87.661
337,4,12,true,11,12,1,41.89659,-87.63096
13303,4,12,true,33,36,3,41.89672,-87.63088
13017,4,12,true,50,55,5,41.89676,-87.6357
31,4,12,true,7,10,3,41.89677,-87.63572
13338,4,12,true,56,57,1,41.89697,-87.62173
173,4,12,true,15,12,-3,41.89704,-87.62173
TA1307000061,4,12,true,33,37,4,41.89745,-87.62873
106,4,12,true,7,10,3,41.89746,-87.62874
13034,4,12,true,26,42,16,41.89754,-87.62352
48,4,12,true,12,10,-2,41.89772,-87.64302
TA1306000009,4,12,true,60,61,1,41.89772,-87.64299
620,4,12,true,49,60,11,41.89817,-87.63754
KA1504000103,4,12,true,28,13,-15,41.89842,-87.68659
145,4,12,true,21,12,-9,41.89856,-87.62211
15529,4,12,true,54,57,3,41.89858,-87.62206
140,4,12,true,23,22,-1,41.89895,-87.6299
TA1307000128,4,12,true,67,71,4,41.89896,-87.6299
657,4,12,true,23,29,6,41.89918,-87.6722
KA1504000117,4,12,true,5,10,5,41.89936,-87.64848
13248,4,12,true,42,25,-17,41.89964,-87.66788
46,4,12,true,5,11,6,41.89994,-87.63444
TA1306000011,4,12,true,29,20,-9,41.89994,-87.63443
KA1504000116,4,12,true,21,26,5,41.90023,-87.64299
17660,4,12,true,23,20,-3,41.90036,-87.69671
13290,4,12,true,31,24,-7,41.90069,-87.66259
13042,4,12,true,66,66,0,41.90097,-87.62377
85,4,12,true,22,21,-1,41.90098,-87.62375
183,4,12,true,10,3,-7,41.90133,-87.67744
TA1307000070,4,12,true,21,15,-6,41.90133,-87.67742
KA1504000133,4,12,true,54,55,1,41.90234,-87.62773
172,4,12,true,13,14,1,41.90236,-87.62774
13241,4,12,true,26,14,-12,41.9029,-87.68731
176,4,12,true,28,27,-1,41.90291,-87.63141
TA1306000006,4,12,true,17,18,1,41.90292,-87.63772
TA1307000039,4,12,true,99,118,19,41.90294,-87.63137
658,4,12,true,21,29,8,41.903,-87.6838
13256,4,12,true,14,8,-6,41.90302,-87.69749
TA1305000034,4,12,true,30,34,4,41.90313,-87.67391
182,4,12,true,16,18,2,41.90317,-87.63442
KA1504000135,4,12,true,75,76,1,41.90319,-87.63439
13136,4,12,true,31,32,1,41.90326,-87.67845
130,4,12,true,6,14,8,41.90327,-87.67846
210,4,12,true,8,15,7,41.90342,-87.66781
13061,4,12,true,67,65,-2,41.90342,-87.66779
KA1504000079,4,12,true,34,41,7,41.9035,-87.64334
359,4,12,true,8,10,2,41.90458,-87.6497
TA1307000115,4,12,true,24,18,-6,41.9046,-87.64056
291,4,12,true,11,12,1,41.90672,-87.63494
TA1308000049,4,12,true,72,53,-19,41.90672,-87.6349
KA1504000134,4,12,true,35,33,-2,41.90687,-87.6262
180,4,12,true,12,8,-4,41.90687,-87.62618
13224,4,12,true,29,26,-3,41.90706,-87.66725
18069,4,12,true,10,9,-1,41.90722,-87.65563
TA1307000143,4,12,true,9,20,11,41.90762,-87.63854
13221,4,12,true,28,56,28,41.90765,-87.67254
13245,4,12,true,20,6,-14,41.90777,-87.68586
301,4,12,true,15,12,-3,41.90796,-87.63203
TA1309000024,4,12,true,70,58,-12,41.908,-87.63152
69,4,12,true,20,16,-4,41.90939,-87.6777
TA1305000041,4,12,true,59,46,-13,41.9094,-87.67769
331,4,12,true,68,64,-4,41.90965,-87.64812
TA1305000037,4,12,true,21,29,8,41.91018,-87.67003
TA1306000008,4,12,true,17,24,7,41.9102,-87.6435
16,4,12,true,10,3,-7,41.91035,-87.67008
213,4,12,true,10,8,-2,41.91037,-87.68237
TA1308000005,4,12,true,20,25,5,41.91042,-87.68238
13258,4,12,true,20,12,-8,41.91043,-87.69718
13257,4,12,true,17,13,-4,41.91054,-87.68956
13154,4,12,true,69,56,-13,41.91054,-87.65312
20,4,12,true,11,19,8,41.91055,-87.65313
13058,4,12,true,61,52,-9,41.91059,-87.64942
60,4,12,true,12,7,-5,41.91059,-87.64942
TA1307000038,4,12,true,31,41,10,41.91138,-87.63868
268,4,12,true,18,9,-9,41.91172,-87.62681
LF-005,4,12,true,62,59,-3,41.91172,-87.62681
13128,4,12,true,30,28,-2,41.91197,-87.63197
289,4,12,true,21,33,12,41.91209,-87.63472
TA1308000050,4,12,true,98,107,9,41.91211,-87.6347
158,4,12,true,14,15,1,41.91262,-87.6814
13243,4,12,true,32,35,3,41.91262,-87.6814
TA1306000032,4,12,true,65,43,-22,41.9137,-87.65285
93,4,12,true,11,10,-1,41.91371,-87.65285
TA1307000166,4,12,true,40,53,13,41.91386,-87.64877
15655,4,12,true,15,9,-6,41.91401,-87.70514
18067,4,12,true,29,27,-2,41.9146,-87.66796
TA1306000007,4,12,true,18,16,-2,41.91469,-87.64333
13068,4,12,true,24,41,17,41.91554,-87.68703
13179,4,12,true,73,49,-24,41.9157,-87.63461
141,4,12,true,14,10,-4,41.91571,-87.63461
13133,4,12,true,29,25,-4,41.91598,-87.67733
TA1305000039,4,12,true,23,15,-8,41.9163,-87.66749
15651,4,12,true,13,12,-1,41.91752,-87.70181
13266,4,12,true,10,15,5,41.91774,-87.69142
TA1309000029,4,12,true,20,12,-8,41.9178,-87.68245
288,4,12,true,5,10,5,41.91809,-87.64375
TA1309000006,4,12,true,20,25,5,41.91809,-87.64375
223,4,12,true,10,5,-5,41.91821,-87.65698
TA1307000163,4,12,true,42,39,-3,41.91821,-87.65696
94,4,12,true,14,12,-2,41.91831,-87.6363
13146,4,12,true,71,68,-3,41.91831,-87.63629
13059,4,12,true,60,66,6,41.91845,-87.65222
113,4,12,true,15,13,-2,41.91846,-87.65222
13259,4,12,true,11,8,-3,41.91852,-87.69744
225,4,12,true,16,10,-6,41.91995,-87.64884
13192,4,12,true,52,68,16,41.91995,-87.64884
13288,4,12,true,23,20,-3,41.92008,-87.67788
TA1309000030,4,12,true,29,29,0,41.92077,-87.66372
13292,4,12,true,9,10,1,41.92152,-87.70733
TA1309000033,4,12,true,48,58,10,41.92158,-87.65381
13193,4,12,true,67,72,5,41.92182,-87.64412
144,4,12,true,16,14,-2,41.92182,-87.64411
13191,4,12,true,55,49,-6,41.92217,-87.63891
327,4,12,true,19,15,-4,41.92225,-87.65783
13084,4,12,true,25,25,0,41.92268,-87.69715
LP-,4,12,true,37,31,-6,41.92396,-87.63584
673,4,12,true,7,10,3,41.92398,-87.63585
KA1504000140,4,12,true,8,13,5,41.92409,-87.67646
15648,4,12,true,10,13,3,41.92464,-87.68931
TA1307000001,4,12,true,57,44,-13,41.92535,-87.66581
188,4,12,true,11,10,-1,41.92536,-87.66581
TA1306000026,4,12,true,84,65,-19,41.92558,-87.65842
87,4,12,true,15,14,-1,41.92559,-87.65843
TA1306000016,4,12,true,77,71,-6,41.9256,-87.65371
67,4,12,true,8,15,7,41.9256,-87.65371
313,4,12,true,13,18,5,41.9257,-87.64246
TA1309000019,4,12,true,64,70,6,41.92586,-87.63897
TA1309000058,4,12,true,74,92,18,41.92591,-87.64927
127,4,12,true,13,16,3,41.92592,-87.64927
177,4,12,true,23,16,-7,41.92627,-87.63086
TA1308000001,4,12,true,70,82,12,41.92627,-87.63086
15646,4,12,true,4,10,6,41.92668,-87.6977
13124,4,12,true,18,20,2,41.92675,-87.63444
TA1309000023,4,12,true,30,33,3,41.9287,-87.65383
TA1307000113,4,12,true,41,37,-4,41.92878,-87.66391
13296,4,12,true,11,23,12,41.92883,-87.66852
TA1309000059,4,12,true,33,25,-8,41.92889,-87.65898
343,4,12,true,10,5,-5,41.92889,-87.65898
349,4,12,true,14,14,0,41.92915,-87.6491
TA1309000061,4,12,true,93,55,-38,41.92915,-87.64909
TA1308000031,4,12,true,13,15,2,41.92946,-87.68417
TA1305000014,4,12,true,80,74,-6,41.92956,-87.64313
340,4,12,true,27,24,-3,41.92956,-87.64313
260,4,12,true,11,4,-7,41.92958,-87.70791
13085,4,12,true,19,19,0,41.92958,-87.70789
TA1307000142,4,12,true,108,108,0,41.93125,-87.64432
220,4,12,true,18,19,1,41.93125,-87.64431
13276,4,12,true,35,43,8,41.93132,-87.63874
324,4,12,true,11,15,4,41.93173,-87.64179
13271,4,12,true,17,18,1,41.93192,-87.67784
152,4,12,true,14,13,-1,41.93221,-87.65864
TA1307000064,4,12,true,45,46,1,41.93222,-87.65864
TA1306000014,4,12,true,74,57,-17,41.93242,-87.65271
13,4,12,true,17,13,-4,41.93242,-87.65271
TA1309000039,4,12,true,59,46,-13,41.93258,-87.63642
329,4,12,true,7,12,5,41.93258,-87.63642
13294,4,12,true,26,18,-8,41.9326,-87.66595
TA1309000036,4,12,true,47,49,2,41.93313,-87.64776
TA1307000006,4,12,true,51,33,-18,41.93571,-87.6636
13268,4,12,true,21,16,-5,41.93588,-87.67843
13269,4,12,true,15,19,4,41.93609,-87.66983
115,4,12,true,12,19,7,41.93628,-87.65266
TA1307000052,4,12,true,56,67,11,41.93628,-87.65266
156,4,12,true,19,23,4,41.9365,-87.64756
TA1307000136,4,12,true,91,87,-4,41.9365,-87.64755
TA1307000041,4,12,true,48,53,5,41.93669,-87.63683
157,4,12,true,9,16,7,41.9367,-87.63683
13137,4,12,true,112,99,-13,41.9376,-87.6441
300,4,12,true,18,15,-3,41.93761,-87.6441
15642,4,12,true,9,13,4,41.93843,-87.69801
154,4,12,true,8,14,6,41.93912,-87.66384
KA17018068,4,12,true,27,11,-16,41.93935,-87.68327
TA1309000042,4,12,true,33,44,11,41.93937,-87.66836
131,4,12,true,14,8,-6,41.93937,-87.66835
13229,4,12,true,28,36,8,41.93946,-87.66376
226,4,12,true,11,16,5,41.93972,-87.65886
TA1308000019,4,12,true,38,26,-12,41.93973,-87.65886
296,4,12,true,14,12,-2,41.9401,-87.64546
13277,4,12,true,59,69,10,41.9401,-87.64546
TA1307000134,4,12,true,65,77,12,41.94016,-87.65303
117,4,12,true,17,23,6,41.94016,-87.65302
13143,4,12,true,10,4,-6,41.94059,-87.67853
334,4,12,true,15,10,-5,41.94076,-87.63919
TA1309000049,4,12,true,46,44,-2,41.94077,-87.63919
15634,4,12,true,11,6,-5,41.94304,-87.68729
TA1307000138,4,12,true,34,29,-5,41.94334,-87.67094
230,4,12,true,7,12,5,41.94335,-87.67093
13144,4,12,true,14,28,14,41.9434,-87.67964
299,4,12,true,13,12,-1,41.94368,-87.64894
TA1309000025,4,12,true,52,67,15,41.94368,-87.64894
229,4,12,true,17,17,0,41.94372,-87.66401
13071,4,12,true,66,55,-11,41.94373,-87.66401
632,4,12,true,46,56,10,41.94453,-87.6547
303,4,12,true,18,16,-2,41.94522,-87.64702
15631,4,12,true,7,10,3,41.94524,-87.70665
13278,4,12,true,65,63,-2,41.94553,-87.64644
15632,4,12,true,10,10,0,41.94664,-87.69463
KA1504000143,4,12,true,10,7,-3,41.94664,-87.68337
227,4,12,true,10,17,7,41.94813,-87.66397
13235,4,12,true,56,60,4,41.94814,-87.66396
304,4,12,true,23,29,6,41.94878,-87.64922
13253,4,12,true,14,14,0,41.9488,-87.67527
13325,4,12,true,71,66,-5,41.94907,-87.64863
114,4,12,true,10,9,-1,41.94935,-87.65451
TA1307000126,4,12,true,43,67,24,41.94936,-87.65451
232,4,12,true,19,11,-8,41.94943,-87.64645
TA1307000150,4,12,true,74,60,-14,41.94945,-87.64646
13319,4,12,true,20,27,7,41.95069,-87.6687
TA1307000127,4,12,true,59,48,-11,41.9508,-87.65918
165,4,12,true,12,9,-3,41.95081,-87.65918
13323,4,12,true,53,36,-17,41.95282,-87.65
256,4,12,true,10,6,-4,41.95282,-87.65
TA1309000043,4,12,true,35,32,-3,41.95417,-87.66434
13063,4,12,true,59,29,-30,41.95424,-87.65441
240,4,12,true,9,10,1,41.95424,-87.65441
254,4,12,true,14,15,1,41.95438,-87.64806
TA1308000022,4,12,true,54,47,-7,41.95438,-87.64805
TA1307000149,4,12,true,11,14,3,41.95467,-87.67392
TA1309000026,4,12,true,12,15,3,41.95601,-87.6802
13249,4,12,true,10,6,-4,41.95606,-87.66885
312,4,12,true,16,8,-8,41.95637,-87.6563
TA1308000047,4,12,true,10,13,3,41.95709,-87.6642
13379,4,12,true,54,41,-13,41.95786,-87.6495
306,4,12,true,14,13,-1,41.9585,-87.655
TA1309000027,4,12,true,33,42,9,41.9585,-87.65499
13389,4,12,true,50,49,-1,41.961,-87.64958
245,4,12,true,14,14,0,41.96101,-87.64958
TA1307000144,4,12,true,16,9,-7,41.96142,-87.6762
TA1309000021,4,12,true,15,8,-7,41.9615,-87.6714
15623,4,12,true,20,15,-5,41.96154,-87.69117
KA1503000022,4,12,true,21,19,-2,41.96158,-87.66609
TA1307000107,4,12,true,53,42,-11,41.96164,-87.65464
TA1307000156,4,12,true,20,21,1,41.96301,-87.68479
TA1309000012,4,12,true,12,9,-3,41.96325,-87.67928
249,4,12,true,10,9,-1,41.96398,-87.63818
TA1308000012,4,12,true,39,45,6,41.96398,-87.63818
293,4,12,true,20,7,-13,41.96521,-87.65822
13074,4,12,true,54,50,-4,41.96521,-87.6582
639,4,12,true,32,39,7,41.96584,-87.64538
KA1504000127,4,12,true,10,11,1,41.96587,-87.70083
TA1307000140,4,12,true,29,34,5,41.96643,-87.68865
326,4,12,true,10,6,-4,41.96665,-87.67113
TA1309000014,4,12,true,37,41,4,41.96709,-87.66744
TA1307000158,4,12,true,31,22,-9,41.9671,-87.67904
TA1307000119,4,12,true,26,22,-4,41.96796,-87.65
TA1308000021,4,12,true,17,17,0,41.96883,-87.65765
KA1504000080,4,12,true,11,9,-2,41.96887,-87.69609
TA1309000015,4,12,true,13,9,-4,41.96889,-87.68401
344,4,12,true,13,12,-1,41.9691,-87.67423
TA1309000066,4,12,true,30,41,11,41.9691,-87.67423
TA1309000041,4,12,true,15,17,2,41.96951,-87.65471
KA1504000171,4,12,true,30,30,0,41.97161,-87.65016
TA1309000035,4,12,true,38,47,9,41.97335,-87.66785
295,4,12,true,10,7,-3,41.97378,-87.65972
13108,4,12,true,27,20,-7,41.97379,-87.65971
KA1504000149,4,12,true,12,17,5,41.97562,-87.67945
KA1504000146,4,12,true,38,34,-4,41.978,-87.66805
463,4,12,true,7,12,5,41.978,-87.66805
294,4,12,true,13,12,-1,41.97835,-87.65976
13109,4,12,true,30,40,10,41.97835,-87.65976
655,4,12,true,10,8,-2,41.97987,-87.68194
KA1504000151,4,12,true,29,20,-9,41.98359,-87.66916
KA1504000152,4,12,true,56,48,-8,41.98403,-87.65231
459,4,12,true,14,16,2,41.98403,-87.65231
15578,4,12,true,27,28,1,41.98405,-87.66027
15575,4,12,true,22,23,1,41.98975,-87.66014
KA1504000148,4,12,true,13,10,-3,41.99086,-87.66971
15571,4,12,true,21,18,-3,41.99478,-87.66028
KA1504000156,4,12,true,8,13,5,41.99925,-87.67137
RP-009,4,12,true,22,15,-7,42.00107,-87.66122
660,4,12,true,24,13,-11,42.00458,-87.66143
KA1504000175,4,12,true,17,19,2,42.00797,-87.66549
KA1504000162,4,12,true,14,6,-8,42.00907,-87.67422
520,4,12,true,24,12,-12,42.01597,-87.66859
515,4,12,true,11,17,6,42.01915,-87.67356
523,4,12,true,11,14,3,42.02089,-87.66505
E002,4,12,true,16,9,-7,42.03256,-87.67912
596,4,12,true,25,33,8,42.04822,-87.68348
E008,4,12,true,9,20,11,42.05049,-87.67782
605,4,12,true,20,20,0,42.05294,-87.67342
604,4,12,true,18,16,-2,42.05824,-87.67744
E014,4,12,true,13,7,-6,42.06483,-87.71531
15491,4,16,false,10,14,4,41.78096,-87.57624
426,4,16,false,17,14,-3,41.7851,-87.60108
KA1503000014,4,16,false,21,28,7,41.7851,-87.60108
TA1309000011,4,16,false,30,14,-16,41.78873,-87.60131
KA1503000071,4,16,false,43,27,-16,41.79148,-87.59988
423,4,16,false,12,5,-7,41.79148,-87.59988
KA1503000074,4,16,false,41,28,-13,41.79174,-87.58395
TA1309000063,4,16,false,22,30,8,41.79325,-87.5878
420,4,16,false,11,12,1,41.79429,-87.60145
KA1504000076,4,16,false,28,22,-6,41.7943,-87.60145
247,4,16,false,12,9,-3,41.79522,-87.58077
TA1308000009,4,16,false,50,46,-4,41.79522,-87.58075
TA1307000164,4,16,false,22,24,2,41.79527,-87.59647
KA1503000052,4,16,false,12,15,3,41.79935,-87.60097
KA1503000059,4,16,false,24,29,5,41.79952,-87.58643
TA1309000037,4,16,false,26,35,9,41.79957,-87.59474
KA1503000007,4,16,false,26,25,-1,41.80242,-87.58689
13398,4,16,false,20,15,-5,41.80256,-87.59035
322,4,16,false,7,10,3,41.80321,-87.59849
TA1308000035,4,16,false,9,10,1,41.80944,-87.59188
KA1503000065,4,16,false,5,13,8,41.81409,-87.59701
13420,4,16,false,7,15,8,41.82459,-87.61678
KA1503000004,4,16,false,17,9,-8,41.83127,-87.6088
15445,4,16,false,17,6,-11,41.83453,-87.63183
13216,4,16,false,11,28,17,41.83473,-87.62581
TA1308000046,4,16,false,4,10,6,41.83779,-87.65115
TA1309000055,4,16,false,18,14,-4,41.8382,-87.64514
KA1503000038,4,16,false,12,3,-9,41.83845,-87.6354
TA1307000048,4,16,false,51,39,-12,41.83855,-87.60821
150,4,16,false,15,6,-9,41.83855,-87.60821
TA1307000139,4,16,false,11,9,-2,41.84205,-87.61698
15443,4,16,false,1,11,10,41.84275,-87.63549
TA1307000005,4,16,false,7,12,5,41.84569,-87.6225
TA1308000014,4,16,false,3,14,11,41.84953,-87.64059
TA1308000026,4,16,false,8,10,2,41.85008,-87.63214
TA1305000004,4,16,false,15,11,-4,41.8514,-87.61884
TA1305000001,4,16,false,10,6,-4,41.85262,-87.6265
13075,4,16,false,25,35,10,41.8531,-87.63192
120,4,16,false,8,10,2,41.8531,-87.63191
15546,4,16,false,15,2,-13,41.85416,-87.61916
13089,4,16,false,8,13,5,41.85497,-87.67567
15545,4,16,false,32,24,-8,41.85627,-87.61334
SL-006,4,16,false,18,9,-9,41.8568,-87.63387
13135,4,16,false,18,10,-8,41.85753,-87.66157
13102,4,16,false,20,28,8,41.85762,-87.61942
13150,4,16,false,27,30,3,41.85783,-87.62455
13099,4,16,false,15,10,-5,41.85784,-87.64627
TA1307000159,4,16,false,4,11,7,41.8579,-87.6687
TA1307000044,4,16,false,14,7,-7,41.85794,-87.64083
13163,4,16,false,15,14,-1,41.85808,-87.65108
13164,4,16,false,19,20,1,41.85818,-87.65648
SL-012,4,16,false,25,15,-10,41.86038,-87.62581
13304,4,16,false,10,6,-4,41.86126,-87.65659
TA1306000002,4,16,false,16,9,-7,41.86238,-87.65108
TA1307000124,4,16,false,41,39,-2,41.86411,-87.62372
TA1309000001,4,16,false,38,18,-20,41.86488,-87.64708
13165,4,16,false,4,12,8,41.86505,-87.65697
13029,4,16,false,87,22,-65,41.86531,-87.6179
97,4,16,false,20,2,-18,41.86531,-87.6179
13431,4,16,false,51,53,2,41.8661,-87.60728
WL-008,4,16,false,22,34,12,41.86712,-87.64108
TA1305000002,4,16,false,76,77,1,41.86721,-87.62597
59,4,16,false,20,26,6,41.86721,-87.62597
15544,4,16,false,239,108,-131,41.86723,-87.61536
3,4,16,false,28,6,-22,41.86723,-87.61536
KA1706005007,4,16,false,33,30,-3,41.86749,-87.63219
SL-005,4,16,false,128,119,-9,41.8679,-87.62304
255,4,16,false,26,16,-10,41.86791,-87.62304
13139,4,16,false,12,16,4,41.86893,-87.65913
13285,4,16,false,25,4,-21,41.86928,-87.67372
13160,4,16,false,19,23,4,41.86947,-87.65548
414,4,16,false,2,11,9,41.87023,-87.63947
15550,4,16,false,31,31,0,41.87024,-87.63947
TA1309000010,4,16,false,63,69,6,41.87074,-87.62574
SL-009,4,16,false,25,19,-6,41.87081,-87.63121
TA1309000064,4,16,false,50,8,-42,41.87127,-87.67369
TA1307000130,4,16,false,16,16,0,41.87178,-87.65103
TA1307000121,4,16,false,24,16,-8,41.87184,-87.64664
41,4,16,false,10,8,-2,41.87209,-87.62957
SL-008,4,16,false,52,50,-2,41.87209,-87.62956
13332,4,16,false,16,35,19,41.87219,-87.6615
SL-011,4,16,false,53,60,7,41.87256,-87.63356
623,4,16,false,99,84,-15,41.87272,-87.62399
KA1504000104,4,16,false,44,4,-40,41.87296,-87.66912
383,4,16,false,15,3,-12,41.87297,-87.66912
SL-007,4,16,false,23,47,24,41.87404,-87.6277
13326,4,16,false,11,15,4,41.87425,-87.63958
321,4,16,false,10,19,9,41.87427,-87.63257
TA1306000025,4,16,false,10,5,-5,41.87464,-87.65703
13028,4,16,false,21,18,-3,41.87475,-87.64981
13081,4,16,false,11,3,-8,41.87501,-87.67326
SL-010,4,16,false,22,26,4,41.87501,-87.63309
15541,4,16,false,106,63,-43,41.8758,-87.62086
13037,4,16,false,12,6,-6,41.87588,-87.64078
TA1305000009,4,16,false,24,10,-14,41.87593,-87.63068
TA1305000010,4,16,false,24,39,15,41.87623,-87.62444
624,4,16,false,19,20,1,41.87626,-87.62923
2,4,16,false,12,15,3,41.87649,-87.62051
TA1305000035,4,16,false,29,16,-13,41.87716,-87.62787
13138,4,16,false,26,19,-7,41.87723,-87.63941
631,4,16,false,12,3,-9,41.87761,-87.6739
15539,4,16,false,29,30,1,41.87763,-87.64405
13158,4,16,false,48,27,-21,41.87764,-87.64957
13157,4,16,false,24,21,-3,41.87773,-87.6548
TA1305000025,4,16,false,91,49,-42,41.87773,-87.63528
TA1309000002,4,16,false,42,71,29,41.87784,-87.62408
13206,4,16,false,9,12,3,41.87794,-87.66201
TA1309000004,4,16,false,60,31,-29,41.87811,-87.63184
638,4,16,false,67,48,-19,41.87827,-87.64078
TA1305000005,4,16,false,38,13,-25,41.87924,-87.62975
13011,4,16,false,74,52,-22,41.87931,-87.63993
TA1309000008,4,16,false,50,38,-12,41.87933,-87.6355
192,4,16,false,15,5,-10,41.87935,-87.63997
KA1503000034,4,16,false,34,9,-25,41.87938,-87.63197
KA1503000015,4,16,false,52,51,-1,41.87948,-87.6257
287,4,16,false,21,2,-19,41.88017,-87.63527
TA1309000007,4,16,false,98,29,-69,41.88022,-87.63526
WL-011,4,16,false,38,40,2,41.88034,-87.64273
73,4,16,false,10,4,-6,41.8804,-87.64273
13156,4,16,false,28,21,-7,41.88042,-87.65554
13300,4,16,false,249,235,-14,41.88097,-87.61675
76,4,16,false,35,33,-2,41.88098,-87.61675
13008,4,16,false,222,238,16,41.88105,-87.62408
90,4,16,false,33,24,-9,41.88107,-87.62409
49,4,16,false,15,2,-13,41.88116,-87.62963
TA1305000006,4,16,false,107,65,-42,41.88122,-87.6296
13134,4,16,false,10,17,7,41.88138,-87.67493
13056,4,16,false,32,14,-18,41.88168,-87.63951
TA1307000120,4,16,false,89,91,2,41.88188,-87.64879
13341,4,16,false,71,44,-27,41.88208,-87.63985
13036,4,16,false,48,36,-12,41.8821,-87.62513
77,4,16,false,12,5,-7,41.88214,-87.64108
TA1305000032,4,16,false,94,60,-34,41.88218,-87.64109
13006,4,16,false,37,24,-13,41.88268,-87.63252
13353,4,16,false,29,22,-7,41.88283,-87.6612
654,4,16,false,17,31,14,41.88307,-87.65698
13409,4,16,false,26,48,22,41.8831,-87.6511
18,4,16,false,10,2,-8,41.88317,-87.63735
KA1503000072,4,16,false,37,16,-21,41.88317,-87.63693
91,4,16,false,10,2,-8,41.88336,-87.64122
WL-012,4,16,false,78,46,-32,41.88337,-87.6412
112,4,16,false,12,18,6,41.88362,-87.6486
13053,4,16,false,56,84,28,41.88365,-87.64863
43,4,16,false,17,14,-3,41.88396,-87.62455
13001,4,16,false,107,104,-3,41.88397,-87.62459
13155,4,16,false,28,11,-17,41.88407,-87.65689
18062,4,16,false,40,26,-14,41.88412,-87.65427
81,4,16,false,11,8,-3,41.88417,-87.6296
TA1306000010,4,16,false,45,40,-5,41.88419,-87.62961
TA1305000030,4,16,false,80,47,-33,41.88459,-87.63178
15535,4,16,false,53,40,-13,41.8846,-87.64455
96,4,16,false,12,4,-8,41.8846,-87.64455
TA1305000029,4,16,false,76,67,-9,41.88466,-87.62787
195,4,16,false,12,15,3,41.88466,-87.61952
13263,4,16,false,67,69,2,41.88467,-87.61952
44,4,16,false,12,14,2,41.88468,-87.62782
TA1306000015,4,16,false,57,65,8,41.88549,-87.65232
518,4,16,false,10,1,-9,41.8855,-87.71686
13021,4,16,false,51,41,-10,41.88559,-87.64184
TA1307000111,4,16,false,88,34,-54,41.88582,-87.63548
164,4,16,false,11,1,-10,41.88583,-87.63547
13073,4,16,false,14,17,3,41.88592,-87.66717
KA17018054,4,16,false,24,16,-8,41.88595,-87.67701
KA1503000012,4,16,false,65,47,-18,41.88599,-87.63089
38,4,16,false,15,12,-3,41.88599,-87.63089
52,4,16,false,12,17,5,41.886,-87.62421
TA1305000011,4,16,false,114,97,-17,41.886,-87.62418
15534,4,16,false,39,58,19,41.88627,-87.61749
13197,4,16,false,25,15,-10,41.8866,-87.65816
TA1308000029,4,16,false,35,39,4,41.88673,-87.62225
TA1307000131,4,16,false,45,56,11,41.88688,-87.62606
194,4,16,false,9,23,14,41.88688,-87.62606
6,4,16,false,20,9,-11,41.88697,-87.61281
KA1503000064,4,16,false,98,110,12,41.88697,-87.61281
100,4,16,false,10,3,-7,41.88814,-87.63657
TA1305000022,4,16,false,59,38,-21,41.88817,-87.63656
56,4,16,false,5,12,7,41.88866,-87.64442
TA1306000003,4,16,false,93,61,-32,41.88867,-87.64442
133,4,16,false,15,15,0,41.88918,-87.63851
KA1503000043,4,16,false,64,85,21,41.88918,-87.63851
13050,4,16,false,65,72,7,41.88919,-87.62775
47,4,16,false,10,4,-6,41.88921,-87.62775
13432,4,16,false,15,12,-3,41.88989,-87.67149
TA1307000151,4,16,false,67,81,14,41.88993,-87.63427
212,4,16,false,13,12,-1,41.88995,-87.63427
636,4,16,false,30,31,1,41.88997,-87.63662
KA1503000044,4,16,false,34,28,-6,41.89018,-87.6262
196,4,16,false,10,9,-1,41.89053,-87.62205
13427,4,16,false,49,50,1,41.89054,-87.62205
13430,4,16,false,57,71,14,41.89077,-87.63169
181,4,16,false,12,10,-2,41.89077,-87.63168
TA1306000013,4,16,false,92,88,-4,41.89083,-87.61852
RN-,4,16,false,63,44,-19,41.89102,-87.63546
672,4,16,false,5,14,9,41.89102,-87.63545
13434,4,16,false,21,21,0,41.89108,-87.66663
TA1308000006,4,16,false,25,26,1,41.89128,-87.67686
TA1307000117,4,16,false,102,114,12,41.89144,-87.62675
13033,4,16,false,66,56,-10,41.8916,-87.64835
13194,4,16,false,29,31,2,41.8918,-87.65878
TA1305000003,4,16,false,73,92,19,41.89187,-87.62061
24,4,16,false,19,18,-1,41.8919,-87.62063
643,4,16,false,10,17,7,41.89203,-87.68939
35,4,16,false,18,22,4,41.89227,-87.61206
13022,4,16,false,542,540,-2,41.89227,-87.61205
99,4,16,false,14,8,-6,41.89255,-87.61449
TA1306000029,4,16,false,74,58,-16,41.89256,-87.61449
13265,4,16,false,52,63,11,41.89383,-87.64172
74,4,16,false,6,18,12,41.89384,-87.64173
13045,4,16,false,90,72,-18,41.89403,-87.62931
110,4,16,false,18,10,-8,41.89406,-87.6293
13016,4,16,false,89,58,-31,41.89431,-87.62277
211,4,16,false,9,13,4,41.89439,-87.62267
KA1503000041,4,16,false,48,27,-21,41.89452,-87.61798
13196,4,16,false,24,28,4,41.89455,-87.65345
TA1307000062,4,16,false,34,25,-9,41.89466,-87.63839
TA1306000012,4,16,false,95,102,7,41.89475,-87.63438
53,4,16,false,15,12,-3,41.89476,-87.63439
627,4,16,false,5,10,5,41.8948,-87.63231
KP1705001026,4,16,false,39,53,14,41.89483,-87.6323
18058,4,16,false,16,9,-7,41.8955,-87.68201
637,4,16,false,14,28,14,41.89563,-87.67209
13132,4,16,false,30,32,2,41.89573,-87.67718
161,4,16,false,14,9,-5,41.89574,-87.62599
15530,4,16,false,69,70,1,41.89575,-87.62596
18003,4,16,false,31,18,-13,41.89575,-87.62011
13247,4,16,false,18,20,2,41.89597,-87.66775
350,4,16,false,7,11,4,41.89597,-87.66774
TA1305000020,4,16,false,38,39,1,41.89636,-87.65406
13289,4,16,false,37,25,-12,41.89638,-87.661
337,4,16,false,9,10,1,41.89659,-87.63096
13303,4,16,false,42,38,-4,41.89672,-87.63088
13017,4,16,false,36,32,-4,41.89676,-87.6357
31,4,16,false,6,14,8,41.89677,-87.63572
13338,4,16,false,39,38,-1,41.89697,-87.62173
TA1307000061,4,16,false,26,28,2,41.89745,-87.62873
106,4,16,false,12,3,-9,41.89746,-87.62874
25,4,16,false,6,11,5,41.89751,-87.62354
13034,4,16,false,69,78,9,41.89754,-87.62352
TA1306000009,4,16,false,59,27,-32,41.89772,-87.64299
620,4,16,false,55,47,-8,41.89817,-87.63754
KA1504000103,4,16,false,15,23,8,41.89842,-87.68659
145,4,16,false,4,10,6,41.89856,-87.62211
15529,4,16,false,74,46,-28,41.89858,-87.62206
140,4,16,false,13,20,7,41.89895,-87.6299
TA1307000128,4,16,false,91,85,-6,41.89896,-87.6299
657,4,16,false,19,13,-6,41.89918,-87.6722
13248,4,16,false,20,11,-9,41.89964,-87.66788
TA1306000011,4,16,false,20,23,3,41.89994,-87.63443
KA1504000116,4,16,false,23,19,-4,41.90023,-87.64299
17660,4,16,false,20,24,4,41.90036,-87.69671
13290,4,16,false,25,21,-4,41.90069,-87.66259
13042,4,16,false,244,223,-21,41.90097,-87.62377
85,4,16,false,21,29,8,41.90098,-87.62375
TA1307000070,4,16,false,32,17,-15,41.90133,-87.67742
KA1504000133,4,16,false,76,62,-14,41.90234,-87.62773
172,4,16,false,7,10,3,41.90236,-87.62774
15654,4,16,false,7,10,3,41.90271,-87.70923
13241,4,16,false,28,15,-13,41.9029,-87.68731
176,4,16,false,28,25,-3,41.90291,-87.63141
TA1306000006,4,16,false,11,9,-2,41.90292,-87.63772
TA1307000039,4,16,false,107,112,5,41.90294,-87.63137
658,4,16,false,12,6,-6,41.903,-87.6838
13256,4,16,false,15,11,-4,41.90302,-87.69749
TA1305000034,4,16,false,37,36,-1,41.90313,-87.67391
182,4,16,false,18,21,3,41.90317,-87.63442
KA1504000135,4,16,false,121,119,-2,41.90319,-87.63439
13136,4,16,false,21,24,3,41.90326,-87.67845
210,4,16,false,16,7,-9,41.90342,-87.66781
13061,4,16,false,69,60,-9,41.90342,-87.66779
KA1504000079,4,16,false,40,49,9,41.9035,-87.64334
TA1307000115,4,16,false,15,23,8,41.9046,-87.64056
291,4,16,false,21,14,-7,41.90672,-87.63494
TA1308000049,4,16,false,55,83,28,41.90672,-87.6349
KA1504000134,4,16,false,47,50,3,41.90687,-87.6262
13224,4,16,false,36,30,-6,41.90706,-87.66725
18069,4,16,false,15,2,-13,41.90722,-87.65563
TA1307000143,4,16,false,14,8,-6,41.90762,-87.63854
13221,4,16,false,45,58,13,41.90765,-87.67254
13245,4,16,false,10,12,2,41.90777,-87.68586
301,4,16,false,11,18,7,41.90796,-87.63203
TA1309000024,4,16,false,63,37,-26,41.908,-87.63152
TA1305000041,4,16,false,43,57,14,41.9094,-87.67769
331,4,16,false,72,73,1,41.90965,-87.64812
TA1305000037,4,16,false,37,22,-15,41.91018,-87.67003
TA1306000008,4,16,false,18,16,-2,41.9102,-87.6435
TA1308000005,4,16,false,15,10,-5,41.91042,-87.68238
13258,4,16,false,11,11,0,41.91043,-87.69718
13257,4,16,false,11,13,2,41.91054,-87.68956
13154,4,16,false,42,49,7,41.91054,-87.65312
13058,4,16,false,40,35,-5,41.91059,-87.64942
60,4,16,false,11,8,-3,41.91059,-87.64942
118,4,16,false,10,7,-3,41.91138,-87.63868
TA1307000038,4,16,false,52,58,6,41.91138,-87.63868
LF-005,4,16,false,185,175,-10,41.91172,-87.62681
268,4,16,false,11,10,-1,41.91172,-87.62681
126,4,16,false,7,10,3,41.91196,-87.63197
13128,4,16,false,37,51,14,41.91197,-87.63197
289,4,16,false,10,23,13,41.91209,-87.63472
TA1308000050,4,16,false,97,120,23,41.91211,-87.6347
158,4,16,false,11,7,-4,41.91262,-87.6814
13243,4,16,false,29,31,2,41.91262,-87.6814
TA1309000032,4,16,false,20,10,-10,41.91293,-87.66417
TA1306000032,4,16,false,30,33,3,41.9137,-87.65285
TA1307000166,4,16,false,19,27,8,41.91386,-87.64877
15655,4,16,false,12,13,1,41.91401,-87.70514
18017,4,16,false,13,12,-1,41.91416,-87.71676
18067,4,16,false,29,9,-20,41.9146,-87.66796
13068,4,16,false,19,24,5,41.91554,-87.68703
13179,4,16,false,64,103,39,41.9157,-87.63461
141,4,16,false,9,18,9,41.91571,-87.63461
13133,4,16,false,37,32,-5,41.91598,-87.67733
TA1305000039,4,16,false,29,41,12,41.9163,-87.66749
15650,4,16,false,7,11,4,41.91711,-87.71023
15651,4,16,false,18,13,-5,41.91752,-87.70181
13266,4,16,false,12,14,2,41.91774,-87.69142
TA1309000029,4,16,false,16,17,1,41.9178,-87.68245
TA1309000006,4,16,false,24,24,0,41.91809,-87.64375
TA1307000163,4,16,false,32,37,5,41.91821,-87.65696
94,4,16,false,25,11,-14,41.91831,-87.6363
13146,4,16,false,101,63,-38,41.91831,-87.63629
13059,4,16,false,61,48,-13,41.91845,-87.65222
13259,4,16,false,14,10,-4,41.91852,-87.69744
13192,4,16,false,32,53,21,41.91995,-87.64884
13288,4,16,false,23,17,-6,41.92008,-87.67788
13242,4,16,false,10,15,5,41.92021,-87.69266
TA1309000030,4,16,false,36,34,-2,41.92077,-87.66372
13292,4,16,false,10,11,1,41.92152,-87.70733
TA1309000033,4,16,false,35,32,-3,41.92158,-87.65381
13193,4,16,false,60,73,13,41.92182,-87.64412
144,4,16,false,8,13,5,41.92182,-87.64411
13191,4,16,false,53,40,-13,41.92217,-87.63891
13084,4,16,false,33,36,3,41.92268,-87.69715
LP-,4,16,false,62,55,-7,41.92396,-87.63584
673,4,16,false,10,12,2,41.92398,-87.63585
KA1504000140,4,16,false,14,16,2,41.92409,-87.67646
16010,4,16,false,3,12,9,41.92458,-87.72787
15648,4,16,false,16,6,-10,41.92464,-87.68931
KA1504000090,4,16,false,6,10,4,41.92483,-87.7145
TA1307000001,4,16,false,56,30,-26,41.92535,-87.66581
TA1306000026,4,16,false,39,37,-2,41.92558,-87.65842
TA1306000016,4,16,false,48,42,-6,41.9256,-87.65371
313,4,16,false,13,20,7,41.9257,-87.64246
TA1309000019,4,16,false,62,61,-1,41.92586,-87.63897
TA1309000058,4,16,false,42,54,12,41.92591,-87.64927
127,4,16,false,10,13,3,41.92592,-87.64927
TA1308000001,4,16,false,136,140,4,41.92627,-87.63086
177,4,16,false,14,22,8,41.92627,-87.63086
15646,4,16,false,7,19,12,41.92668,-87.6977
13124,4,16,false,40,29,-11,41.92675,-87.63444
34,4,16,false,11,1,-10,41.92675,-87.63444
TA1309000023,4,16,false,40,35,-5,41.9287,-87.65383
TA1307000113,4,16,false,30,31,1,41.92878,-87.66391
13296,4,16,false,26,19,-7,41.92883,-87.66852
TA1309000059,4,16,false,22,15,-7,41.92889,-87.65898
TA1309000061,4,16,false,54,46,-8,41.92915,-87.64909
TA1308000031,4,16,false,30,34,4,41.92946,-87.68417
TA1305000014,4,16,false,62,50,-12,41.92956,-87.64313
340,4,16,false,15,11,-4,41.92956,-87.64313
13085,4,16,false,40,38,-2,41.92958,-87.70789
TA1307000142,4,16,false,71,68,-3,41.93125,-87.64432
220,4,16,false,12,18,6,41.93125,-87.64431
13276,4,16,false,73,61,-12,41.93132,-87.63874
324,4,16,false,7,11,4,41.93173,-87.64179
15645,4,16,false,10,9,-1,41.93191,-87.70121
13271,4,16,false,13,11,-2,41.93192,-87.67784
TA1307000064,4,16,false,44,42,-2,41.93222,-87.65864
TA1306000014,4,16,false,45,52,7,41.93242,-87.65271
329,4,16,false,13,19,6,41.93258,-87.63642
TA1309000039,4,16,false,70,95,25,41.93258,-87.63642
13294,4,16,false,15,17,2,41.9326,-87.66595
319,4,16,false,12,1,-11,41.93292,-87.67217
TA1309000036,4,16,false,36,38,2,41.93313,-87.64776
TA1307000006,4,16,false,31,27,-4,41.93571,-87.6636
13268,4,16,false,16,15,-1,41.93588,-87.67843
13269,4,16,false,11,20,9,41.93609,-87.66983
115,4,16,false,11,8,-3,41.93628,-87.65266
TA1307000052,4,16,false,43,40,-3,41.93628,-87.65266
156,4,16,false,11,9,-2,41.9365,-87.64756
TA1307000136,4,16,false,43,45,2,41.9365,-87.64755
TA1307000041,4,16,false,69,65,-4,41.93669,-87.63683
157,4,16,false,13,6,-7,41.9367,-87.63683
13137,4,16,false,71,74,3,41.9376,-87.6441
300,4,16,false,11,10,-1,41.93761,-87.6441
15642,4,16,false,11,11,0,41.93843,-87.69801
154,4,16,false,11,9,-2,41.93912,-87.66384
KA17018068,4,16,false,10,7,-3,41.93935,-87.68327
TA1309000042,4,16,false,38,33,-5,41.93937,-87.66836
KA150400009X,4,16,false,12,10,-2,41.9394,-87.71159
13229,4,16,false,33,24,-9,41.93946,-87.66376
TA1308000019,4,16,false,44,44,0,41.93973,-87.65886
13277,4,16,false,35,39,4,41.9401,-87.64546
296,4,16,false,6,11,5,41.9401,-87.64546
TA1307000134,4,16,false,71,51,-20,41.94016,-87.65303
117,4,16,false,14,11,-3,41.94016,-87.65302
13143,4,16,false,10,12,2,41.94059,-87.67853
334,4,16,false,16,15,-1,41.94076,-87.63919
TA1309000049,4,16,false,63,78,15,41.94077,-87.63919
TA1307000138,4,16,false,29,20,-9,41.94334,-87.67094
13144,4,16,false,19,14,-5,41.9434,-87.67964
TA1309000025,4,16,false,51,64,13,41.94368,-87.64894
229,4,16,false,10,9,-1,41.94372,-87.66401
13071,4,16,false,55,53,-2,41.94373,-87.66401
632,4,16,false,77,71,-6,41.94453,-87.6547
303,4,16,false,10,20,10,41.94522,-87.64702
15631,4,16,false,6,10,4,41.94524,-87.70665
13278,4,16,false,59,59,0,41.94553,-87.64644
227,4,16,false,6,10,4,41.94813,-87.66397
13235,4,16,false,40,34,-6,41.94814,-87.66396
304,4,16,false,10,8,-2,41.94878,-87.64922
13253,4,16,false,15,14,-1,41.9488,-87.67527
13325,4,16,false,62,62,0,41.94907,-87.64863
TA1307000126,4,16,false,90,59,-31,41.94936,-87.65451
TA1307000150,4,16,false,68,51,-17,41.94945,-87.64646
13319,4,16,false,8,20,12,41.95069,-87.6687
TA1307000127,4,16,false,57,32,-25,41.9508,-87.65918
13323,4,16,false,26,35,9,41.95282,-87.65
KA1504000139,4,16,false,10,4,-6,41.954,-87.71909
TA1309000043,4,16,false,22,14,-8,41.95417,-87.66434
13063,4,16,false,38,37,-1,41.95424,-87.65441
254,4,16,false,15,9,-6,41.95438,-87.64806
TA1308000022,4,16,false,43,40,-3,41.95438,-87.64805
TA1307000149,4,16,false,13,7,-6,41.95467,-87.67392
TA1309000026,4,16,false,14,9,-5,41.95601,-87.6802
13379,4,16,false,37,23,-14,41.95786,-87.6495
TA1309000018,4,16,false,15,5,-10,41.95791,-87.67357
TA1309000027,4,16,false,8,13,5,41.9585,-87.65499
13389,4,16,false,35,29,-6,41.961,-87.64958
TA1307000144,4,16,false,11,7,-4,41.96142,-87.6762
KA1503000022,4,16,false,13,13,0,41.96158,-87.66609
TA1307000107,4,16,false,52,46,-6,41.96164,-87.65464
TA1307000156,4,16,false,6,10,4,41.96301,-87.68479
249,4,16,false,10,7,-3,41.96398,-87.63818
TA1308000012,4,16,false,68,87,19,41.96398,-87.63818
13074,4,16,false,24,29,5,41.96521,-87.6582
639,4,16,false,33,32,-1,41.96584,-87.64538
TA1307000140,4,16,false,18,23,5,41.96643,-87.68865
TA1309000014,4,16,false,30,27,-3,41.96709,-87.66744
TA1307000158,4,16,false,12,11,-1,41.9671,-87.67904
TA1307000119,4,16,false,19,13,-6,41.96796,-87.65
TA1308000021,4,16,false,13,16,3,41.96883,-87.65765
TA1309000066,4,16,false,35,30,-5,41.9691,-87.67423
TA1309000041,4,16,false,27,16,-11,41.96951,-87.65471
KA1504000171,4,16,false,25,28,3,41.97161,-87.65016
TA1309000035,4,16,false,25,26,1,41.97335,-87.66785
13108,4,16,false,18,17,-1,41.97379,-87.65971
KA1504000149,4,16,false,9,15,6,41.97562,-87.67945
KA1504000146,4,16,false,39,43,4,41.978,-87.66805
13109,4,16,false,19,18,-1,41.97835,-87.65976
655,4,16,false,10,5,-5,41.97987,-87.68194
KA1504000151,4,16,false,25,23,-2,41.98359,-87.66916
459,4,16,false,20,11,-9,41.98403,-87.65231
KA1504000152,4,16,false,53,60,7,41.98403,-87.65231
15578,4,16,false,10,16,6,41.98405,-87.66027
15575,4,16,false,12,17,5,41.98975,-87.66014
KA1504000148,4,16,false,11,13,2,41.99086,-87.66971
15571,4,16,false,27,25,-2,41.99478,-87.66028
454,4,16,false,8,10,2,41.99478,-87.66027
RP-009,4,16,false,19,11,-8,42.00107,-87.66122
660,4,16,false,13,16,3,42.00458,-87.66143
KA1504000175,4,16,false,11,10,-1,42.00797,-87.66549
520,4,16,false,10,2,-8,42.01597,-87.66859
523,4,16,false,6,10,4,42.02089,-87.66505
E002,4,16,false,14,4,-10,42.03256,-87.67912
596,4,16,false,14,35,21,42.04822,-87.68348
E008,4,16,false,14,17,3,42.05049,-87.67782
605,4,16,false,16,7,-9,42.05294,-87.67342
604,4,16,false,37,25,-12,42.05824,-87.67744
426,4,16,true,23,21,-2,41.7851,-87.60108
KA1503000014,4,16,true,71,93,22,41.7851,-87.60108
KA1503000070,4,16,true,20,18,-2,41.78794,-87.58831
328,4,16,true,18,5,-13,41.78872,-87.6013
TA1309000011,4,16,true,88,31,-57,41.78873,-87.60131
KA1503000071,4,16,true,151,66,-85,41.79148,-87.59988
423,4,16,true,30,11,-19,41.79148,-87.59988
KA1503000074,4,16,true,13,17,4,41.79174,-87.58395
TA1309000063,4,16,true,30,55,25,41.79325,-87.5878
345,4,16,true,8,17,9,41.79326,-87.5878
420,4,16,true,20,17,-3,41.79429,-87.60145
KA1504000076,4,16,true,88,48,-40,41.7943,-87.60145
247,4,16,true,11,16,5,41.79522,-87.58077
TA1308000009,4,16,true,52,70,18,41.79522,-87.58075
TA1307000164,4,16,true,22,36,14,41.79527,-87.59647
KA1503000052,4,16,true,29,48,19,41.79935,-87.60097
418,4,16,true,5,10,5,41.79936,-87.60097
KA1503000059,4,16,true,25,34,9,41.79952,-87.58643
TA1309000037,4,16,true,58,72,14,41.79957,-87.59474
417,4,16,true,9,20,11,41.80242,-87.5869
KA1503000007,4,16,true,20,38,18,41.80242,-87.58689
121,4,16,true,5,14,9,41.80256,-87.59035
13398,4,16,true,11,31,20,41.80256,-87.59035
322,4,16,true,16,12,-4,41.80321,-87.59849
KA1503000032,4,16,true,4,10,6,41.81912,-87.64328
KA1503000068,4,16,true,11,35,24,41.82878,-87.68062
TA1308000045,4,16,true,20,15,-5,41.83062,-87.64129
TA1308000043,4,16,true,16,11,-5,41.83066,-87.64715
15446,4,16,true,11,10,-1,41.83068,-87.65603
KA1503000005,4,16,true,21,14,-7,41.83079,-87.6325
184,4,16,true,10,4,-6,41.83104,-87.62684
TA1307000129,4,16,true,68,9,-59,41.83104,-87.62683
KA1503000004,4,16,true,10,11,1,41.83127,-87.6088
13345,4,16,true,9,12,3,41.83138,-87.61803
15445,4,16,true,23,9,-14,41.83453,-87.63183
13216,4,16,true,112,66,-46,41.83473,-87.62581
148,4,16,true,13,17,4,41.83474,-87.62581
13217,4,16,true,50,38,-12,41.83488,-87.61792
13215,4,16,true,18,21,3,41.83634,-87.6135
TA1308000046,4,16,true,22,24,2,41.83779,-87.65115
TA1309000055,4,16,true,26,39,13,41.8382,-87.64514
KA1503000038,4,16,true,18,11,-7,41.83845,-87.6354
TA1307000048,4,16,true,16,19,3,41.83855,-87.60821
TA1308000036,4,16,true,16,27,11,41.83883,-87.62186
15442,4,16,true,11,4,-7,41.83918,-87.66562
KA1503000040,4,16,true,6,11,5,41.84164,-87.65744
237,4,16,true,12,7,-5,41.84204,-87.61697
TA1307000139,4,16,true,29,45,16,41.84205,-87.61698
TA1307000153,4,16,true,15,53,38,41.84358,-87.64538
147,4,16,true,11,9,-2,41.84569,-87.62251
TA1307000005,4,16,true,52,26,-26,41.84569,-87.6225
TA1308000013,4,16,true,20,11,-9,41.84719,-87.64681
15689,4,16,true,1,14,13,41.84912,-87.69515
TA1305000004,4,16,true,13,11,-2,41.8514,-87.61884
TA1305000001,4,16,true,20,47,27,41.85262,-87.6265
13075,4,16,true,35,21,-14,41.8531,-87.63192
13091,4,16,true,13,11,-2,41.85409,-87.68585
13307,4,16,true,8,12,4,41.85489,-87.66359
13089,4,16,true,13,11,-2,41.85497,-87.67567
13331,4,16,true,17,15,-2,41.85515,-87.65414
4,4,16,true,18,17,-1,41.85627,-87.61334
15545,4,16,true,61,63,2,41.85627,-87.61334
SL-013,4,16,true,13,23,10,41.85659,-87.62755
SL-006,4,16,true,16,10,-6,41.8568,-87.63387
13135,4,16,true,32,34,2,41.85753,-87.66157
338,4,16,true,4,16,12,41.85758,-87.61956
13102,4,16,true,40,67,27,41.85762,-87.61942
273,4,16,true,17,7,-10,41.85783,-87.62455
13150,4,16,true,77,67,-10,41.85783,-87.62455
13099,4,16,true,13,19,6,41.85784,-87.64627
TA1307000159,4,16,true,16,21,5,41.8579,-87.6687
TA1307000044,4,16,true,17,14,-3,41.85794,-87.64083
13163,4,16,true,18,38,20,41.85808,-87.65108
13164,4,16,true,40,40,0,41.85818,-87.65648
SL-012,4,16,true,46,63,17,41.86038,-87.62581
72,4,16,true,9,26,17,41.86039,-87.62581
13304,4,16,true,12,17,5,41.86126,-87.65659
KA1504000109,4,16,true,22,4,-18,41.86192,-87.69347
TA1306000002,4,16,true,43,55,12,41.86238,-87.65108
TA1307000124,4,16,true,72,112,40,41.86411,-87.62372
168,4,16,true,14,21,7,41.86415,-87.62372
282,4,16,true,8,12,4,41.86487,-87.64708
TA1309000001,4,16,true,44,61,17,41.86488,-87.64708
13165,4,16,true,11,10,-1,41.86505,-87.65697
275,4,16,true,11,5,-6,41.86524,-87.66651
13354,4,16,true,14,18,4,41.86524,-87.66651
13029,4,16,true,15,5,-10,41.86531,-87.6179
341,4,16,true,11,14,3,41.86608,-87.60733
13431,4,16,true,31,28,-3,41.8661,-87.60728
WL-008,4,16,true,51,48,-3,41.86712,-87.64108
57,4,16,true,8,17,9,41.86712,-87.64107
59,4,16,true,23,44,21,41.86721,-87.62597
TA1305000002,4,16,true,104,173,69,41.86721,-87.62597
15544,4,16,true,38,33,-5,41.86723,-87.61536
3,4,16,true,14,10,-4,41.86723,-87.61536
TA1305000017,4,16,true,31,23,-8,41.86734,-87.64863
55,4,16,true,10,5,-5,41.86735,-87.64863
KA1706005007,4,16,true,36,54,18,41.86749,-87.63219
SL-005,4,16,true,111,156,45,41.8679,-87.62304
255,4,16,true,33,40,7,41.86791,-87.62304
644,4,16,true,55,30,-25,41.86859,-87.68625
19,4,16,true,8,13,5,41.86892,-87.65913
13139,4,16,true,35,45,10,41.86893,-87.65913
13285,4,16,true,212,18,-194,41.86928,-87.67372
22,4,16,true,16,15,-1,41.86947,-87.65548
13160,4,16,true,55,55,0,41.86947,-87.65548
414,4,16,true,11,9,-2,41.87023,-87.63947
15550,4,16,true,21,33,12,41.87024,-87.63947
TA1309000010,4,16,true,51,89,38,41.87074,-87.62574
SL-009,4,16,true,21,52,31,41.87081,-87.63121
342,4,16,true,57,10,-47,41.87127,-87.6737
TA1309000064,4,16,true,245,30,-215,41.87127,-87.67369
261,4,16,true,29,2,-27,41.87151,-87.6699
TA1307000130,4,16,true,120,63,-57,41.87178,-87.65103
241,4,16,true,15,21,6,41.8718,-87.65102
108,4,16,true,16,14,-2,41.87183,-87.64664
TA1307000121,4,16,true,68,78,10,41.87184,-87.64664
41,4,16,true,11,34,23,41.87209,-87.62957
SL-008,4,16,true,118,148,30,41.87209,-87.62956
13332,4,16,true,125,143,18,41.87219,-87.6615
175,4,16,true,6,10,4,41.87255,-87.63359
SL-011,4,16,true,64,84,20,41.87256,-87.63356
623,4,16,true,48,60,12,41.87272,-87.62399
KA1504000104,4,16,true,219,24,-195,41.87296,-87.66912
383,4,16,true,47,7,-40,41.87297,-87.66912
320,4,16,true,19,26,7,41.87327,-87.66402
5,4,16,true,10,11,1,41.87403,-87.6277
SL-007,4,16,true,37,36,-1,41.87404,-87.6277
13326,4,16,true,33,11,-22,41.87425,-87.63958
321,4,16,true,8,15,7,41.87427,-87.63257
TA1306000025,4,16,true,36,35,-1,41.87464,-87.65703
15668,4,16,true,17,11,-6,41.87471,-87.68642
13028,4,16,true,64,46,-18,41.87475,-87.64981
109,4,16,true,7,17,10,41.87475,-87.64981
13081,4,16,true,47,12,-35,41.87501,-87.67326
89,4,16,true,15,16,1,41.87501,-87.6331
SL-010,4,16,true,48,117,69,41.87501,-87.63309
15541,4,16,true,4,14,10,41.8758,-87.62086
13037,4,16,true,16,17,1,41.87588,-87.64078
50,4,16,true,12,12,0,41.87592,-87.6307
TA1305000009,4,16,true,36,61,25,41.87593,-87.63068
317,4,16,true,43,6,-37,41.87603,-87.68195
TA1305000010,4,16,true,44,31,-13,41.87623,-87.62444
624,4,16,true,48,59,11,41.87626,-87.62923
33,4,16,true,13,4,-9,41.87715,-87.62786
TA1305000035,4,16,true,68,31,-37,41.87716,-87.62787
13138,4,16,true,100,67,-33,41.87723,-87.63941
631,4,16,true,33,11,-22,41.87761,-87.6739
15539,4,16,true,89,61,-28,41.87763,-87.64405
13158,4,16,true,89,103,14,41.87764,-87.64957
134,4,16,true,20,13,-7,41.87764,-87.64954
13157,4,16,true,89,73,-16,41.87773,-87.6548
21,4,16,true,19,12,-7,41.87773,-87.6548
TA1305000025,4,16,true,152,65,-87,41.87773,-87.63528
36,4,16,true,18,12,-6,41.87776,-87.63525
284,4,16,true,10,7,-3,41.87784,-87.62408
TA1309000002,4,16,true,27,39,12,41.87784,-87.62408
146,4,16,true,10,10,0,41.87794,-87.66201
13206,4,16,true,24,56,32,41.87794,-87.66201
283,4,16,true,47,11,-36,41.87809,-87.63183
TA1309000004,4,16,true,260,80,-180,41.87811,-87.63184
107,4,16,true,18,11,-7,41.87822,-87.644
638,4,16,true,227,187,-40,41.87827,-87.64078
37,4,16,true,26,10,-16,41.87921,-87.62975
TA1305000005,4,16,true,148,46,-102,41.87924,-87.62975
286,4,16,true,20,6,-14,41.8793,-87.6355
13011,4,16,true,149,325,176,41.87931,-87.63993
TA1309000008,4,16,true,96,29,-67,41.87933,-87.6355
192,4,16,true,35,40,5,41.87935,-87.63997
KA1503000034,4,16,true,118,8,-110,41.87938,-87.63197
40,4,16,true,22,3,-19,41.87944,-87.63197
39,4,16,true,22,3,-19,41.87948,-87.62571
KA1503000015,4,16,true,112,37,-75,41.87948,-87.6257
15667,4,16,true,8,14,6,41.8798,-87.68609
287,4,16,true,56,6,-50,41.88017,-87.63527
TA1309000007,4,16,true,308,28,-280,41.88022,-87.63526
WL-011,4,16,true,60,84,24,41.88034,-87.64273
73,4,16,true,5,24,19,41.8804,-87.64273
80,4,16,true,12,14,2,41.88042,-87.65556
13156,4,16,true,41,88,47,41.88042,-87.65554
13300,4,16,true,56,96,40,41.88097,-87.61675
76,4,16,true,23,22,-1,41.88098,-87.61675
13008,4,16,true,107,76,-31,41.88105,-87.62408
90,4,16,true,16,9,-7,41.88107,-87.62409
49,4,16,true,51,12,-39,41.88116,-87.62963
TA1305000006,4,16,true,318,56,-262,41.88122,-87.6296
13134,4,16,true,18,18,0,41.88138,-87.67493
13056,4,16,true,86,60,-26,41.88168,-87.63951
191,4,16,true,11,5,-6,41.88169,-87.63951
198,4,16,true,19,40,21,41.88187,-87.6488
TA1307000120,4,16,true,109,172,63,41.88188,-87.64879
13341,4,16,true,150,138,-12,41.88208,-87.63985
174,4,16,true,15,8,-7,41.88208,-87.63984
197,4,16,true,21,8,-13,41.88208,-87.62513
13036,4,16,true,72,46,-26,41.8821,-87.62513
77,4,16,true,22,37,15,41.88214,-87.64108
TA1305000032,4,16,true,198,217,19,41.88218,-87.64109
98,4,16,true,27,9,-18,41.88266,-87.63251
13006,4,16,true,164,64,-100,41.88268,-87.63252
13353,4,16,true,50,100,50,41.88283,-87.6612
346,4,16,true,3,16,13,41.88284,-87.6612
654,4,16,true,28,37,9,41.88307,-87.65698
233,4,16,true,12,21,9,41.88309,-87.6511
13409,4,16,true,56,56,0,41.8831,-87.6511
18,4,16,true,18,4,-14,41.88317,-87.63735
KA1503000072,4,16,true,129,32,-97,41.88317,-87.63693
91,4,16,true,16,52,36,41.88336,-87.64122
WL-012,4,16,true,188,426,238,41.88337,-87.6412
112,4,16,true,28,22,-6,41.88362,-87.6486
13053,4,16,true,81,99,18,41.88365,-87.64863
43,4,16,true,10,15,5,41.88396,-87.62455
13001,4,16,true,140,96,-44,41.88397,-87.62459
13155,4,16,true,25,26,1,41.88407,-87.65689
621,4,16,true,9,17,8,41.88412,-87.65427
18062,4,16,true,44,62,18,41.88412,-87.65427
81,4,16,true,30,21,-9,41.88417,-87.6296
TA1306000010,4,16,true,179,63,-116,41.88419,-87.62961
TA1305000030,4,16,true,225,52,-173,41.88459,-87.63178
96,4,16,true,11,9,-2,41.8846,-87.64455
15535,4,16,true,51,69,18,41.8846,-87.64455
51,4,16,true,32,10,-22,41.88462,-87.63176
TA1305000029,4,16,true,122,121,-1,41.88466,-87.62787
195,4,16,true,25,27,2,41.88466,-87.61952
13263,4,16,true,134,116,-18,41.88467,-87.61952
44,4,16,true,18,16,-2,41.88468,-87.62782
TA1306000015,4,16,true,139,103,-36,41.88549,-87.65232
71,4,16,true,20,13,-7,41.8855,-87.65233
66,4,16,true,19,16,-3,41.88557,-87.64186
13021,4,16,true,141,121,-20,41.88559,-87.64184
TA1307000111,4,16,true,223,68,-155,41.88582,-87.63548
164,4,16,true,42,14,-28,41.88583,-87.63547
13073,4,16,true,21,19,-2,41.88592,-87.66717
KA17018054,4,16,true,22,5,-17,41.88595,-87.67701
KA1503000012,4,16,true,107,68,-39,41.88599,-87.63089
38,4,16,true,29,24,-5,41.88599,-87.63089
52,4,16,true,36,20,-16,41.886,-87.62421
TA1305000011,4,16,true,180,75,-105,41.886,-87.62418
7,4,16,true,27,21,-6,41.88627,-87.61751
15534,4,16,true,84,82,-2,41.88627,-87.61749
217,4,16,true,13,4,-9,41.8866,-87.65821
13197,4,16,true,50,21,-29,41.8866,-87.65816
264,4,16,true,23,7,-16,41.8867,-87.62224
TA1308000029,4,16,true,96,53,-43,41.88673,-87.62225
TA1307000131,4,16,true,105,32,-73,41.88688,-87.62606
194,4,16,true,19,6,-13,41.88688,-87.62606
KA1503000064,4,16,true,42,50,8,41.88697,-87.61281
100,4,16,true,24,18,-6,41.88814,-87.63657
TA1305000022,4,16,true,175,71,-104,41.88817,-87.63656
56,4,16,true,44,40,-4,41.88866,-87.64442
TA1306000003,4,16,true,152,149,-3,41.88867,-87.64442
133,4,16,true,31,57,26,41.88918,-87.63851
KA1503000043,4,16,true,239,280,41,41.88918,-87.63851
13050,4,16,true,134,86,-48,41.88919,-87.62775
47,4,16,true,33,11,-22,41.88921,-87.62775
15664,4,16,true,9,35,26,41.8895,-87.68821
376,4,16,true,6,13,7,41.88951,-87.68818
13432,4,16,true,33,49,16,41.88989,-87.67149
TA1307000151,4,16,true,154,95,-59,41.88993,-87.63427
212,4,16,true,27,20,-7,41.88995,-87.63427
636,4,16,true,77,67,-10,41.88997,-87.63662
125,4,16,true,19,4,-15,41.89018,-87.62621
KA1503000044,4,16,true,88,35,-53,41.89018,-87.6262
196,4,16,true,10,12,2,41.89053,-87.62205
13427,4,16,true,50,61,11,41.89054,-87.62205
26,4,16,true,15,23,8,41.89057,-87.61798
13430,4,16,true,98,98,0,41.89077,-87.63169
181,4,16,true,29,15,-14,41.89077,-87.63168
TA1306000013,4,16,true,95,108,13,41.89083,-87.61852
RN-,4,16,true,74,81,7,41.89102,-87.63546
672,4,16,true,15,24,9,41.89102,-87.63545
277,4,16,true,4,12,8,41.89108,-87.66665
13434,4,16,true,25,41,16,41.89108,-87.66663
TA1308000006,4,16,true,29,32,3,41.89128,-87.67686
199,4,16,true,38,30,-8,41.89143,-87.62676
TA1307000117,4,16,true,168,116,-52,41.89144,-87.62675
13033,4,16,true,90,124,34,41.8916,-87.64835
84,4,16,true,14,19,5,41.89161,-87.64833
186,4,16,true,18,19,1,41.8918,-87.65879
13194,4,16,true,69,77,8,41.8918,-87.65878
TA1305000003,4,16,true,151,106,-45,41.89187,-87.62061
24,4,16,true,29,18,-11,41.8919,-87.62063
643,4,16,true,12,29,17,41.89203,-87.68939
35,4,16,true,18,21,3,41.89227,-87.61206
13022,4,16,true,134,95,-39,41.89227,-87.61205
99,4,16,true,11,16,5,41.89255,-87.61449
TA1306000029,4,16,true,92,83,-9,41.89256,-87.61449
13265,4,16,true,144,121,-23,41.89383,-87.64172
74,4,16,true,19,31,12,41.89384,-87.64173
13045,4,16,true,200,171,-29,41.89403,-87.62931
110,4,16,true,35,35,0,41.89406,-87.6293
13016,4,16,true,485,67,-418,41.89431,-87.62277
211,4,16,true,118,9,-109,41.89439,-87.62267
KA1503000041,4,16,true,224,68,-156,41.89452,-87.61798
142,4,16,true,62,12,-50,41.89453,-87.61806
92,4,16,true,10,15,5,41.89455,-87.65346
13196,4,16,true,60,63,3,41.89455,-87.65345
TA1307000062,4,16,true,107,79,-28,41.89466,-87.63839
111,4,16,true,25,13,-12,41.89466,-87.63837
TA1306000012,4,16,true,166,159,-7,41.89475,-87.63438
53,4,16,true,36,17,-19,41.89476,-87.63439
627,4,16,true,16,19,3,41.8948,-87.63231
KP1705001026,4,16,true,85,76,-9,41.89483,-87.6323
18058,4,16,true,12,28,16,41.8955,-87.68201
637,4,16,true,25,59,34,41.89563,-87.67209
128,4,16,true,5,14,9,41.89571,-87.67716
13132,4,16,true,41,77,36,41.89573,-87.67718
161,4,16,true,24,12,-12,41.89574,-87.62599
15530,4,16,true,123,79,-44,41.89575,-87.62596
18003,4,16,true,122,31,-91,41.89575,-87.62011
635,4,16,true,19,6,-13,41.89576,-87.62012
13247,4,16,true,41,61,20,41.89597,-87.66775
350,4,16,true,10,15,5,41.89597,-87.66774
TA1305000020,4,16,true,60,63,3,41.89636,-87.65406
54,4,16,true,17,8,-9,41.89637,-87.65407
13289,4,16,true,47,71,24,41.89638,-87.661
86,4,16,true,10,19,9,41.89639,-87.661
337,4,16,true,27,14,-13,41.89659,-87.63096
13303,4,16,true,84,64,-20,41.89672,-87.63088
13017,4,16,true,106,104,-2,41.89676,-87.6357
31,4,16,true,28,25,-3,41.89677,-87.63572
13338,4,16,true,124,57,-67,41.89697,-87.62173
173,4,16,true,32,15,-17,41.89704,-87.62173
TA1307000061,4,16,true,61,47,-14,41.89745,-87.62873
106,4,16,true,28,10,-18,41.89746,-87.62874
25,4,16,true,24,7,-17,41.89751,-87.62354
13034,4,16,true,89,38,-51,41.89754,-87.62352
48,4,16,true,36,14,-22,41.89772,-87.64302
TA1306000009,4,16,true,263,72,-191,41.89772,-87.64299
620,4,16,true,60,73,13,41.89817,-87.63754
374,4,16,true,11,12,1,41.89842,-87.68659
KA1504000103,4,16,true,27,44,17,41.89842,-87.68659
145,4,16,true,26,16,-10,41.89856,-87.62211
15529,4,16,true,132,78,-54,41.89858,-87.62206
140,4,16,true,41,29,-12,41.89895,-87.6299
TA1307000128,4,16,true,137,146,9,41.89896,-87.6299
657,4,16,true,37,48,11,41.89918,-87.6722
KA1504000117,4,16,true,28,18,-10,41.89936,-87.64848
13248,4,16,true,22,35,13,41.89964,-87.66788
46,4,16,true,9,16,7,41.89994,-87.63444
TA1306000011,4,16,true,44,62,18,41.89994,-87.63443
364,4,16,true,5,11,6,41.90023,-87.64299
KA1504000116,4,16,true,59,69,10,41.90023,-87.64299
17660,4,16,true,17,28,11,41.90036,-87.69671
13290,4,16,true,48,54,6,41.90069,-87.66259
13042,4,16,true,158,92,-66,41.90097,-87.62377
85,4,16,true,36,14,-22,41.90098,-87.62375
183,4,16,true,6,14,8,41.90133,-87.67744
TA1307000070,4,16,true,30,42,12,41.90133,-87.67742
KA1504000133,4,16,true,82,120,38,41.90234,-87.62773
172,4,16,true,19,18,-1,41.90236,-87.62774
15654,4,16,true,13,6,-7,41.90271,-87.70923
13241,4,16,true,25,19,-6,41.9029,-87.68731
176,4,16,true,44,57,13,41.90291,-87.63141
TA1306000006,4,16,true,26,39,13,41.90292,-87.63772
TA1307000039,4,16,true,175,261,86,41.90294,-87.63137
658,4,16,true,45,19,-26,41.903,-87.6838
13256,4,16,true,21,15,-6,41.90302,-87.69749
17,4,16,true,12,19,7,41.90313,-87.67391
TA1305000034,4,16,true,40,60,20,41.90313,-87.67391
182,4,16,true,31,42,11,41.90317,-87.63442
KA1504000135,4,16,true,146,206,60,41.90319,-87.63439
13136,4,16,true,46,42,-4,41.90326,-87.67845
210,4,16,true,27,29,2,41.90342,-87.66781
13061,4,16,true,106,128,22,41.90342,-87.66779
KA1504000079,4,16,true,83,68,-15,41.9035,-87.64334
359,4,16,true,17,17,0,41.90458,-87.6497
138,4,16,true,8,19,11,41.9046,-87.64057
TA1307000115,4,16,true,61,57,-4,41.9046,-87.64056
291,4,16,true,14,30,16,41.90672,-87.63494
TA1308000049,4,16,true,90,118,28,41.90672,-87.6349
KA1504000134,4,16,true,57,92,35,41.90687,-87.6262
180,4,16,true,14,16,2,41.90687,-87.62618
333,4,16,true,10,23,13,41.90706,-87.66725
13224,4,16,true,32,50,18,41.90706,-87.66725
18069,4,16,true,26,4,-22,41.90722,-87.65563
TA1307000143,4,16,true,11,28,17,41.90762,-87.63854
61,4,16,true,12,16,4,41.90764,-87.67254
13221,4,16,true,44,81,37,41.90765,-87.67254
301,4,16,true,17,27,10,41.90796,-87.63203
TA1309000024,4,16,true,81,132,51,41.908,-87.63152
69,4,16,true,15,18,3,41.90939,-87.6777
TA1305000041,4,16,true,81,87,6,41.9094,-87.67769
331,4,16,true,150,154,4,41.90965,-87.64812
15653,4,16,true,15,11,-4,41.90979,-87.7053
TA1305000037,4,16,true,47,80,33,41.91018,-87.67003
TA1306000008,4,16,true,31,37,6,41.9102,-87.6435
16,4,16,true,15,12,-3,41.91035,-87.67008
TA1308000005,4,16,true,43,33,-10,41.91042,-87.68238
13258,4,16,true,21,30,9,41.91043,-87.69718
13257,4,16,true,16,33,17,41.91054,-87.68956
13154,4,16,true,82,90,8,41.91054,-87.65312
20,4,16,true,16,18,2,41.91055,-87.65313
13058,4,16,true,76,45,-31,41.91059,-87.64942
60,4,16,true,20,21,1,41.91059,-87.64942
118,4,16,true,14,18,4,41.91138,-87.63868
TA1307000038,4,16,true,59,77,18,41.91138,-87.63868
268,4,16,true,28,23,-5,41.91172,-87.62681
LF-005,4,16,true,95,105,10,41.91172,-87.62681
126,4,16,true,6,12,6,41.91196,-87.63197
13128,4,16,true,46,47,1,41.91197,-87.63197
289,4,16,true,29,33,4,41.91209,-87.63472
TA1308000050,4,16,true,155,232,77,41.91211,-87.6347
13243,4,16,true,66,62,-4,41.91262,-87.6814
158,4,16,true,10,18,8,41.91262,-87.6814
TA1309000032,4,16,true,18,13,-5,41.91293,-87.66417
TA1306000032,4,16,true,76,79,3,41.9137,-87.65285
93,4,16,true,13,14,1,41.91371,-87.65285
224,4,16,true,4,12,8,41.91386,-87.64877
TA1307000166,4,16,true,47,67,20,41.91386,-87.64877
15655,4,16,true,27,32,5,41.91401,-87.70514
18017,4,16,true,14,23,9,41.91416,-87.71676
18067,4,16,true,45,45,0,41.9146,-87.66796
TA1306000007,4,16,true,28,31,3,41.91469,-87.64333
28,4,16,true,8,16,8,41.91469,-87.64333
13068,4,16,true,47,48,1,41.91554,-87.68703
116,4,16,true,6,16,10,41.91555,-87.68703
13179,4,16,true,95,86,-9,41.9157,-87.63461
141,4,16,true,19,22,3,41.91571,-87.63461
219,4,16,true,9,13,4,41.91598,-87.67733
13133,4,16,true,54,81,27,41.91598,-87.67733
TA1305000039,4,16,true,38,38,0,41.9163,-87.66749
15650,4,16,true,15,11,-4,41.91711,-87.71023
15651,4,16,true,12,36,24,41.91752,-87.70181
185,4,16,true,5,10,5,41.91774,-87.69143
13266,4,16,true,13,24,11,41.91774,-87.69142
TA1309000029,4,16,true,25,15,-10,41.9178,-87.68245
288,4,16,true,14,10,-4,41.91809,-87.64375
TA1309000006,4,16,true,54,61,7,41.91809,-87.64375
223,4,16,true,10,18,8,41.91821,-87.65698
TA1307000163,4,16,true,55,92,37,41.91821,-87.65696
94,4,16,true,23,25,2,41.91831,-87.6363
13146,4,16,true,85,112,27,41.91831,-87.63629
13059,4,16,true,95,92,-3,41.91845,-87.65222
113,4,16,true,20,16,-4,41.91846,-87.65222
13259,4,16,true,10,19,9,41.91852,-87.69744
225,4,16,true,17,19,2,41.91995,-87.64884
13192,4,16,true,46,72,26,41.91995,-87.64884
13288,4,16,true,20,24,4,41.92008,-87.67788
13242,4,16,true,16,16,0,41.92021,-87.69266
TA1309000030,4,16,true,44,74,30,41.92077,-87.66372
13292,4,16,true,13,23,10,41.92152,-87.70733
TA1309000033,4,16,true,65,90,25,41.92158,-87.65381
13193,4,16,true,98,135,37,41.92182,-87.64412
144,4,16,true,21,24,3,41.92182,-87.64411
13191,4,16,true,80,77,-3,41.92217,-87.63891
143,4,16,true,14,23,9,41.92217,-87.63891
327,4,16,true,11,12,1,41.92225,-87.65783
13084,4,16,true,39,37,-2,41.92268,-87.69715
LP-,4,16,true,44,40,-4,41.92396,-87.63584
673,4,16,true,12,16,4,41.92398,-87.63585
KA1504000140,4,16,true,25,22,-3,41.92409,-87.67646
15648,4,16,true,19,23,4,41.92464,-87.68931
KA1504000090,4,16,true,8,19,11,41.92483,-87.7145
TA1307000001,4,16,true,65,59,-6,41.92535,-87.66581
188,4,16,true,11,16,5,41.92536,-87.66581
TA1306000026,4,16,true,79,58,-21,41.92558,-87.65842
87,4,16,true,13,11,-2,41.92559,-87.65843
TA1306000016,4,16,true,126,103,-23,41.9256,-87.65371
67,4,16,true,17,9,-8,41.9256,-87.65371
313,4,16,true,20,27,7,41.9257,-87.64246
TA1309000019,4,16,true,80,126,46,41.92586,-87.63897
TA1309000058,4,16,true,99,122,23,41.92591,-87.64927
127,4,16,true,17,25,8,41.92592,-87.64927
177,4,16,true,47,37,-10,41.92627,-87.63086
TA1308000001,4,16,true,98,108,10,41.92627,-87.63086
502,4,16,true,11,7,-4,41.92667,-87.69772
15646,4,16,true,19,23,4,41.92668,-87.6977
13124,4,16,true,13,14,1,41.92675,-87.63444
302,4,16,true,6,15,9,41.92859,-87.65421
TA1309000023,4,16,true,46,46,0,41.9287,-87.65383
TA1307000113,4,16,true,47,48,1,41.92878,-87.66391
190,4,16,true,13,6,-7,41.92878,-87.6639
13296,4,16,true,30,38,8,41.92883,-87.66852
343,4,16,true,13,12,-1,41.92889,-87.65898
TA1309000059,4,16,true,29,45,16,41.92889,-87.65898
349,4,16,true,15,18,3,41.92915,-87.6491
TA1309000061,4,16,true,74,70,-4,41.92915,-87.64909
TA1308000031,4,16,true,22,27,5,41.92946,-87.68417
TA1305000014,4,16,true,105,106,1,41.92956,-87.64313
340,4,16,true,23,25,2,41.92956,-87.64313
260,4,16,true,12,14,2,41.92958,-87.70791
13085,4,16,true,33,37,4,41.92958,-87.70789
15643,4,16,true,3,12,9,41.93057,-87.7238
TA1307000142,4,16,true,100,117,17,41.93125,-87.64432
220,4,16,true,27,28,1,41.93125,-87.64431
13276,4,16,true,73,93,20,41.93132,-87.63874
324,4,16,true,20,21,1,41.93173,-87.64179
15645,4,16,true,8,15,7,41.93191,-87.70121
163,4,16,true,5,10,5,41.93191,-87.67784
13271,4,16,true,20,39,19,41.93192,-87.67784
152,4,16,true,18,11,-7,41.93221,-87.65864
TA1307000064,4,16,true,70,76,6,41.93222,-87.65864
13,4,16,true,17,12,-5,41.93242,-87.65271
TA1306000014,4,16,true,62,81,19,41.93242,-87.65271
329,4,16,true,17,24,7,41.93258,-87.63642
TA1309000039,4,16,true,95,122,27,41.93258,-87.63642
13294,4,16,true,57,65,8,41.9326,-87.66595
332,4,16,true,12,19,7,41.93313,-87.64776
TA1309000036,4,16,true,57,69,12,41.93313,-87.64776
15644,4,16,true,13,11,-2,41.93534,-87.71687
TA1307000006,4,16,true,49,35,-14,41.93571,-87.6636
153,4,16,true,11,10,-1,41.93575,-87.66364
13268,4,16,true,21,18,-3,41.93588,-87.67843
250,4,16,true,12,7,-5,41.93609,-87.66984
13269,4,16,true,24,41,17,41.93609,-87.66983
TA1307000052,4,16,true,116,62,-54,41.93628,-87.65266
115,4,16,true,23,23,0,41.93628,-87.65266
156,4,16,true,29,35,6,41.9365,-87.64756
TA1307000136,4,16,true,107,114,7,41.9365,-87.64755
TA1307000041,4,16,true,89,86,-3,41.93669,-87.63683
157,4,16,true,23,29,6,41.9367,-87.63683
13137,4,16,true,136,155,19,41.9376,-87.6441
300,4,16,true,42,44,2,41.93761,-87.6441
15642,4,16,true,4,13,9,41.93843,-87.69801
154,4,16,true,12,8,-4,41.93912,-87.66384
KA17018068,4,16,true,23,18,-5,41.93935,-87.68327
TA1309000042,4,16,true,44,79,35,41.93937,-87.66836
131,4,16,true,7,13,6,41.93937,-87.66835
13229,4,16,true,43,36,-7,41.93946,-87.66376
226,4,16,true,12,7,-5,41.93972,-87.65886
TA1308000019,4,16,true,52,48,-4,41.93973,-87.65886
296,4,16,true,15,25,10,41.9401,-87.64546
13277,4,16,true,63,76,13,41.9401,-87.64546
TA1307000134,4,16,true,97,85,-12,41.94016,-87.65303
117,4,16,true,26,27,1,41.94016,-87.65302
13143,4,16,true,15,19,4,41.94059,-87.67853
334,4,16,true,17,24,7,41.94076,-87.63919
TA1309000049,4,16,true,83,90,7,41.94077,-87.63919
15634,4,16,true,26,11,-15,41.94304,-87.68729
TA1307000138,4,16,true,49,61,12,41.94334,-87.67094
230,4,16,true,11,17,6,41.94335,-87.67093
13144,4,16,true,25,31,6,41.9434,-87.67964
299,4,16,true,19,17,-2,41.94368,-87.64894
TA1309000025,4,16,true,82,97,15,41.94368,-87.64894
229,4,16,true,23,26,3,41.94372,-87.66401
13071,4,16,true,85,84,-1,41.94373,-87.66401
632,4,16,true,79,101,22,41.94453,-87.6547
303,4,16,true,25,21,-4,41.94522,-87.64702
15631,4,16,true,13,14,1,41.94524,-87.70665
13278,4,16,true,86,98,12,41.94553,-87.64644
TA1309000050,4,16,true,9,13,4,41.94618,-87.67331
15632,4,16,true,36,11,-25,41.94664,-87.69463
KA1504000143,4,16,true,12,13,1,41.94664,-87.68337
227,4,16,true,18,21,3,41.94813,-87.66397
13235,4,16,true,97,71,-26,41.94814,-87.66396
304,4,16,true,28,27,-1,41.94878,-87.64922
13253,4,16,true,39,28,-11,41.9488,-87.67527
13325,4,16,true,102,110,8,41.94907,-87.64863
114,4,16,true,11,16,5,41.94935,-87.65451
TA1307000126,4,16,true,77,80,3,41.94936,-87.65451
232,4,16,true,22,18,-4,41.94943,-87.64645
TA1307000150,4,16,true,87,132,45,41.94945,-87.64646
13319,4,16,true,51,59,8,41.95069,-87.6687
TA1307000127,4,16,true,50,50,0,41.9508,-87.65918
165,4,16,true,13,13,0,41.95081,-87.65918
15628,4,16,true,15,8,-7,41.95216,-87.69806
13323,4,16,true,56,44,-12,41.95282,-87.65
256,4,16,true,9,15,6,41.95282,-87.65
15624,4,16,true,10,3,-7,41.95339,-87.73199
314,4,16,true,15,8,-7,41.9535,-87.69199
590,4,16,true,11,5,-6,41.95374,-87.74056
TA1309000043,4,16,true,30,33,3,41.95417,-87.66434
240,4,16,true,14,14,0,41.95424,-87.65441
13063,4,16,true,56,66,10,41.95424,-87.65441
KA1504000158,4,16,true,4,35,31,41.95432,-87.68607
254,4,16,true,20,24,4,41.95438,-87.64806
TA1308000022,4,16,true,81,77,-4,41.95438,-87.64805
TA1307000149,4,16,true,38,29,-9,41.95467,-87.67392
298,4,16,true,16,7,-9,41.95601,-87.68021
TA1309000026,4,16,true,31,52,21,41.95601,-87.6802
13249,4,16,true,9,14,5,41.95606,-87.66885
312,4,16,true,12,13,1,41.95637,-87.6563
TA1308000047,4,16,true,26,18,-8,41.95709,-87.6642
13379,4,16,true,81,75,-6,41.95786,-87.6495
TA1309000018,4,16,true,29,17,-12,41.95791,-87.67357
306,4,16,true,18,10,-8,41.9585,-87.655
TA1309000027,4,16,true,37,51,14,41.9585,-87.65499
13389,4,16,true,60,37,-23,41.961,-87.64958
245,4,16,true,16,14,-2,41.96101,-87.64958
15621,4,16,true,15,21,6,41.96103,-87.70586
15622,4,16,true,12,4,-8,41.96108,-87.69544
TA1307000144,4,16,true,32,26,-6,41.96142,-87.6762
TA1309000021,4,16,true,15,21,6,41.9615,-87.6714
15623,4,16,true,23,17,-6,41.96154,-87.69117
KA1503000022,4,16,true,30,32,2,41.96158,-87.66609
231,4,16,true,19,10,-9,41.96163,-87.65464
TA1307000107,4,16,true,87,85,-2,41.96164,-87.65464
TA1307000156,4,16,true,20,25,5,41.96301,-87.68479
TA1309000012,4,16,true,17,17,0,41.96325,-87.67928
249,4,16,true,23,14,-9,41.96398,-87.63818
TA1308000012,4,16,true,60,70,10,41.96398,-87.63818
13074,4,16,true,54,37,-17,41.96521,-87.6582
639,4,16,true,53,56,3,41.96584,-87.64538
KA1504000127,4,16,true,9,12,3,41.96587,-87.70083
KA1504000093,4,16,true,17,42,25,41.96587,-87.69365
TA1307000140,4,16,true,30,44,14,41.96643,-87.68865
239,4,16,true,15,16,1,41.9665,-87.68843
326,4,16,true,13,9,-4,41.96665,-87.67113
TA1309000014,4,16,true,54,71,17,41.96709,-87.66744
TA1307000158,4,16,true,64,27,-37,41.9671,-87.67904
251,4,16,true,13,6,-7,41.96796,-87.65
TA1307000119,4,16,true,30,30,0,41.96796,-87.65
TA1308000021,4,16,true,31,22,-9,41.96883,-87.65765
KA1504000080,4,16,true,23,25,2,41.96887,-87.69609
TA1309000015,4,16,true,20,20,0,41.96889,-87.68401
TA1309000066,4,16,true,84,51,-33,41.9691,-87.67423
344,4,16,true,20,18,-2,41.9691,-87.67423
TA1309000041,4,16,true,37,26,-11,41.96951,-87.65471
465,4,16,true,15,12,-3,41.97161,-87.65016
KA1504000171,4,16,true,33,33,0,41.97161,-87.65016
325,4,16,true,12,16,4,41.9728,-87.67186
TA1309000035,4,16,true,60,67,7,41.97335,-87.66785
13108,4,16,true,51,36,-15,41.97379,-87.65971
KA1504000078,4,16,true,17,14,-3,41.97491,-87.69258
KA1504000149,4,16,true,20,23,3,41.97562,-87.67945
KA1504000160,4,16,true,15,9,-6,41.97564,-87.70143
KA1504000146,4,16,true,43,43,0,41.978,-87.66805
463,4,16,true,11,16,5,41.978,-87.66805
294,4,16,true,15,9,-6,41.97835,-87.65976
13109,4,16,true,39,46,7,41.97835,-87.65976
KA1504000147,4,16,true,18,14,-4,41.97976,-87.67754
655,4,16,true,27,15,-12,41.97987,-87.68194
460,4,16,true,12,8,-4,41.98358,-87.66916
KA1504000151,4,16,true,47,26,-21,41.98359,-87.66916
459,4,16,true,21,24,3,41.98403,-87.65231
KA1504000152,4,16,true,80,99,19,41.98403,-87.65231
15578,4,16,true,49,23,-26,41.98405,-87.66027
461,4,16,true,8,11,3,41.98405,-87.66027
15575,4,16,true,38,30,-8,41.98975,-87.66014
458,4,16,true,15,9,-6,41.98975,-87.66013
KA1504000148,4,16,true,15,17,2,41.99086,-87.66971
15571,4,16,true,39,41,2,41.99478,-87.66028
454,4,16,true,8,10,2,41.99478,-87.66027
KA1504000156,4,16,true,11,4,-7,41.99925,-87.67137
RP-009,4,16,true,19,21,2,42.00107,-87.66122
660,4,16,true,23,27,4,42.00458,-87.66143
KA1504000175,4,16,true,18,41,23,42.00797,-87.66549
447,4,16,true,4,13,9,42.00797,-87.66548
RP-005,4,16,true,18,5,-13,42.0086,-87.69047
KA1504000162,4,16,true,23,15,-8,42.00907,-87.67422
KA1504000159,4,16,true,6,15,9,42.01059,-87.66241
525,4,16,true,19,13,-6,42.01272,-87.66605
517,4,16,true,10,5,-5,42.01597,-87.675
520,4,16,true,31,27,-4,42.01597,-87.66859
515,4,16,true,17,13,-4,42.01915,-87.67356
523,4,16,true,27,34,7,42.02089,-87.66505
E002,4,16,true,28,42,14,42.03256,-87.67912
599,4,16,true,17,8,-9,42.03972,-87.69942
596,4,16,true,31,41,10,42.04822,-87.68348
E008,4,16,true,10,19,9,42.05049,-87.67782
605,4,16,true,32,9,-23,42.05294,-87.67342
661,4,16,true,18,15,-3,42.05704,-87.68657
604,4,16,true,30,24,-6,42.05824,-87.67744
KA1503000014,5,8,false,18,8,-10,41.7851,-87.60108
TA1309000011,5,8,false,3,16,13,41.78873,-87.60131
KA1503000071,5,8,false,3,15,12,41.79148,-87.59988
TA1309000063,5,8,false,16,6,-10,41.79325,-87.5878
KA1504000076,5,8,false,7,14,7,41.7943,-87.60145
TA1308000009,5,8,false,14,2,-12,41.79522,-87.58075
TA1307000164,5,8,false,9,10,1,41.79527,-87.59647
KA1503000059,5,8,false,8,11,3,41.79952,-87.58643
TA1309000037,5,8,false,10,9,-1,41.79957,-87.59474
KA1503000007,5,8,false,7,10,3,41.80242,-87.58689
121,5,8,false,10,2,-8,41.80256,-87.59035
13398,5,8,false,13,7,-6,41.80256,-87.59035
TA1307000048,5,8,false,13,10,-3,41.83855,-87.60821
13102,5,8,false,12,4,-8,41.85762,-87.61942
13150,5,8,false,12,5,-7,41.85783,-87.62455
TA1307000124,5,8,false,14,9,-5,41.86411,-87.62372
TA1305000002,5,8,false,17,14,-3,41.86721,-87.62597
15544,5,8,false,16,33,17,41.86723,-87.61536
SL-005,5,8,false,39,20,-19,41.8679,-87.62304
13285,5,8,false,3,11,8,41.86928,-87.67372
TA1309000010,5,8,false,30,18,-12,41.87074,-87.62574
TA1309000064,5,8,false,3,14,11,41.87127,-87.67369
SL-008,5,8,false,33,6,-27,41.87209,-87.62956
SL-011,5,8,false,17,9,-8,41.87256,-87.63356
623,5,8,false,27,16,-11,41.87272,-87.62399
KA1504000104,5,8,false,5,12,7,41.87296,-87.66912
SL-007,5,8,false,16,4,-12,41.87404,-87.6277
SL-010,5,8,false,4,10,6,41.87501,-87.63309
15541,5,8,false,10,5,-5,41.8758,-87.62086
TA1305000010,5,8,false,9,15,6,41.87623,-87.62444
TA1305000035,5,8,false,15,3,-12,41.87716,-87.62787
13138,5,8,false,9,14,5,41.87723,-87.63941
15539,5,8,false,15,4,-11,41.87763,-87.64405
13158,5,8,false,21,19,-2,41.87764,-87.64957
TA1305000025,5,8,false,21,34,13,41.87773,-87.63528
TA1309000004,5,8,false,8,30,22,41.87811,-87.63184
638,5,8,false,11,33,22,41.87827,-87.64078
TA1305000005,5,8,false,19,19,0,41.87924,-87.62975
13011,5,8,false,21,30,9,41.87931,-87.63993
TA1309000008,5,8,false,14,20,6,41.87933,-87.6355
KA1503000034,5,8,false,12,10,-2,41.87938,-87.63197
KA1503000015,5,8,false,8,15,7,41.87948,-87.6257
287,5,8,false,2,11,9,41.88017,-87.63527
TA1309000007,5,8,false,9,63,54,41.88022,-87.63526
WL-011,5,8,false,8,12,4,41.88034,-87.64273
13156,5,8,false,11,14,3,41.88042,-87.65554
13300,5,8,false,31,20,-11,41.88097,-87.61675
13008,5,8,false,27,28,1,41.88105,-87.62408
TA1305000006,5,8,false,17,41,24,41.88122,-87.6296
13056,5,8,false,18,13,-5,41.88168,-87.63951
TA1307000120,5,8,false,19,21,2,41.88188,-87.64879
13341,5,8,false,22,17,-5,41.88208,-87.63985
13036,5,8,false,10,17,7,41.8821,-87.62513
TA1305000032,5,8,false,28,33,5,41.88218,-87.64109
13006,5,8,false,17,24,7,41.88268,-87.63252
13353,5,8,false,19,12,-7,41.88283,-87.6612
13409,5,8,false,10,11,1,41.8831,-87.6511
KA1503000072,5,8,false,25,35,10,41.88317,-87.63693
WL-012,5,8,false,27,27,0,41.88337,-87.6412
13053,5,8,false,16,21,5,41.88365,-87.64863
13001,5,8,false,43,27,-16,41.88397,-87.62459
13155,5,8,false,11,13,2,41.88407,-87.65689
18062,5,8,false,17,28,11,41.88412,-87.65427
81,5,8,false,7,10,3,41.88417,-87.6296
TA1306000010,5,8,false,13,26,13,41.88419,-87.62961
TA1305000030,5,8,false,22,50,28,41.88459,-87.63178
15535,5,8,false,12,19,7,41.8846,-87.64455
TA1305000029,5,8,false,12,17,5,41.88466,-87.62787
13263,5,8,false,20,24,4,41.88467,-87.61952
TA1306000015,5,8,false,27,52,25,41.88549,-87.65232
13021,5,8,false,29,40,11,41.88559,-87.64184
TA1307000111,5,8,false,13,51,38,41.88582,-87.63548
13073,5,8,false,1,17,16,41.88592,-87.66717
KA17018054,5,8,false,4,16,12,41.88595,-87.67701
KA1503000012,5,8,false,14,32,18,41.88599,-87.63089
TA1305000011,5,8,false,40,35,-5,41.886,-87.62418
15534,5,8,false,14,13,-1,41.88627,-87.61749
13197,5,8,false,10,19,9,41.8866,-87.65816
TA1308000029,5,8,false,16,19,3,41.88673,-87.62225
TA1307000131,5,8,false,24,11,-13,41.88688,-87.62606
KA1503000064,5,8,false,21,16,-5,41.88697,-87.61281
TA1305000022,5,8,false,24,23,-1,41.88817,-87.63656
TA1306000003,5,8,false,43,22,-21,41.88867,-87.64442
KA1503000043,5,8,false,40,43,3,41.88918,-87.63851
13050,5,8,false,33,37,4,41.88919,-87.62775
TA1307000151,5,8,false,27,33,6,41.88993,-87.63427
636,5,8,false,16,20,4,41.88997,-87.63662
KA1503000044,5,8,false,19,22,3,41.89018,-87.6262
13427,5,8,false,21,26,5,41.89054,-87.62205
13430,5,8,false,13,24,11,41.89077,-87.63169
TA1306000013,5,8,false,32,28,-4,41.89083,-87.61852
RN-,5,8,false,17,42,25,41.89102,-87.63546
13434,5,8,false,14,7,-7,41.89108,-87.66663
TA1308000006,5,8,false,17,12,-5,41.89128,-87.67686
199,5,8,false,4,10,6,41.89143,-87.62676
TA1307000117,5,8,false,22,39,17,41.89144,-87.62675
13033,5,8,false,13,27,14,41.8916,-87.64835
13194,5,8,false,16,1,-15,41.8918,-87.65878
TA1305000003,5,8,false,43,37,-6,41.89187,-87.62061
13022,5,8,false,51,37,-14,41.89227,-87.61205
TA1306000029,5,8,false,32,23,-9,41.89256,-87.61449
13265,5,8,false,20,26,6,41.89383,-87.64172
13045,5,8,false,41,44,3,41.89403,-87.62931
13016,5,8,false,42,40,-2,41.89431,-87.62277
211,5,8,false,3,11,8,41.89439,-87.62267
KA1503000041,5,8,false,53,29,-24,41.89452,-87.61798
13196,5,8,false,24,8,-16,41.89455,-87.65345
TA1307000062,5,8,false,27,13,-14,41.89466,-87.63839
TA1306000012,5,8,false,52,32,-20,41.89475,-87.63438
KP1705001026,5,8,false,22,27,5,41.89483,-87.6323
637,5,8,false,14,8,-6,41.89563,-87.67209
13132,5,8,false,12,13,1,41.89573,-87.67718
15530,5,8,false,26,24,-2,41.89575,-87.62596
18003,5,8,false,10,10,0,41.89575,-87.62011
13247,5,8,false,13,7,-6,41.89597,-87.66775
TA1305000020,5,8,false,11,18,7,41.89636,-87.65406
13289,5,8,false,10,4,-6,41.89638,-87.661
13303,5,8,false,15,14,-1,41.89672,-87.63088
13017,5,8,false,28,27,-1,41.89676,-87.6357
13338,5,8,false,49,24,-25,41.89697,-87.62173
TA1307000061,5,8,false,22,13,-9,41.89745,-87.62873
13034,5,8,false,25,14,-11,41.89754,-87.62352
TA1306000009,5,8,false,26,37,11,41.89772,-87.64299
620,5,8,false,21,12,-9,41.89817,-87.63754
KA1504000103,5,8,false,16,4,-12,41.89842,-87.68659
15529,5,8,false,26,17,-9,41.89858,-87.62206
TA1307000128,5,8,false,19,32,13,41.89896,-87.6299
657,5,8,false,10,3,-7,41.89918,-87.6722
KA1504000117,5,8,false,2,12,10,41.89936,-87.64848
13248,5,8,false,10,5,-5,41.89964,-87.66788
TA1306000011,5,8,false,12,7,-5,41.89994,-87.63443
KA1504000116,5,8,false,11,3,-8,41.90023,-87.64299
13290,5,8,false,18,5,-13,41.90069,-87.66259
13042,5,8,false,41,50,9,41.90097,-87.62377
85,5,8,false,12,4,-8,41.90098,-87.62375
TA1307000070,5,8,false,21,2,-19,41.90133,-87.67742
KA1504000133,5,8,false,20,11,-9,41.90234,-87.62773
176,5,8,false,12,5,-7,41.90291,-87.63141
TA1307000039,5,8,false,54,35,-19,41.90294,-87.63137
658,5,8,false,10,4,-6,41.903,-87.6838
13256,5,8,false,10,5,-5,41.90302,-87.69749
TA1305000034,5,8,false,12,10,-2,41.90313,-87.67391
KA1504000135,5,8,false,41,43,2,41.90319,-87.63439
13136,5,8,false,10,12,2,41.90326,-87.67845
13061,5,8,false,42,31,-11,41.90342,-87.66779
KA1504000079,5,8,false,25,8,-17,41.9035,-87.64334
TA1308000049,5,8,false,24,27,3,41.90672,-87.6349
KA1504000134,5,8,false,21,20,-1,41.90687,-87.6262
13224,5,8,false,19,10,-9,41.90706,-87.66725
TA1307000143,5,8,false,12,9,-3,41.90762,-87.63854
13221,5,8,false,18,8,-10,41.90765,-87.67254
TA1309000024,5,8,false,7,10,3,41.908,-87.63152
TA1305000041,5,8,false,18,22,4,41.9094,-87.67769
331,5,8,false,33,29,-4,41.90965,-87.64812
TA1305000037,5,8,false,16,7,-9,41.91018,-87.67003
TA1308000005,5,8,false,11,5,-6,41.91042,-87.68238
13258,5,8,false,12,5,-7,41.91043,-87.69718
13257,5,8,false,17,5,-12,41.91054,-87.68956
13154,5,8,false,10,17,7,41.91054,-87.65312
TA1307000038,5,8,false,13,12,-1,41.91138,-87.63868
LF-005,5,8,false,25,22,-3,41.91172,-87.62681
13128,5,8,false,14,11,-3,41.91197,-87.63197
TA1308000050,5,8,false,41,62,21,41.91211,-87.6347
13243,5,8,false,11,9,-2,41.91262,-87.6814
TA1306000032,5,8,false,11,14,3,41.9137,-87.65285
TA1307000166,5,8,false,7,12,5,41.91386,-87.64877
13068,5,8,false,13,7,-6,41.91554,-87.68703
13179,5,8,false,20,18,-2,41.9157,-87.63461
13133,5,8,false,8,15,7,41.91598,-87.67733
TA1305000039,5,8,false,10,8,-2,41.9163,-87.66749
15650,5,8,false,13,2,-11,41.91711,-87.71023
15651,5,8,false,9,10,1,41.91752,-87.70181
TA1309000006,5,8,false,13,13,0,41.91809,-87.64375
TA1307000163,5,8,false,13,17,4,41.91821,-87.65696
94,5,8,false,12,5,-7,41.91831,-87.6363
13146,5,8,false,31,30,-1,41.91831,-87.63629
13059,5,8,false,25,30,5,41.91845,-87.65222
13192,5,8,false,12,17,5,41.91995,-87.64884
TA1309000030,5,8,false,13,24,11,41.92077,-87.66372
13292,5,8,false,10,3,-7,41.92152,-87.70733
TA1309000033,5,8,false,12,12,0,41.92158,-87.65381
13193,5,8,false,44,19,-25,41.92182,-87.64412
13191,5,8,false,30,16,-14,41.92217,-87.63891
13084,5,8,false,9,14,5,41.92268,-87.69715
LP-,5,8,false,28,6,-22,41.92396,-87.63584
TA1307000001,5,8,false,8,19,11,41.92535,-87.66581
TA1306000026,5,8,false,14,27,13,41.92558,-87.65842
TA1306000016,5,8,false,12,20,8,41.9256,-87.65371
TA1309000019,5,8,false,31,9,-22,41.92586,-87.63897
TA1309000058,5,8,false,29,22,-7,41.92591,-87.64927
TA1308000001,5,8,false,28,18,-10,41.92627,-87.63086
TA1309000023,5,8,false,20,11,-9,41.9287,-87.65383
TA1307000113,5,8,false,16,22,6,41.92878,-87.66391
13296,5,8,false,13,2,-11,41.92883,-87.66852
TA1309000059,5,8,false,10,14,4,41.92889,-87.65898
TA1309000061,5,8,false,17,14,-3,41.92915,-87.64909
TA1305000014,5,8,false,46,39,-7,41.92956,-87.64313
13085,5,8,false,17,17,0,41.92958,-87.70789
TA1307000142,5,8,false,20,21,1,41.93125,-87.64432
13276,5,8,false,27,21,-6,41.93132,-87.63874
TA1307000064,5,8,false,19,16,-3,41.93222,-87.65864
TA1306000014,5,8,false,10,32,22,41.93242,-87.65271
TA1309000039,5,8,false,17,11,-6,41.93258,-87.63642
13294,5,8,false,15,2,-13,41.9326,-87.66595
TA1309000036,5,8,false,12,13,1,41.93313,-87.64776
TA1307000006,5,8,false,4,13,9,41.93571,-87.6636
TA1307000052,5,8,false,20,24,4,41.93628,-87.65266
TA1307000136,5,8,false,29,10,-19,41.9365,-87.64755
TA1307000041,5,8,false,29,21,-8,41.93669,-87.63683
13137,5,8,false,43,26,-17,41.9376,-87.6441
TA1309000042,5,8,false,10,12,2,41.93937,-87.66836
13229,5,8,false,7,17,10,41.93946,-87.66376
TA1308000019,5,8,false,9,16,7,41.93973,-87.65886
13277,5,8,false,15,10,-5,41.9401,-87.64546
TA1307000134,5,8,false,23,16,-7,41.94016,-87.65303
334,5,8,false,8,11,3,41.94076,-87.63919
TA1309000049,5,8,false,33,26,-7,41.94077,-87.63919
TA1307000138,5,8,false,6,13,7,41.94334,-87.67094
TA1309000025,5,8,false,15,23,8,41.94368,-87.64894
13071,5,8,false,8,16,8,41.94373,-87.66401
632,5,8,false,30,18,-12,41.94453,-87.6547
13278,5,8,false,31,30,-1,41.94553,-87.64644
13235,5,8,false,18,21,3,41.94814,-87.66396
13325,5,8,false,26,17,-9,41.94907,-87.64863
TA1307000126,5,8,false,8,17,9,41.94936,-87.65451
TA1307000150,5,8,false,19,10,-9,41.94945,-87.64646
TA1307000127,5,8,false,11,7,-4,41.9508,-87.65918
13323,5,8,false,20,13,-7,41.95282,-87.65
TA1309000043,5,8,false,10,6,-4,41.95417,-87.66434
13063,5,8,false,16,12,-4,41.95424,-87.65441
TA1308000022,5,8,false,25,11,-14,41.95438,-87.64805
13249,5,8,false,9,10,1,41.95606,-87.66885
13379,5,8,false,18,8,-10,41.95786,-87.6495
TA1309000027,5,8,false,22,12,-10,41.9585,-87.65499
13389,5,8,false,13,7,-6,41.961,-87.64958
TA1308000012,5,8,false,34,4,-30,41.96398,-87.63818
13074,5,8,false,6,14,8,41.96521,-87.6582
TA1309000014,5,8,false,10,6,-4,41.96709,-87.66744
TA1309000066,5,8,false,18,16,-2,41.9691,-87.67423
KA1504000171,5,8,false,8,10,2,41.97161,-87.65016
TA1309000035,5,8,false,9,16,7,41.97335,-87.66785
13108,5,8,false,10,6,-4,41.97379,-87.65971
KA1504000146,5,8,false,14,3,-11,41.978,-87.66805
13109,5,8,false,6,18,12,41.97835,-87.65976
KA1504000151,5,8,false,3,10,7,41.98359,-87.66916
KA1504000152,5,8,false,12,9,-3,41.98403,-87.65231
525,5,8,false,11,1,-10,42.01272,-87.66605
596,5,8,false,11,2,-9,42.04822,-87.68348
661,5,8,false,10,1,-9,42.05704,-87.68657
604,5,8,false,4,15,11,42.05824,-87.67744
KA1503000014,5,8,true,68,20,-48,41.7851,-87.60108
426,5,8,true,12,7,-5,41.7851,-87.60108
KA1503000070,5,8,true,21,13,-8,41.78794,-87.58831
328,5,8,true,7,15,8,41.78872,-87.6013
TA1309000011,5,8,true,9,49,40,41.78873,-87.60131
423,5,8,true,2,12,10,41.79148,-87.59988
KA1503000071,5,8,true,10,97,87,41.79148,-87.59988
TA1309000063,5,8,true,44,15,-29,41.79325,-87.5878
420,5,8,true,16,12,-4,41.79429,-87.60145
KA1504000076,5,8,true,39,68,29,41.7943,-87.60145
TA1308000009,5,8,true,36,6,-30,41.79522,-87.58075
TA1307000164,5,8,true,13,33,20,41.79527,-87.59647
KA1503000052,5,8,true,39,22,-17,41.79935,-87.60097
418,5,8,true,5,11,6,41.79936,-87.60097
KA1503000059,5,8,true,13,14,1,41.79952,-87.58643
TA1309000037,5,8,true,42,11,-31,41.79957,-87.59474
KA1503000007,5,8,true,24,10,-14,41.80242,-87.58689
13398,5,8,true,22,5,-17,41.80256,-87.59035
KA1503000069,5,8,true,10,2,-8,41.80579,-87.59247
TA1308000035,5,8,true,23,19,-4,41.80944,-87.59188
KA1503000065,5,8,true,12,1,-11,41.81409,-87.59701
KA1503000027,5,8,true,4,14,10,41.81666,-87.61942
TA1308000045,5,8,true,11,8,-3,41.83062,-87.64129
184,5,8,true,1,19,18,41.83104,-87.62684
TA1307000129,5,8,true,5,98,93,41.83104,-87.62683
13216,5,8,true,16,37,21,41.83473,-87.62581
148,5,8,true,2,18,16,41.83474,-87.62581
13217,5,8,true,17,3,-14,41.83488,-87.61792
13215,5,8,true,19,3,-16,41.83634,-87.6135
TA1308000046,5,8,true,14,8,-6,41.83779,-87.65115
TA1309000055,5,8,true,22,7,-15,41.8382,-87.64514
KA1503000038,5,8,true,19,6,-13,41.83845,-87.6354
TA1307000048,5,8,true,20,28,8,41.83855,-87.60821
TA1308000036,5,8,true,22,8,-14,41.83883,-87.62186
237,5,8,true,19,2,-17,41.84204,-87.61697
TA1307000139,5,8,true,39,11,-28,41.84205,-87.61698
TA1307000153,5,8,true,16,3,-13,41.84358,-87.64538
TA1307000005,5,8,true,8,37,29,41.84569,-87.6225
TA1308000014,5,8,true,12,2,-10,41.84953,-87.64059
TA1308000026,5,8,true,1,10,9,41.85008,-87.63214
13096,5,8,true,6,10,4,41.8538,-87.69577
13091,5,8,true,3,12,9,41.85409,-87.68585
15546,5,8,true,23,9,-14,41.85416,-87.61916
13089,5,8,true,12,4,-8,41.85497,-87.67567
13331,5,8,true,12,5,-7,41.85515,-87.65414
15545,5,8,true,29,29,0,41.85627,-87.61334
SL-013,5,8,true,12,6,-6,41.85659,-87.62755
SL-006,5,8,true,11,3,-8,41.8568,-87.63387
13135,5,8,true,45,14,-31,41.85753,-87.66157
13102,5,8,true,72,20,-52,41.85762,-87.61942
13150,5,8,true,49,23,-26,41.85783,-87.62455
273,5,8,true,11,10,-1,41.85783,-87.62455
13099,5,8,true,15,2,-13,41.85784,-87.64627
TA1307000159,5,8,true,25,8,-17,41.8579,-87.6687
TA1307000044,5,8,true,12,8,-4,41.85794,-87.64083
13163,5,8,true,30,10,-20,41.85808,-87.65108
13164,5,8,true,27,5,-22,41.85818,-87.65648
SL-012,5,8,true,58,23,-35,41.86038,-87.62581
72,5,8,true,15,3,-12,41.86039,-87.62581
13304,5,8,true,11,4,-7,41.86126,-87.65659
KA1504000109,5,8,true,6,16,10,41.86192,-87.69347
TA1306000002,5,8,true,34,24,-10,41.86238,-87.65108
TA1307000124,5,8,true,93,44,-49,41.86411,-87.62372
168,5,8,true,21,7,-14,41.86415,-87.62372
TA1309000001,5,8,true,27,19,-8,41.86488,-87.64708
13029,5,8,true,1,12,11,41.86531,-87.6179
13431,5,8,true,23,23,0,41.8661,-87.60728
WL-008,5,8,true,16,17,1,41.86712,-87.64108
TA1305000002,5,8,true,106,49,-57,41.86721,-87.62597
59,5,8,true,17,22,5,41.86721,-87.62597
15544,5,8,true,25,39,14,41.86723,-87.61536
TA1305000017,5,8,true,10,26,16,41.86734,-87.64863
KA1706005007,5,8,true,24,13,-11,41.86749,-87.63219
SL-005,5,8,true,111,40,-71,41.8679,-87.62304
255,5,8,true,29,10,-19,41.86791,-87.62304
644,5,8,true,16,2,-14,41.86859,-87.68625
13139,5,8,true,30,11,-19,41.86893,-87.65913
13285,5,8,true,12,87,75,41.86928,-87.67372
22,5,8,true,13,2,-11,41.86947,-87.65548
13160,5,8,true,23,13,-10,41.86947,-87.65548
15550,5,8,true,20,13,-7,41.87024,-87.63947
TA1309000010,5,8,true,79,40,-39,41.87074,-87.62574
SL-009,5,8,true,35,12,-23,41.87081,-87.63121
342,5,8,true,5,42,37,41.87127,-87.6737
TA1309000064,5,8,true,13,120,107,41.87127,-87.67369
261,5,8,true,3,15,12,41.87151,-87.6699
TA1307000130,5,8,true,30,56,26,41.87178,-87.65103
241,5,8,true,10,7,-3,41.8718,-87.65102
TA1307000121,5,8,true,19,92,73,41.87184,-87.64664
41,5,8,true,28,9,-19,41.87209,-87.62957
SL-008,5,8,true,110,26,-84,41.87209,-87.62956
13332,5,8,true,98,26,-72,41.87219,-87.6615
175,5,8,true,21,8,-13,41.87255,-87.63359
SL-011,5,8,true,94,52,-42,41.87256,-87.63356
623,5,8,true,45,29,-16,41.87272,-87.62399
KA1504000104,5,8,true,34,184,150,41.87296,-87.66912
383,5,8,true,4,26,22,41.87297,-87.66912
320,5,8,true,27,10,-17,41.87327,-87.66402
SL-007,5,8,true,45,19,-26,41.87404,-87.6277
13326,5,8,true,10,29,19,41.87425,-87.63958
321,5,8,true,22,7,-15,41.87427,-87.63257
TA1306000025,5,8,true,28,21,-7,41.87464,-87.65703
13028,5,8,true,22,45,23,41.87475,-87.64981
13081,5,8,true,5,18,13,41.87501,-87.67326
SL-010,5,8,true,55,13,-42,41.87501,-87.63309
15541,5,8,true,11,13,2,41.8758,-87.62086
13037,5,8,true,12,17,5,41.87588,-87.64078
50,5,8,true,1,10,9,41.87592,-87.6307
TA1305000009,5,8,true,42,24,-18,41.87593,-87.63068
317,5,8,true,5,14,9,41.87603,-87.68195
TA1305000010,5,8,true,11,25,14,41.87623,-87.62444
624,5,8,true,46,41,-5,41.87626,-87.62923
33,5,8,true,3,14,11,41.87715,-87.62786
TA1305000035,5,8,true,40,68,28,41.87716,-87.62787
13138,5,8,true,35,80,45,41.87723,-87.63941
75,5,8,true,6,14,8,41.87724,-87.63937
15539,5,8,true,50,62,12,41.87763,-87.64405
13158,5,8,true,118,68,-50,41.87764,-87.64957
134,5,8,true,24,9,-15,41.87764,-87.64954
13157,5,8,true,40,29,-11,41.87773,-87.6548
21,5,8,true,12,8,-4,41.87773,-87.6548
TA1305000025,5,8,true,58,142,84,41.87773,-87.63528
36,5,8,true,10,24,14,41.87776,-87.63525
TA1309000002,5,8,true,25,40,15,41.87784,-87.62408
13206,5,8,true,39,36,-3,41.87794,-87.66201
283,5,8,true,7,47,40,41.87809,-87.63183
TA1309000004,5,8,true,58,174,116,41.87811,-87.63184
107,5,8,true,14,18,4,41.87822,-87.644
638,5,8,true,94,120,26,41.87827,-87.64078
37,5,8,true,5,27,22,41.87921,-87.62975
TA1305000005,5,8,true,22,133,111,41.87924,-87.62975
286,5,8,true,2,12,10,41.8793,-87.6355
13011,5,8,true,137,114,-23,41.87931,-87.63993
TA1309000008,5,8,true,40,102,62,41.87933,-87.6355
192,5,8,true,15,23,8,41.87935,-87.63997
KA1503000034,5,8,true,7,114,107,41.87938,-87.63197
40,5,8,true,2,22,20,41.87944,-87.63197
39,5,8,true,3,16,13,41.87948,-87.62571
KA1503000015,5,8,true,46,102,56,41.87948,-87.6257
287,5,8,true,1,53,52,41.88017,-87.63527
TA1309000007,5,8,true,48,269,221,41.88022,-87.63526
WL-011,5,8,true,39,33,-6,41.88034,-87.64273
73,5,8,true,10,7,-3,41.8804,-87.64273
80,5,8,true,16,12,-4,41.88042,-87.65556
13156,5,8,true,71,58,-13,41.88042,-87.65554
13300,5,8,true,30,24,-6,41.88097,-87.61675
13008,5,8,true,13,53,40,41.88105,-87.62408
90,5,8,true,7,17,10,41.88107,-87.62409
49,5,8,true,1,82,81,41.88116,-87.62963
TA1305000006,5,8,true,31,289,258,41.88122,-87.6296
13056,5,8,true,97,79,-18,41.88168,-87.63951
191,5,8,true,14,7,-7,41.88169,-87.63951
198,5,8,true,18,13,-5,41.88187,-87.6488
TA1307000120,5,8,true,122,68,-54,41.88188,-87.64879
13341,5,8,true,96,74,-22,41.88208,-87.63985
197,5,8,true,14,21,7,41.88208,-87.62513
13036,5,8,true,43,92,49,41.8821,-87.62513
77,5,8,true,22,23,1,41.88214,-87.64108
TA1305000032,5,8,true,183,93,-90,41.88218,-87.64109
98,5,8,true,7,35,28,41.88266,-87.63251
13006,5,8,true,28,183,155,41.88268,-87.63252
13353,5,8,true,80,26,-54,41.88283,-87.6612
346,5,8,true,14,9,-5,41.88284,-87.6612
654,5,8,true,33,24,-9,41.88307,-87.65698
13409,5,8,true,44,20,-24,41.8831,-87.6511
18,5,8,true,3,29,26,41.88317,-87.63735
KA1503000072,5,8,true,52,141,89,41.88317,-87.63693
91,5,8,true,24,32,8,41.88336,-87.64122
WL-012,5,8,true,159,173,14,41.88337,-87.6412
112,5,8,true,4,18,14,41.88362,-87.6486
13053,5,8,true,43,53,10,41.88365,-87.64863
43,5,8,true,13,21,8,41.88396,-87.62455
13001,5,8,true,101,155,54,41.88397,-87.62459
13155,5,8,true,15,27,12,41.88407,-87.65689
18062,5,8,true,48,37,-11,41.88412,-87.65427
81,5,8,true,14,48,34,41.88417,-87.6296
TA1306000010,5,8,true,56,171,115,41.88419,-87.62961
TA1305000030,5,8,true,63,326,263,41.88459,-87.63178
15535,5,8,true,44,33,-11,41.8846,-87.64455
51,5,8,true,2,60,58,41.88462,-87.63176
TA1305000029,5,8,true,47,56,9,41.88466,-87.62787
195,5,8,true,58,11,-47,41.88466,-87.61952
13263,5,8,true,144,55,-89,41.88467,-87.61952
44,5,8,true,4,16,12,41.88468,-87.62782
TA1306000015,5,8,true,52,112,60,41.88549,-87.65232
71,5,8,true,11,18,7,41.8855,-87.65233
66,5,8,true,12,29,17,41.88557,-87.64186
13021,5,8,true,117,176,59,41.88559,-87.64184
TA1307000111,5,8,true,39,170,131,41.88582,-87.63548
164,5,8,true,4,20,16,41.88583,-87.63547
13073,5,8,true,19,12,-7,41.88592,-87.66717
KA17018054,5,8,true,7,11,4,41.88595,-87.67701
38,5,8,true,10,45,35,41.88599,-87.63089
KA1503000012,5,8,true,58,131,73,41.88599,-87.63089
52,5,8,true,11,31,20,41.886,-87.62421
TA1305000011,5,8,true,64,168,104,41.886,-87.62418
15534,5,8,true,82,32,-50,41.88627,-87.61749
217,5,8,true,4,10,6,41.8866,-87.65821
13197,5,8,true,23,59,36,41.8866,-87.65816
264,5,8,true,13,14,1,41.8867,-87.62224
TA1308000029,5,8,true,45,45,0,41.88673,-87.62225
194,5,8,true,2,14,12,41.88688,-87.62606
TA1307000131,5,8,true,18,96,78,41.88688,-87.62606
KA1503000064,5,8,true,16,37,21,41.88697,-87.61281
100,5,8,true,12,21,9,41.88814,-87.63657
TA1305000022,5,8,true,72,123,51,41.88817,-87.63656
56,5,8,true,27,17,-10,41.88866,-87.64442
TA1306000003,5,8,true,109,84,-25,41.88867,-87.64442
133,5,8,true,42,49,7,41.88918,-87.63851
KA1503000043,5,8,true,179,200,21,41.88918,-87.63851
13050,5,8,true,60,184,124,41.88919,-87.62775
47,5,8,true,13,33,20,41.88921,-87.62775
15664,5,8,true,18,1,-17,41.8895,-87.68821
13432,5,8,true,25,44,19,41.88989,-87.67149
TA1307000151,5,8,true,104,141,37,41.88993,-87.63427
212,5,8,true,21,20,-1,41.88995,-87.63427
636,5,8,true,65,124,59,41.88997,-87.63662
125,5,8,true,12,21,9,41.89018,-87.62621
KA1503000044,5,8,true,64,106,42,41.89018,-87.6262
196,5,8,true,27,13,-14,41.89053,-87.62205
13427,5,8,true,70,82,12,41.89054,-87.62205
26,5,8,true,19,9,-10,41.89057,-87.61798
13430,5,8,true,64,72,8,41.89077,-87.63169
TA1306000013,5,8,true,78,59,-19,41.89083,-87.61852
RN-,5,8,true,51,71,20,41.89102,-87.63546
672,5,8,true,15,17,2,41.89102,-87.63545
13434,5,8,true,20,10,-10,41.89108,-87.66663
TA1308000006,5,8,true,28,23,-5,41.89128,-87.67686
199,5,8,true,19,16,-3,41.89143,-87.62676
TA1307000117,5,8,true,94,77,-17,41.89144,-87.62675
13033,5,8,true,59,62,3,41.8916,-87.64835
84,5,8,true,14,11,-3,41.89161,-87.64833
186,5,8,true,16,12,-4,41.8918,-87.65879
13194,5,8,true,56,34,-22,41.8918,-87.65878
TA1305000003,5,8,true,129,90,-39,41.89187,-87.62061
24,5,8,true,13,15,2,41.8919,-87.62063
643,5,8,true,26,24,-2,41.89203,-87.68939
35,5,8,true,16,5,-11,41.89227,-87.61206
13022,5,8,true,99,48,-51,41.89227,-87.61205
TA1306000029,5,8,true,61,50,-11,41.89256,-87.61449
13265,5,8,true,81,54,-27,41.89383,-87.64172
74,5,8,true,22,11,-11,41.89384,-87.64173
13045,5,8,true,117,152,35,41.89403,-87.62931
110,5,8,true,27,26,-1,41.89406,-87.6293
13016,5,8,true,85,251,166,41.89431,-87.62277
211,5,8,true,22,99,77,41.89439,-87.62267
KA1503000041,5,8,true,89,168,79,41.89452,-87.61798
142,5,8,true,17,28,11,41.89453,-87.61806
13196,5,8,true,54,33,-21,41.89455,-87.65345
TA1307000062,5,8,true,66,84,18,41.89466,-87.63839
111,5,8,true,11,26,15,41.89466,-87.63837
TA1306000012,5,8,true,132,99,-33,41.89475,-87.63438
53,5,8,true,19,26,7,41.89476,-87.63439
627,5,8,true,11,10,-1,41.8948,-87.63231
KP1705001026,5,8,true,42,25,-17,41.89483,-87.6323
18058,5,8,true,13,5,-8,41.8955,-87.68201
637,5,8,true,39,21,-18,41.89563,-87.67209
13132,5,8,true,37,22,-15,41.89573,-87.67718
161,5,8,true,16,19,3,41.89574,-87.62599
15530,5,8,true,96,124,28,41.89575,-87.62596
18003,5,8,true,40,70,30,41.89575,-87.62011
635,5,8,true,3,17,14,41.89576,-87.62012
13247,5,8,true,36,21,-15,41.89597,-87.66775
TA1305000020,5,8,true,42,53,11,41.89636,-87.65406
13289,5,8,true,48,12,-36,41.89638,-87.661
337,5,8,true,13,8,-5,41.89659,-87.63096
13303,5,8,true,33,35,2,41.89672,-87.63088
13017,5,8,true,82,92,10,41.89676,-87.6357
31,5,8,true,13,20,7,41.89677,-87.63572
13338,5,8,true,91,134,43,41.89697,-87.62173
173,5,8,true,14,27,13,41.89704,-87.62173
TA1307000061,5,8,true,67,52,-15,41.89745,-87.62873
106,5,8,true,16,14,-2,41.89746,-87.62874
25,5,8,true,7,14,7,41.89751,-87.62354
13034,5,8,true,19,82,63,41.89754,-87.62352
48,5,8,true,14,19,5,41.89772,-87.64302
TA1306000009,5,8,true,65,243,178,41.89772,-87.64299
620,5,8,true,56,29,-27,41.89817,-87.63754
KA1504000103,5,8,true,48,24,-24,41.89842,-87.68659
374,5,8,true,18,3,-15,41.89842,-87.68659
145,5,8,true,10,8,-2,41.89856,-87.62211
15529,5,8,true,77,83,6,41.89858,-87.62206
140,5,8,true,19,10,-9,41.89895,-87.6299
TA1307000128,5,8,true,78,49,-29,41.89896,-87.6299
657,5,8,true,45,19,-26,41.89918,-87.6722
KA1504000117,5,8,true,10,13,3,41.89936,-87.64848
13248,5,8,true,49,20,-29,41.89964,-87.66788
46,5,8,true,10,10,0,41.89994,-87.63444
TA1306000011,5,8,true,60,25,-35,41.89994,-87.63443
KA1504000116,5,8,true,46,26,-20,41.90023,-87.64299
364,5,8,true,8,13,5,41.90023,-87.64299
17660,5,8,true,22,7,-15,41.90036,-87.69671
13290,5,8,true,86,19,-67,41.90069,-87.66259
29,5,8,true,11,7,-4,41.90069,-87.66259
13042,5,8,true,76,59,-17,41.90097,-87.62377
85,5,8,true,5,14,9,41.90098,-87.62375
TA1307000070,5,8,true,48,22,-26,41.90133,-87.67742
KA1504000133,5,8,true,54,52,-2,41.90234,-87.62773
172,5,8,true,15,5,-10,41.90236,-87.62774
13241,5,8,true,23,21,-2,41.9029,-87.68731
176,5,8,true,59,23,-36,41.90291,-87.63141
TA1306000006,5,8,true,47,7,-40,41.90292,-87.63772
TA1307000039,5,8,true,173,109,-64,41.90294,-87.63137
658,5,8,true,23,67,44,41.903,-87.6838
13256,5,8,true,11,5,-6,41.90302,-87.69749
TA1305000034,5,8,true,29,16,-13,41.90313,-87.67391
182,5,8,true,41,13,-28,41.90317,-87.63442
KA1504000135,5,8,true,158,95,-63,41.90319,-87.63439
13136,5,8,true,59,30,-29,41.90326,-87.67845
130,5,8,true,10,3,-7,41.90327,-87.67846
210,5,8,true,10,10,0,41.90342,-87.66781
13061,5,8,true,97,60,-37,41.90342,-87.66779
KA1504000079,5,8,true,38,26,-12,41.9035,-87.64334
359,5,8,true,10,3,-7,41.90458,-87.6497
138,5,8,true,20,8,-12,41.9046,-87.64057
TA1307000115,5,8,true,55,12,-43,41.9046,-87.64056
291,5,8,true,12,20,8,41.90672,-87.63494
TA1308000049,5,8,true,47,38,-9,41.90672,-87.6349
KA1504000134,5,8,true,35,10,-25,41.90687,-87.6262
180,5,8,true,14,3,-11,41.90687,-87.62618
13224,5,8,true,39,23,-16,41.90706,-87.66725
333,5,8,true,17,3,-14,41.90706,-87.66725
18069,5,8,true,2,20,18,41.90722,-87.65563
TA1307000143,5,8,true,40,9,-31,41.90762,-87.63854
13221,5,8,true,47,33,-14,41.90765,-87.67254
13245,5,8,true,8,16,8,41.90777,-87.68586
301,5,8,true,38,24,-14,41.90796,-87.63203
TA1309000024,5,8,true,106,64,-42,41.908,-87.63152
69,5,8,true,11,6,-5,41.90939,-87.6777
TA1305000041,5,8,true,58,38,-20,41.9094,-87.67769
331,5,8,true,72,71,-1,41.90965,-87.64812
TA1305000037,5,8,true,64,38,-26,41.91018,-87.67003
TA1306000008,5,8,true,40,12,-28,41.9102,-87.6435
16,5,8,true,12,16,4,41.91035,-87.67008
213,5,8,true,13,2,-11,41.91037,-87.68237
TA1308000005,5,8,true,43,12,-31,41.91042,-87.68238
13258,5,8,true,16,8,-8,41.91043,-87.69718
13257,5,8,true,16,5,-11,41.91054,-87.68956
13154,5,8,true,65,63,-2,41.91054,-87.65312
20,5,8,true,12,7,-5,41.91055,-87.65313
13058,5,8,true,29,29,0,41.91059,-87.64942
118,5,8,true,24,10,-14,41.91138,-87.63868
TA1307000038,5,8,true,62,48,-14,41.91138,-87.63868
LF-005,5,8,true,74,29,-45,41.91172,-87.62681
126,5,8,true,17,14,-3,41.91196,-87.63197
13128,5,8,true,25,26,1,41.91197,-87.63197
289,5,8,true,29,30,1,41.91209,-87.63472
TA1308000050,5,8,true,131,120,-11,41.91211,-87.6347
158,5,8,true,13,4,-9,41.91262,-87.6814
13243,5,8,true,35,29,-6,41.91262,-87.6814
TA1309000032,5,8,true,4,16,12,41.91293,-87.66417
TA1306000032,5,8,true,44,28,-16,41.9137,-87.65285
TA1307000166,5,8,true,45,35,-10,41.91386,-87.64877
224,5,8,true,7,10,3,41.91386,-87.64877
15655,5,8,true,26,7,-19,41.91401,-87.70514
18017,5,8,true,16,2,-14,41.91416,-87.71676
18067,5,8,true,24,8,-16,41.9146,-87.66796
TA1306000007,5,8,true,48,17,-31,41.91469,-87.64333
13068,5,8,true,23,38,15,41.91554,-87.68703
13179,5,8,true,91,48,-43,41.9157,-87.63461
141,5,8,true,26,11,-15,41.91571,-87.63461
13133,5,8,true,32,16,-16,41.91598,-87.67733
TA1305000039,5,8,true,42,45,3,41.9163,-87.66749
15650,5,8,true,16,9,-7,41.91711,-87.71023
15651,5,8,true,13,15,2,41.91752,-87.70181
507,5,8,true,5,12,7,41.91752,-87.70181
13266,5,8,true,15,11,-4,41.91774,-87.69142
TA1309000029,5,8,true,38,24,-14,41.9178,-87.68245
309,5,8,true,11,7,-4,41.91789,-87.6865
TA1309000006,5,8,true,72,35,-37,41.91809,-87.64375
288,5,8,true,10,8,-2,41.91809,-87.64375
TA1307000163,5,8,true,42,36,-6,41.91821,-87.65696
94,5,8,true,22,20,-2,41.91831,-87.6363
13146,5,8,true,124,81,-43,41.91831,-87.63629
13059,5,8,true,69,63,-6,41.91845,-87.65222
113,5,8,true,15,19,4,41.91846,-87.65222
13259,5,8,true,15,6,-9,41.91852,-87.69744
13192,5,8,true,61,45,-16,41.91995,-87.64884
225,5,8,true,20,13,-7,41.91995,-87.64884
13288,5,8,true,25,10,-15,41.92008,-87.67788
TA1309000030,5,8,true,34,26,-8,41.92077,-87.66372
290,5,8,true,11,4,-7,41.92152,-87.70734
13292,5,8,true,15,10,-5,41.92152,-87.70733
TA1309000033,5,8,true,35,57,22,41.92158,-87.65381
13193,5,8,true,80,98,18,41.92182,-87.64412
144,5,8,true,22,22,0,41.92182,-87.64411
13191,5,8,true,69,54,-15,41.92217,-87.63891
143,5,8,true,12,7,-5,41.92217,-87.63891
327,5,8,true,14,6,-8,41.92225,-87.65783
13084,5,8,true,33,15,-18,41.92268,-87.69715
LP-,5,8,true,60,22,-38,41.92396,-87.63584
16010,5,8,true,10,1,-9,41.92458,-87.72787
15648,5,8,true,13,2,-11,41.92464,-87.68931
TA1307000001,5,8,true,37,21,-16,41.92535,-87.66581
TA1306000026,5,8,true,48,42,-6,41.92558,-87.65842
67,5,8,true,3,15,12,41.9256,-87.65371
TA1306000016,5,8,true,41,61,20,41.9256,-87.65371
313,5,8,true,15,11,-4,41.9257,-87.64246
TA1309000019,5,8,true,83,35,-48,41.92586,-87.63897
TA1309000058,5,8,true,59,90,31,41.92591,-87.64927
127,5,8,true,24,9,-15,41.92592,-87.64927
TA1308000001,5,8,true,42,31,-11,41.92627,-87.63086
177,5,8,true,13,11,-2,41.92627,-87.63086
15646,5,8,true,13,5,-8,41.92668,-87.6977
13124,5,8,true,8,14,6,41.92675,-87.63444
302,5,8,true,11,9,-2,41.92859,-87.65421
TA1309000023,5,8,true,55,36,-19,41.9287,-87.65383
TA1307000113,5,8,true,23,14,-9,41.92878,-87.66391
13296,5,8,true,17,26,9,41.92883,-87.66852
TA1309000059,5,8,true,62,25,-37,41.92889,-87.65898
349,5,8,true,11,8,-3,41.92915,-87.6491
TA1309000061,5,8,true,44,56,12,41.92915,-87.64909
TA1308000031,5,8,true,9,16,7,41.92946,-87.68417
TA1305000014,5,8,true,110,87,-23,41.92956,-87.64313
340,5,8,true,28,25,-3,41.92956,-87.64313
13085,5,8,true,17,12,-5,41.92958,-87.70789
15643,5,8,true,3,12,9,41.93057,-87.7238
TA1307000142,5,8,true,55,38,-17,41.93125,-87.64432
220,5,8,true,22,16,-6,41.93125,-87.64431
13276,5,8,true,83,56,-27,41.93132,-87.63874
324,5,8,true,19,11,-8,41.93173,-87.64179
13271,5,8,true,7,12,5,41.93192,-87.67784
152,5,8,true,14,21,7,41.93221,-87.65864
TA1307000064,5,8,true,89,50,-39,41.93222,-87.65864
13,5,8,true,17,13,-4,41.93242,-87.65271
TA1306000014,5,8,true,53,67,14,41.93242,-87.65271
TA1309000039,5,8,true,91,46,-45,41.93258,-87.63642
329,5,8,true,18,10,-8,41.93258,-87.63642
13294,5,8,true,29,14,-15,41.9326,-87.66595
TA1309000036,5,8,true,56,41,-15,41.93313,-87.64776
TA1307000006,5,8,true,42,29,-13,41.93571,-87.6636
153,5,8,true,11,10,-1,41.93575,-87.66364
13268,5,8,true,16,10,-6,41.93588,-87.67843
13269,5,8,true,27,18,-9,41.93609,-87.66983
115,5,8,true,17,22,5,41.93628,-87.65266
TA1307000052,5,8,true,67,83,16,41.93628,-87.65266
156,5,8,true,22,15,-7,41.9365,-87.64756
TA1307000136,5,8,true,50,74,24,41.9365,-87.64755
TA1307000041,5,8,true,79,59,-20,41.93669,-87.63683
157,5,8,true,12,16,4,41.9367,-87.63683
13137,5,8,true,89,78,-11,41.9376,-87.6441
300,5,8,true,31,29,-2,41.93761,-87.6441
154,5,8,true,10,4,-6,41.93912,-87.66384
TA1309000042,5,8,true,35,16,-19,41.93937,-87.66836
131,5,8,true,13,8,-5,41.93937,-87.66835
13229,5,8,true,45,15,-30,41.93946,-87.66376
TA1308000019,5,8,true,38,30,-8,41.93973,-87.65886
13277,5,8,true,59,40,-19,41.9401,-87.64546
296,5,8,true,12,8,-4,41.9401,-87.64546
TA1307000134,5,8,true,50,64,14,41.94016,-87.65303
117,5,8,true,15,14,-1,41.94016,-87.65302
13143,5,8,true,14,14,0,41.94059,-87.67853
334,5,8,true,12,11,-1,41.94076,-87.63919
TA1309000049,5,8,true,57,53,-4,41.94077,-87.63919
15634,5,8,true,12,3,-9,41.94304,-87.68729
TA1307000138,5,8,true,57,48,-9,41.94334,-87.67094
230,5,8,true,20,9,-11,41.94335,-87.67093
13144,5,8,true,37,13,-24,41.9434,-87.67964
TA1309000025,5,8,true,61,32,-29,41.94368,-87.64894
299,5,8,true,10,8,-2,41.94368,-87.64894
229,5,8,true,13,8,-5,41.94372,-87.66401
13071,5,8,true,39,48,9,41.94373,-87.66401
632,5,8,true,51,51,0,41.94453,-87.6547
303,5,8,true,12,5,-7,41.94522,-87.64702
13278,5,8,true,55,37,-18,41.94553,-87.64644
TA1309000050,5,8,true,17,12,-5,41.94618,-87.67331
KA1504000143,5,8,true,13,8,-5,41.94664,-87.68337
227,5,8,true,10,13,3,41.94813,-87.66397
13235,5,8,true,62,72,10,41.94814,-87.66396
304,5,8,true,24,13,-11,41.94878,-87.64922
13253,5,8,true,32,14,-18,41.9488,-87.67527
13325,5,8,true,81,64,-17,41.94907,-87.64863
TA1307000126,5,8,true,27,44,17,41.94936,-87.65451
232,5,8,true,10,14,4,41.94943,-87.64645
TA1307000150,5,8,true,68,41,-27,41.94945,-87.64646
13319,5,8,true,33,18,-15,41.95069,-87.6687
TA1307000127,5,8,true,47,52,5,41.9508,-87.65918
15628,5,8,true,10,5,-5,41.95216,-87.69806
13323,5,8,true,38,16,-22,41.95282,-87.65
256,5,8,true,7,10,3,41.95282,-87.65
TA1309000043,5,8,true,20,29,9,41.95417,-87.66434
13063,5,8,true,51,51,0,41.95424,-87.65441
254,5,8,true,12,8,-4,41.95438,-87.64806
TA1308000022,5,8,true,49,32,-17,41.95438,-87.64805
244,5,8,true,3,12,9,41.95466,-87.67391
TA1307000149,5,8,true,10,59,49,41.95467,-87.67392
TA1309000026,5,8,true,10,26,16,41.95601,-87.6802
312,5,8,true,18,10,-8,41.95637,-87.6563
TA1308000047,5,8,true,13,20,7,41.95709,-87.6642
13379,5,8,true,76,28,-48,41.95786,-87.6495
TA1309000018,5,8,true,17,36,19,41.95791,-87.67357
306,5,8,true,12,1,-11,41.9585,-87.655
TA1309000027,5,8,true,38,16,-22,41.9585,-87.65499
13389,5,8,true,38,45,7,41.961,-87.64958
15622,5,8,true,13,6,-7,41.96108,-87.69544
KA1504000097,5,8,true,12,10,-2,41.96116,-87.71658
TA1307000144,5,8,true,14,30,16,41.96142,-87.6762
TA1309000021,5,8,true,10,7,-3,41.9615,-87.6714
15623,5,8,true,20,4,-16,41.96154,-87.69117
482,5,8,true,10,2,-8,41.96154,-87.69117
KA1503000022,5,8,true,21,17,-4,41.96158,-87.66609
231,5,8,true,7,10,3,41.96163,-87.65464
TA1307000107,5,8,true,47,20,-27,41.96164,-87.65464
TA1307000156,5,8,true,21,11,-10,41.96301,-87.68479
TA1309000012,5,8,true,12,7,-5,41.96325,-87.67928
TA1308000012,5,8,true,37,16,-21,41.96398,-87.63818
13074,5,8,true,17,39,22,41.96521,-87.6582
639,5,8,true,31,24,-7,41.96584,-87.64538
KA1504000127,5,8,true,30,3,-27,41.96587,-87.70083
KA1504000093,5,8,true,9,21,12,41.96587,-87.69365
TA1307000140,5,8,true,27,31,4,41.96643,-87.68865
239,5,8,true,7,10,3,41.9665,-87.68843
TA1309000014,5,8,true,33,28,-5,41.96709,-87.66744
TA1307000158,5,8,true,30,28,-2,41.9671,-87.67904
TA1307000119,5,8,true,33,20,-13,41.96796,-87.65
TA1308000021,5,8,true,7,14,7,41.96883,-87.65765
KA1504000080,5,8,true,13,3,-10,41.96887,-87.69609
TA1309000066,5,8,true,52,34,-18,41.9691,-87.67423
344,5,8,true,8,10,2,41.9691,-87.67423
TA1309000041,5,8,true,15,17,2,41.96951,-87.65471
KA1504000171,5,8,true,18,5,-13,41.97161,-87.65016
325,5,8,true,11,2,-9,41.9728,-87.67186
TA1309000035,5,8,true,39,21,-18,41.97335,-87.66785
13108,5,8,true,17,23,6,41.97379,-87.65971
KA1504000078,5,8,true,13,4,-9,41.97491,-87.69258
KA1504000149,5,8,true,5,11,6,41.97562,-87.67945
KA1504000160,5,8,true,17,8,-9,41.97564,-87.70143
KA1504000146,5,8,true,17,23,6,41.978,-87.66805
13109,5,8,true,31,16,-15,41.97835,-87.65976
KA1504000147,5,8,true,9,13,4,41.97976,-87.67754
655,5,8,true,3,12,9,41.97987,-87.68194
KA1504000151,5,8,true,14,29,15,41.98359,-87.66916
KA1504000152,5,8,true,38,22,-16,41.98403,-87.65231
15578,5,8,true,25,12,-13,41.98405,-87.66027
15575,5,8,true,34,9,-25,41.98975,-87.66014
15571,5,8,true,44,15,-29,41.99478,-87.66028
RP-009,5,8,true,13,29,16,42.00107,-87.66122
RP-008,5,8,true,19,3,-16,42.00446,-87.6724
660,5,8,true,27,14,-13,42.00458,-87.66143
KA1504000175,5,8,true,12,2,-10,42.00797,-87.66549
KA1504000162,5,8,true,2,28,26,42.00907,-87.67422
KA1504000159,5,8,true,11,3,-8,42.01059,-87.66241
515,5,8,true,5,14,9,42.01915,-87.67356
523,5,8,true,16,6,-10,42.02089,-87.66505
E002,5,8,true,23,15,-8,42.03256,-87.67912
596,5,8,true,32,11,-21,42.04822,-87.68348
604,5,8,true,3,41,38,42.05824,-87.67744
15491,5,12,false,14,2,-12,41.78096,-87.57624
KA1503000014,5,12,false,36,28,-8,41.7851,-87.60108
426,5,12,false,12,6,-6,41.7851,-87.60108
TA1309000011,5,12,false,12,21,9,41.78873,-87.60131
KA1503000071,5,12,false,33,27,-6,41.79148,-87.59988
423,5,12,false,10,5,-5,41.79148,-87.59988
KA1503000074,5,12,false,22,45,23,41.79174,-87.58395
TA1309000063,5,12,false,32,10,-22,41.79325,-87.5878
KA1504000076,5,12,false,32,21,-11,41.7943,-87.60145
247,5,12,false,18,4,-14,41.79522,-87.58077
TA1308000009,5,12,false,36,31,-5,41.79522,-87.58075
TA1307000164,5,12,false,22,8,-14,41.79527,-87.59647
KA1503000052,5,12,false,20,12,-8,41.79935,-87.60097
KA1503000059,5,12,false,19,27,8,41.79952,-87.58643
TA1309000037,5,12,false,40,30,-10,41.79957,-87.59474
KA1503000007,5,12,false,18,14,-4,41.80242,-87.58689
13398,5,12,false,16,12,-4,41.80256,-87.59035
TA1308000035,5,12,false,11,10,-1,41.80944,-87.59188
TA1308000038,5,12,false,5,10,5,41.82298,-87.6071
KA1503000004,5,12,false,7,10,3,41.83127,-87.6088
15445,5,12,false,7,10,3,41.83453,-87.63183
TA1308000046,5,12,false,11,3,-8,41.83779,-87.65115
TA1307000048,5,12,false,24,21,-3,41.83855,-87.60821
TA1307000139,5,12,false,14,4,-10,41.84205,-87.61698
TA1308000026,5,12,false,12,3,-9,41.85008,-87.63214
TA1305000004,5,12,false,20,11,-9,41.8514,-87.61884
13075,5,12,false,23,37,14,41.8531,-87.63192
13162,5,12,false,3,10,7,41.85378,-87.64659
15546,5,12,false,13,11,-2,41.85416,-87.61916
15545,5,12,false,38,47,9,41.85627,-87.61334
SL-006,5,12,false,12,13,1,41.8568,-87.63387
13135,5,12,false,15,7,-8,41.85753,-87.66157
13102,5,12,false,20,9,-11,41.85762,-87.61942
273,5,12,false,19,11,-8,41.85783,-87.62455
13150,5,12,false,18,24,6,41.85783,-87.62455
TA1307000159,5,12,false,12,9,-3,41.8579,-87.6687
13164,5,12,false,7,15,8,41.85818,-87.65648
SL-012,5,12,false,25,21,-4,41.86038,-87.62581
KA1504000109,5,12,false,1,17,16,41.86192,-87.69347
TA1307000124,5,12,false,29,38,9,41.86411,-87.62372
TA1309000001,5,12,false,16,14,-2,41.86488,-87.64708
13029,5,12,false,75,41,-34,41.86531,-87.6179
97,5,12,false,20,9,-11,41.86531,-87.6179
13431,5,12,false,57,54,-3,41.8661,-87.60728
WL-008,5,12,false,24,33,9,41.86712,-87.64108
TA1305000002,5,12,false,43,32,-11,41.86721,-87.62597
59,5,12,false,5,14,9,41.86721,-87.62597
15544,5,12,false,327,248,-79,41.86723,-87.61536
3,5,12,false,36,15,-21,41.86723,-87.61536
KA1706005007,5,12,false,18,13,-5,41.86749,-87.63219
SL-005,5,12,false,91,70,-21,41.8679,-87.62304
255,5,12,false,20,15,-5,41.86791,-87.62304
13285,5,12,false,13,9,-4,41.86928,-87.67372
13160,5,12,false,14,11,-3,41.86947,-87.65548
15550,5,12,false,14,7,-7,41.87024,-87.63947
TA1309000010,5,12,false,34,34,0,41.87074,-87.62574
SL-009,5,12,false,16,12,-4,41.87081,-87.63121
TA1309000064,5,12,false,14,14,0,41.87127,-87.67369
TA1307000130,5,12,false,10,9,-1,41.87178,-87.65103
TA1307000121,5,12,false,18,19,1,41.87184,-87.64664
41,5,12,false,11,8,-3,41.87209,-87.62957
SL-008,5,12,false,43,29,-14,41.87209,-87.62956
13332,5,12,false,16,12,-4,41.87219,-87.6615
SL-011,5,12,false,35,27,-8,41.87256,-87.63356
623,5,12,false,81,60,-21,41.87272,-87.62399
KA1504000104,5,12,false,24,14,-10,41.87296,-87.66912
SL-007,5,12,false,18,11,-7,41.87404,-87.6277
321,5,12,false,10,15,5,41.87427,-87.63257
TA1306000025,5,12,false,17,12,-5,41.87464,-87.65703
13028,5,12,false,10,15,5,41.87475,-87.64981
15541,5,12,false,77,69,-8,41.8758,-87.62086
TA1305000010,5,12,false,37,33,-4,41.87623,-87.62444
624,5,12,false,22,30,8,41.87626,-87.62923
TA1305000035,5,12,false,44,19,-25,41.87716,-87.62787
13138,5,12,false,14,14,0,41.87723,-87.63941
15539,5,12,false,17,15,-2,41.87763,-87.64405
13158,5,12,false,34,26,-8,41.87764,-87.64957
13157,5,12,false,19,12,-7,41.87773,-87.6548
TA1305000025,5,12,false,68,46,-22,41.87773,-87.63528
TA1309000002,5,12,false,63,72,9,41.87784,-87.62408
13206,5,12,false,12,7,-5,41.87794,-87.66201
TA1309000004,5,12,false,57,22,-35,41.87811,-87.63184
638,5,12,false,28,18,-10,41.87827,-87.64078
TA1305000005,5,12,false,43,32,-11,41.87924,-87.62975
13011,5,12,false,31,20,-11,41.87931,-87.63993
TA1309000008,5,12,false,73,39,-34,41.87933,-87.6355
KA1503000034,5,12,false,34,22,-12,41.87938,-87.63197
KA1503000015,5,12,false,62,39,-23,41.87948,-87.6257
287,5,12,false,10,7,-3,41.88017,-87.63527
TA1309000007,5,12,false,54,29,-25,41.88022,-87.63526
WL-011,5,12,false,16,10,-6,41.88034,-87.64273
13156,5,12,false,17,14,-3,41.88042,-87.65554
13300,5,12,false,324,278,-46,41.88097,-87.61675
76,5,12,false,29,30,1,41.88098,-87.61675
13008,5,12,false,261,297,36,41.88105,-87.62408
90,5,12,false,43,44,1,41.88107,-87.62409
49,5,12,false,12,5,-7,41.88116,-87.62963
TA1305000006,5,12,false,79,53,-26,41.88122,-87.6296
13134,5,12,false,18,10,-8,41.88138,-87.67493
13056,5,12,false,16,15,-1,41.88168,-87.63951
198,5,12,false,11,3,-8,41.88187,-87.6488
TA1307000120,5,12,false,54,59,5,41.88188,-87.64879
13341,5,12,false,26,20,-6,41.88208,-87.63985
13036,5,12,false,55,42,-13,41.8821,-87.62513
TA1305000032,5,12,false,41,40,-1,41.88218,-87.64109
98,5,12,false,11,7,-4,41.88266,-87.63251
13006,5,12,false,39,27,-12,41.88268,-87.63252
13353,5,12,false,15,11,-4,41.88283,-87.6612
654,5,12,false,20,13,-7,41.88307,-87.65698
13409,5,12,false,28,42,14,41.8831,-87.6511
KA1503000072,5,12,false,29,18,-11,41.88317,-87.63693
WL-012,5,12,false,26,34,8,41.88337,-87.6412
112,5,12,false,3,11,8,41.88362,-87.6486
13053,5,12,false,67,78,11,41.88365,-87.64863
43,5,12,false,17,13,-4,41.88396,-87.62455
13001,5,12,false,110,132,22,41.88397,-87.62459
13155,5,12,false,16,24,8,41.88407,-87.65689
18062,5,12,false,20,32,12,41.88412,-87.65427
81,5,12,false,10,6,-4,41.88417,-87.6296
TA1306000010,5,12,false,60,45,-15,41.88419,-87.62961
TA1305000030,5,12,false,59,38,-21,41.88459,-87.63178
15535,5,12,false,29,34,5,41.8846,-87.64455
TA1305000029,5,12,false,58,68,10,41.88466,-87.62787
195,5,12,false,18,14,-4,41.88466,-87.61952
13263,5,12,false,112,55,-57,41.88467,-87.61952
44,5,12,false,14,6,-8,41.88468,-87.62782
TA1306000015,5,12,false,50,61,11,41.88549,-87.65232
13021,5,12,false,53,29,-24,41.88559,-87.64184
TA1307000111,5,12,false,46,33,-13,41.88582,-87.63548
13073,5,12,false,14,32,18,41.88592,-87.66717
KA17018054,5,12,false,8,13,5,41.88595,-87.67701
KA1503000012,5,12,false,48,52,4,41.88599,-87.63089
52,5,12,false,22,18,-4,41.886,-87.62421
TA1305000011,5,12,false,118,94,-24,41.886,-87.62418
7,5,12,false,12,3,-9,41.88627,-87.61751
15534,5,12,false,32,30,-2,41.88627,-87.61749
13197,5,12,false,12,11,-1,41.8866,-87.65816
264,5,12,false,12,3,-9,41.8867,-87.62224
TA1308000029,5,12,false,22,29,7,41.88673,-87.62225
TA1307000131,5,12,false,85,72,-13,41.88688,-87.62606
194,5,12,false,6,16,10,41.88688,-87.62606
KA1503000064,5,12,false,125,98,-27,41.88697,-87.61281
6,5,12,false,10,7,-3,41.88697,-87.61281
TA1305000022,5,12,false,44,34,-10,41.88817,-87.63656
TA1306000003,5,12,false,56,38,-18,41.88867,-87.64442
KA1503000043,5,12,false,78,62,-16,41.88918,-87.63851
133,5,12,false,19,7,-12,41.88918,-87.63851
13050,5,12,false,69,56,-13,41.88919,-87.62775
47,5,12,false,10,9,-1,41.88921,-87.62775
13432,5,12,false,18,9,-9,41.88989,-87.67149
TA1307000151,5,12,false,70,64,-6,41.88993,-87.63427
212,5,12,false,11,11,0,41.88995,-87.63427
636,5,12,false,21,24,3,41.88997,-87.63662
KA1503000044,5,12,false,33,32,-1,41.89018,-87.6262
13427,5,12,false,33,43,10,41.89054,-87.62205
26,5,12,false,17,6,-11,41.89057,-87.61798
13430,5,12,false,86,95,9,41.89077,-87.63169
181,5,12,false,14,11,-3,41.89077,-87.63168
TA1306000013,5,12,false,73,81,8,41.89083,-87.61852
RN-,5,12,false,34,32,-2,41.89102,-87.63546
672,5,12,false,8,10,2,41.89102,-87.63545
13434,5,12,false,17,7,-10,41.89108,-87.66663
TA1308000006,5,12,false,22,14,-8,41.89128,-87.67686
199,5,12,false,10,14,4,41.89143,-87.62676
TA1307000117,5,12,false,94,117,23,41.89144,-87.62675
13033,5,12,false,50,34,-16,41.8916,-87.64835
13194,5,12,false,21,35,14,41.8918,-87.65878
TA1305000003,5,12,false,65,66,1,41.89187,-87.62061
24,5,12,false,15,7,-8,41.8919,-87.62063
35,5,12,false,24,23,-1,41.89227,-87.61206
13022,5,12,false,524,704,180,41.89227,-87.61205
99,5,12,false,13,8,-5,41.89255,-87.61449
TA1306000029,5,12,false,70,45,-25,41.89256,-87.61449
13265,5,12,false,26,37,11,41.89383,-87.64172
13045,5,12,false,83,89,6,41.89403,-87.62931
110,5,12,false,6,12,6,41.89406,-87.6293
13016,5,12,false,70,68,-2,41.89431,-87.62277
KA1503000041,5,12,false,59,32,-27,41.89452,-87.61798
13196,5,12,false,41,21,-20,41.89455,-87.65345
TA1307000062,5,12,false,33,28,-5,41.89466,-87.63839
TA1306000012,5,12,false,86,67,-19,41.89475,-87.63438
53,5,12,false,10,9,-1,41.89476,-87.63439
KP1705001026,5,12,false,45,45,0,41.89483,-87.6323
18058,5,12,false,16,7,-9,41.8955,-87.68201
637,5,12,false,15,12,-3,41.89563,-87.67209
13132,5,12,false,23,21,-2,41.89573,-87.67718
161,5,12,false,16,15,-1,41.89574,-87.62599
15530,5,12,false,79,58,-21,41.89575,-87.62596
18003,5,12,false,54,21,-33,41.89575,-87.62011
13247,5,12,false,25,17,-8,41.89597,-87.66775
TA1305000020,5,12,false,34,31,-3,41.89636,-87.65406
13289,5,12,false,17,15,-2,41.89638,-87.661
13303,5,12,false,36,37,1,41.89672,-87.63088
13017,5,12,false,30,26,-4,41.89676,-87.6357
13338,5,12,false,72,49,-23,41.89697,-87.62173
173,5,12,false,20,7,-13,41.89704,-87.62173
TA1307000061,5,12,false,41,20,-21,41.89745,-87.62873
25,5,12,false,11,11,0,41.89751,-87.62354
13034,5,12,false,103,78,-25,41.89754,-87.62352
TA1306000009,5,12,false,61,32,-29,41.89772,-87.64299
620,5,12,false,32,25,-7,41.89817,-87.63754
KA1504000103,5,12,false,23,17,-6,41.89842,-87.68659
145,5,12,false,15,8,-7,41.89856,-87.62211
15529,5,12,false,74,42,-32,41.89858,-87.62206
140,5,12,false,7,14,7,41.89895,-87.6299
TA1307000128,5,12,false,65,70,5,41.89896,-87.6299
657,5,12,false,16,7,-9,41.89918,-87.6722
13248,5,12,false,11,8,-3,41.89964,-87.66788
TA1306000011,5,12,false,17,5,-12,41.89994,-87.63443
KA1504000116,5,12,false,13,7,-6,41.90023,-87.64299
17660,5,12,false,20,11,-9,41.90036,-87.69671
13290,5,12,false,24,16,-8,41.90069,-87.66259
13042,5,12,false,235,294,59,41.90097,-87.62377
85,5,12,false,18,28,10,41.90098,-87.62375
TA1307000070,5,12,false,10,12,2,41.90133,-87.67742
KA1504000133,5,12,false,61,73,12,41.90234,-87.62773
172,5,12,false,14,12,-2,41.90236,-87.62774
13241,5,12,false,22,8,-14,41.9029,-87.68731
176,5,12,false,20,11,-9,41.90291,-87.63141
TA1306000006,5,12,false,13,8,-5,41.90292,-87.63772
TA1307000039,5,12,false,77,65,-12,41.90294,-87.63137
658,5,12,false,16,5,-11,41.903,-87.6838
13256,5,12,false,12,8,-4,41.90302,-87.69749
TA1305000034,5,12,false,24,28,4,41.90313,-87.67391
182,5,12,false,12,10,-2,41.90317,-87.63442
KA1504000135,5,12,false,83,82,-1,41.90319,-87.63439
13136,5,12,false,31,25,-6,41.90326,-87.67845
210,5,12,false,6,11,5,41.90342,-87.66781
13061,5,12,false,60,50,-10,41.90342,-87.66779
KA1504000079,5,12,false,30,27,-3,41.9035,-87.64334
TA1307000115,5,12,false,19,24,5,41.9046,-87.64056
291,5,12,false,15,14,-1,41.90672,-87.63494
TA1308000049,5,12,false,65,73,8,41.90672,-87.6349
KA1504000134,5,12,false,29,32,3,41.90687,-87.6262
13224,5,12,false,29,15,-14,41.90706,-87.66725
18069,5,12,false,11,3,-8,41.90722,-87.65563
TA1307000143,5,12,false,5,10,5,41.90762,-87.63854
13221,5,12,false,50,59,9,41.90765,-87.67254
301,5,12,false,10,2,-8,41.90796,-87.63203
TA1309000024,5,12,false,31,46,15,41.908,-87.63152
69,5,12,false,9,12,3,41.90939,-87.6777
TA1305000041,5,12,false,57,52,-5,41.9094,-87.67769
15652,5,12,false,15,12,-3,41.90965,-87.71664
331,5,12,false,49,45,-4,41.90965,-87.64812
TA1305000037,5,12,false,36,22,-14,41.91018,-87.67003
TA1306000008,5,12,false,12,7,-5,41.9102,-87.6435
TA1308000005,5,12,false,16,16,0,41.91042,-87.68238
13258,5,12,false,20,4,-16,41.91043,-87.69718
13257,5,12,false,19,18,-1,41.91054,-87.68956
13154,5,12,false,32,35,3,41.91054,-87.65312
13058,5,12,false,37,28,-9,41.91059,-87.64942
TA1307000038,5,12,false,47,53,6,41.91138,-87.63868
268,5,12,false,19,10,-9,41.91172,-87.62681
LF-005,5,12,false,168,236,68,41.91172,-87.62681
13128,5,12,false,39,35,-4,41.91197,-87.63197
TA1308000050,5,12,false,110,99,-11,41.91211,-87.6347
13243,5,12,false,29,33,4,41.91262,-87.6814
TA1306000032,5,12,false,32,20,-12,41.9137,-87.65285
TA1307000166,5,12,false,23,26,3,41.91386,-87.64877
15655,5,12,false,20,8,-12,41.91401,-87.70514
18017,5,12,false,16,11,-5,41.91416,-87.71676
18067,5,12,false,30,13,-17,41.9146,-87.66796
TA1306000007,5,12,false,16,8,-8,41.91469,-87.64333
13068,5,12,false,20,15,-5,41.91554,-87.68703
13179,5,12,false,81,91,10,41.9157,-87.63461
141,5,12,false,12,3,-9,41.91571,-87.63461
13133,5,12,false,48,23,-25,41.91598,-87.67733
TA1305000039,5,12,false,18,21,3,41.9163,-87.66749
15650,5,12,false,15,5,-10,41.91711,-87.71023
15651,5,12,false,21,30,9,41.91752,-87.70181
13266,5,12,false,18,14,-4,41.91774,-87.69142
TA1309000029,5,12,false,28,10,-18,41.9178,-87.68245
TA1309000006,5,12,false,46,14,-32,41.91809,-87.64375
TA1307000163,5,12,false,33,32,-1,41.91821,-87.65696
94,5,12,false,19,8,-11,41.91831,-87.6363
13146,5,12,false,95,84,-11,41.91831,-87.63629
13059,5,12,false,52,44,-8,41.91845,-87.65222
13259,5,12,false,14,10,-4,41.91852,-87.69744
13192,5,12,false,43,35,-8,41.91995,-87.64884
13288,5,12,false,31,17,-14,41.92008,-87.67788
13242,5,12,false,8,16,8,41.92021,-87.69266
TA1309000030,5,12,false,21,34,13,41.92077,-87.66372
13292,5,12,false,19,8,-11,41.92152,-87.70733
TA1309000033,5,12,false,41,37,-4,41.92158,-87.65381
13193,5,12,false,74,56,-18,41.92182,-87.64412
144,5,12,false,13,10,-3,41.92182,-87.64411
13191,5,12,false,34,20,-14,41.92217,-87.63891
143,5,12,false,10,10,0,41.92217,-87.63891
13084,5,12,false,22,31,9,41.92268,-87.69715
LP-,5,12,false,115,109,-6,41.92396,-87.63584
673,5,12,false,19,8,-11,41.92398,-87.63585
KA1504000140,5,12,false,12,10,-2,41.92409,-87.67646
15648,5,12,false,6,12,6,41.92464,-87.68931
KA1504000090,5,12,false,11,11,0,41.92483,-87.7145
TA1307000001,5,12,false,24,26,2,41.92535,-87.66581
TA1306000026,5,12,false,19,22,3,41.92558,-87.65842
TA1306000016,5,12,false,55,31,-24,41.9256,-87.65371
313,5,12,false,15,12,-3,41.9257,-87.64246
TA1309000019,5,12,false,68,71,3,41.92586,-87.63897
TA1309000058,5,12,false,69,77,8,41.92591,-87.64927
177,5,12,false,21,30,9,41.92627,-87.63086
TA1308000001,5,12,false,187,220,33,41.92627,-87.63086
13124,5,12,false,44,34,-10,41.92675,-87.63444
TA1309000023,5,12,false,38,25,-13,41.9287,-87.65383
TA1307000113,5,12,false,25,21,-4,41.92878,-87.66391
13296,5,12,false,26,10,-16,41.92883,-87.66852
TA1309000059,5,12,false,17,15,-2,41.92889,-87.65898
TA1309000061,5,12,false,40,40,0,41.92915,-87.64909
TA1308000031,5,12,false,22,16,-6,41.92946,-87.68417
TA1305000014,5,12,false,89,70,-19,41.92956,-87.64313
260,5,12,false,5,10,5,41.92958,-87.70791
13085,5,12,false,28,38,10,41.92958,-87.70789
TA1307000142,5,12,false,95,60,-35,41.93125,-87.64432
220,5,12,false,14,9,-5,41.93125,-87.64431
13276,5,12,false,48,28,-20,41.93132,-87.63874
324,5,12,false,12,15,3,41.93173,-87.64179
15645,5,12,false,10,10,0,41.93191,-87.70121
13271,5,12,false,13,9,-4,41.93192,-87.67784
TA1307000064,5,12,false,53,38,-15,41.93222,-87.65864
TA1306000014,5,12,false,53,31,-22,41.93242,-87.65271
TA1309000039,5,12,false,88,56,-32,41.93258,-87.63642
329,5,12,false,17,4,-13,41.93258,-87.63642
13294,5,12,false,17,14,-3,41.9326,-87.66595
TA1309000036,5,12,false,23,41,18,41.93313,-87.64776
TA1307000006,5,12,false,35,21,-14,41.93571,-87.6636
13268,5,12,false,17,7,-10,41.93588,-87.67843
13269,5,12,false,18,10,-8,41.93609,-87.66983
TA1307000052,5,12,false,42,19,-23,41.93628,-87.65266
TA1307000136,5,12,false,60,50,-10,41.9365,-87.64755
TA1307000041,5,12,false,61,53,-8,41.93669,-87.63683
157,5,12,false,11,12,1,41.9367,-87.63683
13137,5,12,false,86,69,-17,41.9376,-87.6441
300,5,12,false,14,6,-8,41.93761,-87.6441
15642,5,12,false,16,14,-2,41.93843,-87.69801
154,5,12,false,10,4,-6,41.93912,-87.66384
KA17018068,5,12,false,13,6,-7,41.93935,-87.68327
TA1309000042,5,12,false,17,26,9,41.93937,-87.66836
13229,5,12,false,30,20,-10,41.93946,-87.66376
TA1308000019,5,12,false,31,35,4,41.93973,-87.65886
13277,5,12,false,62,48,-14,41.9401,-87.64546
TA1307000134,5,12,false,62,102,40,41.94016,-87.65303
117,5,12,false,3,13,10,41.94016,-87.65302
13143,5,12,false,18,9,-9,41.94059,-87.67853
334,5,12,false,11,11,0,41.94076,-87.63919
TA1309000049,5,12,false,92,71,-21,41.94077,-87.63919
TA1307000138,5,12,false,34,28,-6,41.94334,-87.67094
13144,5,12,false,21,15,-6,41.9434,-87.67964
299,5,12,false,11,5,-6,41.94368,-87.64894
TA1309000025,5,12,false,48,84,36,41.94368,-87.64894
229,5,12,false,8,10,2,41.94372,-87.66401
13071,5,12,false,34,52,18,41.94373,-87.66401
632,5,12,false,48,91,43,41.94453,-87.6547
15631,5,12,false,6,10,4,41.94524,-87.70665
13278,5,12,false,43,36,-7,41.94553,-87.64644
TA1309000050,5,12,false,7,11,4,41.94618,-87.67331
KA1504000143,5,12,false,16,4,-12,41.94664,-87.68337
13235,5,12,false,45,64,19,41.94814,-87.66396
304,5,12,false,4,11,7,41.94878,-87.64922
13325,5,12,false,38,56,18,41.94907,-87.64863
114,5,12,false,2,11,9,41.94935,-87.65451
TA1307000126,5,12,false,66,238,172,41.94936,-87.65451
TA1307000150,5,12,false,55,71,16,41.94945,-87.64646
13319,5,12,false,15,13,-2,41.95069,-87.6687
TA1307000127,5,12,false,62,137,75,41.9508,-87.65918
13323,5,12,false,33,28,-5,41.95282,-87.65
TA1309000043,5,12,false,11,20,9,41.95417,-87.66434
240,5,12,false,12,5,-7,41.95424,-87.65441
13063,5,12,false,35,51,16,41.95424,-87.65441
KA1504000158,5,12,false,17,11,-6,41.95432,-87.68607
TA1308000022,5,12,false,30,28,-2,41.95438,-87.64805
TA1307000149,5,12,false,11,9,-2,41.95467,-87.67392
13249,5,12,false,11,4,-7,41.95606,-87.66885
13379,5,12,false,24,19,-5,41.95786,-87.6495
TA1309000027,5,12,false,25,16,-9,41.9585,-87.65499
13389,5,12,false,29,11,-18,41.961,-87.64958
TA1307000144,5,12,false,19,7,-12,41.96142,-87.6762
TA1309000021,5,12,false,12,5,-7,41.9615,-87.6714
KA1503000022,5,12,false,22,7,-15,41.96158,-87.66609
TA1307000107,5,12,false,29,28,-1,41.96164,-87.65464
TA1307000156,5,12,false,3,10,7,41.96301,-87.68479
TA1308000012,5,12,false,72,84,12,41.96398,-87.63818
13074,5,12,false,29,24,-5,41.96521,-87.6582
639,5,12,false,47,24,-23,41.96584,-87.64538
TA1307000140,5,12,false,11,17,6,41.96643,-87.68865
TA1309000014,5,12,false,26,16,-10,41.96709,-87.66744
TA1307000158,5,12,false,13,15,2,41.9671,-87.67904
TA1307000119,5,12,false,14,11,-3,41.96796,-87.65
TA1308000021,5,12,false,12,10,-2,41.96883,-87.65765
TA1309000015,5,12,false,12,5,-7,41.96889,-87.68401
TA1309000066,5,12,false,41,18,-23,41.9691,-87.67423
TA1309000041,5,12,false,17,12,-5,41.96951,-87.65471
KA1504000171,5,12,false,30,12,-18,41.97161,-87.65016
TA1309000035,5,12,false,19,39,20,41.97335,-87.66785
13108,5,12,false,18,16,-2,41.97379,-87.65971
KA1504000146,5,12,false,34,26,-8,41.978,-87.66805
13109,5,12,false,11,13,2,41.97835,-87.65976
KA1504000151,5,12,false,21,18,-3,41.98359,-87.66916
459,5,12,false,14,4,-10,41.98403,-87.65231
KA1504000152,5,12,false,58,61,3,41.98403,-87.65231
15578,5,12,false,15,7,-8,41.98405,-87.66027
15575,5,12,false,19,21,2,41.98975,-87.66014
15571,5,12,false,19,25,6,41.99478,-87.66028
RP-009,5,12,false,23,7,-16,42.00107,-87.66122
660,5,12,false,9,13,4,42.00458,-87.66143
KA1504000175,5,12,false,11,4,-7,42.00797,-87.66549
E002,5,12,false,3,13,10,42.03256,-87.67912
596,5,12,false,16,23,7,42.04822,-87.68348
E008,5,12,false,11,8,-3,42.05049,-87.67782
605,5,12,false,11,7,-4,42.05294,-87.67342
661,5,12,false,14,9,-5,42.05704,-87.68657
604,5,12,false,31,18,-13,42.05824,-87.67744
KA1503000029,5,12,true,10,2,-8,41.77364,-87.56747
426,5,12,true,16,8,-8,41.7851,-87.60108
KA1503000014,5,12,true,66,64,-2,41.7851,-87.60108
KA1503000070,5,12,true,13,10,-3,41.78794,-87.58831
328,5,12,true,11,8,-3,41.78872,-87.6013
TA1309000011,5,12,true,35,33,-2,41.78873,-87.60131
423,5,12,true,8,20,12,41.79148,-87.59988
KA1503000071,5,12,true,49,69,20,41.79148,-87.59988
KA1503000074,5,12,true,14,9,-5,41.79174,-87.58395
TA1309000063,5,12,true,23,29,6,41.79325,-87.5878
420,5,12,true,17,10,-7,41.79429,-87.60145
KA1504000076,5,12,true,68,68,0,41.7943,-87.60145
247,5,12,true,11,8,-3,41.79522,-87.58077
TA1308000009,5,12,true,34,27,-7,41.79522,-87.58075
TA1307000164,5,12,true,15,24,9,41.79527,-87.59647
KA1503000052,5,12,true,24,16,-8,41.79935,-87.60097
KA1503000059,5,12,true,22,25,3,41.79952,-87.58643
TA1309000037,5,12,true,40,45,5,41.79957,-87.59474
KA1503000007,5,12,true,29,23,-6,41.80242,-87.58689
13398,5,12,true,16,9,-7,41.80256,-87.59035
121,5,12,true,10,6,-4,41.80256,-87.59035
322,5,12,true,11,12,1,41.80321,-87.59849
TA1308000035,5,12,true,10,17,7,41.80944,-87.59188
KA1503000065,5,12,true,14,2,-12,41.81409,-87.59701
13420,5,12,true,9,12,3,41.82459,-87.61678
TA1308000045,5,12,true,23,9,-14,41.83062,-87.64129
TA1307000129,5,12,true,17,27,10,41.83104,-87.62683
13345,5,12,true,5,12,7,41.83138,-87.61803
13216,5,12,true,45,60,15,41.83473,-87.62581
148,5,12,true,7,21,14,41.83474,-87.62581
13217,5,12,true,27,19,-8,41.83488,-87.61792
13215,5,12,true,17,11,-6,41.83634,-87.6135
TA1308000046,5,12,true,14,7,-7,41.83779,-87.65115
TA1309000055,5,12,true,24,18,-6,41.8382,-87.64514
KA1503000038,5,12,true,12,15,3,41.83845,-87.6354
TA1307000048,5,12,true,15,18,3,41.83855,-87.60821
TA1308000036,5,12,true,29,19,-10,41.83883,-87.62186
TA1307000139,5,12,true,38,18,-20,41.84205,-87.61698
TA1307000153,5,12,true,12,4,-8,41.84358,-87.64538
TA1307000005,5,12,true,17,19,2,41.84569,-87.6225
TA1305000001,5,12,true,11,6,-5,41.85262,-87.6265
13075,5,12,true,21,18,-3,41.8531,-87.63192
13091,5,12,true,14,4,-10,41.85409,-87.68585
13307,5,12,true,11,13,2,41.85489,-87.66359
4,5,12,true,11,10,-1,41.85627,-87.61334
15545,5,12,true,35,43,8,41.85627,-87.61334
SL-013,5,12,true,6,10,4,41.85659,-87.62755
129,5,12,true,10,3,-7,41.85752,-87.66158
13135,5,12,true,18,19,1,41.85753,-87.66157
13102,5,12,true,32,29,-3,41.85762,-87.61942
13150,5,12,true,29,25,-4,41.85783,-87.62455
TA1307000159,5,12,true,11,21,10,41.8579,-87.6687
13163,5,12,true,15,16,1,41.85808,-87.65108
13164,5,12,true,27,10,-17,41.85818,-87.65648
15,5,12,true,2,10,8,41.85819,-87.65648
SL-012,5,12,true,40,49,9,41.86038,-87.62581
72,5,12,true,11,9,-2,41.86039,-87.62581
13304,5,12,true,12,9,-3,41.86126,-87.65659
TA1306000002,5,12,true,14,19,5,41.86238,-87.65108
TA1307000124,5,12,true,67,56,-11,41.86411,-87.62372
168,5,12,true,15,17,2,41.86415,-87.62372
TA1309000001,5,12,true,47,29,-18,41.86488,-87.64708
13354,5,12,true,11,17,6,41.86524,-87.66651
13029,5,12,true,13,16,3,41.86531,-87.6179
13431,5,12,true,28,11,-17,41.8661,-87.60728
KA1504000101,5,12,true,9,10,1,41.86651,-87.68466
WL-008,5,12,true,27,41,14,41.86712,-87.64108
59,5,12,true,16,22,6,41.86721,-87.62597
TA1305000002,5,12,true,71,92,21,41.86721,-87.62597
15544,5,12,true,43,30,-13,41.86723,-87.61536
TA1305000017,5,12,true,15,28,13,41.86734,-87.64863
55,5,12,true,5,16,11,41.86735,-87.64863
KA1706005007,5,12,true,21,16,-5,41.86749,-87.63219
SL-005,5,12,true,55,46,-9,41.8679,-87.62304
255,5,12,true,16,10,-6,41.86791,-87.62304
644,5,12,true,35,18,-17,41.86859,-87.68625
19,5,12,true,15,4,-11,41.86892,-87.65913
13139,5,12,true,54,36,-18,41.86893,-87.65913
13285,5,12,true,36,46,10,41.86928,-87.67372
22,5,12,true,12,7,-5,41.86947,-87.65548
13160,5,12,true,31,27,-4,41.86947,-87.65548
15550,5,12,true,26,37,11,41.87024,-87.63947
TA1309000010,5,12,true,52,44,-8,41.87074,-87.62574
SL-009,5,12,true,23,21,-2,41.87081,-87.63121
342,5,12,true,15,12,-3,41.87127,-87.6737
TA1309000064,5,12,true,65,58,-7,41.87127,-87.67369
15542,5,12,true,3,17,14,41.87146,-87.64095
TA1307000130,5,12,true,52,65,13,41.87178,-87.65103
241,5,12,true,11,9,-2,41.8718,-87.65102
108,5,12,true,11,24,13,41.87183,-87.64664
TA1307000121,5,12,true,75,67,-8,41.87184,-87.64664
41,5,12,true,21,21,0,41.87209,-87.62957
SL-008,5,12,true,74,81,7,41.87209,-87.62956
13332,5,12,true,80,63,-17,41.87219,-87.6615
SL-011,5,12,true,47,34,-13,41.87256,-87.63356
623,5,12,true,39,35,-4,41.87272,-87.62399
KA1504000104,5,12,true,74,56,-18,41.87296,-87.66912
383,5,12,true,17,7,-10,41.87297,-87.66912
320,5,12,true,22,22,0,41.87327,-87.66402
SL-007,5,12,true,16,30,14,41.87404,-87.6277
13326,5,12,true,23,16,-7,41.87425,-87.63958
321,5,12,true,22,17,-5,41.87427,-87.63257
TA1306000025,5,12,true,23,25,2,41.87464,-87.65703
15668,5,12,true,13,14,1,41.87471,-87.68642
13028,5,12,true,20,31,11,41.87475,-87.64981
SL-010,5,12,true,18,17,-1,41.87501,-87.63309
15541,5,12,true,14,21,7,41.8758,-87.62086
13037,5,12,true,18,7,-11,41.87588,-87.64078
TA1305000009,5,12,true,12,26,14,41.87593,-87.63068
317,5,12,true,4,11,7,41.87603,-87.68195
TA1305000010,5,12,true,18,14,-4,41.87623,-87.62444
624,5,12,true,35,41,6,41.87626,-87.62923
33,5,12,true,9,15,6,41.87715,-87.62786
TA1305000035,5,12,true,31,56,25,41.87716,-87.62787
13138,5,12,true,33,25,-8,41.87723,-87.63941
15539,5,12,true,58,47,-11,41.87763,-87.64405
13158,5,12,true,62,83,21,41.87764,-87.64957
134,5,12,true,18,19,1,41.87764,-87.64954
21,5,12,true,16,8,-8,41.87773,-87.6548
13157,5,12,true,46,57,11,41.87773,-87.6548
TA1305000025,5,12,true,59,66,7,41.87773,-87.63528
36,5,12,true,10,10,0,41.87776,-87.63525
TA1309000002,5,12,true,26,26,0,41.87784,-87.62408
13206,5,12,true,42,31,-11,41.87794,-87.66201
146,5,12,true,5,11,6,41.87794,-87.66201
283,5,12,true,10,9,-1,41.87809,-87.63183
TA1309000004,5,12,true,66,43,-23,41.87811,-87.63184
107,5,12,true,23,18,-5,41.87822,-87.644
638,5,12,true,39,49,10,41.87827,-87.64078
37,5,12,true,15,11,-4,41.87921,-87.62975
TA1305000005,5,12,true,45,39,-6,41.87924,-87.62975
13011,5,12,true,66,73,7,41.87931,-87.63993
TA1309000008,5,12,true,43,21,-22,41.87933,-87.6355
192,5,12,true,22,15,-7,41.87935,-87.63997
KA1503000034,5,12,true,36,19,-17,41.87938,-87.63197
KA1503000015,5,12,true,26,39,13,41.87948,-87.6257
287,5,12,true,17,9,-8,41.88017,-87.63527
TA1309000007,5,12,true,98,60,-38,41.88022,-87.63526
WL-011,5,12,true,34,32,-2,41.88034,-87.64273
80,5,12,true,10,8,-2,41.88042,-87.65556
13156,5,12,true,47,41,-6,41.88042,-87.65554
13300,5,12,true,52,60,8,41.88097,-87.61675
76,5,12,true,14,20,6,41.88098,-87.61675
13008,5,12,true,48,68,20,41.88105,-87.62408
90,5,12,true,12,12,0,41.88107,-87.62409
49,5,12,true,18,11,-7,41.88116,-87.62963
TA1305000006,5,12,true,89,68,-21,41.88122,-87.6296
13134,5,12,true,12,6,-6,41.88138,-87.67493
13056,5,12,true,19,15,-4,41.88168,-87.63951
198,5,12,true,22,12,-10,41.88187,-87.6488
TA1307000120,5,12,true,94,119,25,41.88188,-87.64879
13341,5,12,true,42,33,-9,41.88208,-87.63985
197,5,12,true,8,13,5,41.88208,-87.62513
13036,5,12,true,54,54,0,41.8821,-87.62513
77,5,12,true,7,12,5,41.88214,-87.64108
TA1305000032,5,12,true,91,86,-5,41.88218,-87.64109
98,5,12,true,12,9,-3,41.88266,-87.63251
13006,5,12,true,93,70,-23,41.88268,-87.63252
13353,5,12,true,23,28,5,41.88283,-87.6612
654,5,12,true,23,34,11,41.88307,-87.65698
13409,5,12,true,31,42,11,41.8831,-87.6511
KA1503000072,5,12,true,62,34,-28,41.88317,-87.63693
91,5,12,true,3,11,8,41.88336,-87.64122
WL-012,5,12,true,44,69,25,41.88337,-87.6412
112,5,12,true,15,20,5,41.88362,-87.6486
13053,5,12,true,83,97,14,41.88365,-87.64863
43,5,12,true,13,13,0,41.88396,-87.62455
13001,5,12,true,61,74,13,41.88397,-87.62459
13155,5,12,true,18,19,1,41.88407,-87.65689
18062,5,12,true,33,39,6,41.88412,-87.65427
81,5,12,true,13,28,15,41.88417,-87.6296
TA1306000010,5,12,true,83,86,3,41.88419,-87.62961
TA1305000030,5,12,true,80,82,2,41.88459,-87.63178
15535,5,12,true,41,33,-8,41.8846,-87.64455
96,5,12,true,11,10,-1,41.8846,-87.64455
51,5,12,true,15,17,2,41.88462,-87.63176
TA1305000029,5,12,true,67,52,-15,41.88466,-87.62787
195,5,12,true,21,11,-10,41.88466,-87.61952
13263,5,12,true,62,43,-19,41.88467,-87.61952
44,5,12,true,15,7,-8,41.88468,-87.62782
TA1306000015,5,12,true,60,69,9,41.88549,-87.65232
71,5,12,true,15,21,6,41.8855,-87.65233
66,5,12,true,16,15,-1,41.88557,-87.64186
13021,5,12,true,85,88,3,41.88559,-87.64184
TA1307000111,5,12,true,74,53,-21,41.88582,-87.63548
164,5,12,true,12,12,0,41.88583,-87.63547
13073,5,12,true,10,8,-2,41.88592,-87.66717
38,5,12,true,11,13,2,41.88599,-87.63089
KA1503000012,5,12,true,44,50,6,41.88599,-87.63089
52,5,12,true,3,13,10,41.886,-87.62421
TA1305000011,5,12,true,63,63,0,41.886,-87.62418
15534,5,12,true,41,33,-8,41.88627,-87.61749
13197,5,12,true,23,30,7,41.8866,-87.65816
TA1308000029,5,12,true,41,37,-4,41.88673,-87.62225
TA1307000131,5,12,true,36,23,-13,41.88688,-87.62606
6,5,12,true,9,10,1,41.88697,-87.61281
KA1503000064,5,12,true,21,30,9,41.88697,-87.61281
100,5,12,true,12,12,0,41.88814,-87.63657
TA1305000022,5,12,true,82,84,2,41.88817,-87.63656
56,5,12,true,19,19,0,41.88866,-87.64442
TA1306000003,5,12,true,84,101,17,41.88867,-87.64442
133,5,12,true,27,39,12,41.88918,-87.63851
KA1503000043,5,12,true,115,152,37,41.88918,-87.63851
13050,5,12,true,38,48,10,41.88919,-87.62775
15664,5,12,true,5,15,10,41.8895,-87.68821
13432,5,12,true,14,11,-3,41.88989,-87.67149
TA1307000151,5,12,true,79,69,-10,41.88993,-87.63427
212,5,12,true,11,21,10,41.88995,-87.63427
636,5,12,true,41,67,26,41.88997,-87.63662
KA1503000044,5,12,true,30,33,3,41.89018,-87.6262
13427,5,12,true,47,29,-18,41.89054,-87.62205
26,5,12,true,14,10,-4,41.89057,-87.61798
13430,5,12,true,76,77,1,41.89077,-87.63169
181,5,12,true,8,14,6,41.89077,-87.63168
TA1306000013,5,12,true,54,71,17,41.89083,-87.61852
RN-,5,12,true,63,54,-9,41.89102,-87.63546
672,5,12,true,11,15,4,41.89102,-87.63545
13434,5,12,true,18,14,-4,41.89108,-87.66663
TA1308000006,5,12,true,13,11,-2,41.89128,-87.67686
199,5,12,true,23,37,14,41.89143,-87.62676
TA1307000117,5,12,true,73,107,34,41.89144,-87.62675
13033,5,12,true,67,70,3,41.8916,-87.64835
84,5,12,true,16,14,-2,41.89161,-87.64833
186,5,12,true,12,12,0,41.8918,-87.65879
13194,5,12,true,53,56,3,41.8918,-87.65878
TA1305000003,5,12,true,84,69,-15,41.89187,-87.62061
24,5,12,true,16,17,1,41.8919,-87.62063
643,5,12,true,8,12,4,41.89203,-87.68939
35,5,12,true,14,8,-6,41.89227,-87.61206
13022,5,12,true,96,93,-3,41.89227,-87.61205
99,5,12,true,11,12,1,41.89255,-87.61449
TA1306000029,5,12,true,43,46,3,41.89256,-87.61449
13265,5,12,true,76,92,16,41.89383,-87.64172
74,5,12,true,22,19,-3,41.89384,-87.64173
13045,5,12,true,117,122,5,41.89403,-87.62931
110,5,12,true,22,15,-7,41.89406,-87.6293
13016,5,12,true,131,98,-33,41.89431,-87.62277
211,5,12,true,33,20,-13,41.89439,-87.62267
KA1503000041,5,12,true,84,71,-13,41.89452,-87.61798
142,5,12,true,23,21,-2,41.89453,-87.61806
92,5,12,true,10,6,-4,41.89455,-87.65346
13196,5,12,true,36,30,-6,41.89455,-87.65345
TA1307000062,5,12,true,77,38,-39,41.89466,-87.63839
111,5,12,true,12,14,2,41.89466,-87.63837
TA1306000012,5,12,true,92,94,2,41.89475,-87.63438
53,5,12,true,27,19,-8,41.89476,-87.63439
627,5,12,true,15,7,-8,41.8948,-87.63231
KP1705001026,5,12,true,52,50,-2,41.89483,-87.6323
16920,5,12,true,13,16,3,41.89495,-87.76491
18058,5,12,true,10,12,2,41.8955,-87.68201
637,5,12,true,28,21,-7,41.89563,-87.67209
13132,5,12,true,32,37,5,41.89573,-87.67718
161,5,12,true,12,16,4,41.89574,-87.62599
15530,5,12,true,63,67,4,41.89575,-87.62596
18003,5,12,true,47,45,-2,41.89575,-87.62011
13247,5,12,true,38,31,-7,41.89597,-87.66775
TA1305000020,5,12,true,42,33,-9,41.89636,-87.65406
13289,5,12,true,37,26,-11,41.89638,-87.661
337,5,12,true,17,17,0,41.89659,-87.63096
13303,5,12,true,40,46,6,41.89672,-87.63088
13017,5,12,true,62,56,-6,41.89676,-87.6357
31,5,12,true,15,21,6,41.89677,-87.63572
13338,5,12,true,58,54,-4,41.89697,-87.62173
173,5,12,true,13,14,1,41.89704,-87.62173
TA1307000061,5,12,true,33,34,1,41.89745,-87.62873
106,5,12,true,12,9,-3,41.89746,-87.62874
13034,5,12,true,29,39,10,41.89754,-87.62352
TA1306000009,5,12,true,74,39,-35,41.89772,-87.64299
620,5,12,true,44,47,3,41.89817,-87.63754
KA1504000103,5,12,true,32,20,-12,41.89842,-87.68659
145,5,12,true,13,14,1,41.89856,-87.62211
15529,5,12,true,52,47,-5,41.89858,-87.62206
140,5,12,true,20,22,2,41.89895,-87.6299
TA1307000128,5,12,true,78,100,22,41.89896,-87.6299
657,5,12,true,20,25,5,41.89918,-87.6722
13248,5,12,true,28,28,0,41.89964,-87.66788
TA1306000011,5,12,true,24,29,5,41.89994,-87.63443
KA1504000116,5,12,true,22,21,-1,41.90023,-87.64299
17660,5,12,true,13,10,-3,41.90036,-87.69671
13290,5,12,true,27,20,-7,41.90069,-87.66259
13042,5,12,true,68,86,18,41.90097,-87.62377
85,5,12,true,12,11,-1,41.90098,-87.62375
TA1307000070,5,12,true,22,15,-7,41.90133,-87.67742
KA1504000133,5,12,true,62,51,-11,41.90234,-87.62773
172,5,12,true,12,14,2,41.90236,-87.62774
13241,5,12,true,17,6,-11,41.9029,-87.68731
176,5,12,true,31,32,1,41.90291,-87.63141
TA1306000006,5,12,true,10,18,8,41.90292,-87.63772
TA1307000039,5,12,true,110,121,11,41.90294,-87.63137
658,5,12,true,23,16,-7,41.903,-87.6838
13256,5,12,true,16,16,0,41.90302,-87.69749
17,5,12,true,10,4,-6,41.90313,-87.67391
TA1305000034,5,12,true,42,45,3,41.90313,-87.67391
182,5,12,true,17,20,3,41.90317,-87.63442
KA1504000135,5,12,true,97,104,7,41.90319,-87.63439
13136,5,12,true,37,39,2,41.90326,-87.67845
210,5,12,true,19,20,1,41.90342,-87.66781
13061,5,12,true,77,66,-11,41.90342,-87.66779
KA1504000079,5,12,true,48,47,-1,41.9035,-87.64334
359,5,12,true,10,8,-2,41.90458,-87.6497
TA1307000115,5,12,true,33,34,1,41.9046,-87.64056
291,5,12,true,10,16,6,41.90672,-87.63494
TA1308000049,5,12,true,79,70,-9,41.90672,-87.6349
KA1504000134,5,12,true,41,38,-3,41.90687,-87.6262
180,5,12,true,14,15,1,41.90687,-87.62618
13224,5,12,true,32,27,-5,41.90706,-87.66725
TA1307000143,5,12,true,10,13,3,41.90762,-87.63854
61,5,12,true,12,6,-6,41.90764,-87.67254
13221,5,12,true,34,50,16,41.90765,-87.67254
13245,5,12,true,22,5,-17,41.90777,-87.68586
301,5,12,true,18,13,-5,41.90796,-87.63203
TA1309000024,5,12,true,76,63,-13,41.908,-87.63152
69,5,12,true,10,18,8,41.90939,-87.6777
TA1305000041,5,12,true,57,54,-3,41.9094,-87.67769
331,5,12,true,100,93,-7,41.90965,-87.64812
15653,5,12,true,10,12,2,41.90979,-87.7053
TA1305000037,5,12,true,27,25,-2,41.91018,-87.67003
TA1306000008,5,12,true,24,21,-3,41.9102,-87.6435
TA1308000005,5,12,true,21,17,-4,41.91042,-87.68238
13258,5,12,true,18,5,-13,41.91043,-87.69718
13257,5,12,true,12,6,-6,41.91054,-87.68956
13154,5,12,true,72,86,14,41.91054,-87.65312
20,5,12,true,12,14,2,41.91055,-87.65313
60,5,12,true,9,12,3,41.91059,-87.64942
13058,5,12,true,43,58,15,41.91059,-87.64942
TA1307000038,5,12,true,53,37,-16,41.91138,-87.63868
118,5,12,true,13,7,-6,41.91138,-87.63868
268,5,12,true,20,19,-1,41.91172,-87.62681
LF-005,5,12,true,79,81,2,41.91172,-87.62681
126,5,12,true,10,4,-6,41.91196,-87.63197
13128,5,12,true,27,40,13,41.91197,-87.63197
289,5,12,true,28,30,2,41.91209,-87.63472
TA1308000050,5,12,true,121,125,4,41.91211,-87.6347
158,5,12,true,12,16,4,41.91262,-87.6814
13243,5,12,true,40,53,13,41.91262,-87.6814
TA1309000032,5,12,true,7,15,8,41.91293,-87.66417
TA1306000032,5,12,true,79,57,-22,41.9137,-87.65285
93,5,12,true,15,15,0,41.91371,-87.65285
TA1307000166,5,12,true,44,67,23,41.91386,-87.64877
15655,5,12,true,9,14,5,41.91401,-87.70514
18017,5,12,true,16,13,-3,41.91416,-87.71676
18067,5,12,true,37,37,0,41.9146,-87.66796
TA1306000007,5,12,true,25,17,-8,41.91469,-87.64333
13068,5,12,true,26,29,3,41.91554,-87.68703
116,5,12,true,12,10,-2,41.91555,-87.68703
13179,5,12,true,57,65,8,41.9157,-87.63461
141,5,12,true,11,9,-2,41.91571,-87.63461
13133,5,12,true,39,26,-13,41.91598,-87.67733
TA1305000039,5,12,true,13,21,8,41.9163,-87.66749
15651,5,12,true,21,19,-2,41.91752,-87.70181
13266,5,12,true,17,22,5,41.91774,-87.69142
TA1309000029,5,12,true,31,18,-13,41.9178,-87.68245
288,5,12,true,10,7,-3,41.91809,-87.64375
TA1309000006,5,12,true,37,42,5,41.91809,-87.64375
TA1307000163,5,12,true,45,43,-2,41.91821,-87.65696
94,5,12,true,37,22,-15,41.91831,-87.6363
13146,5,12,true,102,81,-21,41.91831,-87.63629
13059,5,12,true,64,68,4,41.91845,-87.65222
113,5,12,true,18,22,4,41.91846,-87.65222
13259,5,12,true,28,15,-13,41.91852,-87.69744
13192,5,12,true,74,73,-1,41.91995,-87.64884
225,5,12,true,10,18,8,41.91995,-87.64884
13288,5,12,true,23,19,-4,41.92008,-87.67788
13242,5,12,true,9,14,5,41.92021,-87.69266
TA1309000030,5,12,true,30,45,15,41.92077,-87.66372
13292,5,12,true,14,11,-3,41.92152,-87.70733
TA1309000033,5,12,true,58,66,8,41.92158,-87.65381
13193,5,12,true,64,76,12,41.92182,-87.64412
144,5,12,true,15,20,5,41.92182,-87.64411
13191,5,12,true,49,31,-18,41.92217,-87.63891
143,5,12,true,15,7,-8,41.92217,-87.63891
327,5,12,true,12,15,3,41.92225,-87.65783
13084,5,12,true,38,29,-9,41.92268,-87.69715
LP-,5,12,true,50,46,-4,41.92396,-87.63584
673,5,12,true,14,5,-9,41.92398,-87.63585
KA1504000140,5,12,true,18,13,-5,41.92409,-87.67646
KA1504000090,5,12,true,12,10,-2,41.92483,-87.7145
TA1307000001,5,12,true,45,54,9,41.92535,-87.66581
TA1306000026,5,12,true,70,47,-23,41.92558,-87.65842
87,5,12,true,11,10,-1,41.92559,-87.65843
TA1306000016,5,12,true,67,54,-13,41.9256,-87.65371
67,5,12,true,14,11,-3,41.9256,-87.65371
313,5,12,true,16,29,13,41.9257,-87.64246
TA1309000019,5,12,true,83,59,-24,41.92586,-87.63897
TA1309000058,5,12,true,92,108,16,41.92591,-87.64927
127,5,12,true,20,16,-4,41.92592,-87.64927
TA1308000001,5,12,true,86,76,-10,41.92627,-87.63086
177,5,12,true,25,27,2,41.92627,-87.63086
15646,5,12,true,11,9,-2,41.92668,-87.6977
13124,5,12,true,15,14,-1,41.92675,-87.63444
302,5,12,true,6,16,10,41.92859,-87.65421
TA1309000023,5,12,true,41,33,-8,41.9287,-87.65383
TA1307000113,5,12,true,27,22,-5,41.92878,-87.66391
13296,5,12,true,18,12,-6,41.92883,-87.66852
TA1309000059,5,12,true,32,31,-1,41.92889,-87.65898
349,5,12,true,17,13,-4,41.92915,-87.6491
TA1309000061,5,12,true,70,62,-8,41.92915,-87.64909
TA1308000031,5,12,true,15,16,1,41.92946,-87.68417
340,5,12,true,23,13,-10,41.92956,-87.64313
TA1305000014,5,12,true,83,94,11,41.92956,-87.64313
260,5,12,true,10,2,-8,41.92958,-87.70791
13085,5,12,true,19,33,14,41.92958,-87.70789
TA1307000142,5,12,true,87,95,8,41.93125,-87.64432
220,5,12,true,28,25,-3,41.93125,-87.64431
13276,5,12,true,55,60,5,41.93132,-87.63874
324,5,12,true,8,15,7,41.93173,-87.64179
13271,5,12,true,19,26,7,41.93192,-87.67784
152,5,12,true,7,11,4,41.93221,-87.65864
TA1307000064,5,12,true,57,49,-8,41.93222,-87.65864
13,5,12,true,11,11,0,41.93242,-87.65271
TA1306000014,5,12,true,61,69,8,41.93242,-87.65271
TA1309000039,5,12,true,73,47,-26,41.93258,-87.63642
13294,5,12,true,21,22,1,41.9326,-87.66595
TA1309000036,5,12,true,65,57,-8,41.93313,-87.64776
332,5,12,true,15,12,-3,41.93313,-87.64776
TA1307000006,5,12,true,45,30,-15,41.93571,-87.6636
153,5,12,true,12,3,-9,41.93575,-87.66364
13268,5,12,true,20,12,-8,41.93588,-87.67843
13269,5,12,true,38,25,-13,41.93609,-87.66983
TA1307000052,5,12,true,65,59,-6,41.93628,-87.65266
156,5,12,true,14,17,3,41.9365,-87.64756
TA1307000136,5,12,true,114,69,-45,41.9365,-87.64755
TA1307000041,5,12,true,82,45,-37,41.93669,-87.63683
157,5,12,true,17,10,-7,41.9367,-87.63683
13137,5,12,true,118,115,-3,41.9376,-87.6441
300,5,12,true,19,31,12,41.93761,-87.6441
154,5,12,true,16,10,-6,41.93912,-87.66384
KA17018068,5,12,true,15,12,-3,41.93935,-87.68327
TA1309000042,5,12,true,43,46,3,41.93937,-87.66836
131,5,12,true,10,14,4,41.93937,-87.66835
13229,5,12,true,30,32,2,41.93946,-87.66376
226,5,12,true,10,5,-5,41.93972,-87.65886
TA1308000019,5,12,true,33,40,7,41.93973,-87.65886
13277,5,12,true,71,61,-10,41.9401,-87.64546
296,5,12,true,12,10,-2,41.9401,-87.64546
TA1307000134,5,12,true,76,84,8,41.94016,-87.65303
117,5,12,true,17,17,0,41.94016,-87.65302
13143,5,12,true,12,11,-1,41.94059,-87.67853
334,5,12,true,14,15,1,41.94076,-87.63919
TA1309000049,5,12,true,65,52,-13,41.94077,-87.63919
15634,5,12,true,13,6,-7,41.94304,-87.68729
TA1307000138,5,12,true,47,44,-3,41.94334,-87.67094
230,5,12,true,11,11,0,41.94335,-87.67093
13144,5,12,true,18,34,16,41.9434,-87.67964
299,5,12,true,17,6,-11,41.94368,-87.64894
TA1309000025,5,12,true,67,63,-4,41.94368,-87.64894
229,5,12,true,24,15,-9,41.94372,-87.66401
13071,5,12,true,66,68,2,41.94373,-87.66401
632,5,12,true,67,71,4,41.94453,-87.6547
303,5,12,true,22,15,-7,41.94522,-87.64702
15631,5,12,true,2,12,10,41.94524,-87.70665
13278,5,12,true,80,92,12,41.94553,-87.64644
TA1309000050,5,12,true,13,7,-6,41.94618,-87.67331
227,5,12,true,21,10,-11,41.94813,-87.66397
13235,5,12,true,46,87,41,41.94814,-87.66396
304,5,12,true,21,19,-2,41.94878,-87.64922
13253,5,12,true,19,18,-1,41.9488,-87.67527
13325,5,12,true,84,88,4,41.94907,-87.64863
114,5,12,true,7,12,5,41.94935,-87.65451
TA1307000126,5,12,true,53,161,108,41.94936,-87.65451
232,5,12,true,19,10,-9,41.94943,-87.64645
TA1307000150,5,12,true,80,69,-11,41.94945,-87.64646
13319,5,12,true,21,19,-2,41.95069,-87.6687
TA1307000127,5,12,true,71,95,24,41.9508,-87.65918
165,5,12,true,19,12,-7,41.95081,-87.65918
13323,5,12,true,69,41,-28,41.95282,-87.65
256,5,12,true,15,11,-4,41.95282,-87.65
TA1309000043,5,12,true,34,27,-7,41.95417,-87.66434
240,5,12,true,11,9,-2,41.95424,-87.65441
13063,5,12,true,53,60,7,41.95424,-87.65441
KA1504000158,5,12,true,14,9,-5,41.95432,-87.68607
254,5,12,true,16,17,1,41.95438,-87.64806
TA1308000022,5,12,true,46,33,-13,41.95438,-87.64805
TA1307000149,5,12,true,31,13,-18,41.95467,-87.67392
TA1309000026,5,12,true,32,21,-11,41.95601,-87.6802
13249,5,12,true,12,8,-4,41.95606,-87.66885
312,5,12,true,12,11,-1,41.95637,-87.6563
TA1308000047,5,12,true,14,12,-2,41.95709,-87.6642
13379,5,12,true,61,47,-14,41.95786,-87.6495
TA1309000018,5,12,true,10,12,2,41.95791,-87.67357
306,5,12,true,12,14,2,41.9585,-87.655
TA1309000027,5,12,true,46,34,-12,41.9585,-87.65499
13389,5,12,true,52,44,-8,41.961,-87.64958
245,5,12,true,10,14,4,41.96101,-87.64958
15621,5,12,true,8,10,2,41.96103,-87.70586
TA1307000144,5,12,true,24,24,0,41.96142,-87.6762
TA1309000021,5,12,true,13,21,8,41.9615,-87.6714
15623,5,12,true,19,9,-10,41.96154,-87.69117
KA1503000022,5,12,true,26,17,-9,41.96158,-87.66609
231,5,12,true,13,16,3,41.96163,-87.65464
TA1307000107,5,12,true,61,63,2,41.96164,-87.65464
TA1307000156,5,12,true,23,25,2,41.96301,-87.68479
243,5,12,true,6,10,4,41.96302,-87.68479
TA1309000012,5,12,true,16,11,-5,41.96325,-87.67928
TA1308000012,5,12,true,33,49,16,41.96398,-87.63818
293,5,12,true,18,17,-1,41.96521,-87.65822
13074,5,12,true,36,24,-12,41.96521,-87.6582
639,5,12,true,52,50,-2,41.96584,-87.64538
KA1504000093,5,12,true,14,5,-9,41.96587,-87.69365
TA1307000140,5,12,true,29,33,4,41.96643,-87.68865
326,5,12,true,15,8,-7,41.96665,-87.67113
TA1309000014,5,12,true,48,58,10,41.96709,-87.66744
TA1307000158,5,12,true,21,24,3,41.9671,-87.67904
251,5,12,true,13,2,-11,41.96796,-87.65
TA1307000119,5,12,true,26,19,-7,41.96796,-87.65
TA1308000021,5,12,true,20,21,1,41.96883,-87.65765
KA1504000080,5,12,true,13,9,-4,41.96887,-87.69609
TA1309000015,5,12,true,6,14,8,41.96889,-87.68401
344,5,12,true,10,16,6,41.9691,-87.67423
TA1309000066,5,12,true,41,51,10,41.9691,-87.67423
TA1309000041,5,12,true,29,24,-5,41.96951,-87.65471
KA1504000171,5,12,true,20,38,18,41.97161,-87.65016
325,5,12,true,12,11,-1,41.9728,-87.67186
TA1309000035,5,12,true,35,47,12,41.97335,-87.66785
13108,5,12,true,40,21,-19,41.97379,-87.65971
KA1504000078,5,12,true,11,8,-3,41.97491,-87.69258
KA1504000149,5,12,true,19,10,-9,41.97562,-87.67945
464,5,12,true,3,10,7,41.97562,-87.67945
463,5,12,true,12,13,1,41.978,-87.66805
KA1504000146,5,12,true,38,45,7,41.978,-87.66805
13109,5,12,true,42,35,-7,41.97835,-87.65976
KA1504000147,5,12,true,6,10,4,41.97976,-87.67754
655,5,12,true,11,8,-3,41.97987,-87.68194
KA1504000151,5,12,true,35,25,-10,41.98359,-87.66916
KA1504000152,5,12,true,68,61,-7,41.98403,-87.65231
459,5,12,true,17,12,-5,41.98403,-87.65231
15578,5,12,true,21,23,2,41.98405,-87.66027
15575,5,12,true,30,31,1,41.98975,-87.66014
458,5,12,true,11,6,-5,41.98975,-87.66013
KA1504000148,5,12,true,12,9,-3,41.99086,-87.66971
KA1504000129,5,12,true,5,12,7,41.99417,-87.68945
15571,5,12,true,19,23,4,41.99478,-87.66028
RP-009,5,12,true,21,10,-11,42.00107,-87.66122
660,5,12,true,19,14,-5,42.00458,-87.66143
KA1504000175,5,12,true,23,20,-3,42.00797,-87.66549
KA1504000162,5,12,true,11,7,-4,42.00907,-87.67422
RP-007,5,12,true,5,13,8,42.01256,-87.67431
520,5,12,true,24,18,-6,42.01597,-87.66859
523,5,12,true,28,18,-10,42.02089,-87.66505
E002,5,12,true,12,3,-9,42.03256,-87.67912
596,5,12,true,20,24,4,42.04822,-87.68348
E008,5,12,true,9,11,2,42.05049,-87.67782
604,5,12,true,28,19,-9,42.05824,-87.67744
KA1503000002,5,16,false,10,9,-1,41.76641,-87.5657
15491,5,16,false,24,9,-15,41.78096,-87.57624
426,5,16,false,14,13,-1,41.7851,-87.60108
KA1503000014,5,16,false,30,31,1,41.7851,-87.60108
KA1503000070,5,16,false,12,7,-5,41.78794,-87.58831
328,5,16,false,14,4,-10,41.78872,-87.6013
TA1309000011,5,16,false,37,27,-10,41.78873,-87.60131
KA1503000071,5,16,false,36,16,-20,41.79148,-87.59988
423,5,16,false,18,9,-9,41.79148,-87.59988
KA1503000074,5,16,false,46,30,-16,41.79174,-87.58395
TA1309000063,5,16,false,22,33,11,41.79325,-87.5878
345,5,16,false,8,13,5,41.79326,-87.5878
420,5,16,false,13,6,-7,41.79429,-87.60145
KA1504000076,5,16,false,33,21,-12,41.7943,-87.60145
TA1307000160,5,16,false,7,12,5,41.79485,-87.61873
247,5,16,false,10,13,3,41.79522,-87.58077
TA1308000009,5,16,false,60,72,12,41.79522,-87.58075
TA1307000164,5,16,false,41,22,-19,41.79527,-87.59647
KA1503000052,5,16,false,27,16,-11,41.79935,-87.60097
418,5,16,false,11,3,-8,41.79936,-87.60097
KA1503000059,5,16,false,36,31,-5,41.79952,-87.58643
419,5,16,false,10,10,0,41.79952,-87.58643
TA1309000037,5,16,false,40,50,10,41.79957,-87.59474
417,5,16,false,8,13,5,41.80242,-87.5869
KA1503000007,5,16,false,41,25,-16,41.80242,-87.58689
13398,5,16,false,22,29,7,41.80256,-87.59035
TA1309000067,5,16,false,2,10,8,41.80303,-87.60661
TA1308000035,5,16,false,8,13,5,41.80944,-87.59188
TA1308000002,5,16,false,10,14,4,41.80983,-87.59937
KA1503000065,5,16,false,10,4,-6,41.81409,-87.59701
TA1308000038,5,16,false,9,16,7,41.82298,-87.6071
KA1503000004,5,16,false,13,15,2,41.83127,-87.6088
13216,5,16,false,16,9,-7,41.83473,-87.62581
TA1309000055,5,16,false,8,12,4,41.8382,-87.64514
KA1503000038,5,16,false,6,11,5,41.83845,-87.6354
TA1307000048,5,16,false,44,34,-10,41.83855,-87.60821
TA1308000036,5,16,false,7,10,3,41.83883,-87.62186
TA1307000139,5,16,false,16,12,-4,41.84205,-87.61698
15443,5,16,false,3,17,14,41.84275,-87.63549
TA1307000153,5,16,false,3,11,8,41.84358,-87.64538
TA1307000005,5,16,false,12,17,5,41.84569,-87.6225
TA1308000013,5,16,false,15,4,-11,41.84719,-87.64681
TA1308000026,5,16,false,7,11,4,41.85008,-87.63214
TA1305000004,5,16,false,21,23,2,41.8514,-87.61884
TA1305000001,5,16,false,15,17,2,41.85262,-87.6265
13075,5,16,false,51,38,-13,41.8531,-87.63192
15546,5,16,false,13,12,-1,41.85416,-87.61916
13307,5,16,false,14,5,-9,41.85489,-87.66359
13089,5,16,false,9,11,2,41.85497,-87.67567
4,5,16,false,9,15,6,41.85627,-87.61334
15545,5,16,false,54,61,7,41.85627,-87.61334
SL-013,5,16,false,8,18,10,41.85659,-87.62755
SL-006,5,16,false,16,8,-8,41.8568,-87.63387
13135,5,16,false,18,14,-4,41.85753,-87.66157
338,5,16,false,5,16,11,41.85758,-87.61956
13102,5,16,false,24,26,2,41.85762,-87.61942
13150,5,16,false,27,33,6,41.85783,-87.62455
13099,5,16,false,13,19,6,41.85784,-87.64627
TA1307000159,5,16,false,17,17,0,41.8579,-87.6687
13163,5,16,false,24,12,-12,41.85808,-87.65108
13164,5,16,false,28,23,-5,41.85818,-87.65648
SL-012,5,16,false,22,27,5,41.86038,-87.62581
13304,5,16,false,20,17,-3,41.86126,-87.65659
KA1504000109,5,16,false,12,6,-6,41.86192,-87.69347
TA1306000002,5,16,false,16,12,-4,41.86238,-87.65108
TA1307000124,5,16,false,50,50,0,41.86411,-87.62372
282,5,16,false,14,8,-6,41.86487,-87.64708
TA1309000001,5,16,false,28,19,-9,41.86488,-87.64708
13029,5,16,false,114,34,-80,41.86531,-87.6179
97,5,16,false,28,6,-22,41.86531,-87.6179
341,5,16,false,11,25,14,41.86608,-87.60733
13431,5,16,false,102,96,-6,41.8661,-87.60728
KA1504000101,5,16,false,4,14,10,41.86651,-87.68466
WL-008,5,16,false,28,40,12,41.86712,-87.64108
59,5,16,false,16,21,5,41.86721,-87.62597
TA1305000002,5,16,false,70,84,14,41.86721,-87.62597
15544,5,16,false,272,194,-78,41.86723,-87.61536
3,5,16,false,30,8,-22,41.86723,-87.61536
KA1706005007,5,16,false,32,28,-4,41.86749,-87.63219
SL-005,5,16,false,186,173,-13,41.8679,-87.62304
255,5,16,false,29,18,-11,41.86791,-87.62304
644,5,16,false,7,13,6,41.86859,-87.68625
13139,5,16,false,23,16,-7,41.86893,-87.65913
13285,5,16,false,18,9,-9,41.86928,-87.67372
13160,5,16,false,29,22,-7,41.86947,-87.65548
15550,5,16,false,23,20,-3,41.87024,-87.63947
TA1309000010,5,16,false,64,73,9,41.87074,-87.62574
SL-009,5,16,false,28,23,-5,41.87081,-87.63121
TA1309000064,5,16,false,28,12,-16,41.87127,-87.67369
TA1307000130,5,16,false,14,13,-1,41.87178,-87.65103
TA1307000121,5,16,false,22,22,0,41.87184,-87.64664
41,5,16,false,16,17,1,41.87209,-87.62957
SL-008,5,16,false,58,65,7,41.87209,-87.62956
13332,5,16,false,27,29,2,41.87219,-87.6615
SL-011,5,16,false,59,67,8,41.87256,-87.63356
623,5,16,false,132,119,-13,41.87272,-87.62399
KA1504000104,5,16,false,33,12,-21,41.87296,-87.66912
320,5,16,false,8,12,4,41.87327,-87.66402
5,5,16,false,13,8,-5,41.87403,-87.6277
SL-007,5,16,false,39,51,12,41.87404,-87.6277
321,5,16,false,13,10,-3,41.87427,-87.63257
TA1306000025,5,16,false,14,15,1,41.87464,-87.65703
13028,5,16,false,22,19,-3,41.87475,-87.64981
13081,5,16,false,2,10,8,41.87501,-87.67326
SL-010,5,16,false,26,22,-4,41.87501,-87.63309
15541,5,16,false,111,70,-41,41.8758,-87.62086
TA1305000009,5,16,false,19,16,-3,41.87593,-87.63068
TA1305000010,5,16,false,45,65,20,41.87623,-87.62444
624,5,16,false,28,32,4,41.87626,-87.62923
2,5,16,false,12,17,5,41.87649,-87.62051
TA1305000035,5,16,false,40,19,-21,41.87716,-87.62787
13138,5,16,false,23,16,-7,41.87723,-87.63941
631,5,16,false,14,3,-11,41.87761,-87.6739
15539,5,16,false,42,40,-2,41.87763,-87.64405
13158,5,16,false,63,65,2,41.87764,-87.64957
13157,5,16,false,34,34,0,41.87773,-87.6548
21,5,16,false,6,11,5,41.87773,-87.6548
TA1305000025,5,16,false,75,72,-3,41.87773,-87.63528
284,5,16,false,12,9,-3,41.87784,-87.62408
TA1309000002,5,16,false,63,82,19,41.87784,-87.62408
13206,5,16,false,11,13,2,41.87794,-87.66201
TA1309000004,5,16,false,41,30,-11,41.87811,-87.63184
107,5,16,false,11,9,-2,41.87822,-87.644
638,5,16,false,60,49,-11,41.87827,-87.64078
37,5,16,false,10,6,-4,41.87921,-87.62975
TA1305000005,5,16,false,24,23,-1,41.87924,-87.62975
13011,5,16,false,117,61,-56,41.87931,-87.63993
TA1309000008,5,16,false,36,38,2,41.87933,-87.6355
192,5,16,false,13,7,-6,41.87935,-87.63997
KA1503000034,5,16,false,35,22,-13,41.87938,-87.63197
KA1503000015,5,16,false,39,41,2,41.87948,-87.6257
287,5,16,false,16,2,-14,41.88017,-87.63527
TA1309000007,5,16,false,57,22,-35,41.88022,-87.63526
WL-011,5,16,false,24,21,-3,41.88034,-87.64273
13156,5,16,false,49,41,-8,41.88042,-87.65554
13300,5,16,false,384,440,56,41.88097,-87.61675
76,5,16,false,35,54,19,41.88098,-87.61675
13008,5,16,false,301,380,79,41.88105,-87.62408
90,5,16,false,22,69,47,41.88107,-87.62409
49,5,16,false,12,6,-6,41.88116,-87.62963
TA1305000006,5,16,false,85,59,-26,41.88122,-87.6296
13134,5,16,false,19,16,-3,41.88138,-87.67493
13056,5,16,false,35,32,-3,41.88168,-87.63951
198,5,16,false,18,21,3,41.88187,-87.6488
TA1307000120,5,16,false,111,119,8,41.88188,-87.64879
13341,5,16,false,58,47,-11,41.88208,-87.63985
13036,5,16,false,72,73,1,41.8821,-87.62513
TA1305000032,5,16,false,102,68,-34,41.88218,-87.64109
98,5,16,false,10,3,-7,41.88266,-87.63251
13006,5,16,false,40,17,-23,41.88268,-87.63252
13353,5,16,false,23,59,36,41.88283,-87.6612
654,5,16,false,25,23,-2,41.88307,-87.65698
13409,5,16,false,46,52,6,41.8831,-87.6511
18,5,16,false,11,4,-7,41.88317,-87.63735
KA1503000072,5,16,false,25,25,0,41.88317,-87.63693
WL-012,5,16,false,93,68,-25,41.88337,-87.6412
112,5,16,false,12,25,13,41.88362,-87.6486
13053,5,16,false,93,137,44,41.88365,-87.64863
43,5,16,false,35,28,-7,41.88396,-87.62455
13001,5,16,false,149,113,-36,41.88397,-87.62459
13155,5,16,false,25,17,-8,41.88407,-87.65689
18062,5,16,false,37,38,1,41.88412,-87.65427
81,5,16,false,16,9,-7,41.88417,-87.6296
TA1306000010,5,16,false,77,41,-36,41.88419,-87.62961
TA1305000030,5,16,false,104,56,-48,41.88459,-87.63178
15535,5,16,false,77,76,-1,41.8846,-87.64455
TA1305000029,5,16,false,84,117,33,41.88466,-87.62787
195,5,16,false,14,13,-1,41.88466,-87.61952
13263,5,16,false,118,66,-52,41.88467,-87.61952
44,5,16,false,12,14,2,41.88468,-87.62782
TA1306000015,5,16,false,77,86,9,41.88549,-87.65232
71,5,16,false,5,20,15,41.8855,-87.65233
13021,5,16,false,40,56,16,41.88559,-87.64184
TA1307000111,5,16,false,57,36,-21,41.88582,-87.63548
164,5,16,false,10,6,-4,41.88583,-87.63547
13073,5,16,false,28,36,8,41.88592,-87.66717
KA17018054,5,16,false,28,19,-9,41.88595,-87.67701
KA1503000012,5,16,false,80,99,19,41.88599,-87.63089
52,5,16,false,30,20,-10,41.886,-87.62421
TA1305000011,5,16,false,141,123,-18,41.886,-87.62418
15534,5,16,false,61,72,11,41.88627,-87.61749
13197,5,16,false,29,24,-5,41.8866,-87.65816
TA1308000029,5,16,false,47,49,2,41.88673,-87.62225
194,5,16,false,20,16,-4,41.88688,-87.62606
TA1307000131,5,16,false,109,118,9,41.88688,-87.62606
6,5,16,false,19,30,11,41.88697,-87.61281
KA1503000064,5,16,false,153,168,15,41.88697,-87.61281
100,5,16,false,13,3,-10,41.88814,-87.63657
TA1305000022,5,16,false,59,40,-19,41.88817,-87.63656
56,5,16,false,14,9,-5,41.88866,-87.64442
TA1306000003,5,16,false,73,73,0,41.88867,-87.64442
133,5,16,false,14,4,-10,41.88918,-87.63851
KA1503000043,5,16,false,112,118,6,41.88918,-87.63851
13050,5,16,false,93,129,36,41.88919,-87.62775
47,5,16,false,19,13,-6,41.88921,-87.62775
15664,5,16,false,12,12,0,41.8895,-87.68821
13432,5,16,false,13,14,1,41.88989,-87.67149
TA1307000151,5,16,false,92,77,-15,41.88993,-87.63427
212,5,16,false,20,11,-9,41.88995,-87.63427
636,5,16,false,42,40,-2,41.88997,-87.63662
KA1503000044,5,16,false,40,39,-1,41.89018,-87.6262
196,5,16,false,5,12,7,41.89053,-87.62205
13427,5,16,false,50,76,26,41.89054,-87.62205
26,5,16,false,17,21,4,41.89057,-87.61798
13430,5,16,false,105,163,58,41.89077,-87.63169
181,5,16,false,17,12,-5,41.89077,-87.63168
TA1306000013,5,16,false,143,161,18,41.89083,-87.61852
RN-,5,16,false,61,76,15,41.89102,-87.63546
13434,5,16,false,33,29,-4,41.89108,-87.66663
TA1308000006,5,16,false,16,24,8,41.89128,-87.67686
199,5,16,false,16,35,19,41.89143,-87.62676
TA1307000117,5,16,false,136,157,21,41.89144,-87.62675
13033,5,16,false,90,89,-1,41.8916,-87.64835
84,5,16,false,12,17,5,41.89161,-87.64833
13194,5,16,false,47,45,-2,41.8918,-87.65878
TA1305000003,5,16,false,154,164,10,41.89187,-87.62061
24,5,16,false,14,15,1,41.8919,-87.62063
643,5,16,false,8,19,11,41.89203,-87.68939
35,5,16,false,48,59,11,41.89227,-87.61206
13022,5,16,false,789,858,69,41.89227,-87.61205
99,5,16,false,16,18,2,41.89255,-87.61449
TA1306000029,5,16,false,139,153,14,41.89256,-87.61449
13265,5,16,false,65,54,-11,41.89383,-87.64172
74,5,16,false,10,9,-1,41.89384,-87.64173
13045,5,16,false,146,118,-28,41.89403,-87.62931
110,5,16,false,7,17,10,41.89406,-87.6293
13016,5,16,false,107,76,-31,41.89431,-87.62277
211,5,16,false,11,17,6,41.89439,-87.62267
KA1503000041,5,16,false,59,52,-7,41.89452,-87.61798
142,5,16,false,13,4,-9,41.89453,-87.61806
13196,5,16,false,53,31,-22,41.89455,-87.65345
TA1307000062,5,16,false,43,30,-13,41.89466,-87.63839
TA1306000012,5,16,false,132,117,-15,41.89475,-87.63438
53,5,16,false,18,19,1,41.89476,-87.63439
627,5,16,false,12,9,-3,41.8948,-87.63231
KP1705001026,5,16,false,75,75,0,41.89483,-87.6323
KA1504000114,5,16,false,10,3,-7,41.89547,-87.70614
18058,5,16,false,23,19,-4,41.8955,-87.68201
637,5,16,false,40,40,0,41.89563,-87.67209
13132,5,16,false,33,53,20,41.89573,-87.67718
161,5,16,false,11,19,8,41.89574,-87.62599
15530,5,16,false,89,113,24,41.89575,-87.62596
18003,5,16,false,29,25,-4,41.89575,-87.62011
13247,5,16,false,35,32,-3,41.89597,-87.66775
TA1305000020,5,16,false,59,50,-9,41.89636,-87.65406
13289,5,16,false,40,39,-1,41.89638,-87.661
86,5,16,false,3,11,8,41.89639,-87.661
337,5,16,false,12,8,-4,41.89659,-87.63096
13303,5,16,false,60,56,-4,41.89672,-87.63088
13017,5,16,false,50,39,-11,41.89676,-87.6357
13338,5,16,false,52,66,14,41.89697,-87.62173
TA1307000061,5,16,false,42,47,5,41.89745,-87.62873
106,5,16,false,4,11,7,41.89746,-87.62874
25,5,16,false,16,12,-4,41.89751,-87.62354
13034,5,16,false,77,92,15,41.89754,-87.62352
48,5,16,false,14,5,-9,41.89772,-87.64302
TA1306000009,5,16,false,51,31,-20,41.89772,-87.64299
620,5,16,false,37,52,15,41.89817,-87.63754
KA1504000103,5,16,false,35,33,-2,41.89842,-87.68659
145,5,16,false,10,5,-5,41.89856,-87.62211
15529,5,16,false,71,72,1,41.89858,-87.62206
140,5,16,false,13,23,10,41.89895,-87.6299
TA1307000128,5,16,false,93,74,-19,41.89896,-87.6299
657,5,16,false,30,21,-9,41.89918,-87.6722
KA1504000117,5,16,false,14,3,-11,41.89936,-87.64848
13248,5,16,false,18,25,7,41.89964,-87.66788
46,5,16,false,16,9,-7,41.89994,-87.63444
TA1306000011,5,16,false,27,36,9,41.89994,-87.63443
KA1504000116,5,16,false,33,17,-16,41.90023,-87.64299
17660,5,16,false,13,22,9,41.90036,-87.69671
13290,5,16,false,34,29,-5,41.90069,-87.66259
13042,5,16,false,337,321,-16,41.90097,-87.62377
85,5,16,false,29,29,0,41.90098,-87.62375
TA1307000070,5,16,false,35,20,-15,41.90133,-87.67742
KA1504000133,5,16,false,112,97,-15,41.90234,-87.62773
172,5,16,false,17,12,-5,41.90236,-87.62774
15654,5,16,false,4,14,10,41.90271,-87.70923
13241,5,16,false,30,24,-6,41.9029,-87.68731
176,5,16,false,34,37,3,41.90291,-87.63141
TA1306000006,5,16,false,21,16,-5,41.90292,-87.63772
TA1307000039,5,16,false,142,170,28,41.90294,-87.63137
658,5,16,false,17,8,-9,41.903,-87.6838
13256,5,16,false,19,14,-5,41.90302,-87.69749
17,5,16,false,13,4,-9,41.90313,-87.67391
TA1305000034,5,16,false,65,63,-2,41.90313,-87.67391
182,5,16,false,19,30,11,41.90317,-87.63442
KA1504000135,5,16,false,172,166,-6,41.90319,-87.63439
13136,5,16,false,22,62,40,41.90326,-87.67845
210,5,16,false,13,18,5,41.90342,-87.66781
13061,5,16,false,107,83,-24,41.90342,-87.66779
KA1504000079,5,16,false,63,47,-16,41.9035,-87.64334
359,5,16,false,7,12,5,41.90458,-87.6497
TA1307000115,5,16,false,20,23,3,41.9046,-87.64056
291,5,16,false,17,23,6,41.90672,-87.63494
TA1308000049,5,16,false,113,117,4,41.90672,-87.6349
KA1504000134,5,16,false,66,95,29,41.90687,-87.6262
13224,5,16,false,57,45,-12,41.90706,-87.66725
18069,5,16,false,14,4,-10,41.90722,-87.65563
TA1307000143,5,16,false,17,29,12,41.90762,-87.63854
61,5,16,false,5,10,5,41.90764,-87.67254
13221,5,16,false,65,65,0,41.90765,-87.67254
301,5,16,false,10,14,4,41.90796,-87.63203
TA1309000024,5,16,false,102,94,-8,41.908,-87.63152
69,5,16,false,12,16,4,41.90939,-87.6777
TA1305000041,5,16,false,85,122,37,41.9094,-87.67769
15652,5,16,false,12,7,-5,41.90965,-87.71664
331,5,16,false,96,82,-14,41.90965,-87.64812
15653,5,16,false,15,9,-6,41.90979,-87.7053
TA1305000037,5,16,false,40,47,7,41.91018,-87.67003
TA1306000008,5,16,false,42,23,-19,41.9102,-87.6435
TA1308000005,5,16,false,30,35,5,41.91042,-87.68238
13258,5,16,false,21,27,6,41.91043,-87.69718
13257,5,16,false,31,23,-8,41.91054,-87.68956
13154,5,16,false,90,47,-43,41.91054,-87.65312
13058,5,16,false,71,51,-20,41.91059,-87.64942
60,5,16,false,10,7,-3,41.91059,-87.64942
118,5,16,false,8,10,2,41.91138,-87.63868
TA1307000038,5,16,false,54,65,11,41.91138,-87.63868
268,5,16,false,19,22,3,41.91172,-87.62681
LF-005,5,16,false,230,244,14,41.91172,-87.62681
126,5,16,false,7,12,5,41.91196,-87.63197
13128,5,16,false,52,52,0,41.91197,-87.63197
289,5,16,false,32,15,-17,41.91209,-87.63472
TA1308000050,5,16,false,190,199,9,41.91211,-87.6347
13243,5,16,false,50,37,-13,41.91262,-87.6814
158,5,16,false,7,10,3,41.91262,-87.6814
TA1309000032,5,16,false,11,12,1,41.91293,-87.66417
TA1306000032,5,16,false,62,56,-6,41.9137,-87.65285
TA1307000166,5,16,false,35,44,9,41.91386,-87.64877
15655,5,16,false,19,16,-3,41.91401,-87.70514
18017,5,16,false,13,15,2,41.91416,-87.71676
18067,5,16,false,31,32,1,41.9146,-87.66796
TA1306000007,5,16,false,16,20,4,41.91469,-87.64333
13068,5,16,false,33,34,1,41.91554,-87.68703
13179,5,16,false,165,168,3,41.9157,-87.63461
141,5,16,false,18,20,2,41.91571,-87.63461
219,5,16,false,11,10,-1,41.91598,-87.67733
13133,5,16,false,50,61,11,41.91598,-87.67733
TA1305000039,5,16,false,54,59,5,41.9163,-87.66749
15650,5,16,false,15,17,2,41.91711,-87.71023
15651,5,16,false,47,38,-9,41.91752,-87.70181
13266,5,16,false,20,15,-5,41.91774,-87.69142
TA1309000029,5,16,false,18,14,-4,41.9178,-87.68245
TA1309000006,5,16,false,40,35,-5,41.91809,-87.64375
288,5,16,false,3,10,7,41.91809,-87.64375
223,5,16,false,7,12,5,41.91821,-87.65698
TA1307000163,5,16,false,43,38,-5,41.91821,-87.65696
94,5,16,false,23,13,-10,41.91831,-87.6363
13146,5,16,false,134,122,-12,41.91831,-87.63629
13059,5,16,false,67,76,9,41.91845,-87.65222
113,5,16,false,13,11,-2,41.91846,-87.65222
13259,5,16,false,28,16,-12,41.91852,-87.69744
225,5,16,false,11,13,2,41.91995,-87.64884
13192,5,16,false,53,104,51,41.91995,-87.64884
13288,5,16,false,24,24,0,41.92008,-87.67788
13242,5,16,false,32,29,-3,41.92021,-87.69266
TA1309000030,5,16,false,51,49,-2,41.92077,-87.66372
13292,5,16,false,10,19,9,41.92152,-87.70733
TA1309000033,5,16,false,56,74,18,41.92158,-87.65381
13193,5,16,false,106,123,17,41.92182,-87.64412
144,5,16,false,18,27,9,41.92182,-87.64411
13191,5,16,false,66,42,-24,41.92217,-87.63891
143,5,16,false,14,11,-3,41.92217,-87.63891
13084,5,16,false,45,42,-3,41.92268,-87.69715
LP-,5,16,false,91,56,-35,41.92396,-87.63584
673,5,16,false,11,16,5,41.92398,-87.63585
KA1504000140,5,16,false,22,9,-13,41.92409,-87.67646
15648,5,16,false,21,15,-6,41.92464,-87.68931
KA1504000090,5,16,false,8,21,13,41.92483,-87.7145
TA1307000001,5,16,false,40,56,16,41.92535,-87.66581
TA1306000026,5,16,false,48,45,-3,41.92558,-87.65842
67,5,16,false,12,5,-7,41.9256,-87.65371
TA1306000016,5,16,false,61,61,0,41.9256,-87.65371
313,5,16,false,23,24,1,41.9257,-87.64246
TA1309000019,5,16,false,124,115,-9,41.92586,-87.63897
TA1309000058,5,16,false,96,97,1,41.92591,-87.64927
127,5,16,false,4,13,9,41.92592,-87.64927
TA1308000001,5,16,false,268,261,-7,41.92627,-87.63086
177,5,16,false,31,38,7,41.92627,-87.63086
15646,5,16,false,14,20,6,41.92668,-87.6977
13124,5,16,false,48,39,-9,41.92675,-87.63444
TA1309000023,5,16,false,65,71,6,41.9287,-87.65383
TA1307000113,5,16,false,53,48,-5,41.92878,-87.66391
13296,5,16,false,25,35,10,41.92883,-87.66852
TA1309000059,5,16,false,35,19,-16,41.92889,-87.65898
349,5,16,false,14,11,-3,41.92915,-87.6491
TA1309000061,5,16,false,55,63,8,41.92915,-87.64909
TA1308000031,5,16,false,22,41,19,41.92946,-87.68417
TA1305000014,5,16,false,104,88,-16,41.92956,-87.64313
340,5,16,false,13,24,11,41.92956,-87.64313
260,5,16,false,7,10,3,41.92958,-87.70791
13085,5,16,false,44,52,8,41.92958,-87.70789
15643,5,16,false,13,14,1,41.93057,-87.7238
TA1307000142,5,16,false,112,114,2,41.93125,-87.64432
220,5,16,false,18,4,-14,41.93125,-87.64431
13276,5,16,false,63,62,-1,41.93132,-87.63874
324,5,16,false,14,13,-1,41.93173,-87.64179
15645,5,16,false,10,11,1,41.93191,-87.70121
13271,5,16,false,29,17,-12,41.93192,-87.67784
152,5,16,false,12,7,-5,41.93221,-87.65864
TA1307000064,5,16,false,56,52,-4,41.93222,-87.65864
TA1306000014,5,16,false,78,76,-2,41.93242,-87.65271
13,5,16,false,9,12,3,41.93242,-87.65271
329,5,16,false,16,18,2,41.93258,-87.63642
TA1309000039,5,16,false,113,137,24,41.93258,-87.63642
13294,5,16,false,34,32,-2,41.9326,-87.66595
TA1309000036,5,16,false,54,47,-7,41.93313,-87.64776
332,5,16,false,6,12,6,41.93313,-87.64776
TA1307000006,5,16,false,49,53,4,41.93571,-87.6636
13268,5,16,false,25,18,-7,41.93588,-87.67843
13269,5,16,false,30,21,-9,41.93609,-87.66983
TA1307000052,5,16,false,74,56,-18,41.93628,-87.65266
115,5,16,false,13,7,-6,41.93628,-87.65266
156,5,16,false,13,5,-8,41.9365,-87.64756
TA1307000136,5,16,false,86,90,4,41.9365,-87.64755
TA1307000041,5,16,false,87,113,26,41.93669,-87.63683
157,5,16,false,19,21,2,41.9367,-87.63683
13137,5,16,false,107,128,21,41.9376,-87.6441
300,5,16,false,16,18,2,41.93761,-87.6441
15642,5,16,false,10,24,14,41.93843,-87.69801
KA17018068,5,16,false,26,21,-5,41.93935,-87.68327
TA1309000042,5,16,false,37,39,2,41.93937,-87.66836
KA150400009X,5,16,false,5,10,5,41.9394,-87.71159
13229,5,16,false,49,40,-9,41.93946,-87.66376
TA1308000019,5,16,false,71,50,-21,41.93973,-87.65886
13277,5,16,false,70,54,-16,41.9401,-87.64546
296,5,16,false,11,10,-1,41.9401,-87.64546
TA1307000134,5,16,false,130,96,-34,41.94016,-87.65303
117,5,16,false,25,14,-11,41.94016,-87.65302
13143,5,16,false,25,22,-3,41.94059,-87.67853
334,5,16,false,21,30,9,41.94076,-87.63919
TA1309000049,5,16,false,97,111,14,41.94077,-87.63919
15634,5,16,false,10,17,7,41.94304,-87.68729
TA1307000138,5,16,false,44,37,-7,41.94334,-87.67094
13144,5,16,false,21,25,4,41.9434,-87.67964
TA1309000025,5,16,false,104,88,-16,41.94368,-87.64894
299,5,16,false,15,27,12,41.94368,-87.64894
229,5,16,false,9,11,2,41.94372,-87.66401
13071,5,16,false,88,77,-11,41.94373,-87.66401
632,5,16,false,200,127,-73,41.94453,-87.6547
303,5,16,false,14,11,-3,41.94522,-87.64702
15631,5,16,false,11,12,1,41.94524,-87.70665
13278,5,16,false,83,75,-8,41.94553,-87.64644
TA1309000050,5,16,false,13,5,-8,41.94618,-87.67331
15632,5,16,false,10,2,-8,41.94664,-87.69463
KA1504000143,5,16,false,7,11,4,41.94664,-87.68337
227,5,16,false,12,12,0,41.94813,-87.66397
13235,5,16,false,94,59,-35,41.94814,-87.66396
304,5,16,false,10,15,5,41.94878,-87.64922
13253,5,16,false,18,18,0,41.9488,-87.67527
13325,5,16,false,96,53,-43,41.94907,-87.64863
114,5,16,false,15,17,2,41.94935,-87.65451
TA1307000126,5,16,false,220,91,-129,41.94936,-87.65451
232,5,16,false,15,12,-3,41.94943,-87.64645
TA1307000150,5,16,false,91,76,-15,41.94945,-87.64646
13319,5,16,false,34,26,-8,41.95069,-87.6687
TA1307000127,5,16,false,144,89,-55,41.9508,-87.65918
165,5,16,false,9,22,13,41.95081,-87.65918
15628,5,16,false,4,11,7,41.95216,-87.69806
13323,5,16,false,50,46,-4,41.95282,-87.65
KA1504000096,5,16,false,4,14,10,41.95361,-87.70932
KA1504000139,5,16,false,10,5,-5,41.954,-87.71909
TA1309000043,5,16,false,27,30,3,41.95417,-87.66434
13063,5,16,false,52,54,2,41.95424,-87.65441
KA1504000158,5,16,false,13,15,2,41.95432,-87.68607
254,5,16,false,11,12,1,41.95438,-87.64806
TA1308000022,5,16,false,52,65,13,41.95438,-87.64805
TA1307000149,5,16,false,22,13,-9,41.95467,-87.67392
TA1309000026,5,16,false,11,17,6,41.95601,-87.6802
13249,5,16,false,11,9,-2,41.95606,-87.66885
TA1308000047,5,16,false,15,11,-4,41.95709,-87.6642
13379,5,16,false,38,50,12,41.95786,-87.6495
TA1309000018,5,16,false,14,19,5,41.95791,-87.67357
TA1309000027,5,16,false,25,28,3,41.9585,-87.65499
13389,5,16,false,42,46,4,41.961,-87.64958
15622,5,16,false,9,12,3,41.96108,-87.69544
TA1307000144,5,16,false,10,15,5,41.96142,-87.6762
KA1503000022,5,16,false,17,17,0,41.96158,-87.66609
231,5,16,false,13,10,-3,41.96163,-87.65464
TA1307000107,5,16,false,49,63,14,41.96164,-87.65464
TA1307000156,5,16,false,7,18,11,41.96301,-87.68479
TA1308000012,5,16,false,97,90,-7,41.96398,-87.63818
249,5,16,false,18,12,-6,41.96398,-87.63818
13074,5,16,false,28,43,15,41.96521,-87.6582
639,5,16,false,45,50,5,41.96584,-87.64538
TA1307000140,5,16,false,15,23,8,41.96643,-87.68865
TA1309000014,5,16,false,17,42,25,41.96709,-87.66744
TA1307000158,5,16,false,12,14,2,41.9671,-87.67904
TA1307000119,5,16,false,30,28,-2,41.96796,-87.65
TA1308000021,5,16,false,14,17,3,41.96883,-87.65765
KA1504000080,5,16,false,15,7,-8,41.96887,-87.69609
TA1309000015,5,16,false,4,14,10,41.96889,-87.68401
TA1309000066,5,16,false,38,36,-2,41.9691,-87.67423
TA1309000041,5,16,false,33,17,-16,41.96951,-87.65471
KA1504000171,5,16,false,43,20,-23,41.97161,-87.65016
TA1309000035,5,16,false,41,41,0,41.97335,-87.66785
13108,5,16,false,27,22,-5,41.97379,-87.65971
KA1504000149,5,16,false,12,18,6,41.97562,-87.67945
KA1504000146,5,16,false,44,46,2,41.978,-87.66805
13109,5,16,false,26,20,-6,41.97835,-87.65976
294,5,16,false,1,10,9,41.97835,-87.65976
KA1504000147,5,16,false,4,11,7,41.97976,-87.67754
655,5,16,false,14,12,-2,41.97987,-87.68194
KA1504000151,5,16,false,27,24,-3,41.98359,-87.66916
15585,5,16,false,12,7,-5,41.98367,-87.69642
KA1504000152,5,16,false,101,80,-21,41.98403,-87.65231
459,5,16,false,17,22,5,41.98403,-87.65231
15578,5,16,false,16,19,3,41.98405,-87.66027
15575,5,16,false,19,32,13,41.98975,-87.66014
15571,5,16,false,21,25,4,41.99478,-87.66028
454,5,16,false,11,7,-4,41.99478,-87.66027
KA1504000156,5,16,false,10,9,-1,41.99925,-87.67137
RP-009,5,16,false,18,31,13,42.00107,-87.66122
RP-001,5,16,false,10,9,-1,42.00179,-87.68883
660,5,16,false,19,17,-2,42.00458,-87.66143
KA1504000175,5,16,false,15,16,1,42.00797,-87.66549
KA1504000162,5,16,false,10,7,-3,42.00907,-87.67422
KA1504000159,5,16,false,6,17,11,42.01059,-87.66241
523,5,16,false,6,13,7,42.02089,-87.66505
E002,5,16,false,7,22,15,42.03256,-87.67912
599,5,16,false,10,8,-2,42.03972,-87.69942
596,5,16,false,27,32,5,42.04822,-87.68348
E008,5,16,false,25,31,6,42.05049,-87.67782
605,5,16,false,19,28,9,42.05294,-87.67342
661,5,16,false,12,19,7,42.05704,-87.68657
604,5,16,false,22,27,5,42.05824,-87.67744
426,5,16,true,24,14,-10,41.7851,-87.60108
KA1503000014,5,16,true,52,89,37,41.7851,-87.60108
KA1503000070,5,16,true,14,29,15,41.78794,-87.58831
328,5,16,true,30,11,-19,41.78872,-87.6013
TA1309000011,5,16,true,82,27,-55,41.78873,-87.60131
KA1503000071,5,16,true,140,39,-101,41.79148,-87.59988
423,5,16,true,17,8,-9,41.79148,-87.59988
KA1503000075,5,16,true,10,6,-4,41.79156,-87.60785
KA1503000074,5,16,true,9,16,7,41.79174,-87.58395
TA1309000063,5,16,true,21,58,37,41.79325,-87.5878
345,5,16,true,10,16,6,41.79326,-87.5878
420,5,16,true,23,31,8,41.79429,-87.60145
KA1504000076,5,16,true,66,40,-26,41.7943,-87.60145
247,5,16,true,6,15,9,41.79522,-87.58077
TA1308000009,5,16,true,62,74,12,41.79522,-87.58075
TA1307000164,5,16,true,37,31,-6,41.79527,-87.59647
KA1503000052,5,16,true,23,40,17,41.79935,-87.60097
KA1503000059,5,16,true,26,34,8,41.79952,-87.58643
TA1309000037,5,16,true,64,73,9,41.79957,-87.59474
417,5,16,true,6,12,6,41.80242,-87.5869
KA1503000007,5,16,true,37,54,17,41.80242,-87.58689
13398,5,16,true,18,27,9,41.80256,-87.59035
322,5,16,true,20,26,6,41.80321,-87.59849
TA1308000035,5,16,true,9,15,6,41.80944,-87.59188
TA1308000002,5,16,true,6,16,10,41.80983,-87.59937
546,5,16,true,10,1,-9,41.82319,-87.67661
KA1503000068,5,16,true,4,24,20,41.82878,-87.68062
TA1308000045,5,16,true,21,18,-3,41.83062,-87.64129
TA1308000043,5,16,true,18,13,-5,41.83066,-87.64715
15446,5,16,true,10,7,-3,41.83068,-87.65603
KA1503000005,5,16,true,16,7,-9,41.83079,-87.6325
TA1307000129,5,16,true,57,14,-43,41.83104,-87.62683
KA1503000004,5,16,true,12,11,-1,41.83127,-87.6088
15445,5,16,true,20,12,-8,41.83453,-87.63183
13216,5,16,true,95,33,-62,41.83473,-87.62581
148,5,16,true,15,21,6,41.83474,-87.62581
13217,5,16,true,27,53,26,41.83488,-87.61792
13215,5,16,true,21,23,2,41.83634,-87.6135
TA1308000046,5,16,true,14,17,3,41.83779,-87.65115
TA1309000055,5,16,true,28,35,7,41.8382,-87.64514
402,5,16,true,10,4,-6,41.83845,-87.6354
KA1503000038,5,16,true,11,19,8,41.83845,-87.6354
150,5,16,true,11,8,-3,41.83855,-87.60821
TA1307000048,5,16,true,28,34,6,41.83855,-87.60821
TA1308000036,5,16,true,8,16,8,41.83883,-87.62186
KA1503000040,5,16,true,5,10,5,41.84164,-87.65744
237,5,16,true,16,10,-6,41.84204,-87.61697
TA1307000139,5,16,true,52,45,-7,41.84205,-87.61698
TA1307000153,5,16,true,9,21,12,41.84358,-87.64538
147,5,16,true,14,7,-7,41.84569,-87.62251
TA1307000005,5,16,true,26,28,2,41.84569,-87.6225
TA1308000013,5,16,true,13,7,-6,41.84719,-87.64681
TA1305000001,5,16,true,16,19,3,41.85262,-87.6265
13075,5,16,true,35,31,-4,41.8531,-87.63192
120,5,16,true,16,13,-3,41.8531,-87.63191
13162,5,16,true,3,31,28,41.85378,-87.64659
13091,5,16,true,18,17,-1,41.85409,-87.68585
15546,5,16,true,13,11,-2,41.85416,-87.61916
13089,5,16,true,23,16,-7,41.85497,-87.67567
13331,5,16,true,13,9,-4,41.85515,-87.65414
15545,5,16,true,70,64,-6,41.85627,-87.61334
4,5,16,true,15,20,5,41.85627,-87.61334
SL-013,5,16,true,14,34,20,41.85659,-87.62755
129,5,16,true,6,11,5,41.85752,-87.66158
13135,5,16,true,23,29,6,41.85753,-87.66157
338,5,16,true,12,6,-6,41.85758,-87.61956
13102,5,16,true,53,64,11,41.85762,-87.61942
13150,5,16,true,70,60,-10,41.85783,-87.62455
273,5,16,true,17,13,-4,41.85783,-87.62455
13099,5,16,true,10,19,9,41.85784,-87.64627
205,5,16,true,10,7,-3,41.8579,-87.6687
TA1307000159,5,16,true,16,16,0,41.8579,-87.6687
TA1307000044,5,16,true,8,15,7,41.85794,-87.64083
13163,5,16,true,14,32,18,41.85808,-87.65108
13164,5,16,true,50,50,0,41.85818,-87.65648
SL-012,5,16,true,56,84,28,41.86038,-87.62581
72,5,16,true,15,13,-2,41.86039,-87.62581
13304,5,16,true,13,16,3,41.86126,-87.65659
KA1504000109,5,16,true,24,4,-20,41.86192,-87.69347
TA1306000002,5,16,true,38,35,-3,41.86238,-87.65108
TA1307000124,5,16,true,69,100,31,41.86411,-87.62372
168,5,16,true,14,11,-3,41.86415,-87.62372
TA1309000001,5,16,true,40,55,15,41.86488,-87.64708
275,5,16,true,12,9,-3,41.86524,-87.66651
13354,5,16,true,25,22,-3,41.86524,-87.66651
13029,5,16,true,10,16,6,41.86531,-87.6179
341,5,16,true,16,15,-1,41.86608,-87.60733
13431,5,16,true,44,39,-5,41.8661,-87.60728
KA1504000101,5,16,true,12,8,-4,41.86651,-87.68466
WL-008,5,16,true,36,42,6,41.86712,-87.64108
57,5,16,true,9,20,11,41.86712,-87.64107
59,5,16,true,15,33,18,41.86721,-87.62597
TA1305000002,5,16,true,100,151,51,41.86721,-87.62597
15544,5,16,true,48,27,-21,41.86723,-87.61536
TA1305000017,5,16,true,34,21,-13,41.86734,-87.64863
55,5,16,true,13,7,-6,41.86735,-87.64863
KA1706005007,5,16,true,37,46,9,41.86749,-87.63219
SL-005,5,16,true,108,163,55,41.8679,-87.62304
255,5,16,true,23,24,1,41.86791,-87.62304
644,5,16,true,39,56,17,41.86859,-87.68625
19,5,16,true,10,10,0,41.86892,-87.65913
13139,5,16,true,36,43,7,41.86893,-87.65913
13285,5,16,true,169,23,-146,41.86928,-87.67372
22,5,16,true,13,21,8,41.86947,-87.65548
13160,5,16,true,49,58,9,41.86947,-87.65548
414,5,16,true,3,11,8,41.87023,-87.63947
15550,5,16,true,24,37,13,41.87024,-87.63947
TA1309000010,5,16,true,70,69,-1,41.87074,-87.62574
SL-009,5,16,true,32,39,7,41.87081,-87.63121
342,5,16,true,44,3,-41,41.87127,-87.6737
TA1309000064,5,16,true,170,33,-137,41.87127,-87.67369
15542,5,16,true,8,10,2,41.87146,-87.64095
261,5,16,true,24,3,-21,41.87151,-87.6699
TA1307000130,5,16,true,77,78,1,41.87178,-87.65103
241,5,16,true,29,28,-1,41.8718,-87.65102
108,5,16,true,11,12,1,41.87183,-87.64664
TA1307000121,5,16,true,68,73,5,41.87184,-87.64664
41,5,16,true,22,32,10,41.87209,-87.62957
SL-008,5,16,true,112,158,46,41.87209,-87.62956
13332,5,16,true,136,99,-37,41.87219,-87.6615
394,5,16,true,10,10,0,41.87226,-87.63484
175,5,16,true,11,12,1,41.87255,-87.63359
SL-011,5,16,true,64,60,-4,41.87256,-87.63356
623,5,16,true,51,64,13,41.87272,-87.62399
KA1504000104,5,16,true,211,14,-197,41.87296,-87.66912
383,5,16,true,28,6,-22,41.87297,-87.66912
320,5,16,true,27,33,6,41.87327,-87.66402
5,5,16,true,18,18,0,41.87403,-87.6277
SL-007,5,16,true,39,36,-3,41.87404,-87.6277
13326,5,16,true,19,15,-4,41.87425,-87.63958
321,5,16,true,24,18,-6,41.87427,-87.63257
TA1306000025,5,16,true,38,32,-6,41.87464,-87.65703
15668,5,16,true,14,13,-1,41.87471,-87.68642
13028,5,16,true,44,50,6,41.87475,-87.64981
13081,5,16,true,32,10,-22,41.87501,-87.67326
89,5,16,true,5,14,9,41.87501,-87.6331
SL-010,5,16,true,40,80,40,41.87501,-87.63309
15541,5,16,true,12,20,8,41.8758,-87.62086
13037,5,16,true,19,22,3,41.87588,-87.64078
50,5,16,true,9,10,1,41.87592,-87.6307
TA1305000009,5,16,true,54,42,-12,41.87593,-87.63068
317,5,16,true,27,4,-23,41.87603,-87.68195
TA1305000010,5,16,true,30,18,-12,41.87623,-87.62444
45,5,16,true,11,2,-9,41.87623,-87.62444
624,5,16,true,60,46,-14,41.87626,-87.62923
33,5,16,true,19,10,-9,41.87715,-87.62786
TA1305000035,5,16,true,55,32,-23,41.87716,-87.62787
13138,5,16,true,59,75,16,41.87723,-87.63941
631,5,16,true,33,9,-24,41.87761,-87.6739
15539,5,16,true,87,62,-25,41.87763,-87.64405
13158,5,16,true,92,118,26,41.87764,-87.64957
134,5,16,true,16,24,8,41.87764,-87.64954
21,5,16,true,23,10,-13,41.87773,-87.6548
13157,5,16,true,89,86,-3,41.87773,-87.6548
TA1305000025,5,16,true,112,48,-64,41.87773,-87.63528
36,5,16,true,26,13,-13,41.87776,-87.63525
TA1309000002,5,16,true,38,28,-10,41.87784,-87.62408
13206,5,16,true,45,74,29,41.87794,-87.66201
283,5,16,true,43,9,-34,41.87809,-87.63183
TA1309000004,5,16,true,151,63,-88,41.87811,-87.63184
107,5,16,true,16,26,10,41.87822,-87.644
638,5,16,true,158,135,-23,41.87827,-87.64078
37,5,16,true,33,13,-20,41.87921,-87.62975
TA1305000005,5,16,true,104,36,-68,41.87924,-87.62975
286,5,16,true,17,5,-12,41.8793,-87.6355
13011,5,16,true,130,235,105,41.87931,-87.63993
TA1309000008,5,16,true,64,22,-42,41.87933,-87.6355
192,5,16,true,16,38,22,41.87935,-87.63997
KA1503000034,5,16,true,106,12,-94,41.87938,-87.63197
40,5,16,true,16,2,-14,41.87944,-87.63197
39,5,16,true,11,2,-9,41.87948,-87.62571
KA1503000015,5,16,true,76,39,-37,41.87948,-87.6257
15667,5,16,true,10,7,-3,41.8798,-87.68609
287,5,16,true,42,6,-36,41.88017,-87.63527
TA1309000007,5,16,true,180,28,-152,41.88022,-87.63526
WL-011,5,16,true,64,45,-19,41.88034,-87.64273
73,5,16,true,17,16,-1,41.8804,-87.64273
80,5,16,true,12,18,6,41.88042,-87.65556
13156,5,16,true,60,141,81,41.88042,-87.65554
13300,5,16,true,68,82,14,41.88097,-87.61675
76,5,16,true,23,18,-5,41.88098,-87.61675
13008,5,16,true,87,60,-27,41.88105,-87.62408
90,5,16,true,16,13,-3,41.88107,-87.62409
49,5,16,true,45,16,-29,41.88116,-87.62963
TA1305000006,5,16,true,254,66,-188,41.88122,-87.6296
13134,5,16,true,14,19,5,41.88138,-87.67493
13056,5,16,true,89,44,-45,41.88168,-87.63951
191,5,16,true,17,5,-12,41.88169,-87.63951
198,5,16,true,29,40,11,41.88187,-87.6488
TA1307000120,5,16,true,122,180,58,41.88188,-87.64879
13341,5,16,true,89,87,-2,41.88208,-87.63985
174,5,16,true,18,8,-10,41.88208,-87.63984
197,5,16,true,23,10,-13,41.88208,-87.62513
13036,5,16,true,47,40,-7,41.8821,-87.62513
77,5,16,true,27,22,-5,41.88214,-87.64108
TA1305000032,5,16,true,158,195,37,41.88218,-87.64109
98,5,16,true,21,12,-9,41.88266,-87.63251
13006,5,16,true,82,39,-43,41.88268,-87.63252
13353,5,16,true,59,84,25,41.88283,-87.6612
346,5,16,true,13,13,0,41.88284,-87.6612
654,5,16,true,37,30,-7,41.88307,-87.65698
233,5,16,true,9,18,9,41.88309,-87.6511
13409,5,16,true,54,56,2,41.8831,-87.6511
18,5,16,true,20,10,-10,41.88317,-87.63735
KA1503000072,5,16,true,78,35,-43,41.88317,-87.63693
91,5,16,true,19,30,11,41.88336,-87.64122
WL-012,5,16,true,163,275,112,41.88337,-87.6412
112,5,16,true,16,20,4,41.88362,-87.6486
13053,5,16,true,90,120,30,41.88365,-87.64863
43,5,16,true,10,22,12,41.88396,-87.62455
13001,5,16,true,110,108,-2,41.88397,-87.62459
13155,5,16,true,20,26,6,41.88407,-87.65689
621,5,16,true,8,12,4,41.88412,-87.65427
18062,5,16,true,60,72,12,41.88412,-87.65427
81,5,16,true,35,20,-15,41.88417,-87.6296
TA1306000010,5,16,true,180,103,-77,41.88419,-87.62961
TA1305000030,5,16,true,191,52,-139,41.88459,-87.63178
96,5,16,true,11,17,6,41.8846,-87.64455
15535,5,16,true,66,84,18,41.8846,-87.64455
51,5,16,true,30,20,-10,41.88462,-87.63176
TA1305000029,5,16,true,95,95,0,41.88466,-87.62787
195,5,16,true,27,24,-3,41.88466,-87.61952
13263,5,16,true,132,118,-14,41.88467,-87.61952
44,5,16,true,24,21,-3,41.88468,-87.62782
TA1306000015,5,16,true,97,95,-2,41.88549,-87.65232
71,5,16,true,22,19,-3,41.8855,-87.65233
66,5,16,true,22,22,0,41.88557,-87.64186
13021,5,16,true,115,111,-4,41.88559,-87.64184
TA1307000111,5,16,true,125,54,-71,41.88582,-87.63548
164,5,16,true,28,8,-20,41.88583,-87.63547
13073,5,16,true,22,30,8,41.88592,-87.66717
KA17018054,5,16,true,32,18,-14,41.88595,-87.67701
KA1503000012,5,16,true,137,75,-62,41.88599,-87.63089
38,5,16,true,33,17,-16,41.88599,-87.63089
52,5,16,true,25,15,-10,41.886,-87.62421
TA1305000011,5,16,true,127,77,-50,41.886,-87.62418
7,5,16,true,12,23,11,41.88627,-87.61751
15534,5,16,true,81,80,-1,41.88627,-87.61749
217,5,16,true,17,6,-11,41.8866,-87.65821
13197,5,16,true,40,23,-17,41.8866,-87.65816
264,5,16,true,14,5,-9,41.8867,-87.62224
TA1308000029,5,16,true,66,36,-30,41.88673,-87.62225
TA1307000131,5,16,true,97,37,-60,41.88688,-87.62606
194,5,16,true,28,7,-21,41.88688,-87.62606
6,5,16,true,18,16,-2,41.88697,-87.61281
KA1503000064,5,16,true,55,75,20,41.88697,-87.61281
100,5,16,true,27,13,-14,41.88814,-87.63657
TA1305000022,5,16,true,119,70,-49,41.88817,-87.63656
56,5,16,true,39,39,0,41.88866,-87.64442
TA1306000003,5,16,true,156,140,-16,41.88867,-87.64442
KA1503000043,5,16,true,218,188,-30,41.88918,-87.63851
133,5,16,true,40,41,1,41.88918,-87.63851
13050,5,16,true,131,94,-37,41.88919,-87.62775
47,5,16,true,26,24,-2,41.88921,-87.62775
15664,5,16,true,11,45,34,41.8895,-87.68821
13432,5,16,true,33,38,5,41.88989,-87.67149
TA1307000151,5,16,true,128,118,-10,41.88993,-87.63427
212,5,16,true,25,25,0,41.88995,-87.63427
636,5,16,true,65,80,15,41.88997,-87.63662
KA1503000044,5,16,true,74,30,-44,41.89018,-87.6262
KA1504000113,5,16,true,10,2,-8,41.89049,-87.70262
196,5,16,true,9,16,7,41.89053,-87.62205
13427,5,16,true,57,60,3,41.89054,-87.62205
26,5,16,true,20,34,14,41.89057,-87.61798
13430,5,16,true,135,123,-12,41.89077,-87.63169
181,5,16,true,25,19,-6,41.89077,-87.63168
TA1306000013,5,16,true,122,118,-4,41.89083,-87.61852
RN-,5,16,true,114,98,-16,41.89102,-87.63546
672,5,16,true,24,20,-4,41.89102,-87.63545
13434,5,16,true,18,52,34,41.89108,-87.66663
TA1308000006,5,16,true,34,34,0,41.89128,-87.67686
199,5,16,true,26,36,10,41.89143,-87.62676
TA1307000117,5,16,true,167,136,-31,41.89144,-87.62675
13033,5,16,true,112,126,14,41.8916,-87.64835
84,5,16,true,14,21,7,41.89161,-87.64833
186,5,16,true,13,13,0,41.8918,-87.65879
13194,5,16,true,64,85,21,41.8918,-87.65878
TA1305000003,5,16,true,133,106,-27,41.89187,-87.62061
24,5,16,true,34,29,-5,41.8919,-87.62063
643,5,16,true,9,24,15,41.89203,-87.68939
35,5,16,true,19,28,9,41.89227,-87.61206
13022,5,16,true,150,122,-28,41.89227,-87.61205
99,5,16,true,14,20,6,41.89255,-87.61449
TA1306000029,5,16,true,104,80,-24,41.89256,-87.61449
13265,5,16,true,142,124,-18,41.89383,-87.64172
74,5,16,true,28,27,-1,41.89384,-87.64173
13045,5,16,true,167,194,27,41.89403,-87.62931
110,5,16,true,42,41,-1,41.89406,-87.6293
13016,5,16,true,447,58,-389,41.89431,-87.62277
211,5,16,true,97,14,-83,41.89439,-87.62267
KA1503000041,5,16,true,200,81,-119,41.89452,-87.61798
142,5,16,true,71,15,-56,41.89453,-87.61806
92,5,16,true,12,19,7,41.89455,-87.65346
13196,5,16,true,43,65,22,41.89455,-87.65345
TA1307000062,5,16,true,115,56,-59,41.89466,-87.63839
111,5,16,true,25,16,-9,41.89466,-87.63837
TA1306000012,5,16,true,152,162,10,41.89475,-87.63438
53,5,16,true,43,46,3,41.89476,-87.63439
627,5,16,true,10,10,0,41.8948,-87.63231
KP1705001026,5,16,true,90,82,-8,41.89483,-87.6323
18058,5,16,true,17,24,7,41.8955,-87.68201
637,5,16,true,44,78,34,41.89563,-87.67209
128,5,16,true,10,21,11,41.89571,-87.67716
13132,5,16,true,64,73,9,41.89573,-87.67718
161,5,16,true,28,24,-4,41.89574,-87.62599
15530,5,16,true,129,75,-54,41.89575,-87.62596
18003,5,16,true,75,43,-32,41.89575,-87.62011
635,5,16,true,26,5,-21,41.89576,-87.62012
13247,5,16,true,40,59,19,41.89597,-87.66775
350,5,16,true,9,11,2,41.89597,-87.66774
TA1305000020,5,16,true,60,80,20,41.89636,-87.65406
54,5,16,true,22,16,-6,41.89637,-87.65407
13289,5,16,true,43,64,21,41.89638,-87.661
86,5,16,true,9,17,8,41.89639,-87.661
337,5,16,true,22,16,-6,41.89659,-87.63096
13303,5,16,true,83,64,-19,41.89672,-87.63088
13017,5,16,true,114,96,-18,41.89676,-87.6357
31,5,16,true,21,19,-2,41.89677,-87.63572
13338,5,16,true,145,50,-95,41.89697,-87.62173
173,5,16,true,44,20,-24,41.89704,-87.62173
TA1307000061,5,16,true,58,48,-10,41.89745,-87.62873
106,5,16,true,24,9,-15,41.89746,-87.62874
25,5,16,true,23,8,-15,41.89751,-87.62354
13034,5,16,true,81,36,-45,41.89754,-87.62352
48,5,16,true,39,15,-24,41.89772,-87.64302
TA1306000009,5,16,true,140,71,-69,41.89772,-87.64299
620,5,16,true,83,71,-12,41.89817,-87.63754
374,5,16,true,9,10,1,41.89842,-87.68659
KA1504000103,5,16,true,29,37,8,41.89842,-87.68659
145,5,16,true,25,16,-9,41.89856,-87.62211
15529,5,16,true,126,82,-44,41.89858,-87.62206
140,5,16,true,34,37,3,41.89895,-87.6299
TA1307000128,5,16,true,116,150,34,41.89896,-87.6299
657,5,16,true,43,49,6,41.89918,-87.6722
KA1504000117,5,16,true,10,10,0,41.89936,-87.64848
30,5,16,true,10,11,1,41.89964,-87.66789
13248,5,16,true,44,40,-4,41.89964,-87.66788
46,5,16,true,8,14,6,41.89994,-87.63444
TA1306000011,5,16,true,56,58,2,41.89994,-87.63443
KA1504000116,5,16,true,62,63,1,41.90023,-87.64299
364,5,16,true,13,19,6,41.90023,-87.64299
17660,5,16,true,21,30,9,41.90036,-87.69671
29,5,16,true,11,8,-3,41.90069,-87.66259
13290,5,16,true,39,60,21,41.90069,-87.66259
13042,5,16,true,152,122,-30,41.90097,-87.62377
85,5,16,true,29,27,-2,41.90098,-87.62375
183,5,16,true,7,13,6,41.90133,-87.67744
TA1307000070,5,16,true,40,59,19,41.90133,-87.67742
KA1504000133,5,16,true,105,133,28,41.90234,-87.62773
172,5,16,true,13,20,7,41.90236,-87.62774
15654,5,16,true,14,6,-8,41.90271,-87.70923
13241,5,16,true,27,24,-3,41.9029,-87.68731
176,5,16,true,45,60,15,41.90291,-87.63141
TA1306000006,5,16,true,21,36,15,41.90292,-87.63772
TA1307000039,5,16,true,185,263,78,41.90294,-87.63137
658,5,16,true,51,17,-34,41.903,-87.6838
13256,5,16,true,15,17,2,41.90302,-87.69749
17,5,16,true,15,18,3,41.90313,-87.67391
TA1305000034,5,16,true,51,73,22,41.90313,-87.67391
182,5,16,true,29,53,24,41.90317,-87.63442
KA1504000135,5,16,true,176,239,63,41.90319,-87.63439
13136,5,16,true,40,71,31,41.90326,-87.67845
130,5,16,true,13,9,-4,41.90327,-87.67846
210,5,16,true,31,31,0,41.90342,-87.66781
13061,5,16,true,115,118,3,41.90342,-87.66779
KA1504000079,5,16,true,79,84,5,41.9035,-87.64334
359,5,16,true,34,27,-7,41.90458,-87.6497
138,5,16,true,9,21,12,41.9046,-87.64057
TA1307000115,5,16,true,51,51,0,41.9046,-87.64056
291,5,16,true,24,22,-2,41.90672,-87.63494
TA1308000049,5,16,true,103,132,29,41.90672,-87.6349
KA1504000134,5,16,true,79,88,9,41.90687,-87.6262
180,5,16,true,17,20,3,41.90687,-87.62618
13224,5,16,true,84,69,-15,41.90706,-87.66725
333,5,16,true,13,20,7,41.90706,-87.66725
18069,5,16,true,20,1,-19,41.90722,-87.65563
TA1307000143,5,16,true,17,22,5,41.90762,-87.63854
61,5,16,true,13,26,13,41.90764,-87.67254
13221,5,16,true,80,100,20,41.90765,-87.67254
13245,5,16,true,20,2,-18,41.90777,-87.68586
301,5,16,true,27,26,-1,41.90796,-87.63203
TA1309000024,5,16,true,117,137,20,41.908,-87.63152
69,5,16,true,23,15,-8,41.90939,-87.6777
TA1305000041,5,16,true,111,89,-22,41.9094,-87.67769
331,5,16,true,150,157,7,41.90965,-87.64812
15653,5,16,true,7,11,4,41.90979,-87.7053
TA1305000037,5,16,true,45,66,21,41.91018,-87.67003
27,5,16,true,6,14,8,41.91019,-87.6435
TA1306000008,5,16,true,39,46,7,41.9102,-87.6435
16,5,16,true,19,12,-7,41.91035,-87.67008
213,5,16,true,10,10,0,41.91037,-87.68237
TA1308000005,5,16,true,34,33,-1,41.91042,-87.68238
276,5,16,true,4,11,7,41.91043,-87.69718
13258,5,16,true,19,30,11,41.91043,-87.69718
13257,5,16,true,25,26,1,41.91054,-87.68956
13154,5,16,true,84,111,27,41.91054,-87.65312
20,5,16,true,23,26,3,41.91055,-87.65313
60,5,16,true,28,16,-12,41.91059,-87.64942
13058,5,16,true,84,75,-9,41.91059,-87.64942
TA1307000038,5,16,true,75,75,0,41.91138,-87.63868
118,5,16,true,12,33,21,41.91138,-87.63868
LF-005,5,16,true,112,110,-2,41.91172,-87.62681
268,5,16,true,37,37,0,41.91172,-87.62681
126,5,16,true,15,20,5,41.91196,-87.63197
13128,5,16,true,60,66,6,41.91197,-87.63197
289,5,16,true,38,60,22,41.91209,-87.63472
TA1308000050,5,16,true,209,307,98,41.91211,-87.6347
158,5,16,true,24,28,4,41.91262,-87.6814
13243,5,16,true,45,65,20,41.91262,-87.6814
TA1309000032,5,16,true,17,17,0,41.91293,-87.66417
TA1306000032,5,16,true,104,101,-3,41.9137,-87.65285
93,5,16,true,22,24,2,41.91371,-87.65285
224,5,16,true,18,8,-10,41.91386,-87.64877
TA1307000166,5,16,true,63,83,20,41.91386,-87.64877
15655,5,16,true,25,18,-7,41.91401,-87.70514
18017,5,16,true,12,9,-3,41.91416,-87.71676
628,5,16,true,15,11,-4,41.9146,-87.66796
18067,5,16,true,29,42,13,41.9146,-87.66796
28,5,16,true,13,7,-6,41.91469,-87.64333
TA1306000007,5,16,true,24,27,3,41.91469,-87.64333
13068,5,16,true,46,49,3,41.91554,-87.68703
13179,5,16,true,126,136,10,41.9157,-87.63461
141,5,16,true,25,18,-7,41.91571,-87.63461
219,5,16,true,15,11,-4,41.91598,-87.67733
13133,5,16,true,59,59,0,41.91598,-87.67733
58,5,16,true,10,14,4,41.91602,-87.66894
TA1305000039,5,16,true,59,84,25,41.9163,-87.66749
15650,5,16,true,14,13,-1,41.91711,-87.71023
15651,5,16,true,22,53,31,41.91752,-87.70181
13266,5,16,true,21,37,16,41.91774,-87.69142
TA1309000029,5,16,true,36,35,-1,41.9178,-87.68245
309,5,16,true,5,10,5,41.91789,-87.6865
288,5,16,true,9,12,3,41.91809,-87.64375
TA1309000006,5,16,true,55,74,19,41.91809,-87.64375
223,5,16,true,13,8,-5,41.91821,-87.65698
TA1307000163,5,16,true,69,65,-4,41.91821,-87.65696
94,5,16,true,21,31,10,41.91831,-87.6363
13146,5,16,true,125,127,2,41.91831,-87.63629
13059,5,16,true,121,102,-19,41.91845,-87.65222
113,5,16,true,14,13,-1,41.91846,-87.65222
13259,5,16,true,12,24,12,41.91852,-87.69744
310,5,16,true,3,10,7,41.91984,-87.68083
225,5,16,true,17,25,8,41.91995,-87.64884
13192,5,16,true,62,114,52,41.91995,-87.64884
13288,5,16,true,23,22,-1,41.92008,-87.67788
13242,5,16,true,22,34,12,41.92021,-87.69266
307,5,16,true,11,6,-5,41.92077,-87.66373
TA1309000030,5,16,true,52,68,16,41.92077,-87.66372
13292,5,16,true,24,11,-13,41.92152,-87.70733
TA1309000033,5,16,true,87,96,9,41.92158,-87.65381
13193,5,16,true,124,165,41,41.92182,-87.64412
144,5,16,true,28,36,8,41.92182,-87.64411
13191,5,16,true,111,108,-3,41.92217,-87.63891
143,5,16,true,19,18,-1,41.92217,-87.63891
327,5,16,true,17,22,5,41.92225,-87.65783
13084,5,16,true,40,68,28,41.92268,-87.69715
123,5,16,true,12,6,-6,41.92268,-87.69714
LP-,5,16,true,63,34,-29,41.92396,-87.63584
673,5,16,true,14,14,0,41.92398,-87.63585
KA1504000140,5,16,true,18,17,-1,41.92409,-87.67646
15648,5,16,true,28,26,-2,41.92464,-87.68931
KA1504000090,5,16,true,7,16,9,41.92483,-87.7145
TA1307000001,5,16,true,71,66,-5,41.92535,-87.66581
188,5,16,true,19,8,-11,41.92536,-87.66581
TA1306000026,5,16,true,73,56,-17,41.92558,-87.65842
87,5,16,true,17,13,-4,41.92559,-87.65843
TA1306000016,5,16,true,111,75,-36,41.9256,-87.65371
67,5,16,true,19,20,1,41.9256,-87.65371
313,5,16,true,22,26,4,41.9257,-87.64246
TA1309000019,5,16,true,104,130,26,41.92586,-87.63897
TA1309000058,5,16,true,121,130,9,41.92591,-87.64927
127,5,16,true,38,35,-3,41.92592,-87.64927
177,5,16,true,44,39,-5,41.92627,-87.63086
TA1308000001,5,16,true,114,132,18,41.92627,-87.63086
15646,5,16,true,19,19,0,41.92668,-87.6977
13124,5,16,true,20,22,2,41.92675,-87.63444
302,5,16,true,9,17,8,41.92859,-87.65421
TA1309000023,5,16,true,61,75,14,41.9287,-87.65383
TA1307000113,5,16,true,62,58,-4,41.92878,-87.66391
190,5,16,true,12,10,-2,41.92878,-87.6639
13296,5,16,true,28,35,7,41.92883,-87.66852
TA1309000059,5,16,true,42,34,-8,41.92889,-87.65898
343,5,16,true,9,13,4,41.92889,-87.65898
349,5,16,true,21,16,-5,41.92915,-87.6491
TA1309000061,5,16,true,86,72,-14,41.92915,-87.64909
TA1308000031,5,16,true,27,35,8,41.92946,-87.68417
340,5,16,true,30,30,0,41.92956,-87.64313
TA1305000014,5,16,true,106,107,1,41.92956,-87.64313
260,5,16,true,15,11,-4,41.92958,-87.70791
13085,5,16,true,39,40,1,41.92958,-87.70789
15643,5,16,true,7,11,4,41.93057,-87.7238
TA1307000142,5,16,true,117,143,26,41.93125,-87.64432
220,5,16,true,29,21,-8,41.93125,-87.64431
13276,5,16,true,72,83,11,41.93132,-87.63874
324,5,16,true,14,15,1,41.93173,-87.64179
15645,5,16,true,11,10,-1,41.93191,-87.70121
13271,5,16,true,32,35,3,41.93192,-87.67784
152,5,16,true,25,10,-15,41.93221,-87.65864
TA1307000064,5,16,true,97,73,-24,41.93222,-87.65864
13,5,16,true,27,20,-7,41.93242,-87.65271
TA1306000014,5,16,true,90,104,14,41.93242,-87.65271
329,5,16,true,24,35,11,41.93258,-87.63642
TA1309000039,5,16,true,97,144,47,41.93258,-87.63642
13294,5,16,true,29,46,17,41.9326,-87.66595
319,5,16,true,8,15,7,41.93292,-87.67217
332,5,16,true,11,25,14,41.93313,-87.64776
TA1309000036,5,16,true,71,89,18,41.93313,-87.64776
15644,5,16,true,10,14,4,41.93534,-87.71687
TA1307000006,5,16,true,71,45,-26,41.93571,-87.6636
153,5,16,true,15,6,-9,41.93575,-87.66364
13268,5,16,true,15,22,7,41.93588,-87.67843
13269,5,16,true,30,40,10,41.93609,-87.66983
TA1307000052,5,16,true,97,89,-8,41.93628,-87.65266
115,5,16,true,13,29,16,41.93628,-87.65266
156,5,16,true,27,24,-3,41.9365,-87.64756
TA1307000136,5,16,true,125,141,16,41.9365,-87.64755
TA1307000041,5,16,true,97,106,9,41.93669,-87.63683
157,5,16,true,30,27,-3,41.9367,-87.63683
13137,5,16,true,159,168,9,41.9376,-87.6441
300,5,16,true,28,43,15,41.93761,-87.6441
15642,5,16,true,14,20,6,41.93843,-87.69801
KA17018068,5,16,true,15,21,6,41.93935,-87.68327
TA1309000042,5,16,true,62,82,20,41.93937,-87.66836
131,5,16,true,14,15,1,41.93937,-87.66835
KA150400009X,5,16,true,9,16,7,41.9394,-87.71159
13229,5,16,true,44,44,0,41.93946,-87.66376
226,5,16,true,6,10,4,41.93972,-87.65886
TA1308000019,5,16,true,63,60,-3,41.93973,-87.65886
13277,5,16,true,101,100,-1,41.9401,-87.64546
296,5,16,true,18,19,1,41.9401,-87.64546
TA1307000134,5,16,true,125,117,-8,41.94016,-87.65303
117,5,16,true,35,21,-14,41.94016,-87.65302
13143,5,16,true,20,29,9,41.94059,-87.67853
334,5,16,true,19,31,12,41.94076,-87.63919
TA1309000049,5,16,true,94,94,0,41.94077,-87.63919
15634,5,16,true,25,19,-6,41.94304,-87.68729
TA1307000138,5,16,true,55,68,13,41.94334,-87.67094
230,5,16,true,10,23,13,41.94335,-87.67093
13144,5,16,true,17,26,9,41.9434,-87.67964
299,5,16,true,21,28,7,41.94368,-87.64894
TA1309000025,5,16,true,103,115,12,41.94368,-87.64894
229,5,16,true,11,17,6,41.94372,-87.66401
13071,5,16,true,109,108,-1,41.94373,-87.66401
632,5,16,true,120,121,1,41.94453,-87.6547
303,5,16,true,33,27,-6,41.94522,-87.64702
15631,5,16,true,15,14,-1,41.94524,-87.70665
13278,5,16,true,113,116,3,41.94553,-87.64644
TA1309000050,5,16,true,17,19,2,41.94618,-87.67331
15632,5,16,true,23,6,-17,41.94664,-87.69463
KA1504000143,5,16,true,13,11,-2,41.94664,-87.68337
227,5,16,true,19,15,-4,41.94813,-87.66397
13235,5,16,true,103,109,6,41.94814,-87.66396
304,5,16,true,22,24,2,41.94878,-87.64922
13253,5,16,true,26,29,3,41.9488,-87.67527
257,5,16,true,6,10,4,41.9488,-87.67527
13325,5,16,true,115,125,10,41.94907,-87.64863
114,5,16,true,15,13,-2,41.94935,-87.65451
TA1307000126,5,16,true,109,70,-39,41.94936,-87.65451
232,5,16,true,23,24,1,41.94943,-87.64645
TA1307000150,5,16,true,95,111,16,41.94945,-87.64646
13319,5,16,true,44,24,-20,41.95069,-87.6687
TA1307000127,5,16,true,111,74,-37,41.9508,-87.65918
165,5,16,true,17,15,-2,41.95081,-87.65918
15628,5,16,true,12,14,2,41.95216,-87.69806
318,5,16,true,8,10,2,41.95254,-87.6735
13323,5,16,true,81,63,-18,41.95282,-87.65
256,5,16,true,12,12,0,41.95282,-87.65
TA1309000043,5,16,true,55,45,-10,41.95417,-87.66434
240,5,16,true,17,8,-9,41.95424,-87.65441
13063,5,16,true,71,98,27,41.95424,-87.65441
KA1504000158,5,16,true,14,20,6,41.95432,-87.68607
254,5,16,true,15,18,3,41.95438,-87.64806
TA1308000022,5,16,true,79,72,-7,41.95438,-87.64805
TA1307000149,5,16,true,41,38,-3,41.95467,-87.67392
298,5,16,true,13,18,5,41.95601,-87.68021
TA1309000026,5,16,true,41,38,-3,41.95601,-87.6802
13249,5,16,true,14,9,-5,41.95606,-87.66885
312,5,16,true,16,21,5,41.95637,-87.6563
TA1308000047,5,16,true,30,27,-3,41.95709,-87.6642
13379,5,16,true,84,71,-13,41.95786,-87.6495
TA1309000018,5,16,true,30,25,-5,41.95791,-87.67357
306,5,16,true,12,9,-3,41.9585,-87.655
TA1309000027,5,16,true,44,48,4,41.9585,-87.65499
13389,5,16,true,61,50,-11,41.961,-87.64958
15621,5,16,true,16,22,6,41.96103,-87.70586
15622,5,16,true,15,16,1,41.96108,-87.69544
KA1504000097,5,16,true,10,10,0,41.96116,-87.71658
TA1307000144,5,16,true,28,19,-9,41.96142,-87.6762
TA1309000021,5,16,true,18,23,5,41.9615,-87.6714
15623,5,16,true,18,21,3,41.96154,-87.69117
482,5,16,true,5,11,6,41.96154,-87.69117
234,5,16,true,13,3,-10,41.96158,-87.6661
KA1503000022,5,16,true,32,29,-3,41.96158,-87.66609
231,5,16,true,17,21,4,41.96163,-87.65464
TA1307000107,5,16,true,89,82,-7,41.96164,-87.65464
TA1307000156,5,16,true,31,27,-4,41.96301,-87.68479
243,5,16,true,11,7,-4,41.96302,-87.68479
TA1309000012,5,16,true,19,20,1,41.96325,-87.67928
249,5,16,true,25,24,-1,41.96398,-87.63818
TA1308000012,5,16,true,72,89,17,41.96398,-87.63818
293,5,16,true,4,12,8,41.96521,-87.65822
13074,5,16,true,42,37,-5,41.96521,-87.6582
639,5,16,true,49,60,11,41.96584,-87.64538
KA1504000127,5,16,true,10,15,5,41.96587,-87.70083
KA1504000093,5,16,true,16,39,23,41.96587,-87.69365
TA1307000140,5,16,true,23,42,19,41.96643,-87.68865
239,5,16,true,15,9,-6,41.9665,-87.68843
326,5,16,true,13,11,-2,41.96665,-87.67113
TA1309000014,5,16,true,52,48,-4,41.96709,-87.66744
TA1307000158,5,16,true,33,22,-11,41.9671,-87.67904
242,5,16,true,4,12,8,41.9671,-87.67904
251,5,16,true,17,6,-11,41.96796,-87.65
TA1307000119,5,16,true,37,39,2,41.96796,-87.65
474,5,16,true,10,3,-7,41.96835,-87.71182
323,5,16,true,8,14,6,41.96869,-87.66034
TA1308000021,5,16,true,35,28,-7,41.96883,-87.65765
253,5,16,true,9,10,1,41.96883,-87.65765
475,5,16,true,5,10,5,41.96885,-87.69611
KA1504000080,5,16,true,20,18,-2,41.96887,-87.69609
TA1309000015,5,16,true,20,14,-6,41.96889,-87.68401
TA1309000066,5,16,true,94,52,-42,41.9691,-87.67423
344,5,16,true,18,10,-8,41.9691,-87.67423
TA1309000041,5,16,true,54,27,-27,41.96951,-87.65471
465,5,16,true,19,11,-8,41.97161,-87.65016
KA1504000171,5,16,true,37,39,2,41.97161,-87.65016
TA1309000035,5,16,true,69,99,30,41.97335,-87.66785
295,5,16,true,14,7,-7,41.97378,-87.65972
13108,5,16,true,45,50,5,41.97379,-87.65971
KA1504000078,5,16,true,11,13,2,41.97491,-87.69258
KA1504000149,5,16,true,18,18,0,41.97562,-87.67945
KA1504000160,5,16,true,24,9,-15,41.97564,-87.70143
463,5,16,true,15,16,1,41.978,-87.66805
KA1504000146,5,16,true,36,54,18,41.978,-87.66805
294,5,16,true,9,11,2,41.97835,-87.65976
13109,5,16,true,42,57,15,41.97835,-87.65976
KA1504000147,5,16,true,10,20,10,41.97976,-87.67754
655,5,16,true,23,22,-1,41.97987,-87.68194
460,5,16,true,10,10,0,41.98358,-87.66916
KA1504000151,5,16,true,48,34,-14,41.98359,-87.66916
459,5,16,true,28,28,0,41.98403,-87.65231
KA1504000152,5,16,true,65,84,19,41.98403,-87.65231
15578,5,16,true,44,26,-18,41.98405,-87.66027
15575,5,16,true,28,36,8,41.98975,-87.66014
457,5,16,true,3,13,10,41.99052,-87.66982
KA1504000148,5,16,true,14,21,7,41.99086,-87.66971
15571,5,16,true,34,57,23,41.99478,-87.66028
KA1504000156,5,16,true,11,12,1,41.99925,-87.67137
RP-009,5,16,true,21,21,0,42.00107,-87.66122
RP-008,5,16,true,10,12,2,42.00446,-87.6724
660,5,16,true,20,35,15,42.00458,-87.66143
KA1504000175,5,16,true,20,32,12,42.00797,-87.66549
RP-005,5,16,true,11,6,-5,42.0086,-87.69047
KA1504000162,5,16,true,18,10,-8,42.00907,-87.67422
KA1504000159,5,16,true,7,18,11,42.01059,-87.66241
525,5,16,true,16,12,-4,42.01272,-87.66605
517,5,16,true,13,9,-4,42.01597,-87.675
520,5,16,true,22,27,5,42.01597,-87.66859
515,5,16,true,20,13,-7,42.01915,-87.67356
523,5,16,true,17,15,-2,42.02089,-87.66505
598,5,16,true,10,4,-6,42.02578,-87.68411
E002,5,16,true,21,27,6,42.03256,-87.67912
599,5,16,true,11,5,-6,42.03972,-87.69942
596,5,16,true,28,59,31,42.04822,-87.68348
E008,5,16,true,18,11,-7,42.05049,-87.67782
605,5,16,true,29,11,-18,42.05294,-87.67342
604,5,16,true,43,22,-21,42.05824,-87.67744
15491,6,8,false,13,6,-7,41.78096,-87.57624
KA1503000014,6,8,false,16,6,-10,41.7851,-87.60108
KA1503000071,6,8,false,3,10,7,41.79148,-87.59988
KA1503000074,6,8,false,3,10,7,41.79174,-87.58395
KA1504000076,6,8,false,6,12,6,41.7943,-87.60145
TA1308000009,6,8,false,23,12,-11,41.79522,-87.58075
KA1503000059,6,8,false,10,14,4,41.79952,-87.58643
TA1309000037,6,8,false,10,5,-5,41.79957,-87.59474
KA1503000007,6,8,false,15,6,-9,41.80242,-87.58689
13398,6,8,false,12,5,-7,41.80256,-87.59035
13215,6,8,false,10,1,-9,41.83634,-87.6135
TA1307000048,6,8,false,16,13,-3,41.83855,-87.60821
TA1305000004,6,8,false,20,7,-13,41.8514,-87.61884
15546,6,8,false,10,7,-3,41.85416,-87.61916
15545,6,8,false,26,37,11,41.85627,-87.61334
13102,6,8,false,14,10,-4,41.85762,-87.61942
13150,6,8,false,11,10,-1,41.85783,-87.62455
13164,6,8,false,12,9,-3,41.85818,-87.65648
SL-012,6,8,false,15,5,-10,41.86038,-87.62581
TA1307000124,6,8,false,26,14,-12,41.86411,-87.62372
13029,6,8,false,5,44,39,41.86531,-87.6179
13431,6,8,false,17,22,5,41.8661,-87.60728
TA1305000002,6,8,false,32,28,-4,41.86721,-87.62597
15544,6,8,false,29,87,58,41.86723,-87.61536
KA1706005007,6,8,false,13,3,-10,41.86749,-87.63219
SL-005,6,8,false,86,40,-46,41.8679,-87.62304
255,6,8,false,12,1,-11,41.86791,-87.62304
15550,6,8,false,2,14,12,41.87024,-87.63947
TA1309000010,6,8,false,29,16,-13,41.87074,-87.62574
SL-009,6,8,false,19,8,-11,41.87081,-87.63121
TA1309000064,6,8,false,16,4,-12,41.87127,-87.67369
TA1307000121,6,8,false,1,10,9,41.87184,-87.64664
SL-008,6,8,false,43,22,-21,41.87209,-87.62956
SL-011,6,8,false,22,7,-15,41.87256,-87.63356
623,6,8,false,71,22,-49,41.87272,-87.62399
KA1504000104,6,8,false,12,9,-3,41.87296,-87.66912
13028,6,8,false,11,5,-6,41.87475,-87.64981
15541,6,8,false,43,17,-26,41.8758,-87.62086
TA1305000010,6,8,false,17,6,-11,41.87623,-87.62444
624,6,8,false,14,5,-9,41.87626,-87.62923
13158,6,8,false,16,5,-11,41.87764,-87.64957
13157,6,8,false,10,6,-4,41.87773,-87.6548
TA1309000002,6,8,false,14,11,-3,41.87784,-87.62408
13206,6,8,false,10,4,-6,41.87794,-87.66201
638,6,8,false,15,17,2,41.87827,-87.64078
TA1305000005,6,8,false,16,8,-8,41.87924,-87.62975
13011,6,8,false,16,27,11,41.87931,-87.63993
KA1503000015,6,8,false,22,6,-16,41.87948,-87.6257
WL-011,6,8,false,19,8,-11,41.88034,-87.64273
13156,6,8,false,11,6,-5,41.88042,-87.65554
13300,6,8,false,100,84,-16,41.88097,-87.61675
76,6,8,false,11,8,-3,41.88098,-87.61675
13008,6,8,false,84,54,-30,41.88105,-87.62408
TA1305000006,6,8,false,14,4,-10,41.88122,-87.6296
13056,6,8,false,7,11,4,41.88168,-87.63951
TA1307000120,6,8,false,31,29,-2,41.88188,-87.64879
13341,6,8,false,8,10,2,41.88208,-87.63985
13036,6,8,false,26,13,-13,41.8821,-87.62513
TA1305000032,6,8,false,36,22,-14,41.88218,-87.64109
13353,6,8,false,9,13,4,41.88283,-87.6612
13409,6,8,false,16,13,-3,41.8831,-87.6511
WL-012,6,8,false,16,13,-3,41.88337,-87.6412
13053,6,8,false,16,27,11,41.88365,-87.64863
13001,6,8,false,43,32,-11,41.88397,-87.62459
18062,6,8,false,13,17,4,41.88412,-87.65427
TA1306000010,6,8,false,21,11,-10,41.88419,-87.62961
TA1305000030,6,8,false,12,8,-4,41.88459,-87.63178
15535,6,8,false,19,13,-6,41.8846,-87.64455
TA1305000029,6,8,false,18,6,-12,41.88466,-87.62787
13263,6,8,false,47,19,-28,41.88467,-87.61952
TA1306000015,6,8,false,13,18,5,41.88549,-87.65232
13021,6,8,false,21,17,-4,41.88559,-87.64184
TA1307000111,6,8,false,10,10,0,41.88582,-87.63548
KA1503000012,6,8,false,24,14,-10,41.88599,-87.63089
TA1305000011,6,8,false,21,23,2,41.886,-87.62418
15534,6,8,false,34,13,-21,41.88627,-87.61749
TA1308000029,6,8,false,21,13,-8,41.88673,-87.62225
TA1307000131,6,8,false,38,16,-22,41.88688,-87.62606
KA1503000064,6,8,false,42,42,0,41.88697,-87.61281
TA1305000022,6,8,false,25,11,-14,41.88817,-87.63656
TA1306000003,6,8,false,24,15,-9,41.88867,-87.64442
KA1503000043,6,8,false,44,21,-23,41.88918,-87.63851
13050,6,8,false,25,25,0,41.88919,-87.62775
TA1307000151,6,8,false,17,32,15,41.88993,-87.63427
636,6,8,false,14,12,-2,41.88997,-87.63662
13427,6,8,false,28,11,-17,41.89054,-87.62205
13430,6,8,false,26,26,0,41.89077,-87.63169
TA1306000013,6,8,false,54,18,-36,41.89083,-87.61852
RN-,6,8,false,16,13,-3,41.89102,-87.63546
13434,6,8,false,14,4,-10,41.89108,-87.66663
TA1307000117,6,8,false,35,24,-11,41.89144,-87.62675
13033,6,8,false,22,15,-7,41.8916,-87.64835
TA1305000003,6,8,false,43,34,-9,41.89187,-87.62061
35,6,8,false,7,11,4,41.89227,-87.61206
13022,6,8,false,114,100,-14,41.89227,-87.61205
TA1306000029,6,8,false,51,22,-29,41.89256,-87.61449
13265,6,8,false,29,14,-15,41.89383,-87.64172
13045,6,8,false,40,29,-11,41.89403,-87.62931
110,6,8,false,20,8,-12,41.89406,-87.6293
13016,6,8,false,73,17,-56,41.89431,-87.62277
KA1503000041,6,8,false,42,20,-22,41.89452,-87.61798
13196,6,8,false,17,9,-8,41.89455,-87.65345
TA1307000062,6,8,false,13,15,2,41.89466,-87.63839
TA1306000012,6,8,false,39,29,-10,41.89475,-87.63438
KP1705001026,6,8,false,28,18,-10,41.89483,-87.6323
637,6,8,false,12,8,-4,41.89563,-87.67209
13132,6,8,false,22,6,-16,41.89573,-87.67718
15530,6,8,false,28,11,-17,41.89575,-87.62596
18003,6,8,false,14,10,-4,41.89575,-87.62011
TA1305000020,6,8,false,21,19,-2,41.89636,-87.65406
13289,6,8,false,15,6,-9,41.89638,-87.661
13303,6,8,false,24,18,-6,41.89672,-87.63088
13017,6,8,false,18,17,-1,41.89676,-87.6357
13338,6,8,false,22,20,-2,41.89697,-87.62173
TA1307000061,6,8,false,18,12,-6,41.89745,-87.62873
13034,6,8,false,31,16,-15,41.89754,-87.62352
TA1306000009,6,8,false,15,10,-5,41.89772,-87.64299
KA1504000103,6,8,false,17,1,-16,41.89842,-87.68659
15529,6,8,false,39,21,-18,41.89858,-87.62206
TA1307000128,6,8,false,43,28,-15,41.89896,-87.6299
657,6,8,false,14,3,-11,41.89918,-87.6722
17660,6,8,false,13,4,-9,41.90036,-87.69671
13042,6,8,false,112,90,-22,41.90097,-87.62377
85,6,8,false,10,4,-6,41.90098,-87.62375
TA1307000070,6,8,false,12,2,-10,41.90133,-87.67742
KA1504000133,6,8,false,28,29,1,41.90234,-87.62773
15654,6,8,false,11,3,-8,41.90271,-87.70923
13241,6,8,false,18,4,-14,41.9029,-87.68731
176,6,8,false,17,10,-7,41.90291,-87.63141
TA1307000039,6,8,false,55,34,-21,41.90294,-87.63137
13256,6,8,false,12,9,-3,41.90302,-87.69749
TA1305000034,6,8,false,8,13,5,41.90313,-87.67391
KA1504000135,6,8,false,43,40,-3,41.90319,-87.63439
13136,6,8,false,12,20,8,41.90326,-87.67845
13061,6,8,false,18,20,2,41.90342,-87.66779
KA1504000079,6,8,false,21,8,-13,41.9035,-87.64334
TA1307000115,6,8,false,8,16,8,41.9046,-87.64056
TA1308000049,6,8,false,23,25,2,41.90672,-87.6349
KA1504000134,6,8,false,25,19,-6,41.90687,-87.6262
13224,6,8,false,22,8,-14,41.90706,-87.66725
13221,6,8,false,13,14,1,41.90765,-87.67254
301,6,8,false,10,4,-6,41.90796,-87.63203
TA1309000024,6,8,false,27,29,2,41.908,-87.63152
TA1305000041,6,8,false,19,22,3,41.9094,-87.67769
331,6,8,false,23,15,-8,41.90965,-87.64812
TA1305000037,6,8,false,17,9,-8,41.91018,-87.67003
TA1306000008,6,8,false,18,5,-13,41.9102,-87.6435
13154,6,8,false,12,12,0,41.91054,-87.65312
13058,6,8,false,16,17,1,41.91059,-87.64942
TA1307000038,6,8,false,17,10,-7,41.91138,-87.63868
LF-005,6,8,false,94,101,7,41.91172,-87.62681
13128,6,8,false,21,24,3,41.91197,-87.63197
289,6,8,false,4,10,6,41.91209,-87.63472
TA1308000050,6,8,false,39,64,25,41.91211,-87.6347
13243,6,8,false,7,12,5,41.91262,-87.6814
TA1306000032,6,8,false,17,9,-8,41.9137,-87.65285
TA1307000166,6,8,false,22,11,-11,41.91386,-87.64877
18067,6,8,false,6,13,7,41.9146,-87.66796
13068,6,8,false,17,9,-8,41.91554,-87.68703
13179,6,8,false,110,94,-16,41.9157,-87.63461
141,6,8,false,8,22,14,41.91571,-87.63461
TA1305000039,6,8,false,9,12,3,41.9163,-87.66749
TA1309000029,6,8,false,12,5,-7,41.9178,-87.68245
TA1309000006,6,8,false,10,7,-3,41.91809,-87.64375
TA1307000163,6,8,false,13,11,-2,41.91821,-87.65696
13146,6,8,false,37,39,2,41.91831,-87.63629
13059,6,8,false,20,10,-10,41.91845,-87.65222
13192,6,8,false,23,23,0,41.91995,-87.64884
13288,6,8,false,15,7,-8,41.92008,-87.67788
TA1309000033,6,8,false,9,17,8,41.92158,-87.65381
13193,6,8,false,28,27,-1,41.92182,-87.64412
13191,6,8,false,21,14,-7,41.92217,-87.63891
LP-,6,8,false,12,7,-5,41.92396,-87.63584
TA1307000001,6,8,false,19,12,-7,41.92535,-87.66581
TA1306000026,6,8,false,6,19,13,41.92558,-87.65842
TA1306000016,6,8,false,9,21,12,41.9256,-87.65371
TA1309000019,6,8,false,51,33,-18,41.92586,-87.63897
TA1309000058,6,8,false,33,39,6,41.92591,-87.64927
177,6,8,false,8,10,2,41.92627,-87.63086
TA1308000001,6,8,false,39,53,14,41.92627,-87.63086
13124,6,8,false,12,15,3,41.92675,-87.63444
TA1309000023,6,8,false,30,22,-8,41.9287,-87.65383
TA1307000113,6,8,false,15,22,7,41.92878,-87.66391
TA1309000059,6,8,false,17,9,-8,41.92889,-87.65898
TA1309000061,6,8,false,8,15,7,41.92915,-87.64909
TA1305000014,6,8,false,32,39,7,41.92956,-87.64313
13085,6,8,false,6,14,8,41.92958,-87.70789
TA1307000142,6,8,false,35,29,-6,41.93125,-87.64432
13276,6,8,false,66,27,-39,41.93132,-87.63874
TA1307000064,6,8,false,32,21,-11,41.93222,-87.65864
TA1306000014,6,8,false,22,19,-3,41.93242,-87.65271
TA1309000039,6,8,false,53,29,-24,41.93258,-87.63642
13294,6,8,false,10,9,-1,41.9326,-87.66595
TA1309000036,6,8,false,20,19,-1,41.93313,-87.64776
TA1307000006,6,8,false,15,10,-5,41.93571,-87.6636
13268,6,8,false,15,4,-11,41.93588,-87.67843
TA1307000052,6,8,false,36,15,-21,41.93628,-87.65266
TA1307000136,6,8,false,32,21,-11,41.9365,-87.64755
TA1307000041,6,8,false,44,26,-18,41.93669,-87.63683
13137,6,8,false,55,30,-25,41.9376,-87.6441
TA1309000042,6,8,false,15,13,-2,41.93937,-87.66836
13229,6,8,false,17,7,-10,41.93946,-87.66376
TA1308000019,6,8,false,29,22,-7,41.93973,-87.65886
13277,6,8,false,23,22,-1,41.9401,-87.64546
TA1307000134,6,8,false,32,19,-13,41.94016,-87.65303
117,6,8,false,3,11,8,41.94016,-87.65302
TA1309000049,6,8,false,48,48,0,41.94077,-87.63919
TA1307000138,6,8,false,12,13,1,41.94334,-87.67094
TA1309000025,6,8,false,20,15,-5,41.94368,-87.64894
13071,6,8,false,18,20,2,41.94373,-87.66401
632,6,8,false,26,23,-3,41.94453,-87.6547
13278,6,8,false,50,18,-32,41.94553,-87.64644
13235,6,8,false,17,13,-4,41.94814,-87.66396
13253,6,8,false,10,5,-5,41.9488,-87.67527
13325,6,8,false,21,25,4,41.94907,-87.64863
TA1307000126,6,8,false,28,23,-5,41.94936,-87.65451
TA1307000150,6,8,false,40,22,-18,41.94945,-87.64646
13319,6,8,false,13,26,13,41.95069,-87.6687
TA1307000127,6,8,false,17,8,-9,41.9508,-87.65918
13323,6,8,false,24,12,-12,41.95282,-87.65
13063,6,8,false,23,13,-10,41.95424,-87.65441
TA1308000022,6,8,false,29,23,-6,41.95438,-87.64805
13249,6,8,false,13,2,-11,41.95606,-87.66885
13379,6,8,false,23,10,-13,41.95786,-87.6495
TA1309000027,6,8,false,19,13,-6,41.9585,-87.65499
13389,6,8,false,30,11,-19,41.961,-87.64958
TA1307000107,6,8,false,22,18,-4,41.96164,-87.65464
TA1308000012,6,8,false,34,51,17,41.96398,-87.63818
13074,6,8,false,11,10,-1,41.96521,-87.6582
639,6,8,false,14,28,14,41.96584,-87.64538
KA1504000093,6,8,false,10,3,-7,41.96587,-87.69365
TA1307000140,6,8,false,13,3,-10,41.96643,-87.68865
TA1309000014,6,8,false,22,17,-5,41.96709,-87.66744
TA1307000119,6,8,false,16,6,-10,41.96796,-87.65
TA1309000066,6,8,false,17,8,-9,41.9691,-87.67423
TA1309000041,6,8,false,14,8,-6,41.96951,-87.65471
KA1504000171,6,8,false,18,14,-4,41.97161,-87.65016
TA1309000035,6,8,false,11,17,6,41.97335,-87.66785
13108,6,8,false,11,6,-5,41.97379,-87.65971
KA1504000146,6,8,false,10,17,7,41.978,-87.66805
13109,6,8,false,11,13,2,41.97835,-87.65976
KA1504000151,6,8,false,5,11,6,41.98359,-87.66916
KA1504000152,6,8,false,23,15,-8,41.98403,-87.65231
15575,6,8,false,15,9,-6,41.98975,-87.66014
15571,6,8,false,13,3,-10,41.99478,-87.66028
660,6,8,false,10,2,-8,42.00458,-87.66143
596,6,8,false,15,3,-12,42.04822,-87.68348
KA1503000014,6,8,true,79,16,-63,41.7851,-87.60108
426,6,8,true,13,2,-11,41.7851,-87.60108
KA1503000070,6,8,true,18,8,-10,41.78794,-87.58831
TA1309000011,6,8,true,10,15,5,41.78873,-87.60131
KA1503000071,6,8,true,8,17,9,41.79148,-87.59988
KA1503000074,6,8,true,12,9,-3,41.79174,-87.58395
TA1309000063,6,8,true,13,11,-2,41.79325,-87.5878
420,6,8,true,1,11,10,41.79429,-87.60145
KA1504000076,6,8,true,14,80,66,41.7943,-87.60145
TA1308000009,6,8,true,23,18,-5,41.79522,-87.58075
TA1307000164,6,8,true,10,4,-6,41.79527,-87.59647
KA1503000052,6,8,true,24,2,-22,41.79935,-87.60097
KA1503000059,6,8,true,9,11,2,41.79952,-87.58643
TA1309000037,6,8,true,27,12,-15,41.79957,-87.59474
KA1503000007,6,8,true,23,19,-4,41.80242,-87.58689
13398,6,8,true,11,10,-1,41.80256,-87.59035
TA1308000035,6,8,true,10,10,0,41.80944,-87.59188
TA1308000045,6,8,true,20,9,-11,41.83062,-87.64129
TA1307000129,6,8,true,6,21,15,41.83104,-87.62683
13345,6,8,true,3,13,10,41.83138,-87.61803
13216,6,8,true,13,37,24,41.83473,-87.62581
148,6,8,true,8,10,2,41.83474,-87.62581
13217,6,8,true,17,8,-9,41.83488,-87.61792
13215,6,8,true,34,8,-26,41.83634,-87.6135
TA1309000055,6,8,true,13,6,-7,41.8382,-87.64514
TA1307000048,6,8,true,20,32,12,41.83855,-87.60821
TA1308000036,6,8,true,18,13,-5,41.83883,-87.62186
KA1503000040,6,8,true,3,17,14,41.84164,-87.65744
TA1307000139,6,8,true,46,13,-33,41.84205,-87.61698
TA1307000005,6,8,true,13,7,-6,41.84569,-87.6225
TA1305000001,6,8,true,3,12,9,41.85262,-87.6265
13091,6,8,true,6,16,10,41.85409,-87.68585
15546,6,8,true,10,3,-7,41.85416,-87.61916
15545,6,8,true,66,69,3,41.85627,-87.61334
13102,6,8,true,27,15,-12,41.85762,-87.61942
13150,6,8,true,34,34,0,41.85783,-87.62455
TA1307000159,6,8,true,17,6,-11,41.8579,-87.6687
TA1307000044,6,8,true,22,4,-18,41.85794,-87.64083
13164,6,8,true,14,8,-6,41.85818,-87.65648
SL-012,6,8,true,46,21,-25,41.86038,-87.62581
TA1306000002,6,8,true,18,27,9,41.86238,-87.65108
TA1307000124,6,8,true,44,20,-24,41.86411,-87.62372
TA1309000001,6,8,true,13,6,-7,41.86488,-87.64708
13029,6,8,true,8,19,11,41.86531,-87.6179
341,6,8,true,9,11,2,41.86608,-87.60733
13431,6,8,true,29,35,6,41.8661,-87.60728
WL-008,6,8,true,9,26,17,41.86712,-87.64108
TA1305000002,6,8,true,55,44,-11,41.86721,-87.62597
59,6,8,true,9,21,12,41.86721,-87.62597
15544,6,8,true,28,45,17,41.86723,-87.61536
TA1305000017,6,8,true,2,13,11,41.86734,-87.64863
KA1706005007,6,8,true,24,10,-14,41.86749,-87.63219
SL-005,6,8,true,95,43,-52,41.8679,-87.62304
255,6,8,true,21,5,-16,41.86791,-87.62304
13139,6,8,true,21,4,-17,41.86893,-87.65913
13285,6,8,true,5,23,18,41.86928,-87.67372
13160,6,8,true,32,9,-23,41.86947,-87.65548
15550,6,8,true,2,36,34,41.87024,-87.63947
TA1309000010,6,8,true,59,35,-24,41.87074,-87.62574
SL-009,6,8,true,16,10,-6,41.87081,-87.63121
TA1309000064,6,8,true,6,25,19,41.87127,-87.67369
TA1307000130,6,8,true,25,9,-16,41.87178,-87.65103
SL-008,6,8,true,34,39,5,41.87209,-87.62956
13332,6,8,true,39,9,-30,41.87219,-87.6615
SL-011,6,8,true,44,14,-30,41.87256,-87.63356
623,6,8,true,20,21,1,41.87272,-87.62399
KA1504000104,6,8,true,16,22,6,41.87296,-87.66912
SL-007,6,8,true,12,12,0,41.87404,-87.6277
321,6,8,true,13,5,-8,41.87427,-87.63257
13028,6,8,true,7,20,13,41.87475,-87.64981
SL-010,6,8,true,25,7,-18,41.87501,-87.63309
15541,6,8,true,11,13,2,41.8758,-87.62086
15539,6,8,true,20,11,-9,41.87763,-87.64405
13158,6,8,true,30,13,-17,41.87764,-87.64957
134,6,8,true,2,13,11,41.87764,-87.64954
13157,6,8,true,23,19,-4,41.87773,-87.6548
TA1305000025,6,8,true,62,4,-58,41.87773,-87.63528
TA1309000002,6,8,true,9,13,4,41.87784,-87.62408
13206,6,8,true,16,15,-1,41.87794,-87.66201
TA1309000004,6,8,true,8,12,4,41.87811,-87.63184
638,6,8,true,9,30,21,41.87827,-87.64078
TA1305000005,6,8,true,6,10,4,41.87924,-87.62975
13011,6,8,true,11,56,45,41.87931,-87.63993
KA1503000034,6,8,true,7,19,12,41.87938,-87.63197
TA1309000007,6,8,true,4,11,7,41.88022,-87.63526
WL-011,6,8,true,25,27,2,41.88034,-87.64273
13156,6,8,true,20,20,0,41.88042,-87.65554
13300,6,8,true,99,71,-28,41.88097,-87.61675
76,6,8,true,12,7,-5,41.88098,-87.61675
13008,6,8,true,17,29,12,41.88105,-87.62408
TA1305000006,6,8,true,11,16,5,41.88122,-87.6296
13056,6,8,true,5,10,5,41.88168,-87.63951
TA1307000120,6,8,true,48,67,19,41.88188,-87.64879
13341,6,8,true,18,18,0,41.88208,-87.63985
13036,6,8,true,11,18,7,41.8821,-87.62513
77,6,8,true,5,11,6,41.88214,-87.64108
TA1305000032,6,8,true,24,40,16,41.88218,-87.64109
13006,6,8,true,6,12,6,41.88268,-87.63252
13353,6,8,true,23,11,-12,41.88283,-87.6612
654,6,8,true,19,13,-6,41.88307,-87.65698
13409,6,8,true,20,26,6,41.8831,-87.6511
WL-012,6,8,true,9,16,7,41.88337,-87.6412
13053,6,8,true,11,38,27,41.88365,-87.64863
13001,6,8,true,22,32,10,41.88397,-87.62459
13155,6,8,true,11,25,14,41.88407,-87.65689
18062,6,8,true,22,19,-3,41.88412,-87.65427
TA1306000010,6,8,true,16,16,0,41.88419,-87.62961
TA1305000030,6,8,true,10,16,6,41.88459,-87.63178
15535,6,8,true,26,33,7,41.8846,-87.64455
TA1305000029,6,8,true,15,39,24,41.88466,-87.62787
195,6,8,true,15,5,-10,41.88466,-87.61952
13263,6,8,true,56,23,-33,41.88467,-87.61952
TA1306000015,6,8,true,31,32,1,41.88549,-87.65232
13021,6,8,true,24,23,-1,41.88559,-87.64184
TA1307000111,6,8,true,16,15,-1,41.88582,-87.63548
38,6,8,true,5,13,8,41.88599,-87.63089
KA1503000012,6,8,true,21,36,15,41.88599,-87.63089
TA1305000011,6,8,true,15,20,5,41.886,-87.62418
7,6,8,true,12,3,-9,41.88627,-87.61751
15534,6,8,true,31,12,-19,41.88627,-87.61749
13197,6,8,true,2,17,15,41.8866,-87.65816
264,6,8,true,10,4,-6,41.8867,-87.62224
TA1308000029,6,8,true,36,9,-27,41.88673,-87.62225
TA1307000131,6,8,true,14,6,-8,41.88688,-87.62606
6,6,8,true,5,15,10,41.88697,-87.61281
KA1503000064,6,8,true,26,52,26,41.88697,-87.61281
TA1305000022,6,8,true,25,40,15,41.88817,-87.63656
56,6,8,true,27,8,-19,41.88866,-87.64442
TA1306000003,6,8,true,62,34,-28,41.88867,-87.64442
133,6,8,true,12,20,8,41.88918,-87.63851
KA1503000043,6,8,true,76,131,55,41.88918,-87.63851
13050,6,8,true,29,43,14,41.88919,-87.62775
13432,6,8,true,3,21,18,41.88989,-87.67149
TA1307000151,6,8,true,46,43,-3,41.88993,-87.63427
212,6,8,true,10,10,0,41.88995,-87.63427
636,6,8,true,17,20,3,41.88997,-87.63662
KA1503000044,6,8,true,20,2,-18,41.89018,-87.6262
196,6,8,true,10,16,6,41.89053,-87.62205
13427,6,8,true,27,19,-8,41.89054,-87.62205
26,6,8,true,13,9,-4,41.89057,-87.61798
13430,6,8,true,16,16,0,41.89077,-87.63169
181,6,8,true,1,10,9,41.89077,-87.63168
TA1306000013,6,8,true,75,36,-39,41.89083,-87.61852
RN-,6,8,true,42,23,-19,41.89102,-87.63546
672,6,8,true,13,3,-10,41.89102,-87.63545
13434,6,8,true,17,3,-14,41.89108,-87.66663
TA1308000006,6,8,true,19,7,-12,41.89128,-87.67686
199,6,8,true,5,12,7,41.89143,-87.62676
TA1307000117,6,8,true,33,60,27,41.89144,-87.62675
13033,6,8,true,32,24,-8,41.8916,-87.64835
13194,6,8,true,44,16,-28,41.8918,-87.65878
TA1305000003,6,8,true,49,31,-18,41.89187,-87.62061
24,6,8,true,16,8,-8,41.8919,-87.62063
13022,6,8,true,55,58,3,41.89227,-87.61205
99,6,8,true,15,4,-11,41.89255,-87.61449
TA1306000029,6,8,true,58,21,-37,41.89256,-87.61449
13265,6,8,true,50,28,-22,41.89383,-87.64172
13045,6,8,true,51,85,34,41.89403,-87.62931
110,6,8,true,12,27,15,41.89406,-87.6293
13016,6,8,true,52,37,-15,41.89431,-87.62277
211,6,8,true,10,12,2,41.89439,-87.62267
KA1503000041,6,8,true,65,61,-4,41.89452,-87.61798
142,6,8,true,5,15,10,41.89453,-87.61806
13196,6,8,true,17,16,-1,41.89455,-87.65345
TA1307000062,6,8,true,31,30,-1,41.89466,-87.63839
TA1306000012,6,8,true,68,54,-14,41.89475,-87.63438
53,6,8,true,29,9,-20,41.89476,-87.63439
627,6,8,true,5,11,6,41.8948,-87.63231
KP1705001026,6,8,true,37,69,32,41.89483,-87.6323
637,6,8,true,23,10,-13,41.89563,-87.67209
13132,6,8,true,17,12,-5,41.89573,-87.67718
15530,6,8,true,22,30,8,41.89575,-87.62596
18003,6,8,true,27,37,10,41.89575,-87.62011
13247,6,8,true,15,17,2,41.89597,-87.66775
TA1305000020,6,8,true,21,22,1,41.89636,-87.65406
13289,6,8,true,29,11,-18,41.89638,-87.661
337,6,8,true,13,8,-5,41.89659,-87.63096
13303,6,8,true,26,33,7,41.89672,-87.63088
13017,6,8,true,27,31,4,41.89676,-87.6357
31,6,8,true,5,12,7,41.89677,-87.63572
13338,6,8,true,47,26,-21,41.89697,-87.62173
173,6,8,true,12,9,-3,41.89704,-87.62173
TA1307000061,6,8,true,21,9,-12,41.89745,-87.62873
13034,6,8,true,9,17,8,41.89754,-87.62352
TA1306000009,6,8,true,24,26,2,41.89772,-87.64299
620,6,8,true,27,10,-17,41.89817,-87.63754
KA1504000103,6,8,true,23,10,-13,41.89842,-87.68659
145,6,8,true,15,6,-9,41.89856,-87.62211
15529,6,8,true,48,24,-24,41.89858,-87.62206
140,6,8,true,14,11,-3,41.89895,-87.6299
TA1307000128,6,8,true,55,57,2,41.89896,-87.6299
657,6,8,true,27,12,-15,41.89918,-87.6722
13248,6,8,true,20,19,-1,41.89964,-87.66788
TA1306000011,6,8,true,13,31,18,41.89994,-87.63443
KA1504000116,6,8,true,32,24,-8,41.90023,-87.64299
17660,6,8,true,16,2,-14,41.90036,-87.69671
13290,6,8,true,38,7,-31,41.90069,-87.66259
13042,6,8,true,51,70,19,41.90097,-87.62377
85,6,8,true,8,10,2,41.90098,-87.62375
TA1307000070,6,8,true,18,4,-14,41.90133,-87.67742
KA1504000133,6,8,true,28,44,16,41.90234,-87.62773
176,6,8,true,19,21,2,41.90291,-87.63141
TA1306000006,6,8,true,17,8,-9,41.90292,-87.63772
TA1307000039,6,8,true,81,127,46,41.90294,-87.63137
17,6,8,true,12,3,-9,41.90313,-87.67391
TA1305000034,6,8,true,30,26,-4,41.90313,-87.67391
182,6,8,true,17,9,-8,41.90317,-87.63442
KA1504000135,6,8,true,77,53,-24,41.90319,-87.63439
13136,6,8,true,17,26,9,41.90326,-87.67845
210,6,8,true,13,9,-4,41.90342,-87.66781
13061,6,8,true,74,41,-33,41.90342,-87.66779
KA1504000079,6,8,true,32,42,10,41.9035,-87.64334
138,6,8,true,4,10,6,41.9046,-87.64057
TA1307000115,6,8,true,31,11,-20,41.9046,-87.64056
291,6,8,true,16,12,-4,41.90672,-87.63494
TA1308000049,6,8,true,32,29,-3,41.90672,-87.6349
KA1504000134,6,8,true,39,27,-12,41.90687,-87.6262
13224,6,8,true,25,11,-14,41.90706,-87.66725
TA1307000143,6,8,true,14,11,-3,41.90762,-87.63854
61,6,8,true,3,11,8,41.90764,-87.67254
13221,6,8,true,27,32,5,41.90765,-87.67254
301,6,8,true,20,15,-5,41.90796,-87.63203
TA1309000024,6,8,true,80,49,-31,41.908,-87.63152
TA1305000041,6,8,true,24,30,6,41.9094,-87.67769
331,6,8,true,30,61,31,41.90965,-87.64812
15653,6,8,true,18,13,-5,41.90979,-87.7053
TA1305000037,6,8,true,16,28,12,41.91018,-87.67003
TA1306000008,6,8,true,27,11,-16,41.9102,-87.6435
13258,6,8,true,16,12,-4,41.91043,-87.69718
13257,6,8,true,12,7,-5,41.91054,-87.68956
13154,6,8,true,45,44,-1,41.91054,-87.65312
20,6,8,true,4,20,16,41.91055,-87.65313
13058,6,8,true,21,13,-8,41.91059,-87.64942
118,6,8,true,12,7,-5,41.91138,-87.63868
TA1307000038,6,8,true,29,36,7,41.91138,-87.63868
LF-005,6,8,true,74,65,-9,41.91172,-87.62681
268,6,8,true,11,12,1,41.91172,-87.62681
126,6,8,true,7,15,8,41.91196,-87.63197
13128,6,8,true,35,33,-2,41.91197,-87.63197
289,6,8,true,17,21,4,41.91209,-87.63472
TA1308000050,6,8,true,94,100,6,41.91211,-87.6347
13243,6,8,true,25,19,-6,41.91262,-87.6814
TA1306000032,6,8,true,35,29,-6,41.9137,-87.65285
TA1307000166,6,8,true,31,25,-6,41.91386,-87.64877
15655,6,8,true,20,2,-18,41.91401,-87.70514
18067,6,8,true,17,14,-3,41.9146,-87.66796
TA1306000007,6,8,true,19,13,-6,41.91469,-87.64333
13068,6,8,true,17,12,-5,41.91554,-87.68703
13179,6,8,true,144,151,7,41.9157,-87.63461
141,6,8,true,22,41,19,41.91571,-87.63461
13133,6,8,true,19,5,-14,41.91598,-87.67733
TA1305000039,6,8,true,11,17,6,41.9163,-87.66749
15650,6,8,true,15,10,-5,41.91711,-87.71023
15651,6,8,true,14,5,-9,41.91752,-87.70181
TA1309000006,6,8,true,28,22,-6,41.91809,-87.64375
TA1307000163,6,8,true,33,26,-7,41.91821,-87.65696
94,6,8,true,22,17,-5,41.91831,-87.6363
13146,6,8,true,114,61,-53,41.91831,-87.63629
13059,6,8,true,34,54,20,41.91845,-87.65222
113,6,8,true,13,6,-7,41.91846,-87.65222
13192,6,8,true,37,40,3,41.91995,-87.64884
225,6,8,true,13,17,4,41.91995,-87.64884
13288,6,8,true,14,8,-6,41.92008,-87.67788
307,6,8,true,9,12,3,41.92077,-87.66373
TA1309000030,6,8,true,14,46,32,41.92077,-87.66372
13292,6,8,true,10,3,-7,41.92152,-87.70733
TA1309000033,6,8,true,38,40,2,41.92158,-87.65381
13193,6,8,true,46,87,41,41.92182,-87.64412
144,6,8,true,8,31,23,41.92182,-87.64411
13191,6,8,true,50,37,-13,41.92217,-87.63891
143,6,8,true,10,3,-7,41.92217,-87.63891
327,6,8,true,13,4,-9,41.92225,-87.65783
LP-,6,8,true,37,16,-21,41.92396,-87.63584
TA1307000001,6,8,true,28,31,3,41.92535,-87.66581
188,6,8,true,4,10,6,41.92536,-87.66581
TA1306000026,6,8,true,16,33,17,41.92558,-87.65842
TA1306000016,6,8,true,28,41,13,41.9256,-87.65371
313,6,8,true,26,6,-20,41.9257,-87.64246
TA1309000019,6,8,true,77,47,-30,41.92586,-87.63897
TA1309000058,6,8,true,36,103,67,41.92591,-87.64927
127,6,8,true,9,19,10,41.92592,-87.64927
177,6,8,true,15,21,6,41.92627,-87.63086
TA1308000001,6,8,true,82,92,10,41.92627,-87.63086
13124,6,8,true,20,26,6,41.92675,-87.63444
TA1309000023,6,8,true,29,27,-2,41.9287,-87.65383
TA1307000113,6,8,true,32,14,-18,41.92878,-87.66391
13296,6,8,true,15,5,-10,41.92883,-87.66852
TA1309000059,6,8,true,21,20,-1,41.92889,-87.65898
349,6,8,true,10,9,-1,41.92915,-87.6491
TA1309000061,6,8,true,33,32,-1,41.92915,-87.64909
TA1308000031,6,8,true,7,22,15,41.92946,-87.68417
TA1305000014,6,8,true,67,33,-34,41.92956,-87.64313
340,6,8,true,15,9,-6,41.92956,-87.64313
13085,6,8,true,10,14,4,41.92958,-87.70789
TA1307000142,6,8,true,51,49,-2,41.93125,-87.64432
220,6,8,true,17,18,1,41.93125,-87.64431
13276,6,8,true,46,31,-15,41.93132,-87.63874
324,6,8,true,7,11,4,41.93173,-87.64179
13271,6,8,true,11,21,10,41.93192,-87.67784
152,6,8,true,12,14,2,41.93221,-87.65864
TA1307000064,6,8,true,48,41,-7,41.93222,-87.65864
TA1306000014,6,8,true,40,39,-1,41.93242,-87.65271
13,6,8,true,8,10,2,41.93242,-87.65271
TA1309000039,6,8,true,98,43,-55,41.93258,-87.63642
329,6,8,true,12,11,-1,41.93258,-87.63642
13294,6,8,true,11,5,-6,41.9326,-87.66595
332,6,8,true,19,10,-9,41.93313,-87.64776
TA1309000036,6,8,true,33,34,1,41.93313,-87.64776
TA1307000006,6,8,true,19,17,-2,41.93571,-87.6636
13268,6,8,true,11,14,3,41.93588,-87.67843
13269,6,8,true,12,8,-4,41.93609,-87.66983
TA1307000052,6,8,true,33,49,16,41.93628,-87.65266
156,6,8,true,7,12,5,41.9365,-87.64756
TA1307000136,6,8,true,44,64,20,41.9365,-87.64755
TA1307000041,6,8,true,60,44,-16,41.93669,-87.63683
157,6,8,true,17,7,-10,41.9367,-87.63683
13137,6,8,true,76,80,4,41.9376,-87.6441
300,6,8,true,11,10,-1,41.93761,-87.6441
TA1309000042,6,8,true,19,25,6,41.93937,-87.66836
13229,6,8,true,24,14,-10,41.93946,-87.66376
226,6,8,true,13,4,-9,41.93972,-87.65886
TA1308000019,6,8,true,50,31,-19,41.93973,-87.65886
296,6,8,true,11,5,-6,41.9401,-87.64546
13277,6,8,true,32,29,-3,41.9401,-87.64546
TA1307000134,6,8,true,40,57,17,41.94016,-87.65303
117,6,8,true,13,11,-2,41.94016,-87.65302
13143,6,8,true,12,6,-6,41.94059,-87.67853
334,6,8,true,16,14,-2,41.94076,-87.63919
TA1309000049,6,8,true,70,80,10,41.94077,-87.63919
TA1307000138,6,8,true,29,30,1,41.94334,-87.67094
299,6,8,true,13,4,-9,41.94368,-87.64894
TA1309000025,6,8,true,29,30,1,41.94368,-87.64894
229,6,8,true,7,10,3,41.94372,-87.66401
13071,6,8,true,38,26,-12,41.94373,-87.66401
632,6,8,true,38,33,-5,41.94453,-87.6547
303,6,8,true,20,7,-13,41.94522,-87.64702
13278,6,8,true,82,30,-52,41.94553,-87.64644
227,6,8,true,13,5,-8,41.94813,-87.66397
13235,6,8,true,33,37,4,41.94814,-87.66396
13253,6,8,true,28,13,-15,41.9488,-87.67527
13325,6,8,true,79,71,-8,41.94907,-87.64863
TA1307000126,6,8,true,48,21,-27,41.94936,-87.65451
232,6,8,true,22,33,11,41.94943,-87.64645
TA1307000150,6,8,true,103,74,-29,41.94945,-87.64646
13319,6,8,true,18,17,-1,41.95069,-87.6687
TA1307000127,6,8,true,33,28,-5,41.9508,-87.65918
15628,6,8,true,2,13,11,41.95216,-87.69806
13323,6,8,true,31,35,4,41.95282,-87.65
256,6,8,true,2,10,8,41.95282,-87.65
15624,6,8,true,3,13,10,41.95339,-87.73199
TA1309000043,6,8,true,27,9,-18,41.95417,-87.66434
240,6,8,true,12,3,-9,41.95424,-87.65441
13063,6,8,true,43,63,20,41.95424,-87.65441
254,6,8,true,12,3,-9,41.95438,-87.64806
TA1308000022,6,8,true,34,18,-16,41.95438,-87.64805
244,6,8,true,11,1,-10,41.95466,-87.67391
TA1307000149,6,8,true,23,19,-4,41.95467,-87.67392
TA1309000026,6,8,true,19,22,3,41.95601,-87.6802
312,6,8,true,10,4,-6,41.95637,-87.6563
TA1308000047,6,8,true,15,7,-8,41.95709,-87.6642
13379,6,8,true,38,10,-28,41.95786,-87.6495
TA1309000018,6,8,true,7,11,4,41.95791,-87.67357
TA1309000027,6,8,true,26,11,-15,41.9585,-87.65499
13389,6,8,true,41,40,-1,41.961,-87.64958
245,6,8,true,14,8,-6,41.96101,-87.64958
15622,6,8,true,12,11,-1,41.96108,-87.69544
TA1307000144,6,8,true,12,6,-6,41.96142,-87.6762
TA1309000021,6,8,true,15,2,-13,41.9615,-87.6714
KA1503000022,6,8,true,16,9,-7,41.96158,-87.66609
TA1307000107,6,8,true,34,22,-12,41.96164,-87.65464
TA1307000156,6,8,true,11,16,5,41.96301,-87.68479
TA1308000012,6,8,true,36,46,10,41.96398,-87.63818
13074,6,8,true,15,17,2,41.96521,-87.6582
639,6,8,true,30,48,18,41.96584,-87.64538
TA1307000140,6,8,true,16,14,-2,41.96643,-87.68865
TA1309000014,6,8,true,56,23,-33,41.96709,-87.66744
TA1307000158,6,8,true,37,7,-30,41.9671,-87.67904
242,6,8,true,13,4,-9,41.9671,-87.67904
TA1307000119,6,8,true,30,9,-21,41.96796,-87.65
TA1308000021,6,8,true,18,17,-1,41.96883,-87.65765
TA1309000066,6,8,true,17,27,10,41.9691,-87.67423
TA1309000041,6,8,true,24,8,-16,41.96951,-87.65471
KA1504000171,6,8,true,36,18,-18,41.97161,-87.65016
TA1309000035,6,8,true,36,28,-8,41.97335,-87.66785
295,6,8,true,14,4,-10,41.97378,-87.65972
13108,6,8,true,17,12,-5,41.97379,-87.65971
KA1504000149,6,8,true,16,15,-1,41.97562,-87.67945
KA1504000146,6,8,true,14,28,14,41.978,-87.66805
13109,6,8,true,29,13,-16,41.97835,-87.65976
655,6,8,true,2,10,8,41.97987,-87.68194
KA1504000151,6,8,true,16,4,-12,41.98359,-87.66916
459,6,8,true,10,8,-2,41.98403,-87.65231
KA1504000152,6,8,true,28,30,2,41.98403,-87.65231
15578,6,8,true,17,11,-6,41.98405,-87.66027
15575,6,8,true,16,11,-5,41.98975,-87.66014
KA1504000148,6,8,true,11,5,-6,41.99086,-87.66971
15571,6,8,true,20,9,-11,41.99478,-87.66028
RP-009,6,8,true,17,20,3,42.00107,-87.66122
660,6,8,true,36,16,-20,42.00458,-87.66143
KA1504000175,6,8,true,19,2,-17,42.00797,-87.66549
KA1504000159,6,8,true,12,6,-6,42.01059,-87.66241
525,6,8,true,29,3,-26,42.01272,-87.66605
520,6,8,true,6,31,25,42.01597,-87.66859
515,6,8,true,4,32,28,42.01915,-87.67356
523,6,8,true,23,4,-19,42.02089,-87.66505
KA1503000002,6,12,false,14,11,-3,41.76641,-87.5657
KA1503000029,6,12,false,11,11,0,41.77364,-87.56747
KA1503000046,6,12,false,15,15,0,41.78041,-87.59141
15491,6,12,false,27,21,-6,41.78096,-87.57624
KA1503000014,6,12,false,34,25,-9,41.7851,-87.60108
426,6,12,false,20,13,-7,41.7851,-87.60108
KA1503000070,6,12,false,13,14,1,41.78794,-87.58831
TA1309000011,6,12,false,15,8,-7,41.78873,-87.60131
423,6,12,false,11,9,-2,41.79148,-87.59988
KA1503000071,6,12,false,23,23,0,41.79148,-87.59988
KA1503000075,6,12,false,5,11,6,41.79156,-87.60785
424,6,12,false,16,8,-8,41.79174,-87.58395
KA1503000074,6,12,false,63,104,41,41.79174,-87.58395
TA1309000063,6,12,false,48,29,-19,41.79325,-87.5878
345,6,12,false,13,6,-7,41.79326,-87.5878
420,6,12,false,11,11,0,41.79429,-87.60145
KA1504000076,6,12,false,21,35,14,41.7943,-87.60145
TA1307000160,6,12,false,10,3,-7,41.79485,-87.61873
247,6,12,false,25,16,-9,41.79522,-87.58077
TA1308000009,6,12,false,86,93,7,41.79522,-87.58075
TA1307000164,6,12,false,27,24,-3,41.79527,-87.59647
248,6,12,false,10,7,-3,41.79528,-87.59647
KA1503000052,6,12,false,21,12,-9,41.79935,-87.60097
419,6,12,false,12,15,3,41.79952,-87.58643
KA1503000059,6,12,false,41,44,3,41.79952,-87.58643
TA1309000037,6,12,false,45,44,-1,41.79957,-87.59474
417,6,12,false,18,5,-13,41.80242,-87.5869
KA1503000007,6,12,false,52,47,-5,41.80242,-87.58689
13398,6,12,false,31,15,-16,41.80256,-87.59035
TA1308000035,6,12,false,15,18,3,41.80944,-87.59188
TA1308000002,6,12,false,15,14,-1,41.80983,-87.59937
KA1503000065,6,12,false,10,5,-5,41.81409,-87.59701
TA1308000038,6,12,false,11,11,0,41.82298,-87.6071
TA1307000129,6,12,false,17,13,-4,41.83104,-87.62683
KA1503000004,6,12,false,32,33,1,41.83127,-87.6088
13345,6,12,false,5,15,10,41.83138,-87.61803
13216,6,12,false,24,4,-20,41.83473,-87.62581
148,6,12,false,14,5,-9,41.83474,-87.62581
13217,6,12,false,19,8,-11,41.83488,-87.61792
13215,6,12,false,18,12,-6,41.83634,-87.6135
TA1308000046,6,12,false,13,7,-6,41.83779,-87.65115
TA1309000055,6,12,false,5,10,5,41.8382,-87.64514
150,6,12,false,27,11,-16,41.83855,-87.60821
TA1307000048,6,12,false,97,109,12,41.83855,-87.60821
TA1307000139,6,12,false,22,4,-18,41.84205,-87.61698
TA1307000005,6,12,false,13,14,1,41.84569,-87.6225
TA1308000026,6,12,false,17,12,-5,41.85008,-87.63214
TA1305000004,6,12,false,35,27,-8,41.8514,-87.61884
TA1305000001,6,12,false,17,23,6,41.85262,-87.6265
13075,6,12,false,65,110,45,41.8531,-87.63192
120,6,12,false,5,16,11,41.8531,-87.63191
13162,6,12,false,13,10,-3,41.85378,-87.64659
15546,6,12,false,47,23,-24,41.85416,-87.61916
13307,6,12,false,10,6,-4,41.85489,-87.66359
13089,6,12,false,11,7,-4,41.85497,-87.67567
4,6,12,false,11,20,9,41.85627,-87.61334
15545,6,12,false,90,103,13,41.85627,-87.61334
SL-013,6,12,false,28,19,-9,41.85659,-87.62755
SL-006,6,12,false,26,17,-9,41.8568,-87.63387
13135,6,12,false,25,9,-16,41.85753,-87.66157
338,6,12,false,15,8,-7,41.85758,-87.61956
13102,6,12,false,69,61,-8,41.85762,-87.61942
13150,6,12,false,70,51,-19,41.85783,-87.62455
273,6,12,false,17,8,-9,41.85783,-87.62455
13099,6,12,false,10,20,10,41.85784,-87.64627
TA1307000159,6,12,false,23,21,-2,41.8579,-87.6687
13163,6,12,false,22,29,7,41.85808,-87.65108
13164,6,12,false,33,37,4,41.85818,-87.65648
SL-012,6,12,false,32,30,-2,41.86038,-87.62581
13304,6,12,false,13,6,-7,41.86126,-87.65659
137,6,12,false,11,3,-8,41.86238,-87.65108
TA1306000002,6,12,false,14,7,-7,41.86238,-87.65108
TA1307000124,6,12,false,66,60,-6,41.86411,-87.62372
168,6,12,false,16,15,-1,41.86415,-87.62372
TA1309000001,6,12,false,36,29,-7,41.86488,-87.64708
97,6,12,false,17,10,-7,41.86531,-87.6179
13029,6,12,false,98,106,8,41.86531,-87.6179
341,6,12,false,32,30,-2,41.86608,-87.60733
13431,6,12,false,183,200,17,41.8661,-87.60728
WL-008,6,12,false,21,25,4,41.86712,-87.64108
TA1305000002,6,12,false,111,79,-32,41.86721,-87.62597
59,6,12,false,21,17,-4,41.86721,-87.62597
15544,6,12,false,513,449,-64,41.86723,-87.61536
3,6,12,false,98,76,-22,41.86723,-87.61536
TA1305000017,6,12,false,10,10,0,41.86734,-87.64863
626,6,12,false,6,12,6,41.86749,-87.63219
KA1706005007,6,12,false,21,28,7,41.86749,-87.63219
SL-005,6,12,false,240,226,-14,41.8679,-87.62304
255,6,12,false,51,45,-6,41.86791,-87.62304
13139,6,12,false,13,8,-5,41.86893,-87.65913
13160,6,12,false,20,26,6,41.86947,-87.65548
15550,6,12,false,27,22,-5,41.87024,-87.63947
TA1309000010,6,12,false,71,63,-8,41.87074,-87.62574
SL-009,6,12,false,43,26,-17,41.87081,-87.63121
TA1309000064,6,12,false,11,8,-3,41.87127,-87.67369
TA1307000130,6,12,false,19,8,-11,41.87178,-87.65103
TA1307000121,6,12,false,16,12,-4,41.87184,-87.64664
41,6,12,false,32,10,-22,41.87209,-87.62957
SL-008,6,12,false,113,92,-21,41.87209,-87.62956
13332,6,12,false,25,22,-3,41.87219,-87.6615
175,6,12,false,14,10,-4,41.87255,-87.63359
SL-011,6,12,false,40,31,-9,41.87256,-87.63356
623,6,12,false,158,110,-48,41.87272,-87.62399
KA1504000104,6,12,false,25,7,-18,41.87296,-87.66912
SL-007,6,12,false,30,28,-2,41.87404,-87.6277
321,6,12,false,22,15,-7,41.87427,-87.63257
TA1306000025,6,12,false,21,9,-12,41.87464,-87.65703
13028,6,12,false,25,14,-11,41.87475,-87.64981
SL-010,6,12,false,22,12,-10,41.87501,-87.63309
15541,6,12,false,172,153,-19,41.8758,-87.62086
TA1305000009,6,12,false,23,7,-16,41.87593,-87.63068
TA1305000010,6,12,false,41,34,-7,41.87623,-87.62444
624,6,12,false,43,26,-17,41.87626,-87.62923
2,6,12,false,44,30,-14,41.87649,-87.62051
33,6,12,false,8,21,13,41.87715,-87.62786
TA1305000035,6,12,false,23,15,-8,41.87716,-87.62787
13138,6,12,false,20,6,-14,41.87723,-87.63941
15539,6,12,false,73,33,-40,41.87763,-87.64405
13158,6,12,false,58,46,-12,41.87764,-87.64957
134,6,12,false,21,11,-10,41.87764,-87.64954
13157,6,12,false,57,39,-18,41.87773,-87.6548
21,6,12,false,18,9,-9,41.87773,-87.6548
TA1305000025,6,12,false,68,42,-26,41.87773,-87.63528
36,6,12,false,31,8,-23,41.87776,-87.63525
TA1309000002,6,12,false,109,87,-22,41.87784,-87.62408
284,6,12,false,23,32,9,41.87784,-87.62408
13206,6,12,false,35,10,-25,41.87794,-87.66201
TA1309000004,6,12,false,36,4,-32,41.87811,-87.63184
107,6,12,false,12,5,-7,41.87822,-87.644
638,6,12,false,51,33,-18,41.87827,-87.64078
TA1305000005,6,12,false,32,25,-7,41.87924,-87.62975
13011,6,12,false,80,38,-42,41.87931,-87.63993
TA1309000008,6,12,false,34,25,-9,41.87933,-87.6355
KA1503000034,6,12,false,22,20,-2,41.87938,-87.63197
39,6,12,false,11,3,-8,41.87948,-87.62571
KA1503000015,6,12,false,29,57,28,41.87948,-87.6257
TA1309000007,6,12,false,32,15,-17,41.88022,-87.63526
WL-011,6,12,false,21,21,0,41.88034,-87.64273
13156,6,12,false,79,63,-16,41.88042,-87.65554
13300,6,12,false,697,590,-107,41.88097,-87.61675
76,6,12,false,132,146,14,41.88098,-87.61675
13008,6,12,false,477,523,46,41.88105,-87.62408
90,6,12,false,71,123,52,41.88107,-87.62409
49,6,12,false,19,11,-8,41.88116,-87.62963
TA1305000006,6,12,false,83,40,-43,41.88122,-87.6296
13134,6,12,false,13,14,1,41.88138,-87.67493
13056,6,12,false,37,24,-13,41.88168,-87.63951
198,6,12,false,14,16,2,41.88187,-87.6488
TA1307000120,6,12,false,144,128,-16,41.88188,-87.64879
13341,6,12,false,92,50,-42,41.88208,-87.63985
197,6,12,false,16,16,0,41.88208,-87.62513
13036,6,12,false,95,65,-30,41.8821,-87.62513
77,6,12,false,15,5,-10,41.88214,-87.64108
TA1305000032,6,12,false,81,52,-29,41.88218,-87.64109
13006,6,12,false,39,21,-18,41.88268,-87.63252
13353,6,12,false,39,32,-7,41.88283,-87.6612
654,6,12,false,41,27,-14,41.88307,-87.65698
233,6,12,false,11,10,-1,41.88309,-87.6511
13409,6,12,false,42,58,16,41.8831,-87.6511
18,6,12,false,12,5,-7,41.88317,-87.63735
KA1503000072,6,12,false,35,28,-7,41.88317,-87.63693
91,6,12,false,13,11,-2,41.88336,-87.64122
WL-012,6,12,false,62,36,-26,41.88337,-87.6412
112,6,12,false,21,30,9,41.88362,-87.6486
13053,6,12,false,151,142,-9,41.88365,-87.64863
43,6,12,false,49,45,-4,41.88396,-87.62455
13001,6,12,false,229,240,11,41.88397,-87.62459
13155,6,12,false,30,19,-11,41.88407,-87.65689
18062,6,12,false,60,40,-20,41.88412,-87.65427
621,6,12,false,18,7,-11,41.88412,-87.65427
81,6,12,false,27,15,-12,41.88417,-87.6296
TA1306000010,6,12,false,91,56,-35,41.88419,-87.62961
TA1305000030,6,12,false,57,31,-26,41.88459,-87.63178
15535,6,12,false,72,65,-7,41.8846,-87.64455
96,6,12,false,12,7,-5,41.8846,-87.64455
TA1305000029,6,12,false,123,106,-17,41.88466,-87.62787
195,6,12,false,24,34,10,41.88466,-87.61952
13263,6,12,false,158,111,-47,41.88467,-87.61952
44,6,12,false,26,14,-12,41.88468,-87.62782
TA1306000015,6,12,false,138,118,-20,41.88549,-87.65232
518,6,12,false,10,4,-6,41.8855,-87.71686
71,6,12,false,21,26,5,41.8855,-87.65233
66,6,12,false,14,11,-3,41.88557,-87.64186
13021,6,12,false,78,49,-29,41.88559,-87.64184
TA1307000111,6,12,false,65,44,-21,41.88582,-87.63548
13073,6,12,false,20,34,14,41.88592,-87.66717
KA17018054,6,12,false,13,16,3,41.88595,-87.67701
KA1503000012,6,12,false,92,76,-16,41.88599,-87.63089
38,6,12,false,24,15,-9,41.88599,-87.63089
52,6,12,false,40,41,1,41.886,-87.62421
TA1305000011,6,12,false,110,131,21,41.886,-87.62418
7,6,12,false,14,16,2,41.88627,-87.61751
15534,6,12,false,83,67,-16,41.88627,-87.61749
13197,6,12,false,33,20,-13,41.8866,-87.65816
264,6,12,false,18,9,-9,41.8867,-87.62224
TA1308000029,6,12,false,52,60,8,41.88673,-87.62225
TA1307000131,6,12,false,99,67,-32,41.88688,-87.62606
194,6,12,false,20,30,10,41.88688,-87.62606
KA1503000064,6,12,false,309,270,-39,41.88697,-87.61281
6,6,12,false,46,35,-11,41.88697,-87.61281
TA1305000022,6,12,false,57,43,-14,41.88817,-87.63656
56,6,12,false,17,28,11,41.88866,-87.64442
TA1306000003,6,12,false,103,83,-20,41.88867,-87.64442
133,6,12,false,34,9,-25,41.88918,-87.63851
KA1503000043,6,12,false,130,125,-5,41.88918,-87.63851
13050,6,12,false,138,167,29,41.88919,-87.62775
47,6,12,false,18,31,13,41.88921,-87.62775
15664,6,12,false,10,5,-5,41.8895,-87.68821
13432,6,12,false,8,16,8,41.88989,-87.67149
TA1307000151,6,12,false,103,121,18,41.88993,-87.63427
212,6,12,false,37,18,-19,41.88995,-87.63427
636,6,12,false,63,45,-18,41.88997,-87.63662
125,6,12,false,10,22,12,41.89018,-87.62621
KA1503000044,6,12,false,64,62,-2,41.89018,-87.6262
196,6,12,false,17,10,-7,41.89053,-87.62205
13427,6,12,false,98,74,-24,41.89054,-87.62205
26,6,12,false,17,15,-2,41.89057,-87.61798
13430,6,12,false,120,136,16,41.89077,-87.63169
181,6,12,false,20,24,4,41.89077,-87.63168
TA1306000013,6,12,false,158,134,-24,41.89083,-87.61852
RN-,6,12,false,85,73,-12,41.89102,-87.63546
672,6,12,false,8,13,5,41.89102,-87.63545
13434,6,12,false,32,40,8,41.89108,-87.66663
TA1308000006,6,12,false,31,12,-19,41.89128,-87.67686
199,6,12,false,46,19,-27,41.89143,-87.62676
TA1307000117,6,12,false,156,178,22,41.89144,-87.62675
13033,6,12,false,114,102,-12,41.8916,-87.64835
84,6,12,false,29,19,-10,41.89161,-87.64833
13194,6,12,false,67,36,-31,41.8918,-87.65878
TA1305000003,6,12,false,158,153,-5,41.89187,-87.62061
24,6,12,false,11,15,4,41.8919,-87.62063
643,6,12,false,18,15,-3,41.89203,-87.68939
35,6,12,false,79,85,6,41.89227,-87.61206
13022,6,12,false,1106,1227,121,41.89227,-87.61205
99,6,12,false,24,20,-4,41.89255,-87.61449
TA1306000029,6,12,false,146,168,22,41.89256,-87.61449
13265,6,12,false,59,60,1,41.89383,-87.64172
74,6,12,false,16,8,-8,41.89384,-87.64173
13045,6,12,false,153,132,-21,41.89403,-87.62931
110,6,12,false,19,21,2,41.89406,-87.6293
13016,6,12,false,90,115,25,41.89431,-87.62277
211,6,12,false,24,17,-7,41.89439,-87.62267
KA1503000041,6,12,false,82,58,-24,41.89452,-87.61798
142,6,12,false,27,7,-20,41.89453,-87.61806
92,6,12,false,10,8,-2,41.89455,-87.65346
13196,6,12,false,70,38,-32,41.89455,-87.65345
TA1307000062,6,12,false,36,24,-12,41.89466,-87.63839
111,6,12,false,12,2,-10,41.89466,-87.63837
TA1306000012,6,12,false,142,169,27,41.89475,-87.63438
53,6,12,false,30,22,-8,41.89476,-87.63439
627,6,12,false,13,6,-7,41.8948,-87.63231
KP1705001026,6,12,false,71,80,9,41.89483,-87.6323
18058,6,12,false,33,19,-14,41.8955,-87.68201
637,6,12,false,58,27,-31,41.89563,-87.67209
13132,6,12,false,70,52,-18,41.89573,-87.67718
15530,6,12,false,117,100,-17,41.89575,-87.62596
18003,6,12,false,25,32,7,41.89575,-87.62011
13247,6,12,false,60,42,-18,41.89597,-87.66775
TA1305000020,6,12,false,87,41,-46,41.89636,-87.65406
13289,6,12,false,61,30,-31,41.89638,-87.661
86,6,12,false,10,11,1,41.89639,-87.661
337,6,12,false,14,15,1,41.89659,-87.63096
13303,6,12,false,86,99,13,41.89672,-87.63088
13017,6,12,false,36,32,-4,41.89676,-87.6357
13338,6,12,false,68,69,1,41.89697,-87.62173
173,6,12,false,14,21,7,41.89704,-87.62173
TA1307000061,6,12,false,51,50,-1,41.89745,-87.62873
106,6,12,false,14,6,-8,41.89746,-87.62874
25,6,12,false,32,21,-11,41.89751,-87.62354
13034,6,12,false,107,116,9,41.89754,-87.62352
48,6,12,false,12,4,-8,41.89772,-87.64302
TA1306000009,6,12,false,59,42,-17,41.89772,-87.64299
620,6,12,false,60,49,-11,41.89817,-87.63754
KA1504000103,6,12,false,33,17,-16,41.89842,-87.68659
145,6,12,false,21,18,-3,41.89856,-87.62211
15529,6,12,false,69,83,14,41.89858,-87.62206
140,6,12,false,34,31,-3,41.89895,-87.6299
TA1307000128,6,12,false,127,122,-5,41.89896,-87.6299
657,6,12,false,52,13,-39,41.89918,-87.6722
KA1504000117,6,12,false,19,3,-16,41.89936,-87.64848
13248,6,12,false,50,20,-30,41.89964,-87.66788
46,6,12,false,10,8,-2,41.89994,-87.63444
TA1306000011,6,12,false,56,37,-19,41.89994,-87.63443
KA1504000116,6,12,false,27,15,-12,41.90023,-87.64299
17660,6,12,false,51,33,-18,41.90036,-87.69671
13290,6,12,false,48,39,-9,41.90069,-87.66259
13042,6,12,false,632,651,19,41.90097,-87.62377
85,6,12,false,92,93,1,41.90098,-87.62375
TA1307000070,6,12,false,47,33,-14,41.90133,-87.67742
KA1504000133,6,12,false,154,192,38,41.90234,-87.62773
172,6,12,false,32,30,-2,41.90236,-87.62774
15654,6,12,false,11,12,1,41.90271,-87.70923
13241,6,12,false,35,21,-14,41.9029,-87.68731
176,6,12,false,25,38,13,41.90291,-87.63141
TA1306000006,6,12,false,32,23,-9,41.90292,-87.63772
TA1307000039,6,12,false,176,186,10,41.90294,-87.63137
658,6,12,false,26,22,-4,41.903,-87.6838
13256,6,12,false,34,16,-18,41.90302,-87.69749
17,6,12,false,20,10,-10,41.90313,-87.67391
TA1305000034,6,12,false,70,60,-10,41.90313,-87.67391
182,6,12,false,32,24,-8,41.90317,-87.63442
KA1504000135,6,12,false,201,177,-24,41.90319,-87.63439
13136,6,12,false,82,67,-15,41.90326,-87.67845
130,6,12,false,11,11,0,41.90327,-87.67846
210,6,12,false,19,23,4,41.90342,-87.66781
13061,6,12,false,201,125,-76,41.90342,-87.66779
KA1504000079,6,12,false,83,56,-27,41.9035,-87.64334
359,6,12,false,8,10,2,41.90458,-87.6497
TA1307000115,6,12,false,38,40,2,41.9046,-87.64056
291,6,12,false,32,21,-11,41.90672,-87.63494
TA1308000049,6,12,false,190,173,-17,41.90672,-87.6349
KA1504000134,6,12,false,89,66,-23,41.90687,-87.6262
180,6,12,false,22,8,-14,41.90687,-87.62618
13224,6,12,false,56,41,-15,41.90706,-87.66725
333,6,12,false,11,6,-5,41.90706,-87.66725
TA1307000143,6,12,false,34,24,-10,41.90762,-87.63854
61,6,12,false,17,21,4,41.90764,-87.67254
13221,6,12,false,126,115,-11,41.90765,-87.67254
13245,6,12,false,17,9,-8,41.90777,-87.68586
301,6,12,false,18,22,4,41.90796,-87.63203
TA1309000024,6,12,false,129,134,5,41.908,-87.63152
69,6,12,false,20,32,12,41.90939,-87.6777
TA1305000041,6,12,false,167,139,-28,41.9094,-87.67769
331,6,12,false,123,124,1,41.90965,-87.64812
15653,6,12,false,15,15,0,41.90979,-87.7053
TA1305000037,6,12,false,53,40,-13,41.91018,-87.67003
TA1306000008,6,12,false,42,29,-13,41.9102,-87.6435
TA1308000005,6,12,false,59,30,-29,41.91042,-87.68238
13258,6,12,false,34,24,-10,41.91043,-87.69718
13257,6,12,false,31,22,-9,41.91054,-87.68956
13154,6,12,false,64,79,15,41.91054,-87.65312
20,6,12,false,17,10,-7,41.91055,-87.65313
13058,6,12,false,77,65,-12,41.91059,-87.64942
60,6,12,false,10,12,2,41.91059,-87.64942
118,6,12,false,19,24,5,41.91138,-87.63868
TA1307000038,6,12,false,82,95,13,41.91138,-87.63868
268,6,12,false,57,75,18,41.91172,-87.62681
LF-005,6,12,false,616,780,164,41.91172,-87.62681
126,6,12,false,33,23,-10,41.91196,-87.63197
13128,6,12,false,186,168,-18,41.91197,-87.63197
289,6,12,false,31,38,7,41.91209,-87.63472
TA1308000050,6,12,false,276,314,38,41.91211,-87.6347
13243,6,12,false,90,76,-14,41.91262,-87.6814
158,6,12,false,15,14,-1,41.91262,-87.6814
TA1309000032,6,12,false,21,15,-6,41.91293,-87.66417
TA1306000032,6,12,false,72,72,0,41.9137,-87.65285
93,6,12,false,13,13,0,41.91371,-87.65285
TA1307000166,6,12,false,81,66,-15,41.91386,-87.64877
224,6,12,false,16,9,-7,41.91386,-87.64877
15655,6,12,false,31,26,-5,41.91401,-87.70514
18017,6,12,false,31,31,0,41.91416,-87.71676
18067,6,12,false,57,43,-14,41.9146,-87.66796
TA1306000007,6,12,false,31,22,-9,41.91469,-87.64333
13068,6,12,false,35,35,0,41.91554,-87.68703
116,6,12,false,12,1,-11,41.91555,-87.68703
13179,6,12,false,465,483,18,41.9157,-87.63461
141,6,12,false,86,83,-3,41.91571,-87.63461
13133,6,12,false,93,83,-10,41.91598,-87.67733
219,6,12,false,19,17,-2,41.91598,-87.67733
TA1305000039,6,12,false,59,51,-8,41.9163,-87.66749
15650,6,12,false,29,18,-11,41.91711,-87.71023
15651,6,12,false,74,55,-19,41.91752,-87.70181
507,6,12,false,11,11,0,41.91752,-87.70181
13266,6,12,false,29,22,-7,41.91774,-87.69142
TA1309000029,6,12,false,42,25,-17,41.9178,-87.68245
TA1309000006,6,12,false,83,87,4,41.91809,-87.64375
223,6,12,false,14,13,-1,41.91821,-87.65698
TA1307000163,6,12,false,61,48,-13,41.91821,-87.65696
94,6,12,false,58,56,-2,41.91831,-87.6363
13146,6,12,false,324,255,-69,41.91831,-87.63629
13059,6,12,false,158,159,1,41.91845,-87.65222
113,6,12,false,33,34,1,41.91846,-87.65222
13259,6,12,false,35,37,2,41.91852,-87.69744
13192,6,12,false,153,116,-37,41.91995,-87.64884
225,6,12,false,31,26,-5,41.91995,-87.64884
13288,6,12,false,32,18,-14,41.92008,-87.67788
13242,6,12,false,27,37,10,41.92021,-87.69266
307,6,12,false,7,11,4,41.92077,-87.66373
TA1309000030,6,12,false,54,53,-1,41.92077,-87.66372
13292,6,12,false,46,15,-31,41.92152,-87.70733
TA1309000033,6,12,false,122,111,-11,41.92158,-87.65381
13193,6,12,false,156,142,-14,41.92182,-87.64412
144,6,12,false,24,21,-3,41.92182,-87.64411
13191,6,12,false,105,95,-10,41.92217,-87.63891
143,6,12,false,12,19,7,41.92217,-87.63891
327,6,12,false,15,20,5,41.92225,-87.65783
13084,6,12,false,50,58,8,41.92268,-87.69715
LP-,6,12,false,179,194,15,41.92396,-87.63584
673,6,12,false,14,20,6,41.92398,-87.63585
KA1504000140,6,12,false,26,19,-7,41.92409,-87.67646
15648,6,12,false,30,16,-14,41.92464,-87.68931
KA1504000090,6,12,false,34,33,-1,41.92483,-87.7145
TA1307000001,6,12,false,94,60,-34,41.92535,-87.66581
188,6,12,false,10,14,4,41.92536,-87.66581
TA1306000026,6,12,false,78,49,-29,41.92558,-87.65842
TA1306000016,6,12,false,78,60,-18,41.9256,-87.65371
313,6,12,false,28,46,18,41.9257,-87.64246
TA1309000019,6,12,false,227,211,-16,41.92586,-87.63897
TA1309000058,6,12,false,178,143,-35,41.92591,-87.64927
127,6,12,false,29,18,-11,41.92592,-87.64927
177,6,12,false,89,100,11,41.92627,-87.63086
TA1308000001,6,12,false,401,511,110,41.92627,-87.63086
15646,6,12,false,26,17,-9,41.92668,-87.6977
13124,6,12,false,124,115,-9,41.92675,-87.63444
34,6,12,false,21,25,4,41.92675,-87.63444
302,6,12,false,35,24,-11,41.92859,-87.65421
TA1309000023,6,12,false,96,82,-14,41.9287,-87.65383
TA1307000113,6,12,false,89,83,-6,41.92878,-87.66391
190,6,12,false,11,10,-1,41.92878,-87.6639
166,6,12,false,7,11,4,41.92883,-87.66853
13296,6,12,false,63,29,-34,41.92883,-87.66852
TA1309000059,6,12,false,51,40,-11,41.92889,-87.65898
343,6,12,false,6,11,5,41.92889,-87.65898
349,6,12,false,11,10,-1,41.92915,-87.6491
TA1309000061,6,12,false,102,82,-20,41.92915,-87.64909
TA1308000031,6,12,false,28,35,7,41.92946,-87.68417
TA1305000014,6,12,false,165,144,-21,41.92956,-87.64313
340,6,12,false,27,23,-4,41.92956,-87.64313
260,6,12,false,27,21,-6,41.92958,-87.70791
13085,6,12,false,82,71,-11,41.92958,-87.70789
15643,6,12,false,16,18,2,41.93057,-87.7238
TA1307000142,6,12,false,184,106,-78,41.93125,-87.64432
220,6,12,false,22,20,-2,41.93125,-87.64431
13276,6,12,false,173,135,-38,41.93132,-87.63874
324,6,12,false,25,17,-8,41.93173,-87.64179
15645,6,12,false,31,8,-23,41.93191,-87.70121
13271,6,12,false,32,23,-9,41.93192,-87.67784
152,6,12,false,7,13,6,41.93221,-87.65864
TA1307000064,6,12,false,89,81,-8,41.93222,-87.65864
TA1306000014,6,12,false,123,60,-63,41.93242,-87.65271
13,6,12,false,11,14,3,41.93242,-87.65271
TA1309000039,6,12,false,235,204,-31,41.93258,-87.63642
329,6,12,false,34,15,-19,41.93258,-87.63642
13294,6,12,false,70,35,-35,41.9326,-87.66595
TA1309000036,6,12,false,128,61,-67,41.93313,-87.64776
332,6,12,false,28,10,-18,41.93313,-87.64776
15644,6,12,false,13,16,3,41.93534,-87.71687
TA1307000006,6,12,false,115,68,-47,41.93571,-87.6636
153,6,12,false,12,10,-2,41.93575,-87.66364
13268,6,12,false,33,15,-18,41.93588,-87.67843
13269,6,12,false,29,18,-11,41.93609,-87.66983
TA1307000052,6,12,false,124,109,-15,41.93628,-87.65266
115,6,12,false,15,17,2,41.93628,-87.65266
156,6,12,false,10,21,11,41.9365,-87.64756
TA1307000136,6,12,false,96,91,-5,41.9365,-87.64755
TA1307000041,6,12,false,222,218,-4,41.93669,-87.63683
157,6,12,false,31,45,14,41.9367,-87.63683
13137,6,12,false,184,128,-56,41.9376,-87.6441
300,6,12,false,35,39,4,41.93761,-87.6441
15642,6,12,false,12,16,4,41.93843,-87.69801
154,6,12,false,17,5,-12,41.93912,-87.66384
KA17018068,6,12,false,25,11,-14,41.93935,-87.68327
TA1309000042,6,12,false,84,49,-35,41.93937,-87.66836
131,6,12,false,12,7,-5,41.93937,-87.66835
13229,6,12,false,68,38,-30,41.93946,-87.66376
226,6,12,false,14,20,6,41.93972,-87.65886
TA1308000019,6,12,false,81,98,17,41.93973,-87.65886
296,6,12,false,16,18,2,41.9401,-87.64546
13277,6,12,false,127,131,4,41.9401,-87.64546
TA1307000134,6,12,false,184,184,0,41.94016,-87.65303
117,6,12,false,23,33,10,41.94016,-87.65302
13143,6,12,false,21,27,6,41.94059,-87.67853
334,6,12,false,40,35,-5,41.94076,-87.63919
TA1309000049,6,12,false,190,202,12,41.94077,-87.63919
15634,6,12,false,12,14,2,41.94304,-87.68729
TA1307000138,6,12,false,68,58,-10,41.94334,-87.67094
230,6,12,false,6,12,6,41.94335,-87.67093
13144,6,12,false,37,20,-17,41.9434,-87.67964
299,6,12,false,26,14,-12,41.94368,-87.64894
TA1309000025,6,12,false,167,187,20,41.94368,-87.64894
229,6,12,false,24,14,-10,41.94372,-87.66401
13071,6,12,false,138,134,-4,41.94373,-87.66401
632,6,12,false,141,198,57,41.94453,-87.6547
303,6,12,false,21,20,-1,41.94522,-87.64702
15631,6,12,false,11,10,-1,41.94524,-87.70665
13278,6,12,false,111,113,2,41.94553,-87.64644
TA1309000050,6,12,false,33,11,-22,41.94618,-87.67331
15632,6,12,false,10,10,0,41.94664,-87.69463
KA1504000143,6,12,false,26,10,-16,41.94664,-87.68337
227,6,12,false,18,14,-4,41.94813,-87.66397
13235,6,12,false,89,129,40,41.94814,-87.66396
304,6,12,false,10,9,-1,41.94878,-87.64922
13253,6,12,false,29,10,-19,41.9488,-87.67527
13325,6,12,false,108,97,-11,41.94907,-87.64863
114,6,12,false,10,25,15,41.94935,-87.65451
TA1307000126,6,12,false,125,355,230,41.94936,-87.65451
232,6,12,false,35,18,-17,41.94943,-87.64645
TA1307000150,6,12,false,125,124,-1,41.94945,-87.64646
13319,6,12,false,65,49,-16,41.95069,-87.6687
TA1307000127,6,12,false,118,166,48,41.9508,-87.65918
165,6,12,false,11,15,4,41.95081,-87.65918
15628,6,12,false,14,19,5,41.95216,-87.69806
318,6,12,false,17,11,-6,41.95254,-87.6735
13323,6,12,false,89,79,-10,41.95282,-87.65
256,6,12,false,11,10,-1,41.95282,-87.65
KA1504000096,6,12,false,12,8,-4,41.95361,-87.70932
KA1504000139,6,12,false,12,3,-9,41.954,-87.71909
TA1309000043,6,12,false,29,39,10,41.95417,-87.66434
240,6,12,false,13,3,-10,41.95424,-87.65441
13063,6,12,false,89,80,-9,41.95424,-87.65441
KA1504000158,6,12,false,20,8,-12,41.95432,-87.68607
254,6,12,false,17,7,-10,41.95438,-87.64806
TA1308000022,6,12,false,61,81,20,41.95438,-87.64805
TA1307000149,6,12,false,30,19,-11,41.95467,-87.67392
TA1309000026,6,12,false,25,25,0,41.95601,-87.6802
13249,6,12,false,21,13,-8,41.95606,-87.66885
312,6,12,false,15,2,-13,41.95637,-87.6563
TA1308000047,6,12,false,20,12,-8,41.95709,-87.6642
13379,6,12,false,63,34,-29,41.95786,-87.6495
TA1309000018,6,12,false,17,13,-4,41.95791,-87.67357
TA1309000027,6,12,false,41,23,-18,41.9585,-87.65499
13389,6,12,false,63,66,3,41.961,-87.64958
245,6,12,false,16,13,-3,41.96101,-87.64958
15621,6,12,false,11,1,-10,41.96103,-87.70586
15622,6,12,false,23,13,-10,41.96108,-87.69544
TA1307000144,6,12,false,19,15,-4,41.96142,-87.6762
TA1309000021,6,12,false,22,6,-16,41.9615,-87.6714
15623,6,12,false,12,7,-5,41.96154,-87.69117
234,6,12,false,10,4,-6,41.96158,-87.6661
KA1503000022,6,12,false,37,14,-23,41.96158,-87.66609
231,6,12,false,25,7,-18,41.96163,-87.65464
TA1307000107,6,12,false,65,37,-28,41.96164,-87.65464
TA1307000156,6,12,false,35,27,-8,41.96301,-87.68479
TA1309000012,6,12,false,14,16,2,41.96325,-87.67928
249,6,12,false,13,23,10,41.96398,-87.63818
TA1308000012,6,12,false,173,205,32,41.96398,-87.63818
13074,6,12,false,48,36,-12,41.96521,-87.6582
639,6,12,false,92,114,22,41.96584,-87.64538
KA1504000093,6,12,false,11,6,-5,41.96587,-87.69365
TA1307000140,6,12,false,13,31,18,41.96643,-87.68865
326,6,12,false,10,11,1,41.96665,-87.67113
TA1309000014,6,12,false,34,30,-4,41.96709,-87.66744
TA1307000158,6,12,false,26,16,-10,41.9671,-87.67904
TA1307000119,6,12,false,38,49,11,41.96796,-87.65
TA1308000021,6,12,false,32,17,-15,41.96883,-87.65765
253,6,12,false,11,7,-4,41.96883,-87.65765
KA1504000080,6,12,false,10,7,-3,41.96887,-87.69609
TA1309000015,6,12,false,18,9,-9,41.96889,-87.68401
TA1309000066,6,12,false,44,32,-12,41.9691,-87.67423
344,6,12,false,10,6,-4,41.9691,-87.67423
TA1309000041,6,12,false,45,30,-15,41.96951,-87.65471
KA1504000171,6,12,false,67,52,-15,41.97161,-87.65016
465,6,12,false,12,11,-1,41.97161,-87.65016
325,6,12,false,13,7,-6,41.9728,-87.67186
TA1309000035,6,12,false,59,59,0,41.97335,-87.66785
295,6,12,false,17,9,-8,41.97378,-87.65972
13108,6,12,false,54,48,-6,41.97379,-87.65971
KA1504000078,6,12,false,18,6,-12,41.97491,-87.69258
464,6,12,false,10,10,0,41.97562,-87.67945
KA1504000149,6,12,false,21,23,2,41.97562,-87.67945
KA1504000160,6,12,false,12,5,-7,41.97564,-87.70143
463,6,12,false,17,18,1,41.978,-87.66805
KA1504000146,6,12,false,60,67,7,41.978,-87.66805
294,6,12,false,16,8,-8,41.97835,-87.65976
13109,6,12,false,35,33,-2,41.97835,-87.65976
KA1504000147,6,12,false,7,17,10,41.97976,-87.67754
655,6,12,false,9,33,24,41.97987,-87.68194
KA1504000151,6,12,false,31,30,-1,41.98359,-87.66916
KA1504000152,6,12,false,142,135,-7,41.98403,-87.65231
459,6,12,false,33,27,-6,41.98403,-87.65231
15578,6,12,false,37,26,-11,41.98405,-87.66027
15575,6,12,false,45,28,-17,41.98975,-87.66014
KA1504000148,6,12,false,21,8,-13,41.99086,-87.66971
15571,6,12,false,49,40,-9,41.99478,-87.66028
454,6,12,false,11,13,2,41.99478,-87.66027
KA1504000156,6,12,false,25,16,-9,41.99925,-87.67137
RP-009,6,12,false,46,25,-21,42.00107,-87.66122
RP-008,6,12,false,10,12,2,42.00446,-87.6724
660,6,12,false,21,29,8,42.00458,-87.66143
KA1504000175,6,12,false,28,12,-16,42.00797,-87.66549
KA1504000159,6,12,false,15,14,-1,42.01059,-87.66241
525,6,12,false,15,3,-12,42.01272,-87.66605
520,6,12,false,19,10,-9,42.01597,-87.66859
515,6,12,false,12,9,-3,42.01915,-87.67356
523,6,12,false,15,11,-4,42.02089,-87.66505
E002,6,12,false,20,24,4,42.03256,-87.67912
599,6,12,false,9,10,1,42.03972,-87.69942
596,6,12,false,53,54,1,42.04822,-87.68348
E008,6,12,false,27,30,3,42.05049,-87.67782
605,6,12,false,21,19,-2,42.05294,-87.67342
661,6,12,false,13,10,-3,42.05704,-87.68657
604,6,12,false,33,21,-12,42.05824,-87.67744
E006,6,12,false,11,4,-7,42.06367,-87.69871
KA1503000002,6,12,true,11,8,-3,41.76641,-87.5657
KA1503000014,6,12,true,54,33,-21,41.7851,-87.60108
426,6,12,true,11,26,15,41.7851,-87.60108
KA1503000070,6,12,true,13,13,0,41.78794,-87.58831
TA1309000011,6,12,true,25,12,-13,41.78873,-87.60131
KA1503000071,6,12,true,25,42,17,41.79148,-87.59988
KA1503000074,6,12,true,29,25,-4,41.79174,-87.58395
424,6,12,true,5,10,5,41.79174,-87.58395
TA1309000063,6,12,true,37,33,-4,41.79325,-87.5878
420,6,12,true,20,10,-10,41.79429,-87.60145
KA1504000076,6,12,true,48,52,4,41.7943,-87.60145
247,6,12,true,22,18,-4,41.79522,-87.58077
TA1308000009,6,12,true,47,47,0,41.79522,-87.58075
TA1307000164,6,12,true,25,25,0,41.79527,-87.59647
KA1503000052,6,12,true,21,20,-1,41.79935,-87.60097
KA1503000059,6,12,true,31,23,-8,41.79952,-87.58643
TA1309000037,6,12,true,53,58,5,41.79957,-87.59474
KA1503000007,6,12,true,29,39,10,41.80242,-87.58689
13398,6,12,true,18,15,-3,41.80256,-87.59035
322,6,12,true,9,13,4,41.80321,-87.59849
TA1308000002,6,12,true,5,12,7,41.80983,-87.59937
TA1308000038,6,12,true,9,12,3,41.82298,-87.6071
13420,6,12,true,11,9,-2,41.82459,-87.61678
18022,6,12,true,11,5,-6,41.82672,-87.68315
TA1308000045,6,12,true,8,16,8,41.83062,-87.64129
TA1308000043,6,12,true,11,12,1,41.83066,-87.64715
TA1307000129,6,12,true,19,14,-5,41.83104,-87.62683
13345,6,12,true,9,19,10,41.83138,-87.61803
13216,6,12,true,48,41,-7,41.83473,-87.62581
148,6,12,true,11,14,3,41.83474,-87.62581
13217,6,12,true,17,31,14,41.83488,-87.61792
13215,6,12,true,13,5,-8,41.83634,-87.6135
TA1308000046,6,12,true,17,12,-5,41.83779,-87.65115
TA1309000055,6,12,true,29,25,-4,41.8382,-87.64514
KA1503000038,6,12,true,17,10,-7,41.83845,-87.6354
TA1307000048,6,12,true,50,49,-1,41.83855,-87.60821
150,6,12,true,16,18,2,41.83855,-87.60821
TA1308000036,6,12,true,13,13,0,41.83883,-87.62186
237,6,12,true,12,5,-7,41.84204,-87.61697
TA1307000139,6,12,true,49,27,-22,41.84205,-87.61698
TA1307000153,6,12,true,16,12,-4,41.84358,-87.64538
TA1307000005,6,12,true,21,20,-1,41.84569,-87.6225
TA1305000004,6,12,true,10,5,-5,41.8514,-87.61884
TA1305000001,6,12,true,12,20,8,41.85262,-87.6265
13075,6,12,true,37,43,6,41.8531,-87.63192
120,6,12,true,10,21,11,41.8531,-87.63191
13091,6,12,true,18,16,-2,41.85409,-87.68585
15546,6,12,true,11,12,1,41.85416,-87.61916
13307,6,12,true,13,8,-5,41.85489,-87.66359
13089,6,12,true,21,15,-6,41.85497,-87.67567
13331,6,12,true,9,17,8,41.85515,-87.65414
4,6,12,true,22,23,1,41.85627,-87.61334
15545,6,12,true,119,121,2,41.85627,-87.61334
SL-013,6,12,true,16,17,1,41.85659,-87.62755
SL-006,6,12,true,13,13,0,41.8568,-87.63387
13135,6,12,true,27,22,-5,41.85753,-87.66157
338,6,12,true,14,13,-1,41.85758,-87.61956
13102,6,12,true,71,61,-10,41.85762,-87.61942
273,6,12,true,15,10,-5,41.85783,-87.62455
13150,6,12,true,53,52,-1,41.85783,-87.62455
13099,6,12,true,14,21,7,41.85784,-87.64627
TA1307000159,6,12,true,35,24,-11,41.8579,-87.6687
TA1307000044,6,12,true,10,21,11,41.85794,-87.64083
13163,6,12,true,15,29,14,41.85808,-87.65108
13164,6,12,true,40,38,-2,41.85818,-87.65648
15,6,12,true,10,6,-4,41.85819,-87.65648
SL-012,6,12,true,43,43,0,41.86038,-87.62581
72,6,12,true,16,10,-6,41.86039,-87.62581
13304,6,12,true,7,14,7,41.86126,-87.65659
137,6,12,true,17,3,-14,41.86238,-87.65108
TA1306000002,6,12,true,45,32,-13,41.86238,-87.65108
TA1307000124,6,12,true,60,61,1,41.86411,-87.62372
168,6,12,true,15,20,5,41.86415,-87.62372
TA1309000001,6,12,true,31,25,-6,41.86488,-87.64708
13354,6,12,true,20,20,0,41.86524,-87.66651
13029,6,12,true,10,24,14,41.86531,-87.6179
341,6,12,true,22,14,-8,41.86608,-87.60733
13431,6,12,true,60,58,-2,41.8661,-87.60728
WL-008,6,12,true,45,59,14,41.86712,-87.64108
57,6,12,true,14,19,5,41.86712,-87.64107
TA1305000002,6,12,true,120,92,-28,41.86721,-87.62597
59,6,12,true,26,25,-1,41.86721,-87.62597
3,6,12,true,19,16,-3,41.86723,-87.61536
15544,6,12,true,78,95,17,41.86723,-87.61536
TA1305000017,6,12,true,15,8,-7,41.86734,-87.64863
KA1706005007,6,12,true,28,32,4,41.86749,-87.63219
SL-005,6,12,true,146,104,-42,41.8679,-87.62304
255,6,12,true,38,28,-10,41.86791,-87.62304
644,6,12,true,41,27,-14,41.86859,-87.68625
19,6,12,true,10,7,-3,41.86892,-87.65913
13139,6,12,true,25,34,9,41.86893,-87.65913
13285,6,12,true,24,31,7,41.86928,-87.67372
22,6,12,true,14,15,1,41.86947,-87.65548
13160,6,12,true,44,56,12,41.86947,-87.65548
15550,6,12,true,30,32,2,41.87024,-87.63947
TA1309000010,6,12,true,82,70,-12,41.87074,-87.62574
SL-009,6,12,true,37,28,-9,41.87081,-87.63121
342,6,12,true,5,12,7,41.87127,-87.6737
TA1309000064,6,12,true,38,37,-1,41.87127,-87.67369
TA1307000130,6,12,true,29,53,24,41.87178,-87.65103
241,6,12,true,12,5,-7,41.8718,-87.65102
108,6,12,true,15,30,15,41.87183,-87.64664
TA1307000121,6,12,true,90,72,-18,41.87184,-87.64664
41,6,12,true,16,26,10,41.87209,-87.62957
SL-008,6,12,true,85,90,5,41.87209,-87.62956
13332,6,12,true,104,98,-6,41.87219,-87.6615
175,6,12,true,11,10,-1,41.87255,-87.63359
SL-011,6,12,true,28,33,5,41.87256,-87.63356
623,6,12,true,73,52,-21,41.87272,-87.62399
KA1504000104,6,12,true,30,10,-20,41.87296,-87.66912
320,6,12,true,27,19,-8,41.87327,-87.66402
SL-007,6,12,true,26,23,-3,41.87404,-87.6277
13326,6,12,true,16,8,-8,41.87425,-87.63958
321,6,12,true,24,19,-5,41.87427,-87.63257
TA1306000025,6,12,true,46,27,-19,41.87464,-87.65703
15668,6,12,true,13,7,-6,41.87471,-87.68642
13028,6,12,true,33,30,-3,41.87475,-87.64981
89,6,12,true,15,9,-6,41.87501,-87.6331
SL-010,6,12,true,29,24,-5,41.87501,-87.63309
15541,6,12,true,41,28,-13,41.8758,-87.62086
13037,6,12,true,15,10,-5,41.87588,-87.64078
TA1305000009,6,12,true,11,9,-2,41.87593,-87.63068
TA1305000010,6,12,true,26,22,-4,41.87623,-87.62444
45,6,12,true,10,14,4,41.87623,-87.62444
624,6,12,true,22,26,4,41.87626,-87.62923
33,6,12,true,11,12,1,41.87715,-87.62786
TA1305000035,6,12,true,26,11,-15,41.87716,-87.62787
13138,6,12,true,9,14,5,41.87723,-87.63941
15539,6,12,true,83,82,-1,41.87763,-87.64405
13158,6,12,true,68,78,10,41.87764,-87.64957
134,6,12,true,12,15,3,41.87764,-87.64954
13157,6,12,true,62,49,-13,41.87773,-87.6548
21,6,12,true,15,19,4,41.87773,-87.6548
TA1305000025,6,12,true,50,53,3,41.87773,-87.63528
36,6,12,true,20,11,-9,41.87776,-87.63525
TA1309000002,6,12,true,25,34,9,41.87784,-87.62408
146,6,12,true,12,12,0,41.87794,-87.66201
13206,6,12,true,27,34,7,41.87794,-87.66201
TA1309000004,6,12,true,13,13,0,41.87811,-87.63184
107,6,12,true,17,20,3,41.87822,-87.644
638,6,12,true,26,42,16,41.87827,-87.64078
TA1305000005,6,12,true,10,13,3,41.87924,-87.62975
13011,6,12,true,25,41,16,41.87931,-87.63993
KA1503000015,6,12,true,23,29,6,41.87948,-87.6257
15667,6,12,true,9,14,5,41.8798,-87.68609
TA1309000007,6,12,true,26,9,-17,41.88022,-87.63526
WL-011,6,12,true,30,27,-3,41.88034,-87.64273
73,6,12,true,21,4,-17,41.8804,-87.64273
80,6,12,true,10,15,5,41.88042,-87.65556
13156,6,12,true,53,46,-7,41.88042,-87.65554
13300,6,12,true,142,184,42,41.88097,-87.61675
76,6,12,true,28,32,4,41.88098,-87.61675
13008,6,12,true,82,83,1,41.88105,-87.62408
90,6,12,true,11,19,8,41.88107,-87.62409
49,6,12,true,15,16,1,41.88116,-87.62963
TA1305000006,6,12,true,45,55,10,41.88122,-87.6296
13134,6,12,true,16,17,1,41.88138,-87.67493
13056,6,12,true,11,15,4,41.88168,-87.63951
198,6,12,true,18,25,7,41.88187,-87.6488
TA1307000120,6,12,true,124,151,27,41.88188,-87.64879
13341,6,12,true,31,60,29,41.88208,-87.63985
197,6,12,true,7,13,6,41.88208,-87.62513
13036,6,12,true,30,30,0,41.8821,-87.62513
77,6,12,true,22,25,3,41.88214,-87.64108
TA1305000032,6,12,true,76,86,10,41.88218,-87.64109
13006,6,12,true,24,27,3,41.88268,-87.63252
13353,6,12,true,53,55,2,41.88283,-87.6612
346,6,12,true,11,12,1,41.88284,-87.6612
654,6,12,true,48,32,-16,41.88307,-87.65698
233,6,12,true,14,11,-3,41.88309,-87.6511
13409,6,12,true,41,45,4,41.8831,-87.6511
KA1503000072,6,12,true,11,15,4,41.88317,-87.63693
WL-012,6,12,true,50,62,12,41.88337,-87.6412
112,6,12,true,23,30,7,41.88362,-87.6486
13053,6,12,true,114,128,14,41.88365,-87.64863
43,6,12,true,25,12,-13,41.88396,-87.62455
13001,6,12,true,94,70,-24,41.88397,-87.62459
13155,6,12,true,32,12,-20,41.88407,-87.65689
18062,6,12,true,51,44,-7,41.88412,-87.65427
621,6,12,true,2,15,13,41.88412,-87.65427
81,6,12,true,34,19,-15,41.88417,-87.6296
TA1306000010,6,12,true,70,89,19,41.88419,-87.62961
TA1305000030,6,12,true,29,32,3,41.88459,-87.63178
96,6,12,true,22,7,-15,41.8846,-87.64455
15535,6,12,true,76,73,-3,41.8846,-87.64455
51,6,12,true,7,10,3,41.88462,-87.63176
TA1305000029,6,12,true,66,66,0,41.88466,-87.62787
195,6,12,true,44,24,-20,41.88466,-87.61952
13263,6,12,true,64,58,-6,41.88467,-87.61952
44,6,12,true,15,18,3,41.88468,-87.62782
TA1306000015,6,12,true,72,105,33,41.88549,-87.65232
71,6,12,true,18,22,4,41.8855,-87.65233
66,6,12,true,18,10,-8,41.88557,-87.64186
13021,6,12,true,73,59,-14,41.88559,-87.64184
TA1307000111,6,12,true,35,44,9,41.88582,-87.63548
164,6,12,true,10,15,5,41.88583,-87.63547
13073,6,12,true,13,20,7,41.88592,-87.66717
KA17018054,6,12,true,10,15,5,41.88595,-87.67701
38,6,12,true,19,10,-9,41.88599,-87.63089
KA1503000012,6,12,true,60,53,-7,41.88599,-87.63089
52,6,12,true,15,18,3,41.886,-87.62421
TA1305000011,6,12,true,58,48,-10,41.886,-87.62418
7,6,12,true,12,15,3,41.88627,-87.61751
15534,6,12,true,54,57,3,41.88627,-87.61749
13197,6,12,true,31,29,-2,41.8866,-87.65816
264,6,12,true,11,7,-4,41.8867,-87.62224
TA1308000029,6,12,true,31,26,-5,41.88673,-87.62225
TA1307000131,6,12,true,24,30,6,41.88688,-87.62606
6,6,12,true,16,13,-3,41.88697,-87.61281
KA1503000064,6,12,true,73,95,22,41.88697,-87.61281
100,6,12,true,15,15,0,41.88814,-87.63657
TA1305000022,6,12,true,66,69,3,41.88817,-87.63656
56,6,12,true,42,37,-5,41.88866,-87.64442
TA1306000003,6,12,true,103,104,1,41.88867,-87.64442
KA1503000043,6,12,true,166,140,-26,41.88918,-87.63851
133,6,12,true,44,29,-15,41.88918,-87.63851
13050,6,12,true,72,87,15,41.88919,-87.62775
47,6,12,true,12,17,5,41.88921,-87.62775
15664,6,12,true,10,6,-4,41.8895,-87.68821
13432,6,12,true,13,21,8,41.88989,-87.67149
TA1307000151,6,12,true,89,102,13,41.88993,-87.63427
212,6,12,true,34,32,-2,41.88995,-87.63427
636,6,12,true,77,71,-6,41.88997,-87.63662
125,6,12,true,10,4,-6,41.89018,-87.62621
KA1503000044,6,12,true,28,41,13,41.89018,-87.6262
196,6,12,true,14,8,-6,41.89053,-87.62205
13427,6,12,true,46,43,-3,41.89054,-87.62205
26,6,12,true,21,12,-9,41.89057,-87.61798
13430,6,12,true,67,99,32,41.89077,-87.63169
181,6,12,true,20,27,7,41.89077,-87.63168
TA1306000013,6,12,true,92,99,7,41.89083,-87.61852
RN-,6,12,true,88,89,1,41.89102,-87.63546
672,6,12,true,21,29,8,41.89102,-87.63545
13434,6,12,true,35,27,-8,41.89108,-87.66663
TA1308000006,6,12,true,31,23,-8,41.89128,-87.67686
199,6,12,true,36,47,11,41.89143,-87.62676
TA1307000117,6,12,true,130,133,3,41.89144,-87.62675
13033,6,12,true,92,100,8,41.8916,-87.64835
214,6,12,true,12,6,-6,41.89161,-87.67688
84,6,12,true,23,23,0,41.89161,-87.64833
186,6,12,true,14,9,-5,41.8918,-87.65879
13194,6,12,true,81,53,-28,41.8918,-87.65878
TA1305000003,6,12,true,94,87,-7,41.89187,-87.62061
24,6,12,true,21,31,10,41.8919,-87.62063
643,6,12,true,18,29,11,41.89203,-87.68939
35,6,12,true,31,18,-13,41.89227,-87.61206
13022,6,12,true,191,216,25,41.89227,-87.61205
99,6,12,true,28,18,-10,41.89255,-87.61449
TA1306000029,6,12,true,66,81,15,41.89256,-87.61449
13265,6,12,true,98,100,2,41.89383,-87.64172
74,6,12,true,31,15,-16,41.89384,-87.64173
13045,6,12,true,148,157,9,41.89403,-87.62931
110,6,12,true,38,47,9,41.89406,-87.6293
13016,6,12,true,57,54,-3,41.89431,-87.62277
211,6,12,true,16,21,5,41.89439,-87.62267
KA1503000041,6,12,true,53,46,-7,41.89452,-87.61798
142,6,12,true,22,18,-4,41.89453,-87.61806
13196,6,12,true,54,36,-18,41.89455,-87.65345
TA1307000062,6,12,true,73,55,-18,41.89466,-87.63839
111,6,12,true,18,13,-5,41.89466,-87.63837
TA1306000012,6,12,true,140,133,-7,41.89475,-87.63438
53,6,12,true,36,31,-5,41.89476,-87.63439
627,6,12,true,14,19,5,41.8948,-87.63231
KP1705001026,6,12,true,69,75,6,41.89483,-87.6323
16920,6,12,true,16,21,5,41.89495,-87.76491
18058,6,12,true,24,28,4,41.8955,-87.68201
637,6,12,true,60,48,-12,41.89563,-87.67209
128,6,12,true,5,13,8,41.89571,-87.67716
13132,6,12,true,53,58,5,41.89573,-87.67718
161,6,12,true,15,16,1,41.89574,-87.62599
15530,6,12,true,73,71,-2,41.89575,-87.62596
18003,6,12,true,32,28,-4,41.89575,-87.62011
13247,6,12,true,37,43,6,41.89597,-87.66775
TA1305000020,6,12,true,48,54,6,41.89636,-87.65406
54,6,12,true,15,11,-4,41.89637,-87.65407
13289,6,12,true,38,46,8,41.89638,-87.661
86,6,12,true,21,19,-2,41.89639,-87.661
337,6,12,true,10,16,6,41.89659,-87.63096
13303,6,12,true,66,61,-5,41.89672,-87.63088
13017,6,12,true,53,29,-24,41.89676,-87.6357
31,6,12,true,15,13,-2,41.89677,-87.63572
13338,6,12,true,41,52,11,41.89697,-87.62173
173,6,12,true,17,6,-11,41.89704,-87.62173
TA1307000061,6,12,true,51,39,-12,41.89745,-87.62873
106,6,12,true,11,10,-1,41.89746,-87.62874
25,6,12,true,15,8,-7,41.89751,-87.62354
13034,6,12,true,56,45,-11,41.89754,-87.62352
48,6,12,true,19,13,-6,41.89772,-87.64302
TA1306000009,6,12,true,61,51,-10,41.89772,-87.64299
620,6,12,true,82,63,-19,41.89817,-87.63754
KA1504000103,6,12,true,53,21,-32,41.89842,-87.68659
374,6,12,true,16,8,-8,41.89842,-87.68659
145,6,12,true,13,29,16,41.89856,-87.62211
15529,6,12,true,65,64,-1,41.89858,-87.62206
140,6,12,true,39,53,14,41.89895,-87.6299
TA1307000128,6,12,true,115,120,5,41.89896,-87.6299
657,6,12,true,64,50,-14,41.89918,-87.6722
KA1504000117,6,12,true,12,9,-3,41.89936,-87.64848
30,6,12,true,13,10,-3,41.89964,-87.66789
13248,6,12,true,46,26,-20,41.89964,-87.66788
46,6,12,true,8,14,6,41.89994,-87.63444
TA1306000011,6,12,true,39,38,-1,41.89994,-87.63443
KA1504000116,6,12,true,30,37,7,41.90023,-87.64299
17660,6,12,true,34,33,-1,41.90036,-87.69671
622,6,12,true,3,12,9,41.90037,-87.69671
29,6,12,true,17,10,-7,41.90069,-87.66259
13290,6,12,true,50,48,-2,41.90069,-87.66259
13042,6,12,true,177,196,19,41.90097,-87.62377
85,6,12,true,25,38,13,41.90098,-87.62375
183,6,12,true,14,11,-3,41.90133,-87.67744
TA1307000070,6,12,true,39,27,-12,41.90133,-87.67742
KA1504000133,6,12,true,99,85,-14,41.90234,-87.62773
172,6,12,true,29,16,-13,41.90236,-87.62774
305,6,12,true,12,4,-8,41.9028,-87.69005
13241,6,12,true,31,24,-7,41.9029,-87.68731
176,6,12,true,48,51,3,41.90291,-87.63141
TA1306000006,6,12,true,23,26,3,41.90292,-87.63772
TA1307000039,6,12,true,234,208,-26,41.90294,-87.63137
658,6,12,true,29,26,-3,41.903,-87.6838
13256,6,12,true,28,17,-11,41.90302,-87.69749
17,6,12,true,9,18,9,41.90313,-87.67391
TA1305000034,6,12,true,46,57,11,41.90313,-87.67391
182,6,12,true,49,40,-9,41.90317,-87.63442
KA1504000135,6,12,true,183,196,13,41.90319,-87.63439
13136,6,12,true,64,74,10,41.90326,-87.67845
130,6,12,true,13,13,0,41.90327,-87.67846
210,6,12,true,28,21,-7,41.90342,-87.66781
13061,6,12,true,144,126,-18,41.90342,-87.66779
KA1504000079,6,12,true,86,84,-2,41.9035,-87.64334
359,6,12,true,25,19,-6,41.90458,-87.6497
138,6,12,true,6,10,4,41.9046,-87.64057
TA1307000115,6,12,true,26,36,10,41.9046,-87.64056
291,6,12,true,45,29,-16,41.90672,-87.63494
TA1308000049,6,12,true,122,141,19,41.90672,-87.6349
KA1504000134,6,12,true,56,56,0,41.90687,-87.6262
180,6,12,true,13,16,3,41.90687,-87.62618
13224,6,12,true,49,40,-9,41.90706,-87.66725
333,6,12,true,7,11,4,41.90706,-87.66725
18069,6,12,true,10,3,-7,41.90722,-87.65563
TA1307000143,6,12,true,27,29,2,41.90762,-87.63854
61,6,12,true,17,22,5,41.90764,-87.67254
13221,6,12,true,64,75,11,41.90765,-87.67254
13245,6,12,true,20,4,-16,41.90777,-87.68586
301,6,12,true,22,21,-1,41.90796,-87.63203
TA1309000024,6,12,true,132,129,-3,41.908,-87.63152
69,6,12,true,20,18,-2,41.90939,-87.6777
TA1305000041,6,12,true,110,122,12,41.9094,-87.67769
331,6,12,true,140,165,25,41.90965,-87.64812
15653,6,12,true,14,12,-2,41.90979,-87.7053
TA1305000037,6,12,true,52,35,-17,41.91018,-87.67003
27,6,12,true,11,7,-4,41.91019,-87.6435
TA1306000008,6,12,true,46,47,1,41.9102,-87.6435
16,6,12,true,14,14,0,41.91035,-87.67008
TA1308000005,6,12,true,57,40,-17,41.91042,-87.68238
13258,6,12,true,30,21,-9,41.91043,-87.69718
160,6,12,true,10,2,-8,41.91054,-87.68957
13257,6,12,true,25,20,-5,41.91054,-87.68956
13154,6,12,true,107,117,10,41.91054,-87.65312
20,6,12,true,20,23,3,41.91055,-87.65313
60,6,12,true,18,18,0,41.91059,-87.64942
13058,6,12,true,77,80,3,41.91059,-87.64942
118,6,12,true,15,23,8,41.91138,-87.63868
TA1307000038,6,12,true,63,112,49,41.91138,-87.63868
268,6,12,true,58,56,-2,41.91172,-87.62681
LF-005,6,12,true,248,250,2,41.91172,-87.62681
126,6,12,true,19,20,1,41.91196,-87.63197
13128,6,12,true,74,69,-5,41.91197,-87.63197
289,6,12,true,42,54,12,41.91209,-87.63472
TA1308000050,6,12,true,250,234,-16,41.91211,-87.6347
13243,6,12,true,81,70,-11,41.91262,-87.6814
158,6,12,true,10,16,6,41.91262,-87.6814
TA1309000032,6,12,true,8,17,9,41.91293,-87.66417
TA1306000032,6,12,true,104,79,-25,41.9137,-87.65285
93,6,12,true,29,24,-5,41.91371,-87.65285
224,6,12,true,24,13,-11,41.91386,-87.64877
TA1307000166,6,12,true,74,68,-6,41.91386,-87.64877
15655,6,12,true,19,14,-5,41.91401,-87.70514
18017,6,12,true,11,11,0,41.91416,-87.71676
628,6,12,true,15,15,0,41.9146,-87.66796
18067,6,12,true,36,38,2,41.9146,-87.66796
TA1306000007,6,12,true,29,37,8,41.91469,-87.64333
13068,6,12,true,47,59,12,41.91554,-87.68703
116,6,12,true,8,10,2,41.91555,-87.68703
13179,6,12,true,311,241,-70,41.9157,-87.63461
141,6,12,true,68,66,-2,41.91571,-87.63461
219,6,12,true,14,9,-5,41.91598,-87.67733
13133,6,12,true,63,58,-5,41.91598,-87.67733
58,6,12,true,14,20,6,41.91602,-87.66894
TA1305000039,6,12,true,53,76,23,41.9163,-87.66749
15651,6,12,true,26,22,-4,41.91752,-87.70181
13266,6,12,true,20,33,13,41.91774,-87.69142
TA1309000029,6,12,true,43,26,-17,41.9178,-87.68245
TA1309000006,6,12,true,87,67,-20,41.91809,-87.64375
288,6,12,true,20,12,-8,41.91809,-87.64375
223,6,12,true,11,17,6,41.91821,-87.65698
TA1307000163,6,12,true,74,57,-17,41.91821,-87.65696
94,6,12,true,42,36,-6,41.91831,-87.6363
13146,6,12,true,208,155,-53,41.91831,-87.63629
13059,6,12,true,135,159,24,41.91845,-87.65222
113,6,12,true,20,31,11,41.91846,-87.65222
13259,6,12,true,29,29,0,41.91852,-87.69744
13192,6,12,true,114,87,-27,41.91995,-87.64884
225,6,12,true,18,17,-1,41.91995,-87.64884
13288,6,12,true,36,42,6,41.92008,-87.67788
13242,6,12,true,18,23,5,41.92021,-87.69266
307,6,12,true,15,13,-2,41.92077,-87.66373
TA1309000030,6,12,true,74,68,-6,41.92077,-87.66372
290,6,12,true,11,7,-4,41.92152,-87.70734
13292,6,12,true,18,18,0,41.92152,-87.70733
TA1309000033,6,12,true,118,88,-30,41.92158,-87.65381
13193,6,12,true,140,134,-6,41.92182,-87.64412
144,6,12,true,49,39,-10,41.92182,-87.64411
143,6,12,true,15,14,-1,41.92217,-87.63891
13191,6,12,true,69,79,10,41.92217,-87.63891
327,6,12,true,11,24,13,41.92225,-87.65783
13084,6,12,true,70,47,-23,41.92268,-87.69715
123,6,12,true,9,15,6,41.92268,-87.69714
LP-,6,12,true,53,58,5,41.92396,-87.63584
673,6,12,true,14,6,-8,41.92398,-87.63585
KA1504000140,6,12,true,19,22,3,41.92409,-87.67646
15648,6,12,true,16,15,-1,41.92464,-87.68931
503,6,12,true,1,10,9,41.92483,-87.71451
KA1504000090,6,12,true,19,23,4,41.92483,-87.7145
TA1307000001,6,12,true,68,60,-8,41.92535,-87.66581
188,6,12,true,17,15,-2,41.92536,-87.66581
TA1306000026,6,12,true,77,49,-28,41.92558,-87.65842
87,6,12,true,19,14,-5,41.92559,-87.65843
TA1306000016,6,12,true,83,66,-17,41.9256,-87.65371
67,6,12,true,20,15,-5,41.9256,-87.65371
313,6,12,true,34,34,0,41.9257,-87.64246
TA1309000019,6,12,true,134,146,12,41.92586,-87.63897
TA1309000058,6,12,true,145,143,-2,41.92591,-87.64927
127,6,12,true,27,23,-4,41.92592,-87.64927
177,6,12,true,44,40,-4,41.92627,-87.63086
TA1308000001,6,12,true,189,205,16,41.92627,-87.63086
15646,6,12,true,18,19,1,41.92668,-87.6977
34,6,12,true,13,8,-5,41.92675,-87.63444
13124,6,12,true,37,43,6,41.92675,-87.63444
302,6,12,true,28,26,-2,41.92859,-87.65421
TA1309000023,6,12,true,83,80,-3,41.9287,-87.65383
TA1307000113,6,12,true,65,70,5,41.92878,-87.66391
190,6,12,true,11,12,1,41.92878,-87.6639
166,6,12,true,4,17,13,41.92883,-87.66853
13296,6,12,true,26,14,-12,41.92883,-87.66852
TA1309000059,6,12,true,61,40,-21,41.92889,-87.65898
343,6,12,true,12,6,-6,41.92889,-87.65898
349,6,12,true,18,19,1,41.92915,-87.6491
TA1309000061,6,12,true,93,99,6,41.92915,-87.64909
258,6,12,true,11,7,-4,41.92946,-87.68417
TA1308000031,6,12,true,28,36,8,41.92946,-87.68417
TA1305000014,6,12,true,148,127,-21,41.92956,-87.64313
340,6,12,true,41,32,-9,41.92956,-87.64313
260,6,12,true,19,28,9,41.92958,-87.70791
13085,6,12,true,41,58,17,41.92958,-87.70789
TA1307000142,6,12,true,120,149,29,41.93125,-87.64432
220,6,12,true,28,36,8,41.93125,-87.64431
13276,6,12,true,87,108,21,41.93132,-87.63874
324,6,12,true,20,27,7,41.93173,-87.64179
15645,6,12,true,20,15,-5,41.93191,-87.70121
163,6,12,true,6,11,5,41.93191,-87.67784
13271,6,12,true,35,28,-7,41.93192,-87.67784
152,6,12,true,29,25,-4,41.93221,-87.65864
TA1307000064,6,12,true,82,90,8,41.93222,-87.65864
TA1306000014,6,12,true,93,61,-32,41.93242,-87.65271
13,6,12,true,17,13,-4,41.93242,-87.65271
329,6,12,true,28,22,-6,41.93258,-87.63642
TA1309000039,6,12,true,113,130,17,41.93258,-87.63642
13294,6,12,true,41,25,-16,41.9326,-87.66595
TA1309000036,6,12,true,115,89,-26,41.93313,-87.64776
332,6,12,true,22,27,5,41.93313,-87.64776
TA1307000006,6,12,true,94,82,-12,41.93571,-87.6636
153,6,12,true,22,23,1,41.93575,-87.66364
13268,6,12,true,26,21,-5,41.93588,-87.67843
13269,6,12,true,58,37,-21,41.93609,-87.66983
TA1307000052,6,12,true,114,100,-14,41.93628,-87.65266
115,6,12,true,21,29,8,41.93628,-87.65266
156,6,12,true,30,23,-7,41.9365,-87.64756
TA1307000136,6,12,true,114,112,-2,41.9365,-87.64755
TA1307000041,6,12,true,151,150,-1,41.93669,-87.63683
157,6,12,true,38,42,4,41.9367,-87.63683
13137,6,12,true,175,167,-8,41.9376,-87.6441
300,6,12,true,56,38,-18,41.93761,-87.6441
15642,6,12,true,18,17,-1,41.93843,-87.69801
664,6,12,true,13,4,-9,41.93934,-87.68327
KA17018068,6,12,true,18,9,-9,41.93935,-87.68327
TA1309000042,6,12,true,62,59,-3,41.93937,-87.66836
131,6,12,true,15,21,6,41.93937,-87.66835
KA150400009X,6,12,true,13,7,-6,41.9394,-87.71159
13229,6,12,true,50,49,-1,41.93946,-87.66376
226,6,12,true,12,16,4,41.93972,-87.65886
TA1308000019,6,12,true,77,82,5,41.93973,-87.65886
13277,6,12,true,102,78,-24,41.9401,-87.64546
296,6,12,true,26,24,-2,41.9401,-87.64546
TA1307000134,6,12,true,119,180,61,41.94016,-87.65303
117,6,12,true,12,30,18,41.94016,-87.65302
13143,6,12,true,17,24,7,41.94059,-87.67853
334,6,12,true,35,30,-5,41.94076,-87.63919
TA1309000049,6,12,true,118,103,-15,41.94077,-87.63919
308,6,12,true,10,11,1,41.94152,-87.68471
15634,6,12,true,13,22,9,41.94304,-87.68729
TA1307000138,6,12,true,61,77,16,41.94334,-87.67094
230,6,12,true,13,16,3,41.94335,-87.67093
13144,6,12,true,31,32,1,41.9434,-87.67964
299,6,12,true,31,31,0,41.94368,-87.64894
TA1309000025,6,12,true,109,143,34,41.94368,-87.64894
229,6,12,true,18,18,0,41.94372,-87.66401
13071,6,12,true,123,150,27,41.94373,-87.66401
632,6,12,true,108,106,-2,41.94453,-87.6547
303,6,12,true,23,29,6,41.94522,-87.64702
15631,6,12,true,10,7,-3,41.94524,-87.70665
13278,6,12,true,107,118,11,41.94553,-87.64644
TA1309000050,6,12,true,21,18,-3,41.94618,-87.67331
15632,6,12,true,9,14,5,41.94664,-87.69463
KA1504000143,6,12,true,5,10,5,41.94664,-87.68337
227,6,12,true,20,18,-2,41.94813,-87.66397
13235,6,12,true,91,97,6,41.94814,-87.66396
304,6,12,true,35,29,-6,41.94878,-87.64922
257,6,12,true,11,8,-3,41.9488,-87.67527
13253,6,12,true,31,38,7,41.9488,-87.67527
13325,6,12,true,157,129,-28,41.94907,-87.64863
114,6,12,true,16,24,8,41.94935,-87.65451
TA1307000126,6,12,true,93,178,85,41.94936,-87.65451
232,6,12,true,33,53,20,41.94943,-87.64645
TA1307000150,6,12,true,113,109,-4,41.94945,-87.64646
13319,6,12,true,48,41,-7,41.95069,-87.6687
TA1307000127,6,12,true,51,96,45,41.9508,-87.65918
165,6,12,true,23,17,-6,41.95081,-87.65918
15628,6,12,true,10,17,7,41.95216,-87.69806
318,6,12,true,15,12,-3,41.95254,-87.6735
13323,6,12,true,88,80,-8,41.95282,-87.65
TA1309000043,6,12,true,40,45,5,41.95417,-87.66434
240,6,12,true,19,15,-4,41.95424,-87.65441
13063,6,12,true,71,81,10,41.95424,-87.65441
KA1504000158,6,12,true,17,9,-8,41.95432,-87.68607
254,6,12,true,13,13,0,41.95438,-87.64806
TA1308000022,6,12,true,81,54,-27,41.95438,-87.64805
244,6,12,true,12,12,0,41.95466,-87.67391
TA1307000149,6,12,true,32,21,-11,41.95467,-87.67392
298,6,12,true,16,20,4,41.95601,-87.68021
TA1309000026,6,12,true,38,42,4,41.95601,-87.6802
13249,6,12,true,22,16,-6,41.95606,-87.66885
312,6,12,true,17,20,3,41.95637,-87.6563
TA1308000047,6,12,true,15,19,4,41.95709,-87.6642
13379,6,12,true,72,90,18,41.95786,-87.6495
TA1309000018,6,12,true,22,25,3,41.95791,-87.67357
306,6,12,true,12,8,-4,41.9585,-87.655
TA1309000027,6,12,true,55,56,1,41.9585,-87.65499
13389,6,12,true,91,85,-6,41.961,-87.64958
245,6,12,true,18,12,-6,41.96101,-87.64958
15621,6,12,true,16,16,0,41.96103,-87.70586
15622,6,12,true,17,22,5,41.96108,-87.69544
TA1307000144,6,12,true,30,34,4,41.96142,-87.6762
297,6,12,true,10,5,-5,41.9615,-87.67141
TA1309000021,6,12,true,18,23,5,41.9615,-87.6714
15623,6,12,true,31,13,-18,41.96154,-87.69117
234,6,12,true,7,10,3,41.96158,-87.6661
KA1503000022,6,12,true,42,28,-14,41.96158,-87.66609
231,6,12,true,22,22,0,41.96163,-87.65464
TA1307000107,6,12,true,88,77,-11,41.96164,-87.65464
TA1307000156,6,12,true,50,38,-12,41.96301,-87.68479
243,6,12,true,9,10,1,41.96302,-87.68479
TA1309000012,6,12,true,19,21,2,41.96325,-87.67928
249,6,12,true,17,13,-4,41.96398,-87.63818
TA1308000012,6,12,true,87,97,10,41.96398,-87.63818
13074,6,12,true,54,43,-11,41.96521,-87.6582
639,6,12,true,93,102,9,41.96584,-87.64538
KA1504000127,6,12,true,23,16,-7,41.96587,-87.70083
KA1504000093,6,12,true,18,22,4,41.96587,-87.69365
TA1307000140,6,12,true,33,61,28,41.96643,-87.68865
239,6,12,true,10,15,5,41.9665,-87.68843
326,6,12,true,20,13,-7,41.96665,-87.67113
TA1309000014,6,12,true,63,58,-5,41.96709,-87.66744
TA1307000158,6,12,true,38,41,3,41.9671,-87.67904
251,6,12,true,14,6,-8,41.96796,-87.65
TA1307000119,6,12,true,30,41,11,41.96796,-87.65
15615,6,12,true,6,17,11,41.96835,-87.71183
TA1308000021,6,12,true,34,35,1,41.96883,-87.65765
KA1504000080,6,12,true,14,27,13,41.96887,-87.69609
TA1309000015,6,12,true,23,8,-15,41.96889,-87.68401
TA1309000066,6,12,true,66,58,-8,41.9691,-87.67423
344,6,12,true,9,17,8,41.9691,-87.67423
TA1309000041,6,12,true,32,37,5,41.96951,-87.65471
KA1504000171,6,12,true,67,42,-25,41.97161,-87.65016
465,6,12,true,11,5,-6,41.97161,-87.65016
325,6,12,true,16,12,-4,41.9728,-87.67186
TA1309000035,6,12,true,82,89,7,41.97335,-87.66785
295,6,12,true,13,13,0,41.97378,-87.65972
13108,6,12,true,66,48,-18,41.97379,-87.65971
464,6,12,true,11,7,-4,41.97562,-87.67945
KA1504000149,6,12,true,26,24,-2,41.97562,-87.67945
KA1504000146,6,12,true,69,58,-11,41.978,-87.66805
463,6,12,true,15,22,7,41.978,-87.66805
294,6,12,true,24,13,-11,41.97835,-87.65976
13109,6,12,true,43,47,4,41.97835,-87.65976
KA1504000147,6,12,true,17,17,0,41.97976,-87.67754
655,6,12,true,19,14,-5,41.97987,-87.68194
460,6,12,true,13,18,5,41.98358,-87.66916
KA1504000151,6,12,true,40,47,7,41.98359,-87.66916
459,6,12,true,30,20,-10,41.98403,-87.65231
KA1504000152,6,12,true,102,130,28,41.98403,-87.65231
15578,6,12,true,41,35,-6,41.98405,-87.66027
461,6,12,true,11,9,-2,41.98405,-87.66027
15575,6,12,true,51,59,8,41.98975,-87.66014
458,6,12,true,10,1,-9,41.98975,-87.66013
KA1504000148,6,12,true,18,10,-8,41.99086,-87.66971
15571,6,12,true,41,41,0,41.99478,-87.66028
454,6,12,true,17,12,-5,41.99478,-87.66027
KA1504000156,6,12,true,11,17,6,41.99925,-87.67137
RP-009,6,12,true,26,15,-11,42.00107,-87.66122
RP-008,6,12,true,17,11,-6,42.00446,-87.6724
660,6,12,true,21,20,-1,42.00458,-87.66143
KA1504000175,6,12,true,19,19,0,42.00797,-87.66549
447,6,12,true,10,4,-6,42.00797,-87.66548
RP-005,6,12,true,14,5,-9,42.0086,-87.69047
KA1504000162,6,12,true,16,9,-7,42.00907,-87.67422
KA1504000159,6,12,true,22,10,-12,42.01059,-87.66241
525,6,12,true,13,13,0,42.01272,-87.66605
520,6,12,true,34,26,-8,42.01597,-87.66859
515,6,12,true,10,11,1,42.01915,-87.67356
16806,6,12,true,10,13,3,42.01953,-87.66955
523,6,12,true,33,24,-9,42.02089,-87.66505
597,6,12,true,11,10,-1,42.03256,-87.67914
E002,6,12,true,25,24,-1,42.03256,-87.67912
599,6,12,true,4,14,10,42.03972,-87.69942
596,6,12,true,39,68,29,42.04822,-87.68348
E008,6,12,true,14,14,0,42.05049,-87.67782
605,6,12,true,26,30,4,42.05294,-87.67342
604,6,12,true,20,24,4,42.05824,-87.67744
E006,6,12,true,6,14,8,42.06367,-87.69871
KA1503000002,6,16,false,7,11,4,41.76641,-87.5657
KA1503000029,6,16,false,7,15,8,41.77364,-87.56747
653,6,16,false,8,11,3,41.78059,-87.58491
15491,6,16,false,28,22,-6,41.78096,-87.57624
426,6,16,false,18,21,3,41.7851,-87.60108
KA1503000014,6,16,false,31,34,3,41.7851,-87.60108
KA1503000070,6,16,false,6,13,7,41.78794,-87.58831
TA1309000011,6,16,false,10,10,0,41.78873,-87.60131
KA1503000071,6,16,false,42,25,-17,41.79148,-87.59988
KA1503000074,6,16,false,109,67,-42,41.79174,-87.58395
424,6,16,false,18,18,0,41.79174,-87.58395
TA1309000063,6,16,false,36,45,9,41.79325,-87.5878
420,6,16,false,10,13,3,41.79429,-87.60145
KA1504000076,6,16,false,21,23,2,41.7943,-87.60145
TA1307000160,6,16,false,11,5,-6,41.79485,-87.61873
247,6,16,false,19,27,8,41.79522,-87.58077
TA1308000009,6,16,false,124,139,15,41.79522,-87.58075
TA1307000164,6,16,false,22,26,4,41.79527,-87.59647
248,6,16,false,7,10,3,41.79528,-87.59647
KA1503000052,6,16,false,13,14,1,41.79935,-87.60097
419,6,16,false,5,11,6,41.79952,-87.58643
KA1503000059,6,16,false,36,44,8,41.79952,-87.58643
TA1309000037,6,16,false,51,49,-2,41.79957,-87.59474
15470,6,16,false,5,11,6,41.80228,-87.61807
417,6,16,false,9,14,5,41.80242,-87.5869
KA1503000007,6,16,false,44,45,1,41.80242,-87.58689
121,6,16,false,6,11,5,41.80256,-87.59035
13398,6,16,false,16,23,7,41.80256,-87.59035
322,6,16,false,12,27,15,41.80321,-87.59849
TA1308000035,6,16,false,15,20,5,41.80944,-87.59188
TA1308000002,6,16,false,9,13,4,41.80983,-87.59937
KA1503000065,6,16,false,10,8,-2,41.81409,-87.59701
KA1503000027,6,16,false,10,5,-5,41.81666,-87.61942
TA1308000038,6,16,false,16,24,8,41.82298,-87.6071
13420,6,16,false,7,10,3,41.82459,-87.61678
TA1308000045,6,16,false,13,11,-2,41.83062,-87.64129
KA1503000005,6,16,false,17,16,-1,41.83079,-87.6325
TA1307000129,6,16,false,22,19,-3,41.83104,-87.62683
KA1503000004,6,16,false,26,40,14,41.83127,-87.6088
13345,6,16,false,15,5,-10,41.83138,-87.61803
15445,6,16,false,20,17,-3,41.83453,-87.63183
13216,6,16,false,17,10,-7,41.83473,-87.62581
13215,6,16,false,14,21,7,41.83634,-87.6135
263,6,16,false,3,10,7,41.8364,-87.61348
TA1308000046,6,16,false,14,15,1,41.83779,-87.65115
TA1309000055,6,16,false,10,15,5,41.8382,-87.64514
TA1307000048,6,16,false,128,131,3,41.83855,-87.60821
150,6,16,false,13,36,23,41.83855,-87.60821
TA1307000139,6,16,false,9,15,6,41.84205,-87.61698
15443,6,16,false,2,14,12,41.84275,-87.63549
TA1307000153,6,16,false,10,8,-2,41.84358,-87.64538
TA1308000013,6,16,false,10,8,-2,41.84719,-87.64681
TA1308000026,6,16,false,20,20,0,41.85008,-87.63214
TA1305000004,6,16,false,21,48,27,41.8514,-87.61884
TA1305000001,6,16,false,31,27,-4,41.85262,-87.6265
13075,6,16,false,94,118,24,41.8531,-87.63192
120,6,16,false,12,17,5,41.8531,-87.63191
13162,6,16,false,12,13,1,41.85378,-87.64659
13096,6,16,false,10,13,3,41.8538,-87.69577
15546,6,16,false,26,36,10,41.85416,-87.61916
13307,6,16,false,18,15,-3,41.85489,-87.66359
13089,6,16,false,10,22,12,41.85497,-87.67567
13331,6,16,false,8,19,11,41.85515,-87.65414
15545,6,16,false,120,109,-11,41.85627,-87.61334
4,6,16,false,26,21,-5,41.85627,-87.61334
SL-013,6,16,false,18,22,4,41.85659,-87.62755
SL-006,6,16,false,22,30,8,41.8568,-87.63387
13135,6,16,false,30,17,-13,41.85753,-87.66157
338,6,16,false,16,13,-3,41.85758,-87.61956
13102,6,16,false,64,70,6,41.85762,-87.61942
13150,6,16,false,40,36,-4,41.85783,-87.62455
273,6,16,false,7,11,4,41.85783,-87.62455
13099,6,16,false,17,12,-5,41.85784,-87.64627
TA1307000159,6,16,false,22,17,-5,41.8579,-87.6687
TA1307000044,6,16,false,25,16,-9,41.85794,-87.64083
13163,6,16,false,19,39,20,41.85808,-87.65108
13164,6,16,false,30,46,16,41.85818,-87.65648
SL-012,6,16,false,51,38,-13,41.86038,-87.62581
72,6,16,false,8,15,7,41.86039,-87.62581
13304,6,16,false,3,12,9,41.86126,-87.65659
KA1504000109,6,16,false,11,16,5,41.86192,-87.69347
TA1306000002,6,16,false,7,12,5,41.86238,-87.65108
TA1307000124,6,16,false,80,73,-7,41.86411,-87.62372
168,6,16,false,6,18,12,41.86415,-87.62372
282,6,16,false,7,15,8,41.86487,-87.64708
TA1309000001,6,16,false,32,25,-7,41.86488,-87.64708
13029,6,16,false,155,104,-51,41.86531,-87.6179
97,6,16,false,24,14,-10,41.86531,-87.6179
341,6,16,false,70,52,-18,41.86608,-87.60733
13431,6,16,false,183,221,38,41.8661,-87.60728
WL-008,6,16,false,47,26,-21,41.86712,-87.64108
TA1305000002,6,16,false,122,92,-30,41.86721,-87.62597
59,6,16,false,19,31,12,41.86721,-87.62597
15544,6,16,false,424,311,-113,41.86723,-87.61536
3,6,16,false,70,38,-32,41.86723,-87.61536
TA1305000017,6,16,false,12,7,-5,41.86734,-87.64863
626,6,16,false,8,10,2,41.86749,-87.63219
KA1706005007,6,16,false,26,37,11,41.86749,-87.63219
SL-005,6,16,false,266,210,-56,41.8679,-87.62304
255,6,16,false,65,64,-1,41.86791,-87.62304
644,6,16,false,11,8,-3,41.86859,-87.68625
13139,6,16,false,16,35,19,41.86893,-87.65913
13285,6,16,false,16,5,-11,41.86928,-87.67372
22,6,16,false,4,10,6,41.86947,-87.65548
13160,6,16,false,14,22,8,41.86947,-87.65548
15550,6,16,false,25,10,-15,41.87024,-87.63947
TA1309000010,6,16,false,74,103,29,41.87074,-87.62574
SL-009,6,16,false,30,40,10,41.87081,-87.63121
TA1309000064,6,16,false,11,11,0,41.87127,-87.67369
15542,6,16,false,13,5,-8,41.87146,-87.64095
TA1307000130,6,16,false,10,25,15,41.87178,-87.65103
TA1307000121,6,16,false,15,3,-12,41.87184,-87.64664
41,6,16,false,15,29,14,41.87209,-87.62957
SL-008,6,16,false,124,112,-12,41.87209,-87.62956
13332,6,16,false,28,38,10,41.87219,-87.6615
175,6,16,false,16,20,4,41.87255,-87.63359
SL-011,6,16,false,46,69,23,41.87256,-87.63356
623,6,16,false,227,198,-29,41.87272,-87.62399
KA1504000104,6,16,false,11,4,-7,41.87296,-87.66912
SL-007,6,16,false,38,32,-6,41.87404,-87.6277
13326,6,16,false,15,8,-7,41.87425,-87.63958
321,6,16,false,12,24,12,41.87427,-87.63257
TA1306000025,6,16,false,14,17,3,41.87464,-87.65703
13028,6,16,false,28,20,-8,41.87475,-87.64981
13081,6,16,false,2,11,9,41.87501,-87.67326
SL-010,6,16,false,13,18,5,41.87501,-87.63309
15541,6,16,false,207,161,-46,41.8758,-87.62086
TA1305000009,6,16,false,17,17,0,41.87593,-87.63068
TA1305000010,6,16,false,68,51,-17,41.87623,-87.62444
624,6,16,false,32,38,6,41.87626,-87.62923
2,6,16,false,38,29,-9,41.87649,-87.62051
33,6,16,false,11,15,4,41.87715,-87.62786
TA1305000035,6,16,false,43,38,-5,41.87716,-87.62787
13138,6,16,false,15,16,1,41.87723,-87.63941
15539,6,16,false,40,51,11,41.87763,-87.64405
13158,6,16,false,45,38,-7,41.87764,-87.64957
134,6,16,false,11,18,7,41.87764,-87.64954
21,6,16,false,3,15,12,41.87773,-87.6548
13157,6,16,false,33,48,15,41.87773,-87.6548
TA1305000025,6,16,false,67,86,19,41.87773,-87.63528
36,6,16,false,13,10,-3,41.87776,-87.63525
284,6,16,false,15,12,-3,41.87784,-87.62408
TA1309000002,6,16,false,120,121,1,41.87784,-87.62408
13206,6,16,false,21,24,3,41.87794,-87.66201
283,6,16,false,13,5,-8,41.87809,-87.63183
TA1309000004,6,16,false,24,13,-11,41.87811,-87.63184
638,6,16,false,43,38,-5,41.87827,-87.64078
TA1305000005,6,16,false,42,36,-6,41.87924,-87.62975
13011,6,16,false,49,46,-3,41.87931,-87.63993
TA1309000008,6,16,false,50,55,5,41.87933,-87.6355
192,6,16,false,10,11,1,41.87935,-87.63997
KA1503000034,6,16,false,28,39,11,41.87938,-87.63197
39,6,16,false,12,10,-2,41.87948,-87.62571
KA1503000015,6,16,false,57,80,23,41.87948,-87.6257
15667,6,16,false,11,9,-2,41.8798,-87.68609
TA1309000007,6,16,false,35,29,-6,41.88022,-87.63526
WL-011,6,16,false,37,34,-3,41.88034,-87.64273
13156,6,16,false,60,39,-21,41.88042,-87.65554
13300,6,16,false,724,754,30,41.88097,-87.61675
76,6,16,false,179,181,2,41.88098,-87.61675
13008,6,16,false,656,619,-37,41.88105,-87.62408
90,6,16,false,82,129,47,41.88107,-87.62409
49,6,16,false,13,5,-8,41.88116,-87.62963
TA1305000006,6,16,false,63,83,20,41.88122,-87.6296
13134,6,16,false,25,26,1,41.88138,-87.67493
13056,6,16,false,20,36,16,41.88168,-87.63951
198,6,16,false,17,21,4,41.88187,-87.6488
TA1307000120,6,16,false,138,136,-2,41.88188,-87.64879
13341,6,16,false,39,56,17,41.88208,-87.63985
197,6,16,false,10,28,18,41.88208,-87.62513
13036,6,16,false,69,79,10,41.8821,-87.62513
77,6,16,false,9,14,5,41.88214,-87.64108
TA1305000032,6,16,false,66,62,-4,41.88218,-87.64109
13006,6,16,false,26,39,13,41.88268,-87.63252
13353,6,16,false,51,43,-8,41.88283,-87.6612
654,6,16,false,26,17,-9,41.88307,-87.65698
233,6,16,false,6,10,4,41.88309,-87.6511
13409,6,16,false,43,52,9,41.8831,-87.6511
KA1503000072,6,16,false,24,18,-6,41.88317,-87.63693
WL-012,6,16,false,45,47,2,41.88337,-87.6412
112,6,16,false,32,28,-4,41.88362,-87.6486
13053,6,16,false,133,168,35,41.88365,-87.64863
43,6,16,false,68,64,-4,41.88396,-87.62455
13001,6,16,false,198,254,56,41.88397,-87.62459
13155,6,16,false,21,11,-10,41.88407,-87.65689
621,6,16,false,10,7,-3,41.88412,-87.65427
18062,6,16,false,24,32,8,41.88412,-87.65427
81,6,16,false,18,28,10,41.88417,-87.6296
TA1306000010,6,16,false,63,49,-14,41.88419,-87.62961
TA1305000030,6,16,false,59,45,-14,41.88459,-87.63178
15535,6,16,false,78,71,-7,41.8846,-87.64455
TA1305000029,6,16,false,129,158,29,41.88466,-87.62787
195,6,16,false,21,36,15,41.88466,-87.61952
13263,6,16,false,161,141,-20,41.88467,-87.61952
44,6,16,false,30,39,9,41.88468,-87.62782
TA1306000015,6,16,false,131,133,2,41.88549,-87.65232
518,6,16,false,10,7,-3,41.8855,-87.71686
71,6,16,false,23,25,2,41.8855,-87.65233
66,6,16,false,14,6,-8,41.88557,-87.64186
13021,6,16,false,45,56,11,41.88559,-87.64184
TA1307000111,6,16,false,75,57,-18,41.88582,-87.63548
13073,6,16,false,31,59,28,41.88592,-87.66717
KA17018054,6,16,false,19,25,6,41.88595,-87.67701
38,6,16,false,24,20,-4,41.88599,-87.63089
KA1503000012,6,16,false,86,93,7,41.88599,-87.63089
52,6,16,false,72,49,-23,41.886,-87.62421
TA1305000011,6,16,false,198,202,4,41.886,-87.62418
7,6,16,false,14,13,-1,41.88627,-87.61751
15534,6,16,false,71,97,26,41.88627,-87.61749
13197,6,16,false,14,24,10,41.8866,-87.65816
264,6,16,false,7,12,5,41.8867,-87.62224
TA1308000029,6,16,false,77,79,2,41.88673,-87.62225
194,6,16,false,34,30,-4,41.88688,-87.62606
TA1307000131,6,16,false,170,184,14,41.88688,-87.62606
KA1503000064,6,16,false,331,316,-15,41.88697,-87.61281
6,6,16,false,56,60,4,41.88697,-87.61281
TA1305000022,6,16,false,36,47,11,41.88817,-87.63656
56,6,16,false,27,24,-3,41.88866,-87.64442
TA1306000003,6,16,false,100,124,24,41.88867,-87.64442
133,6,16,false,19,20,1,41.88918,-87.63851
KA1503000043,6,16,false,87,121,34,41.88918,-87.63851
13050,6,16,false,158,181,23,41.88919,-87.62775
47,6,16,false,11,26,15,41.88921,-87.62775
13432,6,16,false,32,29,-3,41.88989,-87.67149
TA1307000151,6,16,false,114,117,3,41.88993,-87.63427
212,6,16,false,22,17,-5,41.88995,-87.63427
636,6,16,false,33,43,10,41.88997,-87.63662
125,6,16,false,5,10,5,41.89018,-87.62621
KA1503000044,6,16,false,29,46,17,41.89018,-87.6262
196,6,16,false,19,21,2,41.89053,-87.62205
13427,6,16,false,64,85,21,41.89054,-87.62205
26,6,16,false,23,38,15,41.89057,-87.61798
13430,6,16,false,170,214,44,41.89077,-87.63169
181,6,16,false,21,29,8,41.89077,-87.63168
TA1306000013,6,16,false,210,194,-16,41.89083,-87.61852
RN-,6,16,false,84,90,6,41.89102,-87.63546
672,6,16,false,11,16,5,41.89102,-87.63545
277,6,16,false,6,13,7,41.89108,-87.66665
13434,6,16,false,41,57,16,41.89108,-87.66663
TA1308000006,6,16,false,29,30,1,41.89128,-87.67686
199,6,16,false,29,48,19,41.89143,-87.62676
TA1307000117,6,16,false,283,296,13,41.89144,-87.62675
13033,6,16,false,74,111,37,41.8916,-87.64835
84,6,16,false,12,12,0,41.89161,-87.64833
186,6,16,false,11,13,2,41.8918,-87.65879
13194,6,16,false,28,42,14,41.8918,-87.65878
TA1305000003,6,16,false,200,156,-44,41.89187,-87.62061
24,6,16,false,31,34,3,41.8919,-87.62063
643,6,16,false,13,12,-1,41.89203,-87.68939
35,6,16,false,119,176,57,41.89227,-87.61206
13022,6,16,false,1501,1468,-33,41.89227,-87.61205
99,6,16,false,19,37,18,41.89255,-87.61449
TA1306000029,6,16,false,188,235,47,41.89256,-87.61449
13265,6,16,false,50,77,27,41.89383,-87.64172
74,6,16,false,8,15,7,41.89384,-87.64173
13045,6,16,false,137,152,15,41.89403,-87.62931
110,6,16,false,26,39,13,41.89406,-87.6293
13016,6,16,false,70,128,58,41.89431,-87.62277
211,6,16,false,16,19,3,41.89439,-87.62267
KA1503000041,6,16,false,58,85,27,41.89452,-87.61798
142,6,16,false,7,18,11,41.89453,-87.61806
13196,6,16,false,33,53,20,41.89455,-87.65345
TA1307000062,6,16,false,27,25,-2,41.89466,-87.63839
111,6,16,false,12,20,8,41.89466,-87.63837
TA1306000012,6,16,false,133,138,5,41.89475,-87.63438
53,6,16,false,18,39,21,41.89476,-87.63439
627,6,16,false,25,19,-6,41.8948,-87.63231
KP1705001026,6,16,false,61,75,14,41.89483,-87.6323
18058,6,16,false,21,32,11,41.8955,-87.68201
637,6,16,false,39,40,1,41.89563,-87.67209
13132,6,16,false,60,59,-1,41.89573,-87.67718
161,6,16,false,15,22,7,41.89574,-87.62599
15530,6,16,false,109,134,25,41.89575,-87.62596
18003,6,16,false,44,51,7,41.89575,-87.62011
13247,6,16,false,35,45,10,41.89597,-87.66775
TA1305000020,6,16,false,46,62,16,41.89636,-87.65406
13289,6,16,false,33,46,13,41.89638,-87.661
337,6,16,false,7,16,9,41.89659,-87.63096
13303,6,16,false,57,89,32,41.89672,-87.63088
13017,6,16,false,39,61,22,41.89676,-87.6357
31,6,16,false,10,8,-2,41.89677,-87.63572
13338,6,16,false,92,111,19,41.89697,-87.62173
173,6,16,false,18,19,1,41.89704,-87.62173
TA1307000061,6,16,false,47,74,27,41.89745,-87.62873
106,6,16,false,10,14,4,41.89746,-87.62874
25,6,16,false,32,52,20,41.89751,-87.62354
13034,6,16,false,152,173,21,41.89754,-87.62352
TA1306000009,6,16,false,32,42,10,41.89772,-87.64299
620,6,16,false,50,54,4,41.89817,-87.63754
374,6,16,false,7,11,4,41.89842,-87.68659
KA1504000103,6,16,false,14,26,12,41.89842,-87.68659
145,6,16,false,18,32,14,41.89856,-87.62211
15529,6,16,false,141,110,-31,41.89858,-87.62206
140,6,16,false,25,25,0,41.89895,-87.6299
TA1307000128,6,16,false,116,120,4,41.89896,-87.6299
657,6,16,false,44,35,-9,41.89918,-87.6722
KA1504000117,6,16,false,11,11,0,41.89936,-87.64848
13248,6,16,false,38,22,-16,41.89964,-87.66788
TA1306000011,6,16,false,46,49,3,41.89994,-87.63443
KA1504000116,6,16,false,18,18,0,41.90023,-87.64299
17660,6,16,false,33,35,2,41.90036,-87.69671
13290,6,16,false,60,45,-15,41.90069,-87.66259
29,6,16,false,9,13,4,41.90069,-87.66259
13042,6,16,false,747,658,-89,41.90097,-87.62377
85,6,16,false,93,95,2,41.90098,-87.62375
183,6,16,false,11,8,-3,41.90133,-87.67744
TA1307000070,6,16,false,34,47,13,41.90133,-87.67742
KA1504000133,6,16,false,150,142,-8,41.90234,-87.62773
172,6,16,false,17,26,9,41.90236,-87.62774
15654,6,16,false,23,13,-10,41.90271,-87.70923
305,6,16,false,7,10,3,41.9028,-87.69005
13241,6,16,false,23,37,14,41.9029,-87.68731
176,6,16,false,32,52,20,41.90291,-87.63141
TA1306000006,6,16,false,19,24,5,41.90292,-87.63772
TA1307000039,6,16,false,181,222,41,41.90294,-87.63137
658,6,16,false,23,24,1,41.903,-87.6838
13256,6,16,false,26,27,1,41.90302,-87.69749
216,6,16,false,3,10,7,41.90302,-87.69749
17,6,16,false,12,5,-7,41.90313,-87.67391
TA1305000034,6,16,false,72,70,-2,41.90313,-87.67391
182,6,16,false,30,23,-7,41.90317,-87.63442
KA1504000135,6,16,false,198,216,18,41.90319,-87.63439
13136,6,16,false,43,57,14,41.90326,-87.67845
130,6,16,false,10,7,-3,41.90327,-87.67846
210,6,16,false,22,24,2,41.90342,-87.66781
13061,6,16,false,128,144,16,41.90342,-87.66779
KA1504000079,6,16,false,73,52,-21,41.9035,-87.64334
359,6,16,false,14,18,4,41.90458,-87.6497
TA1307000115,6,16,false,35,22,-13,41.9046,-87.64056
291,6,16,false,24,34,10,41.90672,-87.63494
TA1308000049,6,16,false,190,177,-13,41.90672,-87.6349
KA1504000134,6,16,false,94,94,0,41.90687,-87.6262
180,6,16,false,8,17,9,41.90687,-87.62618
13224,6,16,false,57,62,5,41.90706,-87.66725
333,6,16,false,4,10,6,41.90706,-87.66725
TA1307000143,6,16,false,29,29,0,41.90762,-87.63854
61,6,16,false,13,20,7,41.90764,-87.67254
13221,6,16,false,88,97,9,41.90765,-87.67254
13245,6,16,false,14,11,-3,41.90777,-87.68586
301,6,16,false,18,5,-13,41.90796,-87.63203
TA1309000024,6,16,false,122,117,-5,41.908,-87.63152
69,6,16,false,12,28,16,41.90939,-87.6777
TA1305000041,6,16,false,157,165,8,41.9094,-87.67769
15652,6,16,false,10,8,-2,41.90965,-87.71664
331,6,16,false,130,129,-1,41.90965,-87.64812
15653,6,16,false,15,31,16,41.90979,-87.7053
TA1305000037,6,16,false,50,54,4,41.91018,-87.67003
TA1306000008,6,16,false,42,45,3,41.9102,-87.6435
16,6,16,false,10,11,1,41.91035,-87.67008
TA1308000005,6,16,false,31,42,11,41.91042,-87.68238
276,6,16,false,10,8,-2,41.91043,-87.69718
13258,6,16,false,31,37,6,41.91043,-87.69718
13257,6,16,false,48,33,-15,41.91054,-87.68956
13154,6,16,false,62,75,13,41.91054,-87.65312
13058,6,16,false,58,65,7,41.91059,-87.64942
TA1307000038,6,16,false,97,86,-11,41.91138,-87.63868
118,6,16,false,11,8,-3,41.91138,-87.63868
LF-005,6,16,false,934,744,-190,41.91172,-87.62681
268,6,16,false,53,75,22,41.91172,-87.62681
126,6,16,false,31,34,3,41.91196,-87.63197
13128,6,16,false,171,135,-36,41.91197,-87.63197
289,6,16,false,37,44,7,41.91209,-87.63472
TA1308000050,6,16,false,306,259,-47,41.91211,-87.6347
13243,6,16,false,82,84,2,41.91262,-87.6814
158,6,16,false,15,24,9,41.91262,-87.6814
TA1309000032,6,16,false,17,14,-3,41.91293,-87.66417
TA1306000032,6,16,false,68,82,14,41.9137,-87.65285
93,6,16,false,12,6,-6,41.91371,-87.65285
TA1307000166,6,16,false,56,77,21,41.91386,-87.64877
15655,6,16,false,26,35,9,41.91401,-87.70514
18017,6,16,false,34,21,-13,41.91416,-87.71676
18067,6,16,false,32,37,5,41.9146,-87.66796
TA1306000007,6,16,false,26,36,10,41.91469,-87.64333
13068,6,16,false,59,68,9,41.91554,-87.68703
13179,6,16,false,341,295,-46,41.9157,-87.63461
141,6,16,false,22,51,29,41.91571,-87.63461
219,6,16,false,9,12,3,41.91598,-87.67733
13133,6,16,false,80,98,18,41.91598,-87.67733
TA1305000039,6,16,false,38,42,4,41.9163,-87.66749
15650,6,16,false,23,32,9,41.91711,-87.71023
15651,6,16,false,59,52,-7,41.91752,-87.70181
507,6,16,false,6,11,5,41.91752,-87.70181
13266,6,16,false,31,38,7,41.91774,-87.69142
TA1309000029,6,16,false,42,52,10,41.9178,-87.68245
288,6,16,false,9,13,4,41.91809,-87.64375
TA1309000006,6,16,false,75,82,7,41.91809,-87.64375
TA1307000163,6,16,false,62,48,-14,41.91821,-87.65696
94,6,16,false,72,50,-22,41.91831,-87.6363
13146,6,16,false,313,258,-55,41.91831,-87.63629
13059,6,16,false,128,158,30,41.91845,-87.65222
113,6,16,false,27,30,3,41.91846,-87.65222
13259,6,16,false,32,27,-5,41.91852,-87.69744
225,6,16,false,17,16,-1,41.91995,-87.64884
13192,6,16,false,107,141,34,41.91995,-87.64884
13288,6,16,false,30,54,24,41.92008,-87.67788
13242,6,16,false,61,43,-18,41.92021,-87.69266
307,6,16,false,11,8,-3,41.92077,-87.66373
TA1309000030,6,16,false,51,48,-3,41.92077,-87.66372
13292,6,16,false,19,35,16,41.92152,-87.70733
TA1309000033,6,16,false,99,128,29,41.92158,-87.65381
13193,6,16,false,185,171,-14,41.92182,-87.64412
144,6,16,false,35,18,-17,41.92182,-87.64411
143,6,16,false,10,14,4,41.92217,-87.63891
13191,6,16,false,90,105,15,41.92217,-87.63891
327,6,16,false,18,31,13,41.92225,-87.65783
13084,6,16,false,86,70,-16,41.92268,-87.69715
123,6,16,false,13,13,0,41.92268,-87.69714
LP-,6,16,false,207,166,-41,41.92396,-87.63584
673,6,16,false,20,25,5,41.92398,-87.63585
KA1504000140,6,16,false,17,30,13,41.92409,-87.67646
15648,6,16,false,25,22,-3,41.92464,-87.68931
503,6,16,false,1,10,9,41.92483,-87.71451
KA1504000090,6,16,false,26,22,-4,41.92483,-87.7145
TA1307000001,6,16,false,65,94,29,41.92535,-87.66581
TA1306000026,6,16,false,49,49,0,41.92558,-87.65842
TA1306000016,6,16,false,62,59,-3,41.9256,-87.65371
67,6,16,false,10,17,7,41.9256,-87.65371
313,6,16,false,31,26,-5,41.9257,-87.64246
TA1309000019,6,16,false,163,166,3,41.92586,-87.63897
TA1309000058,6,16,false,151,182,31,41.92591,-87.64927
127,6,16,false,23,24,1,41.92592,-87.64927
TA1308000001,6,16,false,614,522,-92,41.92627,-87.63086
177,6,16,false,114,123,9,41.92627,-87.63086
15646,6,16,false,28,28,0,41.92668,-87.6977
13124,6,16,false,136,89,-47,41.92675,-87.63444
34,6,16,false,20,22,2,41.92675,-87.63444
302,6,16,false,16,19,3,41.92859,-87.65421
TA1309000023,6,16,false,102,111,9,41.9287,-87.65383
TA1307000113,6,16,false,67,96,29,41.92878,-87.66391
190,6,16,false,22,10,-12,41.92878,-87.6639
13296,6,16,false,40,63,23,41.92883,-87.66852
TA1309000059,6,16,false,42,63,21,41.92889,-87.65898
349,6,16,false,15,13,-2,41.92915,-87.6491
TA1309000061,6,16,false,90,131,41,41.92915,-87.64909
TA1308000031,6,16,false,32,45,13,41.92946,-87.68417
TA1305000014,6,16,false,135,139,4,41.92956,-87.64313
340,6,16,false,18,26,8,41.92956,-87.64313
260,6,16,false,18,14,-4,41.92958,-87.70791
13085,6,16,false,54,83,29,41.92958,-87.70789
15643,6,16,false,15,17,2,41.93057,-87.7238
TA1307000142,6,16,false,132,155,23,41.93125,-87.64432
220,6,16,false,17,20,3,41.93125,-87.64431
13276,6,16,false,134,126,-8,41.93132,-87.63874
324,6,16,false,18,19,1,41.93173,-87.64179
15645,6,16,false,9,19,10,41.93191,-87.70121
13271,6,16,false,33,31,-2,41.93192,-87.67784
152,6,16,false,5,16,11,41.93221,-87.65864
TA1307000064,6,16,false,72,116,44,41.93222,-87.65864
13,6,16,false,12,12,0,41.93242,-87.65271
TA1306000014,6,16,false,78,133,55,41.93242,-87.65271
TA1309000039,6,16,false,250,221,-29,41.93258,-87.63642
329,6,16,false,23,23,0,41.93258,-87.63642
13294,6,16,false,38,50,12,41.9326,-87.66595
TA1309000036,6,16,false,76,97,21,41.93313,-87.64776
15644,6,16,false,13,11,-2,41.93534,-87.71687
TA1307000006,6,16,false,75,108,33,41.93571,-87.6636
153,6,16,false,12,7,-5,41.93575,-87.66364
13268,6,16,false,19,39,20,41.93588,-87.67843
13269,6,16,false,18,35,17,41.93609,-87.66983
115,6,16,false,3,18,15,41.93628,-87.65266
TA1307000052,6,16,false,82,130,48,41.93628,-87.65266
156,6,16,false,9,18,9,41.9365,-87.64756
TA1307000136,6,16,false,104,136,32,41.9365,-87.64755
TA1307000041,6,16,false,217,219,2,41.93669,-87.63683
157,6,16,false,29,34,5,41.9367,-87.63683
13137,6,16,false,155,186,31,41.9376,-87.6441
300,6,16,false,30,44,14,41.93761,-87.6441
15642,6,16,false,19,37,18,41.93843,-87.69801
154,6,16,false,15,10,-5,41.93912,-87.66384
KA17018068,6,16,false,22,32,10,41.93935,-87.68327
TA1309000042,6,16,false,58,60,2,41.93937,-87.66836
KA150400009X,6,16,false,6,11,5,41.9394,-87.71159
15640,6,16,false,5,10,5,41.93941,-87.72357
13229,6,16,false,68,76,8,41.93946,-87.66376
226,6,16,false,14,14,0,41.93972,-87.65886
TA1308000019,6,16,false,115,114,-1,41.93973,-87.65886
296,6,16,false,13,16,3,41.9401,-87.64546
13277,6,16,false,117,129,12,41.9401,-87.64546
TA1307000134,6,16,false,195,223,28,41.94016,-87.65303
117,6,16,false,12,30,18,41.94016,-87.65302
13143,6,16,false,19,33,14,41.94059,-87.67853
334,6,16,false,32,46,14,41.94076,-87.63919
TA1309000049,6,16,false,236,241,5,41.94077,-87.63919
15634,6,16,false,12,16,4,41.94304,-87.68729
TA1307000138,6,16,false,73,76,3,41.94334,-87.67094
230,6,16,false,3,12,9,41.94335,-87.67093
13144,6,16,false,43,45,2,41.9434,-87.67964
TA1309000025,6,16,false,155,143,-12,41.94368,-87.64894
299,6,16,false,12,23,11,41.94368,-87.64894
229,6,16,false,18,23,5,41.94372,-87.66401
13071,6,16,false,125,134,9,41.94373,-87.66401
632,6,16,false,309,262,-47,41.94453,-87.6547
303,6,16,false,8,12,4,41.94522,-87.64702
15631,6,16,false,11,18,7,41.94524,-87.70665
13278,6,16,false,110,154,44,41.94553,-87.64644
TA1309000050,6,16,false,29,17,-12,41.94618,-87.67331
15632,6,16,false,10,5,-5,41.94664,-87.69463
KA1504000143,6,16,false,11,10,-1,41.94664,-87.68337
227,6,16,false,14,19,5,41.94813,-87.66397
13235,6,16,false,115,98,-17,41.94814,-87.66396
13253,6,16,false,32,28,-4,41.9488,-87.67527
13325,6,16,false,120,102,-18,41.94907,-87.64863
114,6,16,false,18,24,6,41.94935,-87.65451
TA1307000126,6,16,false,318,178,-140,41.94936,-87.65451
232,6,16,false,22,42,20,41.94943,-87.64645
TA1307000150,6,16,false,127,146,19,41.94945,-87.64646
13319,6,16,false,41,49,8,41.95069,-87.6687
TA1307000127,6,16,false,210,136,-74,41.9508,-87.65918
165,6,16,false,13,23,10,41.95081,-87.65918
15628,6,16,false,4,19,15,41.95216,-87.69806
256,6,16,false,6,10,4,41.95282,-87.65
13323,6,16,false,62,76,14,41.95282,-87.65
15624,6,16,false,8,11,3,41.95339,-87.73199
KA1504000096,6,16,false,11,4,-7,41.95361,-87.70932
TA1309000043,6,16,false,34,48,14,41.95417,-87.66434
13063,6,16,false,67,80,13,41.95424,-87.65441
KA1504000158,6,16,false,4,18,14,41.95432,-87.68607
254,6,16,false,8,20,12,41.95438,-87.64806
TA1308000022,6,16,false,102,122,20,41.95438,-87.64805
TA1307000149,6,16,false,33,24,-9,41.95467,-87.67392
TA1309000026,6,16,false,24,31,7,41.95601,-87.6802
13249,6,16,false,21,20,-1,41.95606,-87.66885
312,6,16,false,10,8,-2,41.95637,-87.6563
TA1308000047,6,16,false,12,12,0,41.95709,-87.6642
13379,6,16,false,66,54,-12,41.95786,-87.6495
TA1309000018,6,16,false,21,14,-7,41.95791,-87.67357
TA1309000027,6,16,false,46,45,-1,41.9585,-87.65499
13389,6,16,false,76,54,-22,41.961,-87.64958
245,6,16,false,14,16,2,41.96101,-87.64958
15621,6,16,false,8,13,5,41.96103,-87.70586
15622,6,16,false,19,15,-4,41.96108,-87.69544
TA1307000144,6,16,false,18,31,13,41.96142,-87.6762
TA1309000021,6,16,false,17,27,10,41.9615,-87.6714
KA1503000022,6,16,false,23,43,20,41.96158,-87.66609
231,6,16,false,19,8,-11,41.96163,-87.65464
TA1307000107,6,16,false,67,101,34,41.96164,-87.65464
TA1307000156,6,16,false,28,23,-5,41.96301,-87.68479
TA1309000012,6,16,false,16,12,-4,41.96325,-87.67928
TA1308000012,6,16,false,353,272,-81,41.96398,-87.63818
249,6,16,false,25,30,5,41.96398,-87.63818
293,6,16,false,2,10,8,41.96521,-87.65822
13074,6,16,false,44,49,5,41.96521,-87.6582
639,6,16,false,132,108,-24,41.96584,-87.64538
KA1504000093,6,16,false,8,13,5,41.96587,-87.69365
TA1307000140,6,16,false,25,26,1,41.96643,-87.68865
239,6,16,false,1,10,9,41.9665,-87.68843
TA1309000014,6,16,false,53,49,-4,41.96709,-87.66744
TA1307000158,6,16,false,24,27,3,41.9671,-87.67904
TA1307000119,6,16,false,36,31,-5,41.96796,-87.65
323,6,16,false,10,8,-2,41.96869,-87.66034
TA1308000021,6,16,false,33,50,17,41.96883,-87.65765
KA1504000080,6,16,false,18,17,-1,41.96887,-87.69609
TA1309000015,6,16,false,11,10,-1,41.96889,-87.68401
TA1309000066,6,16,false,45,50,5,41.9691,-87.67423
TA1309000041,6,16,false,31,21,-10,41.96951,-87.65471
KA1504000171,6,16,false,69,43,-26,41.97161,-87.65016
465,6,16,false,4,10,6,41.97161,-87.65016
TA1309000035,6,16,false,54,42,-12,41.97335,-87.66785
295,6,16,false,9,14,5,41.97378,-87.65972
13108,6,16,false,24,46,22,41.97379,-87.65971
KA1504000078,6,16,false,13,15,2,41.97491,-87.69258
KA1504000149,6,16,false,15,24,9,41.97562,-87.67945
KA1504000128,6,16,false,7,14,7,41.97567,-87.70927
KA1504000146,6,16,false,73,74,1,41.978,-87.66805
463,6,16,false,8,13,5,41.978,-87.66805
13109,6,16,false,28,33,5,41.97835,-87.65976
294,6,16,false,4,13,9,41.97835,-87.65976
KA1504000147,6,16,false,7,15,8,41.97976,-87.67754
655,6,16,false,20,15,-5,41.97987,-87.68194
KA1504000151,6,16,false,33,30,-3,41.98359,-87.66916
KA1504000152,6,16,false,184,152,-32,41.98403,-87.65231
459,6,16,false,21,24,3,41.98403,-87.65231
15578,6,16,false,34,29,-5,41.98405,-87.66027
15575,6,16,false,23,39,16,41.98975,-87.66014
458,6,16,false,6,15,9,41.98975,-87.66013
KA1504000129,6,16,false,5,13,8,41.99417,-87.68945
15571,6,16,false,47,47,0,41.99478,-87.66028
KA1504000156,6,16,false,10,11,1,41.99925,-87.67137
RP-009,6,16,false,16,26,10,42.00107,-87.66122
451,6,16,false,9,16,7,42.00108,-87.66123
660,6,16,false,14,29,15,42.00458,-87.66143
KA1504000175,6,16,false,15,23,8,42.00797,-87.66549
KA1504000162,6,16,false,11,6,-5,42.00907,-87.67422
KA1504000159,6,16,false,14,14,0,42.01059,-87.66241
525,6,16,false,12,12,0,42.01272,-87.66605
523,6,16,false,8,26,18,42.02089,-87.66505
597,6,16,false,4,11,7,42.03256,-87.67914
E002,6,16,false,38,22,-16,42.03256,-87.67912
599,6,16,false,15,11,-4,42.03972,-87.69942
596,6,16,false,43,42,-1,42.04822,-87.68348
E008,6,16,false,36,41,5,42.05049,-87.67782
605,6,16,false,20,25,5,42.05294,-87.67342
661,6,16,false,17,21,4,42.05704,-87.68657
604,6,16,false,38,43,5,42.05824,-87.67744
E006,6,16,false,14,8,-6,42.06367,-87.69871
15491,6,16,true,10,9,-1,41.78096,-87.57624
426,6,16,true,16,21,5,41.7851,-87.60108
KA1503000014,6,16,true,45,63,18,41.7851,-87.60108
KA1503000070,6,16,true,10,15,5,41.78794,-87.58831
TA1309000011,6,16,true,22,25,3,41.78873,-87.60131
KA1503000071,6,16,true,48,29,-19,41.79148,-87.59988
423,6,16,true,18,16,-2,41.79148,-87.59988
KA1503000074,6,16,true,24,23,-1,41.79174,-87.58395
TA1309000063,6,16,true,37,34,-3,41.79325,-87.5878
345,6,16,true,11,8,-3,41.79326,-87.5878
420,6,16,true,12,12,0,41.79429,-87.60145
KA1504000076,6,16,true,44,34,-10,41.7943,-87.60145
247,6,16,true,21,25,4,41.79522,-87.58077
TA1308000009,6,16,true,81,69,-12,41.79522,-87.58075
TA1307000164,6,16,true,14,34,20,41.79527,-87.59647
248,6,16,true,19,14,-5,41.79528,-87.59647
KA1503000052,6,16,true,25,22,-3,41.79935,-87.60097
418,6,16,true,7,12,5,41.79936,-87.60097
KA1503000059,6,16,true,33,34,1,41.79952,-87.58643
419,6,16,true,6,11,5,41.79952,-87.58643
TA1309000037,6,16,true,59,55,-4,41.79957,-87.59474
417,6,16,true,12,15,3,41.80242,-87.5869
KA1503000007,6,16,true,35,30,-5,41.80242,-87.58689
13398,6,16,true,18,20,2,41.80256,-87.59035
322,6,16,true,10,24,14,41.80321,-87.59849
KA1503000069,6,16,true,12,6,-6,41.80579,-87.59247
TA1308000035,6,16,true,12,19,7,41.80944,-87.59188
TA1308000038,6,16,true,6,11,5,41.82298,-87.6071
TA1308000045,6,16,true,16,13,-3,41.83062,-87.64129
TA1308000043,6,16,true,15,13,-2,41.83066,-87.64715
KA1503000005,6,16,true,14,13,-1,41.83079,-87.6325
TA1307000129,6,16,true,20,13,-7,41.83104,-87.62683
KA1503000004,6,16,true,12,11,-1,41.83127,-87.6088
15445,6,16,true,15,18,3,41.83453,-87.63183
13216,6,16,true,37,16,-21,41.83473,-87.62581
13217,6,16,true,27,27,0,41.83488,-87.61792
13215,6,16,true,16,13,-3,41.83634,-87.6135
280,6,16,true,4,14,10,41.83779,-87.65116
TA1308000046,6,16,true,13,25,12,41.83779,-87.65115
TA1309000055,6,16,true,39,37,-2,41.8382,-87.64514
KA1503000038,6,16,true,10,18,8,41.83845,-87.6354
TA1307000048,6,16,true,90,71,-19,41.83855,-87.60821
150,6,16,true,10,8,-2,41.83855,-87.60821
272,6,16,true,5,10,5,41.83882,-87.62186
TA1308000036,6,16,true,14,10,-4,41.83883,-87.62186
15442,6,16,true,11,6,-5,41.83918,-87.66562
237,6,16,true,9,10,1,41.84204,-87.61697
TA1307000139,6,16,true,32,30,-2,41.84205,-87.61698
TA1307000153,6,16,true,21,18,-3,41.84358,-87.64538
TA1307000005,6,16,true,14,17,3,41.84569,-87.6225
TA1308000013,6,16,true,13,10,-3,41.84719,-87.64681
TA1308000014,6,16,true,10,5,-5,41.84953,-87.64059
TA1308000026,6,16,true,10,18,8,41.85008,-87.63214
TA1305000001,6,16,true,13,16,3,41.85262,-87.6265
13075,6,16,true,58,50,-8,41.8531,-87.63192
120,6,16,true,9,13,4,41.8531,-87.63191
13162,6,16,true,7,10,3,41.85378,-87.64659
15546,6,16,true,15,13,-2,41.85416,-87.61916
13307,6,16,true,9,12,3,41.85489,-87.66359
13089,6,16,true,10,10,0,41.85497,-87.67567
13331,6,16,true,12,7,-5,41.85515,-87.65414
15545,6,16,true,111,103,-8,41.85627,-87.61334
4,6,16,true,44,38,-6,41.85627,-87.61334
SL-013,6,16,true,20,15,-5,41.85659,-87.62755
SL-006,6,16,true,12,16,4,41.8568,-87.63387
13135,6,16,true,30,31,1,41.85753,-87.66157
338,6,16,true,8,12,4,41.85758,-87.61956
13102,6,16,true,49,56,7,41.85762,-87.61942
273,6,16,true,11,10,-1,41.85783,-87.62455
13150,6,16,true,58,57,-1,41.85783,-87.62455
13099,6,16,true,18,23,5,41.85784,-87.64627
TA1307000159,6,16,true,14,23,9,41.8579,-87.6687
TA1307000044,6,16,true,17,8,-9,41.85794,-87.64083
13163,6,16,true,16,27,11,41.85808,-87.65108
13164,6,16,true,41,52,11,41.85818,-87.65648
SL-012,6,16,true,58,67,9,41.86038,-87.62581
72,6,16,true,17,13,-4,41.86039,-87.62581
137,6,16,true,13,8,-5,41.86238,-87.65108
TA1306000002,6,16,true,23,27,4,41.86238,-87.65108
TA1307000124,6,16,true,51,66,15,41.86411,-87.62372
168,6,16,true,12,14,2,41.86415,-87.62372
TA1309000001,6,16,true,36,33,-3,41.86488,-87.64708
13354,6,16,true,15,25,10,41.86524,-87.66651
13029,6,16,true,21,27,6,41.86531,-87.6179
341,6,16,true,30,29,-1,41.86608,-87.60733
13431,6,16,true,74,59,-15,41.8661,-87.60728
KA1504000101,6,16,true,17,13,-4,41.86651,-87.68466
WL-008,6,16,true,49,64,15,41.86712,-87.64108
57,6,16,true,9,11,2,41.86712,-87.64107
59,6,16,true,25,40,15,41.86721,-87.62597
TA1305000002,6,16,true,92,116,24,41.86721,-87.62597
3,6,16,true,23,15,-8,41.86723,-87.61536
15544,6,16,true,46,53,7,41.86723,-87.61536
TA1305000017,6,16,true,27,21,-6,41.86734,-87.64863
KA1706005007,6,16,true,30,28,-2,41.86749,-87.63219
626,6,16,true,7,14,7,41.86749,-87.63219
SL-005,6,16,true,98,130,32,41.8679,-87.62304
255,6,16,true,29,35,6,41.86791,-87.62304
644,6,16,true,50,21,-29,41.86859,-87.68625
19,6,16,true,17,18,1,41.86892,-87.65913
13139,6,16,true,41,38,-3,41.86893,-87.65913
13285,6,16,true,29,19,-10,41.86928,-87.67372
22,6,16,true,16,15,-1,41.86947,-87.65548
13160,6,16,true,48,51,3,41.86947,-87.65548
414,6,16,true,8,10,2,41.87023,-87.63947
15550,6,16,true,27,19,-8,41.87024,-87.63947
TA1309000010,6,16,true,50,47,-3,41.87074,-87.62574
SL-009,6,16,true,21,21,0,41.87081,-87.63121
342,6,16,true,11,3,-8,41.87127,-87.6737
TA1309000064,6,16,true,30,28,-2,41.87127,-87.67369
TA1307000130,6,16,true,44,40,-4,41.87178,-87.65103
241,6,16,true,8,12,4,41.8718,-87.65102
108,6,16,true,19,9,-10,41.87183,-87.64664
TA1307000121,6,16,true,55,39,-16,41.87184,-87.64664
41,6,16,true,19,24,5,41.87209,-87.62957
SL-008,6,16,true,78,81,3,41.87209,-87.62956
13332,6,16,true,89,74,-15,41.87219,-87.6615
175,6,16,true,12,12,0,41.87255,-87.63359
SL-011,6,16,true,45,53,8,41.87256,-87.63356
623,6,16,true,51,54,3,41.87272,-87.62399
KA1504000104,6,16,true,28,9,-19,41.87296,-87.66912
320,6,16,true,25,23,-2,41.87327,-87.66402
SL-007,6,16,true,23,28,5,41.87404,-87.6277
13326,6,16,true,11,9,-2,41.87425,-87.63958
321,6,16,true,9,15,6,41.87427,-87.63257
TA1306000025,6,16,true,20,20,0,41.87464,-87.65703
15668,6,16,true,16,12,-4,41.87471,-87.68642
109,6,16,true,20,10,-10,41.87475,-87.64981
13028,6,16,true,32,28,-4,41.87475,-87.64981
SL-010,6,16,true,25,25,0,41.87501,-87.63309
15541,6,16,true,23,25,2,41.8758,-87.62086
13037,6,16,true,10,3,-7,41.87588,-87.64078
TA1305000009,6,16,true,19,11,-8,41.87593,-87.63068
TA1305000010,6,16,true,11,10,-1,41.87623,-87.62444
624,6,16,true,26,26,0,41.87626,-87.62923
33,6,16,true,18,6,-12,41.87715,-87.62786
TA1305000035,6,16,true,21,22,1,41.87716,-87.62787
15539,6,16,true,77,62,-15,41.87763,-87.64405
13158,6,16,true,51,63,12,41.87764,-87.64957
134,6,16,true,7,19,12,41.87764,-87.64954
21,6,16,true,19,19,0,41.87773,-87.6548
13157,6,16,true,31,45,14,41.87773,-87.6548
TA1305000025,6,16,true,39,36,-3,41.87773,-87.63528
284,6,16,true,4,12,8,41.87784,-87.62408
TA1309000002,6,16,true,20,34,14,41.87784,-87.62408
13206,6,16,true,29,45,16,41.87794,-87.66201
107,6,16,true,21,27,6,41.87822,-87.644
638,6,16,true,21,22,1,41.87827,-87.64078
TA1305000005,6,16,true,16,16,0,41.87924,-87.62975
13011,6,16,true,33,39,6,41.87931,-87.63993
192,6,16,true,3,11,8,41.87935,-87.63997
KA1503000015,6,16,true,36,21,-15,41.87948,-87.6257
15667,6,16,true,12,19,7,41.8798,-87.68609
TA1309000007,6,16,true,10,5,-5,41.88022,-87.63526
WL-011,6,16,true,43,36,-7,41.88034,-87.64273
73,6,16,true,18,5,-13,41.8804,-87.64273
80,6,16,true,8,10,2,41.88042,-87.65556
13156,6,16,true,34,44,10,41.88042,-87.65554
13300,6,16,true,186,191,5,41.88097,-87.61675
76,6,16,true,35,39,4,41.88098,-87.61675
13008,6,16,true,81,63,-18,41.88105,-87.62408
90,6,16,true,14,9,-5,41.88107,-87.62409
49,6,16,true,12,8,-4,41.88116,-87.62963
TA1305000006,6,16,true,45,24,-21,41.88122,-87.6296
13056,6,16,true,12,14,2,41.88168,-87.63951
198,6,16,true,12,28,16,41.88187,-87.6488
TA1307000120,6,16,true,119,121,2,41.88188,-87.64879
13341,6,16,true,18,26,8,41.88208,-87.63985
197,6,16,true,16,8,-8,41.88208,-87.62513
13036,6,16,true,27,33,6,41.8821,-87.62513
77,6,16,true,22,21,-1,41.88214,-87.64108
TA1305000032,6,16,true,79,87,8,41.88218,-87.64109
13006,6,16,true,18,12,-6,41.88268,-87.63252
13353,6,16,true,56,55,-1,41.88283,-87.6612
654,6,16,true,32,32,0,41.88307,-87.65698
13409,6,16,true,48,52,4,41.8831,-87.6511
KA1503000072,6,16,true,14,18,4,41.88317,-87.63693
WL-012,6,16,true,35,28,-7,41.88337,-87.6412
112,6,16,true,12,15,3,41.88362,-87.6486
13053,6,16,true,114,95,-19,41.88365,-87.64863
43,6,16,true,20,11,-9,41.88396,-87.62455
13001,6,16,true,67,70,3,41.88397,-87.62459
13155,6,16,true,27,31,4,41.88407,-87.65689
621,6,16,true,10,18,8,41.88412,-87.65427
18062,6,16,true,29,38,9,41.88412,-87.65427
81,6,16,true,26,12,-14,41.88417,-87.6296
TA1306000010,6,16,true,73,68,-5,41.88419,-87.62961
TA1305000030,6,16,true,25,22,-3,41.88459,-87.63178
15535,6,16,true,57,50,-7,41.8846,-87.64455
96,6,16,true,3,15,12,41.8846,-87.64455
TA1305000029,6,16,true,84,67,-17,41.88466,-87.62787
195,6,16,true,36,39,3,41.88466,-87.61952
13263,6,16,true,103,70,-33,41.88467,-87.61952
44,6,16,true,26,22,-4,41.88468,-87.62782
TA1306000015,6,16,true,68,91,23,41.88549,-87.65232
71,6,16,true,20,16,-4,41.8855,-87.65233
66,6,16,true,11,14,3,41.88557,-87.64186
13021,6,16,true,54,56,2,41.88559,-87.64184
TA1307000111,6,16,true,39,32,-7,41.88582,-87.63548
13073,6,16,true,23,25,2,41.88592,-87.66717
KA17018054,6,16,true,23,13,-10,41.88595,-87.67701
KA1503000012,6,16,true,59,66,7,41.88599,-87.63089
38,6,16,true,15,27,12,41.88599,-87.63089
52,6,16,true,18,11,-7,41.886,-87.62421
TA1305000011,6,16,true,52,77,25,41.886,-87.62418
7,6,16,true,11,23,12,41.88627,-87.61751
15534,6,16,true,58,62,4,41.88627,-87.61749
217,6,16,true,11,3,-8,41.8866,-87.65821
13197,6,16,true,13,18,5,41.8866,-87.65816
TA1308000029,6,16,true,24,20,-4,41.88673,-87.62225
TA1307000131,6,16,true,46,30,-16,41.88688,-87.62606
194,6,16,true,7,12,5,41.88688,-87.62606
6,6,16,true,18,17,-1,41.88697,-87.61281
KA1503000064,6,16,true,88,88,0,41.88697,-87.61281
100,6,16,true,10,19,9,41.88814,-87.63657
TA1305000022,6,16,true,51,47,-4,41.88817,-87.63656
56,6,16,true,23,38,15,41.88866,-87.64442
TA1306000003,6,16,true,96,122,26,41.88867,-87.64442
KA1503000043,6,16,true,118,119,1,41.88918,-87.63851
133,6,16,true,29,35,6,41.88918,-87.63851
13050,6,16,true,65,84,19,41.88919,-87.62775
47,6,16,true,23,17,-6,41.88921,-87.62775
15664,6,16,true,10,11,1,41.8895,-87.68821
13432,6,16,true,27,17,-10,41.88989,-87.67149
TA1307000151,6,16,true,93,76,-17,41.88993,-87.63427
212,6,16,true,20,25,5,41.88995,-87.63427
636,6,16,true,47,41,-6,41.88997,-87.63662
KA1503000044,6,16,true,22,28,6,41.89018,-87.6262
196,6,16,true,9,13,4,41.89053,-87.62205
13427,6,16,true,39,25,-14,41.89054,-87.62205
26,6,16,true,12,21,9,41.89057,-87.61798
13430,6,16,true,92,94,2,41.89077,-87.63169
181,6,16,true,22,18,-4,41.89077,-87.63168
TA1306000013,6,16,true,102,100,-2,41.89083,-87.61852
RN-,6,16,true,88,112,24,41.89102,-87.63546
672,6,16,true,27,25,-2,41.89102,-87.63545
13434,6,16,true,35,39,4,41.89108,-87.66663
TA1308000006,6,16,true,19,27,8,41.89128,-87.67686
199,6,16,true,35,36,1,41.89143,-87.62676
TA1307000117,6,16,true,131,125,-6,41.89144,-87.62675
13033,6,16,true,100,96,-4,41.8916,-87.64835
84,6,16,true,24,24,0,41.89161,-87.64833
186,6,16,true,6,13,7,41.8918,-87.65879
13194,6,16,true,41,60,19,41.8918,-87.65878
TA1305000003,6,16,true,93,85,-8,41.89187,-87.62061
24,6,16,true,24,22,-2,41.8919,-87.62063
643,6,16,true,18,16,-2,41.89203,-87.68939
35,6,16,true,25,28,3,41.89227,-87.61206
13022,6,16,true,226,200,-26,41.89227,-87.61205
99,6,16,true,19,26,7,41.89255,-87.61449
TA1306000029,6,16,true,87,91,4,41.89256,-87.61449
13265,6,16,true,84,88,4,41.89383,-87.64172
74,6,16,true,27,15,-12,41.89384,-87.64173
13045,6,16,true,105,120,15,41.89403,-87.62931
110,6,16,true,39,37,-2,41.89406,-87.6293
13016,6,16,true,68,42,-26,41.89431,-87.62277
211,6,16,true,14,10,-4,41.89439,-87.62267
KA1503000041,6,16,true,77,41,-36,41.89452,-87.61798
142,6,16,true,24,9,-15,41.89453,-87.61806
13196,6,16,true,46,40,-6,41.89455,-87.65345
TA1307000062,6,16,true,24,28,4,41.89466,-87.63839
111,6,16,true,16,11,-5,41.89466,-87.63837
TA1306000012,6,16,true,106,121,15,41.89475,-87.63438
53,6,16,true,31,32,1,41.89476,-87.63439
627,6,16,true,13,6,-7,41.8948,-87.63231
KP1705001026,6,16,true,65,64,-1,41.89483,-87.6323
659,6,16,true,5,11,6,41.8955,-87.68201
18058,6,16,true,14,29,15,41.8955,-87.68201
637,6,16,true,30,34,4,41.89563,-87.67209
128,6,16,true,17,30,13,41.89571,-87.67716
13132,6,16,true,41,78,37,41.89573,-87.67718
161,6,16,true,18,23,5,41.89574,-87.62599
15530,6,16,true,64,78,14,41.89575,-87.62596
18003,6,16,true,26,12,-14,41.89575,-87.62011
635,6,16,true,10,5,-5,41.89576,-87.62012
13247,6,16,true,33,51,18,41.89597,-87.66775
TA1305000020,6,16,true,45,40,-5,41.89636,-87.65406
54,6,16,true,13,7,-6,41.89637,-87.65407
13289,6,16,true,28,46,18,41.89638,-87.661
86,6,16,true,6,12,6,41.89639,-87.661
337,6,16,true,14,13,-1,41.89659,-87.63096
13303,6,16,true,51,49,-2,41.89672,-87.63088
13017,6,16,true,48,48,0,41.89676,-87.6357
31,6,16,true,19,11,-8,41.89677,-87.63572
13338,6,16,true,49,35,-14,41.89697,-87.62173
173,6,16,true,16,13,-3,41.89704,-87.62173
TA1307000061,6,16,true,52,46,-6,41.89745,-87.62873
106,6,16,true,4,11,7,41.89746,-87.62874
25,6,16,true,18,14,-4,41.89751,-87.62354
13034,6,16,true,57,38,-19,41.89754,-87.62352
TA1306000009,6,16,true,36,28,-8,41.89772,-87.64299
620,6,16,true,49,44,-5,41.89817,-87.63754
KA1504000103,6,16,true,28,22,-6,41.89842,-87.68659
374,6,16,true,12,14,2,41.89842,-87.68659
145,6,16,true,20,15,-5,41.89856,-87.62211
15529,6,16,true,58,68,10,41.89858,-87.62206
140,6,16,true,37,47,10,41.89895,-87.6299
TA1307000128,6,16,true,115,96,-19,41.89896,-87.6299
657,6,16,true,34,35,1,41.89918,-87.6722
KA1504000117,6,16,true,19,7,-12,41.89936,-87.64848
30,6,16,true,7,10,3,41.89964,-87.66789
13248,6,16,true,39,26,-13,41.89964,-87.66788
46,6,16,true,14,13,-1,41.89994,-87.63444
TA1306000011,6,16,true,31,20,-11,41.89994,-87.63443
364,6,16,true,12,7,-5,41.90023,-87.64299
KA1504000116,6,16,true,21,24,3,41.90023,-87.64299
17660,6,16,true,22,25,3,41.90036,-87.69671
13290,6,16,true,51,49,-2,41.90069,-87.66259
13042,6,16,true,190,145,-45,41.90097,-87.62377
85,6,16,true,31,21,-10,41.90098,-87.62375
183,6,16,true,3,16,13,41.90133,-87.67744
TA1307000070,6,16,true,39,43,4,41.90133,-87.67742
KA1504000133,6,16,true,122,105,-17,41.90234,-87.62773
172,6,16,true,26,23,-3,41.90236,-87.62774
15654,6,16,true,12,8,-4,41.90271,-87.70923
13241,6,16,true,26,22,-4,41.9029,-87.68731
176,6,16,true,38,55,17,41.90291,-87.63141
TA1306000006,6,16,true,22,28,6,41.90292,-87.63772
TA1307000039,6,16,true,192,203,11,41.90294,-87.63137
658,6,16,true,28,23,-5,41.903,-87.6838
216,6,16,true,7,11,4,41.90302,-87.69749
13256,6,16,true,21,29,8,41.90302,-87.69749
17,6,16,true,13,14,1,41.90313,-87.67391
TA1305000034,6,16,true,53,62,9,41.90313,-87.67391
182,6,16,true,37,38,1,41.90317,-87.63442
KA1504000135,6,16,true,154,163,9,41.90319,-87.63439
13136,6,16,true,41,54,13,41.90326,-87.67845
130,6,16,true,17,11,-6,41.90327,-87.67846
210,6,16,true,20,24,4,41.90342,-87.66781
13061,6,16,true,107,127,20,41.90342,-87.66779
KA1504000079,6,16,true,51,62,11,41.9035,-87.64334
359,6,16,true,25,20,-5,41.90458,-87.6497
138,6,16,true,10,14,4,41.9046,-87.64057
TA1307000115,6,16,true,26,42,16,41.9046,-87.64056
291,6,16,true,29,28,-1,41.90672,-87.63494
TA1308000049,6,16,true,116,136,20,41.90672,-87.6349
KA1504000134,6,16,true,63,56,-7,41.90687,-87.6262
180,6,16,true,9,12,3,41.90687,-87.62618
13224,6,16,true,54,48,-6,41.90706,-87.66725
333,6,16,true,8,19,11,41.90706,-87.66725
TA1307000143,6,16,true,21,13,-8,41.90762,-87.63854
61,6,16,true,18,20,2,41.90764,-87.67254
13221,6,16,true,72,83,11,41.90765,-87.67254
13245,6,16,true,5,12,7,41.90777,-87.68586
301,6,16,true,17,26,9,41.90796,-87.63203
TA1309000024,6,16,true,91,83,-8,41.908,-87.63152
69,6,16,true,16,28,12,41.90939,-87.6777
TA1305000041,6,16,true,125,108,-17,41.9094,-87.67769
331,6,16,true,128,122,-6,41.90965,-87.64812
15653,6,16,true,22,20,-2,41.90979,-87.7053
509,6,16,true,6,10,4,41.9098,-87.70531
TA1305000037,6,16,true,40,55,15,41.91018,-87.67003
TA1306000008,6,16,true,35,27,-8,41.9102,-87.6435
16,6,16,true,10,13,3,41.91035,-87.67008
TA1308000005,6,16,true,34,38,4,41.91042,-87.68238
13258,6,16,true,25,20,-5,41.91043,-87.69718
276,6,16,true,7,12,5,41.91043,-87.69718
13257,6,16,true,30,21,-9,41.91054,-87.68956
13154,6,16,true,105,100,-5,41.91054,-87.65312
20,6,16,true,23,15,-8,41.91055,-87.65313
60,6,16,true,16,19,3,41.91059,-87.64942
13058,6,16,true,61,64,3,41.91059,-87.64942
TA1307000038,6,16,true,52,56,4,41.91138,-87.63868
118,6,16,true,14,20,6,41.91138,-87.63868
LF-005,6,16,true,321,235,-86,41.91172,-87.62681
268,6,16,true,53,41,-12,41.91172,-87.62681
126,6,16,true,23,9,-14,41.91196,-87.63197
13128,6,16,true,83,45,-38,41.91197,-87.63197
289,6,16,true,23,30,7,41.91209,-87.63472
TA1308000050,6,16,true,192,203,11,41.91211,-87.6347
13243,6,16,true,99,73,-26,41.91262,-87.6814
158,6,16,true,11,16,5,41.91262,-87.6814
TA1309000032,6,16,true,19,17,-2,41.91293,-87.66417
TA1306000032,6,16,true,89,84,-5,41.9137,-87.65285
93,6,16,true,25,23,-2,41.91371,-87.65285
TA1307000166,6,16,true,40,48,8,41.91386,-87.64877
224,6,16,true,9,20,11,41.91386,-87.64877
15655,6,16,true,20,28,8,41.91401,-87.70514
18017,6,16,true,17,15,-2,41.91416,-87.71676
18067,6,16,true,45,43,-2,41.9146,-87.66796
TA1306000007,6,16,true,36,26,-10,41.91469,-87.64333
28,6,16,true,8,11,3,41.91469,-87.64333
13068,6,16,true,38,60,22,41.91554,-87.68703
116,6,16,true,10,9,-1,41.91555,-87.68703
13179,6,16,true,173,142,-31,41.9157,-87.63461
141,6,16,true,31,32,1,41.91571,-87.63461
219,6,16,true,9,11,2,41.91598,-87.67733
13133,6,16,true,62,79,17,41.91598,-87.67733
58,6,16,true,12,8,-4,41.91602,-87.66894
TA1305000039,6,16,true,40,33,-7,41.9163,-87.66749
15650,6,16,true,18,21,3,41.91711,-87.71023
15651,6,16,true,30,32,2,41.91752,-87.70181
507,6,16,true,8,11,3,41.91752,-87.70181
13266,6,16,true,19,34,15,41.91774,-87.69142
TA1309000029,6,16,true,38,28,-10,41.9178,-87.68245
309,6,16,true,7,12,5,41.91789,-87.6865
288,6,16,true,16,13,-3,41.91809,-87.64375
TA1309000006,6,16,true,63,78,15,41.91809,-87.64375
223,6,16,true,14,11,-3,41.91821,-87.65698
TA1307000163,6,16,true,59,83,24,41.91821,-87.65696
94,6,16,true,37,36,-1,41.91831,-87.6363
13146,6,16,true,147,171,24,41.91831,-87.63629
13059,6,16,true,123,126,3,41.91845,-87.65222
113,6,16,true,40,29,-11,41.91846,-87.65222
13259,6,16,true,14,28,14,41.91852,-87.69744
225,6,16,true,30,24,-6,41.91995,-87.64884
13192,6,16,true,61,92,31,41.91995,-87.64884
13288,6,16,true,33,38,5,41.92008,-87.67788
13242,6,16,true,34,32,-2,41.92021,-87.69266
222,6,16,true,8,10,2,41.92023,-87.69265
307,6,16,true,9,11,2,41.92077,-87.66373
TA1309000030,6,16,true,56,44,-12,41.92077,-87.66372
13292,6,16,true,19,26,7,41.92152,-87.70733
TA1309000033,6,16,true,90,92,2,41.92158,-87.65381
13193,6,16,true,123,126,3,41.92182,-87.64412
144,6,16,true,26,33,7,41.92182,-87.64411
13191,6,16,true,81,78,-3,41.92217,-87.63891
143,6,16,true,13,14,1,41.92217,-87.63891
327,6,16,true,26,24,-2,41.92225,-87.65783
13084,6,16,true,39,55,16,41.92268,-87.69715
123,6,16,true,10,12,2,41.92268,-87.69714
LP-,6,16,true,77,75,-2,41.92396,-87.63584
673,6,16,true,19,18,-1,41.92398,-87.63585
KA1504000140,6,16,true,13,14,1,41.92409,-87.67646
15648,6,16,true,25,13,-12,41.92464,-87.68931
504,6,16,true,6,10,4,41.92464,-87.68931
KA1504000090,6,16,true,8,17,9,41.92483,-87.7145
TA1307000001,6,16,true,83,62,-21,41.92535,-87.66581
188,6,16,true,15,12,-3,41.92536,-87.66581
TA1306000026,6,16,true,56,56,0,41.92558,-87.65842
87,6,16,true,9,13,4,41.92559,-87.65843
67,6,16,true,15,8,-7,41.9256,-87.65371
TA1306000016,6,16,true,62,71,9,41.9256,-87.65371
313,6,16,true,24,34,10,41.9257,-87.64246
TA1309000019,6,16,true,110,123,13,41.92586,-87.63897
TA1309000058,6,16,true,99,122,23,41.92591,-87.64927
127,6,16,true,35,24,-11,41.92592,-87.64927
TA1308000001,6,16,true,253,191,-62,41.92627,-87.63086
177,6,16,true,67,60,-7,41.92627,-87.63086
15646,6,16,true,22,23,1,41.92668,-87.6977
34,6,16,true,5,10,5,41.92675,-87.63444
13124,6,16,true,20,36,16,41.92675,-87.63444
302,6,16,true,19,22,3,41.92859,-87.65421
TA1309000023,6,16,true,69,70,1,41.9287,-87.65383
TA1307000113,6,16,true,55,70,15,41.92878,-87.66391
190,6,16,true,8,21,13,41.92878,-87.6639
13296,6,16,true,25,31,6,41.92883,-87.66852
343,6,16,true,15,9,-6,41.92889,-87.65898
TA1309000059,6,16,true,45,46,1,41.92889,-87.65898
349,6,16,true,20,25,5,41.92915,-87.6491
TA1309000061,6,16,true,83,106,23,41.92915,-87.64909
258,6,16,true,11,11,0,41.92946,-87.68417
TA1308000031,6,16,true,36,37,1,41.92946,-87.68417
340,6,16,true,25,25,0,41.92956,-87.64313
TA1305000014,6,16,true,98,123,25,41.92956,-87.64313
260,6,16,true,14,9,-5,41.92958,-87.70791
13085,6,16,true,40,60,20,41.92958,-87.70789
15643,6,16,true,4,20,16,41.93057,-87.7238
TA1307000142,6,16,true,103,109,6,41.93125,-87.64432
220,6,16,true,22,29,7,41.93125,-87.64431
13276,6,16,true,91,79,-12,41.93132,-87.63874
324,6,16,true,25,31,6,41.93173,-87.64179
15645,6,16,true,8,19,11,41.93191,-87.70121
13271,6,16,true,42,28,-14,41.93192,-87.67784
152,6,16,true,21,13,-8,41.93221,-87.65864
TA1307000064,6,16,true,73,86,13,41.93222,-87.65864
TA1306000014,6,16,true,78,80,2,41.93242,-87.65271
13,6,16,true,10,17,7,41.93242,-87.65271
TA1309000039,6,16,true,117,104,-13,41.93258,-87.63642
329,6,16,true,32,35,3,41.93258,-87.63642
13294,6,16,true,28,42,14,41.9326,-87.66595
TA1309000036,6,16,true,70,61,-9,41.93313,-87.64776
332,6,16,true,21,17,-4,41.93313,-87.64776
15644,6,16,true,8,11,3,41.93534,-87.71687
TA1307000006,6,16,true,66,87,21,41.93571,-87.6636
153,6,16,true,16,12,-4,41.93575,-87.66364
13268,6,16,true,23,23,0,41.93588,-87.67843
13269,6,16,true,14,29,15,41.93609,-87.66983
TA1307000052,6,16,true,89,87,-2,41.93628,-87.65266
115,6,16,true,26,25,-1,41.93628,-87.65266
156,6,16,true,35,32,-3,41.9365,-87.64756
TA1307000136,6,16,true,99,108,9,41.9365,-87.64755
TA1307000041,6,16,true,159,142,-17,41.93669,-87.63683
157,6,16,true,30,26,-4,41.9367,-87.63683
13137,6,16,true,145,136,-9,41.9376,-87.6441
300,6,16,true,45,45,0,41.93761,-87.6441
15642,6,16,true,17,22,5,41.93843,-87.69801
154,6,16,true,15,13,-2,41.93912,-87.66384
KA17018068,6,16,true,15,20,5,41.93935,-87.68327
TA1309000042,6,16,true,68,59,-9,41.93937,-87.66836
131,6,16,true,16,11,-5,41.93937,-87.66835
KA150400009X,6,16,true,16,9,-7,41.9394,-87.71159
13229,6,16,true,32,59,27,41.93946,-87.66376
226,6,16,true,23,16,-7,41.93972,-87.65886
TA1308000019,6,16,true,62,81,19,41.93973,-87.65886
13277,6,16,true,96,83,-13,41.9401,-87.64546
296,6,16,true,18,18,0,41.9401,-87.64546
TA1307000134,6,16,true,152,150,-2,41.94016,-87.65303
117,6,16,true,33,38,5,41.94016,-87.65302
13143,6,16,true,12,23,11,41.94059,-87.67853
334,6,16,true,19,30,11,41.94076,-87.63919
TA1309000049,6,16,true,131,120,-11,41.94077,-87.63919
15634,6,16,true,13,8,-5,41.94304,-87.68729
TA1307000138,6,16,true,45,66,21,41.94334,-87.67094
230,6,16,true,13,12,-1,41.94335,-87.67093
13144,6,16,true,31,36,5,41.9434,-87.67964
TA1309000025,6,16,true,102,104,2,41.94368,-87.64894
299,6,16,true,23,28,5,41.94368,-87.64894
229,6,16,true,28,33,5,41.94372,-87.66401
13071,6,16,true,107,118,11,41.94373,-87.66401
632,6,16,true,156,149,-7,41.94453,-87.6547
303,6,16,true,21,37,16,41.94522,-87.64702
15631,6,16,true,11,8,-3,41.94524,-87.70665
13278,6,16,true,92,107,15,41.94553,-87.64644
TA1309000050,6,16,true,20,25,5,41.94618,-87.67331
15632,6,16,true,18,11,-7,41.94664,-87.69463
KA1504000143,6,16,true,15,9,-6,41.94664,-87.68337
227,6,16,true,22,21,-1,41.94813,-87.66397
13235,6,16,true,96,75,-21,41.94814,-87.66396
304,6,16,true,34,43,9,41.94878,-87.64922
13253,6,16,true,24,36,12,41.9488,-87.67527
13325,6,16,true,115,116,1,41.94907,-87.64863
114,6,16,true,19,25,6,41.94935,-87.65451
TA1307000126,6,16,true,108,80,-28,41.94936,-87.65451
232,6,16,true,27,48,21,41.94943,-87.64645
TA1307000150,6,16,true,129,120,-9,41.94945,-87.64646
13319,6,16,true,34,26,-8,41.95069,-87.6687
TA1307000127,6,16,true,85,69,-16,41.9508,-87.65918
165,6,16,true,16,16,0,41.95081,-87.65918
15628,6,16,true,12,13,1,41.95216,-87.69806
256,6,16,true,19,18,-1,41.95282,-87.65
13323,6,16,true,59,59,0,41.95282,-87.65
314,6,16,true,10,8,-2,41.9535,-87.69199
TA1309000043,6,16,true,34,27,-7,41.95417,-87.66434
240,6,16,true,20,21,1,41.95424,-87.65441
13063,6,16,true,54,78,24,41.95424,-87.65441
486,6,16,true,4,10,6,41.95431,-87.68607
KA1504000158,6,16,true,7,13,6,41.95432,-87.68607
254,6,16,true,28,34,6,41.95438,-87.64806
TA1308000022,6,16,true,88,94,6,41.95438,-87.64805
244,6,16,true,12,13,1,41.95466,-87.67391
TA1307000149,6,16,true,29,28,-1,41.95467,-87.67392
298,6,16,true,6,13,7,41.95601,-87.68021
TA1309000026,6,16,true,34,42,8,41.95601,-87.6802
13249,6,16,true,19,13,-6,41.95606,-87.66885
312,6,16,true,20,28,8,41.95637,-87.6563
TA1308000047,6,16,true,21,18,-3,41.95709,-87.6642
13379,6,16,true,50,64,14,41.95786,-87.6495
TA1309000018,6,16,true,19,21,2,41.95791,-87.67357
306,6,16,true,8,18,10,41.9585,-87.655
TA1309000027,6,16,true,30,67,37,41.9585,-87.65499
13389,6,16,true,51,58,7,41.961,-87.64958
245,6,16,true,12,18,6,41.96101,-87.64958
15621,6,16,true,9,10,1,41.96103,-87.70586
15622,6,16,true,17,15,-2,41.96108,-87.69544
TA1307000144,6,16,true,35,23,-12,41.96142,-87.6762
TA1309000021,6,16,true,16,21,5,41.9615,-87.6714
482,6,16,true,11,10,-1,41.96154,-87.69117
15623,6,16,true,18,17,-1,41.96154,-87.69117
KA1503000022,6,16,true,29,29,0,41.96158,-87.66609
231,6,16,true,25,19,-6,41.96163,-87.65464
TA1307000107,6,16,true,82,96,14,41.96164,-87.65464
TA1307000156,6,16,true,40,30,-10,41.96301,-87.68479
243,6,16,true,18,12,-6,41.96302,-87.68479
TA1309000012,6,16,true,19,26,7,41.96325,-87.67928
TA1308000012,6,16,true,171,139,-32,41.96398,-87.63818
249,6,16,true,36,24,-12,41.96398,-87.63818
293,6,16,true,7,19,12,41.96521,-87.65822
13074,6,16,true,41,53,12,41.96521,-87.6582
639,6,16,true,78,72,-6,41.96584,-87.64538
KA1504000127,6,16,true,19,22,3,41.96587,-87.70083
KA1504000093,6,16,true,16,14,-2,41.96587,-87.69365
TA1307000140,6,16,true,51,42,-9,41.96643,-87.68865
239,6,16,true,10,13,3,41.9665,-87.68843
326,6,16,true,17,17,0,41.96665,-87.67113
KA1504000126,6,16,true,4,11,7,41.96668,-87.70807
TA1309000014,6,16,true,46,77,31,41.96709,-87.66744
TA1307000158,6,16,true,20,26,6,41.9671,-87.67904
TA1307000119,6,16,true,29,31,2,41.96796,-87.65
323,6,16,true,16,11,-5,41.96869,-87.66034
TA1308000021,6,16,true,26,34,8,41.96883,-87.65765
475,6,16,true,4,10,6,41.96885,-87.69611
KA1504000080,6,16,true,19,19,0,41.96887,-87.69609
TA1309000015,6,16,true,17,10,-7,41.96889,-87.68401
TA1309000066,6,16,true,56,45,-11,41.9691,-87.67423
344,6,16,true,11,11,0,41.9691,-87.67423
TA1309000041,6,16,true,25,38,13,41.96951,-87.65471
KA1504000171,6,16,true,61,43,-18,41.97161,-87.65016
465,6,16,true,13,13,0,41.97161,-87.65016
325,6,16,true,7,15,8,41.9728,-87.67186
TA1309000035,6,16,true,75,62,-13,41.97335,-87.66785
295,6,16,true,14,18,4,41.97378,-87.65972
13108,6,16,true,53,51,-2,41.97379,-87.65971
KA1504000078,6,16,true,15,11,-4,41.97491,-87.69258
KA1504000149,6,16,true,27,19,-8,41.97562,-87.67945
464,6,16,true,8,10,2,41.97562,-87.67945
KA1504000160,6,16,true,18,9,-9,41.97564,-87.70143
463,6,16,true,13,14,1,41.978,-87.66805
KA1504000146,6,16,true,55,72,17,41.978,-87.66805
294,6,16,true,11,14,3,41.97835,-87.65976
13109,6,16,true,35,63,28,41.97835,-87.65976
KA1504000147,6,16,true,6,10,4,41.97976,-87.67754
655,6,16,true,20,14,-6,41.97987,-87.68194
460,6,16,true,10,8,-2,41.98358,-87.66916
KA1504000151,6,16,true,38,38,0,41.98359,-87.66916
KA1504000152,6,16,true,121,112,-9,41.98403,-87.65231
459,6,16,true,29,25,-4,41.98403,-87.65231
15578,6,16,true,45,27,-18,41.98405,-87.66027
461,6,16,true,12,6,-6,41.98405,-87.66027
15575,6,16,true,33,40,7,41.98975,-87.66014
458,6,16,true,4,20,16,41.98975,-87.66013
KA1504000148,6,16,true,15,23,8,41.99086,-87.66971
15571,6,16,true,42,46,4,41.99478,-87.66028
454,6,16,true,17,12,-5,41.99478,-87.66027
KA1504000156,6,16,true,14,16,2,41.99925,-87.67137
RP-009,6,16,true,15,26,11,42.00107,-87.66122
RP-008,6,16,true,7,19,12,42.00446,-87.6724
660,6,16,true,17,31,14,42.00458,-87.66143
KA1504000175,6,16,true,18,17,-1,42.00797,-87.66549
RP-005,6,16,true,11,14,3,42.0086,-87.69047
432,6,16,true,10,4,-6,42.00907,-87.67423
KA1504000162,6,16,true,10,7,-3,42.00907,-87.67422
KA1504000159,6,16,true,10,20,10,42.01059,-87.66241
525,6,16,true,12,34,22,42.01272,-87.66605
520,6,16,true,47,25,-22,42.01597,-87.66859
515,6,16,true,20,12,-8,42.01915,-87.67356
523,6,16,true,22,27,5,42.02089,-87.66505
662,6,16,true,5,10,5,42.02354,-87.69961
598,6,16,true,10,9,-1,42.02578,-87.68411
E002,6,16,true,25,20,-5,42.03256,-87.67912
599,6,16,true,13,6,-7,42.03972,-87.69942
596,6,16,true,33,31,-2,42.04822,-87.68348
600,6,16,true,10,2,-8,42.04831,-87.6983
E008,6,16,true,15,13,-2,42.05049,-87.67782
605,6,16,true,18,15,-3,42.05294,-87.67342
604,6,16,true,17,29,12,42.05824,-87.67744
E006,6,16,true,6,14,8,42.06367,-87.69871
15491,7,8,false,7,21,14,41.78096,-87.57624
KA1503000014,7,8,false,18,2,-16,41.7851,-87.60108
KA1504000076,7,8,false,2,10,8,41.7943,-87.60145
TA1308000009,7,8,false,15,16,1,41.79522,-87.58075
KA1503000059,7,8,false,12,6,-6,41.79952,-87.58643
TA1309000037,7,8,false,15,6,-9,41.79957,-87.59474
13398,7,8,false,10,8,-2,41.80256,-87.59035
TA1308000035,7,8,false,4,13,9,41.80944,-87.59188
KA1503000004,7,8,false,11,9,-2,41.83127,-87.6088
TA1307000048,7,8,false,23,18,-5,41.83855,-87.60821
TA1307000139,7,8,false,11,4,-7,41.84205,-87.61698
TA1305000004,7,8,false,28,8,-20,41.8514,-87.61884
15545,7,8,false,15,31,16,41.85627,-87.61334
13102,7,8,false,13,5,-8,41.85762,-87.61942
13150,7,8,false,10,5,-5,41.85783,-87.62455
SL-012,7,8,false,13,6,-7,41.86038,-87.62581
TA1307000124,7,8,false,28,13,-15,41.86411,-87.62372
13029,7,8,false,13,16,3,41.86531,-87.6179
13431,7,8,false,13,17,4,41.8661,-87.60728
TA1305000002,7,8,false,19,15,-4,41.86721,-87.62597
15544,7,8,false,14,42,28,41.86723,-87.61536
SL-005,7,8,false,61,35,-26,41.8679,-87.62304
255,7,8,false,10,5,-5,41.86791,-87.62304
TA1309000010,7,8,false,30,10,-20,41.87074,-87.62574
SL-009,7,8,false,10,2,-8,41.87081,-87.63121
SL-008,7,8,false,20,11,-9,41.87209,-87.62956
13332,7,8,false,13,5,-8,41.87219,-87.6615
SL-011,7,8,false,18,9,-9,41.87256,-87.63356
623,7,8,false,67,32,-35,41.87272,-87.62399
SL-007,7,8,false,11,6,-5,41.87404,-87.6277
15541,7,8,false,23,30,7,41.8758,-87.62086
TA1305000010,7,8,false,42,10,-32,41.87623,-87.62444
13158,7,8,false,17,3,-14,41.87764,-87.64957
TA1305000025,7,8,false,11,7,-4,41.87773,-87.63528
TA1309000002,7,8,false,12,12,0,41.87784,-87.62408
638,7,8,false,3,16,13,41.87827,-87.64078
13011,7,8,false,9,26,17,41.87931,-87.63993
TA1309000008,7,8,false,4,17,13,41.87933,-87.6355
KA1503000015,7,8,false,18,5,-13,41.87948,-87.6257
WL-011,7,8,false,14,6,-8,41.88034,-87.64273
13300,7,8,false,89,88,-1,41.88097,-87.61675
13008,7,8,false,62,39,-23,41.88105,-87.62408
TA1305000006,7,8,false,17,6,-11,41.88122,-87.6296
TA1307000120,7,8,false,23,13,-10,41.88188,-87.64879
13341,7,8,false,14,7,-7,41.88208,-87.63985
13036,7,8,false,14,4,-10,41.8821,-87.62513
TA1305000032,7,8,false,21,20,-1,41.88218,-87.64109
13006,7,8,false,10,9,-1,41.88268,-87.63252
KA1503000072,7,8,false,18,10,-8,41.88317,-87.63693
WL-012,7,8,false,13,15,2,41.88337,-87.6412
13053,7,8,false,5,36,31,41.88365,-87.64863
13001,7,8,false,48,27,-21,41.88397,-87.62459
18062,7,8,false,7,12,5,41.88412,-87.65427
TA1305000030,7,8,false,10,11,1,41.88459,-87.63178
195,7,8,false,10,3,-7,41.88466,-87.61952
13263,7,8,false,51,29,-22,41.88467,-87.61952
TA1306000015,7,8,false,3,19,16,41.88549,-87.65232
KA1503000012,7,8,false,20,21,1,41.88599,-87.63089
TA1305000011,7,8,false,36,29,-7,41.886,-87.62418
15534,7,8,false,21,11,-10,41.88627,-87.61749
TA1308000029,7,8,false,40,16,-24,41.88673,-87.62225
TA1307000131,7,8,false,40,17,-23,41.88688,-87.62606
KA1503000064,7,8,false,33,32,-1,41.88697,-87.61281
TA1305000022,7,8,false,12,3,-9,41.88817,-87.63656
TA1306000003,7,8,false,10,12,2,41.88867,-87.64442
KA1503000043,7,8,false,26,13,-13,41.88918,-87.63851
13050,7,8,false,20,7,-13,41.88919,-87.62775
TA1307000151,7,8,false,17,15,-2,41.88993,-87.63427
13427,7,8,false,37,14,-23,41.89054,-87.62205
13430,7,8,false,27,20,-7,41.89077,-87.63169
TA1306000013,7,8,false,54,25,-29,41.89083,-87.61852
RN-,7,8,false,19,15,-4,41.89102,-87.63546
TA1308000006,7,8,false,11,8,-3,41.89128,-87.67686
TA1307000117,7,8,false,70,35,-35,41.89144,-87.62675
13033,7,8,false,15,12,-3,41.8916,-87.64835
TA1305000003,7,8,false,43,25,-18,41.89187,-87.62061
13022,7,8,false,128,104,-24,41.89227,-87.61205
TA1306000029,7,8,false,66,35,-31,41.89256,-87.61449
13265,7,8,false,13,17,4,41.89383,-87.64172
13045,7,8,false,26,22,-4,41.89403,-87.62931
13016,7,8,false,50,36,-14,41.89431,-87.62277
KA1503000041,7,8,false,42,19,-23,41.89452,-87.61798
13196,7,8,false,17,5,-12,41.89455,-87.65345
TA1307000062,7,8,false,13,7,-6,41.89466,-87.63839
TA1306000012,7,8,false,30,20,-10,41.89475,-87.63438
KP1705001026,7,8,false,12,9,-3,41.89483,-87.6323
15530,7,8,false,17,17,0,41.89575,-87.62596
18003,7,8,false,10,11,1,41.89575,-87.62011
13247,7,8,false,12,9,-3,41.89597,-87.66775
TA1305000020,7,8,false,17,13,-4,41.89636,-87.65406
13289,7,8,false,15,5,-10,41.89638,-87.661
13303,7,8,false,17,10,-7,41.89672,-87.63088
13017,7,8,false,17,14,-3,41.89676,-87.6357
13338,7,8,false,17,15,-2,41.89697,-87.62173
TA1307000061,7,8,false,20,5,-15,41.89745,-87.62873
13034,7,8,false,14,10,-4,41.89754,-87.62352
TA1306000009,7,8,false,14,7,-7,41.89772,-87.64299
620,7,8,false,21,8,-13,41.89817,-87.63754
15529,7,8,false,48,10,-38,41.89858,-87.62206
TA1307000128,7,8,false,21,23,2,41.89896,-87.6299
13290,7,8,false,11,5,-6,41.90069,-87.66259
13042,7,8,false,89,76,-13,41.90097,-87.62377
KA1504000133,7,8,false,15,9,-6,41.90234,-87.62773
13241,7,8,false,10,3,-7,41.9029,-87.68731
TA1307000039,7,8,false,38,27,-11,41.90294,-87.63137
KA1504000135,7,8,false,18,25,7,41.90319,-87.63439
13136,7,8,false,10,10,0,41.90326,-87.67845
13061,7,8,false,12,16,4,41.90342,-87.66779
KA1504000079,7,8,false,15,13,-2,41.9035,-87.64334
TA1308000049,7,8,false,12,10,-2,41.90672,-87.6349
KA1504000134,7,8,false,23,18,-5,41.90687,-87.6262
13224,7,8,false,20,6,-14,41.90706,-87.66725
TA1307000143,7,8,false,12,5,-7,41.90762,-87.63854
13221,7,8,false,2,19,17,41.90765,-87.67254
TA1309000024,7,8,false,17,18,1,41.908,-87.63152
TA1305000041,7,8,false,11,34,23,41.9094,-87.67769
331,7,8,false,17,9,-8,41.90965,-87.64812
TA1305000037,7,8,false,12,5,-7,41.91018,-87.67003
TA1306000008,7,8,false,14,5,-9,41.9102,-87.6435
13257,7,8,false,11,2,-9,41.91054,-87.68956
TA1307000038,7,8,false,8,12,4,41.91138,-87.63868
LF-005,7,8,false,43,53,10,41.91172,-87.62681
13128,7,8,false,12,11,-1,41.91197,-87.63197
TA1308000050,7,8,false,25,38,13,41.91211,-87.6347
TA1306000032,7,8,false,10,4,-6,41.9137,-87.65285
TA1307000166,7,8,false,12,6,-6,41.91386,-87.64877
15655,7,8,false,11,8,-3,41.91401,-87.70514
18067,7,8,false,5,12,7,41.9146,-87.66796
13179,7,8,false,38,24,-14,41.9157,-87.63461
13133,7,8,false,13,7,-6,41.91598,-87.67733
TA1307000163,7,8,false,17,13,-4,41.91821,-87.65696
13146,7,8,false,26,18,-8,41.91831,-87.63629
13059,7,8,false,18,9,-9,41.91845,-87.65222
TA1309000033,7,8,false,21,13,-8,41.92158,-87.65381
13193,7,8,false,27,21,-6,41.92182,-87.64412
13191,7,8,false,20,12,-8,41.92217,-87.63891
13084,7,8,false,10,7,-3,41.92268,-87.69715
LP-,7,8,false,24,19,-5,41.92396,-87.63584
TA1306000016,7,8,false,13,10,-3,41.9256,-87.65371
TA1309000019,7,8,false,42,21,-21,41.92586,-87.63897
TA1309000058,7,8,false,18,12,-6,41.92591,-87.64927
TA1308000001,7,8,false,49,50,1,41.92627,-87.63086
TA1309000023,7,8,false,20,8,-12,41.9287,-87.65383
TA1307000113,7,8,false,11,7,-4,41.92878,-87.66391
TA1309000061,7,8,false,14,6,-8,41.92915,-87.64909
TA1305000014,7,8,false,24,25,1,41.92956,-87.64313
13085,7,8,false,11,13,2,41.92958,-87.70789
TA1307000142,7,8,false,19,17,-2,41.93125,-87.64432
13276,7,8,false,30,20,-10,41.93132,-87.63874
TA1307000064,7,8,false,19,19,0,41.93222,-87.65864
TA1306000014,7,8,false,13,22,9,41.93242,-87.65271
TA1309000039,7,8,false,32,21,-11,41.93258,-87.63642
TA1309000036,7,8,false,11,6,-5,41.93313,-87.64776
TA1307000006,7,8,false,19,9,-10,41.93571,-87.6636
TA1307000052,7,8,false,22,4,-18,41.93628,-87.65266
TA1307000136,7,8,false,9,10,1,41.9365,-87.64755
TA1307000041,7,8,false,39,25,-14,41.93669,-87.63683
13137,7,8,false,40,26,-14,41.9376,-87.6441
TA1309000042,7,8,false,5,16,11,41.93937,-87.66836
13229,7,8,false,11,7,-4,41.93946,-87.66376
TA1308000019,7,8,false,15,15,0,41.93973,-87.65886
13277,7,8,false,12,17,5,41.9401,-87.64546
TA1307000134,7,8,false,18,19,1,41.94016,-87.65303
TA1309000049,7,8,false,44,36,-8,41.94077,-87.63919
TA1307000138,7,8,false,8,10,2,41.94334,-87.67094
TA1309000025,7,8,false,11,9,-2,41.94368,-87.64894
13071,7,8,false,10,17,7,41.94373,-87.66401
632,7,8,false,16,18,2,41.94453,-87.6547
15631,7,8,false,11,2,-9,41.94524,-87.70665
13278,7,8,false,38,19,-19,41.94553,-87.64644
15632,7,8,false,1,10,9,41.94664,-87.69463
13235,7,8,false,10,16,6,41.94814,-87.66396
13325,7,8,false,10,15,5,41.94907,-87.64863
TA1307000126,7,8,false,12,11,-1,41.94936,-87.65451
TA1307000150,7,8,false,24,17,-7,41.94945,-87.64646
13319,7,8,false,7,14,7,41.95069,-87.6687
TA1307000127,7,8,false,11,12,1,41.9508,-87.65918
13323,7,8,false,7,13,6,41.95282,-87.65
TA1309000043,7,8,false,14,6,-8,41.95417,-87.66434
13063,7,8,false,15,11,-4,41.95424,-87.65441
TA1308000022,7,8,false,27,15,-12,41.95438,-87.64805
TA1308000047,7,8,false,10,3,-7,41.95709,-87.6642
13379,7,8,false,28,7,-21,41.95786,-87.6495
TA1309000027,7,8,false,20,11,-9,41.9585,-87.65499
13389,7,8,false,16,11,-5,41.961,-87.64958
TA1307000107,7,8,false,15,13,-2,41.96164,-87.65464
TA1308000012,7,8,false,21,31,10,41.96398,-87.63818
13074,7,8,false,10,3,-7,41.96521,-87.6582
639,7,8,false,20,15,-5,41.96584,-87.64538
TA1309000014,7,8,false,16,2,-14,41.96709,-87.66744
TA1307000119,7,8,false,14,7,-7,41.96796,-87.65
TA1308000021,7,8,false,10,5,-5,41.96883,-87.65765
TA1309000066,7,8,false,15,10,-5,41.9691,-87.67423
TA1309000041,7,8,false,14,4,-10,41.96951,-87.65471
KA1504000171,7,8,false,20,12,-8,41.97161,-87.65016
TA1309000035,7,8,false,6,12,6,41.97335,-87.66785
13108,7,8,false,10,3,-7,41.97379,-87.65971
KA1504000146,7,8,false,8,10,2,41.978,-87.66805
13109,7,8,false,4,11,7,41.97835,-87.65976
KA1504000152,7,8,false,23,19,-4,41.98403,-87.65231
15575,7,8,false,12,6,-6,41.98975,-87.66014
596,7,8,false,16,9,-7,42.04822,-87.68348
E008,7,8,false,10,1,-9,42.05049,-87.67782
KA1503000014,7,8,true,36,7,-29,41.7851,-87.60108
KA1503000070,7,8,true,10,5,-5,41.78794,-87.58831
KA1503000071,7,8,true,9,16,7,41.79148,-87.59988
TA1309000063,7,8,true,8,17,9,41.79325,-87.5878
KA1504000076,7,8,true,9,28,19,41.7943,-87.60145
TA1308000009,7,8,true,20,17,-3,41.79522,-87.58075
TA1307000164,7,8,true,13,12,-1,41.79527,-87.59647
KA1503000052,7,8,true,14,4,-10,41.79935,-87.60097
TA1309000037,7,8,true,20,15,-5,41.79957,-87.59474
KA1503000007,7,8,true,19,4,-15,41.80242,-87.58689
13398,7,8,true,12,6,-6,41.80256,-87.59035
TA1308000035,7,8,true,10,8,-2,41.80944,-87.59188
TA1308000045,7,8,true,13,2,-11,41.83062,-87.64129
13345,7,8,true,1,10,9,41.83138,-87.61803
13216,7,8,true,17,33,16,41.83473,-87.62581
148,7,8,true,3,13,10,41.83474,-87.62581
13215,7,8,true,13,4,-9,41.83634,-87.6135
TA1309000055,7,8,true,11,5,-6,41.8382,-87.64514
KA1503000038,7,8,true,11,8,-3,41.83845,-87.6354
TA1307000048,7,8,true,31,43,12,41.83855,-87.60821
237,7,8,true,14,2,-12,41.84204,-87.61697
TA1307000139,7,8,true,36,10,-26,41.84205,-87.61698
TA1307000005,7,8,true,14,2,-12,41.84569,-87.6225
TA1305000001,7,8,true,2,10,8,41.85262,-87.6265
13075,7,8,true,3,11,8,41.8531,-87.63192
15545,7,8,true,58,56,-2,41.85627,-87.61334
13102,7,8,true,28,11,-17,41.85762,-87.61942
13150,7,8,true,21,13,-8,41.85783,-87.62455
SL-012,7,8,true,11,11,0,41.86038,-87.62581
72,7,8,true,10,4,-6,41.86039,-87.62581
TA1306000002,7,8,true,20,16,-4,41.86238,-87.65108
TA1307000124,7,8,true,37,14,-23,41.86411,-87.62372
TA1309000001,7,8,true,11,6,-5,41.86488,-87.64708
13029,7,8,true,4,10,6,41.86531,-87.6179
13431,7,8,true,41,51,10,41.8661,-87.60728
WL-008,7,8,true,5,26,21,41.86712,-87.64108
TA1305000002,7,8,true,48,40,-8,41.86721,-87.62597
59,7,8,true,6,20,14,41.86721,-87.62597
15544,7,8,true,21,29,8,41.86723,-87.61536
TA1305000017,7,8,true,3,15,12,41.86734,-87.64863
SL-005,7,8,true,51,40,-11,41.8679,-87.62304
255,7,8,true,19,6,-13,41.86791,-87.62304
13139,7,8,true,10,4,-6,41.86893,-87.65913
13160,7,8,true,14,11,-3,41.86947,-87.65548
15550,7,8,true,2,26,24,41.87024,-87.63947
TA1309000010,7,8,true,32,31,-1,41.87074,-87.62574
SL-009,7,8,true,14,9,-5,41.87081,-87.63121
TA1309000064,7,8,true,2,12,10,41.87127,-87.67369
TA1307000130,7,8,true,14,8,-6,41.87178,-87.65103
SL-008,7,8,true,41,24,-17,41.87209,-87.62956
13332,7,8,true,38,14,-24,41.87219,-87.6615
SL-011,7,8,true,26,16,-10,41.87256,-87.63356
623,7,8,true,25,39,14,41.87272,-87.62399
KA1504000104,7,8,true,16,15,-1,41.87296,-87.66912
SL-007,7,8,true,9,10,1,41.87404,-87.6277
TA1306000025,7,8,true,19,6,-13,41.87464,-87.65703
SL-010,7,8,true,22,12,-10,41.87501,-87.63309
15541,7,8,true,16,30,14,41.8758,-87.62086
13138,7,8,true,2,10,8,41.87723,-87.63941
15539,7,8,true,20,4,-16,41.87763,-87.64405
13158,7,8,true,25,12,-13,41.87764,-87.64957
13157,7,8,true,16,35,19,41.87773,-87.6548
TA1305000025,7,8,true,26,9,-17,41.87773,-87.63528
13206,7,8,true,6,12,6,41.87794,-87.66201
638,7,8,true,12,34,22,41.87827,-87.64078
13011,7,8,true,8,52,44,41.87931,-87.63993
TA1309000007,7,8,true,6,12,6,41.88022,-87.63526
WL-011,7,8,true,45,30,-15,41.88034,-87.64273
13156,7,8,true,27,49,22,41.88042,-87.65554
13300,7,8,true,54,68,14,41.88097,-87.61675
13008,7,8,true,25,18,-7,41.88105,-87.62408
TA1305000006,7,8,true,10,21,11,41.88122,-87.6296
198,7,8,true,3,17,14,41.88187,-87.6488
TA1307000120,7,8,true,33,54,21,41.88188,-87.64879
13341,7,8,true,8,17,9,41.88208,-87.63985
13036,7,8,true,11,13,2,41.8821,-87.62513
TA1305000032,7,8,true,24,36,12,41.88218,-87.64109
13006,7,8,true,5,10,5,41.88268,-87.63252
13353,7,8,true,16,15,-1,41.88283,-87.6612
13409,7,8,true,12,10,-2,41.8831,-87.6511
WL-012,7,8,true,4,12,8,41.88337,-87.6412
13053,7,8,true,12,24,12,41.88365,-87.64863
13001,7,8,true,24,20,-4,41.88397,-87.62459
13155,7,8,true,7,12,5,41.88407,-87.65689
18062,7,8,true,12,22,10,41.88412,-87.65427
TA1306000010,7,8,true,12,8,-4,41.88419,-87.62961
TA1305000030,7,8,true,11,17,6,41.88459,-87.63178
15535,7,8,true,22,8,-14,41.8846,-87.64455
TA1305000029,7,8,true,16,11,-5,41.88466,-87.62787
195,7,8,true,12,4,-8,41.88466,-87.61952
13263,7,8,true,48,21,-27,41.88467,-87.61952
TA1306000015,7,8,true,10,20,10,41.88549,-87.65232
13021,7,8,true,19,9,-10,41.88559,-87.64184
TA1307000111,7,8,true,20,13,-7,41.88582,-87.63548
KA1503000012,7,8,true,22,19,-3,41.88599,-87.63089
52,7,8,true,1,12,11,41.886,-87.62421
TA1305000011,7,8,true,13,17,4,41.886,-87.62418
15534,7,8,true,23,10,-13,41.88627,-87.61749
TA1308000029,7,8,true,38,13,-25,41.88673,-87.62225
TA1307000131,7,8,true,13,10,-3,41.88688,-87.62606
KA1503000064,7,8,true,29,43,14,41.88697,-87.61281
100,7,8,true,11,2,-9,41.88814,-87.63657
TA1305000022,7,8,true,26,9,-17,41.88817,-87.63656
56,7,8,true,15,2,-13,41.88866,-87.64442
TA1306000003,7,8,true,57,44,-13,41.88867,-87.64442
KA1503000043,7,8,true,58,64,6,41.88918,-87.63851
133,7,8,true,7,19,12,41.88918,-87.63851
13050,7,8,true,17,32,15,41.88919,-87.62775
TA1307000151,7,8,true,23,21,-2,41.88993,-87.63427
636,7,8,true,24,25,1,41.88997,-87.63662
13427,7,8,true,14,11,-3,41.89054,-87.62205
13430,7,8,true,11,13,2,41.89077,-87.63169
TA1306000013,7,8,true,48,39,-9,41.89083,-87.61852
RN-,7,8,true,25,26,1,41.89102,-87.63546
13434,7,8,true,18,3,-15,41.89108,-87.66663
TA1307000117,7,8,true,20,21,1,41.89144,-87.62675
13033,7,8,true,24,16,-8,41.8916,-87.64835
13194,7,8,true,31,7,-24,41.8918,-87.65878
TA1305000003,7,8,true,30,21,-9,41.89187,-87.62061
13022,7,8,true,58,54,-4,41.89227,-87.61205
TA1306000029,7,8,true,47,14,-33,41.89256,-87.61449
13265,7,8,true,51,16,-35,41.89383,-87.64172
13045,7,8,true,39,52,13,41.89403,-87.62931
110,7,8,true,12,9,-3,41.89406,-87.6293
13016,7,8,true,26,18,-8,41.89431,-87.62277
KA1503000041,7,8,true,54,23,-31,41.89452,-87.61798
13196,7,8,true,10,9,-1,41.89455,-87.65345
TA1307000062,7,8,true,9,22,13,41.89466,-87.63839
TA1306000012,7,8,true,46,34,-12,41.89475,-87.63438
53,7,8,true,11,7,-4,41.89476,-87.63439
KP1705001026,7,8,true,13,39,26,41.89483,-87.6323
637,7,8,true,24,8,-16,41.89563,-87.67209
13132,7,8,true,17,16,-1,41.89573,-87.67718
15530,7,8,true,30,14,-16,41.89575,-87.62596
18003,7,8,true,22,12,-10,41.89575,-87.62011
13247,7,8,true,14,15,1,41.89597,-87.66775
TA1305000020,7,8,true,19,23,4,41.89636,-87.65406
13289,7,8,true,29,9,-20,41.89638,-87.661
13303,7,8,true,23,31,8,41.89672,-87.63088
13017,7,8,true,14,18,4,41.89676,-87.6357
13338,7,8,true,28,24,-4,41.89697,-87.62173
TA1307000061,7,8,true,23,20,-3,41.89745,-87.62873
13034,7,8,true,15,19,4,41.89754,-87.62352
TA1306000009,7,8,true,30,13,-17,41.89772,-87.64299
620,7,8,true,11,11,0,41.89817,-87.63754
KA1504000103,7,8,true,15,4,-11,41.89842,-87.68659
15529,7,8,true,29,13,-16,41.89858,-87.62206
140,7,8,true,9,13,4,41.89895,-87.6299
TA1307000128,7,8,true,32,20,-12,41.89896,-87.6299
657,7,8,true,13,3,-10,41.89918,-87.6722
13248,7,8,true,21,13,-8,41.89964,-87.66788
TA1306000011,7,8,true,9,11,2,41.89994,-87.63443
KA1504000116,7,8,true,17,16,-1,41.90023,-87.64299
13290,7,8,true,25,2,-23,41.90069,-87.66259
13042,7,8,true,48,59,11,41.90097,-87.62377
TA1307000070,7,8,true,13,3,-10,41.90133,-87.67742
KA1504000133,7,8,true,28,54,26,41.90234,-87.62773
176,7,8,true,11,10,-1,41.90291,-87.63141
TA1306000006,7,8,true,13,5,-8,41.90292,-87.63772
TA1307000039,7,8,true,55,73,18,41.90294,-87.63137
TA1305000034,7,8,true,18,14,-4,41.90313,-87.67391
KA1504000135,7,8,true,29,27,-2,41.90319,-87.63439
13136,7,8,true,13,21,8,41.90326,-87.67845
210,7,8,true,12,4,-8,41.90342,-87.66781
13061,7,8,true,21,16,-5,41.90342,-87.66779
KA1504000079,7,8,true,8,27,19,41.9035,-87.64334
TA1307000115,7,8,true,11,10,-1,41.9046,-87.64056
TA1308000049,7,8,true,25,14,-11,41.90672,-87.6349
KA1504000134,7,8,true,39,12,-27,41.90687,-87.6262
13224,7,8,true,16,7,-9,41.90706,-87.66725
TA1307000143,7,8,true,11,4,-7,41.90762,-87.63854
13221,7,8,true,15,26,11,41.90765,-87.67254
301,7,8,true,13,8,-5,41.90796,-87.63203
TA1309000024,7,8,true,45,42,-3,41.908,-87.63152
TA1305000041,7,8,true,18,45,27,41.9094,-87.67769
331,7,8,true,22,42,20,41.90965,-87.64812
TA1305000037,7,8,true,10,16,6,41.91018,-87.67003
TA1306000008,7,8,true,18,11,-7,41.9102,-87.6435
13257,7,8,true,10,3,-7,41.91054,-87.68956
13154,7,8,true,18,28,10,41.91054,-87.65312
20,7,8,true,3,15,12,41.91055,-87.65313
13058,7,8,true,21,12,-9,41.91059,-87.64942
118,7,8,true,10,4,-6,41.91138,-87.63868
TA1307000038,7,8,true,28,26,-2,41.91138,-87.63868
268,7,8,true,12,3,-9,41.91172,-87.62681
LF-005,7,8,true,59,61,2,41.91172,-87.62681
13128,7,8,true,14,7,-7,41.91197,-87.63197
289,7,8,true,16,11,-5,41.91209,-87.63472
TA1308000050,7,8,true,64,74,10,41.91211,-87.6347
13243,7,8,true,15,24,9,41.91262,-87.6814
TA1309000032,7,8,true,1,15,14,41.91293,-87.66417
TA1306000032,7,8,true,38,17,-21,41.9137,-87.65285
TA1307000166,7,8,true,19,18,-1,41.91386,-87.64877
15655,7,8,true,10,2,-8,41.91401,-87.70514
18067,7,8,true,15,11,-4,41.9146,-87.66796
TA1306000007,7,8,true,12,13,1,41.91469,-87.64333
13068,7,8,true,12,7,-5,41.91554,-87.68703
13179,7,8,true,36,40,4,41.9157,-87.63461
141,7,8,true,11,8,-3,41.91571,-87.63461
13133,7,8,true,10,7,-3,41.91598,-87.67733
15650,7,8,true,12,5,-7,41.91711,-87.71023
TA1309000029,7,8,true,11,8,-3,41.9178,-87.68245
TA1309000006,7,8,true,12,11,-1,41.91809,-87.64375
TA1307000163,7,8,true,22,17,-5,41.91821,-87.65696
13146,7,8,true,43,28,-15,41.91831,-87.63629
13059,7,8,true,15,20,5,41.91845,-87.65222
13259,7,8,true,14,1,-13,41.91852,-87.69744
13192,7,8,true,19,25,6,41.91995,-87.64884
13288,7,8,true,15,9,-6,41.92008,-87.67788
TA1309000030,7,8,true,16,28,12,41.92077,-87.66372
TA1309000033,7,8,true,36,24,-12,41.92158,-87.65381
13193,7,8,true,34,43,9,41.92182,-87.64412
13191,7,8,true,36,18,-18,41.92217,-87.63891
13084,7,8,true,18,2,-16,41.92268,-87.69715
LP-,7,8,true,23,10,-13,41.92396,-87.63584
TA1307000001,7,8,true,20,39,19,41.92535,-87.66581
188,7,8,true,6,10,4,41.92536,-87.66581
TA1306000026,7,8,true,9,22,13,41.92558,-87.65842
TA1306000016,7,8,true,15,24,9,41.9256,-87.65371
313,7,8,true,11,2,-9,41.9257,-87.64246
TA1309000019,7,8,true,53,26,-27,41.92586,-87.63897
TA1309000058,7,8,true,22,26,4,41.92591,-87.64927
TA1308000001,7,8,true,58,65,7,41.92627,-87.63086
177,7,8,true,7,19,12,41.92627,-87.63086
13124,7,8,true,12,14,2,41.92675,-87.63444
TA1309000023,7,8,true,14,22,8,41.9287,-87.65383
TA1307000113,7,8,true,14,12,-2,41.92878,-87.66391
13296,7,8,true,10,9,-1,41.92883,-87.66852
TA1309000059,7,8,true,15,12,-3,41.92889,-87.65898
TA1309000061,7,8,true,25,29,4,41.92915,-87.64909
TA1305000014,7,8,true,51,41,-10,41.92956,-87.64313
13085,7,8,true,10,5,-5,41.92958,-87.70789
TA1307000142,7,8,true,19,22,3,41.93125,-87.64432
13276,7,8,true,31,21,-10,41.93132,-87.63874
13271,7,8,true,4,11,7,41.93192,-87.67784
TA1307000064,7,8,true,17,26,9,41.93222,-87.65864
TA1306000014,7,8,true,21,30,9,41.93242,-87.65271
TA1309000039,7,8,true,37,40,3,41.93258,-87.63642
TA1309000036,7,8,true,32,30,-2,41.93313,-87.64776
TA1307000006,7,8,true,12,13,1,41.93571,-87.6636
TA1307000052,7,8,true,26,28,2,41.93628,-87.65266
TA1307000136,7,8,true,18,25,7,41.9365,-87.64755
TA1307000041,7,8,true,64,40,-24,41.93669,-87.63683
157,7,8,true,19,11,-8,41.9367,-87.63683
13137,7,8,true,61,58,-3,41.9376,-87.6441
300,7,8,true,14,11,-3,41.93761,-87.6441
KA17018068,7,8,true,11,2,-9,41.93935,-87.68327
TA1309000042,7,8,true,12,22,10,41.93937,-87.66836
13229,7,8,true,9,11,2,41.93946,-87.66376
TA1308000019,7,8,true,14,24,10,41.93973,-87.65886
13277,7,8,true,22,25,3,41.9401,-87.64546
TA1307000134,7,8,true,26,24,-2,41.94016,-87.65303
334,7,8,true,14,6,-8,41.94076,-87.63919
TA1309000049,7,8,true,42,35,-7,41.94077,-87.63919
TA1307000138,7,8,true,9,10,1,41.94334,-87.67094
TA1309000025,7,8,true,23,24,1,41.94368,-87.64894
13071,7,8,true,29,26,-3,41.94373,-87.66401
632,7,8,true,39,33,-6,41.94453,-87.6547
303,7,8,true,15,7,-8,41.94522,-87.64702
15631,7,8,true,4,10,6,41.94524,-87.70665
13278,7,8,true,64,37,-27,41.94553,-87.64644
TA1309000050,7,8,true,5,10,5,41.94618,-87.67331
13235,7,8,true,30,26,-4,41.94814,-87.66396
304,7,8,true,2,12,10,41.94878,-87.64922
13253,7,8,true,16,8,-8,41.9488,-87.67527
13325,7,8,true,35,41,6,41.94907,-87.64863
TA1307000126,7,8,true,20,14,-6,41.94936,-87.65451
232,7,8,true,15,7,-8,41.94943,-87.64645
TA1307000150,7,8,true,82,41,-41,41.94945,-87.64646
13319,7,8,true,18,27,9,41.95069,-87.6687
TA1307000127,7,8,true,17,13,-4,41.9508,-87.65918
13323,7,8,true,26,22,-4,41.95282,-87.65
TA1309000043,7,8,true,18,15,-3,41.95417,-87.66434
13063,7,8,true,22,48,26,41.95424,-87.65441
TA1308000022,7,8,true,27,14,-13,41.95438,-87.64805
TA1307000149,7,8,true,4,11,7,41.95467,-87.67392
13249,7,8,true,10,3,-7,41.95606,-87.66885
13379,7,8,true,36,15,-21,41.95786,-87.6495
TA1309000018,7,8,true,3,13,10,41.95791,-87.67357
TA1309000027,7,8,true,23,14,-9,41.9585,-87.65499
13389,7,8,true,38,12,-26,41.961,-87.64958
15623,7,8,true,7,14,7,41.96154,-87.69117
TA1307000107,7,8,true,55,34,-21,41.96164,-87.65464
TA1307000156,7,8,true,7,13,6,41.96301,-87.68479
TA1309000012,7,8,true,10,9,-1,41.96325,-87.67928
TA1308000012,7,8,true,24,37,13,41.96398,-87.63818
13074,7,8,true,18,24,6,41.96521,-87.6582
639,7,8,true,47,51,4,41.96584,-87.64538
KA1504000093,7,8,true,11,6,-5,41.96587,-87.69365
TA1307000140,7,8,true,5,17,12,41.96643,-87.68865
TA1309000014,7,8,true,27,17,-10,41.96709,-87.66744
TA1307000158,7,8,true,30,5,-25,41.9671,-87.67904
TA1307000119,7,8,true,16,12,-4,41.96796,-87.65
TA1308000021,7,8,true,16,7,-9,41.96883,-87.65765
TA1309000066,7,8,true,18,35,17,41.9691,-87.67423
KA1504000171,7,8,true,26,10,-16,41.97161,-87.65016
TA1309000035,7,8,true,23,13,-10,41.97335,-87.66785
13108,7,8,true,14,4,-10,41.97379,-87.65971
KA1504000149,7,8,true,14,4,-10,41.97562,-87.67945
KA1504000146,7,8,true,10,18,8,41.978,-87.66805
13109,7,8,true,13,9,-4,41.97835,-87.65976
KA1504000151,7,8,true,19,8,-11,41.98359,-87.66916
KA1504000152,7,8,true,70,64,-6,41.98403,-87.65231
15578,7,8,true,12,10,-2,41.98405,-87.66027
15575,7,8,true,10,15,5,41.98975,-87.66014
15571,7,8,true,28,9,-19,41.99478,-87.66028
KA1504000175,7,8,true,15,4,-11,42.00797,-87.66549
KA1504000159,7,8,true,12,3,-9,42.01059,-87.66241
525,7,8,true,36,4,-32,42.01272,-87.66605
520,7,8,true,3,32,29,42.01597,-87.66859
E002,7,8,true,18,9,-9,42.03256,-87.67912
599,7,8,true,1,20,19,42.03972,-87.69942
596,7,8,true,4,10,6,42.04822,-87.68348
KA1503000002,7,12,false,13,14,1,41.76641,-87.5657
KA1503000029,7,12,false,14,9,-5,41.77364,-87.56747
KA1503000046,7,12,false,10,8,-2,41.78041,-87.59141
KA1503000054,7,12,false,8,11,3,41.78061,-87.60582
15491,7,12,false,31,55,24,41.78096,-87.57624
KA1503000014,7,12,false,39,18,-21,41.7851,-87.60108
426,7,12,false,3,11,8,41.7851,-87.60108
KA1503000070,7,12,false,16,6,-10,41.78794,-87.58831
TA1309000011,7,12,false,14,14,0,41.78873,-87.60131
KA1503000071,7,12,false,45,30,-15,41.79148,-87.59988
KA1503000074,7,12,false,54,95,41,41.79174,-87.58395
TA1309000063,7,12,false,26,20,-6,41.79325,-87.5878
KA1504000076,7,12,false,23,18,-5,41.7943,-87.60145
247,7,12,false,6,11,5,41.79522,-87.58077
TA1308000009,7,12,false,73,81,8,41.79522,-87.58075
TA1307000164,7,12,false,44,23,-21,41.79527,-87.59647
KA1503000052,7,12,false,19,18,-1,41.79935,-87.60097
KA1503000059,7,12,false,37,44,7,41.79952,-87.58643
419,7,12,false,1,12,11,41.79952,-87.58643
TA1309000037,7,12,false,43,34,-9,41.79957,-87.59474
KA1503000007,7,12,false,30,24,-6,41.80242,-87.58689
13398,7,12,false,19,5,-14,41.80256,-87.59035
KA1503000069,7,12,false,16,6,-10,41.80579,-87.59247
TA1308000035,7,12,false,17,15,-2,41.80944,-87.59188
TA1308000002,7,12,false,18,3,-15,41.80983,-87.59937
TA1308000007,7,12,false,16,15,-1,41.80984,-87.61628
TA1308000038,7,12,false,9,14,5,41.82298,-87.6071
TA1308000043,7,12,false,14,4,-10,41.83066,-87.64715
KA1503000005,7,12,false,3,28,25,41.83079,-87.6325
TA1307000129,7,12,false,16,25,9,41.83104,-87.62683
KA1503000004,7,12,false,39,23,-16,41.83127,-87.6088
15445,7,12,false,7,19,12,41.83453,-87.63183
13216,7,12,false,19,13,-6,41.83473,-87.62581
13217,7,12,false,11,4,-7,41.83488,-87.61792
13215,7,12,false,25,8,-17,41.83634,-87.6135
TA1309000055,7,12,false,14,11,-3,41.8382,-87.64514
150,7,12,false,13,12,-1,41.83855,-87.60821
TA1307000048,7,12,false,72,71,-1,41.83855,-87.60821
TA1308000036,7,12,false,14,11,-3,41.83883,-87.62186
TA1307000139,7,12,false,19,17,-2,41.84205,-87.61698
TA1307000153,7,12,false,4,12,8,41.84358,-87.64538
TA1307000005,7,12,false,15,6,-9,41.84569,-87.6225
TA1308000014,7,12,false,1,10,9,41.84953,-87.64059
TA1308000026,7,12,false,5,17,12,41.85008,-87.63214
TA1305000004,7,12,false,40,18,-22,41.8514,-87.61884
TA1305000001,7,12,false,35,15,-20,41.85262,-87.6265
13075,7,12,false,85,84,-1,41.8531,-87.63192
120,7,12,false,3,11,8,41.8531,-87.63191
13162,7,12,false,10,12,2,41.85378,-87.64659
15546,7,12,false,38,15,-23,41.85416,-87.61916
13307,7,12,false,12,8,-4,41.85489,-87.66359
13089,7,12,false,11,17,6,41.85497,-87.67567
15545,7,12,false,98,117,19,41.85627,-87.61334
SL-013,7,12,false,12,14,2,41.85659,-87.62755
SL-006,7,12,false,39,29,-10,41.8568,-87.63387
13135,7,12,false,25,21,-4,41.85753,-87.66157
338,7,12,false,11,8,-3,41.85758,-87.61956
13102,7,12,false,55,54,-1,41.85762,-87.61942
13150,7,12,false,41,30,-11,41.85783,-87.62455
273,7,12,false,10,2,-8,41.85783,-87.62455
13099,7,12,false,9,12,3,41.85784,-87.64627
TA1307000159,7,12,false,11,20,9,41.8579,-87.6687
TA1307000044,7,12,false,13,11,-2,41.85794,-87.64083
13163,7,12,false,26,17,-9,41.85808,-87.65108
13164,7,12,false,32,25,-7,41.85818,-87.65648
SL-012,7,12,false,36,28,-8,41.86038,-87.62581
13304,7,12,false,18,6,-12,41.86126,-87.65659
KA1504000109,7,12,false,3,10,7,41.86192,-87.69347
TA1307000124,7,12,false,57,56,-1,41.86411,-87.62372
168,7,12,false,7,12,5,41.86415,-87.62372
TA1309000001,7,12,false,30,17,-13,41.86488,-87.64708
97,7,12,false,12,3,-9,41.86531,-87.6179
13029,7,12,false,97,91,-6,41.86531,-87.6179
341,7,12,false,8,18,10,41.86608,-87.60733
13431,7,12,false,169,195,26,41.8661,-87.60728
WL-008,7,12,false,42,39,-3,41.86712,-87.64108
57,7,12,false,2,11,9,41.86712,-87.64107
TA1305000002,7,12,false,117,79,-38,41.86721,-87.62597
59,7,12,false,22,17,-5,41.86721,-87.62597
15544,7,12,false,435,439,4,41.86723,-87.61536
3,7,12,false,30,44,14,41.86723,-87.61536
KA1706005007,7,12,false,30,22,-8,41.86749,-87.63219
SL-005,7,12,false,234,201,-33,41.8679,-87.62304
255,7,12,false,30,23,-7,41.86791,-87.62304
644,7,12,false,14,3,-11,41.86859,-87.68625
13139,7,12,false,16,10,-6,41.86893,-87.65913
13160,7,12,false,26,24,-2,41.86947,-87.65548
15550,7,12,false,27,26,-1,41.87024,-87.63947
TA1309000010,7,12,false,87,64,-23,41.87074,-87.62574
SL-009,7,12,false,50,23,-27,41.87081,-87.63121
TA1309000064,7,12,false,16,7,-9,41.87127,-87.67369
15542,7,12,false,8,11,3,41.87146,-87.64095
TA1307000130,7,12,false,7,15,8,41.87178,-87.65103
41,7,12,false,11,7,-4,41.87209,-87.62957
SL-008,7,12,false,74,52,-22,41.87209,-87.62956
13332,7,12,false,27,24,-3,41.87219,-87.6615
175,7,12,false,5,12,7,41.87255,-87.63359
SL-011,7,12,false,38,46,8,41.87256,-87.63356
623,7,12,false,156,105,-51,41.87272,-87.62399
SL-007,7,12,false,36,33,-3,41.87404,-87.6277
13326,7,12,false,11,9,-2,41.87425,-87.63958
321,7,12,false,2,16,14,41.87427,-87.63257
TA1306000025,7,12,false,14,4,-10,41.87464,-87.65703
13028,7,12,false,22,10,-12,41.87475,-87.64981
13081,7,12,false,11,5,-6,41.87501,-87.67326
SL-010,7,12,false,33,17,-16,41.87501,-87.63309
15541,7,12,false,187,120,-67,41.8758,-87.62086
13037,7,12,false,20,11,-9,41.87588,-87.64078
TA1305000009,7,12,false,15,11,-4,41.87593,-87.63068
TA1305000010,7,12,false,71,53,-18,41.87623,-87.62444
624,7,12,false,71,43,-28,41.87626,-87.62923
2,7,12,false,7,15,8,41.87649,-87.62051
TA1305000035,7,12,false,29,20,-9,41.87716,-87.62787
13138,7,12,false,16,9,-7,41.87723,-87.63941
631,7,12,false,14,8,-6,41.87761,-87.6739
15539,7,12,false,50,35,-15,41.87763,-87.64405
13158,7,12,false,58,50,-8,41.87764,-87.64957
13157,7,12,false,40,27,-13,41.87773,-87.6548
TA1305000025,7,12,false,52,46,-6,41.87773,-87.63528
36,7,12,false,15,3,-12,41.87776,-87.63525
TA1309000002,7,12,false,141,101,-40,41.87784,-87.62408
284,7,12,false,9,11,2,41.87784,-87.62408
13206,7,12,false,31,18,-13,41.87794,-87.66201
TA1309000004,7,12,false,24,7,-17,41.87811,-87.63184
638,7,12,false,51,34,-17,41.87827,-87.64078
TA1305000005,7,12,false,28,31,3,41.87924,-87.62975
13011,7,12,false,48,42,-6,41.87931,-87.63993
TA1309000008,7,12,false,53,37,-16,41.87933,-87.6355
KA1503000034,7,12,false,19,7,-12,41.87938,-87.63197
39,7,12,false,13,11,-2,41.87948,-87.62571
KA1503000015,7,12,false,53,35,-18,41.87948,-87.6257
15667,7,12,false,10,10,0,41.8798,-87.68609
TA1309000007,7,12,false,41,16,-25,41.88022,-87.63526
WL-011,7,12,false,31,15,-16,41.88034,-87.64273
13156,7,12,false,62,50,-12,41.88042,-87.65554
13300,7,12,false,581,549,-32,41.88097,-87.61675
76,7,12,false,68,68,0,41.88098,-87.61675
13008,7,12,false,461,490,29,41.88105,-87.62408
90,7,12,false,42,59,17,41.88107,-87.62409
49,7,12,false,7,13,6,41.88116,-87.62963
TA1305000006,7,12,false,78,56,-22,41.88122,-87.6296
13134,7,12,false,16,11,-5,41.88138,-87.67493
13056,7,12,false,40,26,-14,41.88168,-87.63951
198,7,12,false,12,9,-3,41.88187,-87.6488
TA1307000120,7,12,false,134,149,15,41.88188,-87.64879
13341,7,12,false,58,40,-18,41.88208,-87.63985
197,7,12,false,10,8,-2,41.88208,-87.62513
13036,7,12,false,95,80,-15,41.8821,-87.62513
TA1305000032,7,12,false,96,66,-30,41.88218,-87.64109
13006,7,12,false,50,28,-22,41.88268,-87.63252
13353,7,12,false,30,22,-8,41.88283,-87.6612
654,7,12,false,17,18,1,41.88307,-87.65698
13409,7,12,false,32,46,14,41.8831,-87.6511
KA1503000072,7,12,false,22,17,-5,41.88317,-87.63693
WL-012,7,12,false,59,44,-15,41.88337,-87.6412
112,7,12,false,12,14,2,41.88362,-87.6486
13053,7,12,false,148,165,17,41.88365,-87.64863
43,7,12,false,30,23,-7,41.88396,-87.62455
13001,7,12,false,202,187,-15,41.88397,-87.62459
13155,7,12,false,15,26,11,41.88407,-87.65689
18062,7,12,false,51,48,-3,41.88412,-87.65427
TA1306000010,7,12,false,77,57,-20,41.88419,-87.62961
TA1305000030,7,12,false,52,23,-29,41.88459,-87.63178
15535,7,12,false,74,48,-26,41.8846,-87.64455
96,7,12,false,6,18,12,41.8846,-87.64455
TA1305000029,7,12,false,118,113,-5,41.88466,-87.62787
195,7,12,false,22,24,2,41.88466,-87.61952
13263,7,12,false,153,98,-55,41.88467,-87.61952
44,7,12,false,21,19,-2,41.88468,-87.62782
TA1306000015,7,12,false,79,102,23,41.88549,-87.65232
518,7,12,false,21,15,-6,41.8855,-87.71686
71,7,12,false,11,23,12,41.8855,-87.65233
66,7,12,false,8,15,7,41.88557,-87.64186
13021,7,12,false,60,26,-34,41.88559,-87.64184
TA1307000111,7,12,false,51,41,-10,41.88582,-87.63548
13073,7,12,false,15,26,11,41.88592,-87.66717
KA1503000012,7,12,false,62,49,-13,41.88599,-87.63089
38,7,12,false,13,12,-1,41.88599,-87.63089
52,7,12,false,20,30,10,41.886,-87.62421
TA1305000011,7,12,false,131,120,-11,41.886,-87.62418
7,7,12,false,11,5,-6,41.88627,-87.61751
15534,7,12,false,89,58,-31,41.88627,-87.61749
13197,7,12,false,14,13,-1,41.8866,-87.65816
TA1308000029,7,12,false,66,53,-13,41.88673,-87.62225
194,7,12,false,13,14,1,41.88688,-87.62606
TA1307000131,7,12,false,98,100,2,41.88688,-87.62606
KA1503000064,7,12,false,287,227,-60,41.88697,-87.61281
6,7,12,false,36,26,-10,41.88697,-87.61281
TA1305000022,7,12,false,89,47,-42,41.88817,-87.63656
56,7,12,false,22,12,-10,41.88866,-87.64442
TA1306000003,7,12,false,99,80,-19,41.88867,-87.64442
KA1503000043,7,12,false,96,74,-22,41.88918,-87.63851
133,7,12,false,18,16,-2,41.88918,-87.63851
13050,7,12,false,130,125,-5,41.88919,-87.62775
47,7,12,false,8,18,10,41.88921,-87.62775
13432,7,12,false,10,12,2,41.88989,-87.67149
TA1307000151,7,12,false,94,115,21,41.88993,-87.63427
212,7,12,false,26,10,-16,41.88995,-87.63427
636,7,12,false,40,40,0,41.88997,-87.63662
KA1503000044,7,12,false,78,57,-21,41.89018,-87.6262
13427,7,12,false,66,61,-5,41.89054,-87.62205
26,7,12,false,14,14,0,41.89057,-87.61798
13430,7,12,false,133,145,12,41.89077,-87.63169
181,7,12,false,12,10,-2,41.89077,-87.63168
TA1306000013,7,12,false,226,159,-67,41.89083,-87.61852
RN-,7,12,false,86,68,-18,41.89102,-87.63546
672,7,12,false,12,8,-4,41.89102,-87.63545
13434,7,12,false,19,35,16,41.89108,-87.66663
TA1308000006,7,12,false,29,12,-17,41.89128,-87.67686
199,7,12,false,18,24,6,41.89143,-87.62676
TA1307000117,7,12,false,209,197,-12,41.89144,-87.62675
13033,7,12,false,96,86,-10,41.8916,-87.64835
84,7,12,false,8,11,3,41.89161,-87.64833
13194,7,12,false,59,37,-22,41.8918,-87.65878
TA1305000003,7,12,false,158,167,9,41.89187,-87.62061
24,7,12,false,10,20,10,41.8919,-87.62063
643,7,12,false,13,15,2,41.89203,-87.68939
35,7,12,false,38,52,14,41.89227,-87.61206
13022,7,12,false,1103,1219,116,41.89227,-87.61205
99,7,12,false,13,13,0,41.89255,-87.61449
TA1306000029,7,12,false,142,148,6,41.89256,-87.61449
13265,7,12,false,83,51,-32,41.89383,-87.64172
74,7,12,false,12,6,-6,41.89384,-87.64173
13045,7,12,false,128,125,-3,41.89403,-87.62931
110,7,12,false,22,27,5,41.89406,-87.6293
13016,7,12,false,108,121,13,41.89431,-87.62277
211,7,12,false,9,16,7,41.89439,-87.62267
KA1503000041,7,12,false,78,59,-19,41.89452,-87.61798
142,7,12,false,25,17,-8,41.89453,-87.61806
13196,7,12,false,70,33,-37,41.89455,-87.65345
TA1307000062,7,12,false,51,35,-16,41.89466,-87.63839
111,7,12,false,6,11,5,41.89466,-87.63837
TA1306000012,7,12,false,135,121,-14,41.89475,-87.63438
53,7,12,false,21,14,-7,41.89476,-87.63439
KP1705001026,7,12,false,100,60,-40,41.89483,-87.6323
18058,7,12,false,25,11,-14,41.8955,-87.68201
637,7,12,false,45,26,-19,41.89563,-87.67209
13132,7,12,false,75,73,-2,41.89573,-87.67718
161,7,12,false,17,16,-1,41.89574,-87.62599
15530,7,12,false,123,128,5,41.89575,-87.62596
18003,7,12,false,23,22,-1,41.89575,-87.62011
13247,7,12,false,56,34,-22,41.89597,-87.66775
TA1305000020,7,12,false,79,55,-24,41.89636,-87.65406
13289,7,12,false,62,39,-23,41.89638,-87.661
13303,7,12,false,61,40,-21,41.89672,-87.63088
13017,7,12,false,68,37,-31,41.89676,-87.6357
13338,7,12,false,92,81,-11,41.89697,-87.62173
173,7,12,false,11,26,15,41.89704,-87.62173
TA1307000061,7,12,false,48,43,-5,41.89745,-87.62873
106,7,12,false,12,5,-7,41.89746,-87.62874
25,7,12,false,8,17,9,41.89751,-87.62354
13034,7,12,false,92,112,20,41.89754,-87.62352
TA1306000009,7,12,false,61,22,-39,41.89772,-87.64299
620,7,12,false,38,37,-1,41.89817,-87.63754
KA1504000103,7,12,false,55,26,-29,41.89842,-87.68659
145,7,12,false,17,6,-11,41.89856,-87.62211
15529,7,12,false,79,83,4,41.89858,-87.62206
140,7,12,false,19,22,3,41.89895,-87.6299
TA1307000128,7,12,false,122,118,-4,41.89896,-87.6299
657,7,12,false,44,27,-17,41.89918,-87.6722
KA1504000117,7,12,false,16,6,-10,41.89936,-87.64848
13248,7,12,false,36,13,-23,41.89964,-87.66788
TA1306000011,7,12,false,50,31,-19,41.89994,-87.63443
KA1504000116,7,12,false,52,15,-37,41.90023,-87.64299
17660,7,12,false,47,12,-35,41.90036,-87.69671
13290,7,12,false,45,36,-9,41.90069,-87.66259
13042,7,12,false,544,563,19,41.90097,-87.62377
85,7,12,false,24,40,16,41.90098,-87.62375
TA1307000070,7,12,false,65,39,-26,41.90133,-87.67742
KA1504000133,7,12,false,121,124,3,41.90234,-87.62773
172,7,12,false,15,24,9,41.90236,-87.62774
15654,7,12,false,10,16,6,41.90271,-87.70923
13241,7,12,false,39,18,-21,41.9029,-87.68731
176,7,12,false,29,15,-14,41.90291,-87.63141
TA1306000006,7,12,false,29,11,-18,41.90292,-87.63772
TA1307000039,7,12,false,165,156,-9,41.90294,-87.63137
658,7,12,false,12,15,3,41.903,-87.6838
13256,7,12,false,26,17,-9,41.90302,-87.69749
17,7,12,false,12,8,-4,41.90313,-87.67391
TA1305000034,7,12,false,72,69,-3,41.90313,-87.67391
182,7,12,false,29,26,-3,41.90317,-87.63442
KA1504000135,7,12,false,158,151,-7,41.90319,-87.63439
13136,7,12,false,63,52,-11,41.90326,-87.67845
130,7,12,false,10,5,-5,41.90327,-87.67846
210,7,12,false,17,4,-13,41.90342,-87.66781
13061,7,12,false,109,95,-14,41.90342,-87.66779
KA1504000079,7,12,false,53,54,1,41.9035,-87.64334
TA1307000115,7,12,false,18,18,0,41.9046,-87.64056
291,7,12,false,17,16,-1,41.90672,-87.63494
TA1308000049,7,12,false,145,147,2,41.90672,-87.6349
KA1504000134,7,12,false,80,68,-12,41.90687,-87.6262
180,7,12,false,7,14,7,41.90687,-87.62618
13224,7,12,false,75,42,-33,41.90706,-87.66725
TA1307000143,7,12,false,35,23,-12,41.90762,-87.63854
61,7,12,false,7,16,9,41.90764,-87.67254
13221,7,12,false,94,114,20,41.90765,-87.67254
13245,7,12,false,17,6,-11,41.90777,-87.68586
301,7,12,false,10,13,3,41.90796,-87.63203
TA1309000024,7,12,false,100,97,-3,41.908,-87.63152
69,7,12,false,11,16,5,41.90939,-87.6777
TA1305000041,7,12,false,144,151,7,41.9094,-87.67769
331,7,12,false,111,137,26,41.90965,-87.64812
15653,7,12,false,17,19,2,41.90979,-87.7053
TA1305000037,7,12,false,58,56,-2,41.91018,-87.67003
TA1306000008,7,12,false,38,31,-7,41.9102,-87.6435
TA1308000005,7,12,false,44,48,4,41.91042,-87.68238
13258,7,12,false,24,23,-1,41.91043,-87.69718
13257,7,12,false,48,15,-33,41.91054,-87.68956
13154,7,12,false,48,59,11,41.91054,-87.65312
20,7,12,false,6,10,4,41.91055,-87.65313
13058,7,12,false,51,62,11,41.91059,-87.64942
TA1307000038,7,12,false,64,55,-9,41.91138,-87.63868
268,7,12,false,24,29,5,41.91172,-87.62681
LF-005,7,12,false,543,668,125,41.91172,-87.62681
126,7,12,false,16,14,-2,41.91196,-87.63197
13128,7,12,false,109,130,21,41.91197,-87.63197
289,7,12,false,18,27,9,41.91209,-87.63472
TA1308000050,7,12,false,250,252,2,41.91211,-87.6347
13243,7,12,false,84,70,-14,41.91262,-87.6814
158,7,12,false,9,10,1,41.91262,-87.6814
TA1306000032,7,12,false,58,53,-5,41.9137,-87.65285
224,7,12,false,10,3,-7,41.91386,-87.64877
TA1307000166,7,12,false,52,53,1,41.91386,-87.64877
15655,7,12,false,32,30,-2,41.91401,-87.70514
18017,7,12,false,43,26,-17,41.91416,-87.71676
641,7,12,false,10,4,-6,41.91416,-87.71676
18067,7,12,false,53,54,1,41.9146,-87.66796
TA1306000007,7,12,false,43,23,-20,41.91469,-87.64333
13068,7,12,false,53,29,-24,41.91554,-87.68703
13179,7,12,false,194,204,10,41.9157,-87.63461
141,7,12,false,18,21,3,41.91571,-87.63461
13133,7,12,false,73,67,-6,41.91598,-87.67733
219,7,12,false,6,11,5,41.91598,-87.67733
58,7,12,false,3,11,8,41.91602,-87.66894
TA1305000039,7,12,false,70,51,-19,41.9163,-87.66749
15650,7,12,false,18,20,2,41.91711,-87.71023
15651,7,12,false,41,40,-1,41.91752,-87.70181
13266,7,12,false,22,21,-1,41.91774,-87.69142
TA1309000029,7,12,false,32,14,-18,41.9178,-87.68245
TA1309000006,7,12,false,73,60,-13,41.91809,-87.64375
223,7,12,false,12,8,-4,41.91821,-87.65698
TA1307000163,7,12,false,68,60,-8,41.91821,-87.65696
94,7,12,false,36,19,-17,41.91831,-87.6363
13146,7,12,false,183,234,51,41.91831,-87.63629
13059,7,12,false,112,107,-5,41.91845,-87.65222
113,7,12,false,12,19,7,41.91846,-87.65222
13259,7,12,false,24,18,-6,41.91852,-87.69744
13192,7,12,false,114,105,-9,41.91995,-87.64884
13288,7,12,false,51,24,-27,41.92008,-87.67788
13242,7,12,false,22,23,1,41.92021,-87.69266
TA1309000030,7,12,false,44,52,8,41.92077,-87.66372
13292,7,12,false,11,32,21,41.92152,-87.70733
TA1309000033,7,12,false,100,92,-8,41.92158,-87.65381
13193,7,12,false,111,122,11,41.92182,-87.64412
144,7,12,false,15,15,0,41.92182,-87.64411
143,7,12,false,12,12,0,41.92217,-87.63891
13191,7,12,false,63,64,1,41.92217,-87.63891
327,7,12,false,11,10,-1,41.92225,-87.65783
13084,7,12,false,47,53,6,41.92268,-87.69715
LP-,7,12,false,170,188,18,41.92396,-87.63584
673,7,12,false,16,8,-8,41.92398,-87.63585
KA1504000140,7,12,false,28,14,-14,41.92409,-87.67646
15648,7,12,false,39,19,-20,41.92464,-87.68931
KA1504000090,7,12,false,18,32,14,41.92483,-87.7145
TA1307000001,7,12,false,77,55,-22,41.92535,-87.66581
TA1306000026,7,12,false,65,23,-42,41.92558,-87.65842
TA1306000016,7,12,false,82,60,-22,41.9256,-87.65371
67,7,12,false,8,10,2,41.9256,-87.65371
313,7,12,false,23,16,-7,41.9257,-87.64246
TA1309000019,7,12,false,199,189,-10,41.92586,-87.63897
TA1309000058,7,12,false,141,114,-27,41.92591,-87.64927
127,7,12,false,13,11,-2,41.92592,-87.64927
177,7,12,false,41,67,26,41.92627,-87.63086
TA1308000001,7,12,false,372,426,54,41.92627,-87.63086
15646,7,12,false,28,27,-1,41.92668,-87.6977
34,7,12,false,13,2,-11,41.92675,-87.63444
13124,7,12,false,94,149,55,41.92675,-87.63444
302,7,12,false,7,13,6,41.92859,-87.65421
TA1309000023,7,12,false,92,89,-3,41.9287,-87.65383
TA1307000113,7,12,false,68,78,10,41.92878,-87.66391
13296,7,12,false,53,33,-20,41.92883,-87.66852
TA1309000059,7,12,false,45,33,-12,41.92889,-87.65898
349,7,12,false,18,7,-11,41.92915,-87.6491
TA1309000061,7,12,false,96,65,-31,41.92915,-87.64909
TA1308000031,7,12,false,19,37,18,41.92946,-87.68417
TA1305000014,7,12,false,165,123,-42,41.92956,-87.64313
340,7,12,false,14,17,3,41.92956,-87.64313
260,7,12,false,18,32,14,41.92958,-87.70791
13085,7,12,false,92,112,20,41.92958,-87.70789
15643,7,12,false,23,12,-11,41.93057,-87.7238
TA1307000142,7,12,false,160,111,-49,41.93125,-87.64432
220,7,12,false,13,15,2,41.93125,-87.64431
13276,7,12,false,129,115,-14,41.93132,-87.63874
324,7,12,false,34,17,-17,41.93173,-87.64179
15645,7,12,false,7,10,3,41.93191,-87.70121
13271,7,12,false,33,25,-8,41.93192,-87.67784
TA1307000064,7,12,false,58,51,-7,41.93222,-87.65864
TA1306000014,7,12,false,107,68,-39,41.93242,-87.65271
13,7,12,false,15,5,-10,41.93242,-87.65271
TA1309000039,7,12,false,229,213,-16,41.93258,-87.63642
329,7,12,false,26,19,-7,41.93258,-87.63642
13294,7,12,false,53,22,-31,41.9326,-87.66595
TA1309000036,7,12,false,92,74,-18,41.93313,-87.64776
332,7,12,false,3,10,7,41.93313,-87.64776
TA1307000006,7,12,false,74,71,-3,41.93571,-87.6636
153,7,12,false,18,6,-12,41.93575,-87.66364
13268,7,12,false,33,27,-6,41.93588,-87.67843
13269,7,12,false,30,16,-14,41.93609,-87.66983
TA1307000052,7,12,false,94,84,-10,41.93628,-87.65266
156,7,12,false,7,14,7,41.9365,-87.64756
TA1307000136,7,12,false,81,73,-8,41.9365,-87.64755
TA1307000041,7,12,false,197,199,2,41.93669,-87.63683
157,7,12,false,14,13,-1,41.9367,-87.63683
13137,7,12,false,159,133,-26,41.9376,-87.6441
300,7,12,false,17,15,-2,41.93761,-87.6441
15642,7,12,false,20,16,-4,41.93843,-87.69801
KA17018068,7,12,false,28,10,-18,41.93935,-87.68327
TA1309000042,7,12,false,45,28,-17,41.93937,-87.66836
13229,7,12,false,56,48,-8,41.93946,-87.66376
226,7,12,false,11,10,-1,41.93972,-87.65886
TA1308000019,7,12,false,76,57,-19,41.93973,-87.65886
13277,7,12,false,108,94,-14,41.9401,-87.64546
296,7,12,false,15,17,2,41.9401,-87.64546
TA1307000134,7,12,false,141,162,21,41.94016,-87.65303
117,7,12,false,13,10,-3,41.94016,-87.65302
13143,7,12,false,27,19,-8,41.94059,-87.67853
334,7,12,false,19,27,8,41.94076,-87.63919
TA1309000049,7,12,false,204,179,-25,41.94077,-87.63919
15634,7,12,false,11,9,-2,41.94304,-87.68729
TA1307000138,7,12,false,39,55,16,41.94334,-87.67094
13144,7,12,false,42,30,-12,41.9434,-87.67964
299,7,12,false,13,15,2,41.94368,-87.64894
TA1309000025,7,12,false,123,140,17,41.94368,-87.64894
229,7,12,false,12,19,7,41.94372,-87.66401
13071,7,12,false,105,127,22,41.94373,-87.66401
632,7,12,false,184,193,9,41.94453,-87.6547
15631,7,12,false,11,12,1,41.94524,-87.70665
13278,7,12,false,100,92,-8,41.94553,-87.64644
TA1309000050,7,12,false,15,17,2,41.94618,-87.67331
15632,7,12,false,14,16,2,41.94664,-87.69463
KA1504000143,7,12,false,23,9,-14,41.94664,-87.68337
227,7,12,false,12,11,-1,41.94813,-87.66397
13235,7,12,false,121,102,-19,41.94814,-87.66396
13253,7,12,false,26,15,-11,41.9488,-87.67527
13325,7,12,false,98,94,-4,41.94907,-87.64863
114,7,12,false,9,12,3,41.94935,-87.65451
TA1307000126,7,12,false,85,183,98,41.94936,-87.65451
232,7,12,false,16,7,-9,41.94943,-87.64645
TA1307000150,7,12,false,156,146,-10,41.94945,-87.64646
347,7,12,false,4,11,7,41.95068,-87.6687
13319,7,12,false,59,46,-13,41.95069,-87.6687
TA1307000127,7,12,false,119,156,37,41.9508,-87.65918
165,7,12,false,15,10,-5,41.95081,-87.65918
15628,7,12,false,12,6,-6,41.95216,-87.69806
13323,7,12,false,75,68,-7,41.95282,-87.65
256,7,12,false,13,12,-1,41.95282,-87.65
15624,7,12,false,6,12,6,41.95339,-87.73199
KA1504000139,7,12,false,10,4,-6,41.954,-87.71909
TA1309000043,7,12,false,35,34,-1,41.95417,-87.66434
13063,7,12,false,96,70,-26,41.95424,-87.65441
240,7,12,false,14,10,-4,41.95424,-87.65441
KA1504000158,7,12,false,9,12,3,41.95432,-87.68607
254,7,12,false,6,11,5,41.95438,-87.64806
TA1308000022,7,12,false,81,82,1,41.95438,-87.64805
TA1307000149,7,12,false,22,22,0,41.95467,-87.67392
TA1309000026,7,12,false,23,20,-3,41.95601,-87.6802
13249,7,12,false,18,20,2,41.95606,-87.66885
312,7,12,false,12,6,-6,41.95637,-87.6563
TA1308000047,7,12,false,27,16,-11,41.95709,-87.6642
13379,7,12,false,47,38,-9,41.95786,-87.6495
TA1309000018,7,12,false,14,7,-7,41.95791,-87.67357
TA1309000027,7,12,false,50,21,-29,41.9585,-87.65499
13389,7,12,false,84,52,-32,41.961,-87.64958
245,7,12,false,15,10,-5,41.96101,-87.64958
15622,7,12,false,14,10,-4,41.96108,-87.69544
TA1307000144,7,12,false,13,21,8,41.96142,-87.6762
TA1309000021,7,12,false,13,16,3,41.9615,-87.6714
KA1503000022,7,12,false,26,6,-20,41.96158,-87.66609
TA1307000107,7,12,false,76,41,-35,41.96164,-87.65464
TA1307000156,7,12,false,17,26,9,41.96301,-87.68479
TA1309000012,7,12,false,14,8,-6,41.96325,-87.67928
TA1308000012,7,12,false,169,242,73,41.96398,-87.63818
13074,7,12,false,58,37,-21,41.96521,-87.6582
639,7,12,false,80,123,43,41.96584,-87.64538
KA1504000127,7,12,false,13,11,-2,41.96587,-87.70083
KA1504000093,7,12,false,15,9,-6,41.96587,-87.69365
TA1307000140,7,12,false,27,40,13,41.96643,-87.68865
KA1504000126,7,12,false,13,5,-8,41.96668,-87.70807
TA1309000014,7,12,false,45,23,-22,41.96709,-87.66744
TA1307000158,7,12,false,14,18,4,41.9671,-87.67904
TA1307000119,7,12,false,46,29,-17,41.96796,-87.65
15615,7,12,false,10,8,-2,41.96835,-87.71183
323,7,12,false,10,3,-7,41.96869,-87.66034
TA1308000021,7,12,false,33,21,-12,41.96883,-87.65765
KA1504000080,7,12,false,12,5,-7,41.96887,-87.69609
TA1309000015,7,12,false,17,9,-8,41.96889,-87.68401
TA1309000066,7,12,false,59,26,-33,41.9691,-87.67423
TA1309000041,7,12,false,35,22,-13,41.96951,-87.65471
KA1504000171,7,12,false,64,51,-13,41.97161,-87.65016
465,7,12,false,12,7,-5,41.97161,-87.65016
TA1309000035,7,12,false,60,59,-1,41.97335,-87.66785
13108,7,12,false,68,46,-22,41.97379,-87.65971
KA1504000078,7,12,false,21,12,-9,41.97491,-87.69258
KA1504000149,7,12,false,22,19,-3,41.97562,-87.67945
KA1504000160,7,12,false,13,8,-5,41.97564,-87.70143
KA1504000128,7,12,false,16,10,-6,41.97567,-87.70927
KA1504000146,7,12,false,80,58,-22,41.978,-87.66805
13109,7,12,false,24,41,17,41.97835,-87.65976
KA1504000151,7,12,false,41,42,1,41.98359,-87.66916
459,7,12,false,12,9,-3,41.98403,-87.65231
KA1504000152,7,12,false,103,162,59,41.98403,-87.65231
15578,7,12,false,34,33,-1,41.98405,-87.66027
15575,7,12,false,39,39,0,41.98975,-87.66014
KA1504000148,7,12,false,14,11,-3,41.99086,-87.66971
KA1504000129,7,12,false,10,3,-7,41.99417,-87.68945
15571,7,12,false,50,35,-15,41.99478,-87.66028
KA1504000156,7,12,false,13,5,-8,41.99925,-87.67137
RP-009,7,12,false,31,22,-9,42.00107,-87.66122
RP-008,7,12,false,11,8,-3,42.00446,-87.6724
660,7,12,false,28,17,-11,42.00458,-87.66143
KA1504000175,7,12,false,11,9,-2,42.00797,-87.66549
KA1504000162,7,12,false,10,10,0,42.00907,-87.67422
KA1504000159,7,12,false,23,17,-6,42.01059,-87.66241
520,7,12,false,14,5,-9,42.01597,-87.66859
523,7,12,false,15,10,-5,42.02089,-87.66505
E002,7,12,false,25,25,0,42.03256,-87.67912
596,7,12,false,46,57,11,42.04822,-87.68348
E008,7,12,false,39,29,-10,42.05049,-87.67782
605,7,12,false,14,20,6,42.05294,-87.67342
604,7,12,false,25,22,-3,42.05824,-87.67744
KA1503000002,7,12,true,14,10,-4,41.76641,-87.5657
15491,7,12,true,11,7,-4,41.78096,-87.57624
KA1503000014,7,12,true,75,56,-19,41.7851,-87.60108
426,7,12,true,10,26,16,41.7851,-87.60108
KA1503000070,7,12,true,12,3,-9,41.78794,-87.58831
TA1309000011,7,12,true,20,18,-2,41.78873,-87.60131
KA1503000071,7,12,true,45,54,9,41.79148,-87.59988
KA1503000074,7,12,true,30,25,-5,41.79174,-87.58395
TA1309000063,7,12,true,20,28,8,41.79325,-87.5878
420,7,12,true,25,9,-16,41.79429,-87.60145
KA1504000076,7,12,true,59,43,-16,41.7943,-87.60145
247,7,12,true,12,9,-3,41.79522,-87.58077
TA1308000009,7,12,true,50,59,9,41.79522,-87.58075
TA1307000164,7,12,true,36,31,-5,41.79527,-87.59647
248,7,12,true,5,11,6,41.79528,-87.59647
KA1503000052,7,12,true,26,33,7,41.79935,-87.60097
KA1503000059,7,12,true,33,25,-8,41.79952,-87.58643
TA1309000037,7,12,true,62,59,-3,41.79957,-87.59474
417,7,12,true,8,13,5,41.80242,-87.5869
KA1503000007,7,12,true,36,34,-2,41.80242,-87.58689
13398,7,12,true,26,11,-15,41.80256,-87.59035
322,7,12,true,10,9,-1,41.80321,-87.59849
TA1308000035,7,12,true,10,10,0,41.80944,-87.59188
TA1308000038,7,12,true,13,11,-2,41.82298,-87.6071
TA1308000045,7,12,true,11,14,3,41.83062,-87.64129
TA1308000043,7,12,true,6,11,5,41.83066,-87.64715
KA1503000005,7,12,true,6,17,11,41.83079,-87.6325
TA1307000129,7,12,true,2,18,16,41.83104,-87.62683
13345,7,12,true,10,5,-5,41.83138,-87.61803
15445,7,12,true,11,25,14,41.83453,-87.63183
13216,7,12,true,16,22,6,41.83473,-87.62581
13217,7,12,true,17,16,-1,41.83488,-87.61792
13215,7,12,true,19,11,-8,41.83634,-87.6135
TA1308000046,7,12,true,9,13,4,41.83779,-87.65115
TA1309000055,7,12,true,35,38,3,41.8382,-87.64514
KA1503000038,7,12,true,18,16,-2,41.83845,-87.6354
TA1307000048,7,12,true,51,48,-3,41.83855,-87.60821
150,7,12,true,12,11,-1,41.83855,-87.60821
TA1308000036,7,12,true,17,7,-10,41.83883,-87.62186
TA1307000139,7,12,true,42,29,-13,41.84205,-87.61698
15443,7,12,true,10,4,-6,41.84275,-87.63549
TA1307000153,7,12,true,17,13,-4,41.84358,-87.64538
TA1307000005,7,12,true,15,2,-13,41.84569,-87.6225
TA1308000026,7,12,true,7,11,4,41.85008,-87.63214
TA1305000001,7,12,true,12,21,9,41.85262,-87.6265
13075,7,12,true,40,42,2,41.8531,-87.63192
13162,7,12,true,14,7,-7,41.85378,-87.64659
15546,7,12,true,14,7,-7,41.85416,-87.61916
13307,7,12,true,11,10,-1,41.85489,-87.66359
13089,7,12,true,7,11,4,41.85497,-87.67567
13331,7,12,true,10,8,-2,41.85515,-87.65414
4,7,12,true,32,34,2,41.85627,-87.61334
15545,7,12,true,124,135,11,41.85627,-87.61334
SL-013,7,12,true,15,15,0,41.85659,-87.62755
SL-006,7,12,true,9,21,12,41.8568,-87.63387
13135,7,12,true,19,24,5,41.85753,-87.66157
338,7,12,true,7,13,6,41.85758,-87.61956
13102,7,12,true,64,66,2,41.85762,-87.61942
273,7,12,true,10,6,-4,41.85783,-87.62455
13150,7,12,true,47,44,-3,41.85783,-87.62455
13099,7,12,true,14,11,-3,41.85784,-87.64627
TA1307000159,7,12,true,18,17,-1,41.8579,-87.6687
TA1307000044,7,12,true,13,12,-1,41.85794,-87.64083
13163,7,12,true,20,32,12,41.85808,-87.65108
13164,7,12,true,37,24,-13,41.85818,-87.65648
SL-012,7,12,true,46,34,-12,41.86038,-87.62581
13304,7,12,true,17,9,-8,41.86126,-87.65659
TA1306000002,7,12,true,37,35,-2,41.86238,-87.65108
TA1307000124,7,12,true,73,55,-18,41.86411,-87.62372
168,7,12,true,17,7,-10,41.86415,-87.62372
TA1309000001,7,12,true,44,35,-9,41.86488,-87.64708
13354,7,12,true,17,19,2,41.86524,-87.66651
13029,7,12,true,14,23,9,41.86531,-87.6179
341,7,12,true,12,12,0,41.86608,-87.60733
13431,7,12,true,48,68,20,41.8661,-87.60728
WL-008,7,12,true,48,61,13,41.86712,-87.64108
57,7,12,true,9,10,1,41.86712,-87.64107
59,7,12,true,13,7,-6,41.86721,-87.62597
TA1305000002,7,12,true,99,95,-4,41.86721,-87.62597
3,7,12,true,26,13,-13,41.86723,-87.61536
15544,7,12,true,63,73,10,41.86723,-87.61536
TA1305000017,7,12,true,13,17,4,41.86734,-87.64863
KA1706005007,7,12,true,25,25,0,41.86749,-87.63219
SL-005,7,12,true,122,96,-26,41.8679,-87.62304
255,7,12,true,21,23,2,41.86791,-87.62304
644,7,12,true,31,18,-13,41.86859,-87.68625
13139,7,12,true,44,39,-5,41.86893,-87.65913
13285,7,12,true,22,24,2,41.86928,-87.67372
13160,7,12,true,45,38,-7,41.86947,-87.65548
22,7,12,true,9,10,1,41.86947,-87.65548
15550,7,12,true,30,27,-3,41.87024,-87.63947
TA1309000010,7,12,true,69,62,-7,41.87074,-87.62574
SL-009,7,12,true,38,14,-24,41.87081,-87.63121
TA1309000064,7,12,true,39,26,-13,41.87127,-87.67369
15542,7,12,true,3,10,7,41.87146,-87.64095
TA1307000130,7,12,true,37,28,-9,41.87178,-87.65103
108,7,12,true,15,28,13,41.87183,-87.64664
TA1307000121,7,12,true,65,64,-1,41.87184,-87.64664
41,7,12,true,13,17,4,41.87209,-87.62957
SL-008,7,12,true,58,69,11,41.87209,-87.62956
13332,7,12,true,88,77,-11,41.87219,-87.6615
SL-011,7,12,true,49,38,-11,41.87256,-87.63356
623,7,12,true,42,44,2,41.87272,-87.62399
KA1504000104,7,12,true,12,15,3,41.87296,-87.66912
320,7,12,true,25,10,-15,41.87327,-87.66402
5,7,12,true,10,10,0,41.87403,-87.6277
SL-007,7,12,true,33,22,-11,41.87404,-87.6277
321,7,12,true,17,9,-8,41.87427,-87.63257
TA1306000025,7,12,true,25,26,1,41.87464,-87.65703
15668,7,12,true,18,9,-9,41.87471,-87.68642
13028,7,12,true,24,34,10,41.87475,-87.64981
SL-010,7,12,true,39,22,-17,41.87501,-87.63309
15541,7,12,true,26,36,10,41.8758,-87.62086
13037,7,12,true,10,7,-3,41.87588,-87.64078
TA1305000009,7,12,true,14,12,-2,41.87593,-87.63068
45,7,12,true,6,11,5,41.87623,-87.62444
TA1305000010,7,12,true,16,27,11,41.87623,-87.62444
624,7,12,true,20,19,-1,41.87626,-87.62923
TA1305000035,7,12,true,17,20,3,41.87716,-87.62787
13138,7,12,true,10,14,4,41.87723,-87.63941
15539,7,12,true,89,64,-25,41.87763,-87.64405
13158,7,12,true,64,66,2,41.87764,-87.64957
134,7,12,true,17,18,1,41.87764,-87.64954
13157,7,12,true,70,54,-16,41.87773,-87.6548
21,7,12,true,14,9,-5,41.87773,-87.6548
TA1305000025,7,12,true,40,37,-3,41.87773,-87.63528
36,7,12,true,13,6,-7,41.87776,-87.63525
TA1309000002,7,12,true,21,23,2,41.87784,-87.62408
13206,7,12,true,23,30,7,41.87794,-87.66201
TA1309000004,7,12,true,7,16,9,41.87811,-87.63184
107,7,12,true,11,7,-4,41.87822,-87.644
638,7,12,true,40,40,0,41.87827,-87.64078
TA1305000005,7,12,true,11,9,-2,41.87924,-87.62975
13011,7,12,true,36,28,-8,41.87931,-87.63993
TA1309000008,7,12,true,11,9,-2,41.87933,-87.6355
KA1503000015,7,12,true,21,22,1,41.87948,-87.6257
15667,7,12,true,8,10,2,41.8798,-87.68609
TA1309000007,7,12,true,23,9,-14,41.88022,-87.63526
WL-011,7,12,true,32,33,1,41.88034,-87.64273
80,7,12,true,11,10,-1,41.88042,-87.65556
13156,7,12,true,88,49,-39,41.88042,-87.65554
13300,7,12,true,130,137,7,41.88097,-87.61675
76,7,12,true,17,31,14,41.88098,-87.61675
13008,7,12,true,65,78,13,41.88105,-87.62408
90,7,12,true,17,13,-4,41.88107,-87.62409
49,7,12,true,7,17,10,41.88116,-87.62963
TA1305000006,7,12,true,33,35,2,41.88122,-87.6296
13134,7,12,true,13,22,9,41.88138,-87.67493
13056,7,12,true,11,9,-2,41.88168,-87.63951
198,7,12,true,30,31,1,41.88187,-87.6488
TA1307000120,7,12,true,134,151,17,41.88188,-87.64879
13341,7,12,true,20,32,12,41.88208,-87.63985
13036,7,12,true,30,28,-2,41.8821,-87.62513
TA1305000032,7,12,true,88,96,8,41.88218,-87.64109
13006,7,12,true,26,19,-7,41.88268,-87.63252
13353,7,12,true,63,52,-11,41.88283,-87.6612
346,7,12,true,7,11,4,41.88284,-87.6612
654,7,12,true,25,20,-5,41.88307,-87.65698
233,7,12,true,5,12,7,41.88309,-87.6511
13409,7,12,true,49,33,-16,41.8831,-87.6511
KA1503000072,7,12,true,13,19,6,41.88317,-87.63693
WL-012,7,12,true,34,42,8,41.88337,-87.6412
112,7,12,true,12,16,4,41.88362,-87.6486
13053,7,12,true,98,97,-1,41.88365,-87.64863
13001,7,12,true,58,47,-11,41.88397,-87.62459
13155,7,12,true,16,22,6,41.88407,-87.65689
18062,7,12,true,34,43,9,41.88412,-87.65427
81,7,12,true,7,18,11,41.88417,-87.6296
TA1306000010,7,12,true,62,88,26,41.88419,-87.62961
TA1305000030,7,12,true,23,24,1,41.88459,-87.63178
15535,7,12,true,46,63,17,41.8846,-87.64455
TA1305000029,7,12,true,51,76,25,41.88466,-87.62787
195,7,12,true,25,17,-8,41.88466,-87.61952
13263,7,12,true,93,68,-25,41.88467,-87.61952
44,7,12,true,9,12,3,41.88468,-87.62782
TA1306000015,7,12,true,86,89,3,41.88549,-87.65232
71,7,12,true,7,13,6,41.8855,-87.65233
66,7,12,true,10,7,-3,41.88557,-87.64186
13021,7,12,true,57,55,-2,41.88559,-87.64184
TA1307000111,7,12,true,28,19,-9,41.88582,-87.63548
13073,7,12,true,12,12,0,41.88592,-87.66717
38,7,12,true,13,4,-9,41.88599,-87.63089
KA1503000012,7,12,true,41,44,3,41.88599,-87.63089
52,7,12,true,15,16,1,41.886,-87.62421
TA1305000011,7,12,true,62,54,-8,41.886,-87.62418
7,7,12,true,13,7,-6,41.88627,-87.61751
15534,7,12,true,51,54,3,41.88627,-87.61749
13197,7,12,true,24,14,-10,41.8866,-87.65816
TA1308000029,7,12,true,35,24,-11,41.88673,-87.62225
TA1307000131,7,12,true,31,35,4,41.88688,-87.62606
KA1503000064,7,12,true,69,115,46,41.88697,-87.61281
100,7,12,true,11,13,2,41.88814,-87.63657
TA1305000022,7,12,true,54,52,-2,41.88817,-87.63656
56,7,12,true,37,32,-5,41.88866,-87.64442
TA1306000003,7,12,true,127,115,-12,41.88867,-87.64442
133,7,12,true,26,31,5,41.88918,-87.63851
KA1503000043,7,12,true,134,144,10,41.88918,-87.63851
13050,7,12,true,84,69,-15,41.88919,-87.62775
47,7,12,true,10,9,-1,41.88921,-87.62775
376,7,12,true,9,11,2,41.88951,-87.68818
13432,7,12,true,14,17,3,41.88989,-87.67149
TA1307000151,7,12,true,81,83,2,41.88993,-87.63427
212,7,12,true,15,9,-6,41.88995,-87.63427
636,7,12,true,65,38,-27,41.88997,-87.63662
KA1503000044,7,12,true,28,41,13,41.89018,-87.6262
13427,7,12,true,24,27,3,41.89054,-87.62205
26,7,12,true,14,13,-1,41.89057,-87.61798
13430,7,12,true,82,85,3,41.89077,-87.63169
181,7,12,true,16,15,-1,41.89077,-87.63168
TA1306000013,7,12,true,77,102,25,41.89083,-87.61852
RN-,7,12,true,83,63,-20,41.89102,-87.63546
672,7,12,true,11,12,1,41.89102,-87.63545
13434,7,12,true,23,37,14,41.89108,-87.66663
TA1308000006,7,12,true,20,14,-6,41.89128,-87.67686
199,7,12,true,30,28,-2,41.89143,-87.62676
TA1307000117,7,12,true,107,128,21,41.89144,-87.62675
13033,7,12,true,85,69,-16,41.8916,-87.64835
84,7,12,true,14,14,0,41.89161,-87.64833
13194,7,12,true,69,72,3,41.8918,-87.65878
TA1305000003,7,12,true,93,87,-6,41.89187,-87.62061
24,7,12,true,19,18,-1,41.8919,-87.62063
643,7,12,true,28,22,-6,41.89203,-87.68939
35,7,12,true,19,12,-7,41.89227,-87.61206
13022,7,12,true,251,219,-32,41.89227,-87.61205
99,7,12,true,14,10,-4,41.89255,-87.61449
TA1306000029,7,12,true,61,71,10,41.89256,-87.61449
13265,7,12,true,98,76,-22,41.89383,-87.64172
74,7,12,true,26,20,-6,41.89384,-87.64173
13045,7,12,true,146,127,-19,41.89403,-87.62931
110,7,12,true,27,34,7,41.89406,-87.6293
13016,7,12,true,46,49,3,41.89431,-87.62277
211,7,12,true,10,6,-4,41.89439,-87.62267
KA1503000041,7,12,true,59,55,-4,41.89452,-87.61798
142,7,12,true,12,18,6,41.89453,-87.61806
92,7,12,true,13,4,-9,41.89455,-87.65346
13196,7,12,true,53,41,-12,41.89455,-87.65345
TA1307000062,7,12,true,63,40,-23,41.89466,-87.63839
111,7,12,true,20,15,-5,41.89466,-87.63837
TA1306000012,7,12,true,128,129,1,41.89475,-87.63438
53,7,12,true,21,21,0,41.89476,-87.63439
627,7,12,true,19,11,-8,41.8948,-87.63231
KP1705001026,7,12,true,66,65,-1,41.89483,-87.6323
16920,7,12,true,20,26,6,41.89495,-87.76491
18058,7,12,true,15,22,7,41.8955,-87.68201
659,7,12,true,1,10,9,41.8955,-87.68201
637,7,12,true,39,42,3,41.89563,-87.67209
128,7,12,true,11,21,10,41.89571,-87.67716
13132,7,12,true,60,72,12,41.89573,-87.67718
161,7,12,true,13,20,7,41.89574,-87.62599
15530,7,12,true,78,81,3,41.89575,-87.62596
18003,7,12,true,26,21,-5,41.89575,-87.62011
13247,7,12,true,54,40,-14,41.89597,-87.66775
TA1305000020,7,12,true,55,58,3,41.89636,-87.65406
54,7,12,true,8,16,8,41.89637,-87.65407
13289,7,12,true,42,53,11,41.89638,-87.661
337,7,12,true,14,10,-4,41.89659,-87.63096
13303,7,12,true,54,54,0,41.89672,-87.63088
13017,7,12,true,46,56,10,41.89676,-87.6357
13338,7,12,true,34,38,4,41.89697,-87.62173
173,7,12,true,12,5,-7,41.89704,-87.62173
TA1307000061,7,12,true,45,49,4,41.89745,-87.62873
13034,7,12,true,38,26,-12,41.89754,-87.62352
48,7,12,true,10,7,-3,41.89772,-87.64302
TA1306000009,7,12,true,47,40,-7,41.89772,-87.64299
620,7,12,true,48,39,-9,41.89817,-87.63754
KA1504000103,7,12,true,30,23,-7,41.89842,-87.68659
374,7,12,true,6,10,4,41.89842,-87.68659
145,7,12,true,15,16,1,41.89856,-87.62211
15529,7,12,true,59,56,-3,41.89858,-87.62206
140,7,12,true,22,37,15,41.89895,-87.6299
TA1307000128,7,12,true,115,116,1,41.89896,-87.6299
657,7,12,true,56,29,-27,41.89918,-87.6722
13248,7,12,true,31,28,-3,41.89964,-87.66788
TA1306000011,7,12,true,44,28,-16,41.89994,-87.63443
KA1504000116,7,12,true,85,24,-61,41.90023,-87.64299
364,7,12,true,5,12,7,41.90023,-87.64299
17660,7,12,true,19,29,10,41.90036,-87.69671
622,7,12,true,14,8,-6,41.90037,-87.69671
13290,7,12,true,55,31,-24,41.90069,-87.66259
29,7,12,true,10,9,-1,41.90069,-87.66259
13042,7,12,true,160,186,26,41.90097,-87.62377
85,7,12,true,14,23,9,41.90098,-87.62375
183,7,12,true,10,5,-5,41.90133,-87.67744
TA1307000070,7,12,true,42,27,-15,41.90133,-87.67742
KA1504000133,7,12,true,113,86,-27,41.90234,-87.62773
172,7,12,true,16,12,-4,41.90236,-87.62774
13241,7,12,true,19,20,1,41.9029,-87.68731
176,7,12,true,41,42,1,41.90291,-87.63141
TA1306000006,7,12,true,21,24,3,41.90292,-87.63772
TA1307000039,7,12,true,192,201,9,41.90294,-87.63137
658,7,12,true,22,40,18,41.903,-87.6838
13256,7,12,true,23,21,-2,41.90302,-87.69749
TA1305000034,7,12,true,81,72,-9,41.90313,-87.67391
17,7,12,true,10,12,2,41.90313,-87.67391
182,7,12,true,40,36,-4,41.90317,-87.63442
KA1504000135,7,12,true,156,191,35,41.90319,-87.63439
13136,7,12,true,42,46,4,41.90326,-87.67845
210,7,12,true,19,17,-2,41.90342,-87.66781
13061,7,12,true,114,90,-24,41.90342,-87.66779
KA1504000079,7,12,true,72,79,7,41.9035,-87.64334
359,7,12,true,9,10,1,41.90458,-87.6497
TA1307000115,7,12,true,39,33,-6,41.9046,-87.64056
291,7,12,true,13,41,28,41.90672,-87.63494
TA1308000049,7,12,true,103,93,-10,41.90672,-87.6349
KA1504000134,7,12,true,52,56,4,41.90687,-87.6262
180,7,12,true,18,16,-2,41.90687,-87.62618
13224,7,12,true,49,41,-8,41.90706,-87.66725
TA1307000143,7,12,true,15,24,9,41.90762,-87.63854
61,7,12,true,14,14,0,41.90764,-87.67254
13221,7,12,true,89,94,5,41.90765,-87.67254
13245,7,12,true,24,7,-17,41.90777,-87.68586
301,7,12,true,19,18,-1,41.90796,-87.63203
TA1309000024,7,12,true,91,86,-5,41.908,-87.63152
69,7,12,true,15,12,-3,41.90939,-87.6777
TA1305000041,7,12,true,96,113,17,41.9094,-87.67769
331,7,12,true,130,181,51,41.90965,-87.64812
15653,7,12,true,18,14,-4,41.90979,-87.7053
TA1305000037,7,12,true,56,45,-11,41.91018,-87.67003
TA1306000008,7,12,true,33,32,-1,41.9102,-87.6435
TA1308000005,7,12,true,49,39,-10,41.91042,-87.68238
13258,7,12,true,26,23,-3,41.91043,-87.69718
160,7,12,true,12,9,-3,41.91054,-87.68957
13257,7,12,true,17,19,2,41.91054,-87.68956
13154,7,12,true,101,123,22,41.91054,-87.65312
20,7,12,true,17,17,0,41.91055,-87.65313
60,7,12,true,15,16,1,41.91059,-87.64942
13058,7,12,true,66,88,22,41.91059,-87.64942
118,7,12,true,16,10,-6,41.91138,-87.63868
TA1307000038,7,12,true,54,62,8,41.91138,-87.63868
268,7,12,true,29,17,-12,41.91172,-87.62681
LF-005,7,12,true,268,293,25,41.91172,-87.62681
126,7,12,true,12,12,0,41.91196,-87.63197
13128,7,12,true,89,80,-9,41.91197,-87.63197
289,7,12,true,28,33,5,41.91209,-87.63472
TA1308000050,7,12,true,218,202,-16,41.91211,-87.6347
13243,7,12,true,84,73,-11,41.91262,-87.6814
158,7,12,true,14,19,5,41.91262,-87.6814
TA1306000032,7,12,true,89,82,-7,41.9137,-87.65285
93,7,12,true,10,27,17,41.91371,-87.65285
224,7,12,true,12,12,0,41.91386,-87.64877
TA1307000166,7,12,true,77,80,3,41.91386,-87.64877
15655,7,12,true,25,21,-4,41.91401,-87.70514
18017,7,12,true,30,32,2,41.91416,-87.71676
18067,7,12,true,78,77,-1,41.9146,-87.66796
628,7,12,true,7,12,5,41.9146,-87.66796
TA1306000007,7,12,true,37,24,-13,41.91469,-87.64333
13068,7,12,true,58,56,-2,41.91554,-87.68703
116,7,12,true,10,11,1,41.91555,-87.68703
13179,7,12,true,149,141,-8,41.9157,-87.63461
141,7,12,true,28,27,-1,41.91571,-87.63461
13133,7,12,true,73,65,-8,41.91598,-87.67733
219,7,12,true,9,10,1,41.91598,-87.67733
58,7,12,true,14,5,-9,41.91602,-87.66894
TA1305000039,7,12,true,52,72,20,41.9163,-87.66749
15650,7,12,true,13,14,1,41.91711,-87.71023
15651,7,12,true,27,24,-3,41.91752,-87.70181
13266,7,12,true,24,22,-2,41.91774,-87.69142
TA1309000029,7,12,true,39,32,-7,41.9178,-87.68245
TA1309000006,7,12,true,58,49,-9,41.91809,-87.64375
288,7,12,true,13,11,-2,41.91809,-87.64375
223,7,12,true,11,11,0,41.91821,-87.65698
TA1307000163,7,12,true,74,51,-23,41.91821,-87.65696
94,7,12,true,27,22,-5,41.91831,-87.6363
13146,7,12,true,178,141,-37,41.91831,-87.63629
13059,7,12,true,114,115,1,41.91845,-87.65222
113,7,12,true,23,18,-5,41.91846,-87.65222
13259,7,12,true,21,16,-5,41.91852,-87.69744
225,7,12,true,17,16,-1,41.91995,-87.64884
13192,7,12,true,115,117,2,41.91995,-87.64884
13288,7,12,true,41,25,-16,41.92008,-87.67788
13242,7,12,true,26,30,4,41.92021,-87.69266
307,7,12,true,7,13,6,41.92077,-87.66373
TA1309000030,7,12,true,77,58,-19,41.92077,-87.66372
13292,7,12,true,23,17,-6,41.92152,-87.70733
TA1309000033,7,12,true,98,84,-14,41.92158,-87.65381
13193,7,12,true,116,133,17,41.92182,-87.64412
144,7,12,true,14,25,11,41.92182,-87.64411
143,7,12,true,14,11,-3,41.92217,-87.63891
13191,7,12,true,64,64,0,41.92217,-87.63891
327,7,12,true,19,21,2,41.92225,-87.65783
13084,7,12,true,46,32,-14,41.92268,-87.69715
LP-,7,12,true,87,97,10,41.92396,-87.63584
673,7,12,true,14,4,-10,41.92398,-87.63585
KA1504000140,7,12,true,20,23,3,41.92409,-87.67646
15648,7,12,true,8,10,2,41.92464,-87.68931
KA1504000090,7,12,true,15,17,2,41.92483,-87.7145
TA1307000001,7,12,true,79,55,-24,41.92535,-87.66581
188,7,12,true,11,18,7,41.92536,-87.66581
TA1306000026,7,12,true,62,34,-28,41.92558,-87.65842
87,7,12,true,14,8,-6,41.92559,-87.65843
67,7,12,true,11,8,-3,41.9256,-87.65371
TA1306000016,7,12,true,53,67,14,41.9256,-87.65371
313,7,12,true,21,20,-1,41.9257,-87.64246
TA1309000019,7,12,true,147,143,-4,41.92586,-87.63897
TA1309000058,7,12,true,132,131,-1,41.92591,-87.64927
127,7,12,true,15,24,9,41.92592,-87.64927
177,7,12,true,37,35,-2,41.92627,-87.63086
TA1308000001,7,12,true,174,188,14,41.92627,-87.63086
15646,7,12,true,26,22,-4,41.92668,-87.6977
13124,7,12,true,47,51,4,41.92675,-87.63444
302,7,12,true,15,22,7,41.92859,-87.65421
TA1309000023,7,12,true,69,76,7,41.9287,-87.65383
TA1307000113,7,12,true,58,87,29,41.92878,-87.66391
190,7,12,true,9,15,6,41.92878,-87.6639
13296,7,12,true,30,34,4,41.92883,-87.66852
TA1309000059,7,12,true,39,41,2,41.92889,-87.65898
349,7,12,true,20,28,8,41.92915,-87.6491
TA1309000061,7,12,true,92,88,-4,41.92915,-87.64909
TA1308000031,7,12,true,30,32,2,41.92946,-87.68417
340,7,12,true,29,19,-10,41.92956,-87.64313
TA1305000014,7,12,true,130,145,15,41.92956,-87.64313
260,7,12,true,15,16,1,41.92958,-87.70791
13085,7,12,true,37,78,41,41.92958,-87.70789
TA1307000142,7,12,true,122,136,14,41.93125,-87.64432
220,7,12,true,35,20,-15,41.93125,-87.64431
13276,7,12,true,91,93,2,41.93132,-87.63874
324,7,12,true,15,27,12,41.93173,-87.64179
15645,7,12,true,14,8,-6,41.93191,-87.70121
163,7,12,true,12,7,-5,41.93191,-87.67784
13271,7,12,true,36,43,7,41.93192,-87.67784
152,7,12,true,15,19,4,41.93221,-87.65864
TA1307000064,7,12,true,77,80,3,41.93222,-87.65864
TA1306000014,7,12,true,73,56,-17,41.93242,-87.65271
13,7,12,true,20,11,-9,41.93242,-87.65271
TA1309000039,7,12,true,115,101,-14,41.93258,-87.63642
329,7,12,true,20,15,-5,41.93258,-87.63642
13294,7,12,true,46,28,-18,41.9326,-87.66595
332,7,12,true,15,20,5,41.93313,-87.64776
TA1309000036,7,12,true,68,95,27,41.93313,-87.64776
TA1307000006,7,12,true,99,81,-18,41.93571,-87.6636
153,7,12,true,20,13,-7,41.93575,-87.66364
13268,7,12,true,24,19,-5,41.93588,-87.67843
13269,7,12,true,60,26,-34,41.93609,-87.66983
TA1307000052,7,12,true,90,72,-18,41.93628,-87.65266
115,7,12,true,20,13,-7,41.93628,-87.65266
156,7,12,true,24,18,-6,41.9365,-87.64756
TA1307000136,7,12,true,88,103,15,41.9365,-87.64755
TA1307000041,7,12,true,152,170,18,41.93669,-87.63683
157,7,12,true,32,34,2,41.9367,-87.63683
13137,7,12,true,162,149,-13,41.9376,-87.6441
300,7,12,true,49,30,-19,41.93761,-87.6441
15642,7,12,true,8,23,15,41.93843,-87.69801
154,7,12,true,10,10,0,41.93912,-87.66384
KA17018068,7,12,true,7,12,5,41.93935,-87.68327
TA1309000042,7,12,true,72,69,-3,41.93937,-87.66836
13229,7,12,true,43,54,11,41.93946,-87.66376
TA1308000019,7,12,true,63,60,-3,41.93973,-87.65886
13277,7,12,true,107,70,-37,41.9401,-87.64546
296,7,12,true,19,9,-10,41.9401,-87.64546
TA1307000134,7,12,true,127,147,20,41.94016,-87.65303
117,7,12,true,31,27,-4,41.94016,-87.65302
13143,7,12,true,19,25,6,41.94059,-87.67853
334,7,12,true,7,19,12,41.94076,-87.63919
TA1309000049,7,12,true,149,127,-22,41.94077,-87.63919
308,7,12,true,11,5,-6,41.94152,-87.68471
15634,7,12,true,16,20,4,41.94304,-87.68729
TA1307000138,7,12,true,50,75,25,41.94334,-87.67094
230,7,12,true,16,6,-10,41.94335,-87.67093
13144,7,12,true,29,30,1,41.9434,-87.67964
299,7,12,true,16,13,-3,41.94368,-87.64894
TA1309000025,7,12,true,80,110,30,41.94368,-87.64894
229,7,12,true,21,24,3,41.94372,-87.66401
13071,7,12,true,116,130,14,41.94373,-87.66401
632,7,12,true,107,116,9,41.94453,-87.6547
303,7,12,true,28,26,-2,41.94522,-87.64702
15631,7,12,true,12,20,8,41.94524,-87.70665
13278,7,12,true,111,102,-9,41.94553,-87.64644
TA1309000050,7,12,true,15,18,3,41.94618,-87.67331
15632,7,12,true,20,33,13,41.94664,-87.69463
KA1504000143,7,12,true,11,5,-6,41.94664,-87.68337
227,7,12,true,14,19,5,41.94813,-87.66397
13235,7,12,true,76,92,16,41.94814,-87.66396
304,7,12,true,14,13,-1,41.94878,-87.64922
13253,7,12,true,35,34,-1,41.9488,-87.67527
13325,7,12,true,105,118,13,41.94907,-87.64863
114,7,12,true,11,16,5,41.94935,-87.65451
TA1307000126,7,12,true,83,122,39,41.94936,-87.65451
232,7,12,true,27,24,-3,41.94943,-87.64645
TA1307000150,7,12,true,125,114,-11,41.94945,-87.64646
18016,7,12,true,6,11,5,41.94993,-87.71395
13319,7,12,true,39,43,4,41.95069,-87.6687
TA1307000127,7,12,true,70,85,15,41.9508,-87.65918
165,7,12,true,15,26,11,41.95081,-87.65918
15628,7,12,true,18,14,-4,41.95216,-87.69806
13323,7,12,true,76,69,-7,41.95282,-87.65
256,7,12,true,16,10,-6,41.95282,-87.65
TA1309000043,7,12,true,34,32,-2,41.95417,-87.66434
13063,7,12,true,59,44,-15,41.95424,-87.65441
240,7,12,true,15,13,-2,41.95424,-87.65441
254,7,12,true,12,16,4,41.95438,-87.64806
TA1308000022,7,12,true,91,63,-28,41.95438,-87.64805
TA1307000149,7,12,true,39,24,-15,41.95467,-87.67392
298,7,12,true,6,12,6,41.95601,-87.68021
TA1309000026,7,12,true,59,33,-26,41.95601,-87.6802
13249,7,12,true,15,19,4,41.95606,-87.66885
312,7,12,true,11,13,2,41.95637,-87.6563
TA1308000047,7,12,true,23,17,-6,41.95709,-87.6642
13379,7,12,true,64,47,-17,41.95786,-87.6495
TA1309000018,7,12,true,20,20,0,41.95791,-87.67357
306,7,12,true,13,5,-8,41.9585,-87.655
TA1309000027,7,12,true,70,33,-37,41.9585,-87.65499
13389,7,12,true,94,55,-39,41.961,-87.64958
245,7,12,true,19,14,-5,41.96101,-87.64958
15621,7,12,true,17,14,-3,41.96103,-87.70586
15622,7,12,true,22,22,0,41.96108,-87.69544
TA1307000144,7,12,true,33,18,-15,41.96142,-87.6762
TA1309000021,7,12,true,29,18,-11,41.9615,-87.6714
15623,7,12,true,13,19,6,41.96154,-87.69117
KA1503000022,7,12,true,36,19,-17,41.96158,-87.66609
231,7,12,true,5,21,16,41.96163,-87.65464
TA1307000107,7,12,true,82,75,-7,41.96164,-87.65464
TA1307000156,7,12,true,34,45,11,41.96301,-87.68479
TA1309000012,7,12,true,27,18,-9,41.96325,-87.67928
249,7,12,true,12,17,5,41.96398,-87.63818
TA1308000012,7,12,true,110,149,39,41.96398,-87.63818
13074,7,12,true,57,42,-15,41.96521,-87.6582
639,7,12,true,76,77,1,41.96584,-87.64538
KA1504000127,7,12,true,22,16,-6,41.96587,-87.70083
KA1504000093,7,12,true,17,18,1,41.96587,-87.69365
TA1307000140,7,12,true,37,37,0,41.96643,-87.68865
239,7,12,true,8,10,2,41.9665,-87.68843
326,7,12,true,11,9,-2,41.96665,-87.67113
TA1309000014,7,12,true,58,53,-5,41.96709,-87.66744
TA1307000158,7,12,true,44,32,-12,41.9671,-87.67904
TA1307000119,7,12,true,32,32,0,41.96796,-87.65
323,7,12,true,10,5,-5,41.96869,-87.66034
TA1308000021,7,12,true,38,29,-9,41.96883,-87.65765
253,7,12,true,10,6,-4,41.96883,-87.65765
KA1504000080,7,12,true,15,13,-2,41.96887,-87.69609
TA1309000015,7,12,true,22,21,-1,41.96889,-87.68401
TA1309000066,7,12,true,76,61,-15,41.9691,-87.67423
344,7,12,true,14,7,-7,41.9691,-87.67423
TA1309000041,7,12,true,36,29,-7,41.96951,-87.65471
465,7,12,true,14,8,-6,41.97161,-87.65016
KA1504000171,7,12,true,49,51,2,41.97161,-87.65016
325,7,12,true,12,17,5,41.9728,-87.67186
TA1309000035,7,12,true,86,64,-22,41.97335,-87.66785
295,7,12,true,7,18,11,41.97378,-87.65972
13108,7,12,true,51,55,4,41.97379,-87.65971
KA1504000078,7,12,true,15,22,7,41.97491,-87.69258
KA1504000149,7,12,true,24,20,-4,41.97562,-87.67945
KA1504000160,7,12,true,8,12,4,41.97564,-87.70143
KA1504000146,7,12,true,78,57,-21,41.978,-87.66805
463,7,12,true,13,24,11,41.978,-87.66805
13109,7,12,true,45,42,-3,41.97835,-87.65976
294,7,12,true,11,10,-1,41.97835,-87.65976
655,7,12,true,15,15,0,41.97987,-87.68194
460,7,12,true,5,13,8,41.98358,-87.66916
KA1504000151,7,12,true,61,46,-15,41.98359,-87.66916
459,7,12,true,23,18,-5,41.98403,-87.65231
KA1504000152,7,12,true,108,115,7,41.98403,-87.65231
15578,7,12,true,37,29,-8,41.98405,-87.66027
15575,7,12,true,27,46,19,41.98975,-87.66014
KA1504000148,7,12,true,20,17,-3,41.99086,-87.66971
15571,7,12,true,45,48,3,41.99478,-87.66028
454,7,12,true,8,16,8,41.99478,-87.66027
KA1504000156,7,12,true,22,12,-10,41.99925,-87.67137
453,7,12,true,11,7,-4,41.99925,-87.67137
RP-009,7,12,true,23,26,3,42.00107,-87.66122
RP-008,7,12,true,13,8,-5,42.00446,-87.6724
660,7,12,true,29,18,-11,42.00458,-87.66143
KA1504000175,7,12,true,28,28,0,42.00797,-87.66549
KA1504000162,7,12,true,19,7,-12,42.00907,-87.67422
KA1504000159,7,12,true,15,7,-8,42.01059,-87.66241
525,7,12,true,18,11,-7,42.01272,-87.66605
520,7,12,true,31,21,-10,42.01597,-87.66859
16806,7,12,true,4,10,6,42.01953,-87.66955
523,7,12,true,21,22,1,42.02089,-87.66505
E002,7,12,true,14,22,8,42.03256,-87.67912
596,7,12,true,19,30,11,42.04822,-87.68348
E008,7,12,true,7,18,11,42.05049,-87.67782
604,7,12,true,12,9,-3,42.05824,-87.67744
E006,7,12,true,6,12,6,42.06367,-87.69871
20232,7,16,false,10,5,-5,41.68588,-87.57378
20222,7,16,false,5,11,6,41.7046,-87.52832
20224,7,16,false,3,13,10,41.71371,-87.53083
KA1503000049,7,16,false,7,11,4,41.75788,-87.54938
KA1503000002,7,16,false,18,26,8,41.76641,-87.5657
KA1503000029,7,16,false,18,14,-4,41.77364,-87.56747
KA1503000021,7,16,false,6,11,5,41.77888,-87.58665
653,7,16,false,12,4,-8,41.78059,-87.58491
15491,7,16,false,40,37,-3,41.78096,-87.57624
KA1503000014,7,16,false,46,43,-3,41.7851,-87.60108
426,7,16,false,4,10,6,41.7851,-87.60108
KA1503000070,7,16,false,20,19,-1,41.78794,-87.58831
TA1309000011,7,16,false,11,5,-6,41.78873,-87.60131
KA1503000071,7,16,false,31,45,14,41.79148,-87.59988
KA1503000074,7,16,false,125,50,-75,41.79174,-87.58395
424,7,16,false,11,6,-5,41.79174,-87.58395
TA1309000063,7,16,false,32,36,4,41.79325,-87.5878
345,7,16,false,13,3,-10,41.79326,-87.5878
KA1504000076,7,16,false,21,28,7,41.7943,-87.60145
247,7,16,false,17,19,2,41.79522,-87.58077
TA1308000009,7,16,false,131,175,44,41.79522,-87.58075
TA1307000164,7,16,false,25,35,10,41.79527,-87.59647
KA1503000052,7,16,false,18,17,-1,41.79935,-87.60097
KA1503000059,7,16,false,52,58,6,41.79952,-87.58643
TA1309000037,7,16,false,51,66,15,41.79957,-87.59474
15470,7,16,false,6,10,4,41.80228,-87.61807
KA1503000007,7,16,false,36,70,34,41.80242,-87.58689
13398,7,16,false,32,22,-10,41.80256,-87.59035
322,7,16,false,10,10,0,41.80321,-87.59849
TA1308000035,7,16,false,21,26,5,41.80944,-87.59188
TA1309000053,7,16,false,10,3,-7,41.80985,-87.60675
KA1503000065,7,16,false,8,20,12,41.81409,-87.59701
TA1308000023,7,16,false,12,7,-5,41.81649,-87.60659
TA1308000038,7,16,false,28,26,-2,41.82298,-87.6071
TA1308000045,7,16,false,32,6,-26,41.83062,-87.64129
TA1308000043,7,16,false,17,11,-6,41.83066,-87.64715
KA1503000005,7,16,false,32,3,-29,41.83079,-87.6325
TA1307000129,7,16,false,37,12,-25,41.83104,-87.62683
KA1503000004,7,16,false,40,34,-6,41.83127,-87.6088
13345,7,16,false,15,8,-7,41.83138,-87.61803
15445,7,16,false,34,9,-25,41.83453,-87.63183
13216,7,16,false,24,16,-8,41.83473,-87.62581
13217,7,16,false,6,10,4,41.83488,-87.61792
13215,7,16,false,14,13,-1,41.83634,-87.6135
TA1308000046,7,16,false,17,23,6,41.83779,-87.65115
TA1309000055,7,16,false,17,21,4,41.8382,-87.64514
KA1503000038,7,16,false,9,14,5,41.83845,-87.6354
TA1307000048,7,16,false,141,136,-5,41.83855,-87.60821
150,7,16,false,30,27,-3,41.83855,-87.60821
TA1308000036,7,16,false,18,15,-3,41.83883,-87.62186
TA1307000139,7,16,false,23,19,-4,41.84205,-87.61698
15443,7,16,false,7,15,8,41.84275,-87.63549
TA1307000153,7,16,false,10,7,-3,41.84358,-87.64538
TA1307000005,7,16,false,9,14,5,41.84569,-87.6225
TA1308000013,7,16,false,10,10,0,41.84719,-87.64681
TA1308000026,7,16,false,19,22,3,41.85008,-87.63214
TA1305000004,7,16,false,34,54,20,41.8514,-87.61884
TA1305000001,7,16,false,34,45,11,41.85262,-87.6265
13075,7,16,false,141,98,-43,41.8531,-87.63192
13162,7,16,false,20,12,-8,41.85378,-87.64659
13096,7,16,false,6,12,6,41.8538,-87.69577
15546,7,16,false,35,40,5,41.85416,-87.61916
13307,7,16,false,17,14,-3,41.85489,-87.66359
13089,7,16,false,14,7,-7,41.85497,-87.67567
13331,7,16,false,11,10,-1,41.85515,-87.65414
4,7,16,false,18,20,2,41.85627,-87.61334
15545,7,16,false,102,116,14,41.85627,-87.61334
SL-013,7,16,false,11,11,0,41.85659,-87.62755
SL-006,7,16,false,34,32,-2,41.8568,-87.63387
13135,7,16,false,25,31,6,41.85753,-87.66157
13102,7,16,false,75,74,-1,41.85762,-87.61942
13150,7,16,false,58,50,-8,41.85783,-87.62455
13099,7,16,false,21,15,-6,41.85784,-87.64627
TA1307000159,7,16,false,13,8,-5,41.8579,-87.6687
TA1307000044,7,16,false,15,22,7,41.85794,-87.64083
13163,7,16,false,26,42,16,41.85808,-87.65108
13164,7,16,false,42,40,-2,41.85818,-87.65648
SL-012,7,16,false,38,64,26,41.86038,-87.62581
13304,7,16,false,8,16,8,41.86126,-87.65659
TA1306000002,7,16,false,14,10,-4,41.86238,-87.65108
TA1307000124,7,16,false,62,69,7,41.86411,-87.62372
TA1309000001,7,16,false,30,26,-4,41.86488,-87.64708
13354,7,16,false,6,10,4,41.86524,-87.66651
13029,7,16,false,132,81,-51,41.86531,-87.6179
97,7,16,false,20,7,-13,41.86531,-87.6179
341,7,16,false,22,11,-11,41.86608,-87.60733
13431,7,16,false,276,243,-33,41.8661,-87.60728
KA1504000101,7,16,false,5,14,9,41.86651,-87.68466
WL-008,7,16,false,42,36,-6,41.86712,-87.64108
TA1305000002,7,16,false,129,130,1,41.86721,-87.62597
59,7,16,false,6,22,16,41.86721,-87.62597
15544,7,16,false,418,322,-96,41.86723,-87.61536
3,7,16,false,46,25,-21,41.86723,-87.61536
TA1305000017,7,16,false,19,8,-11,41.86734,-87.64863
KA1706005007,7,16,false,36,35,-1,41.86749,-87.63219
SL-005,7,16,false,237,273,36,41.8679,-87.62304
255,7,16,false,29,35,6,41.86791,-87.62304
644,7,16,false,12,11,-1,41.86859,-87.68625
13139,7,16,false,16,18,2,41.86893,-87.65913
13285,7,16,false,10,4,-6,41.86928,-87.67372
13160,7,16,false,21,34,13,41.86947,-87.65548
15550,7,16,false,35,24,-11,41.87024,-87.63947
TA1309000010,7,16,false,100,119,19,41.87074,-87.62574
SL-009,7,16,false,17,41,24,41.87081,-87.63121
15542,7,16,false,15,9,-6,41.87146,-87.64095
TA1307000130,7,16,false,19,17,-2,41.87178,-87.65103
TA1307000121,7,16,false,20,20,0,41.87184,-87.64664
41,7,16,false,14,15,1,41.87209,-87.62957
SL-008,7,16,false,81,95,14,41.87209,-87.62956
13332,7,16,false,26,33,7,41.87219,-87.6615
394,7,16,false,5,10,5,41.87226,-87.63484
SL-011,7,16,false,54,54,0,41.87256,-87.63356
623,7,16,false,162,169,7,41.87272,-87.62399
SL-007,7,16,false,60,58,-2,41.87404,-87.6277
13326,7,16,false,23,11,-12,41.87425,-87.63958
321,7,16,false,4,14,10,41.87427,-87.63257
TA1306000025,7,16,false,9,13,4,41.87464,-87.65703
15668,7,16,false,9,12,3,41.87471,-87.68642
13028,7,16,false,18,39,21,41.87475,-87.64981
SL-010,7,16,false,18,19,1,41.87501,-87.63309
15541,7,16,false,189,207,18,41.8758,-87.62086
13037,7,16,false,11,6,-5,41.87588,-87.64078
TA1305000009,7,16,false,12,16,4,41.87593,-87.63068
TA1305000010,7,16,false,69,64,-5,41.87623,-87.62444
45,7,16,false,6,10,4,41.87623,-87.62444
624,7,16,false,48,43,-5,41.87626,-87.62923
2,7,16,false,44,64,20,41.87649,-87.62051
TA1305000035,7,16,false,55,45,-10,41.87716,-87.62787
13138,7,16,false,21,18,-3,41.87723,-87.63941
631,7,16,false,3,14,11,41.87761,-87.6739
15539,7,16,false,42,66,24,41.87763,-87.64405
13158,7,16,false,56,51,-5,41.87764,-87.64957
13157,7,16,false,46,51,5,41.87773,-87.6548
TA1305000025,7,16,false,56,75,19,41.87773,-87.63528
36,7,16,false,8,14,6,41.87776,-87.63525
284,7,16,false,9,16,7,41.87784,-87.62408
TA1309000002,7,16,false,119,181,62,41.87784,-87.62408
13206,7,16,false,24,24,0,41.87794,-87.66201
TA1309000004,7,16,false,20,19,-1,41.87811,-87.63184
107,7,16,false,3,10,7,41.87822,-87.644
638,7,16,false,21,43,22,41.87827,-87.64078
TA1305000005,7,16,false,30,23,-7,41.87924,-87.62975
13011,7,16,false,38,38,0,41.87931,-87.63993
TA1309000008,7,16,false,44,65,21,41.87933,-87.6355
KA1503000034,7,16,false,32,38,6,41.87938,-87.63197
KA1503000015,7,16,false,57,41,-16,41.87948,-87.6257
15667,7,16,false,11,12,1,41.8798,-87.68609
TA1309000007,7,16,false,25,20,-5,41.88022,-87.63526
WL-011,7,16,false,18,27,9,41.88034,-87.64273
73,7,16,false,2,11,9,41.8804,-87.64273
13156,7,16,false,55,43,-12,41.88042,-87.65554
13300,7,16,false,672,647,-25,41.88097,-87.61675
76,7,16,false,75,82,7,41.88098,-87.61675
13008,7,16,false,531,533,2,41.88105,-87.62408
90,7,16,false,58,96,38,41.88107,-87.62409
49,7,16,false,14,9,-5,41.88116,-87.62963
TA1305000006,7,16,false,83,60,-23,41.88122,-87.6296
13134,7,16,false,11,19,8,41.88138,-87.67493
13056,7,16,false,20,26,6,41.88168,-87.63951
198,7,16,false,13,6,-7,41.88187,-87.6488
TA1307000120,7,16,false,138,130,-8,41.88188,-87.64879
13341,7,16,false,23,42,19,41.88208,-87.63985
13036,7,16,false,87,84,-3,41.8821,-87.62513
77,7,16,false,12,13,1,41.88214,-87.64108
TA1305000032,7,16,false,61,75,14,41.88218,-87.64109
98,7,16,false,10,2,-8,41.88266,-87.63251
13006,7,16,false,20,36,16,41.88268,-87.63252
13353,7,16,false,34,43,9,41.88283,-87.6612
654,7,16,false,33,27,-6,41.88307,-87.65698
13409,7,16,false,37,58,21,41.8831,-87.6511
KA1503000072,7,16,false,16,12,-4,41.88317,-87.63693
WL-012,7,16,false,31,29,-2,41.88337,-87.6412
112,7,16,false,16,9,-7,41.88362,-87.6486
13053,7,16,false,165,122,-43,41.88365,-87.64863
43,7,16,false,31,29,-2,41.88396,-87.62455
13001,7,16,false,212,217,5,41.88397,-87.62459
13155,7,16,false,20,21,1,41.88407,-87.65689
621,7,16,false,12,11,-1,41.88412,-87.65427
18062,7,16,false,18,35,17,41.88412,-87.65427
81,7,16,false,6,22,16,41.88417,-87.6296
TA1306000010,7,16,false,58,54,-4,41.88419,-87.62961
TA1305000030,7,16,false,45,63,18,41.88459,-87.63178
15535,7,16,false,49,41,-8,41.8846,-87.64455
96,7,16,false,8,12,4,41.8846,-87.64455
TA1305000029,7,16,false,170,170,0,41.88466,-87.62787
195,7,16,false,33,26,-7,41.88466,-87.61952
13263,7,16,false,159,155,-4,41.88467,-87.61952
44,7,16,false,19,28,9,41.88468,-87.62782
TA1306000015,7,16,false,86,85,-1,41.88549,-87.65232
71,7,16,false,6,11,5,41.8855,-87.65233
66,7,16,false,11,6,-5,41.88557,-87.64186
13021,7,16,false,47,72,25,41.88559,-87.64184
TA1307000111,7,16,false,53,75,22,41.88582,-87.63548
13073,7,16,false,32,82,50,41.88592,-87.66717
KA17018054,7,16,false,12,19,7,41.88595,-87.67701
38,7,16,false,22,11,-11,41.88599,-87.63089
KA1503000012,7,16,false,77,69,-8,41.88599,-87.63089
52,7,16,false,20,34,14,41.886,-87.62421
TA1305000011,7,16,false,162,176,14,41.886,-87.62418
7,7,16,false,13,9,-4,41.88627,-87.61751
15534,7,16,false,86,94,8,41.88627,-87.61749
13197,7,16,false,9,14,5,41.8866,-87.65816
TA1308000029,7,16,false,68,92,24,41.88673,-87.62225
194,7,16,false,8,17,9,41.88688,-87.62606
TA1307000131,7,16,false,140,175,35,41.88688,-87.62606
KA1503000064,7,16,false,281,256,-25,41.88697,-87.61281
6,7,16,false,20,18,-2,41.88697,-87.61281
TA1305000022,7,16,false,66,60,-6,41.88817,-87.63656
56,7,16,false,14,12,-2,41.88866,-87.64442
TA1306000003,7,16,false,85,120,35,41.88867,-87.64442
KA1503000043,7,16,false,100,99,-1,41.88918,-87.63851
133,7,16,false,14,16,2,41.88918,-87.63851
13050,7,16,false,108,112,4,41.88919,-87.62775
47,7,16,false,8,10,2,41.88921,-87.62775
13432,7,16,false,29,16,-13,41.88989,-87.67149
TA1307000151,7,16,false,103,124,21,41.88993,-87.63427
212,7,16,false,10,8,-2,41.88995,-87.63427
636,7,16,false,33,42,9,41.88997,-87.63662
125,7,16,false,11,8,-3,41.89018,-87.62621
KA1503000044,7,16,false,60,51,-9,41.89018,-87.6262
196,7,16,false,16,16,0,41.89053,-87.62205
13427,7,16,false,66,75,9,41.89054,-87.62205
26,7,16,false,12,25,13,41.89057,-87.61798
13430,7,16,false,94,153,59,41.89077,-87.63169
181,7,16,false,16,23,7,41.89077,-87.63168
TA1306000013,7,16,false,210,234,24,41.89083,-87.61852
RN-,7,16,false,76,88,12,41.89102,-87.63546
672,7,16,false,15,10,-5,41.89102,-87.63545
13434,7,16,false,42,38,-4,41.89108,-87.66663
TA1308000006,7,16,false,24,32,8,41.89128,-87.67686
199,7,16,false,29,27,-2,41.89143,-87.62676
TA1307000117,7,16,false,253,307,54,41.89144,-87.62675
13033,7,16,false,69,107,38,41.8916,-87.64835
84,7,16,false,7,14,7,41.89161,-87.64833
13194,7,16,false,27,41,14,41.8918,-87.65878
TA1305000003,7,16,false,183,239,56,41.89187,-87.62061
24,7,16,false,17,24,7,41.8919,-87.62063
643,7,16,false,7,11,4,41.89203,-87.68939
35,7,16,false,48,76,28,41.89227,-87.61206
13022,7,16,false,1372,1482,110,41.89227,-87.61205
99,7,16,false,15,13,-2,41.89255,-87.61449
TA1306000029,7,16,false,186,193,7,41.89256,-87.61449
13265,7,16,false,59,72,13,41.89383,-87.64172
74,7,16,false,7,10,3,41.89384,-87.64173
13045,7,16,false,130,134,4,41.89403,-87.62931
110,7,16,false,12,28,16,41.89406,-87.6293
13016,7,16,false,155,174,19,41.89431,-87.62277
KA1503000041,7,16,false,88,71,-17,41.89452,-87.61798
142,7,16,false,12,10,-2,41.89453,-87.61806
13196,7,16,false,39,38,-1,41.89455,-87.65345
TA1307000062,7,16,false,53,42,-11,41.89466,-87.63839
TA1306000012,7,16,false,124,152,28,41.89475,-87.63438
53,7,16,false,7,11,4,41.89476,-87.63439
KP1705001026,7,16,false,59,77,18,41.89483,-87.6323
18058,7,16,false,23,29,6,41.8955,-87.68201
637,7,16,false,28,34,6,41.89563,-87.67209
128,7,16,false,3,12,9,41.89571,-87.67716
13132,7,16,false,56,53,-3,41.89573,-87.67718
161,7,16,false,9,14,5,41.89574,-87.62599
15530,7,16,false,115,142,27,41.89575,-87.62596
18003,7,16,false,27,44,17,41.89575,-87.62011
13247,7,16,false,43,55,12,41.89597,-87.66775
TA1305000020,7,16,false,38,61,23,41.89636,-87.65406
13289,7,16,false,36,49,13,41.89638,-87.661
13303,7,16,false,77,88,11,41.89672,-87.63088
13017,7,16,false,36,43,7,41.89676,-87.6357
13338,7,16,false,108,103,-5,41.89697,-87.62173
173,7,16,false,6,20,14,41.89704,-87.62173
TA1307000061,7,16,false,52,67,15,41.89745,-87.62873
106,7,16,false,4,11,7,41.89746,-87.62874
25,7,16,false,22,17,-5,41.89751,-87.62354
13034,7,16,false,112,129,17,41.89754,-87.62352
TA1306000009,7,16,false,14,41,27,41.89772,-87.64299
620,7,16,false,42,51,9,41.89817,-87.63754
KA1504000103,7,16,false,31,37,6,41.89842,-87.68659
145,7,16,false,20,13,-7,41.89856,-87.62211
15529,7,16,false,121,104,-17,41.89858,-87.62206
140,7,16,false,14,29,15,41.89895,-87.6299
TA1307000128,7,16,false,100,147,47,41.89896,-87.6299
657,7,16,false,27,37,10,41.89918,-87.6722
13248,7,16,false,28,23,-5,41.89964,-87.66788
TA1306000011,7,16,false,45,30,-15,41.89994,-87.63443
KA1504000116,7,16,false,22,15,-7,41.90023,-87.64299
17660,7,16,false,12,26,14,41.90036,-87.69671
13290,7,16,false,38,44,6,41.90069,-87.66259
13042,7,16,false,726,720,-6,41.90097,-87.62377
85,7,16,false,46,51,5,41.90098,-87.62375
TA1307000070,7,16,false,27,39,12,41.90133,-87.67742
KA1504000133,7,16,false,121,144,23,41.90234,-87.62773
172,7,16,false,9,21,12,41.90236,-87.62774
15654,7,16,false,10,16,6,41.90271,-87.70923
13241,7,16,false,27,27,0,41.9029,-87.68731
176,7,16,false,26,16,-10,41.90291,-87.63141
TA1306000006,7,16,false,11,19,8,41.90292,-87.63772
TA1307000039,7,16,false,185,205,20,41.90294,-87.63137
658,7,16,false,20,15,-5,41.903,-87.6838
13256,7,16,false,31,32,1,41.90302,-87.69749
17,7,16,false,12,8,-4,41.90313,-87.67391
TA1305000034,7,16,false,61,68,7,41.90313,-87.67391
182,7,16,false,14,15,1,41.90317,-87.63442
KA1504000135,7,16,false,164,191,27,41.90319,-87.63439
13136,7,16,false,47,66,19,41.90326,-87.67845
210,7,16,false,12,11,-1,41.90342,-87.66781
13061,7,16,false,113,134,21,41.90342,-87.66779
KA1504000079,7,16,false,61,58,-3,41.9035,-87.64334
359,7,16,false,8,13,5,41.90458,-87.6497
TA1307000115,7,16,false,23,26,3,41.9046,-87.64056
291,7,16,false,25,23,-2,41.90672,-87.63494
TA1308000049,7,16,false,154,171,17,41.90672,-87.6349
KA1504000134,7,16,false,80,84,4,41.90687,-87.6262
180,7,16,false,4,10,6,41.90687,-87.62618
13224,7,16,false,43,67,24,41.90706,-87.66725
TA1307000143,7,16,false,25,27,2,41.90762,-87.63854
61,7,16,false,6,10,4,41.90764,-87.67254
13221,7,16,false,88,124,36,41.90765,-87.67254
301,7,16,false,9,16,7,41.90796,-87.63203
TA1309000024,7,16,false,107,120,13,41.908,-87.63152
69,7,16,false,12,15,3,41.90939,-87.6777
TA1305000041,7,16,false,121,149,28,41.9094,-87.67769
331,7,16,false,97,102,5,41.90965,-87.64812
15653,7,16,false,31,32,1,41.90979,-87.7053
TA1305000037,7,16,false,53,59,6,41.91018,-87.67003
TA1306000008,7,16,false,28,40,12,41.9102,-87.6435
TA1308000005,7,16,false,31,28,-3,41.91042,-87.68238
13258,7,16,false,49,42,-7,41.91043,-87.69718
13257,7,16,false,39,34,-5,41.91054,-87.68956
13154,7,16,false,70,78,8,41.91054,-87.65312
13058,7,16,false,69,67,-2,41.91059,-87.64942
TA1307000038,7,16,false,108,103,-5,41.91138,-87.63868
LF-005,7,16,false,971,742,-229,41.91172,-87.62681
268,7,16,false,61,45,-16,41.91172,-87.62681
126,7,16,false,17,15,-2,41.91196,-87.63197
13128,7,16,false,117,105,-12,41.91197,-87.63197
289,7,16,false,36,29,-7,41.91209,-87.63472
TA1308000050,7,16,false,273,218,-55,41.91211,-87.6347
158,7,16,false,13,13,0,41.91262,-87.6814
13243,7,16,false,80,87,7,41.91262,-87.6814
TA1309000032,7,16,false,20,19,-1,41.91293,-87.66417
TA1306000032,7,16,false,53,54,1,41.9137,-87.65285
93,7,16,false,9,11,2,41.91371,-87.65285
TA1307000166,7,16,false,60,69,9,41.91386,-87.64877
15655,7,16,false,25,31,6,41.91401,-87.70514
18017,7,16,false,35,44,9,41.91416,-87.71676
18067,7,16,false,39,59,20,41.9146,-87.66796
TA1306000007,7,16,false,35,32,-3,41.91469,-87.64333
13068,7,16,false,40,45,5,41.91554,-87.68703
116,7,16,false,11,3,-8,41.91555,-87.68703
13179,7,16,false,252,253,1,41.9157,-87.63461
141,7,16,false,30,17,-13,41.91571,-87.63461
13133,7,16,false,60,71,11,41.91598,-87.67733
TA1305000039,7,16,false,47,51,4,41.9163,-87.66749
15650,7,16,false,21,29,8,41.91711,-87.71023
15651,7,16,false,42,51,9,41.91752,-87.70181
13266,7,16,false,29,29,0,41.91774,-87.69142
TA1309000029,7,16,false,33,31,-2,41.9178,-87.68245
TA1309000006,7,16,false,58,60,2,41.91809,-87.64375
TA1307000163,7,16,false,58,63,5,41.91821,-87.65696
94,7,16,false,19,24,5,41.91831,-87.6363
13146,7,16,false,252,203,-49,41.91831,-87.63629
13059,7,16,false,124,153,29,41.91845,-87.65222
113,7,16,false,17,12,-5,41.91846,-87.65222
13259,7,16,false,19,32,13,41.91852,-87.69744
13192,7,16,false,65,69,4,41.91995,-87.64884
225,7,16,false,8,13,5,41.91995,-87.64884
13288,7,16,false,37,32,-5,41.92008,-87.67788
13242,7,16,false,43,41,-2,41.92021,-87.69266
TA1309000030,7,16,false,70,73,3,41.92077,-87.66372
13292,7,16,false,32,29,-3,41.92152,-87.70733
TA1309000033,7,16,false,88,102,14,41.92158,-87.65381
13193,7,16,false,152,184,32,41.92182,-87.64412
144,7,16,false,25,20,-5,41.92182,-87.64411
13191,7,16,false,81,95,14,41.92217,-87.63891
327,7,16,false,9,13,4,41.92225,-87.65783
13084,7,16,false,46,59,13,41.92268,-87.69715
LP-,7,16,false,196,156,-40,41.92396,-87.63584
673,7,16,false,12,13,1,41.92398,-87.63585
KA1504000140,7,16,false,20,17,-3,41.92409,-87.67646
16010,7,16,false,6,10,4,41.92458,-87.72787
15648,7,16,false,21,21,0,41.92464,-87.68931
KA1504000090,7,16,false,9,21,12,41.92483,-87.7145
TA1307000001,7,16,false,51,83,32,41.92535,-87.66581
TA1306000026,7,16,false,45,52,7,41.92558,-87.65842
TA1306000016,7,16,false,57,55,-2,41.9256,-87.65371
313,7,16,false,15,19,4,41.9257,-87.64246
TA1309000019,7,16,false,182,199,17,41.92586,-87.63897
TA1309000058,7,16,false,92,101,9,41.92591,-87.64927
127,7,16,false,10,12,2,41.92592,-87.64927
TA1308000001,7,16,false,706,617,-89,41.92627,-87.63086
177,7,16,false,56,63,7,41.92627,-87.63086
15646,7,16,false,31,33,2,41.92668,-87.6977
13124,7,16,false,124,83,-41,41.92675,-87.63444
34,7,16,false,12,10,-2,41.92675,-87.63444
302,7,16,false,15,8,-7,41.92859,-87.65421
TA1309000023,7,16,false,93,85,-8,41.9287,-87.65383
TA1307000113,7,16,false,69,79,10,41.92878,-87.66391
13296,7,16,false,29,44,15,41.92883,-87.66852
TA1309000059,7,16,false,29,49,20,41.92889,-87.65898
349,7,16,false,14,16,2,41.92915,-87.6491
TA1309000061,7,16,false,81,108,27,41.92915,-87.64909
TA1308000031,7,16,false,35,33,-2,41.92946,-87.68417
340,7,16,false,12,11,-1,41.92956,-87.64313
TA1305000014,7,16,false,123,147,24,41.92956,-87.64313
260,7,16,false,13,9,-4,41.92958,-87.70791
13085,7,16,false,72,59,-13,41.92958,-87.70789
15643,7,16,false,11,13,2,41.93057,-87.7238
TA1307000142,7,16,false,92,126,34,41.93125,-87.64432
220,7,16,false,16,10,-6,41.93125,-87.64431
13276,7,16,false,148,131,-17,41.93132,-87.63874
324,7,16,false,12,10,-2,41.93173,-87.64179
15645,7,16,false,8,18,10,41.93191,-87.70121
13271,7,16,false,16,40,24,41.93192,-87.67784
TA1307000064,7,16,false,61,75,14,41.93222,-87.65864
13,7,16,false,8,14,6,41.93242,-87.65271
TA1306000014,7,16,false,76,93,17,41.93242,-87.65271
TA1309000039,7,16,false,228,214,-14,41.93258,-87.63642
329,7,16,false,18,21,3,41.93258,-87.63642
13294,7,16,false,30,53,23,41.9326,-87.66595
332,7,16,false,10,8,-2,41.93313,-87.64776
TA1309000036,7,16,false,80,86,6,41.93313,-87.64776
15644,7,16,false,12,4,-8,41.93534,-87.71687
TA1307000006,7,16,false,51,68,17,41.93571,-87.6636
153,7,16,false,7,12,5,41.93575,-87.66364
13268,7,16,false,35,40,5,41.93588,-87.67843
13269,7,16,false,25,22,-3,41.93609,-87.66983
115,7,16,false,12,6,-6,41.93628,-87.65266
TA1307000052,7,16,false,68,115,47,41.93628,-87.65266
156,7,16,false,10,7,-3,41.9365,-87.64756
TA1307000136,7,16,false,65,71,6,41.9365,-87.64755
TA1307000041,7,16,false,236,232,-4,41.93669,-87.63683
157,7,16,false,15,31,16,41.9367,-87.63683
13137,7,16,false,148,193,45,41.9376,-87.6441
300,7,16,false,10,21,11,41.93761,-87.6441
15642,7,16,false,19,31,12,41.93843,-87.69801
KA17018068,7,16,false,20,30,10,41.93935,-87.68327
TA1309000042,7,16,false,39,46,7,41.93937,-87.66836
KA150400009X,7,16,false,9,11,2,41.9394,-87.71159
13229,7,16,false,53,46,-7,41.93946,-87.66376
226,7,16,false,12,8,-4,41.93972,-87.65886
TA1308000019,7,16,false,94,84,-10,41.93973,-87.65886
13277,7,16,false,110,103,-7,41.9401,-87.64546
296,7,16,false,9,16,7,41.9401,-87.64546
TA1307000134,7,16,false,154,170,16,41.94016,-87.65303
117,7,16,false,10,10,0,41.94016,-87.65302
13143,7,16,false,17,41,24,41.94059,-87.67853
334,7,16,false,14,31,17,41.94076,-87.63919
TA1309000049,7,16,false,215,223,8,41.94077,-87.63919
15634,7,16,false,11,14,3,41.94304,-87.68729
TA1307000138,7,16,false,58,59,1,41.94334,-87.67094
13144,7,16,false,35,33,-2,41.9434,-87.67964
TA1309000025,7,16,false,144,136,-8,41.94368,-87.64894
299,7,16,false,12,14,2,41.94368,-87.64894
229,7,16,false,11,10,-1,41.94372,-87.66401
13071,7,16,false,131,122,-9,41.94373,-87.66401
632,7,16,false,200,168,-32,41.94453,-87.6547
303,7,16,false,12,9,-3,41.94522,-87.64702
15631,7,16,false,19,12,-7,41.94524,-87.70665
13278,7,16,false,108,147,39,41.94553,-87.64644
TA1309000050,7,16,false,20,21,1,41.94618,-87.67331
15632,7,16,false,12,18,6,41.94664,-87.69463
KA1504000143,7,16,false,20,19,-1,41.94664,-87.68337
KA1504000142,7,16,false,12,6,-6,41.94735,-87.71759
227,7,16,false,9,13,4,41.94813,-87.66397
13235,7,16,false,90,107,17,41.94814,-87.66396
304,7,16,false,8,12,4,41.94878,-87.64922
13253,7,16,false,21,20,-1,41.9488,-87.67527
13325,7,16,false,114,100,-14,41.94907,-87.64863
114,7,16,false,13,19,6,41.94935,-87.65451
TA1307000126,7,16,false,227,176,-51,41.94936,-87.65451
232,7,16,false,11,17,6,41.94943,-87.64645
TA1307000150,7,16,false,132,147,15,41.94945,-87.64646
13319,7,16,false,27,28,1,41.95069,-87.6687
TA1307000127,7,16,false,157,147,-10,41.9508,-87.65918
165,7,16,false,16,7,-9,41.95081,-87.65918
15628,7,16,false,14,21,7,41.95216,-87.69806
256,7,16,false,5,11,6,41.95282,-87.65
13323,7,16,false,51,75,24,41.95282,-87.65
15624,7,16,false,12,4,-8,41.95339,-87.73199
KA1504000139,7,16,false,13,10,-3,41.954,-87.71909
TA1309000043,7,16,false,31,32,1,41.95417,-87.66434
13063,7,16,false,42,48,6,41.95424,-87.65441
KA1504000158,7,16,false,9,12,3,41.95432,-87.68607
TA1308000022,7,16,false,107,145,38,41.95438,-87.64805
TA1307000149,7,16,false,27,14,-13,41.95467,-87.67392
TA1309000026,7,16,false,10,25,15,41.95601,-87.6802
13249,7,16,false,14,19,5,41.95606,-87.66885
312,7,16,false,15,10,-5,41.95637,-87.6563
TA1308000047,7,16,false,19,11,-8,41.95709,-87.6642
13379,7,16,false,61,58,-3,41.95786,-87.6495
TA1309000018,7,16,false,11,17,6,41.95791,-87.67357
306,7,16,false,5,12,7,41.9585,-87.655
TA1309000027,7,16,false,26,30,4,41.9585,-87.65499
13389,7,16,false,55,71,16,41.961,-87.64958
245,7,16,false,4,12,8,41.96101,-87.64958
15621,7,16,false,4,13,9,41.96103,-87.70586
15622,7,16,false,17,19,2,41.96108,-87.69544
TA1307000144,7,16,false,13,24,11,41.96142,-87.6762
TA1309000021,7,16,false,10,17,7,41.9615,-87.6714
KA1503000022,7,16,false,31,45,14,41.96158,-87.66609
231,7,16,false,10,12,2,41.96163,-87.65464
TA1307000107,7,16,false,69,94,25,41.96164,-87.65464
TA1307000156,7,16,false,18,28,10,41.96301,-87.68479
TA1309000012,7,16,false,10,9,-1,41.96325,-87.67928
TA1308000012,7,16,false,383,311,-72,41.96398,-87.63818
249,7,16,false,25,29,4,41.96398,-87.63818
293,7,16,false,6,12,6,41.96521,-87.65822
13074,7,16,false,34,51,17,41.96521,-87.6582
639,7,16,false,124,117,-7,41.96584,-87.64538
TA1307000140,7,16,false,28,28,0,41.96643,-87.68865
TA1309000014,7,16,false,36,49,13,41.96709,-87.66744
TA1307000158,7,16,false,13,23,10,41.9671,-87.67904
TA1307000119,7,16,false,46,39,-7,41.96796,-87.65
TA1308000021,7,16,false,28,36,8,41.96883,-87.65765
KA1504000080,7,16,false,7,15,8,41.96887,-87.69609
TA1309000015,7,16,false,15,15,0,41.96889,-87.68401
TA1309000066,7,16,false,48,40,-8,41.9691,-87.67423
TA1309000041,7,16,false,25,20,-5,41.96951,-87.65471
KA1504000171,7,16,false,84,76,-8,41.97161,-87.65016
465,7,16,false,6,13,7,41.97161,-87.65016
TA1309000035,7,16,false,57,93,36,41.97335,-87.66785
295,7,16,false,5,11,6,41.97378,-87.65972
13108,7,16,false,49,48,-1,41.97379,-87.65971
KA1504000078,7,16,false,7,13,6,41.97491,-87.69258
KA1504000149,7,16,false,16,22,6,41.97562,-87.67945
KA1504000160,7,16,false,13,11,-2,41.97564,-87.70143
KA1504000146,7,16,false,65,57,-8,41.978,-87.66805
463,7,16,false,11,13,2,41.978,-87.66805
294,7,16,false,5,13,8,41.97835,-87.65976
13109,7,16,false,34,49,15,41.97835,-87.65976
KA1504000147,7,16,false,11,10,-1,41.97976,-87.67754
655,7,16,false,27,26,-1,41.97987,-87.68194
KA1504000151,7,16,false,24,41,17,41.98359,-87.66916
KA1504000152,7,16,false,275,188,-87,41.98403,-87.65231
459,7,16,false,9,17,8,41.98403,-87.65231
15578,7,16,false,19,30,11,41.98405,-87.66027
15575,7,16,false,38,51,13,41.98975,-87.66014
KA1504000148,7,16,false,14,12,-2,41.99086,-87.66971
15571,7,16,false,37,58,21,41.99478,-87.66028
RP-009,7,16,false,27,35,8,42.00107,-87.66122
660,7,16,false,15,36,21,42.00458,-87.66143
KA1504000175,7,16,false,23,30,7,42.00797,-87.66549
KA1504000159,7,16,false,21,28,7,42.01059,-87.66241
525,7,16,false,9,13,4,42.01272,-87.66605
520,7,16,false,9,13,4,42.01597,-87.66859
523,7,16,false,12,23,11,42.02089,-87.66505
E002,7,16,false,22,19,-3,42.03256,-87.67912
599,7,16,false,16,4,-12,42.03972,-87.69942
596,7,16,false,24,46,22,42.04822,-87.68348
E008,7,16,false,37,66,29,42.05049,-87.67782
605,7,16,false,25,24,-1,42.05294,-87.67342
604,7,16,false,47,39,-8,42.05824,-87.67744
KA1503000002,7,16,true,9,12,3,41.76641,-87.5657
KA1503000029,7,16,true,5,10,5,41.77364,-87.56747
15491,7,16,true,15,11,-4,41.78096,-87.57624
426,7,16,true,18,11,-7,41.7851,-87.60108
KA1503000014,7,16,true,52,84,32,41.7851,-87.60108
KA1503000070,7,16,true,14,15,1,41.78794,-87.58831
TA1309000011,7,16,true,37,18,-19,41.78873,-87.60131
KA1503000071,7,16,true,61,43,-18,41.79148,-87.59988
423,7,16,true,14,8,-6,41.79148,-87.59988
KA1503000074,7,16,true,29,23,-6,41.79174,-87.58395
TA1309000063,7,16,true,31,37,6,41.79325,-87.5878
420,7,16,true,14,18,4,41.79429,-87.60145
KA1504000076,7,16,true,43,33,-10,41.7943,-87.60145
247,7,16,true,13,13,0,41.79522,-87.58077
TA1308000009,7,16,true,90,92,2,41.79522,-87.58075
TA1307000164,7,16,true,40,34,-6,41.79527,-87.59647
KA1503000052,7,16,true,31,29,-2,41.79935,-87.60097
KA1503000059,7,16,true,33,27,-6,41.79952,-87.58643
419,7,16,true,6,11,5,41.79952,-87.58643
TA1309000037,7,16,true,56,76,20,41.79957,-87.59474
KA1503000007,7,16,true,30,41,11,41.80242,-87.58689
13398,7,16,true,19,25,6,41.80256,-87.59035
322,7,16,true,14,15,1,41.80321,-87.59849
TA1308000035,7,16,true,16,20,4,41.80944,-87.59188
TA1308000002,7,16,true,11,8,-3,41.80983,-87.59937
KA1503000065,7,16,true,9,10,1,41.81409,-87.59701
TA1308000045,7,16,true,10,16,6,41.83062,-87.64129
15446,7,16,true,8,13,5,41.83068,-87.65603
KA1503000005,7,16,true,29,7,-22,41.83079,-87.6325
TA1307000129,7,16,true,27,14,-13,41.83104,-87.62683
KA1503000004,7,16,true,19,11,-8,41.83127,-87.6088
13345,7,16,true,10,9,-1,41.83138,-87.61803
15445,7,16,true,25,12,-13,41.83453,-87.63183
13216,7,16,true,34,28,-6,41.83473,-87.62581
148,7,16,true,7,10,3,41.83474,-87.62581
13217,7,16,true,35,27,-8,41.83488,-87.61792
13215,7,16,true,15,15,0,41.83634,-87.6135
TA1308000046,7,16,true,14,14,0,41.83779,-87.65115
339,7,16,true,7,10,3,41.83817,-87.64523
TA1309000055,7,16,true,38,38,0,41.8382,-87.64514
KA1503000038,7,16,true,19,14,-5,41.83845,-87.6354
TA1307000048,7,16,true,68,63,-5,41.83855,-87.60821
150,7,16,true,13,10,-3,41.83855,-87.60821
TA1308000036,7,16,true,22,23,1,41.83883,-87.62186
237,7,16,true,15,14,-1,41.84204,-87.61697
TA1307000139,7,16,true,31,17,-14,41.84205,-87.61698
15443,7,16,true,7,12,5,41.84275,-87.63549
TA1307000153,7,16,true,17,35,18,41.84358,-87.64538
TA1307000005,7,16,true,15,16,1,41.84569,-87.6225
TA1308000013,7,16,true,10,12,2,41.84719,-87.64681
TA1308000026,7,16,true,9,13,4,41.85008,-87.63214
TA1305000004,7,16,true,11,10,-1,41.8514,-87.61884
TA1305000001,7,16,true,10,15,5,41.85262,-87.6265
13075,7,16,true,56,47,-9,41.8531,-87.63192
120,7,16,true,4,12,8,41.8531,-87.63191
13091,7,16,true,2,11,9,41.85409,-87.68585
15546,7,16,true,15,25,10,41.85416,-87.61916
13307,7,16,true,8,10,2,41.85489,-87.66359
15545,7,16,true,141,128,-13,41.85627,-87.61334
4,7,16,true,30,28,-2,41.85627,-87.61334
SL-013,7,16,true,15,16,1,41.85659,-87.62755
SL-006,7,16,true,12,13,1,41.8568,-87.63387
13135,7,16,true,25,22,-3,41.85753,-87.66157
338,7,16,true,12,13,1,41.85758,-87.61956
13102,7,16,true,50,56,6,41.85762,-87.61942
273,7,16,true,17,10,-7,41.85783,-87.62455
13150,7,16,true,45,68,23,41.85783,-87.62455
13099,7,16,true,9,15,6,41.85784,-87.64627
TA1307000159,7,16,true,19,21,2,41.8579,-87.6687
TA1307000044,7,16,true,12,5,-7,41.85794,-87.64083
13163,7,16,true,15,16,1,41.85808,-87.65108
13164,7,16,true,25,34,9,41.85818,-87.65648
SL-012,7,16,true,34,55,21,41.86038,-87.62581
72,7,16,true,10,7,-3,41.86039,-87.62581
13304,7,16,true,10,16,6,41.86126,-87.65659
TA1306000002,7,16,true,26,24,-2,41.86238,-87.65108
TA1307000124,7,16,true,49,65,16,41.86411,-87.62372
168,7,16,true,10,15,5,41.86415,-87.62372
TA1309000001,7,16,true,33,27,-6,41.86488,-87.64708
13354,7,16,true,29,35,6,41.86524,-87.66651
275,7,16,true,6,13,7,41.86524,-87.66651
13029,7,16,true,16,24,8,41.86531,-87.6179
341,7,16,true,13,20,7,41.86608,-87.60733
13431,7,16,true,105,100,-5,41.8661,-87.60728
WL-008,7,16,true,49,61,12,41.86712,-87.64108
57,7,16,true,16,11,-5,41.86712,-87.64107
59,7,16,true,24,30,6,41.86721,-87.62597
TA1305000002,7,16,true,118,134,16,41.86721,-87.62597
3,7,16,true,11,6,-5,41.86723,-87.61536
15544,7,16,true,73,77,4,41.86723,-87.61536
TA1305000017,7,16,true,23,9,-14,41.86734,-87.64863
KA1706005007,7,16,true,34,42,8,41.86749,-87.63219
SL-005,7,16,true,99,102,3,41.8679,-87.62304
255,7,16,true,12,24,12,41.86791,-87.62304
644,7,16,true,31,34,3,41.86859,-87.68625
19,7,16,true,11,8,-3,41.86892,-87.65913
13139,7,16,true,44,48,4,41.86893,-87.65913
13285,7,16,true,28,11,-17,41.86928,-87.67372
13160,7,16,true,37,40,3,41.86947,-87.65548
22,7,16,true,8,17,9,41.86947,-87.65548
15550,7,16,true,36,31,-5,41.87024,-87.63947
TA1309000010,7,16,true,66,68,2,41.87074,-87.62574
SL-009,7,16,true,23,37,14,41.87081,-87.63121
TA1309000064,7,16,true,28,11,-17,41.87127,-87.67369
TA1307000130,7,16,true,49,34,-15,41.87178,-87.65103
241,7,16,true,11,15,4,41.8718,-87.65102
108,7,16,true,17,5,-12,41.87183,-87.64664
TA1307000121,7,16,true,54,38,-16,41.87184,-87.64664
41,7,16,true,14,11,-3,41.87209,-87.62957
SL-008,7,16,true,72,94,22,41.87209,-87.62956
13332,7,16,true,100,84,-16,41.87219,-87.6615
394,7,16,true,3,10,7,41.87226,-87.63484
175,7,16,true,7,15,8,41.87255,-87.63359
SL-011,7,16,true,40,36,-4,41.87256,-87.63356
623,7,16,true,51,52,1,41.87272,-87.62399
KA1504000104,7,16,true,45,12,-33,41.87296,-87.66912
383,7,16,true,11,2,-9,41.87297,-87.66912
320,7,16,true,12,16,4,41.87327,-87.66402
SL-007,7,16,true,43,37,-6,41.87404,-87.6277
321,7,16,true,12,17,5,41.87427,-87.63257
TA1306000025,7,16,true,25,19,-6,41.87464,-87.65703
15668,7,16,true,11,5,-6,41.87471,-87.68642
13028,7,16,true,29,22,-7,41.87475,-87.64981
SL-010,7,16,true,25,27,2,41.87501,-87.63309
15541,7,16,true,26,29,3,41.8758,-87.62086
13037,7,16,true,14,8,-6,41.87588,-87.64078
TA1305000009,7,16,true,21,18,-3,41.87593,-87.63068
TA1305000010,7,16,true,24,14,-10,41.87623,-87.62444
624,7,16,true,27,17,-10,41.87626,-87.62923
33,7,16,true,10,3,-7,41.87715,-87.62786
TA1305000035,7,16,true,30,27,-3,41.87716,-87.62787
15539,7,16,true,61,75,14,41.87763,-87.64405
13158,7,16,true,52,54,2,41.87764,-87.64957
13157,7,16,true,64,65,1,41.87773,-87.6548
21,7,16,true,7,13,6,41.87773,-87.6548
TA1305000025,7,16,true,36,46,10,41.87773,-87.63528
36,7,16,true,4,12,8,41.87776,-87.63525
TA1309000002,7,16,true,31,23,-8,41.87784,-87.62408
13206,7,16,true,44,36,-8,41.87794,-87.66201
107,7,16,true,16,12,-4,41.87822,-87.644
638,7,16,true,37,30,-7,41.87827,-87.64078
TA1305000005,7,16,true,20,10,-10,41.87924,-87.62975
13011,7,16,true,57,28,-29,41.87931,-87.63993
192,7,16,true,11,7,-4,41.87935,-87.63997
KA1503000034,7,16,true,17,2,-15,41.87938,-87.63197
KA1503000015,7,16,true,12,9,-3,41.87948,-87.6257
15667,7,16,true,14,19,5,41.8798,-87.68609
WL-011,7,16,true,45,62,17,41.88034,-87.64273
73,7,16,true,10,10,0,41.8804,-87.64273
80,7,16,true,4,10,6,41.88042,-87.65556
13156,7,16,true,34,66,32,41.88042,-87.65554
13300,7,16,true,169,182,13,41.88097,-87.61675
76,7,16,true,27,21,-6,41.88098,-87.61675
13008,7,16,true,68,73,5,41.88105,-87.62408
90,7,16,true,12,16,4,41.88107,-87.62409
49,7,16,true,15,7,-8,41.88116,-87.62963
TA1305000006,7,16,true,48,49,1,41.88122,-87.6296
13056,7,16,true,13,14,1,41.88168,-87.63951
198,7,16,true,24,24,0,41.88187,-87.6488
TA1307000120,7,16,true,128,133,5,41.88188,-87.64879
13341,7,16,true,26,36,10,41.88208,-87.63985
13036,7,16,true,31,23,-8,41.8821,-87.62513
77,7,16,true,21,26,5,41.88214,-87.64108
TA1305000032,7,16,true,80,102,22,41.88218,-87.64109
13006,7,16,true,22,11,-11,41.88268,-87.63252
13353,7,16,true,37,54,17,41.88283,-87.6612
346,7,16,true,10,9,-1,41.88284,-87.6612
654,7,16,true,24,23,-1,41.88307,-87.65698
13409,7,16,true,35,37,2,41.8831,-87.6511
KA1503000072,7,16,true,14,13,-1,41.88317,-87.63693
WL-012,7,16,true,30,24,-6,41.88337,-87.6412
112,7,16,true,15,12,-3,41.88362,-87.6486
13053,7,16,true,76,96,20,41.88365,-87.64863
43,7,16,true,14,9,-5,41.88396,-87.62455
13001,7,16,true,66,46,-20,41.88397,-87.62459
13155,7,16,true,15,16,1,41.88407,-87.65689
18062,7,16,true,33,41,8,41.88412,-87.65427
81,7,16,true,17,14,-3,41.88417,-87.6296
TA1306000010,7,16,true,71,64,-7,41.88419,-87.62961
TA1305000030,7,16,true,28,22,-6,41.88459,-87.63178
15535,7,16,true,56,60,4,41.8846,-87.64455
TA1305000029,7,16,true,78,69,-9,41.88466,-87.62787
195,7,16,true,15,16,1,41.88466,-87.61952
13263,7,16,true,82,81,-1,41.88467,-87.61952
44,7,16,true,25,20,-5,41.88468,-87.62782
TA1306000015,7,16,true,57,72,15,41.88549,-87.65232
71,7,16,true,10,13,3,41.8855,-87.65233
66,7,16,true,13,6,-7,41.88557,-87.64186
13021,7,16,true,63,46,-17,41.88559,-87.64184
TA1307000111,7,16,true,52,29,-23,41.88582,-87.63548
13073,7,16,true,24,23,-1,41.88592,-87.66717
KA17018054,7,16,true,14,20,6,41.88595,-87.67701
38,7,16,true,15,10,-5,41.88599,-87.63089
KA1503000012,7,16,true,56,64,8,41.88599,-87.63089
52,7,16,true,10,12,2,41.886,-87.62421
TA1305000011,7,16,true,47,54,7,41.886,-87.62418
7,7,16,true,19,13,-6,41.88627,-87.61751
15534,7,16,true,52,73,21,41.88627,-87.61749
13197,7,16,true,17,15,-2,41.8866,-87.65816
TA1308000029,7,16,true,29,31,2,41.88673,-87.62225
TA1307000131,7,16,true,31,29,-2,41.88688,-87.62606
KA1503000064,7,16,true,90,68,-22,41.88697,-87.61281
6,7,16,true,11,10,-1,41.88697,-87.61281
TA1305000022,7,16,true,57,51,-6,41.88817,-87.63656
56,7,16,true,24,21,-3,41.88866,-87.64442
TA1306000003,7,16,true,131,124,-7,41.88867,-87.64442
KA1503000043,7,16,true,143,121,-22,41.88918,-87.63851
133,7,16,true,27,13,-14,41.88918,-87.63851
13050,7,16,true,66,54,-12,41.88919,-87.62775
13432,7,16,true,29,29,0,41.88989,-87.67149
TA1307000151,7,16,true,79,78,-1,41.88993,-87.63427
212,7,16,true,9,17,8,41.88995,-87.63427
636,7,16,true,48,58,10,41.88997,-87.63662
KA1503000044,7,16,true,30,32,2,41.89018,-87.6262
196,7,16,true,5,10,5,41.89053,-87.62205
13427,7,16,true,30,39,9,41.89054,-87.62205
26,7,16,true,13,20,7,41.89057,-87.61798
13430,7,16,true,85,78,-7,41.89077,-87.63169
181,7,16,true,7,10,3,41.89077,-87.63168
TA1306000013,7,16,true,85,114,29,41.89083,-87.61852
RN-,7,16,true,67,76,9,41.89102,-87.63546
672,7,16,true,16,10,-6,41.89102,-87.63545
13434,7,16,true,29,26,-3,41.89108,-87.66663
TA1308000006,7,16,true,25,16,-9,41.89128,-87.67686
199,7,16,true,24,34,10,41.89143,-87.62676
TA1307000117,7,16,true,134,136,2,41.89144,-87.62675
13033,7,16,true,65,105,40,41.8916,-87.64835
84,7,16,true,12,13,1,41.89161,-87.64833
186,7,16,true,7,19,12,41.8918,-87.65879
13194,7,16,true,47,60,13,41.8918,-87.65878
TA1305000003,7,16,true,99,105,6,41.89187,-87.62061
24,7,16,true,25,19,-6,41.8919,-87.62063
643,7,16,true,11,12,1,41.89203,-87.68939
35,7,16,true,26,23,-3,41.89227,-87.61206
13022,7,16,true,276,249,-27,41.89227,-87.61205
99,7,16,true,10,11,1,41.89255,-87.61449
TA1306000029,7,16,true,82,103,21,41.89256,-87.61449
13265,7,16,true,81,85,4,41.89383,-87.64172
74,7,16,true,26,15,-11,41.89384,-87.64173
13045,7,16,true,113,129,16,41.89403,-87.62931
110,7,16,true,29,29,0,41.89406,-87.6293
13016,7,16,true,65,44,-21,41.89431,-87.62277
211,7,16,true,17,9,-8,41.89439,-87.62267
KA1503000041,7,16,true,52,49,-3,41.89452,-87.61798
142,7,16,true,17,9,-8,41.89453,-87.61806
13196,7,16,true,31,31,0,41.89455,-87.65345
TA1307000062,7,16,true,37,32,-5,41.89466,-87.63839
TA1306000012,7,16,true,124,126,2,41.89475,-87.63438
53,7,16,true,23,16,-7,41.89476,-87.63439
KP1705001026,7,16,true,59,43,-16,41.89483,-87.6323
18058,7,16,true,8,20,12,41.8955,-87.68201
637,7,16,true,27,29,2,41.89563,-87.67209
128,7,16,true,12,11,-1,41.89571,-87.67716
13132,7,16,true,58,72,14,41.89573,-87.67718
161,7,16,true,20,13,-7,41.89574,-87.62599
15530,7,16,true,70,73,3,41.89575,-87.62596
18003,7,16,true,27,19,-8,41.89575,-87.62011
13247,7,16,true,26,34,8,41.89597,-87.66775
TA1305000020,7,16,true,52,61,9,41.89636,-87.65406
13289,7,16,true,39,38,-1,41.89638,-87.661
337,7,16,true,14,7,-7,41.89659,-87.63096
13303,7,16,true,45,51,6,41.89672,-87.63088
13017,7,16,true,59,62,3,41.89676,-87.6357
31,7,16,true,7,12,5,41.89677,-87.63572
13338,7,16,true,49,43,-6,41.89697,-87.62173
TA1307000061,7,16,true,47,40,-7,41.89745,-87.62873
106,7,16,true,11,7,-4,41.89746,-87.62874
13034,7,16,true,60,40,-20,41.89754,-87.62352
TA1306000009,7,16,true,33,34,1,41.89772,-87.64299
620,7,16,true,45,37,-8,41.89817,-87.63754
KA1504000103,7,16,true,22,32,10,41.89842,-87.68659
145,7,16,true,16,14,-2,41.89856,-87.62211
15529,7,16,true,71,68,-3,41.89858,-87.62206
140,7,16,true,24,27,3,41.89895,-87.6299
TA1307000128,7,16,true,112,106,-6,41.89896,-87.6299
657,7,16,true,37,50,13,41.89918,-87.6722
KA1504000117,7,16,true,13,13,0,41.89936,-87.64848
13248,7,16,true,27,37,10,41.89964,-87.66788
46,7,16,true,10,8,-2,41.89994,-87.63444
TA1306000011,7,16,true,38,33,-5,41.89994,-87.63443
KA1504000116,7,16,true,15,36,21,41.90023,-87.64299
17660,7,16,true,25,27,2,41.90036,-87.69671
29,7,16,true,8,14,6,41.90069,-87.66259
13290,7,16,true,42,52,10,41.90069,-87.66259
13042,7,16,true,236,203,-33,41.90097,-87.62377
85,7,16,true,18,16,-2,41.90098,-87.62375
TA1307000070,7,16,true,36,28,-8,41.90133,-87.67742
KA1504000133,7,16,true,100,79,-21,41.90234,-87.62773
172,7,16,true,12,15,3,41.90236,-87.62774
305,7,16,true,7,10,3,41.9028,-87.69005
13241,7,16,true,14,19,5,41.9029,-87.68731
176,7,16,true,37,53,16,41.90291,-87.63141
TA1306000006,7,16,true,19,14,-5,41.90292,-87.63772
TA1307000039,7,16,true,180,197,17,41.90294,-87.63137
658,7,16,true,15,23,8,41.903,-87.6838
13256,7,16,true,21,22,1,41.90302,-87.69749
17,7,16,true,12,9,-3,41.90313,-87.67391
TA1305000034,7,16,true,51,51,0,41.90313,-87.67391
182,7,16,true,34,27,-7,41.90317,-87.63442
KA1504000135,7,16,true,207,217,10,41.90319,-87.63439
13136,7,16,true,64,41,-23,41.90326,-87.67845
130,7,16,true,12,9,-3,41.90327,-87.67846
210,7,16,true,13,25,12,41.90342,-87.66781
13061,7,16,true,84,113,29,41.90342,-87.66779
KA1504000079,7,16,true,77,70,-7,41.9035,-87.64334
359,7,16,true,12,16,4,41.90458,-87.6497
138,7,16,true,6,11,5,41.9046,-87.64057
TA1307000115,7,16,true,30,31,1,41.9046,-87.64056
291,7,16,true,19,24,5,41.90672,-87.63494
TA1308000049,7,16,true,108,130,22,41.90672,-87.6349
KA1504000134,7,16,true,50,67,17,41.90687,-87.6262
180,7,16,true,13,11,-2,41.90687,-87.62618
333,7,16,true,7,11,4,41.90706,-87.66725
13224,7,16,true,42,50,8,41.90706,-87.66725
TA1307000143,7,16,true,15,12,-3,41.90762,-87.63854
61,7,16,true,5,16,11,41.90764,-87.67254
13221,7,16,true,94,92,-2,41.90765,-87.67254
301,7,16,true,30,12,-18,41.90796,-87.63203
TA1309000024,7,16,true,85,96,11,41.908,-87.63152
69,7,16,true,19,13,-6,41.90939,-87.6777
TA1305000041,7,16,true,86,104,18,41.9094,-87.67769
331,7,16,true,126,134,8,41.90965,-87.64812
15653,7,16,true,21,20,-1,41.90979,-87.7053
TA1305000037,7,16,true,38,58,20,41.91018,-87.67003
TA1306000008,7,16,true,45,27,-18,41.9102,-87.6435
TA1308000005,7,16,true,31,28,-3,41.91042,-87.68238
13258,7,16,true,28,22,-6,41.91043,-87.69718
13257,7,16,true,17,23,6,41.91054,-87.68956
13154,7,16,true,120,95,-25,41.91054,-87.65312
20,7,16,true,35,26,-9,41.91055,-87.65313
60,7,16,true,16,8,-8,41.91059,-87.64942
13058,7,16,true,77,82,5,41.91059,-87.64942
118,7,16,true,5,10,5,41.91138,-87.63868
TA1307000038,7,16,true,49,73,24,41.91138,-87.63868
LF-005,7,16,true,416,330,-86,41.91172,-87.62681
268,7,16,true,36,32,-4,41.91172,-87.62681
126,7,16,true,15,17,2,41.91196,-87.63197
13128,7,16,true,72,50,-22,41.91197,-87.63197
289,7,16,true,32,28,-4,41.91209,-87.63472
TA1308000050,7,16,true,204,207,3,41.91211,-87.6347
13243,7,16,true,76,79,3,41.91262,-87.6814
158,7,16,true,8,13,5,41.91262,-87.6814
TA1309000032,7,16,true,11,18,7,41.91293,-87.66417
TA1306000032,7,16,true,85,78,-7,41.9137,-87.65285
93,7,16,true,20,15,-5,41.91371,-87.65285
TA1307000166,7,16,true,62,54,-8,41.91386,-87.64877
15655,7,16,true,22,28,6,41.91401,-87.70514
18017,7,16,true,12,18,6,41.91416,-87.71676
18067,7,16,true,53,33,-20,41.9146,-87.66796
628,7,16,true,9,12,3,41.9146,-87.66796
TA1306000007,7,16,true,19,32,13,41.91469,-87.64333
13068,7,16,true,51,44,-7,41.91554,-87.68703
13179,7,16,true,182,141,-41,41.9157,-87.63461
141,7,16,true,28,15,-13,41.91571,-87.63461
219,7,16,true,12,13,1,41.91598,-87.67733
13133,7,16,true,64,74,10,41.91598,-87.67733
58,7,16,true,15,10,-5,41.91602,-87.66894
TA1305000039,7,16,true,46,43,-3,41.9163,-87.66749
15650,7,16,true,17,12,-5,41.91711,-87.71023
15651,7,16,true,38,35,-3,41.91752,-87.70181
13266,7,16,true,16,25,9,41.91774,-87.69142
TA1309000029,7,16,true,17,34,17,41.9178,-87.68245
288,7,16,true,13,7,-6,41.91809,-87.64375
TA1309000006,7,16,true,49,49,0,41.91809,-87.64375
223,7,16,true,11,12,1,41.91821,-87.65698
TA1307000163,7,16,true,60,66,6,41.91821,-87.65696
94,7,16,true,26,27,1,41.91831,-87.6363
13146,7,16,true,130,147,17,41.91831,-87.63629
13059,7,16,true,123,126,3,41.91845,-87.65222
113,7,16,true,16,19,3,41.91846,-87.65222
13259,7,16,true,18,21,3,41.91852,-87.69744
225,7,16,true,15,17,2,41.91995,-87.64884
13192,7,16,true,57,76,19,41.91995,-87.64884
13288,7,16,true,32,42,10,41.92008,-87.67788
13242,7,16,true,28,27,-1,41.92021,-87.69266
TA1309000030,7,16,true,53,47,-6,41.92077,-87.66372
13292,7,16,true,23,16,-7,41.92152,-87.70733
TA1309000033,7,16,true,96,92,-4,41.92158,-87.65381
13193,7,16,true,138,181,43,41.92182,-87.64412
144,7,16,true,23,21,-2,41.92182,-87.64411
143,7,16,true,11,14,3,41.92217,-87.63891
13191,7,16,true,55,69,14,41.92217,-87.63891
327,7,16,true,18,14,-4,41.92225,-87.65783
13084,7,16,true,53,44,-9,41.92268,-87.69715
123,7,16,true,12,14,2,41.92268,-87.69714
LP-,7,16,true,71,67,-4,41.92396,-87.63584
673,7,16,true,15,25,10,41.92398,-87.63585
16010,7,16,true,3,10,7,41.92458,-87.72787
15648,7,16,true,19,20,1,41.92464,-87.68931
KA1504000090,7,16,true,3,16,13,41.92483,-87.7145
TA1307000001,7,16,true,40,73,33,41.92535,-87.66581
TA1306000026,7,16,true,60,51,-9,41.92558,-87.65842
67,7,16,true,10,9,-1,41.9256,-87.65371
TA1306000016,7,16,true,55,59,4,41.9256,-87.65371
313,7,16,true,8,22,14,41.9257,-87.64246
TA1309000019,7,16,true,119,127,8,41.92586,-87.63897
TA1309000058,7,16,true,106,90,-16,41.92591,-87.64927
127,7,16,true,16,16,0,41.92592,-87.64927
TA1308000001,7,16,true,357,306,-51,41.92627,-87.63086
177,7,16,true,56,46,-10,41.92627,-87.63086
15646,7,16,true,26,21,-5,41.92668,-87.6977
13124,7,16,true,40,22,-18,41.92675,-87.63444
34,7,16,true,10,7,-3,41.92675,-87.63444
302,7,16,true,17,10,-7,41.92859,-87.65421
TA1309000023,7,16,true,73,85,12,41.9287,-87.65383
TA1307000113,7,16,true,57,71,14,41.92878,-87.66391
13296,7,16,true,29,40,11,41.92883,-87.66852
TA1309000059,7,16,true,41,49,8,41.92889,-87.65898
349,7,16,true,14,22,8,41.92915,-87.6491
TA1309000061,7,16,true,88,125,37,41.92915,-87.64909
258,7,16,true,10,6,-4,41.92946,-87.68417
TA1308000031,7,16,true,28,27,-1,41.92946,-87.68417
TA1305000014,7,16,true,122,121,-1,41.92956,-87.64313
340,7,16,true,24,27,3,41.92956,-87.64313
260,7,16,true,15,13,-2,41.92958,-87.70791
13085,7,16,true,53,41,-12,41.92958,-87.70789
15643,7,16,true,4,15,11,41.93057,-87.7238
TA1307000142,7,16,true,114,129,15,41.93125,-87.64432
220,7,16,true,27,24,-3,41.93125,-87.64431
13276,7,16,true,75,71,-4,41.93132,-87.63874
324,7,16,true,12,20,8,41.93173,-87.64179
13271,7,16,true,32,32,0,41.93192,-87.67784
152,7,16,true,13,13,0,41.93221,-87.65864
TA1307000064,7,16,true,70,74,4,41.93222,-87.65864
13,7,16,true,10,9,-1,41.93242,-87.65271
TA1306000014,7,16,true,86,91,5,41.93242,-87.65271
TA1309000039,7,16,true,153,149,-4,41.93258,-87.63642
329,7,16,true,13,21,8,41.93258,-87.63642
13294,7,16,true,23,43,20,41.9326,-87.66595
332,7,16,true,12,9,-3,41.93313,-87.64776
TA1309000036,7,16,true,69,90,21,41.93313,-87.64776
15644,7,16,true,12,6,-6,41.93534,-87.71687
TA1307000006,7,16,true,60,87,27,41.93571,-87.6636
153,7,16,true,11,14,3,41.93575,-87.66364
13268,7,16,true,22,27,5,41.93588,-87.67843
250,7,16,true,10,10,0,41.93609,-87.66984
13269,7,16,true,23,33,10,41.93609,-87.66983
TA1307000052,7,16,true,97,92,-5,41.93628,-87.65266
115,7,16,true,13,20,7,41.93628,-87.65266
156,7,16,true,18,20,2,41.9365,-87.64756
TA1307000136,7,16,true,100,114,14,41.9365,-87.64755
TA1307000041,7,16,true,174,153,-21,41.93669,-87.63683
157,7,16,true,29,26,-3,41.9367,-87.63683
13137,7,16,true,138,156,18,41.9376,-87.6441
300,7,16,true,40,33,-7,41.93761,-87.6441
KA17018068,7,16,true,18,16,-2,41.93935,-87.68327
TA1309000042,7,16,true,48,69,21,41.93937,-87.66836
KA150400009X,7,16,true,7,13,6,41.9394,-87.71159
13229,7,16,true,38,53,15,41.93946,-87.66376
TA1308000019,7,16,true,52,69,17,41.93973,-87.65886
296,7,16,true,22,26,4,41.9401,-87.64546
13277,7,16,true,85,109,24,41.9401,-87.64546
TA1307000134,7,16,true,132,147,15,41.94016,-87.65303
117,7,16,true,17,17,0,41.94016,-87.65302
13143,7,16,true,20,23,3,41.94059,-87.67853
334,7,16,true,21,19,-2,41.94076,-87.63919
TA1309000049,7,16,true,130,122,-8,41.94077,-87.63919
15634,7,16,true,9,17,8,41.94304,-87.68729
TA1307000138,7,16,true,45,51,6,41.94334,-87.67094
13144,7,16,true,16,21,5,41.9434,-87.67964
299,7,16,true,21,15,-6,41.94368,-87.64894
TA1309000025,7,16,true,100,123,23,41.94368,-87.64894
229,7,16,true,15,11,-4,41.94372,-87.66401
13071,7,16,true,118,106,-12,41.94373,-87.66401
632,7,16,true,120,121,1,41.94453,-87.6547
303,7,16,true,24,24,0,41.94522,-87.64702
13278,7,16,true,113,134,21,41.94553,-87.64644
TA1309000050,7,16,true,22,21,-1,41.94618,-87.67331
15632,7,16,true,15,15,0,41.94664,-87.69463
KA1504000143,7,16,true,7,11,4,41.94664,-87.68337
227,7,16,true,16,20,4,41.94813,-87.66397
13235,7,16,true,109,112,3,41.94814,-87.66396
304,7,16,true,19,26,7,41.94878,-87.64922
13253,7,16,true,30,31,1,41.9488,-87.67527
13325,7,16,true,132,145,13,41.94907,-87.64863
TA1307000126,7,16,true,115,93,-22,41.94936,-87.65451
232,7,16,true,36,23,-13,41.94943,-87.64645
TA1307000150,7,16,true,135,135,0,41.94945,-87.64646
13319,7,16,true,34,28,-6,41.95069,-87.6687
TA1307000127,7,16,true,65,78,13,41.9508,-87.65918
165,7,16,true,17,19,2,41.95081,-87.65918
15628,7,16,true,14,18,4,41.95216,-87.69806
13323,7,16,true,54,51,-3,41.95282,-87.65
256,7,16,true,14,16,2,41.95282,-87.65
TA1309000043,7,16,true,31,35,4,41.95417,-87.66434
240,7,16,true,15,8,-7,41.95424,-87.65441
13063,7,16,true,60,62,2,41.95424,-87.65441
KA1504000158,7,16,true,12,19,7,41.95432,-87.68607
254,7,16,true,12,17,5,41.95438,-87.64806
TA1308000022,7,16,true,97,73,-24,41.95438,-87.64805
TA1307000149,7,16,true,30,31,1,41.95467,-87.67392
298,7,16,true,11,6,-5,41.95601,-87.68021
TA1309000026,7,16,true,39,64,25,41.95601,-87.6802
13249,7,16,true,21,22,1,41.95606,-87.66885
312,7,16,true,15,12,-3,41.95637,-87.6563
TA1308000047,7,16,true,24,25,1,41.95709,-87.6642
13379,7,16,true,56,79,23,41.95786,-87.6495
TA1309000018,7,16,true,23,19,-4,41.95791,-87.67357
TA1309000027,7,16,true,29,39,10,41.9585,-87.65499
13389,7,16,true,74,67,-7,41.961,-87.64958
245,7,16,true,7,15,8,41.96101,-87.64958
15621,7,16,true,10,10,0,41.96103,-87.70586
15622,7,16,true,26,17,-9,41.96108,-87.69544
TA1307000144,7,16,true,29,30,1,41.96142,-87.6762
TA1309000021,7,16,true,13,16,3,41.9615,-87.6714
15623,7,16,true,21,23,2,41.96154,-87.69117
234,7,16,true,8,13,5,41.96158,-87.6661
KA1503000022,7,16,true,22,25,3,41.96158,-87.66609
231,7,16,true,14,28,14,41.96163,-87.65464
TA1307000107,7,16,true,97,90,-7,41.96164,-87.65464
TA1307000156,7,16,true,44,43,-1,41.96301,-87.68479
243,7,16,true,5,11,6,41.96302,-87.68479
TA1309000012,7,16,true,16,13,-3,41.96325,-87.67928
TA1308000012,7,16,true,215,166,-49,41.96398,-87.63818
249,7,16,true,35,21,-14,41.96398,-87.63818
13074,7,16,true,56,57,1,41.96521,-87.6582
639,7,16,true,97,85,-12,41.96584,-87.64538
KA1504000127,7,16,true,15,19,4,41.96587,-87.70083
KA1504000093,7,16,true,5,13,8,41.96587,-87.69365
TA1307000140,7,16,true,36,44,8,41.96643,-87.68865
239,7,16,true,7,11,4,41.9665,-87.68843
TA1309000014,7,16,true,56,55,-1,41.96709,-87.66744
TA1307000158,7,16,true,21,23,2,41.9671,-87.67904
TA1307000119,7,16,true,40,43,3,41.96796,-87.65
TA1308000021,7,16,true,27,22,-5,41.96883,-87.65765
KA1504000080,7,16,true,18,20,2,41.96887,-87.69609
TA1309000015,7,16,true,14,20,6,41.96889,-87.68401
344,7,16,true,11,15,4,41.9691,-87.67423
TA1309000066,7,16,true,46,63,17,41.9691,-87.67423
TA1309000041,7,16,true,23,32,9,41.96951,-87.65471
KA1504000171,7,16,true,60,55,-5,41.97161,-87.65016
465,7,16,true,10,12,2,41.97161,-87.65016
325,7,16,true,7,10,3,41.9728,-87.67186
TA1309000035,7,16,true,56,108,52,41.97335,-87.66785
295,7,16,true,11,12,1,41.97378,-87.65972
13108,7,16,true,45,56,11,41.97379,-87.65971
KA1504000078,7,16,true,12,15,3,41.97491,-87.69258
KA1504000149,7,16,true,22,24,2,41.97562,-87.67945
KA1504000160,7,16,true,13,12,-1,41.97564,-87.70143
KA1504000146,7,16,true,95,84,-11,41.978,-87.66805
463,7,16,true,14,13,-1,41.978,-87.66805
294,7,16,true,13,9,-4,41.97835,-87.65976
13109,7,16,true,55,57,2,41.97835,-87.65976
655,7,16,true,19,17,-2,41.97987,-87.68194
KA1504000151,7,16,true,41,48,7,41.98359,-87.66916
KA1504000152,7,16,true,176,137,-39,41.98403,-87.65231
459,7,16,true,29,37,8,41.98403,-87.65231
15578,7,16,true,33,16,-17,41.98405,-87.66027
15575,7,16,true,39,42,3,41.98975,-87.66014
KA1504000148,7,16,true,10,10,0,41.99086,-87.66971
15571,7,16,true,49,44,-5,41.99478,-87.66028
454,7,16,true,9,17,8,41.99478,-87.66027
KA1504000156,7,16,true,11,12,1,41.99925,-87.67137
RP-009,7,16,true,15,24,9,42.00107,-87.66122
RP-008,7,16,true,13,29,16,42.00446,-87.6724
660,7,16,true,27,25,-2,42.00458,-87.66143
KA1504000175,7,16,true,22,25,3,42.00797,-87.66549
RP-005,7,16,true,10,8,-2,42.0086,-87.69047
KA1504000162,7,16,true,10,8,-2,42.00907,-87.67422
KA1504000159,7,16,true,11,17,6,42.01059,-87.66241
525,7,16,true,11,22,11,42.01272,-87.66605
517,7,16,true,10,8,-2,42.01597,-87.675
520,7,16,true,44,22,-22,42.01597,-87.66859
515,7,16,true,14,8,-6,42.01915,-87.67356
523,7,16,true,14,25,11,42.02089,-87.66505
E002,7,16,true,18,17,-1,42.03256,-87.67912
596,7,16,true,28,39,11,42.04822,-87.68348
E008,7,16,true,16,9,-7,42.05049,-87.67782
604,7,16,true,14,18,4,42.05824,-87.67744