station_id,dayofweek,hour,is_member,starts,ends,diff,lat,lng
20112,1,9,false,1,1,0,41.70717,-87.61842
20238,1,9,false,5,1,-4,41.7187,-87.597
20106,1,9,false,1,2,1,41.71897,-87.60833
20228,1,9,false,1,1,0,41.72222,-87.57897
20237,1,9,false,1,1,0,41.72616,-87.56634
20119,1,9,false,1,1,0,41.72682,-87.6543
595,1,9,false,1,3,2,41.73663,-87.62264
20230,1,9,false,1,1,0,41.73716,-87.57272
20229,1,9,false,2,1,-1,41.73734,-87.54849
585,1,9,false,2,1,-1,41.74344,-87.60485
576,1,9,false,1,1,0,41.75129,-87.59752
KA1503000028,1,9,false,1,1,0,41.75712,-87.57585
KA1503000049,1,9,false,2,1,-1,41.75788,-87.54938
571,1,9,false,1,1,0,41.75836,-87.61415
KA1503000019,1,9,false,1,1,0,41.75867,-87.5869
11,1,9,false,1,1,0,41.76662,-87.57646
KA1503000018,1,9,false,4,6,2,41.76663,-87.57645
KA1503000029,1,9,false,4,2,-2,41.77364,-87.56747
KA1503000021,1,9,false,2,3,1,41.77888,-87.58665
KA1503000054,1,9,false,1,3,2,41.78061,-87.60582
15491,1,9,false,1,1,0,41.78096,-87.57624
KA1503000033,1,9,false,2,1,-1,41.78411,-87.61329
426,1,9,false,5,4,-1,41.7851,-87.60108
KA1503000014,1,9,false,10,14,4,41.7851,-87.60108
KA1503000070,1,9,false,4,2,-2,41.78794,-87.58831
328,1,9,false,1,9,8,41.78872,-87.6013
TA1309000011,1,9,false,5,18,13,41.78873,-87.60131
423,1,9,false,5,5,0,41.79148,-87.59988
KA1503000071,1,9,false,6,23,17,41.79148,-87.59988
KA1503000074,1,9,false,8,1,-7,41.79174,-87.58395
TA1309000063,1,9,false,5,4,-1,41.79325,-87.5878
345,1,9,false,1,1,0,41.79326,-87.5878
559,1,9,false,1,2,1,41.79423,-87.65509
KA1504000076,1,9,false,13,5,-8,41.7943,-87.60145
TA1307000160,1,9,false,5,1,-4,41.79485,-87.61873
247,1,9,false,6,1,-5,41.79522,-87.58077
TA1308000009,1,9,false,14,13,-1,41.79522,-87.58075
TA1307000164,1,9,false,14,6,-8,41.79527,-87.59647
248,1,9,false,2,4,2,41.79528,-87.59647
KA1503000052,1,9,false,8,3,-5,41.79935,-87.60097
KA1503000059,1,9,false,20,8,-12,41.79952,-87.58643
419,1,9,false,1,1,0,41.79952,-87.58643
TA1309000037,1,9,false,9,12,3,41.79957,-87.59474
417,1,9,false,4,1,-3,41.80242,-87.5869
KA1503000007,1,9,false,13,6,-7,41.80242,-87.58689
13398,1,9,false,11,5,-6,41.80256,-87.59035
121,1,9,false,1,2,1,41.80256,-87.59035
TA1309000067,1,9,false,4,4,0,41.80303,-87.60661
322,1,9,false,3,6,3,41.80321,-87.59849
KA1503000069,1,9,false,5,1,-4,41.80579,-87.59247
KA1504000091,1,9,false,1,4,3,41.80823,-87.6772
552,1,9,false,1,1,0,41.80887,-87.66452
TA1308000035,1,9,false,2,4,2,41.80944,-87.59188
TA1308000002,1,9,false,2,7,5,41.80983,-87.59937
TA1308000007,1,9,false,2,3,1,41.80984,-87.61628
336,1,9,false,1,2,1,41.80985,-87.60675
549,1,9,false,1,1,0,41.81401,-87.66662
KA1503000065,1,9,false,5,3,-2,41.81409,-87.59701
KA1503000027,1,9,false,8,2,-6,41.81666,-87.61942
13083,1,9,false,2,1,-1,41.82167,-87.62153
355,1,9,false,1,1,0,41.82217,-87.63032
TA1308000038,1,9,false,1,7,6,41.82298,-87.6071
15449,1,9,false,1,2,1,41.82302,-87.62657
16932,1,9,false,2,1,-1,41.82346,-87.66558
179,1,9,false,2,2,0,41.82458,-87.61678
13420,1,9,false,1,2,1,41.82459,-87.61678
KA1503000068,1,9,false,1,2,1,41.82878,-87.68062
KA1503000066,1,9,false,2,2,0,41.83011,-87.67031
TA1308000043,1,9,false,2,1,-1,41.83066,-87.64715
15446,1,9,false,2,2,0,41.83068,-87.65603
TA1307000129,1,9,false,6,4,-2,41.83104,-87.62683
KA1503000004,1,9,false,7,2,-5,41.83127,-87.6088
13345,1,9,false,1,8,7,41.83138,-87.61803
13216,1,9,false,1,10,9,41.83473,-87.62581
13217,1,9,false,11,3,-8,41.83488,-87.61792
13215,1,9,false,3,2,-1,41.83634,-87.6135
263,1,9,false,3,1,-2,41.8364,-87.61348
TA1308000046,1,9,false,7,4,-3,41.83779,-87.65115
TA1309000055,1,9,false,5,15,10,41.8382,-87.64514
402,1,9,false,1,1,0,41.83845,-87.6354
KA1503000038,1,9,false,3,3,0,41.83845,-87.6354
TA1307000048,1,9,false,13,15,2,41.83855,-87.60821
150,1,9,false,1,4,3,41.83855,-87.60821
237,1,9,false,1,2,1,41.84204,-87.61697
TA1307000139,1,9,false,10,6,-4,41.84205,-87.61698
15443,1,9,false,9,1,-8,41.84275,-87.63549
TA1307000153,1,9,false,1,4,3,41.84358,-87.64538
TA1307000005,1,9,false,2,1,-1,41.84569,-87.6225
TA1308000026,1,9,false,4,3,-1,41.85008,-87.63214
TA1305000004,1,9,false,17,17,0,41.8514,-87.61884
TA1305000001,1,9,false,4,6,2,41.85262,-87.6265
13075,1,9,false,6,1,-5,41.8531,-87.63192
120,1,9,false,1,2,1,41.8531,-87.63191
13162,1,9,false,7,5,-2,41.85378,-87.64659
13096,1,9,false,2,3,1,41.8538,-87.69577
13091,1,9,false,7,2,-5,41.85409,-87.68585
15546,1,9,false,13,6,-7,41.85416,-87.61916
13307,1,9,false,3,1,-2,41.85489,-87.66359
13089,1,9,false,10,3,-7,41.85497,-87.67567
4,1,9,false,4,2,-2,41.85627,-87.61334
15545,1,9,false,13,18,5,41.85627,-87.61334
SL-013,1,9,false,4,2,-2,41.85659,-87.62755
SL-006,1,9,false,5,2,-3,41.8568,-87.63387
13135,1,9,false,15,9,-6,41.85753,-87.66157
13102,1,9,false,21,10,-11,41.85762,-87.61942
13150,1,9,false,13,9,-4,41.85783,-87.62455
13099,1,9,false,4,1,-3,41.85784,-87.64627
TA1307000159,1,9,false,3,2,-1,41.8579,-87.6687
14,1,9,false,1,1,0,41.85808,-87.65109
13163,1,9,false,6,2,-4,41.85808,-87.65108
13164,1,9,false,12,2,-10,41.85818,-87.65648
SL-012,1,9,false,10,6,-4,41.86038,-87.62581
13304,1,9,false,4,4,0,41.86126,-87.65659
TA1306000002,1,9,false,4,1,-3,41.86238,-87.65108
TA1307000124,1,9,false,17,26,9,41.86411,-87.62372
168,1,9,false,1,3,2,41.86415,-87.62372
TA1309000001,1,9,false,5,5,0,41.86488,-87.64708
13165,1,9,false,1,2,1,41.86505,-87.65697
13029,1,9,false,3,22,19,41.86531,-87.6179
341,1,9,false,1,1,0,41.86608,-87.60733
13431,1,9,false,15,7,-8,41.8661,-87.60728
KA1504000101,1,9,false,1,2,1,41.86651,-87.68466
WL-008,1,9,false,11,4,-7,41.86712,-87.64108
TA1305000002,1,9,false,29,29,0,41.86721,-87.62597
3,1,9,false,4,2,-2,41.86723,-87.61536
15544,1,9,false,28,116,88,41.86723,-87.61536
TA1305000017,1,9,false,6,3,-3,41.86734,-87.64863
KA1706005007,1,9,false,5,7,2,41.86749,-87.63219
SL-005,1,9,false,45,38,-7,41.8679,-87.62304
255,1,9,false,5,2,-3,41.86791,-87.62304
644,1,9,false,7,1,-6,41.86859,-87.68625
13139,1,9,false,1,6,5,41.86893,-87.65913
13285,1,9,false,1,10,9,41.86928,-87.67372
13160,1,9,false,5,5,0,41.86947,-87.65548
15550,1,9,false,5,8,3,41.87024,-87.63947
TA1309000010,1,9,false,18,14,-4,41.87074,-87.62574
SL-009,1,9,false,1,1,0,41.87081,-87.63121
342,1,9,false,2,1,-1,41.87127,-87.6737
TA1309000064,1,9,false,11,4,-7,41.87127,-87.67369
15542,1,9,false,1,1,0,41.87146,-87.64095
261,1,9,false,2,2,0,41.87151,-87.6699
TA1307000130,1,9,false,1,5,4,41.87178,-87.65103
108,1,9,false,1,1,0,41.87183,-87.64664
TA1307000121,1,9,false,3,5,2,41.87184,-87.64664
41,1,9,false,5,3,-2,41.87209,-87.62957
SL-008,1,9,false,17,12,-5,41.87209,-87.62956
13332,1,9,false,13,11,-2,41.87219,-87.6615
394,1,9,false,2,1,-1,41.87226,-87.63484
175,1,9,false,3,1,-2,41.87255,-87.63359
SL-011,1,9,false,13,21,8,41.87256,-87.63356
623,1,9,false,90,36,-54,41.87272,-87.62399
KA1504000104,1,9,false,4,12,8,41.87296,-87.66912
383,1,9,false,3,3,0,41.87297,-87.66912
5,1,9,false,2,1,-1,41.87403,-87.6277
SL-007,1,9,false,14,8,-6,41.87404,-87.6277
13326,1,9,false,4,5,1,41.87425,-87.63958
321,1,9,false,6,4,-2,41.87427,-87.63257
356,1,9,false,2,1,-1,41.87464,-87.70168
TA1306000025,1,9,false,7,8,1,41.87464,-87.65703
15668,1,9,false,3,1,-2,41.87471,-87.68642
13028,1,9,false,8,16,8,41.87475,-87.64981
13081,1,9,false,2,3,1,41.87501,-87.67326
SL-010,1,9,false,9,4,-5,41.87501,-87.63309
15541,1,9,false,29,20,-9,41.8758,-87.62086
13037,1,9,false,3,2,-1,41.87588,-87.64078
TA1305000009,1,9,false,10,5,-5,41.87593,-87.63068
317,1,9,false,1,7,6,41.87603,-87.68195
TA1305000010,1,9,false,41,9,-32,41.87623,-87.62444
45,1,9,false,7,4,-3,41.87623,-87.62444
624,1,9,false,20,12,-8,41.87626,-87.62923
2,1,9,false,1,2,1,41.87649,-87.62051
33,1,9,false,2,2,0,41.87715,-87.62786
TA1305000035,1,9,false,17,8,-9,41.87716,-87.62787
13138,1,9,false,4,10,6,41.87723,-87.63941
631,1,9,false,5,4,-1,41.87761,-87.6739
15539,1,9,false,5,4,-1,41.87763,-87.64405
13158,1,9,false,15,13,-2,41.87764,-87.64957
13157,1,9,false,10,11,1,41.87773,-87.6548
TA1305000025,1,9,false,31,57,26,41.87773,-87.63528
TA1309000002,1,9,false,30,30,0,41.87784,-87.62408
13206,1,9,false,8,3,-5,41.87794,-87.66201
TA1309000004,1,9,false,5,9,4,41.87811,-87.63184
638,1,9,false,15,15,0,41.87827,-87.64078
37,1,9,false,1,5,4,41.87921,-87.62975
TA1305000005,1,9,false,9,11,2,41.87924,-87.62975
286,1,9,false,2,1,-1,41.8793,-87.6355
13011,1,9,false,14,20,6,41.87931,-87.63993
TA1309000008,1,9,false,33,24,-9,41.87933,-87.6355
192,1,9,false,1,5,4,41.87935,-87.63997
KA1503000034,1,9,false,9,10,1,41.87938,-87.63197
40,1,9,false,2,1,-1,41.87944,-87.63197
39,1,9,false,3,5,2,41.87948,-87.62571
KA1503000015,1,9,false,13,13,0,41.87948,-87.6257
287,1,9,false,4,2,-2,41.88017,-87.63527
TA1309000007,1,9,false,17,24,7,41.88022,-87.63526
WL-011,1,9,false,19,8,-11,41.88034,-87.64273
80,1,9,false,2,1,-1,41.88042,-87.65556
13156,1,9,false,8,4,-4,41.88042,-87.65554
13300,1,9,false,106,60,-46,41.88097,-87.61675
76,1,9,false,9,4,-5,41.88098,-87.61675
13008,1,9,false,70,69,-1,41.88105,-87.62408
90,1,9,false,2,3,1,41.88107,-87.62409
49,1,9,false,6,7,1,41.88116,-87.62963
TA1305000006,1,9,false,21,30,9,41.88122,-87.6296
13134,1,9,false,2,6,4,41.88138,-87.67493
13056,1,9,false,7,6,-1,41.88168,-87.63951
TA1307000120,1,9,false,28,27,-1,41.88188,-87.64879
13341,1,9,false,13,17,4,41.88208,-87.63985
174,1,9,false,1,1,0,41.88208,-87.63984
13036,1,9,false,28,11,-17,41.8821,-87.62513
77,1,9,false,1,8,7,41.88214,-87.64108
TA1305000032,1,9,false,36,26,-10,41.88218,-87.64109
13006,1,9,false,13,10,-3,41.88268,-87.63252
13353,1,9,false,9,5,-4,41.88283,-87.6612
346,1,9,false,1,2,1,41.88284,-87.6612
654,1,9,false,7,8,1,41.88307,-87.65698
13409,1,9,false,8,25,17,41.8831,-87.6511
18,1,9,false,2,7,5,41.88317,-87.63735
KA1503000072,1,9,false,9,14,5,41.88317,-87.63693
91,1,9,false,2,1,-1,41.88336,-87.64122
WL-012,1,9,false,31,19,-12,41.88337,-87.6412
112,1,9,false,5,3,-2,41.88362,-87.6486
13053,1,9,false,13,37,24,41.88365,-87.64863
43,1,9,false,8,7,-1,41.88396,-87.62455
13001,1,9,false,38,38,0,41.88397,-87.62459
13155,1,9,false,9,9,0,41.88407,-87.65689
18062,1,9,false,11,19,8,41.88412,-87.65427
81,1,9,false,2,15,13,41.88417,-87.6296
TA1306000010,1,9,false,18,33,15,41.88419,-87.62961
KA1504000106,1,9,false,1,1,0,41.88459,-87.70631
TA1305000030,1,9,false,33,39,6,41.88459,-87.63178
15535,1,9,false,8,11,3,41.8846,-87.64455
51,1,9,false,1,6,5,41.88462,-87.63176
TA1305000029,1,9,false,41,29,-12,41.88466,-87.62787
195,1,9,false,2,1,-1,41.88466,-87.61952
13263,1,9,false,22,28,6,41.88467,-87.61952
TA1306000015,1,9,false,21,21,0,41.88549,-87.65232
71,1,9,false,2,5,3,41.8855,-87.65233
66,1,9,false,1,1,0,41.88557,-87.64186
13021,1,9,false,25,21,-4,41.88559,-87.64184
TA1307000111,1,9,false,20,19,-1,41.88582,-87.63548
164,1,9,false,1,3,2,41.88583,-87.63547
13073,1,9,false,3,6,3,41.88592,-87.66717
656,1,9,false,1,1,0,41.88595,-87.67701
KA17018054,1,9,false,4,4,0,41.88595,-87.67701
KA1503000012,1,9,false,32,26,-6,41.88599,-87.63089
38,1,9,false,6,3,-3,41.88599,-87.63089
52,1,9,false,5,9,4,41.886,-87.62421
TA1305000011,1,9,false,69,45,-24,41.886,-87.62418
7,1,9,false,2,1,-1,41.88627,-87.61751
15534,1,9,false,21,13,-8,41.88627,-87.61749
13197,1,9,false,9,7,-2,41.8866,-87.65816
TA1308000029,1,9,false,62,24,-38,41.88673,-87.62225
TA1307000131,1,9,false,54,21,-33,41.88688,-87.62606
KA1503000064,1,9,false,37,30,-7,41.88697,-87.61281
16905,1,9,false,2,2,0,41.88767,-87.76547
100,1,9,false,4,2,-2,41.88814,-87.63657
TA1305000022,1,9,false,27,41,14,41.88817,-87.63656
56,1,9,false,5,2,-3,41.88866,-87.64442
TA1306000003,1,9,false,25,14,-11,41.88867,-87.64442
KA1503000043,1,9,false,34,24,-10,41.88918,-87.63851
133,1,9,false,6,5,-1,41.88918,-87.63851
13050,1,9,false,38,27,-11,41.88919,-87.62775
15664,1,9,false,2,3,1,41.8895,-87.68821
13432,1,9,false,5,7,2,41.88989,-87.67149
TA1307000151,1,9,false,25,36,11,41.88993,-87.63427
212,1,9,false,6,9,3,41.88995,-87.63427
636,1,9,false,15,11,-4,41.88997,-87.63662
KA1503000044,1,9,false,18,15,-3,41.89018,-87.6262
196,1,9,false,1,1,0,41.89053,-87.62205
13427,1,9,false,19,27,8,41.89054,-87.62205
26,1,9,false,2,2,0,41.89057,-87.61798
13430,1,9,false,39,27,-12,41.89077,-87.63169
181,1,9,false,1,2,1,41.89077,-87.63168
TA1306000013,1,9,false,48,37,-11,41.89083,-87.61852
RN-,1,9,false,26,11,-15,41.89102,-87.63546
672,1,9,false,3,2,-1,41.89102,-87.63545
13434,1,9,false,7,6,-1,41.89108,-87.66663
TA1308000006,1,9,false,10,6,-4,41.89128,-87.67686
199,1,9,false,2,7,5,41.89143,-87.62676
TA1307000117,1,9,false,71,53,-18,41.89144,-87.62675
13033,1,9,false,14,19,5,41.8916,-87.64835
214,1,9,false,2,1,-1,41.89161,-87.67688
186,1,9,false,2,1,-1,41.8918,-87.65879
13194,1,9,false,14,7,-7,41.8918,-87.65878
TA1305000003,1,9,false,36,32,-4,41.89187,-87.62061
24,1,9,false,6,1,-5,41.8919,-87.62063
643,1,9,false,5,1,-4,41.89203,-87.68939
35,1,9,false,3,3,0,41.89227,-87.61206
13022,1,9,false,97,100,3,41.89227,-87.61205
99,1,9,false,6,4,-2,41.89255,-87.61449
TA1306000029,1,9,false,30,18,-12,41.89256,-87.61449
13265,1,9,false,13,22,9,41.89383,-87.64172
74,1,9,false,7,4,-3,41.89384,-87.64173
13045,1,9,false,42,29,-13,41.89403,-87.62931
110,1,9,false,4,7,3,41.89406,-87.6293
13016,1,9,false,55,45,-10,41.89431,-87.62277
211,1,9,false,5,11,6,41.89439,-87.62267
KA1503000041,1,9,false,59,39,-20,41.89452,-87.61798
142,1,9,false,5,3,-2,41.89453,-87.61806
13196,1,9,false,20,6,-14,41.89455,-87.65345
TA1307000062,1,9,false,29,10,-19,41.89466,-87.63839
111,1,9,false,4,2,-2,41.89466,-87.63837
TA1306000012,1,9,false,27,31,4,41.89475,-87.63438
53,1,9,false,7,7,0,41.89476,-87.63439
627,1,9,false,3,1,-2,41.8948,-87.63231
KP1705001026,1,9,false,21,9,-12,41.89483,-87.6323
KA1504000114,1,9,false,1,3,2,41.89547,-87.70614
18058,1,9,false,5,3,-2,41.8955,-87.68201
637,1,9,false,9,1,-8,41.89563,-87.67209
128,1,9,false,2,2,0,41.89571,-87.67716
13132,1,9,false,13,12,-1,41.89573,-87.67718
161,1,9,false,2,2,0,41.89574,-87.62599
15530,1,9,false,48,30,-18,41.89575,-87.62596
18003,1,9,false,12,8,-4,41.89575,-87.62011
13247,1,9,false,7,5,-2,41.89597,-87.66775
TA1305000020,1,9,false,14,13,-1,41.89636,-87.65406
54,1,9,false,1,3,2,41.89637,-87.65407
13289,1,9,false,14,3,-11,41.89638,-87.661
337,1,9,false,2,1,-1,41.89659,-87.63096
13303,1,9,false,20,8,-12,41.89672,-87.63088
13017,1,9,false,15,13,-2,41.89676,-87.6357
31,1,9,false,3,5,2,41.89677,-87.63572
13338,1,9,false,27,19,-8,41.89697,-87.62173
173,1,9,false,4,1,-3,41.89704,-87.62173
TA1307000061,1,9,false,18,20,2,41.89745,-87.62873
13034,1,9,false,28,23,-5,41.89754,-87.62352
48,1,9,false,4,1,-3,41.89772,-87.64302
TA1306000009,1,9,false,14,38,24,41.89772,-87.64299
620,1,9,false,20,22,2,41.89817,-87.63754
KA1504000103,1,9,false,11,2,-9,41.89842,-87.68659
145,1,9,false,5,4,-1,41.89856,-87.62211
15529,1,9,false,35,36,1,41.89858,-87.62206
140,1,9,false,7,3,-4,41.89895,-87.6299
TA1307000128,1,9,false,25,20,-5,41.89896,-87.6299
657,1,9,false,11,6,-5,41.89918,-87.6722
KA1504000117,1,9,false,1,10,9,41.89936,-87.64848
13248,1,9,false,3,4,1,41.89964,-87.66788
46,1,9,false,2,1,-1,41.89994,-87.63444
TA1306000011,1,9,false,7,5,-2,41.89994,-87.63443
KA1504000116,1,9,false,6,14,8,41.90023,-87.64299
17660,1,9,false,9,6,-3,41.90036,-87.69671
622,1,9,false,5,2,-3,41.90037,-87.69671
13290,1,9,false,14,10,-4,41.90069,-87.66259
13042,1,9,false,84,54,-30,41.90097,-87.62377
85,1,9,false,6,8,2,41.90098,-87.62375
TA1307000070,1,9,false,11,9,-2,41.90133,-87.67742
KA1504000133,1,9,false,17,23,6,41.90234,-87.62773
172,1,9,false,2,7,5,41.90236,-87.62774
15654,1,9,false,1,1,0,41.90271,-87.70923
510,1,9,false,1,1,0,41.90272,-87.70923
13241,1,9,false,10,4,-6,41.9029,-87.68731
176,1,9,false,3,3,0,41.90291,-87.63141
TA1307000039,1,9,false,36,40,4,41.90294,-87.63137
658,1,9,false,8,4,-4,41.903,-87.6838
13256,1,9,false,7,9,2,41.90302,-87.69749
TA1305000034,1,9,false,13,8,-5,41.90313,-87.67391
182,1,9,false,4,5,1,41.90317,-87.63442
KA1504000135,1,9,false,15,16,1,41.90319,-87.63439
13136,1,9,false,5,10,5,41.90326,-87.67845
210,1,9,false,6,2,-4,41.90342,-87.66781
13061,1,9,false,22,20,-2,41.90342,-87.66779
KA1504000079,1,9,false,2,12,10,41.9035,-87.64334
359,1,9,false,2,4,2,41.90458,-87.6497
138,1,9,false,2,3,1,41.9046,-87.64057
TA1307000115,1,9,false,2,9,7,41.9046,-87.64056
TA1308000049,1,9,false,19,20,1,41.90672,-87.6349
KA1504000134,1,9,false,16,14,-2,41.90687,-87.6262
180,1,9,false,3,1,-2,41.90687,-87.62618
13224,1,9,false,12,9,-3,41.90706,-87.66725
333,1,9,false,1,1,0,41.90706,-87.66725
TA1307000143,1,9,false,2,4,2,41.90762,-87.63854
61,1,9,false,1,1,0,41.90764,-87.67254
13221,1,9,false,9,6,-3,41.90765,-87.67254
13245,1,9,false,6,1,-5,41.90777,-87.68586
301,1,9,false,5,1,-4,41.90796,-87.63203
TA1309000024,1,9,false,13,21,8,41.908,-87.63152
69,1,9,false,2,4,2,41.90939,-87.6777
TA1305000041,1,9,false,20,30,10,41.9094,-87.67769
508,1,9,false,1,2,1,41.90964,-87.71664
15652,1,9,false,4,3,-1,41.90965,-87.71664
331,1,9,false,18,13,-5,41.90965,-87.64812
15653,1,9,false,7,1,-6,41.90979,-87.7053
TA1305000037,1,9,false,10,15,5,41.91018,-87.67003
TA1306000008,1,9,false,3,3,0,41.9102,-87.6435
TA1308000005,1,9,false,12,5,-7,41.91042,-87.68238
13258,1,9,false,10,6,-4,41.91043,-87.69718
276,1,9,false,3,1,-2,41.91043,-87.69718
13257,1,9,false,19,5,-14,41.91054,-87.68956
13154,1,9,false,13,5,-8,41.91054,-87.65312
20,1,9,false,2,1,-1,41.91055,-87.65313
13058,1,9,false,8,13,5,41.91059,-87.64942
TA1307000038,1,9,false,11,10,-1,41.91138,-87.63868
LF-005,1,9,false,47,32,-15,41.91172,-87.62681
268,1,9,false,2,1,-1,41.91172,-87.62681
126,1,9,false,2,1,-1,41.91196,-87.63197
13128,1,9,false,12,11,-1,41.91197,-87.63197
TA1308000050,1,9,false,38,38,0,41.91211,-87.6347
13243,1,9,false,14,8,-6,41.91262,-87.6814
158,1,9,false,2,5,3,41.91262,-87.6814
TA1309000032,1,9,false,1,3,2,41.91293,-87.66417
TA1306000032,1,9,false,11,6,-5,41.9137,-87.65285
224,1,9,false,1,1,0,41.91386,-87.64877
TA1307000166,1,9,false,6,7,1,41.91386,-87.64877
15655,1,9,false,9,7,-2,41.91401,-87.70514
18017,1,9,false,12,6,-6,41.91416,-87.71676
18067,1,9,false,13,3,-10,41.9146,-87.66796
TA1306000007,1,9,false,2,1,-1,41.91469,-87.64333
13068,1,9,false,4,12,8,41.91554,-87.68703
13179,1,9,false,21,24,3,41.9157,-87.63461
141,1,9,false,3,2,-1,41.91571,-87.63461
13133,1,9,false,12,6,-6,41.91598,-87.67733
219,1,9,false,1,2,1,41.91598,-87.67733
TA1305000039,1,9,false,9,11,2,41.9163,-87.66749
15650,1,9,false,4,2,-2,41.91711,-87.71023
15651,1,9,false,8,3,-5,41.91752,-87.70181
13266,1,9,false,5,6,1,41.91774,-87.69142
TA1309000029,1,9,false,10,3,-7,41.9178,-87.68245
288,1,9,false,1,1,0,41.91809,-87.64375
TA1309000006,1,9,false,9,12,3,41.91809,-87.64375
TA1307000163,1,9,false,10,8,-2,41.91821,-87.65696
94,1,9,false,7,3,-4,41.91831,-87.6363
13146,1,9,false,13,30,17,41.91831,-87.63629
13059,1,9,false,26,16,-10,41.91845,-87.65222
113,1,9,false,2,1,-1,41.91846,-87.65222
13259,1,9,false,12,2,-10,41.91852,-87.69744
259,1,9,false,1,1,0,41.91853,-87.69745
310,1,9,false,1,2,1,41.91984,-87.68083
13192,1,9,false,8,7,-1,41.91995,-87.64884
225,1,9,false,1,2,1,41.91995,-87.64884
13288,1,9,false,2,4,2,41.92008,-87.67788
13242,1,9,false,2,2,0,41.92021,-87.69266
222,1,9,false,2,2,0,41.92023,-87.69265
TA1309000030,1,9,false,8,9,1,41.92077,-87.66372
13292,1,9,false,5,7,2,41.92152,-87.70733
TA1309000033,1,9,false,10,12,2,41.92158,-87.65381
13193,1,9,false,31,25,-6,41.92182,-87.64412
144,1,9,false,7,5,-2,41.92182,-87.64411
13191,1,9,false,11,13,2,41.92217,-87.63891
327,1,9,false,2,1,-1,41.92225,-87.65783
13084,1,9,false,10,16,6,41.92268,-87.69715
123,1,9,false,2,1,-1,41.92268,-87.69714
LP-,1,9,false,14,4,-10,41.92396,-87.63584
673,1,9,false,3,1,-2,41.92398,-87.63585
KA1504000140,1,9,false,3,4,1,41.92409,-87.67646
16010,1,9,false,6,1,-5,41.92458,-87.72787
15648,1,9,false,10,5,-5,41.92464,-87.68931
503,1,9,false,1,2,1,41.92483,-87.71451
TA1307000001,1,9,false,8,6,-2,41.92535,-87.66581
188,1,9,false,4,3,-1,41.92536,-87.66581
TA1306000026,1,9,false,14,13,-1,41.92558,-87.65842
TA1306000016,1,9,false,17,20,3,41.9256,-87.65371
313,1,9,false,9,2,-7,41.9257,-87.64246
TA1309000019,1,9,false,22,18,-4,41.92586,-87.63897
TA1309000058,1,9,false,20,24,4,41.92591,-87.64927
127,1,9,false,5,4,-1,41.92592,-87.64927
TA1308000001,1,9,false,44,36,-8,41.92627,-87.63086
177,1,9,false,3,1,-2,41.92627,-87.63086
15646,1,9,false,10,2,-8,41.92668,-87.6977
13124,1,9,false,13,10,-3,41.92675,-87.63444
34,1,9,false,1,1,0,41.92675,-87.63444
302,1,9,false,2,2,0,41.92859,-87.65421
TA1309000023,1,9,false,16,1,-15,41.9287,-87.65383
TA1307000113,1,9,false,6,6,0,41.92878,-87.66391
13296,1,9,false,3,5,2,41.92883,-87.66852
TA1309000059,1,9,false,9,8,-1,41.92889,-87.65898
349,1,9,false,1,1,0,41.92915,-87.6491
TA1309000061,1,9,false,13,6,-7,41.92915,-87.64909
TA1308000031,1,9,false,9,5,-4,41.92946,-87.68417
258,1,9,false,1,1,0,41.92946,-87.68417
340,1,9,false,4,1,-3,41.92956,-87.64313
TA1305000014,1,9,false,29,33,4,41.92956,-87.64313
260,1,9,false,1,4,3,41.92958,-87.70791
13085,1,9,false,13,10,-3,41.92958,-87.70789
15643,1,9,false,7,3,-4,41.93057,-87.7238
TA1307000142,1,9,false,18,14,-4,41.93125,-87.64432
13276,1,9,false,39,19,-20,41.93132,-87.63874
324,1,9,false,5,4,-1,41.93173,-87.64179
15645,1,9,false,3,5,2,41.93191,-87.70121
13271,1,9,false,4,9,5,41.93192,-87.67784
152,1,9,false,2,3,1,41.93221,-87.65864
TA1307000064,1,9,false,11,9,-2,41.93222,-87.65864
TA1306000014,1,9,false,16,10,-6,41.93242,-87.65271
13,1,9,false,1,2,1,41.93242,-87.65271
TA1309000039,1,9,false,15,9,-6,41.93258,-87.63642
13294,1,9,false,11,7,-4,41.9326,-87.66595
319,1,9,false,4,1,-3,41.93292,-87.67217
TA1309000036,1,9,false,14,10,-4,41.93313,-87.64776
332,1,9,false,3,2,-1,41.93313,-87.64776
15644,1,9,false,3,3,0,41.93534,-87.71687
TA1307000006,1,9,false,8,8,0,41.93571,-87.6636
153,1,9,false,2,6,4,41.93575,-87.66364
13268,1,9,false,2,7,5,41.93588,-87.67843
250,1,9,false,3,1,-2,41.93609,-87.66984
13269,1,9,false,6,8,2,41.93609,-87.66983
TA1307000052,1,9,false,22,16,-6,41.93628,-87.65266
115,1,9,false,2,2,0,41.93628,-87.65266
156,1,9,false,2,5,3,41.9365,-87.64756
TA1307000136,1,9,false,13,18,5,41.9365,-87.64755
TA1307000041,1,9,false,17,22,5,41.93669,-87.63683
157,1,9,false,1,4,3,41.9367,-87.63683
13137,1,9,false,25,34,9,41.9376,-87.6441
300,1,9,false,7,8,1,41.93761,-87.6441
15642,1,9,false,5,1,-4,41.93843,-87.69801
154,1,9,false,3,1,-2,41.93912,-87.66384
KA17018068,1,9,false,6,1,-5,41.93935,-87.68327
TA1309000042,1,9,false,7,9,2,41.93937,-87.66836
131,1,9,false,1,1,0,41.93937,-87.66835
KA150400009X,1,9,false,3,4,1,41.9394,-87.71159
15640,1,9,false,1,2,1,41.93941,-87.72357
13229,1,9,false,18,26,8,41.93946,-87.66376
226,1,9,false,1,1,0,41.93972,-87.65886
TA1308000019,1,9,false,11,17,6,41.93973,-87.65886
13277,1,9,false,19,10,-9,41.9401,-87.64546
296,1,9,false,3,1,-2,41.9401,-87.64546
TA1307000134,1,9,false,13,29,16,41.94016,-87.65303
117,1,9,false,2,5,3,41.94016,-87.65302
13143,1,9,false,10,1,-9,41.94059,-87.67853
TA1309000049,1,9,false,29,14,-15,41.94077,-87.63919
493,1,9,false,1,1,0,41.94304,-87.68729
15634,1,9,false,4,7,3,41.94304,-87.68729
TA1307000138,1,9,false,2,8,6,41.94334,-87.67094
230,1,9,false,1,5,4,41.94335,-87.67093
13144,1,9,false,5,3,-2,41.9434,-87.67964
TA1309000025,1,9,false,12,11,-1,41.94368,-87.64894
229,1,9,false,3,1,-2,41.94372,-87.66401
13071,1,9,false,18,22,4,41.94373,-87.66401
632,1,9,false,19,18,-1,41.94453,-87.6547
303,1,9,false,4,1,-3,41.94522,-87.64702
15631,1,9,false,5,2,-3,41.94524,-87.70665
13278,1,9,false,29,22,-7,41.94553,-87.64644
TA1309000050,1,9,false,5,1,-4,41.94618,-87.67331
15632,1,9,false,3,2,-1,41.94664,-87.69463
227,1,9,false,4,5,1,41.94813,-87.66397
13235,1,9,false,13,13,0,41.94814,-87.66396
304,1,9,false,4,2,-2,41.94878,-87.64922
13253,1,9,false,3,1,-2,41.9488,-87.67527
257,1,9,false,1,2,1,41.9488,-87.67527
13325,1,9,false,13,12,-1,41.94907,-87.64863
114,1,9,false,4,2,-2,41.94935,-87.65451
TA1307000126,1,9,false,15,16,1,41.94936,-87.65451
232,1,9,false,3,1,-2,41.94943,-87.64645
TA1307000150,1,9,false,14,10,-4,41.94945,-87.64646
18016,1,9,false,1,1,0,41.94993,-87.71395
347,1,9,false,1,1,0,41.95068,-87.6687
13319,1,9,false,4,5,1,41.95069,-87.6687
TA1307000127,1,9,false,15,13,-2,41.9508,-87.65918
15628,1,9,false,1,1,0,41.95216,-87.69806
13323,1,9,false,12,8,-4,41.95282,-87.65
256,1,9,false,2,1,-1,41.95282,-87.65
KA1504000096,1,9,false,4,3,-1,41.95361,-87.70932
KA1504000139,1,9,false,3,2,-1,41.954,-87.71909
TA1309000043,1,9,false,5,1,-4,41.95417,-87.66434
13063,1,9,false,16,17,1,41.95424,-87.65441
240,1,9,false,1,4,3,41.95424,-87.65441
KA1504000158,1,9,false,4,2,-2,41.95432,-87.68607
TA1308000022,1,9,false,23,8,-15,41.95438,-87.64805
16991,1,9,false,1,1,0,41.95448,-87.7496
TA1307000149,1,9,false,2,5,3,41.95467,-87.67392
TA1309000026,1,9,false,5,3,-2,41.95601,-87.6802
13249,1,9,false,7,4,-3,41.95606,-87.66885
312,1,9,false,2,4,2,41.95637,-87.6563
TA1308000047,1,9,false,5,4,-1,41.95709,-87.6642
13379,1,9,false,13,11,-2,41.95786,-87.6495
TA1309000018,1,9,false,4,3,-1,41.95791,-87.67357
TA1309000027,1,9,false,13,9,-4,41.9585,-87.65499
13389,1,9,false,17,5,-12,41.961,-87.64958
15621,1,9,false,2,1,-1,41.96103,-87.70586
KA1706005015,1,9,false,2,3,1,41.96108,-87.73569
15622,1,9,false,2,3,1,41.96108,-87.69544
TA1307000144,1,9,false,2,6,4,41.96142,-87.6762
TA1309000021,1,9,false,3,4,1,41.9615,-87.6714
KA1503000022,1,9,false,5,4,-1,41.96158,-87.66609
231,1,9,false,3,2,-1,41.96163,-87.65464
TA1307000107,1,9,false,20,9,-11,41.96164,-87.65464
TA1307000156,1,9,false,2,4,2,41.96301,-87.68479
TA1309000012,1,9,false,5,1,-4,41.96325,-87.67928
TA1308000012,1,9,false,11,13,2,41.96398,-87.63818
13074,1,9,false,5,5,0,41.96521,-87.6582
639,1,9,false,19,14,-5,41.96584,-87.64538
KA1504000093,1,9,false,3,2,-1,41.96587,-87.69365
478,1,9,false,1,1,0,41.96587,-87.69364
TA1307000140,1,9,false,3,3,0,41.96643,-87.68865
KA1504000126,1,9,false,6,1,-5,41.96668,-87.70807
TA1309000014,1,9,false,10,6,-4,41.96709,-87.66744
TA1307000158,1,9,false,4,6,2,41.9671,-87.67904
TA1307000119,1,9,false,11,7,-4,41.96796,-87.65
15615,1,9,false,2,3,1,41.96835,-87.71183
TA1308000021,1,9,false,7,4,-3,41.96883,-87.65765
475,1,9,false,2,1,-1,41.96885,-87.69611
KA1504000080,1,9,false,2,5,3,41.96887,-87.69609
344,1,9,false,1,1,0,41.9691,-87.67423
TA1309000066,1,9,false,12,13,1,41.9691,-87.67423
TA1309000041,1,9,false,9,6,-3,41.96951,-87.65471
KA1504000171,1,9,false,11,4,-7,41.97161,-87.65016
TA1309000035,1,9,false,11,11,0,41.97335,-87.66785
295,1,9,false,2,2,0,41.97378,-87.65972
13108,1,9,false,6,9,3,41.97379,-87.65971
KA1504000078,1,9,false,2,3,1,41.97491,-87.69258
KA1504000149,1,9,false,8,1,-7,41.97562,-87.67945
KA1504000160,1,9,false,2,1,-1,41.97564,-87.70143
471,1,9,false,1,1,0,41.97564,-87.70143
KA1504000128,1,9,false,1,1,0,41.97567,-87.70927
KA1504000146,1,9,false,6,16,10,41.978,-87.66805
13109,1,9,false,7,9,2,41.97835,-87.65976
KA1504000147,1,9,false,1,3,2,41.97976,-87.67754
655,1,9,false,1,2,1,41.97987,-87.68194
KA1504000167,1,9,false,2,2,0,41.98206,-87.70895
KA1504000151,1,9,false,4,9,5,41.98359,-87.66916
15585,1,9,false,1,3,2,41.98367,-87.69642
KA1504000152,1,9,false,15,11,-4,41.98403,-87.65231
459,1,9,false,1,1,0,41.98403,-87.65231
15578,1,9,false,7,2,-5,41.98405,-87.66027
15575,1,9,false,22,3,-19,41.98975,-87.66014
458,1,9,false,2,2,0,41.98975,-87.66013
457,1,9,false,2,2,0,41.99052,-87.66982
KA1504000148,1,9,false,4,2,-2,41.99086,-87.66971
KA1504000155,1,9,false,4,2,-2,41.99118,-87.68359
15571,1,9,false,12,7,-5,41.99478,-87.66028
454,1,9,false,1,1,0,41.99478,-87.66027
KA1504000156,1,9,false,4,6,2,41.99925,-87.67137
RP-009,1,9,false,1,4,3,42.00107,-87.66122
RP-001,1,9,false,1,2,1,42.00179,-87.68883
RP-008,1,9,false,5,7,2,42.00446,-87.6724
660,1,9,false,8,1,-7,42.00458,-87.66143
354,1,9,false,2,3,1,42.00587,-87.66802
KA1504000175,1,9,false,7,2,-5,42.00797,-87.66549
RP-005,1,9,false,2,1,-1,42.0086,-87.69047
RP-006,1,9,false,1,4,3,42.01213,-87.68292
RP-004,1,9,false,4,3,-1,42.01234,-87.68825
RP-007,1,9,false,2,2,0,42.01256,-87.67431
525,1,9,false,5,1,-4,42.01272,-87.66605
517,1,9,false,3,3,0,42.01597,-87.675
520,1,9,false,1,1,0,42.01597,-87.66859
519,1,9,false,1,4,3,42.01696,-87.67773
515,1,9,false,4,6,2,42.01915,-87.67356
514,1,9,false,2,5,3,42.01927,-87.68452
16806,1,9,false,2,1,-1,42.01953,-87.66955
662,1,9,false,1,1,0,42.02354,-87.69961
E002,1,9,false,3,11,8,42.03256,-87.67912
599,1,9,false,4,1,-3,42.03972,-87.69942
596,1,9,false,13,12,-1,42.04822,-87.68348
600,1,9,false,3,2,-1,42.04831,-87.6983
E008,1,9,false,10,7,-3,42.05049,-87.67782
605,1,9,false,1,6,5,42.05294,-87.67342
661,1,9,false,18,2,-16,42.05704,-87.68657
604,1,9,false,5,19,14,42.05824,-87.67744
E007,1,9,false,1,2,1,42.06431,-87.68615
717,1,9,true,1,1,0,41.68588,-87.57376
20222,1,9,true,1,2,1,41.7046,-87.52832
20112,1,9,true,1,1,0,41.70717,-87.61842
20107,1,9,true,2,1,-1,41.7122,-87.66772
20223,1,9,true,1,1,0,41.71272,-87.53472
20105,1,9,true,2,1,-1,41.71972,-87.6429
20103,1,9,true,1,2,1,41.7281,-87.66757
20242,1,9,true,1,1,0,41.7282,-87.54962
20231,1,9,true,2,2,0,41.7368,-87.58282
20230,1,9,true,1,1,0,41.73716,-87.57272
583,1,9,true,2,4,2,41.74656,-87.58599
577,1,9,true,2,2,0,41.75117,-87.58534
576,1,9,true,1,1,0,41.75129,-87.59752
KA1503000028,1,9,true,1,1,0,41.75712,-87.57585
KA1503000019,1,9,true,4,2,-2,41.75867,-87.5869
KA1503000020,1,9,true,4,1,-3,41.76223,-87.55923
12,1,9,true,2,2,0,41.76641,-87.5657
KA1503000002,1,9,true,2,3,1,41.76641,-87.5657
KA1503000030,1,9,true,1,2,1,41.77352,-87.57722
KA1503000029,1,9,true,5,3,-2,41.77364,-87.56747
KA1503000055,1,9,true,1,1,0,41.77939,-87.64463
KA1503000053,1,9,true,2,2,0,41.78009,-87.61595
653,1,9,true,3,1,-2,41.78059,-87.58491
KA1503000054,1,9,true,2,1,-1,41.78061,-87.60582
15491,1,9,true,5,5,0,41.78096,-87.57624
KA1503000014,1,9,true,42,42,0,41.7851,-87.60108
426,1,9,true,7,9,2,41.7851,-87.60108
KA1503000070,1,9,true,31,27,-4,41.78794,-87.58831
425,1,9,true,2,1,-1,41.78795,-87.58831
328,1,9,true,2,11,9,41.78872,-87.6013
TA1309000011,1,9,true,14,74,60,41.78873,-87.60131
423,1,9,true,5,33,28,41.79148,-87.59988
KA1503000071,1,9,true,17,108,91,41.79148,-87.59988
KA1503000075,1,9,true,1,3,2,41.79156,-87.60785
KA1503000074,1,9,true,12,8,-4,41.79174,-87.58395
TA1309000063,1,9,true,23,19,-4,41.79325,-87.5878
345,1,9,true,7,4,-3,41.79326,-87.5878
420,1,9,true,10,9,-1,41.79429,-87.60145
KA1504000076,1,9,true,37,43,6,41.7943,-87.60145
TA1307000160,1,9,true,4,2,-2,41.79485,-87.61873
247,1,9,true,10,1,-9,41.79522,-87.58077
TA1308000009,1,9,true,50,19,-31,41.79522,-87.58075
TA1307000164,1,9,true,16,12,-4,41.79527,-87.59647
KA1503000052,1,9,true,29,11,-18,41.79935,-87.60097
418,1,9,true,7,4,-3,41.79936,-87.60097
KA1503000059,1,9,true,27,12,-15,41.79952,-87.58643
419,1,9,true,5,2,-3,41.79952,-87.58643
TA1309000037,1,9,true,25,15,-10,41.79957,-87.59474
554,1,9,true,1,1,0,41.80091,-87.67468
417,1,9,true,11,2,-9,41.80242,-87.5869
KA1503000007,1,9,true,48,10,-38,41.80242,-87.58689
13398,1,9,true,25,5,-20,41.80256,-87.59035
121,1,9,true,9,1,-8,41.80256,-87.59035
16940,1,9,true,1,2,1,41.80302,-87.66469
TA1309000067,1,9,true,1,1,0,41.80303,-87.60661
322,1,9,true,7,6,-1,41.80321,-87.59849
KA1503000069,1,9,true,2,2,0,41.80579,-87.59247
KA1503000051,1,9,true,5,2,-3,41.80815,-87.64563
16937,1,9,true,3,2,-1,41.80887,-87.66453
552,1,9,true,1,1,0,41.80887,-87.66452
TA1308000035,1,9,true,9,5,-4,41.80944,-87.59188
TA1308000002,1,9,true,11,12,1,41.80983,-87.59937
TA1309000053,1,9,true,3,3,0,41.80985,-87.60675
KA1503000065,1,9,true,8,3,-5,41.81409,-87.59701
TA1308000023,1,9,true,2,3,1,41.81649,-87.60659
KA1503000027,1,9,true,3,1,-2,41.81666,-87.61942
KA1503000032,1,9,true,1,8,7,41.81912,-87.64328
13083,1,9,true,2,1,-1,41.82167,-87.62153
TA1308000038,1,9,true,5,3,-2,41.82298,-87.6071
15449,1,9,true,1,5,4,41.82302,-87.62657
546,1,9,true,2,8,6,41.82319,-87.67661
13420,1,9,true,4,2,-2,41.82459,-87.61678
KA1503000068,1,9,true,1,1,0,41.82878,-87.68062
KA1503000066,1,9,true,1,2,1,41.83011,-87.67031
TA1308000045,1,9,true,6,2,-4,41.83062,-87.64129
TA1308000043,1,9,true,11,2,-9,41.83066,-87.64715
279,1,9,true,2,1,-1,41.83067,-87.64715
15446,1,9,true,8,2,-6,41.83068,-87.65603
KA1503000005,1,9,true,3,8,5,41.83079,-87.6325
TA1307000129,1,9,true,12,19,7,41.83104,-87.62683
KA1503000004,1,9,true,8,4,-4,41.83127,-87.6088
13345,1,9,true,3,1,-2,41.83138,-87.61803
15445,1,9,true,8,6,-2,41.83453,-87.63183
13216,1,9,true,21,69,48,41.83473,-87.62581
148,1,9,true,8,9,1,41.83474,-87.62581
149,1,9,true,2,1,-1,41.83486,-87.61791
13217,1,9,true,27,15,-12,41.83488,-87.61792
13215,1,9,true,11,12,1,41.83634,-87.6135
280,1,9,true,1,1,0,41.83779,-87.65116
TA1308000046,1,9,true,12,6,-6,41.83779,-87.65115
339,1,9,true,2,2,0,41.83817,-87.64523
TA1309000055,1,9,true,15,9,-6,41.8382,-87.64514
KA1503000038,1,9,true,18,10,-8,41.83845,-87.6354
150,1,9,true,3,3,0,41.83855,-87.60821
TA1307000048,1,9,true,17,21,4,41.83855,-87.60821
272,1,9,true,1,5,4,41.83882,-87.62186
TA1308000036,1,9,true,9,13,4,41.83883,-87.62186
15442,1,9,true,1,2,1,41.83918,-87.66562
KA1503000040,1,9,true,3,4,1,41.84164,-87.65744
237,1,9,true,13,4,-9,41.84204,-87.61697
TA1307000139,1,9,true,42,18,-24,41.84205,-87.61698
15443,1,9,true,3,4,1,41.84275,-87.63549
TA1307000153,1,9,true,11,3,-8,41.84358,-87.64538
15691,1,9,true,1,4,3,41.84449,-87.70203
147,1,9,true,3,2,-1,41.84569,-87.62251
TA1307000005,1,9,true,8,10,2,41.84569,-87.6225
TA1308000013,1,9,true,5,18,13,41.84719,-87.64681
TA1309000003,1,9,true,3,4,1,41.84847,-87.68512
TA1307000066,1,9,true,1,2,1,41.8492,-87.67564
TA1308000014,1,9,true,15,2,-13,41.84953,-87.64059
209,1,9,true,2,2,0,41.84953,-87.64058
TA1308000026,1,9,true,3,4,1,41.85008,-87.63214
TA1305000004,1,9,true,9,5,-4,41.8514,-87.61884
62,1,9,true,1,1,0,41.85141,-87.61884
42,1,9,true,5,3,-2,41.85261,-87.62653
TA1305000001,1,9,true,16,10,-6,41.85262,-87.6265
13075,1,9,true,13,27,14,41.8531,-87.63192
120,1,9,true,4,9,5,41.8531,-87.63191
13162,1,9,true,12,4,-8,41.85378,-87.64659
13096,1,9,true,9,6,-3,41.8538,-87.69577
13091,1,9,true,13,5,-8,41.85409,-87.68585
203,1,9,true,2,1,-1,41.85409,-87.68585
370,1,9,true,2,2,0,41.85415,-87.61917
15546,1,9,true,14,4,-10,41.85416,-87.61916
208,1,9,true,3,1,-2,41.85489,-87.66359
13089,1,9,true,7,8,1,41.85497,-87.67567
13331,1,9,true,8,7,-1,41.85515,-87.65414
171,1,9,true,3,2,-1,41.85516,-87.65414
4,1,9,true,6,6,0,41.85627,-87.61334
15545,1,9,true,25,30,5,41.85627,-87.61334
178,1,9,true,1,1,0,41.85657,-87.62755
SL-013,1,9,true,5,10,5,41.85659,-87.62755
SL-006,1,9,true,3,4,1,41.8568,-87.63387
129,1,9,true,2,3,1,41.85752,-87.66158
202,1,9,true,2,2,0,41.85752,-87.64621
13135,1,9,true,23,22,-1,41.85753,-87.66157
338,1,9,true,10,2,-8,41.85758,-87.61956
13102,1,9,true,43,20,-23,41.85762,-87.61942
13150,1,9,true,31,18,-13,41.85783,-87.62455
273,1,9,true,10,6,-4,41.85783,-87.62455
13099,1,9,true,18,6,-12,41.85784,-87.64627
TA1307000159,1,9,true,28,17,-11,41.8579,-87.6687
205,1,9,true,9,3,-6,41.8579,-87.6687
170,1,9,true,3,5,2,41.85793,-87.64083
TA1307000044,1,9,true,9,9,0,41.85794,-87.64083
14,1,9,true,2,1,-1,41.85808,-87.65109
13163,1,9,true,18,14,-4,41.85808,-87.65108
13164,1,9,true,20,7,-13,41.85818,-87.65648
15,1,9,true,7,1,-6,41.85819,-87.65648
SL-012,1,9,true,39,16,-23,41.86038,-87.62581
72,1,9,true,16,4,-12,41.86039,-87.62581
13304,1,9,true,12,8,-4,41.86126,-87.65659
KA1504000109,1,9,true,7,2,-5,41.86192,-87.69347
TA1306000002,1,9,true,23,11,-12,41.86238,-87.65108
137,1,9,true,2,2,0,41.86238,-87.65108
TA1307000124,1,9,true,48,24,-24,41.86411,-87.62372
168,1,9,true,18,9,-9,41.86415,-87.62372
282,1,9,true,1,6,5,41.86487,-87.64708
TA1309000001,1,9,true,23,21,-2,41.86488,-87.64708
13165,1,9,true,4,3,-1,41.86505,-87.65697
275,1,9,true,4,3,-1,41.86524,-87.66651
13354,1,9,true,1,13,12,41.86524,-87.66651
13029,1,9,true,3,15,12,41.86531,-87.6179
13431,1,9,true,14,17,3,41.8661,-87.60728
434,1,9,true,3,1,-2,41.86651,-87.68465
KA1504000102,1,9,true,2,4,2,41.86664,-87.69453
WL-008,1,9,true,14,15,1,41.86712,-87.64108
57,1,9,true,1,2,1,41.86712,-87.64107
TA1305000002,1,9,true,78,62,-16,41.86721,-87.62597
59,1,9,true,17,13,-4,41.86721,-87.62597
15544,1,9,true,24,19,-5,41.86723,-87.61536
3,1,9,true,2,6,4,41.86723,-87.61536
TA1305000017,1,9,true,11,35,24,41.86734,-87.64863
55,1,9,true,9,3,-6,41.86735,-87.64863
KA1706005007,1,9,true,18,7,-11,41.86749,-87.63219
626,1,9,true,3,1,-2,41.86749,-87.63219
SL-005,1,9,true,61,21,-40,41.8679,-87.62304
255,1,9,true,12,4,-8,41.86791,-87.62304
644,1,9,true,13,7,-6,41.86859,-87.68625
19,1,9,true,4,9,5,41.86892,-87.65913
13139,1,9,true,19,10,-9,41.86893,-87.65913
13285,1,9,true,14,88,74,41.86928,-87.67372
13160,1,9,true,27,22,-5,41.86947,-87.65548
22,1,9,true,3,3,0,41.86947,-87.65548
414,1,9,true,6,3,-3,41.87023,-87.63947
15550,1,9,true,22,17,-5,41.87024,-87.63947
TA1309000010,1,9,true,44,33,-11,41.87074,-87.62574
SL-009,1,9,true,11,17,6,41.87081,-87.63121
342,1,9,true,2,19,17,41.87127,-87.6737
TA1309000064,1,9,true,16,52,36,41.87127,-87.67369
15542,1,9,true,7,36,29,41.87146,-87.64095
TA1307000130,1,9,true,25,51,26,41.87178,-87.65103
241,1,9,true,10,11,1,41.8718,-87.65102
108,1,9,true,6,12,6,41.87183,-87.64664
TA1307000121,1,9,true,66,40,-26,41.87184,-87.64664
41,1,9,true,17,6,-11,41.87209,-87.62957
SL-008,1,9,true,45,28,-17,41.87209,-87.62956
13332,1,9,true,63,36,-27,41.87219,-87.6615
394,1,9,true,7,1,-6,41.87226,-87.63484
175,1,9,true,5,2,-3,41.87255,-87.63359
SL-011,1,9,true,33,27,-6,41.87256,-87.63356
623,1,9,true,36,21,-15,41.87272,-87.62399
KA1504000104,1,9,true,23,90,67,41.87296,-87.66912
383,1,9,true,5,28,23,41.87297,-87.66912
320,1,9,true,12,9,-3,41.87327,-87.66402
5,1,9,true,5,3,-2,41.87403,-87.6277
SL-007,1,9,true,10,19,9,41.87404,-87.6277
169,1,9,true,5,5,0,41.87424,-87.63959
13326,1,9,true,12,10,-2,41.87425,-87.63958
321,1,9,true,18,12,-6,41.87427,-87.63257
32,1,9,true,6,1,-5,41.87464,-87.65703
TA1306000025,1,9,true,15,16,1,41.87464,-87.65703
15668,1,9,true,11,6,-5,41.87471,-87.68642
13028,1,9,true,39,30,-9,41.87475,-87.64981
109,1,9,true,9,4,-5,41.87475,-87.64981
13081,1,9,true,3,18,15,41.87501,-87.67326
89,1,9,true,6,4,-2,41.87501,-87.6331
SL-010,1,9,true,16,14,-2,41.87501,-87.63309
15541,1,9,true,5,10,5,41.8758,-87.62086
13037,1,9,true,11,11,0,41.87588,-87.64078
50,1,9,true,3,3,0,41.87592,-87.6307
TA1305000009,1,9,true,11,18,7,41.87593,-87.63068
317,1,9,true,5,27,22,41.87603,-87.68195
TA1305000010,1,9,true,8,15,7,41.87623,-87.62444
624,1,9,true,34,30,-4,41.87626,-87.62923
33,1,9,true,4,14,10,41.87715,-87.62786
TA1305000035,1,9,true,18,31,13,41.87716,-87.62787
13138,1,9,true,18,43,25,41.87723,-87.63941
75,1,9,true,5,6,1,41.87724,-87.63937
631,1,9,true,3,20,17,41.87761,-87.6739
15539,1,9,true,42,29,-13,41.87763,-87.64405
13158,1,9,true,45,32,-13,41.87764,-87.64957
134,1,9,true,18,5,-13,41.87764,-87.64954
21,1,9,true,7,9,2,41.87773,-87.6548
13157,1,9,true,26,35,9,41.87773,-87.6548
TA1305000025,1,9,true,23,100,77,41.87773,-87.63528
36,1,9,true,3,13,10,41.87776,-87.63525
TA1309000002,1,9,true,27,18,-9,41.87784,-87.62408
284,1,9,true,2,10,8,41.87784,-87.62408
13206,1,9,true,18,16,-2,41.87794,-87.66201
146,1,9,true,3,2,-1,41.87794,-87.66201
283,1,9,true,11,20,9,41.87809,-87.63183
TA1309000004,1,9,true,19,53,34,41.87811,-87.63184
107,1,9,true,8,5,-3,41.87822,-87.644
638,1,9,true,39,89,50,41.87827,-87.64078
37,1,9,true,3,38,35,41.87921,-87.62975
TA1305000005,1,9,true,24,113,89,41.87924,-87.62975
286,1,9,true,1,12,11,41.8793,-87.6355
13011,1,9,true,37,95,58,41.87931,-87.63993
TA1309000008,1,9,true,24,32,8,41.87933,-87.6355
192,1,9,true,10,16,6,41.87935,-87.63997
KA1503000034,1,9,true,5,42,37,41.87938,-87.63197
39,1,9,true,1,11,10,41.87948,-87.62571
KA1503000015,1,9,true,23,54,31,41.87948,-87.6257
15667,1,9,true,2,2,0,41.8798,-87.68609
381,1,9,true,3,2,-1,41.87981,-87.68607
287,1,9,true,1,11,10,41.88017,-87.63527
TA1309000007,1,9,true,34,94,60,41.88022,-87.63526
WL-011,1,9,true,26,25,-1,41.88034,-87.64273
73,1,9,true,9,11,2,41.8804,-87.64273
80,1,9,true,11,6,-5,41.88042,-87.65556
13156,1,9,true,28,24,-4,41.88042,-87.65554
13300,1,9,true,33,38,5,41.88097,-87.61675
76,1,9,true,7,3,-4,41.88098,-87.61675
13008,1,9,true,20,53,33,41.88105,-87.62408
90,1,9,true,2,14,12,41.88107,-87.62409
49,1,9,true,6,26,20,41.88116,-87.62963
TA1305000006,1,9,true,38,127,89,41.88122,-87.6296
13134,1,9,true,9,7,-2,41.88138,-87.67493
215,1,9,true,2,1,-1,41.88139,-87.67492
13056,1,9,true,38,49,11,41.88168,-87.63951
191,1,9,true,9,2,-7,41.88169,-87.63951
198,1,9,true,6,10,4,41.88187,-87.6488
TA1307000120,1,9,true,55,86,31,41.88188,-87.64879
13341,1,9,true,25,67,42,41.88208,-87.63985
174,1,9,true,1,11,10,41.88208,-87.63984
197,1,9,true,3,11,8,41.88208,-87.62513
13036,1,9,true,26,68,42,41.8821,-87.62513
77,1,9,true,10,8,-2,41.88214,-87.64108
TA1305000032,1,9,true,87,56,-31,41.88218,-87.64109
98,1,9,true,2,5,3,41.88266,-87.63251
13006,1,9,true,29,74,45,41.88268,-87.63252
13353,1,9,true,19,22,3,41.88283,-87.6612
346,1,9,true,5,4,-1,41.88284,-87.6612
654,1,9,true,14,20,6,41.88307,-87.65698
233,1,9,true,6,3,-3,41.88309,-87.6511
13409,1,9,true,19,34,15,41.8831,-87.6511
18,1,9,true,2,21,19,41.88317,-87.63735
KA1503000072,1,9,true,13,65,52,41.88317,-87.63693
91,1,9,true,18,23,5,41.88336,-87.64122
WL-012,1,9,true,79,91,12,41.88337,-87.6412
112,1,9,true,7,13,6,41.88362,-87.6486
13053,1,9,true,27,50,23,41.88365,-87.64863
43,1,9,true,6,9,3,41.88396,-87.62455
13001,1,9,true,45,68,23,41.88397,-87.62459
88,1,9,true,3,5,2,41.88407,-87.65691
13155,1,9,true,6,11,5,41.88407,-87.65689
621,1,9,true,4,8,4,41.88412,-87.65427
18062,1,9,true,16,33,17,41.88412,-87.65427
81,1,9,true,14,26,12,41.88417,-87.6296
TA1306000010,1,9,true,51,92,41,41.88419,-87.62961
15666,1,9,true,1,3,2,41.88446,-87.6963
TA1305000030,1,9,true,36,163,127,41.88459,-87.63178
96,1,9,true,4,6,2,41.8846,-87.64455
15535,1,9,true,29,41,12,41.8846,-87.64455
51,1,9,true,7,38,31,41.88462,-87.63176
TA1305000029,1,9,true,42,57,15,41.88466,-87.62787
195,1,9,true,22,10,-12,41.88466,-87.61952
13263,1,9,true,69,36,-33,41.88467,-87.61952
44,1,9,true,4,6,2,41.88468,-87.62782
TA1306000015,1,9,true,32,66,34,41.88549,-87.65232
71,1,9,true,11,12,1,41.8855,-87.65233
66,1,9,true,7,8,1,41.88557,-87.64186
13021,1,9,true,72,91,19,41.88559,-87.64184
TA1307000111,1,9,true,43,76,33,41.88582,-87.63548
164,1,9,true,8,21,13,41.88583,-87.63547
13073,1,9,true,2,10,8,41.88592,-87.66717
119,1,9,true,1,3,2,41.88593,-87.66717
656,1,9,true,2,3,1,41.88595,-87.67701
KA17018054,1,9,true,6,9,3,41.88595,-87.67701
KA1503000012,1,9,true,78,58,-20,41.88599,-87.63089
38,1,9,true,18,24,6,41.88599,-87.63089
52,1,9,true,6,14,8,41.886,-87.62421
TA1305000011,1,9,true,33,84,51,41.886,-87.62418
7,1,9,true,3,2,-1,41.88627,-87.61751
15534,1,9,true,24,24,0,41.88627,-87.61749
217,1,9,true,4,2,-2,41.8866,-87.65821
13197,1,9,true,11,22,11,41.8866,-87.65816
264,1,9,true,4,8,4,41.8867,-87.62224
TA1308000029,1,9,true,29,30,1,41.88673,-87.62225
TA1307000131,1,9,true,8,52,44,41.88688,-87.62606
KA1503000064,1,9,true,31,30,-1,41.88697,-87.61281
532,1,9,true,1,2,1,41.88792,-87.77446
100,1,9,true,7,17,10,41.88814,-87.63657
TA1305000022,1,9,true,82,93,11,41.88817,-87.63656
56,1,9,true,17,12,-5,41.88866,-87.64442
TA1306000003,1,9,true,35,33,-2,41.88867,-87.64442
KA1503000043,1,9,true,133,104,-29,41.88918,-87.63851
133,1,9,true,23,20,-3,41.88918,-87.63851
13050,1,9,true,39,62,23,41.88919,-87.62775
47,1,9,true,11,23,12,41.88921,-87.62775
15664,1,9,true,10,3,-7,41.8895,-87.68821
376,1,9,true,2,1,-1,41.88951,-87.68818
285,1,9,true,1,8,7,41.88989,-87.67149
13432,1,9,true,9,24,15,41.88989,-87.67149
TA1307000151,1,9,true,80,81,1,41.88993,-87.63427
212,1,9,true,10,12,2,41.88995,-87.63427
636,1,9,true,30,47,17,41.88997,-87.63662
125,1,9,true,2,6,4,41.89018,-87.62621
KA1503000044,1,9,true,15,39,24,41.89018,-87.6262
196,1,9,true,5,18,13,41.89053,-87.62205
13427,1,9,true,27,49,22,41.89054,-87.62205
26,1,9,true,12,2,-10,41.89057,-87.61798
13430,1,9,true,31,87,56,41.89077,-87.63169
181,1,9,true,4,21,17,41.89077,-87.63168
TA1306000013,1,9,true,47,35,-12,41.89083,-87.61852
RN-,1,9,true,19,49,30,41.89102,-87.63546
672,1,9,true,15,14,-1,41.89102,-87.63545
13434,1,9,true,18,19,1,41.89108,-87.66663
TA1308000006,1,9,true,10,5,-5,41.89128,-87.67686
199,1,9,true,7,11,4,41.89143,-87.62676
TA1307000117,1,9,true,42,78,36,41.89144,-87.62675
13033,1,9,true,45,42,-3,41.8916,-87.64835
214,1,9,true,7,4,-3,41.89161,-87.67688
84,1,9,true,12,5,-7,41.89161,-87.64833
186,1,9,true,10,6,-4,41.8918,-87.65879
13194,1,9,true,42,22,-20,41.8918,-87.65878
TA1305000003,1,9,true,68,55,-13,41.89187,-87.62061
24,1,9,true,12,8,-4,41.8919,-87.62063
643,1,9,true,4,7,3,41.89203,-87.68939
35,1,9,true,7,3,-4,41.89227,-87.61206
13022,1,9,true,49,50,1,41.89227,-87.61205
99,1,9,true,5,2,-3,41.89255,-87.61449
TA1306000029,1,9,true,45,36,-9,41.89256,-87.61449
13265,1,9,true,68,46,-22,41.89383,-87.64172
74,1,9,true,6,10,4,41.89384,-87.64173
13045,1,9,true,85,79,-6,41.89403,-87.62931
110,1,9,true,12,24,12,41.89406,-87.6293
13016,1,9,true,69,127,58,41.89431,-87.62277
211,1,9,true,14,47,33,41.89439,-87.62267
KA1503000041,1,9,true,82,112,30,41.89452,-87.61798
142,1,9,true,11,19,8,41.89453,-87.61806
92,1,9,true,7,5,-2,41.89455,-87.65346
13196,1,9,true,32,28,-4,41.89455,-87.65345
TA1307000062,1,9,true,60,76,16,41.89466,-87.63839
111,1,9,true,9,12,3,41.89466,-87.63837
TA1306000012,1,9,true,86,81,-5,41.89475,-87.63438
53,1,9,true,25,21,-4,41.89476,-87.63439
627,1,9,true,4,7,3,41.8948,-87.63231
KP1705001026,1,9,true,27,28,1,41.89483,-87.6323
18058,1,9,true,9,5,-4,41.8955,-87.68201
637,1,9,true,38,16,-22,41.89563,-87.67209
128,1,9,true,11,5,-6,41.89571,-87.67716
13132,1,9,true,26,18,-8,41.89573,-87.67718
161,1,9,true,11,6,-5,41.89574,-87.62599
15530,1,9,true,50,67,17,41.89575,-87.62596
18003,1,9,true,27,57,30,41.89575,-87.62011
635,1,9,true,6,16,10,41.89576,-87.62012
13247,1,9,true,23,16,-7,41.89597,-87.66775
350,1,9,true,5,1,-4,41.89597,-87.66774
TA1305000020,1,9,true,27,41,14,41.89636,-87.65406
54,1,9,true,2,10,8,41.89637,-87.65407
13289,1,9,true,21,10,-11,41.89638,-87.661
86,1,9,true,5,6,1,41.89639,-87.661
337,1,9,true,5,2,-3,41.89659,-87.63096
13303,1,9,true,26,23,-3,41.89672,-87.63088
13017,1,9,true,83,49,-34,41.89676,-87.6357
31,1,9,true,25,16,-9,41.89677,-87.63572
13338,1,9,true,68,82,14,41.89697,-87.62173
173,1,9,true,11,15,4,41.89704,-87.62173
TA1307000061,1,9,true,22,39,17,41.89745,-87.62873
106,1,9,true,5,4,-1,41.89746,-87.62874
25,1,9,true,2,8,6,41.89751,-87.62354
13034,1,9,true,17,26,9,41.89754,-87.62352
48,1,9,true,11,32,21,41.89772,-87.64302
TA1306000009,1,9,true,55,127,72,41.89772,-87.64299
620,1,9,true,42,15,-27,41.89817,-87.63754
KA1504000103,1,9,true,13,4,-9,41.89842,-87.68659
145,1,9,true,12,23,11,41.89856,-87.62211
15529,1,9,true,33,91,58,41.89858,-87.62206
140,1,9,true,14,17,3,41.89895,-87.6299
TA1307000128,1,9,true,54,59,5,41.89896,-87.6299
657,1,9,true,23,21,-2,41.89918,-87.6722
KA1504000117,1,9,true,9,8,-1,41.89936,-87.64848
30,1,9,true,2,2,0,41.89964,-87.66789
13248,1,9,true,20,13,-7,41.89964,-87.66788
46,1,9,true,7,5,-2,41.89994,-87.63444
TA1306000011,1,9,true,11,7,-4,41.89994,-87.63443
KA1504000116,1,9,true,26,15,-11,41.90023,-87.64299
364,1,9,true,1,4,3,41.90023,-87.64299
17660,1,9,true,7,12,5,41.90036,-87.69671
622,1,9,true,2,2,0,41.90037,-87.69671
13290,1,9,true,20,15,-5,41.90069,-87.66259
29,1,9,true,7,4,-3,41.90069,-87.66259
13042,1,9,true,42,88,46,41.90097,-87.62377
85,1,9,true,7,14,7,41.90098,-87.62375
TA1307000070,1,9,true,21,4,-17,41.90133,-87.67742
KA1504000133,1,9,true,43,37,-6,41.90234,-87.62773
172,1,9,true,6,11,5,41.90236,-87.62774
15654,1,9,true,5,3,-2,41.90271,-87.70923
13241,1,9,true,14,9,-5,41.9029,-87.68731
176,1,9,true,26,17,-9,41.90291,-87.63141
TA1306000006,1,9,true,11,5,-6,41.90292,-87.63772
23,1,9,true,2,2,0,41.90292,-87.63772
TA1307000039,1,9,true,82,88,6,41.90294,-87.63137
658,1,9,true,30,13,-17,41.903,-87.6838
216,1,9,true,9,5,-4,41.90302,-87.69749
13256,1,9,true,7,7,0,41.90302,-87.69749
TA1305000034,1,9,true,19,12,-7,41.90313,-87.67391
17,1,9,true,8,4,-4,41.90313,-87.67391
182,1,9,true,27,12,-15,41.90317,-87.63442
KA1504000135,1,9,true,64,61,-3,41.90319,-87.63439
13136,1,9,true,18,18,0,41.90326,-87.67845
130,1,9,true,3,1,-2,41.90327,-87.67846
210,1,9,true,6,10,4,41.90342,-87.66781
13061,1,9,true,62,67,5,41.90342,-87.66779
KA1504000079,1,9,true,32,15,-17,41.9035,-87.64334
359,1,9,true,3,6,3,41.90458,-87.6497
138,1,9,true,4,3,-1,41.9046,-87.64057
TA1307000115,1,9,true,11,14,3,41.9046,-87.64056
291,1,9,true,12,8,-4,41.90672,-87.63494
TA1308000049,1,9,true,40,27,-13,41.90672,-87.6349
KA1504000134,1,9,true,36,21,-15,41.90687,-87.6262
180,1,9,true,11,2,-9,41.90687,-87.62618
13224,1,9,true,34,17,-17,41.90706,-87.66725
333,1,9,true,1,6,5,41.90706,-87.66725
18069,1,9,true,2,12,10,41.90722,-87.65563
TA1307000143,1,9,true,18,6,-12,41.90762,-87.63854
236,1,9,true,6,1,-5,41.90762,-87.63853
61,1,9,true,4,5,1,41.90764,-87.67254
13221,1,9,true,39,28,-11,41.90765,-87.67254
13245,1,9,true,3,5,2,41.90777,-87.68586
301,1,9,true,21,10,-11,41.90796,-87.63203
TA1309000024,1,9,true,78,47,-31,41.908,-87.63152
69,1,9,true,4,8,4,41.90939,-87.6777
TA1305000041,1,9,true,18,32,14,41.9094,-87.67769
331,1,9,true,49,49,0,41.90965,-87.64812
15653,1,9,true,8,5,-3,41.90979,-87.7053
509,1,9,true,1,1,0,41.9098,-87.70531
TA1305000037,1,9,true,33,15,-18,41.91018,-87.67003
TA1306000008,1,9,true,17,12,-5,41.9102,-87.6435
16,1,9,true,9,4,-5,41.91035,-87.67008
TA1308000005,1,9,true,13,7,-6,41.91042,-87.68238
13258,1,9,true,10,5,-5,41.91043,-87.69718
276,1,9,true,1,1,0,41.91043,-87.69718
160,1,9,true,2,2,0,41.91054,-87.68957
13257,1,9,true,13,6,-7,41.91054,-87.68956
13154,1,9,true,41,32,-9,41.91054,-87.65312
20,1,9,true,5,3,-2,41.91055,-87.65313
60,1,9,true,5,3,-2,41.91059,-87.64942
13058,1,9,true,32,31,-1,41.91059,-87.64942
TA1307000038,1,9,true,35,33,-2,41.91138,-87.63868
118,1,9,true,9,8,-1,41.91138,-87.63868
268,1,9,true,11,5,-6,41.91172,-87.62681
LF-005,1,9,true,34,37,3,41.91172,-87.62681
126,1,9,true,2,4,2,41.91196,-87.63197
13128,1,9,true,27,18,-9,41.91197,-87.63197
289,1,9,true,14,16,2,41.91209,-87.63472
TA1308000050,1,9,true,64,62,-2,41.91211,-87.6347
13243,1,9,true,29,25,-4,41.91262,-87.6814
158,1,9,true,4,2,-2,41.91262,-87.6814
TA1309000032,1,9,true,6,5,-1,41.91293,-87.66417
TA1306000032,1,9,true,27,20,-7,41.9137,-87.65285
93,1,9,true,5,7,2,41.91371,-87.65285
224,1,9,true,12,12,0,41.91386,-87.64877
TA1307000166,1,9,true,14,28,14,41.91386,-87.64877
511,1,9,true,3,1,-2,41.914,-87.70515
15655,1,9,true,9,3,-6,41.91401,-87.70514
18017,1,9,true,3,3,0,41.91416,-87.71676
18067,1,9,true,18,12,-6,41.9146,-87.66796
628,1,9,true,2,2,0,41.9146,-87.66796
28,1,9,true,7,1,-6,41.91469,-87.64333
TA1306000007,1,9,true,14,11,-3,41.91469,-87.64333
13068,1,9,true,16,38,22,41.91554,-87.68703
116,1,9,true,2,5,3,41.91555,-87.68703
13179,1,9,true,44,41,-3,41.9157,-87.63461
141,1,9,true,13,14,1,41.91571,-87.63461
13133,1,9,true,25,12,-13,41.91598,-87.67733
58,1,9,true,1,2,1,41.91602,-87.66894
TA1305000039,1,9,true,21,16,-5,41.9163,-87.66749
15650,1,9,true,6,6,0,41.91711,-87.71023
15651,1,9,true,14,5,-9,41.91752,-87.70181
507,1,9,true,3,1,-2,41.91752,-87.70181
13266,1,9,true,7,4,-3,41.91774,-87.69142
TA1309000029,1,9,true,15,4,-11,41.9178,-87.68245
309,1,9,true,3,2,-1,41.91789,-87.6865
288,1,9,true,8,8,0,41.91809,-87.64375
TA1309000006,1,9,true,20,24,4,41.91809,-87.64375
223,1,9,true,4,7,3,41.91821,-87.65698
TA1307000163,1,9,true,26,26,0,41.91821,-87.65696
94,1,9,true,30,10,-20,41.91831,-87.6363
13146,1,9,true,62,33,-29,41.91831,-87.63629
13059,1,9,true,39,44,5,41.91845,-87.65222
113,1,9,true,9,9,0,41.91846,-87.65222
13259,1,9,true,7,6,-1,41.91852,-87.69744
310,1,9,true,4,2,-2,41.91984,-87.68083
225,1,9,true,9,5,-4,41.91995,-87.64884
13192,1,9,true,35,37,2,41.91995,-87.64884
13288,1,9,true,15,5,-10,41.92008,-87.67788
13242,1,9,true,4,6,2,41.92021,-87.69266
222,1,9,true,4,2,-2,41.92023,-87.69265
307,1,9,true,5,4,-1,41.92077,-87.66373
TA1309000030,1,9,true,20,21,1,41.92077,-87.66372
290,1,9,true,3,3,0,41.92152,-87.70734
13292,1,9,true,11,2,-9,41.92152,-87.70733
TA1309000033,1,9,true,36,25,-11,41.92158,-87.65381
13193,1,9,true,48,31,-17,41.92182,-87.64412
144,1,9,true,15,13,-2,41.92182,-87.64411
13191,1,9,true,38,18,-20,41.92217,-87.63891
327,1,9,true,6,6,0,41.92225,-87.65783
13084,1,9,true,18,18,0,41.92268,-87.69715
123,1,9,true,5,2,-3,41.92268,-87.69714
LP-,1,9,true,17,12,-5,41.92396,-87.63584
673,1,9,true,4,2,-2,41.92398,-87.63585
KA1504000140,1,9,true,12,6,-6,41.92409,-87.67646
16010,1,9,true,1,2,1,41.92458,-87.72787
15648,1,9,true,5,2,-3,41.92464,-87.68931
504,1,9,true,4,2,-2,41.92464,-87.68931
503,1,9,true,1,1,0,41.92483,-87.71451
KA1504000090,1,9,true,5,4,-1,41.92483,-87.7145
TA1307000001,1,9,true,36,48,12,41.92535,-87.66581
188,1,9,true,9,8,-1,41.92536,-87.66581
TA1306000026,1,9,true,41,50,9,41.92558,-87.65842
87,1,9,true,6,3,-3,41.92559,-87.65843
67,1,9,true,7,6,-1,41.9256,-87.65371
TA1306000016,1,9,true,40,44,4,41.9256,-87.65371
313,1,9,true,9,6,-3,41.9257,-87.64246
TA1309000019,1,9,true,61,30,-31,41.92586,-87.63897
TA1309000058,1,9,true,65,61,-4,41.92591,-87.64927
127,1,9,true,12,8,-4,41.92592,-87.64927
TA1308000001,1,9,true,50,48,-2,41.92627,-87.63086
177,1,9,true,8,7,-1,41.92627,-87.63086
502,1,9,true,1,1,0,41.92667,-87.69772
15646,1,9,true,10,17,7,41.92668,-87.6977
13124,1,9,true,10,23,13,41.92675,-87.63444
302,1,9,true,2,7,5,41.92859,-87.65421
TA1309000023,1,9,true,19,10,-9,41.9287,-87.65383
TA1307000113,1,9,true,8,7,-1,41.92878,-87.66391
190,1,9,true,2,1,-1,41.92878,-87.6639
13296,1,9,true,11,13,2,41.92883,-87.66852
TA1309000059,1,9,true,20,13,-7,41.92889,-87.65898
343,1,9,true,7,3,-4,41.92889,-87.65898
349,1,9,true,15,6,-9,41.92915,-87.6491
TA1309000061,1,9,true,28,29,1,41.92915,-87.64909
258,1,9,true,1,2,1,41.92946,-87.68417
TA1308000031,1,9,true,7,11,4,41.92946,-87.68417
TA1305000014,1,9,true,77,53,-24,41.92956,-87.64313
340,1,9,true,11,9,-2,41.92956,-87.64313
260,1,9,true,3,1,-2,41.92958,-87.70791
13085,1,9,true,13,9,-4,41.92958,-87.70789
499,1,9,true,3,1,-2,41.93056,-87.72381
15643,1,9,true,3,3,0,41.93057,-87.7238
TA1307000142,1,9,true,28,40,12,41.93125,-87.64432
220,1,9,true,13,11,-2,41.93125,-87.64431
13276,1,9,true,59,38,-21,41.93132,-87.63874
324,1,9,true,12,9,-3,41.93173,-87.64179
15645,1,9,true,4,2,-2,41.93191,-87.70121
13271,1,9,true,1,17,16,41.93192,-87.67784
152,1,9,true,10,9,-1,41.93221,-87.65864
TA1307000064,1,9,true,34,32,-2,41.93222,-87.65864
13,1,9,true,7,2,-5,41.93242,-87.65271
TA1306000014,1,9,true,43,39,-4,41.93242,-87.65271
TA1309000039,1,9,true,59,19,-40,41.93258,-87.63642
329,1,9,true,9,7,-2,41.93258,-87.63642
13294,1,9,true,9,6,-3,41.9326,-87.66595
319,1,9,true,2,1,-1,41.93292,-87.67217
332,1,9,true,6,4,-2,41.93313,-87.64776
TA1309000036,1,9,true,33,35,2,41.93313,-87.64776
15644,1,9,true,3,1,-2,41.93534,-87.71687
TA1307000006,1,9,true,28,31,3,41.93571,-87.6636
153,1,9,true,7,7,0,41.93575,-87.66364
162,1,9,true,1,1,0,41.93588,-87.67844
13268,1,9,true,8,6,-2,41.93588,-87.67843
250,1,9,true,2,5,3,41.93609,-87.66984
13269,1,9,true,14,17,3,41.93609,-87.66983
TA1307000052,1,9,true,50,45,-5,41.93628,-87.65266
115,1,9,true,13,16,3,41.93628,-87.65266
156,1,9,true,5,14,9,41.9365,-87.64756
TA1307000136,1,9,true,43,31,-12,41.9365,-87.64755
TA1307000041,1,9,true,71,40,-31,41.93669,-87.63683
157,1,9,true,13,6,-7,41.9367,-87.63683
13137,1,9,true,81,55,-26,41.9376,-87.6441
300,1,9,true,17,17,0,41.93761,-87.6441
15642,1,9,true,6,2,-4,41.93843,-87.69801
154,1,9,true,3,3,0,41.93912,-87.66384
KA17018068,1,9,true,6,3,-3,41.93935,-87.68327
TA1309000042,1,9,true,19,21,2,41.93937,-87.66836
131,1,9,true,9,15,6,41.93937,-87.66835
496,1,9,true,1,1,0,41.9394,-87.72356
KA150400009X,1,9,true,4,2,-2,41.9394,-87.71159
15640,1,9,true,6,2,-4,41.93941,-87.72357
497,1,9,true,1,1,0,41.93941,-87.71159
13229,1,9,true,15,16,1,41.93946,-87.66376
226,1,9,true,2,3,1,41.93972,-87.65886
TA1308000019,1,9,true,12,12,0,41.93973,-87.65886
13277,1,9,true,28,16,-12,41.9401,-87.64546
296,1,9,true,7,9,2,41.9401,-87.64546
TA1307000134,1,9,true,36,35,-1,41.94016,-87.65303
117,1,9,true,3,9,6,41.94016,-87.65302
228,1,9,true,4,2,-2,41.94058,-87.67854
13143,1,9,true,19,3,-16,41.94059,-87.67853
334,1,9,true,11,6,-5,41.94076,-87.63919
TA1309000049,1,9,true,37,29,-8,41.94077,-87.63919
308,1,9,true,2,4,2,41.94152,-87.68471
493,1,9,true,1,1,0,41.94304,-87.68729
15634,1,9,true,1,2,1,41.94304,-87.68729
TA1307000138,1,9,true,34,39,5,41.94334,-87.67094
230,1,9,true,11,9,-2,41.94335,-87.67093
13144,1,9,true,9,23,14,41.9434,-87.67964
299,1,9,true,7,8,1,41.94368,-87.64894
TA1309000025,1,9,true,31,40,9,41.94368,-87.64894
229,1,9,true,14,6,-8,41.94372,-87.66401
13071,1,9,true,43,60,17,41.94373,-87.66401
632,1,9,true,21,34,13,41.94453,-87.6547
303,1,9,true,14,8,-6,41.94522,-87.64702
15631,1,9,true,5,3,-2,41.94524,-87.70665
13278,1,9,true,41,28,-13,41.94553,-87.64644
TA1309000050,1,9,true,4,9,5,41.94618,-87.67331
492,1,9,true,2,1,-1,41.94662,-87.68337
15632,1,9,true,2,6,4,41.94664,-87.69463
KA1504000143,1,9,true,5,10,5,41.94664,-87.68337
KA1504000142,1,9,true,1,2,1,41.94735,-87.71759
227,1,9,true,2,14,12,41.94813,-87.66397
13235,1,9,true,54,35,-19,41.94814,-87.66396
304,1,9,true,15,8,-7,41.94878,-87.64922
13253,1,9,true,18,11,-7,41.9488,-87.67527
257,1,9,true,1,3,2,41.9488,-87.67527
13325,1,9,true,54,77,23,41.94907,-87.64863
114,1,9,true,8,3,-5,41.94935,-87.65451
TA1307000126,1,9,true,19,36,17,41.94936,-87.65451
232,1,9,true,12,6,-6,41.94943,-87.64645
TA1307000150,1,9,true,32,36,4,41.94945,-87.64646
640,1,9,true,1,1,0,41.94993,-87.71396
18016,1,9,true,2,3,1,41.94993,-87.71395
347,1,9,true,1,2,1,41.95068,-87.6687
13319,1,9,true,22,14,-8,41.95069,-87.6687
TA1307000127,1,9,true,41,23,-18,41.9508,-87.65918
165,1,9,true,5,2,-3,41.95081,-87.65918
15628,1,9,true,8,6,-2,41.95216,-87.69806
318,1,9,true,3,3,0,41.95254,-87.6735
13323,1,9,true,55,31,-24,41.95282,-87.65
256,1,9,true,10,12,2,41.95282,-87.65
15624,1,9,true,3,3,0,41.95339,-87.73199
485,1,9,true,1,1,0,41.95361,-87.70933
KA1504000139,1,9,true,3,1,-2,41.954,-87.71909
TA1309000043,1,9,true,28,9,-19,41.95417,-87.66434
240,1,9,true,7,11,4,41.95424,-87.65441
13063,1,9,true,40,49,9,41.95424,-87.65441
KA1504000158,1,9,true,4,5,1,41.95432,-87.68607
254,1,9,true,13,8,-5,41.95438,-87.64806
TA1308000022,1,9,true,30,14,-16,41.95438,-87.64805
16991,1,9,true,4,7,3,41.95448,-87.7496
244,1,9,true,2,13,11,41.95466,-87.67391
TA1307000149,1,9,true,15,24,9,41.95467,-87.67392
TA1309000026,1,9,true,9,8,-1,41.95601,-87.6802
13249,1,9,true,8,3,-5,41.95606,-87.66885
246,1,9,true,1,1,0,41.95606,-87.66885
312,1,9,true,6,11,5,41.95637,-87.6563
TA1308000047,1,9,true,16,4,-12,41.95709,-87.6642
292,1,9,true,3,2,-1,41.95709,-87.6642
13379,1,9,true,29,23,-6,41.95786,-87.6495
TA1309000018,1,9,true,38,18,-20,41.95791,-87.67357
316,1,9,true,2,1,-1,41.95841,-87.69401
306,1,9,true,17,7,-10,41.9585,-87.655
TA1309000027,1,9,true,31,16,-15,41.9585,-87.65499
13389,1,9,true,37,14,-23,41.961,-87.64958
245,1,9,true,13,8,-5,41.96101,-87.64958
15621,1,9,true,5,6,1,41.96103,-87.70586
480,1,9,true,2,2,0,41.96104,-87.70586
KA1706005015,1,9,true,1,1,0,41.96108,-87.73569
15622,1,9,true,14,9,-5,41.96108,-87.69544
KA1504000097,1,9,true,5,2,-3,41.96116,-87.71658
238,1,9,true,2,5,3,41.96141,-87.6762
TA1307000144,1,9,true,14,13,-1,41.96142,-87.6762
297,1,9,true,3,2,-1,41.9615,-87.67141
TA1309000021,1,9,true,7,5,-2,41.9615,-87.6714
15623,1,9,true,12,5,-7,41.96154,-87.69117
482,1,9,true,5,1,-4,41.96154,-87.69117
234,1,9,true,2,4,2,41.96158,-87.6661
KA1503000022,1,9,true,13,17,4,41.96158,-87.66609
231,1,9,true,12,6,-6,41.96163,-87.65464
TA1307000107,1,9,true,26,36,10,41.96164,-87.65464
TA1307000156,1,9,true,14,13,-1,41.96301,-87.68479
243,1,9,true,1,4,3,41.96302,-87.68479
TA1309000012,1,9,true,7,10,3,41.96325,-87.67928
TA1308000012,1,9,true,23,24,1,41.96398,-87.63818
249,1,9,true,5,8,3,41.96398,-87.63818
293,1,9,true,1,6,5,41.96521,-87.65822
13074,1,9,true,23,17,-6,41.96521,-87.6582
639,1,9,true,25,17,-8,41.96584,-87.64538
KA1504000127,1,9,true,4,1,-3,41.96587,-87.70083
477,1,9,true,1,3,2,41.96587,-87.70083
KA1504000093,1,9,true,6,4,-2,41.96587,-87.69365
478,1,9,true,2,4,2,41.96587,-87.69364
TA1307000140,1,9,true,31,9,-22,41.96643,-87.68865
239,1,9,true,11,2,-9,41.9665,-87.68843
326,1,9,true,7,9,2,41.96665,-87.67113
KA1504000126,1,9,true,1,1,0,41.96668,-87.70807
TA1309000014,1,9,true,20,13,-7,41.96709,-87.66744
242,1,9,true,6,7,1,41.9671,-87.67904
TA1307000158,1,9,true,10,39,29,41.9671,-87.67904
251,1,9,true,4,10,6,41.96796,-87.65
TA1307000119,1,9,true,11,29,18,41.96796,-87.65
15615,1,9,true,5,12,7,41.96835,-87.71183
474,1,9,true,2,1,-1,41.96835,-87.71182
323,1,9,true,6,3,-3,41.96869,-87.66034
TA1308000021,1,9,true,10,7,-3,41.96883,-87.65765
253,1,9,true,4,2,-2,41.96883,-87.65765
KA1504000080,1,9,true,8,3,-5,41.96887,-87.69609
TA1309000015,1,9,true,7,6,-1,41.96889,-87.68401
311,1,9,true,2,1,-1,41.9689,-87.68402
344,1,9,true,10,9,-1,41.9691,-87.67423
TA1309000066,1,9,true,17,24,7,41.9691,-87.67423
TA1309000041,1,9,true,8,9,1,41.96951,-87.65471
KA1504000171,1,9,true,26,14,-12,41.97161,-87.65016
465,1,9,true,10,6,-4,41.97161,-87.65016
325,1,9,true,7,10,3,41.9728,-87.67186
TA1309000035,1,9,true,14,8,-6,41.97335,-87.66785
295,1,9,true,6,8,2,41.97378,-87.65972
13108,1,9,true,15,16,1,41.97379,-87.65971
KA1504000078,1,9,true,4,5,1,41.97491,-87.69258
KA1504000149,1,9,true,8,7,-1,41.97562,-87.67945
KA1504000160,1,9,true,6,7,1,41.97564,-87.70143
KA1504000128,1,9,true,3,5,2,41.97567,-87.70927
463,1,9,true,4,2,-2,41.978,-87.66805
KA1504000146,1,9,true,19,39,20,41.978,-87.66805
294,1,9,true,3,4,1,41.97835,-87.65976
13109,1,9,true,13,21,8,41.97835,-87.65976
KA1504000147,1,9,true,7,3,-4,41.97976,-87.67754
655,1,9,true,3,10,7,41.97987,-87.68194
KA1504000167,1,9,true,1,2,1,41.98206,-87.70895
460,1,9,true,7,2,-5,41.98358,-87.66916
KA1504000151,1,9,true,17,16,-1,41.98359,-87.66916
468,1,9,true,1,1,0,41.98367,-87.69642
KA1504000152,1,9,true,48,35,-13,41.98403,-87.65231
459,1,9,true,12,9,-3,41.98403,-87.65231
15578,1,9,true,21,17,-4,41.98405,-87.66027
461,1,9,true,5,9,4,41.98405,-87.66027
15575,1,9,true,22,15,-7,41.98975,-87.66014
458,1,9,true,3,3,0,41.98975,-87.66013
455,1,9,true,1,1,0,41.99024,-87.69338
457,1,9,true,6,2,-4,41.99052,-87.66982
KA1504000148,1,9,true,9,4,-5,41.99086,-87.66971
KA1504000155,1,9,true,4,2,-2,41.99118,-87.68359
452,1,9,true,2,1,-1,41.99417,-87.68945
15571,1,9,true,35,16,-19,41.99478,-87.66028
454,1,9,true,8,1,-7,41.99478,-87.66027
KA1504000156,1,9,true,6,14,8,41.99925,-87.67137
RP-009,1,9,true,11,6,-5,42.00107,-87.66122
451,1,9,true,2,3,1,42.00108,-87.66123
RP-001,1,9,true,4,2,-2,42.00179,-87.68883
449,1,9,true,2,1,-1,42.00446,-87.67241
RP-008,1,9,true,5,4,-1,42.00446,-87.6724
660,1,9,true,15,6,-9,42.00458,-87.66143
KA1504000175,1,9,true,14,8,-6,42.00797,-87.66549
447,1,9,true,4,1,-3,42.00797,-87.66548
RP-005,1,9,true,5,3,-2,42.0086,-87.69047
432,1,9,true,1,2,1,42.00907,-87.67423
KA1504000162,1,9,true,5,4,-1,42.00907,-87.67422
KA1504000159,1,9,true,16,2,-14,42.01059,-87.66241
RP-007,1,9,true,2,3,1,42.01256,-87.67431
525,1,9,true,1,2,1,42.01272,-87.66605
517,1,9,true,4,1,-3,42.01597,-87.675
520,1,9,true,7,10,3,42.01597,-87.66859
527,1,9,true,3,3,0,42.01892,-87.69004
515,1,9,true,5,9,4,42.01915,-87.67356
514,1,9,true,1,1,0,42.01927,-87.68452
16806,1,9,true,8,3,-5,42.01953,-87.66955
523,1,9,true,12,1,-11,42.02089,-87.66505
662,1,9,true,1,1,0,42.02354,-87.69961
E002,1,9,true,22,8,-14,42.03256,-87.67912
599,1,9,true,2,6,4,42.03972,-87.69942
596,1,9,true,21,21,0,42.04822,-87.68348
603,1,9,true,1,2,1,42.05049,-87.67782
E008,1,9,true,2,6,4,42.05049,-87.67782
661,1,9,true,4,1,-3,42.05704,-87.68657
604,1,9,true,7,41,34,42.05824,-87.67744
E006,1,9,true,1,1,0,42.06367,-87.69871
E014,1,9,true,5,1,-4,42.06483,-87.71531
20215,1,17,false,1,2,1,41.64856,-87.54618
20214,1,17,false,1,2,1,41.65191,-87.53961
20212,1,17,false,1,2,1,41.65693,-87.59883
20218,1,17,false,1,1,0,41.68103,-87.53798
20243,1,17,false,1,1,0,41.68701,-87.62111
20203,1,17,false,2,3,1,41.69131,-87.71286
20131,1,17,false,1,3,2,41.69169,-87.61
20108,1,17,false,3,1,-2,41.69921,-87.66888
699,1,17,false,1,1,0,41.70022,-87.61233
20222,1,17,false,1,2,1,41.7046,-87.52832
20123,1,17,false,1,1,0,41.70461,-87.68115
20130,1,17,false,3,2,-1,41.70534,-87.62903
696,1,17,false,1,1,0,41.70717,-87.61841
20107,1,17,false,5,5,0,41.7122,-87.66772
20223,1,17,false,1,3,2,41.71272,-87.53472
20224,1,17,false,1,1,0,41.71371,-87.53083
20238,1,17,false,1,2,1,41.7187,-87.597
703,1,17,false,4,1,-3,41.71871,-87.59699
20105,1,17,false,1,1,0,41.71972,-87.6429
20104,1,17,false,3,1,-2,41.72171,-87.62283
20119,1,17,false,2,3,1,41.72682,-87.6543
20103,1,17,false,1,8,7,41.7281,-87.66757
20242,1,17,false,2,1,-1,41.7282,-87.54962
201022,1,17,false,4,3,-1,41.73246,-87.65808
20116,1,17,false,1,3,2,41.73652,-87.60126
20231,1,17,false,1,1,0,41.7368,-87.58282
20101,1,17,false,1,3,2,41.73785,-87.64489
20121,1,17,false,5,3,-2,41.74152,-87.65842
584,1,17,false,2,1,-1,41.74412,-87.59905
TA1309000051,1,17,false,1,1,0,41.74462,-87.55121
581,1,17,false,1,1,0,41.74462,-87.5512
583,1,17,false,7,2,-5,41.74656,-87.58599
574,1,17,false,2,7,5,41.75095,-87.61379
577,1,17,false,1,4,3,41.75117,-87.58534
575,1,17,false,3,1,-2,41.75318,-87.60502
571,1,17,false,1,3,2,41.75836,-87.61415
KA1503000019,1,17,false,1,1,0,41.75867,-87.5869
KA1503000024,1,17,false,5,1,-4,41.75876,-87.56644
399,1,17,false,1,1,0,41.76225,-87.5592
15599,1,17,false,3,1,-2,41.76551,-87.61693
KA1503000003,1,17,false,2,2,0,41.76572,-87.60498
652,1,17,false,1,1,0,41.766,-87.61173
KA1503000002,1,17,false,11,6,-5,41.76641,-87.5657
12,1,17,false,1,3,2,41.76641,-87.5657
KA1503000045,1,17,false,3,1,-2,41.76649,-87.58647
650,1,17,false,2,1,-1,41.7689,-87.63586
15597,1,17,false,1,1,0,41.76906,-87.64461
KA1503000047,1,17,false,1,2,1,41.76929,-87.62821
KA1503000023,1,17,false,2,3,1,41.77346,-87.58534
KA1503000030,1,17,false,4,7,3,41.77352,-87.57722
KA1503000029,1,17,false,6,9,3,41.77364,-87.56747
KA1503000031,1,17,false,1,2,1,41.77373,-87.60564
564,1,17,false,1,1,0,41.7754,-87.6543
KA1503000021,1,17,false,10,4,-6,41.77888,-87.58665
16948,1,17,false,3,1,-2,41.77937,-87.6649
KA1503000055,1,17,false,1,1,0,41.77939,-87.64463
649,1,17,false,1,1,0,41.77984,-87.63477
KA1503000053,1,17,false,2,1,-1,41.78009,-87.61595
KA1503000046,1,17,false,4,8,4,41.78041,-87.59141
428,1,17,false,1,1,0,41.78041,-87.59139
653,1,17,false,10,4,-6,41.78059,-87.58491
KA1503000054,1,17,false,5,4,-1,41.78061,-87.60582
15491,1,17,false,24,20,-4,41.78096,-87.57624
101,1,17,false,2,4,2,41.78105,-87.57611
KA1503000033,1,17,false,1,3,2,41.78411,-87.61329
426,1,17,false,10,7,-3,41.7851,-87.60108
KA1503000014,1,17,false,34,32,-2,41.7851,-87.60108
KA1503000070,1,17,false,13,7,-6,41.78794,-87.58831
425,1,17,false,2,4,2,41.78795,-87.58831
TA1309000011,1,17,false,30,10,-20,41.78873,-87.60131
KA1503000071,1,17,false,37,17,-20,41.79148,-87.59988
423,1,17,false,7,3,-4,41.79148,-87.59988
KA1503000075,1,17,false,8,4,-4,41.79156,-87.60785
KA1503000074,1,17,false,21,15,-6,41.79174,-87.58395
TA1309000063,1,17,false,23,35,12,41.79325,-87.5878
345,1,17,false,2,8,6,41.79326,-87.5878
KA1503000073,1,17,false,1,2,1,41.79345,-87.61585
557,1,17,false,1,1,0,41.7941,-87.67549
559,1,17,false,3,4,1,41.79423,-87.65509
420,1,17,false,3,4,1,41.79429,-87.60145
KA1504000076,1,17,false,27,25,-2,41.7943,-87.60145
TA1307000160,1,17,false,5,9,4,41.79485,-87.61873
247,1,17,false,3,12,9,41.79522,-87.58077
TA1308000009,1,17,false,67,84,17,41.79522,-87.58075
TA1307000164,1,17,false,37,21,-16,41.79527,-87.59647
248,1,17,false,2,4,2,41.79528,-87.59647
646,1,17,false,2,5,3,41.79663,-87.62592
KA1503000052,1,17,false,21,15,-6,41.79935,-87.60097
418,1,17,false,2,2,0,41.79936,-87.60097
419,1,17,false,1,4,3,41.79952,-87.58643
KA1503000059,1,17,false,17,31,14,41.79952,-87.58643
TA1309000037,1,17,false,38,41,3,41.79957,-87.59474
15470,1,17,false,4,6,2,41.80228,-87.61807
417,1,17,false,2,5,3,41.80242,-87.5869
KA1503000007,1,17,false,42,36,-6,41.80242,-87.58689
13398,1,17,false,22,15,-7,41.80256,-87.59035
121,1,17,false,2,2,0,41.80256,-87.59035
TA1309000067,1,17,false,6,12,6,41.80303,-87.60661
322,1,17,false,4,4,0,41.80321,-87.59849
594,1,17,false,3,1,-2,41.80567,-87.68337
KA1503000069,1,17,false,2,9,7,41.80579,-87.59247
KA1503000051,1,17,false,3,2,-1,41.80815,-87.64563
KA1503000009,1,17,false,1,1,0,41.80932,-87.63346
TA1308000035,1,17,false,10,4,-6,41.80944,-87.59188
267,1,17,false,1,1,0,41.80944,-87.59188
252,1,17,false,1,3,2,41.80982,-87.59936
TA1308000002,1,17,false,8,12,4,41.80983,-87.59937
TA1308000007,1,17,false,12,2,-10,41.80984,-87.61628
TA1309000053,1,17,false,8,5,-3,41.80985,-87.60675
549,1,17,false,1,1,0,41.81401,-87.66662
413,1,17,false,1,3,2,41.81408,-87.59701
KA1503000065,1,17,false,10,5,-5,41.81409,-87.59701
271,1,17,false,2,1,-1,41.81648,-87.60659
TA1308000023,1,17,false,3,7,4,41.81649,-87.60659
KA1503000027,1,17,false,11,3,-8,41.81666,-87.61942
KA1503000032,1,17,false,4,8,4,41.81912,-87.64328
13083,1,17,false,3,6,3,41.82167,-87.62153
265,1,17,false,1,2,1,41.82297,-87.6071
TA1308000038,1,17,false,18,12,-6,41.82298,-87.6071
407,1,17,false,1,1,0,41.82303,-87.62658
546,1,17,false,1,2,1,41.82319,-87.67661
16932,1,17,false,2,2,0,41.82346,-87.66558
13420,1,17,false,7,4,-3,41.82459,-87.61678
18022,1,17,false,6,2,-4,41.82672,-87.68315
TA1307000161,1,17,false,1,3,2,41.82707,-87.64572
KA1503000068,1,17,false,3,2,-1,41.82878,-87.68062
KA1503000066,1,17,false,2,5,3,41.83011,-87.67031
TA1308000045,1,17,false,3,5,2,41.83062,-87.64129
TA1308000043,1,17,false,6,8,2,41.83066,-87.64715
15446,1,17,false,4,2,-2,41.83068,-87.65603
KA1503000005,1,17,false,3,2,-1,41.83079,-87.6325
184,1,17,false,3,1,-2,41.83104,-87.62684
TA1307000129,1,17,false,5,11,6,41.83104,-87.62683
406,1,17,false,2,1,-1,41.83127,-87.6088
KA1503000004,1,17,false,18,18,0,41.83127,-87.6088
13345,1,17,false,5,6,1,41.83138,-87.61803
15445,1,17,false,1,9,8,41.83453,-87.63183
13216,1,17,false,23,13,-10,41.83473,-87.62581
149,1,17,false,2,1,-1,41.83486,-87.61791
13217,1,17,false,10,3,-7,41.83488,-87.61792
13215,1,17,false,28,14,-14,41.83634,-87.6135
TA1308000046,1,17,false,11,8,-3,41.83779,-87.65115
TA1309000055,1,17,false,13,11,-2,41.8382,-87.64514
KA1503000038,1,17,false,6,2,-4,41.83845,-87.6354
150,1,17,false,2,5,3,41.83855,-87.60821
TA1307000048,1,17,false,67,75,8,41.83855,-87.60821
TA1308000036,1,17,false,7,7,0,41.83883,-87.62186
15442,1,17,false,2,4,2,41.83918,-87.66562
366,1,17,false,2,3,1,41.84164,-87.65744
KA1503000040,1,17,false,4,9,5,41.84164,-87.65744
TA1307000139,1,17,false,13,16,3,41.84205,-87.61698
15443,1,17,false,1,16,15,41.84275,-87.63549
401,1,17,false,3,2,-1,41.84276,-87.63549
TA1307000153,1,17,false,3,1,-2,41.84358,-87.64538
TA1307000005,1,17,false,7,14,7,41.84569,-87.6225
TA1308000013,1,17,false,6,6,0,41.84719,-87.64681
15689,1,17,false,2,2,0,41.84912,-87.69515
TA1307000066,1,17,false,1,1,0,41.8492,-87.67564
TA1308000014,1,17,false,2,5,3,41.84953,-87.64059
TA1308000026,1,17,false,9,8,-1,41.85008,-87.63214
TA1305000004,1,17,false,31,27,-4,41.8514,-87.61884
TA1305000001,1,17,false,17,19,2,41.85262,-87.6265
13075,1,17,false,48,68,20,41.8531,-87.63192
120,1,17,false,1,1,0,41.8531,-87.63191
13162,1,17,false,10,14,4,41.85378,-87.64659
13096,1,17,false,1,4,3,41.8538,-87.69577
15685,1,17,false,3,1,-2,41.85399,-87.71511
13091,1,17,false,7,9,2,41.85409,-87.68585
15546,1,17,false,8,24,16,41.85416,-87.61916
208,1,17,false,5,2,-3,41.85489,-87.66359
13307,1,17,false,12,10,-2,41.85489,-87.66359
124,1,17,false,1,1,0,41.85492,-87.67609
13089,1,17,false,13,17,4,41.85497,-87.67567
13331,1,17,false,7,9,2,41.85515,-87.65414
171,1,17,false,4,1,-3,41.85516,-87.65414
4,1,17,false,4,3,-1,41.85627,-87.61334
15545,1,17,false,55,67,12,41.85627,-87.61334
SL-013,1,17,false,11,10,-1,41.85659,-87.62755
218,1,17,false,1,1,0,41.85679,-87.63387
SL-006,1,17,false,19,13,-6,41.8568,-87.63387
129,1,17,false,2,3,1,41.85752,-87.66158
13135,1,17,false,16,20,4,41.85753,-87.66157
338,1,17,false,2,6,4,41.85758,-87.61956
13102,1,17,false,35,43,8,41.85762,-87.61942
13150,1,17,false,45,45,0,41.85783,-87.62455
273,1,17,false,4,4,0,41.85783,-87.62455
13099,1,17,false,12,19,7,41.85784,-87.64627
TA1307000159,1,17,false,17,14,-3,41.8579,-87.6687
205,1,17,false,1,4,3,41.8579,-87.6687
170,1,17,false,1,1,0,41.85793,-87.64083
TA1307000044,1,17,false,11,15,4,41.85794,-87.64083
13163,1,17,false,22,14,-8,41.85808,-87.65108
13164,1,17,false,20,24,4,41.85818,-87.65648
15,1,17,false,2,2,0,41.85819,-87.65648
SL-012,1,17,false,27,37,10,41.86038,-87.62581
72,1,17,false,1,5,4,41.86039,-87.62581
274,1,17,false,1,2,1,41.86126,-87.6566
13304,1,17,false,17,20,3,41.86126,-87.65659
TA1306000002,1,17,false,6,18,12,41.86238,-87.65108
TA1307000124,1,17,false,78,53,-25,41.86411,-87.62372
168,1,17,false,3,7,4,41.86415,-87.62372
TA1309000001,1,17,false,31,28,-3,41.86488,-87.64708
13165,1,17,false,10,6,-4,41.86505,-87.65697
13354,1,17,false,8,7,-1,41.86524,-87.66651
13029,1,17,false,69,16,-53,41.86531,-87.6179
97,1,17,false,1,2,1,41.86531,-87.6179
341,1,17,false,9,7,-2,41.86608,-87.60733
13431,1,17,false,120,94,-26,41.8661,-87.60728
15682,1,17,false,1,1,0,41.86651,-87.70649
KA1504000101,1,17,false,5,4,-1,41.86651,-87.68466
KA1504000102,1,17,false,3,1,-2,41.86664,-87.69453
WL-008,1,17,false,32,43,11,41.86712,-87.64108
TA1305000002,1,17,false,107,106,-1,41.86721,-87.62597
59,1,17,false,9,15,6,41.86721,-87.62597
15544,1,17,false,162,123,-39,41.86723,-87.61536
3,1,17,false,8,1,-7,41.86723,-87.61536
TA1305000017,1,17,false,7,13,6,41.86734,-87.64863
55,1,17,false,1,1,0,41.86735,-87.64863
626,1,17,false,1,6,5,41.86749,-87.63219
KA1706005007,1,17,false,28,35,7,41.86749,-87.63219
SL-005,1,17,false,238,209,-29,41.8679,-87.62304
255,1,17,false,17,24,7,41.86791,-87.62304
644,1,17,false,7,11,4,41.86859,-87.68625
19,1,17,false,2,3,1,41.86892,-87.65913
13139,1,17,false,9,25,16,41.86893,-87.65913
13285,1,17,false,13,9,-4,41.86928,-87.67372
22,1,17,false,3,2,-1,41.86947,-87.65548
13160,1,17,false,24,24,0,41.86947,-87.65548
382,1,17,false,3,3,0,41.8699,-87.68725
414,1,17,false,3,3,0,41.87023,-87.63947
15550,1,17,false,32,27,-5,41.87024,-87.63947
TA1309000010,1,17,false,86,75,-11,41.87074,-87.62574
SL-009,1,17,false,36,19,-17,41.87081,-87.63121
TA1309000064,1,17,false,25,18,-7,41.87127,-87.67369
15542,1,17,false,3,7,4,41.87146,-87.64095
TA1307000130,1,17,false,16,16,0,41.87178,-87.65103
108,1,17,false,1,1,0,41.87183,-87.64664
TA1307000121,1,17,false,16,19,3,41.87184,-87.64664
41,1,17,false,16,12,-4,41.87209,-87.62957
SL-008,1,17,false,79,110,31,41.87209,-87.62956
13332,1,17,false,27,22,-5,41.87219,-87.6615
394,1,17,false,5,11,6,41.87226,-87.63484
175,1,17,false,6,12,6,41.87255,-87.63359
SL-011,1,17,false,87,68,-19,41.87256,-87.63356
623,1,17,false,122,106,-16,41.87272,-87.62399
KA1504000104,1,17,false,40,7,-33,41.87296,-87.66912
383,1,17,false,6,2,-4,41.87297,-87.66912
16915,1,17,false,2,1,-1,41.873,-87.7645
320,1,17,false,3,6,3,41.87327,-87.66402
5,1,17,false,3,2,-1,41.87403,-87.6277
SL-007,1,17,false,43,39,-4,41.87404,-87.6277
13326,1,17,false,14,13,-1,41.87425,-87.63958
321,1,17,false,9,8,-1,41.87427,-87.63257
535,1,17,false,5,2,-3,41.87433,-87.72582
TA1306000025,1,17,false,17,6,-11,41.87464,-87.65703
15668,1,17,false,12,8,-4,41.87471,-87.68642
13028,1,17,false,14,17,3,41.87475,-87.64981
13081,1,17,false,9,5,-4,41.87501,-87.67326
SL-010,1,17,false,41,24,-17,41.87501,-87.63309
16907,1,17,false,3,2,-1,41.87568,-87.71549
15541,1,17,false,137,94,-43,41.8758,-87.62086
13037,1,17,false,15,11,-4,41.87588,-87.64078
TA1305000009,1,17,false,25,22,-3,41.87593,-87.63068
45,1,17,false,3,1,-2,41.87623,-87.62444
TA1305000010,1,17,false,36,36,0,41.87623,-87.62444
624,1,17,false,35,24,-11,41.87626,-87.62923
2,1,17,false,5,4,-1,41.87649,-87.62051
33,1,17,false,3,4,1,41.87715,-87.62786
TA1305000035,1,17,false,44,31,-13,41.87716,-87.62787
13138,1,17,false,22,21,-1,41.87723,-87.63941
631,1,17,false,13,5,-8,41.87761,-87.6739
15539,1,17,false,36,35,-1,41.87763,-87.64405
13158,1,17,false,82,67,-15,41.87764,-87.64957
134,1,17,false,5,7,2,41.87764,-87.64954
21,1,17,false,4,2,-2,41.87773,-87.6548
13157,1,17,false,42,45,3,41.87773,-87.6548
TA1305000025,1,17,false,86,67,-19,41.87773,-87.63528
36,1,17,false,12,2,-10,41.87776,-87.63525
TA1309000002,1,17,false,117,72,-45,41.87784,-87.62408
284,1,17,false,5,3,-2,41.87784,-87.62408
13206,1,17,false,16,15,-1,41.87794,-87.66201
146,1,17,false,1,1,0,41.87794,-87.66201
283,1,17,false,14,5,-9,41.87809,-87.63183
TA1309000004,1,17,false,52,14,-38,41.87811,-87.63184
107,1,17,false,10,6,-4,41.87822,-87.644
638,1,17,false,59,31,-28,41.87827,-87.64078
37,1,17,false,8,6,-2,41.87921,-87.62975
TA1305000005,1,17,false,43,36,-7,41.87924,-87.62975
286,1,17,false,7,2,-5,41.8793,-87.6355
13011,1,17,false,86,71,-15,41.87931,-87.63993
TA1309000008,1,17,false,55,44,-11,41.87933,-87.6355
192,1,17,false,10,4,-6,41.87935,-87.63997
KA1503000034,1,17,false,23,6,-17,41.87938,-87.63197
39,1,17,false,7,5,-2,41.87948,-87.62571
KA1503000015,1,17,false,75,39,-36,41.87948,-87.6257
15667,1,17,false,8,9,1,41.8798,-87.68609
381,1,17,false,2,1,-1,41.87981,-87.68607
287,1,17,false,8,8,0,41.88017,-87.63527
TA1309000007,1,17,false,87,31,-56,41.88022,-87.63526
16918,1,17,false,1,2,1,41.88028,-87.77447
WL-011,1,17,false,41,38,-3,41.88034,-87.64273
73,1,17,false,3,1,-2,41.8804,-87.64273
80,1,17,false,1,2,1,41.88042,-87.65556
13156,1,17,false,45,48,3,41.88042,-87.65554
13300,1,17,false,376,320,-56,41.88097,-87.61675
76,1,17,false,18,16,-2,41.88098,-87.61675
13008,1,17,false,380,341,-39,41.88105,-87.62408
90,1,17,false,16,24,8,41.88107,-87.62409
49,1,17,false,8,7,-1,41.88116,-87.62963
TA1305000006,1,17,false,71,48,-23,41.88122,-87.6296
13134,1,17,false,19,13,-6,41.88138,-87.67493
13056,1,17,false,22,26,4,41.88168,-87.63951
198,1,17,false,13,13,0,41.88187,-87.6488
TA1307000120,1,17,false,125,101,-24,41.88188,-87.64879
13341,1,17,false,71,57,-14,41.88208,-87.63985
174,1,17,false,7,2,-5,41.88208,-87.63984
197,1,17,false,3,2,-1,41.88208,-87.62513
13036,1,17,false,80,48,-32,41.8821,-87.62513
77,1,17,false,9,8,-1,41.88214,-87.64108
TA1305000032,1,17,false,107,77,-30,41.88218,-87.64109
98,1,17,false,7,3,-4,41.88266,-87.63251
13006,1,17,false,34,28,-6,41.88268,-87.63252
13353,1,17,false,19,33,14,41.88283,-87.6612
346,1,17,false,2,5,3,41.88284,-87.6612
654,1,17,false,20,38,18,41.88307,-87.65698
233,1,17,false,7,5,-2,41.88309,-87.6511
13409,1,17,false,38,26,-12,41.8831,-87.6511
18,1,17,false,11,4,-7,41.88317,-87.63735
KA1503000072,1,17,false,47,36,-11,41.88317,-87.63693
91,1,17,false,5,2,-3,41.88336,-87.64122
WL-012,1,17,false,103,66,-37,41.88337,-87.6412
112,1,17,false,6,3,-3,41.88362,-87.6486
13053,1,17,false,83,119,36,41.88365,-87.64863
43,1,17,false,11,13,2,41.88396,-87.62455
13001,1,17,false,104,139,35,41.88397,-87.62459
88,1,17,false,2,2,0,41.88407,-87.65691
13155,1,17,false,18,16,-2,41.88407,-87.65689
18062,1,17,false,47,26,-21,41.88412,-87.65427
621,1,17,false,7,2,-5,41.88412,-87.65427
81,1,17,false,16,9,-7,41.88417,-87.6296
TA1306000010,1,17,false,116,57,-59,41.88419,-87.62961
15666,1,17,false,6,2,-4,41.88446,-87.6963
KA1504000106,1,17,false,2,2,0,41.88459,-87.70631
TA1305000030,1,17,false,101,35,-66,41.88459,-87.63178
96,1,17,false,2,2,0,41.8846,-87.64455
15535,1,17,false,31,41,10,41.8846,-87.64455
51,1,17,false,10,2,-8,41.88462,-87.63176
TA1305000029,1,17,false,112,110,-2,41.88466,-87.62787
195,1,17,false,6,6,0,41.88466,-87.61952
13263,1,17,false,113,94,-19,41.88467,-87.61952
44,1,17,false,14,12,-2,41.88468,-87.62782
528,1,17,false,2,1,-1,41.88537,-87.72661
TA1306000015,1,17,false,93,66,-27,41.88549,-87.65232
71,1,17,false,6,8,2,41.8855,-87.65233
66,1,17,false,7,4,-3,41.88557,-87.64186
13021,1,17,false,50,50,0,41.88559,-87.64184
TA1307000111,1,17,false,63,49,-14,41.88582,-87.63548
164,1,17,false,15,6,-9,41.88583,-87.63547
13073,1,17,false,18,17,-1,41.88592,-87.66717
119,1,17,false,1,1,0,41.88593,-87.66717
KA17018054,1,17,false,6,7,1,41.88595,-87.67701
38,1,17,false,9,3,-6,41.88599,-87.63089
KA1503000012,1,17,false,48,69,21,41.88599,-87.63089
52,1,17,false,15,6,-9,41.886,-87.62421
TA1305000011,1,17,false,171,139,-32,41.886,-87.62418
7,1,17,false,9,7,-2,41.88627,-87.61751
15534,1,17,false,64,65,1,41.88627,-87.61749
217,1,17,false,2,4,2,41.8866,-87.65821
13197,1,17,false,17,12,-5,41.8866,-87.65816
264,1,17,false,6,10,4,41.8867,-87.62224
TA1308000029,1,17,false,26,44,18,41.88673,-87.62225
16903,1,17,false,5,3,-2,41.88686,-87.74531
194,1,17,false,6,10,4,41.88688,-87.62606
TA1307000131,1,17,false,78,98,20,41.88688,-87.62606
KA1503000064,1,17,false,120,110,-10,41.88697,-87.61281
6,1,17,false,1,2,1,41.88697,-87.61281
16905,1,17,false,5,2,-3,41.88767,-87.76547
530,1,17,false,4,1,-3,41.88783,-87.75558
16906,1,17,false,4,3,-1,41.88792,-87.77445
100,1,17,false,11,3,-8,41.88814,-87.63657
TA1305000022,1,17,false,80,48,-32,41.88817,-87.63656
56,1,17,false,11,14,3,41.88866,-87.64442
TA1306000003,1,17,false,82,100,18,41.88867,-87.64442
KA1503000043,1,17,false,135,92,-43,41.88918,-87.63851
133,1,17,false,13,11,-2,41.88918,-87.63851
13050,1,17,false,62,63,1,41.88919,-87.62775
47,1,17,false,5,5,0,41.88921,-87.62775
15664,1,17,false,5,3,-2,41.8895,-87.68821
13432,1,17,false,16,13,-3,41.88989,-87.67149
285,1,17,false,1,2,1,41.88989,-87.67149
TA1307000151,1,17,false,101,86,-15,41.88993,-87.63427
212,1,17,false,6,11,5,41.88995,-87.63427
636,1,17,false,43,29,-14,41.88997,-87.63662
393,1,17,false,3,4,1,41.88998,-87.75395
125,1,17,false,12,7,-5,41.89018,-87.62621
KA1503000044,1,17,false,34,59,25,41.89018,-87.6262
196,1,17,false,13,6,-7,41.89053,-87.62205
13427,1,17,false,64,63,-1,41.89054,-87.62205
26,1,17,false,9,6,-3,41.89057,-87.61798
13430,1,17,false,91,103,12,41.89077,-87.63169
181,1,17,false,8,8,0,41.89077,-87.63168
TA1306000013,1,17,false,155,152,-3,41.89083,-87.61852
RN-,1,17,false,70,64,-6,41.89102,-87.63546
672,1,17,false,8,3,-5,41.89102,-87.63545
277,1,17,false,7,1,-6,41.89108,-87.66665
13434,1,17,false,30,25,-5,41.89108,-87.66663
TA1308000006,1,17,false,19,21,2,41.89128,-87.67686
199,1,17,false,8,9,1,41.89143,-87.62676
TA1307000117,1,17,false,155,166,11,41.89144,-87.62675
13033,1,17,false,96,58,-38,41.8916,-87.64835
214,1,17,false,2,4,2,41.89161,-87.67688
84,1,17,false,4,8,4,41.89161,-87.64833
13194,1,17,false,32,43,11,41.8918,-87.65878
TA1305000003,1,17,false,122,125,3,41.89187,-87.62061
24,1,17,false,5,9,4,41.8919,-87.62063
643,1,17,false,10,16,6,41.89203,-87.68939
35,1,17,false,17,16,-1,41.89227,-87.61206
13022,1,17,false,672,674,2,41.89227,-87.61205
99,1,17,false,4,14,10,41.89255,-87.61449
TA1306000029,1,17,false,142,130,-12,41.89256,-87.61449
13265,1,17,false,81,82,1,41.89383,-87.64172
74,1,17,false,9,10,1,41.89384,-87.64173
13045,1,17,false,137,134,-3,41.89403,-87.62931
110,1,17,false,17,10,-7,41.89406,-87.6293
13016,1,17,false,72,67,-5,41.89431,-87.62277
211,1,17,false,13,9,-4,41.89439,-87.62267
KA1503000041,1,17,false,62,63,1,41.89452,-87.61798
142,1,17,false,8,11,3,41.89453,-87.61806
92,1,17,false,2,5,3,41.89455,-87.65346
13196,1,17,false,44,45,1,41.89455,-87.65345
TA1307000062,1,17,false,47,39,-8,41.89466,-87.63839
111,1,17,false,5,3,-2,41.89466,-87.63837
TA1306000012,1,17,false,130,108,-22,41.89475,-87.63438
53,1,17,false,13,13,0,41.89476,-87.63439
627,1,17,false,3,7,4,41.8948,-87.63231
KP1705001026,1,17,false,59,51,-8,41.89483,-87.6323
16920,1,17,false,1,2,1,41.89495,-87.76491
KA1504000114,1,17,false,2,9,7,41.89547,-87.70614
659,1,17,false,2,3,1,41.8955,-87.68201
18058,1,17,false,12,25,13,41.8955,-87.68201
637,1,17,false,16,31,15,41.89563,-87.67209
128,1,17,false,2,6,4,41.89571,-87.67716
13132,1,17,false,47,42,-5,41.89573,-87.67718
161,1,17,false,8,6,-2,41.89574,-87.62599
15530,1,17,false,89,88,-1,41.89575,-87.62596
18003,1,17,false,24,40,16,41.89575,-87.62011
635,1,17,false,4,1,-3,41.89576,-87.62012
13247,1,17,false,29,46,17,41.89597,-87.66775
350,1,17,false,6,6,0,41.89597,-87.66774
TA1305000020,1,17,false,49,42,-7,41.89636,-87.65406
54,1,17,false,2,4,2,41.89637,-87.65407
13289,1,17,false,47,48,1,41.89638,-87.661
86,1,17,false,3,6,3,41.89639,-87.661
337,1,17,false,5,3,-2,41.89659,-87.63096
13303,1,17,false,80,53,-27,41.89672,-87.63088
13017,1,17,false,56,43,-13,41.89676,-87.6357
31,1,17,false,4,9,5,41.89677,-87.63572
13338,1,17,false,31,57,26,41.89697,-87.62173
173,1,17,false,5,8,3,41.89704,-87.62173
TA1307000061,1,17,false,40,45,5,41.89745,-87.62873
106,1,17,false,7,4,-3,41.89746,-87.62874
25,1,17,false,10,19,9,41.89751,-87.62354
13034,1,17,false,80,92,12,41.89754,-87.62352
48,1,17,false,4,5,1,41.89772,-87.64302
TA1306000009,1,17,false,81,34,-47,41.89772,-87.64299
620,1,17,false,54,46,-8,41.89817,-87.63754
374,1,17,false,4,3,-1,41.89842,-87.68659
KA1504000103,1,17,false,28,46,18,41.89842,-87.68659
145,1,17,false,7,4,-3,41.89856,-87.62211
15529,1,17,false,72,99,27,41.89858,-87.62206
140,1,17,false,4,14,10,41.89895,-87.6299
TA1307000128,1,17,false,141,124,-17,41.89896,-87.6299
657,1,17,false,24,19,-5,41.89918,-87.6722
KA1504000117,1,17,false,22,13,-9,41.89936,-87.64848
30,1,17,false,1,2,1,41.89964,-87.66789
13248,1,17,false,32,29,-3,41.89964,-87.66788
46,1,17,false,5,1,-4,41.89994,-87.63444
TA1306000011,1,17,false,42,51,9,41.89994,-87.63443
KA1504000116,1,17,false,20,13,-7,41.90023,-87.64299
364,1,17,false,1,3,2,41.90023,-87.64299
17660,1,17,false,25,21,-4,41.90036,-87.69671
622,1,17,false,1,4,3,41.90037,-87.69671
13290,1,17,false,41,25,-16,41.90069,-87.66259
29,1,17,false,2,7,5,41.90069,-87.66259
13042,1,17,false,332,312,-20,41.90097,-87.62377
85,1,17,false,15,23,8,41.90098,-87.62375
183,1,17,false,2,2,0,41.90133,-87.67744
TA1307000070,1,17,false,21,22,1,41.90133,-87.67742
KA1504000133,1,17,false,109,100,-9,41.90234,-87.62773
172,1,17,false,9,5,-4,41.90236,-87.62774
15654,1,17,false,5,14,9,41.90271,-87.70923
305,1,17,false,2,3,1,41.9028,-87.69005
13241,1,17,false,17,26,9,41.9029,-87.68731
176,1,17,false,14,20,6,41.90291,-87.63141
TA1306000006,1,17,false,10,25,15,41.90292,-87.63772
TA1307000039,1,17,false,164,136,-28,41.90294,-87.63137
658,1,17,false,24,5,-19,41.903,-87.6838
216,1,17,false,2,1,-1,41.90302,-87.69749
13256,1,17,false,30,35,5,41.90302,-87.69749
17,1,17,false,4,5,1,41.90313,-87.67391
TA1305000034,1,17,false,48,55,7,41.90313,-87.67391
182,1,17,false,11,9,-2,41.90317,-87.63442
KA1504000135,1,17,false,151,156,5,41.90319,-87.63439
13136,1,17,false,26,32,6,41.90326,-87.67845
130,1,17,false,7,2,-5,41.90327,-87.67846
210,1,17,false,4,7,3,41.90342,-87.66781
13061,1,17,false,115,119,4,41.90342,-87.66779
KA1504000079,1,17,false,53,63,10,41.9035,-87.64334
359,1,17,false,3,6,3,41.90458,-87.6497
138,1,17,false,1,4,3,41.9046,-87.64057
TA1307000115,1,17,false,17,24,7,41.9046,-87.64056
291,1,17,false,8,7,-1,41.90672,-87.63494
TA1308000049,1,17,false,96,126,30,41.90672,-87.6349
KA1504000134,1,17,false,81,68,-13,41.90687,-87.6262
180,1,17,false,6,5,-1,41.90687,-87.62618
13224,1,17,false,48,31,-17,41.90706,-87.66725
333,1,17,false,10,6,-4,41.90706,-87.66725
18069,1,17,false,7,3,-4,41.90722,-87.65563
TA1307000143,1,17,false,29,28,-1,41.90762,-87.63854
61,1,17,false,4,6,2,41.90764,-87.67254
13221,1,17,false,76,66,-10,41.90765,-87.67254
13245,1,17,false,16,13,-3,41.90777,-87.68586
159,1,17,false,1,1,0,41.90777,-87.68586
301,1,17,false,7,3,-4,41.90796,-87.63203
TA1309000024,1,17,false,107,96,-11,41.908,-87.63152
69,1,17,false,5,9,4,41.90939,-87.6777
TA1305000041,1,17,false,76,96,20,41.9094,-87.67769
15652,1,17,false,8,4,-4,41.90965,-87.71664
331,1,17,false,83,108,25,41.90965,-87.64812
15653,1,17,false,26,15,-11,41.90979,-87.7053
509,1,17,false,1,2,1,41.9098,-87.70531
TA1305000037,1,17,false,43,43,0,41.91018,-87.67003
27,1,17,false,3,2,-1,41.91019,-87.6435
TA1306000008,1,17,false,26,31,5,41.9102,-87.6435
16,1,17,false,3,5,2,41.91035,-87.67008
213,1,17,false,1,1,0,41.91037,-87.68237
TA1308000005,1,17,false,20,16,-4,41.91042,-87.68238
276,1,17,false,5,4,-1,41.91043,-87.69718
13258,1,17,false,22,27,5,41.91043,-87.69718
160,1,17,false,1,1,0,41.91054,-87.68957
13257,1,17,false,21,24,3,41.91054,-87.68956
13154,1,17,false,62,72,10,41.91054,-87.65312
20,1,17,false,7,13,6,41.91055,-87.65313
13058,1,17,false,62,62,0,41.91059,-87.64942
60,1,17,false,5,6,1,41.91059,-87.64942
118,1,17,false,7,2,-5,41.91138,-87.63868
TA1307000038,1,17,false,56,62,6,41.91138,-87.63868
268,1,17,false,13,13,0,41.91172,-87.62681
LF-005,1,17,false,289,491,202,41.91172,-87.62681
126,1,17,false,2,4,2,41.91196,-87.63197
13128,1,17,false,61,79,18,41.91197,-87.63197
289,1,17,false,13,11,-2,41.91209,-87.63472
TA1308000050,1,17,false,180,157,-23,41.91211,-87.6347
158,1,17,false,5,6,1,41.91262,-87.6814
13243,1,17,false,41,45,4,41.91262,-87.6814
TA1309000032,1,17,false,13,16,3,41.91293,-87.66417
TA1306000032,1,17,false,50,43,-7,41.9137,-87.65285
93,1,17,false,6,7,1,41.91371,-87.65285
TA1307000166,1,17,false,33,38,5,41.91386,-87.64877
511,1,17,false,2,1,-1,41.914,-87.70515
15655,1,17,false,15,21,6,41.91401,-87.70514
18017,1,17,false,29,31,2,41.91416,-87.71676
641,1,17,false,2,4,2,41.91416,-87.71676
18067,1,17,false,35,16,-19,41.9146,-87.66796
628,1,17,false,1,2,1,41.9146,-87.66796
28,1,17,false,4,3,-1,41.91469,-87.64333
TA1306000007,1,17,false,18,22,4,41.91469,-87.64333
13068,1,17,false,42,31,-11,41.91554,-87.68703
116,1,17,false,2,3,1,41.91555,-87.68703
13179,1,17,false,143,156,13,41.9157,-87.63461
141,1,17,false,8,24,16,41.91571,-87.63461
219,1,17,false,2,3,1,41.91598,-87.67733
13133,1,17,false,49,74,25,41.91598,-87.67733
58,1,17,false,2,4,2,41.91602,-87.66894
TA1305000039,1,17,false,57,48,-9,41.9163,-87.66749
15650,1,17,false,12,13,1,41.91711,-87.71023
506,1,17,false,1,2,1,41.91711,-87.71023
507,1,17,false,3,2,-1,41.91752,-87.70181
15651,1,17,false,21,28,7,41.91752,-87.70181
185,1,17,false,2,1,-1,41.91774,-87.69143
13266,1,17,false,24,17,-7,41.91774,-87.69142
TA1309000029,1,17,false,16,20,4,41.9178,-87.68245
309,1,17,false,2,3,1,41.91789,-87.6865
TA1309000006,1,17,false,36,23,-13,41.91809,-87.64375
288,1,17,false,3,1,-2,41.91809,-87.64375
223,1,17,false,1,4,3,41.91821,-87.65698
TA1307000163,1,17,false,45,45,0,41.91821,-87.65696
94,1,17,false,13,8,-5,41.91831,-87.6363
13146,1,17,false,133,78,-55,41.91831,-87.63629
13059,1,17,false,76,80,4,41.91845,-87.65222
113,1,17,false,10,10,0,41.91846,-87.65222
13259,1,17,false,21,15,-6,41.91852,-87.69744
259,1,17,false,3,1,-2,41.91853,-87.69745
310,1,17,false,4,2,-2,41.91984,-87.68083
225,1,17,false,4,4,0,41.91995,-87.64884
13192,1,17,false,75,89,14,41.91995,-87.64884
357,1,17,false,1,3,2,41.92,-87.75
13288,1,17,false,21,21,0,41.92008,-87.67788
13242,1,17,false,15,16,1,41.92021,-87.69266
307,1,17,false,6,3,-3,41.92077,-87.66373
TA1309000030,1,17,false,37,45,8,41.92077,-87.66372
290,1,17,false,1,3,2,41.92152,-87.70734
13292,1,17,false,22,25,3,41.92152,-87.70733
TA1309000033,1,17,false,53,79,26,41.92158,-87.65381
13193,1,17,false,110,136,26,41.92182,-87.64412
144,1,17,false,6,12,6,41.92182,-87.64411
13191,1,17,false,77,69,-8,41.92217,-87.63891
143,1,17,false,4,10,6,41.92217,-87.63891
327,1,17,false,4,7,3,41.92225,-87.65783
13084,1,17,false,39,43,4,41.92268,-87.69715
123,1,17,false,3,4,1,41.92268,-87.69714
LP-,1,17,false,116,77,-39,41.92396,-87.63584
673,1,17,false,3,7,4,41.92398,-87.63585
KA1504000140,1,17,false,13,18,5,41.92409,-87.67646
16010,1,17,false,9,8,-1,41.92458,-87.72787
15648,1,17,false,15,11,-4,41.92464,-87.68931
504,1,17,false,2,4,2,41.92464,-87.68931
KA1504000090,1,17,false,14,5,-9,41.92483,-87.7145
TA1307000001,1,17,false,53,60,7,41.92535,-87.66581
188,1,17,false,6,5,-1,41.92536,-87.66581
TA1306000026,1,17,false,53,48,-5,41.92558,-87.65842
87,1,17,false,1,2,1,41.92559,-87.65843
67,1,17,false,4,1,-3,41.9256,-87.65371
TA1306000016,1,17,false,63,67,4,41.9256,-87.65371
313,1,17,false,6,5,-1,41.9257,-87.64246
TA1309000019,1,17,false,108,124,16,41.92586,-87.63897
TA1309000058,1,17,false,112,113,1,41.92591,-87.64927
127,1,17,false,10,12,2,41.92592,-87.64927
TA1308000001,1,17,false,182,189,7,41.92627,-87.63086
177,1,17,false,12,25,13,41.92627,-87.63086
15646,1,17,false,10,12,2,41.92668,-87.6977
13124,1,17,false,83,56,-27,41.92675,-87.63444
34,1,17,false,3,5,2,41.92675,-87.63444
302,1,17,false,5,5,0,41.92859,-87.65421
TA1309000023,1,17,false,62,58,-4,41.9287,-87.65383
TA1307000113,1,17,false,50,53,3,41.92878,-87.66391
13296,1,17,false,35,33,-2,41.92883,-87.66852
343,1,17,false,1,4,3,41.92889,-87.65898
TA1309000059,1,17,false,21,25,4,41.92889,-87.65898
349,1,17,false,8,7,-1,41.92915,-87.6491
TA1309000061,1,17,false,78,82,4,41.92915,-87.64909
TA1308000031,1,17,false,42,33,-9,41.92946,-87.68417
258,1,17,false,4,3,-1,41.92946,-87.68417
340,1,17,false,9,20,11,41.92956,-87.64313
TA1305000014,1,17,false,79,107,28,41.92956,-87.64313
260,1,17,false,6,5,-1,41.92958,-87.70791
13085,1,17,false,53,56,3,41.92958,-87.70789
499,1,17,false,1,7,6,41.93056,-87.72381
15643,1,17,false,19,10,-9,41.93057,-87.7238
TA1307000142,1,17,false,80,92,12,41.93125,-87.64432
220,1,17,false,6,14,8,41.93125,-87.64431
13276,1,17,false,106,78,-28,41.93132,-87.63874
324,1,17,false,15,9,-6,41.93173,-87.64179
501,1,17,false,1,1,0,41.93191,-87.70121
15645,1,17,false,10,16,6,41.93191,-87.70121
13271,1,17,false,16,10,-6,41.93192,-87.67784
152,1,17,false,6,7,1,41.93221,-87.65864
TA1307000064,1,17,false,65,57,-8,41.93222,-87.65864
TA1306000014,1,17,false,85,71,-14,41.93242,-87.65271
13,1,17,false,6,9,3,41.93242,-87.65271
329,1,17,false,10,5,-5,41.93258,-87.63642
TA1309000039,1,17,false,124,126,2,41.93258,-87.63642
13294,1,17,false,22,18,-4,41.9326,-87.66595
319,1,17,false,3,3,0,41.93292,-87.67217
332,1,17,false,3,5,2,41.93313,-87.64776
TA1309000036,1,17,false,40,67,27,41.93313,-87.64776
15644,1,17,false,12,9,-3,41.93534,-87.71687
TA1307000006,1,17,false,61,38,-23,41.93571,-87.6636
153,1,17,false,10,1,-9,41.93575,-87.66364
162,1,17,false,5,6,1,41.93588,-87.67844
13268,1,17,false,17,35,18,41.93588,-87.67843
13269,1,17,false,22,12,-10,41.93609,-87.66983
TA1307000052,1,17,false,73,67,-6,41.93628,-87.65266
115,1,17,false,2,9,7,41.93628,-87.65266
156,1,17,false,7,11,4,41.9365,-87.64756
TA1307000136,1,17,false,82,86,4,41.9365,-87.64755
TA1307000041,1,17,false,105,126,21,41.93669,-87.63683
157,1,17,false,12,11,-1,41.9367,-87.63683
13137,1,17,false,135,112,-23,41.9376,-87.6441
300,1,17,false,23,21,-2,41.93761,-87.6441
15642,1,17,false,11,22,11,41.93843,-87.69801
154,1,17,false,6,4,-2,41.93912,-87.66384
664,1,17,false,1,3,2,41.93934,-87.68327
KA17018068,1,17,false,17,10,-7,41.93935,-87.68327
TA1309000042,1,17,false,40,44,4,41.93937,-87.66836
131,1,17,false,8,7,-1,41.93937,-87.66835
KA150400009X,1,17,false,16,6,-10,41.9394,-87.71159
15640,1,17,false,12,9,-3,41.93941,-87.72357
13229,1,17,false,66,46,-20,41.93946,-87.66376
226,1,17,false,5,11,6,41.93972,-87.65886
TA1308000019,1,17,false,64,52,-12,41.93973,-87.65886
13277,1,17,false,67,55,-12,41.9401,-87.64546
296,1,17,false,12,7,-5,41.9401,-87.64546
TA1307000134,1,17,false,118,98,-20,41.94016,-87.65303
117,1,17,false,15,2,-13,41.94016,-87.65302
228,1,17,false,1,4,3,41.94058,-87.67854
13143,1,17,false,32,17,-15,41.94059,-87.67853
334,1,17,false,12,16,4,41.94076,-87.63919
TA1309000049,1,17,false,111,113,2,41.94077,-87.63919
308,1,17,false,1,2,1,41.94152,-87.68471
15634,1,17,false,9,17,8,41.94304,-87.68729
TA1307000138,1,17,false,55,34,-21,41.94334,-87.67094
230,1,17,false,9,5,-4,41.94335,-87.67093
13144,1,17,false,22,21,-1,41.9434,-87.67964
299,1,17,false,6,7,1,41.94368,-87.64894
TA1309000025,1,17,false,82,113,31,41.94368,-87.64894
229,1,17,false,11,6,-5,41.94372,-87.66401
13071,1,17,false,96,78,-18,41.94373,-87.66401
632,1,17,false,83,91,8,41.94453,-87.6547
303,1,17,false,12,5,-7,41.94522,-87.64702
15631,1,17,false,7,6,-1,41.94524,-87.70665
13278,1,17,false,82,98,16,41.94553,-87.64644
TA1309000050,1,17,false,10,14,4,41.94618,-87.67331
491,1,17,false,5,4,-1,41.94664,-87.69463
15632,1,17,false,5,5,0,41.94664,-87.69463
KA1504000143,1,17,false,10,6,-4,41.94664,-87.68337
KA1504000142,1,17,false,3,3,0,41.94735,-87.71759
16994,1,17,false,2,2,0,41.94784,-87.74
227,1,17,false,11,12,1,41.94813,-87.66397
13235,1,17,false,67,82,15,41.94814,-87.66396
304,1,17,false,5,8,3,41.94878,-87.64922
257,1,17,false,2,1,-1,41.9488,-87.67527
13253,1,17,false,11,16,5,41.9488,-87.67527
13325,1,17,false,68,53,-15,41.94907,-87.64863
114,1,17,false,11,12,1,41.94935,-87.65451
TA1307000126,1,17,false,78,172,94,41.94936,-87.65451
232,1,17,false,10,7,-3,41.94943,-87.64645
TA1307000150,1,17,false,80,79,-1,41.94945,-87.64646
18016,1,17,false,4,2,-2,41.94993,-87.71395
13319,1,17,false,26,32,6,41.95069,-87.6687
TA1307000127,1,17,false,82,97,15,41.9508,-87.65918
165,1,17,false,7,5,-2,41.95081,-87.65918
15628,1,17,false,8,9,1,41.95216,-87.69806
256,1,17,false,9,4,-5,41.95282,-87.65
13323,1,17,false,48,51,3,41.95282,-87.65
15624,1,17,false,7,6,-1,41.95339,-87.73199
314,1,17,false,2,1,-1,41.9535,-87.69199
KA1504000096,1,17,false,2,8,6,41.95361,-87.70932
590,1,17,false,1,6,5,41.95374,-87.74056
KA1504000139,1,17,false,4,10,6,41.954,-87.71909
TA1309000043,1,17,false,30,18,-12,41.95417,-87.66434
240,1,17,false,6,5,-1,41.95424,-87.65441
13063,1,17,false,49,53,4,41.95424,-87.65441
KA1504000158,1,17,false,7,6,-1,41.95432,-87.68607
254,1,17,false,4,6,2,41.95438,-87.64806
TA1308000022,1,17,false,83,87,4,41.95438,-87.64805
16991,1,17,false,3,8,5,41.95448,-87.7496
TA1307000149,1,17,false,9,8,-1,41.95467,-87.67392
298,1,17,false,2,1,-1,41.95601,-87.68021
TA1309000026,1,17,false,17,23,6,41.95601,-87.6802
13249,1,17,false,15,8,-7,41.95606,-87.66885
312,1,17,false,3,8,5,41.95637,-87.6563
TA1308000047,1,17,false,6,11,5,41.95709,-87.6642
13379,1,17,false,48,27,-21,41.95786,-87.6495
TA1309000018,1,17,false,12,14,2,41.95791,-87.67357
316,1,17,false,2,2,0,41.95841,-87.69401
306,1,17,false,2,2,0,41.9585,-87.655
TA1309000027,1,17,false,39,21,-18,41.9585,-87.65499
592,1,17,false,3,2,-1,41.96065,-87.74538
13389,1,17,false,63,60,-3,41.961,-87.64958
245,1,17,false,7,2,-5,41.96101,-87.64958
15621,1,17,false,5,10,5,41.96103,-87.70586
15622,1,17,false,17,12,-5,41.96108,-87.69544
KA1504000164,1,17,false,6,3,-3,41.96109,-87.72897
KA1504000097,1,17,false,2,5,3,41.96116,-87.71658
238,1,17,false,2,2,0,41.96141,-87.6762
TA1307000144,1,17,false,9,6,-3,41.96142,-87.6762
297,1,17,false,3,2,-1,41.9615,-87.67141
TA1309000021,1,17,false,6,9,3,41.9615,-87.6714
15623,1,17,false,3,4,1,41.96154,-87.69117
KA1503000022,1,17,false,24,36,12,41.96158,-87.66609
231,1,17,false,8,7,-1,41.96163,-87.65464
TA1307000107,1,17,false,56,55,-1,41.96164,-87.65464
TA1307000156,1,17,false,15,24,9,41.96301,-87.68479
243,1,17,false,1,4,3,41.96302,-87.68479
TA1309000012,1,17,false,20,12,-8,41.96325,-87.67928
249,1,17,false,3,1,-2,41.96398,-87.63818
TA1308000012,1,17,false,144,174,30,41.96398,-87.63818
293,1,17,false,3,2,-1,41.96521,-87.65822
13074,1,17,false,33,36,3,41.96521,-87.6582
639,1,17,false,60,40,-20,41.96584,-87.64538
KA1504000127,1,17,false,5,8,3,41.96587,-87.70083
KA1504000093,1,17,false,6,4,-2,41.96587,-87.69365
478,1,17,false,1,1,0,41.96587,-87.69364
TA1307000140,1,17,false,8,20,12,41.96643,-87.68865
KA1504000126,1,17,false,5,6,1,41.96668,-87.70807
TA1309000014,1,17,false,29,26,-3,41.96709,-87.66744
TA1307000158,1,17,false,16,13,-3,41.9671,-87.67904
242,1,17,false,5,5,0,41.9671,-87.67904
TA1307000119,1,17,false,34,24,-10,41.96796,-87.65
15615,1,17,false,1,11,10,41.96835,-87.71183
323,1,17,false,2,3,1,41.96869,-87.66034
TA1308000021,1,17,false,37,24,-13,41.96883,-87.65765
KA1504000080,1,17,false,17,10,-7,41.96887,-87.69609
TA1309000015,1,17,false,8,3,-5,41.96889,-87.68401
TA1309000066,1,17,false,54,43,-11,41.9691,-87.67423
344,1,17,false,4,1,-3,41.9691,-87.67423
TA1309000041,1,17,false,28,21,-7,41.96951,-87.65471
KA1504000171,1,17,false,53,40,-13,41.97161,-87.65016
465,1,17,false,4,8,4,41.97161,-87.65016
325,1,17,false,2,3,1,41.9728,-87.67186
TA1309000035,1,17,false,32,41,9,41.97335,-87.66785
295,1,17,false,4,4,0,41.97378,-87.65972
13108,1,17,false,41,33,-8,41.97379,-87.65971
KA1504000078,1,17,false,7,6,-1,41.97491,-87.69258
464,1,17,false,2,1,-1,41.97562,-87.67945
KA1504000149,1,17,false,10,12,2,41.97562,-87.67945
471,1,17,false,2,1,-1,41.97564,-87.70143
KA1504000160,1,17,false,12,17,5,41.97564,-87.70143
KA1504000128,1,17,false,4,4,0,41.97567,-87.70927
463,1,17,false,2,3,1,41.978,-87.66805
KA1504000146,1,17,false,33,34,1,41.978,-87.66805
13109,1,17,false,31,29,-2,41.97835,-87.65976
294,1,17,false,5,3,-2,41.97835,-87.65976
KA1504000147,1,17,false,4,4,0,41.97976,-87.67754
655,1,17,false,3,1,-2,41.97987,-87.68194
KA1504000161,1,17,false,11,3,-8,41.98038,-87.71612
KA1504000167,1,17,false,8,5,-3,41.98206,-87.70895
494,1,17,false,1,1,0,41.98234,-87.70892
KA1504000151,1,17,false,24,20,-4,41.98359,-87.66916
15585,1,17,false,4,6,2,41.98367,-87.69642
KA1504000152,1,17,false,100,88,-12,41.98403,-87.65231
459,1,17,false,6,6,0,41.98403,-87.65231
15578,1,17,false,23,22,-1,41.98405,-87.66027
15575,1,17,false,29,37,8,41.98975,-87.66014
458,1,17,false,3,3,0,41.98975,-87.66013
KA1504000130,1,17,false,1,1,0,41.99024,-87.69338
457,1,17,false,1,1,0,41.99052,-87.66982
KA1504000148,1,17,false,10,11,1,41.99086,-87.66971
KA1504000155,1,17,false,4,2,-2,41.99118,-87.68359
KA1504000129,1,17,false,1,4,3,41.99417,-87.68945
15571,1,17,false,26,33,7,41.99478,-87.66028
454,1,17,false,5,4,-1,41.99478,-87.66027
453,1,17,false,1,1,0,41.99925,-87.67137
KA1504000156,1,17,false,6,15,9,41.99925,-87.67137
RP-009,1,17,false,41,38,-3,42.00107,-87.66122
451,1,17,false,2,4,2,42.00108,-87.66123
RP-001,1,17,false,16,11,-5,42.00179,-87.68883
449,1,17,false,1,1,0,42.00446,-87.67241
RP-008,1,17,false,4,4,0,42.00446,-87.6724
RP-002,1,17,false,5,9,4,42.00456,-87.68065
660,1,17,false,24,21,-3,42.00458,-87.66143
354,1,17,false,2,2,0,42.00587,-87.66802
KA1504000175,1,17,false,14,15,1,42.00797,-87.66549
447,1,17,false,1,4,3,42.00797,-87.66548
RP-005,1,17,false,4,3,-1,42.0086,-87.69047
432,1,17,false,3,3,0,42.00907,-87.67423
KA1504000162,1,17,false,10,5,-5,42.00907,-87.67422
KA1504000159,1,17,false,12,11,-1,42.01059,-87.66241
RP-006,1,17,false,4,3,-1,42.01213,-87.68292
RP-004,1,17,false,7,1,-6,42.01234,-87.68825
526,1,17,false,6,2,-4,42.01235,-87.68825
RP-007,1,17,false,7,1,-6,42.01256,-87.67431
525,1,17,false,9,13,4,42.01272,-87.66605
520,1,17,false,12,16,4,42.01597,-87.66859
519,1,17,false,3,5,2,42.01696,-87.67773
527,1,17,false,7,3,-4,42.01892,-87.69004
515,1,17,false,11,8,-3,42.01915,-87.67356
514,1,17,false,4,3,-1,42.01927,-87.68452
16806,1,17,false,5,5,0,42.01953,-87.66955
523,1,17,false,12,8,-4,42.02089,-87.66505
662,1,17,false,8,6,-2,42.02354,-87.69961
598,1,17,false,9,4,-5,42.02578,-87.68411
597,1,17,false,3,2,-1,42.03256,-87.67914
E002,1,17,false,10,16,6,42.03256,-87.67912
E011,1,17,false,2,1,-1,42.03473,-87.69912
599,1,17,false,3,6,3,42.03972,-87.69942
596,1,17,false,17,31,14,42.04822,-87.68348
600,1,17,false,6,4,-2,42.04831,-87.6983
E008,1,17,false,14,20,6,42.05049,-87.67782
605,1,17,false,12,12,0,42.05294,-87.67342
661,1,17,false,6,6,0,42.05704,-87.68657
604,1,17,false,40,28,-12,42.05824,-87.67744
E006,1,17,false,5,4,-1,42.06367,-87.69871
E007,1,17,false,3,1,-2,42.06431,-87.68615
20222,1,17,true,1,1,0,41.7046,-87.52832
20106,1,17,true,1,1,0,41.71897,-87.60833
20118,1,17,true,3,1,-2,41.72762,-87.63487
20121,1,17,true,1,1,0,41.74152,-87.65842
580,1,17,true,1,1,0,41.75172,-87.55282
579,1,17,true,1,1,0,41.75182,-87.56522
KA1503000024,1,17,true,2,1,-1,41.75876,-87.56644
KA1503000020,1,17,true,1,2,1,41.76223,-87.55923
399,1,17,true,2,1,-1,41.76225,-87.5592
KA1503000002,1,17,true,11,6,-5,41.76641,-87.5657
12,1,17,true,1,1,0,41.76641,-87.5657
650,1,17,true,1,3,2,41.7689,-87.63586
KA1503000029,1,17,true,2,5,3,41.77364,-87.56747
KA1503000046,1,17,true,2,1,-1,41.78041,-87.59141
653,1,17,true,1,5,4,41.78059,-87.58491
15491,1,17,true,4,6,2,41.78096,-87.57624
KA1503000033,1,17,true,3,5,2,41.78411,-87.61329
426,1,17,true,12,28,16,41.7851,-87.60108
KA1503000014,1,17,true,58,117,59,41.7851,-87.60108
KA1503000070,1,17,true,10,15,5,41.78794,-87.58831
328,1,17,true,13,2,-11,41.78872,-87.6013
TA1309000011,1,17,true,91,18,-73,41.78873,-87.60131
KA1503000071,1,17,true,157,54,-103,41.79148,-87.59988
423,1,17,true,24,6,-18,41.79148,-87.59988
KA1503000075,1,17,true,7,2,-5,41.79156,-87.60785
424,1,17,true,4,4,0,41.79174,-87.58395
KA1503000074,1,17,true,11,26,15,41.79174,-87.58395
TA1309000063,1,17,true,35,78,43,41.79325,-87.5878
345,1,17,true,8,13,5,41.79326,-87.5878
KA1503000073,1,17,true,1,3,2,41.79345,-87.61585
420,1,17,true,24,10,-14,41.79429,-87.60145
KA1504000076,1,17,true,103,57,-46,41.7943,-87.60145
TA1307000160,1,17,true,1,3,2,41.79485,-87.61873
KA1503000013,1,17,true,2,2,0,41.79498,-87.63312
247,1,17,true,6,9,3,41.79522,-87.58077
TA1308000009,1,17,true,57,88,31,41.79522,-87.58075
TA1307000164,1,17,true,37,46,9,41.79527,-87.59647
248,1,17,true,7,10,3,41.79528,-87.59647
KA1503000052,1,17,true,47,46,-1,41.79935,-87.60097
418,1,17,true,7,9,2,41.79936,-87.60097
419,1,17,true,1,4,3,41.79952,-87.58643
KA1503000059,1,17,true,34,38,4,41.79952,-87.58643
TA1309000037,1,17,true,69,109,40,41.79957,-87.59474
KA1503000010,1,17,true,1,3,2,41.8018,-87.64522
15470,1,17,true,3,3,0,41.80228,-87.61807
417,1,17,true,5,10,5,41.80242,-87.5869
KA1503000007,1,17,true,26,69,43,41.80242,-87.58689
13398,1,17,true,28,23,-5,41.80256,-87.59035
121,1,17,true,9,10,1,41.80256,-87.59035
TA1309000067,1,17,true,4,8,4,41.80303,-87.60661
322,1,17,true,12,18,6,41.80321,-87.59849
594,1,17,true,1,1,0,41.80567,-87.68337
KA1503000069,1,17,true,4,12,8,41.80579,-87.59247
KA1503000051,1,17,true,7,2,-5,41.80815,-87.64563
KA1504000091,1,17,true,1,2,1,41.80823,-87.6772
KA1503000009,1,17,true,3,3,0,41.80932,-87.63346
267,1,17,true,4,4,0,41.80944,-87.59188
TA1308000035,1,17,true,15,17,2,41.80944,-87.59188
252,1,17,true,1,5,4,41.80982,-87.59936
TA1308000002,1,17,true,6,10,4,41.80983,-87.59937
TA1309000053,1,17,true,6,5,-1,41.80985,-87.60675
336,1,17,true,1,1,0,41.80985,-87.60675
352,1,17,true,1,1,0,41.8137,-87.63448
KA1503000065,1,17,true,7,12,5,41.81409,-87.59701
TA1308000023,1,17,true,6,2,-4,41.81649,-87.60659
410,1,17,true,2,1,-1,41.81666,-87.61942
KA1503000027,1,17,true,4,6,2,41.81666,-87.61942
KA1503000032,1,17,true,6,2,-4,41.81912,-87.64328
13083,1,17,true,5,4,-1,41.82167,-87.62153
TA1308000038,1,17,true,7,10,3,41.82298,-87.6071
546,1,17,true,6,3,-3,41.82319,-87.67661
13420,1,17,true,2,14,12,41.82459,-87.61678
18022,1,17,true,1,3,2,41.82672,-87.68315
262,1,17,true,1,4,3,41.82707,-87.64573
TA1307000161,1,17,true,6,4,-2,41.82707,-87.64572
KA1503000068,1,17,true,5,9,4,41.82878,-87.68062
9,1,17,true,1,6,5,41.82878,-87.68061
KA1503000066,1,17,true,6,9,3,41.83011,-87.67031
369,1,17,true,1,1,0,41.83012,-87.67031
278,1,17,true,4,6,2,41.83062,-87.64129
TA1308000045,1,17,true,14,23,9,41.83062,-87.64129
TA1308000043,1,17,true,7,8,1,41.83066,-87.64715
279,1,17,true,1,1,0,41.83067,-87.64715
15446,1,17,true,6,13,7,41.83068,-87.65603
KA1503000005,1,17,true,10,8,-2,41.83079,-87.6325
184,1,17,true,9,1,-8,41.83104,-87.62684
TA1307000129,1,17,true,58,10,-48,41.83104,-87.62683
406,1,17,true,2,2,0,41.83127,-87.6088
KA1503000004,1,17,true,13,15,2,41.83127,-87.6088
13345,1,17,true,10,7,-3,41.83138,-87.61803
335,1,17,true,1,4,3,41.83139,-87.61803
15445,1,17,true,24,7,-17,41.83453,-87.63183
13216,1,17,true,99,43,-56,41.83473,-87.62581
148,1,17,true,12,6,-6,41.83474,-87.62581
149,1,17,true,3,6,3,41.83486,-87.61791
13217,1,17,true,33,63,30,41.83488,-87.61792
13215,1,17,true,18,27,9,41.83634,-87.6135
263,1,17,true,1,5,4,41.8364,-87.61348
280,1,17,true,2,2,0,41.83779,-87.65116
TA1308000046,1,17,true,10,42,32,41.83779,-87.65115
339,1,17,true,1,6,5,41.83817,-87.64523
TA1309000055,1,17,true,37,64,27,41.8382,-87.64514
KA1503000038,1,17,true,16,22,6,41.83845,-87.6354
TA1307000048,1,17,true,38,38,0,41.83855,-87.60821
150,1,17,true,4,5,1,41.83855,-87.60821
TA1308000036,1,17,true,18,36,18,41.83883,-87.62186
15442,1,17,true,8,4,-4,41.83918,-87.66562
KA1504000168,1,17,true,1,1,0,41.84152,-87.68514
KA1503000040,1,17,true,2,25,23,41.84164,-87.65744
13213,1,17,true,7,1,-6,41.84171,-87.62694
237,1,17,true,6,13,7,41.84204,-87.61697
TA1307000139,1,17,true,62,53,-9,41.84205,-87.61698
15443,1,17,true,9,13,4,41.84275,-87.63549
207,1,17,true,1,2,1,41.84358,-87.64539
TA1307000153,1,17,true,6,30,24,41.84358,-87.64538
15691,1,17,true,1,2,1,41.84449,-87.70203
147,1,17,true,2,4,2,41.84569,-87.62251
TA1307000005,1,17,true,13,22,9,41.84569,-87.6225
206,1,17,true,2,1,-1,41.84719,-87.64683
TA1308000013,1,17,true,24,8,-16,41.84719,-87.64681
TA1309000003,1,17,true,11,4,-7,41.84847,-87.68512
442,1,17,true,1,1,0,41.84912,-87.69515
15689,1,17,true,3,4,1,41.84912,-87.69515
TA1307000066,1,17,true,3,5,2,41.8492,-87.67564
TA1308000014,1,17,true,9,6,-3,41.84953,-87.64059
209,1,17,true,2,3,1,41.84953,-87.64058
132,1,17,true,5,1,-4,41.85008,-87.63215
TA1308000026,1,17,true,7,7,0,41.85008,-87.63214
TA1305000004,1,17,true,8,10,2,41.8514,-87.61884
42,1,17,true,5,2,-3,41.85261,-87.62653
TA1305000001,1,17,true,30,22,-8,41.85262,-87.6265
13075,1,17,true,50,31,-19,41.8531,-87.63192
120,1,17,true,15,7,-8,41.8531,-87.63191
13162,1,17,true,4,9,5,41.85378,-87.64659
13096,1,17,true,3,13,10,41.8538,-87.69577
15685,1,17,true,1,2,1,41.85399,-87.71511
203,1,17,true,4,2,-2,41.85409,-87.68585
13091,1,17,true,9,12,3,41.85409,-87.68585
15546,1,17,true,13,12,-1,41.85416,-87.61916
208,1,17,true,2,4,2,41.85489,-87.66359
13307,1,17,true,13,17,4,41.85489,-87.66359
124,1,17,true,3,4,1,41.85492,-87.67609
13089,1,17,true,10,16,6,41.85497,-87.67567
13331,1,17,true,17,16,-1,41.85515,-87.65414
171,1,17,true,7,1,-6,41.85516,-87.65414
15545,1,17,true,135,129,-6,41.85627,-87.61334
4,1,17,true,14,15,1,41.85627,-87.61334
178,1,17,true,1,3,2,41.85657,-87.62755
SL-013,1,17,true,15,34,19,41.85659,-87.62755
SL-006,1,17,true,30,20,-10,41.8568,-87.63387
129,1,17,true,7,9,2,41.85752,-87.66158
202,1,17,true,2,3,1,41.85752,-87.64621
13135,1,17,true,33,42,9,41.85753,-87.66157
338,1,17,true,7,16,9,41.85758,-87.61956
13102,1,17,true,73,83,10,41.85762,-87.61942
273,1,17,true,11,20,9,41.85783,-87.62455
13150,1,17,true,59,116,57,41.85783,-87.62455
13099,1,17,true,17,16,-1,41.85784,-87.64627
205,1,17,true,6,12,6,41.8579,-87.6687
TA1307000159,1,17,true,15,35,20,41.8579,-87.6687
170,1,17,true,7,3,-4,41.85793,-87.64083
TA1307000044,1,17,true,27,22,-5,41.85794,-87.64083
14,1,17,true,1,2,1,41.85808,-87.65109
13163,1,17,true,27,44,17,41.85808,-87.65108
13164,1,17,true,29,71,42,41.85818,-87.65648
15,1,17,true,4,6,2,41.85819,-87.65648
SL-012,1,17,true,63,102,39,41.86038,-87.62581
72,1,17,true,9,19,10,41.86039,-87.62581
274,1,17,true,3,7,4,41.86126,-87.6566
13304,1,17,true,10,30,20,41.86126,-87.65659
KA1504000109,1,17,true,10,2,-8,41.86192,-87.69347
TA1306000002,1,17,true,52,46,-6,41.86238,-87.65108
137,1,17,true,2,3,1,41.86238,-87.65108
TA1307000124,1,17,true,88,169,81,41.86411,-87.62372
168,1,17,true,10,40,30,41.86415,-87.62372
282,1,17,true,9,15,6,41.86487,-87.64708
TA1309000001,1,17,true,60,57,-3,41.86488,-87.64708
136,1,17,true,1,1,0,41.86504,-87.65698
13165,1,17,true,10,3,-7,41.86505,-87.65697
13354,1,17,true,30,23,-7,41.86524,-87.66651
275,1,17,true,4,4,0,41.86524,-87.66651
13029,1,17,true,9,5,-4,41.86531,-87.6179
341,1,17,true,7,4,-3,41.86608,-87.60733
13431,1,17,true,76,66,-10,41.8661,-87.60728
KA1504000101,1,17,true,12,16,4,41.86651,-87.68466
WL-008,1,17,true,70,73,3,41.86712,-87.64108
57,1,17,true,4,9,5,41.86712,-87.64107
59,1,17,true,24,51,27,41.86721,-87.62597
TA1305000002,1,17,true,134,258,124,41.86721,-87.62597
3,1,17,true,5,3,-2,41.86723,-87.61536
15544,1,17,true,30,39,9,41.86723,-87.61536
TA1305000017,1,17,true,61,22,-39,41.86734,-87.64863
55,1,17,true,7,5,-2,41.86735,-87.64863
KA1706005007,1,17,true,47,50,3,41.86749,-87.63219
626,1,17,true,8,13,5,41.86749,-87.63219
SL-005,1,17,true,136,180,44,41.8679,-87.62304
255,1,17,true,22,26,4,41.86791,-87.62304
644,1,17,true,50,58,8,41.86859,-87.68625
19,1,17,true,11,13,2,41.86892,-87.65913
13139,1,17,true,72,55,-17,41.86893,-87.65913
13285,1,17,true,125,14,-111,41.86928,-87.67372
13160,1,17,true,86,89,3,41.86947,-87.65548
22,1,17,true,9,16,7,41.86947,-87.65548
382,1,17,true,3,5,2,41.8699,-87.68725
414,1,17,true,8,7,-1,41.87023,-87.63947
15550,1,17,true,31,65,34,41.87024,-87.63947
TA1309000010,1,17,true,95,158,63,41.87074,-87.62574
SL-009,1,17,true,30,63,33,41.87081,-87.63121
342,1,17,true,37,4,-33,41.87127,-87.6737
TA1309000064,1,17,true,167,29,-138,41.87127,-87.67369
15542,1,17,true,35,18,-17,41.87146,-87.64095
261,1,17,true,25,5,-20,41.87151,-87.6699
TA1307000130,1,17,true,95,78,-17,41.87178,-87.65103
241,1,17,true,17,22,5,41.8718,-87.65102
108,1,17,true,15,33,18,41.87183,-87.64664
TA1307000121,1,17,true,84,111,27,41.87184,-87.64664
41,1,17,true,18,40,22,41.87209,-87.62957
SL-008,1,17,true,138,223,85,41.87209,-87.62956
13332,1,17,true,150,155,5,41.87219,-87.6615
394,1,17,true,1,7,6,41.87226,-87.63484
175,1,17,true,12,32,20,41.87255,-87.63359
SL-011,1,17,true,63,128,65,41.87256,-87.63356
623,1,17,true,56,79,23,41.87272,-87.62399
KA1504000104,1,17,true,132,24,-108,41.87296,-87.66912
383,1,17,true,36,3,-33,41.87297,-87.66912
320,1,17,true,18,31,13,41.87327,-87.66402
5,1,17,true,7,11,4,41.87403,-87.6277
SL-007,1,17,true,37,56,19,41.87404,-87.6277
13326,1,17,true,35,14,-21,41.87425,-87.63958
321,1,17,true,19,15,-4,41.87427,-87.63257
TA1306000025,1,17,true,46,43,-3,41.87464,-87.65703
32,1,17,true,7,6,-1,41.87464,-87.65703
15668,1,17,true,23,16,-7,41.87471,-87.68642
13028,1,17,true,61,42,-19,41.87475,-87.64981
109,1,17,true,14,6,-8,41.87475,-87.64981
13081,1,17,true,63,14,-49,41.87501,-87.67326
122,1,17,true,7,4,-3,41.87501,-87.67325
89,1,17,true,5,15,10,41.87501,-87.6331
SL-010,1,17,true,81,82,1,41.87501,-87.63309
15541,1,17,true,26,22,-4,41.8758,-87.62086
13037,1,17,true,44,16,-28,41.87588,-87.64078
50,1,17,true,16,20,4,41.87592,-87.6307
TA1305000009,1,17,true,68,83,15,41.87593,-87.63068
317,1,17,true,45,2,-43,41.87603,-87.68195
TA1305000010,1,17,true,38,14,-24,41.87623,-87.62444
45,1,17,true,7,4,-3,41.87623,-87.62444
624,1,17,true,77,48,-29,41.87626,-87.62923
2,1,17,true,5,3,-2,41.87649,-87.62051
33,1,17,true,10,5,-5,41.87715,-87.62786
TA1305000035,1,17,true,96,36,-60,41.87716,-87.62787
13138,1,17,true,125,53,-72,41.87723,-87.63941
75,1,17,true,9,4,-5,41.87724,-87.63937
631,1,17,true,17,1,-16,41.87761,-87.6739
15539,1,17,true,78,130,52,41.87763,-87.64405
13158,1,17,true,108,183,75,41.87764,-87.64957
134,1,17,true,14,27,13,41.87764,-87.64954
21,1,17,true,19,18,-1,41.87773,-87.6548
13157,1,17,true,83,113,30,41.87773,-87.6548
TA1305000025,1,17,true,146,55,-91,41.87773,-87.63528
36,1,17,true,29,14,-15,41.87776,-87.63525
TA1309000002,1,17,true,67,34,-33,41.87784,-87.62408
284,1,17,true,8,6,-2,41.87784,-87.62408
13206,1,17,true,59,53,-6,41.87794,-87.66201
146,1,17,true,6,13,7,41.87794,-87.66201
283,1,17,true,37,7,-30,41.87809,-87.63183
TA1309000004,1,17,true,161,29,-132,41.87811,-87.63184
107,1,17,true,15,30,15,41.87822,-87.644
638,1,17,true,235,144,-91,41.87827,-87.64078
37,1,17,true,27,7,-20,41.87921,-87.62975
TA1305000005,1,17,true,172,32,-140,41.87924,-87.62975
286,1,17,true,23,4,-19,41.8793,-87.6355
13011,1,17,true,256,187,-69,41.87931,-87.63993
TA1309000008,1,17,true,126,23,-103,41.87933,-87.6355
192,1,17,true,23,18,-5,41.87935,-87.63997
KA1503000034,1,17,true,104,6,-98,41.87938,-87.63197
39,1,17,true,15,12,-3,41.87948,-87.62571
KA1503000015,1,17,true,132,65,-67,41.87948,-87.6257
15667,1,17,true,29,17,-12,41.8798,-87.68609
381,1,17,true,2,8,6,41.87981,-87.68607
16916,1,17,true,1,5,4,41.88012,-87.76323
542,1,17,true,1,3,2,41.88013,-87.76322
287,1,17,true,41,5,-36,41.88017,-87.63527
TA1309000007,1,17,true,236,31,-205,41.88022,-87.63526
WL-011,1,17,true,84,80,-4,41.88034,-87.64273
73,1,17,true,12,28,16,41.8804,-87.64273
80,1,17,true,8,27,19,41.88042,-87.65556
13156,1,17,true,80,146,66,41.88042,-87.65554
13300,1,17,true,127,167,40,41.88097,-87.61675
76,1,17,true,20,13,-7,41.88098,-87.61675
13008,1,17,true,118,90,-28,41.88105,-87.62408
90,1,17,true,20,13,-7,41.88107,-87.62409
49,1,17,true,68,13,-55,41.88116,-87.62963
TA1305000006,1,17,true,288,64,-224,41.88122,-87.6296
13134,1,17,true,39,22,-17,41.88138,-87.67493
215,1,17,true,2,5,3,41.88139,-87.67492
396,1,17,true,1,1,0,41.88159,-87.7044
13056,1,17,true,97,74,-23,41.88168,-87.63951
191,1,17,true,26,19,-7,41.88169,-87.63951
198,1,17,true,25,49,24,41.88187,-87.6488
TA1307000120,1,17,true,198,247,49,41.88188,-87.64879
13341,1,17,true,228,156,-72,41.88208,-87.63985
174,1,17,true,15,23,8,41.88208,-87.63984
197,1,17,true,15,10,-5,41.88208,-87.62513
13036,1,17,true,67,41,-26,41.8821,-87.62513
77,1,17,true,37,55,18,41.88214,-87.64108
TA1305000032,1,17,true,236,239,3,41.88218,-87.64109
98,1,17,true,52,10,-42,41.88266,-87.63251
13006,1,17,true,152,46,-106,41.88268,-87.63252
13353,1,17,true,41,91,50,41.88283,-87.6612
346,1,17,true,10,15,5,41.88284,-87.6612
654,1,17,true,45,49,4,41.88307,-87.65698
233,1,17,true,7,10,3,41.88309,-87.6511
13409,1,17,true,91,76,-15,41.8831,-87.6511
18,1,17,true,22,10,-12,41.88317,-87.63735
KA1503000072,1,17,true,111,26,-85,41.88317,-87.63693
91,1,17,true,49,52,3,41.88336,-87.64122
WL-012,1,17,true,350,247,-103,41.88337,-87.6412
112,1,17,true,19,22,3,41.88362,-87.6486
13053,1,17,true,145,115,-30,41.88365,-87.64863
43,1,17,true,31,21,-10,41.88396,-87.62455
13001,1,17,true,186,91,-95,41.88397,-87.62459
88,1,17,true,6,8,2,41.88407,-87.65691
13155,1,17,true,42,32,-10,41.88407,-87.65689
621,1,17,true,15,16,1,41.88412,-87.65427
18062,1,17,true,82,90,8,41.88412,-87.65427
81,1,17,true,53,18,-35,41.88417,-87.6296
TA1306000010,1,17,true,297,140,-157,41.88419,-87.62961
15666,1,17,true,2,6,4,41.88446,-87.6963
KA1504000106,1,17,true,4,4,0,41.88459,-87.70631
TA1305000030,1,17,true,233,46,-187,41.88459,-87.63178
15535,1,17,true,128,85,-43,41.8846,-87.64455
96,1,17,true,18,11,-7,41.8846,-87.64455
51,1,17,true,42,10,-32,41.88462,-87.63176
TA1305000029,1,17,true,177,125,-52,41.88466,-87.62787
195,1,17,true,27,45,18,41.88466,-87.61952
13263,1,17,true,183,214,31,41.88467,-87.61952
44,1,17,true,21,22,1,41.88468,-87.62782
528,1,17,true,3,3,0,41.88537,-87.72661
TA1306000015,1,17,true,135,123,-12,41.88549,-87.65232
518,1,17,true,2,4,2,41.8855,-87.71686
71,1,17,true,10,20,10,41.8855,-87.65233
66,1,17,true,28,25,-3,41.88557,-87.64186
13021,1,17,true,222,113,-109,41.88559,-87.64184
TA1307000111,1,17,true,190,42,-148,41.88582,-87.63548
164,1,17,true,48,5,-43,41.88583,-87.63547
13073,1,17,true,23,20,-3,41.88592,-87.66717
119,1,17,true,7,4,-3,41.88593,-87.66717
KA17018054,1,17,true,29,8,-21,41.88595,-87.67701
656,1,17,true,3,3,0,41.88595,-87.67701
KA1503000012,1,17,true,136,59,-77,41.88599,-87.63089
38,1,17,true,29,14,-15,41.88599,-87.63089
52,1,17,true,43,19,-24,41.886,-87.62421
TA1305000011,1,17,true,207,77,-130,41.886,-87.62418
7,1,17,true,16,32,16,41.88627,-87.61751
15534,1,17,true,100,131,31,41.88627,-87.61749
217,1,17,true,17,8,-9,41.8866,-87.65821
13197,1,17,true,64,43,-21,41.8866,-87.65816
264,1,17,true,32,10,-22,41.8867,-87.62224
TA1308000029,1,17,true,93,59,-34,41.88673,-87.62225
TA1307000131,1,17,true,139,44,-95,41.88688,-87.62606
194,1,17,true,30,5,-25,41.88688,-87.62606
6,1,17,true,2,6,4,41.88697,-87.61281
KA1503000064,1,17,true,67,87,20,41.88697,-87.61281
16906,1,17,true,3,19,16,41.88792,-87.77445
100,1,17,true,49,30,-19,41.88814,-87.63657
TA1305000022,1,17,true,237,117,-120,41.88817,-87.63656
56,1,17,true,53,58,5,41.88866,-87.64442
TA1306000003,1,17,true,218,237,19,41.88867,-87.64442
KA1503000043,1,17,true,373,320,-53,41.88918,-87.63851
133,1,17,true,71,69,-2,41.88918,-87.63851
13050,1,17,true,171,86,-85,41.88919,-87.62775
47,1,17,true,46,22,-24,41.88921,-87.62775
15664,1,17,true,15,18,3,41.8895,-87.68821
376,1,17,true,13,3,-10,41.88951,-87.68818
13432,1,17,true,51,32,-19,41.88989,-87.67149
285,1,17,true,2,2,0,41.88989,-87.67149
TA1307000151,1,17,true,238,160,-78,41.88993,-87.63427
212,1,17,true,49,28,-21,41.88995,-87.63427
636,1,17,true,132,92,-40,41.88997,-87.63662
378,1,17,true,2,1,-1,41.89014,-87.71289
125,1,17,true,25,14,-11,41.89018,-87.62621
KA1503000044,1,17,true,94,47,-47,41.89018,-87.6262
196,1,17,true,18,25,7,41.89053,-87.62205
13427,1,17,true,87,83,-4,41.89054,-87.62205
26,1,17,true,24,32,8,41.89057,-87.61798
13430,1,17,true,158,83,-75,41.89077,-87.63169
181,1,17,true,29,12,-17,41.89077,-87.63168
TA1306000013,1,17,true,156,177,21,41.89083,-87.61852
RN-,1,17,true,159,122,-37,41.89102,-87.63546
672,1,17,true,23,30,7,41.89102,-87.63545
277,1,17,true,12,7,-5,41.89108,-87.66665
13434,1,17,true,27,49,22,41.89108,-87.66663
TA1308000006,1,17,true,33,37,4,41.89128,-87.67686
199,1,17,true,38,36,-2,41.89143,-87.62676
TA1307000117,1,17,true,223,176,-47,41.89144,-87.62675
13033,1,17,true,119,117,-2,41.8916,-87.64835
214,1,17,true,1,10,9,41.89161,-87.67688
84,1,17,true,18,20,2,41.89161,-87.64833
186,1,17,true,15,23,8,41.8918,-87.65879
13194,1,17,true,79,97,18,41.8918,-87.65878
TA1305000003,1,17,true,175,131,-44,41.89187,-87.62061
24,1,17,true,37,42,5,41.8919,-87.62063
643,1,17,true,12,24,12,41.89203,-87.68939
35,1,17,true,10,25,15,41.89227,-87.61206
13022,1,17,true,183,191,8,41.89227,-87.61205
99,1,17,true,18,23,5,41.89255,-87.61449
TA1306000029,1,17,true,127,147,20,41.89256,-87.61449
13265,1,17,true,213,207,-6,41.89383,-87.64172
74,1,17,true,31,52,21,41.89384,-87.64173
13045,1,17,true,244,267,23,41.89403,-87.62931
110,1,17,true,46,40,-6,41.89406,-87.6293
13016,1,17,true,366,78,-288,41.89431,-87.62277
211,1,17,true,92,12,-80,41.89439,-87.62267
KA1503000041,1,17,true,207,124,-83,41.89452,-87.61798
142,1,17,true,60,27,-33,41.89453,-87.61806
92,1,17,true,14,22,8,41.89455,-87.65346
13196,1,17,true,80,87,7,41.89455,-87.65345
TA1307000062,1,17,true,147,77,-70,41.89466,-87.63839
111,1,17,true,31,10,-21,41.89466,-87.63837
TA1306000012,1,17,true,243,213,-30,41.89475,-87.63438
53,1,17,true,69,45,-24,41.89476,-87.63439
627,1,17,true,18,22,4,41.8948,-87.63231
KP1705001026,1,17,true,118,117,-1,41.89483,-87.6323
524,1,17,true,1,1,0,41.89489,-87.77449
550,1,17,true,2,2,0,41.89495,-87.76491
16920,1,17,true,2,3,1,41.89495,-87.76491
KA1504000114,1,17,true,8,4,-4,41.89547,-87.70614
373,1,17,true,1,5,4,41.89548,-87.70614
18058,1,17,true,38,37,-1,41.8955,-87.68201
659,1,17,true,6,16,10,41.8955,-87.68201
637,1,17,true,56,97,41,41.89563,-87.67209
128,1,17,true,7,11,4,41.89571,-87.67716
13132,1,17,true,54,92,38,41.89573,-87.67718
161,1,17,true,17,22,5,41.89574,-87.62599
15530,1,17,true,148,109,-39,41.89575,-87.62596
18003,1,17,true,134,52,-82,41.89575,-87.62011
635,1,17,true,18,9,-9,41.89576,-87.62012
13247,1,17,true,54,94,40,41.89597,-87.66775
350,1,17,true,9,7,-2,41.89597,-87.66774
TA1305000020,1,17,true,65,63,-2,41.89636,-87.65406
54,1,17,true,16,14,-2,41.89637,-87.65407
13289,1,17,true,52,102,50,41.89638,-87.661
86,1,17,true,6,13,7,41.89639,-87.661
337,1,17,true,22,19,-3,41.89659,-87.63096
13303,1,17,true,69,108,39,41.89672,-87.63088
13017,1,17,true,136,133,-3,41.89676,-87.6357
31,1,17,true,29,27,-2,41.89677,-87.63572
13338,1,17,true,160,76,-84,41.89697,-87.62173
173,1,17,true,61,20,-41,41.89704,-87.62173
TA1307000061,1,17,true,61,71,10,41.89745,-87.62873
106,1,17,true,11,11,0,41.89746,-87.62874
25,1,17,true,13,8,-5,41.89751,-87.62354
13034,1,17,true,104,52,-52,41.89754,-87.62352
48,1,17,true,49,22,-27,41.89772,-87.64302
TA1306000009,1,17,true,220,87,-133,41.89772,-87.64299
620,1,17,true,100,139,39,41.89817,-87.63754
374,1,17,true,11,14,3,41.89842,-87.68659
KA1504000103,1,17,true,50,89,39,41.89842,-87.68659
145,1,17,true,44,33,-11,41.89856,-87.62211
15529,1,17,true,208,116,-92,41.89858,-87.62206
140,1,17,true,43,35,-8,41.89895,-87.6299
TA1307000128,1,17,true,201,240,39,41.89896,-87.6299
657,1,17,true,38,66,28,41.89918,-87.6722
KA1504000117,1,17,true,22,15,-7,41.89936,-87.64848
30,1,17,true,2,3,1,41.89964,-87.66789
13248,1,17,true,37,95,58,41.89964,-87.66788
46,1,17,true,13,13,0,41.89994,-87.63444
TA1306000011,1,17,true,68,103,35,41.89994,-87.63443
364,1,17,true,12,12,0,41.90023,-87.64299
KA1504000116,1,17,true,71,82,11,41.90023,-87.64299
17660,1,17,true,25,26,1,41.90036,-87.69671
622,1,17,true,6,6,0,41.90037,-87.69671
29,1,17,true,24,14,-10,41.90069,-87.66259
13290,1,17,true,65,73,8,41.90069,-87.66259
13042,1,17,true,213,158,-55,41.90097,-87.62377
85,1,17,true,29,21,-8,41.90098,-87.62375
183,1,17,true,7,13,6,41.90133,-87.67744
TA1307000070,1,17,true,45,87,42,41.90133,-87.67742
KA1504000133,1,17,true,135,136,1,41.90234,-87.62773
172,1,17,true,14,14,0,41.90236,-87.62774
15654,1,17,true,6,7,1,41.90271,-87.70923
305,1,17,true,6,5,-1,41.9028,-87.69005
13241,1,17,true,38,24,-14,41.9029,-87.68731
176,1,17,true,48,77,29,41.90291,-87.63141
23,1,17,true,7,12,5,41.90292,-87.63772
TA1306000006,1,17,true,28,79,51,41.90292,-87.63772
TA1307000039,1,17,true,257,358,101,41.90294,-87.63137
658,1,17,true,54,28,-26,41.903,-87.6838
13256,1,17,true,36,11,-25,41.90302,-87.69749
216,1,17,true,3,4,1,41.90302,-87.69749
17,1,17,true,11,20,9,41.90313,-87.67391
TA1305000034,1,17,true,62,83,21,41.90313,-87.67391
182,1,17,true,28,57,29,41.90317,-87.63442
KA1504000135,1,17,true,246,327,81,41.90319,-87.63439
13136,1,17,true,52,67,15,41.90326,-87.67845
130,1,17,true,15,17,2,41.90327,-87.67846
210,1,17,true,12,27,15,41.90342,-87.66781
13061,1,17,true,166,163,-3,41.90342,-87.66779
KA1504000079,1,17,true,97,123,26,41.9035,-87.64334
359,1,17,true,11,22,11,41.90458,-87.6497
138,1,17,true,5,13,8,41.9046,-87.64057
TA1307000115,1,17,true,55,76,21,41.9046,-87.64056
291,1,17,true,21,20,-1,41.90672,-87.63494
TA1308000049,1,17,true,109,158,49,41.90672,-87.6349
KA1504000134,1,17,true,82,115,33,41.90687,-87.6262
180,1,17,true,18,18,0,41.90687,-87.62618
13224,1,17,true,73,77,4,41.90706,-87.66725
333,1,17,true,13,24,11,41.90706,-87.66725
18069,1,17,true,74,2,-72,41.90722,-87.65563
TA1307000143,1,17,true,25,42,17,41.90762,-87.63854
236,1,17,true,2,7,5,41.90762,-87.63853
61,1,17,true,16,20,4,41.90764,-87.67254
13221,1,17,true,103,125,22,41.90765,-87.67254
13245,1,17,true,20,10,-10,41.90777,-87.68586
159,1,17,true,5,1,-4,41.90777,-87.68586
301,1,17,true,28,36,8,41.90796,-87.63203
TA1309000024,1,17,true,141,201,60,41.908,-87.63152
69,1,17,true,15,23,8,41.90939,-87.6777
TA1305000041,1,17,true,108,114,6,41.9094,-87.67769
15652,1,17,true,5,4,-1,41.90965,-87.71664
331,1,17,true,163,212,49,41.90965,-87.64812
15653,1,17,true,19,23,4,41.90979,-87.7053
509,1,17,true,2,2,0,41.9098,-87.70531
TA1305000037,1,17,true,79,99,20,41.91018,-87.67003
27,1,17,true,9,16,7,41.91019,-87.6435
TA1306000008,1,17,true,45,91,46,41.9102,-87.6435
16,1,17,true,12,21,9,41.91035,-87.67008
213,1,17,true,8,15,7,41.91037,-87.68237
TA1308000005,1,17,true,29,52,23,41.91042,-87.68238
13258,1,17,true,29,27,-2,41.91043,-87.69718
276,1,17,true,9,10,1,41.91043,-87.69718
160,1,17,true,7,6,-1,41.91054,-87.68957
13257,1,17,true,25,42,17,41.91054,-87.68956
13154,1,17,true,147,171,24,41.91054,-87.65312
20,1,17,true,21,30,9,41.91055,-87.65313
60,1,17,true,9,13,4,41.91059,-87.64942
13058,1,17,true,78,84,6,41.91059,-87.64942
TA1307000038,1,17,true,120,111,-9,41.91138,-87.63868
118,1,17,true,25,24,-1,41.91138,-87.63868
268,1,17,true,25,34,9,41.91172,-87.62681
LF-005,1,17,true,218,327,109,41.91172,-87.62681
126,1,17,true,12,15,3,41.91196,-87.63197
13128,1,17,true,59,82,23,41.91197,-87.63197
289,1,17,true,31,47,16,41.91209,-87.63472
TA1308000050,1,17,true,247,332,85,41.91211,-87.6347
158,1,17,true,11,18,7,41.91262,-87.6814
13243,1,17,true,86,133,47,41.91262,-87.6814
315,1,17,true,3,1,-2,41.91293,-87.66417
TA1309000032,1,17,true,20,24,4,41.91293,-87.66417
TA1306000032,1,17,true,120,140,20,41.9137,-87.65285
93,1,17,true,19,30,11,41.91371,-87.65285
224,1,17,true,17,22,5,41.91386,-87.64877
TA1307000166,1,17,true,72,99,27,41.91386,-87.64877
511,1,17,true,5,1,-4,41.914,-87.70515
15655,1,17,true,46,49,3,41.91401,-87.70514
641,1,17,true,3,4,1,41.91416,-87.71676
18017,1,17,true,4,14,10,41.91416,-87.71676
628,1,17,true,10,5,-5,41.9146,-87.66796
18067,1,17,true,39,66,27,41.9146,-87.66796
28,1,17,true,7,10,3,41.91469,-87.64333
TA1306000007,1,17,true,34,70,36,41.91469,-87.64333
13068,1,17,true,79,60,-19,41.91554,-87.68703
116,1,17,true,11,7,-4,41.91555,-87.68703
13179,1,17,true,147,205,58,41.9157,-87.63461
141,1,17,true,21,32,11,41.91571,-87.63461
219,1,17,true,11,13,2,41.91598,-87.67733
13133,1,17,true,56,123,67,41.91598,-87.67733
58,1,17,true,12,19,7,41.91602,-87.66894
TA1305000039,1,17,true,62,89,27,41.9163,-87.66749
15650,1,17,true,29,18,-11,41.91711,-87.71023
506,1,17,true,1,1,0,41.91711,-87.71023
507,1,17,true,4,2,-2,41.91752,-87.70181
15651,1,17,true,25,27,2,41.91752,-87.70181
185,1,17,true,3,8,5,41.91774,-87.69143
13266,1,17,true,33,37,4,41.91774,-87.69142
TA1309000029,1,17,true,28,31,3,41.9178,-87.68245
309,1,17,true,1,3,2,41.91789,-87.6865
288,1,17,true,15,15,0,41.91809,-87.64375
TA1309000006,1,17,true,76,98,22,41.91809,-87.64375
223,1,17,true,9,21,12,41.91821,-87.65698
TA1307000163,1,17,true,95,93,-2,41.91821,-87.65696
94,1,17,true,24,29,5,41.91831,-87.6363
13146,1,17,true,136,207,71,41.91831,-87.63629
13059,1,17,true,163,147,-16,41.91845,-87.65222
113,1,17,true,16,14,-2,41.91846,-87.65222
13259,1,17,true,26,21,-5,41.91852,-87.69744
259,1,17,true,2,4,2,41.91853,-87.69745
310,1,17,true,5,10,5,41.91984,-87.68083
225,1,17,true,23,15,-8,41.91995,-87.64884
13192,1,17,true,92,127,35,41.91995,-87.64884
13288,1,17,true,41,47,6,41.92008,-87.67788
13242,1,17,true,14,17,3,41.92021,-87.69266
222,1,17,true,6,5,-1,41.92023,-87.69265
307,1,17,true,5,7,2,41.92077,-87.66373
TA1309000030,1,17,true,72,86,14,41.92077,-87.66372
290,1,17,true,11,5,-6,41.92152,-87.70734
13292,1,17,true,18,26,8,41.92152,-87.70733
TA1309000033,1,17,true,113,129,16,41.92158,-87.65381
13193,1,17,true,161,212,51,41.92182,-87.64412
144,1,17,true,35,44,9,41.92182,-87.64411
13191,1,17,true,98,102,4,41.92217,-87.63891
143,1,17,true,13,26,13,41.92217,-87.63891
327,1,17,true,20,19,-1,41.92225,-87.65783
13084,1,17,true,47,61,14,41.92268,-87.69715
123,1,17,true,9,7,-2,41.92268,-87.69714
LP-,1,17,true,60,69,9,41.92396,-87.63584
673,1,17,true,6,7,1,41.92398,-87.63585
KA1504000140,1,17,true,29,21,-8,41.92409,-87.67646
505,1,17,true,3,3,0,41.92409,-87.67646
16010,1,17,true,3,10,7,41.92458,-87.72787
504,1,17,true,6,5,-1,41.92464,-87.68931
15648,1,17,true,15,24,9,41.92464,-87.68931
503,1,17,true,2,2,0,41.92483,-87.71451
KA1504000090,1,17,true,4,16,12,41.92483,-87.7145
TA1307000001,1,17,true,99,116,17,41.92535,-87.66581
188,1,17,true,13,19,6,41.92536,-87.66581
TA1306000026,1,17,true,108,119,11,41.92558,-87.65842
87,1,17,true,6,11,5,41.92559,-87.65843
TA1306000016,1,17,true,121,87,-34,41.9256,-87.65371
67,1,17,true,13,15,2,41.9256,-87.65371
313,1,17,true,17,29,12,41.9257,-87.64246
TA1309000019,1,17,true,174,161,-13,41.92586,-87.63897
TA1309000058,1,17,true,195,202,7,41.92591,-87.64927
127,1,17,true,33,23,-10,41.92592,-87.64927
177,1,17,true,28,26,-2,41.92627,-87.63086
TA1308000001,1,17,true,198,226,28,41.92627,-87.63086
502,1,17,true,2,4,2,41.92667,-87.69772
15646,1,17,true,6,24,18,41.92668,-87.6977
13124,1,17,true,53,33,-20,41.92675,-87.63444
34,1,17,true,5,5,0,41.92675,-87.63444
302,1,17,true,8,10,2,41.92859,-87.65421
TA1309000023,1,17,true,79,88,9,41.9287,-87.65383
TA1307000113,1,17,true,52,63,11,41.92878,-87.66391
190,1,17,true,7,8,1,41.92878,-87.6639
166,1,17,true,8,10,2,41.92883,-87.66853
13296,1,17,true,48,35,-13,41.92883,-87.66852
343,1,17,true,11,10,-1,41.92889,-87.65898
TA1309000059,1,17,true,40,51,11,41.92889,-87.65898
349,1,17,true,17,29,12,41.92915,-87.6491
TA1309000061,1,17,true,149,123,-26,41.92915,-87.64909
TA1308000031,1,17,true,28,26,-2,41.92946,-87.68417
258,1,17,true,6,5,-1,41.92946,-87.68417
340,1,17,true,31,25,-6,41.92956,-87.64313
TA1305000014,1,17,true,157,172,15,41.92956,-87.64313
260,1,17,true,9,11,2,41.92958,-87.70791
13085,1,17,true,48,44,-4,41.92958,-87.70789
15643,1,17,true,10,10,0,41.93057,-87.7238
TA1307000142,1,17,true,172,200,28,41.93125,-87.64432
220,1,17,true,25,34,9,41.93125,-87.64431
13276,1,17,true,95,117,22,41.93132,-87.63874
324,1,17,true,20,26,6,41.93173,-87.64179
501,1,17,true,2,2,0,41.93191,-87.70121
15645,1,17,true,12,18,6,41.93191,-87.70121
163,1,17,true,7,7,0,41.93191,-87.67784
13271,1,17,true,28,46,18,41.93192,-87.67784
152,1,17,true,19,22,3,41.93221,-87.65864
TA1307000064,1,17,true,149,110,-39,41.93222,-87.65864
13,1,17,true,9,11,2,41.93242,-87.65271
TA1306000014,1,17,true,111,134,23,41.93242,-87.65271
329,1,17,true,16,14,-2,41.93258,-87.63642
TA1309000039,1,17,true,160,197,37,41.93258,-87.63642
13294,1,17,true,55,35,-20,41.9326,-87.66595
319,1,17,true,7,6,-1,41.93292,-87.67217
332,1,17,true,17,33,16,41.93313,-87.64776
TA1309000036,1,17,true,108,168,60,41.93313,-87.64776
15644,1,17,true,4,18,14,41.93534,-87.71687
500,1,17,true,5,5,0,41.93534,-87.71686
TA1307000006,1,17,true,78,89,11,41.93571,-87.6636
153,1,17,true,18,12,-6,41.93575,-87.66364
162,1,17,true,2,12,10,41.93588,-87.67844
13268,1,17,true,23,28,5,41.93588,-87.67843
250,1,17,true,7,12,5,41.93609,-87.66984
13269,1,17,true,46,70,24,41.93609,-87.66983
TA1307000052,1,17,true,109,101,-8,41.93628,-87.65266
115,1,17,true,16,20,4,41.93628,-87.65266
156,1,17,true,26,40,14,41.9365,-87.64756
TA1307000136,1,17,true,127,166,39,41.9365,-87.64755
TA1307000041,1,17,true,150,167,17,41.93669,-87.63683
157,1,17,true,19,31,12,41.9367,-87.63683
13137,1,17,true,221,247,26,41.9376,-87.6441
300,1,17,true,39,41,2,41.93761,-87.6441
15642,1,17,true,16,17,1,41.93843,-87.69801
154,1,17,true,17,13,-4,41.93912,-87.66384
664,1,17,true,4,13,9,41.93934,-87.68327
KA17018068,1,17,true,12,29,17,41.93935,-87.68327
TA1309000042,1,17,true,86,105,19,41.93937,-87.66836
131,1,17,true,12,20,8,41.93937,-87.66835
KA150400009X,1,17,true,15,9,-6,41.9394,-87.71159
15640,1,17,true,8,6,-2,41.93941,-87.72357
497,1,17,true,3,1,-2,41.93941,-87.71159
13229,1,17,true,69,75,6,41.93946,-87.66376
226,1,17,true,16,11,-5,41.93972,-87.65886
TA1308000019,1,17,true,81,86,5,41.93973,-87.65886
13277,1,17,true,118,123,5,41.9401,-87.64546
296,1,17,true,25,39,14,41.9401,-87.64546
TA1307000134,1,17,true,180,160,-20,41.94016,-87.65303
117,1,17,true,38,22,-16,41.94016,-87.65302
13143,1,17,true,16,23,7,41.94059,-87.67853
334,1,17,true,32,32,0,41.94076,-87.63919
TA1309000049,1,17,true,148,151,3,41.94077,-87.63919
493,1,17,true,7,5,-2,41.94304,-87.68729
15634,1,17,true,17,17,0,41.94304,-87.68729
TA1307000138,1,17,true,74,98,24,41.94334,-87.67094
230,1,17,true,14,19,5,41.94335,-87.67093
13144,1,17,true,34,39,5,41.9434,-87.67964
299,1,17,true,15,30,15,41.94368,-87.64894
TA1309000025,1,17,true,124,147,23,41.94368,-87.64894
229,1,17,true,24,24,0,41.94372,-87.66401
13071,1,17,true,122,148,26,41.94373,-87.66401
632,1,17,true,119,139,20,41.94453,-87.6547
303,1,17,true,48,45,-3,41.94522,-87.64702
490,1,17,true,1,2,1,41.94523,-87.70664
15631,1,17,true,8,19,11,41.94524,-87.70665
13278,1,17,true,133,157,24,41.94553,-87.64644
330,1,17,true,3,4,1,41.94618,-87.67331
TA1309000050,1,17,true,21,24,3,41.94618,-87.67331
KA1504000141,1,17,true,2,5,3,41.94627,-87.73105
492,1,17,true,2,1,-1,41.94662,-87.68337
491,1,17,true,5,3,-2,41.94664,-87.69463
15632,1,17,true,8,12,4,41.94664,-87.69463
KA1504000143,1,17,true,13,13,0,41.94664,-87.68337
KA1504000142,1,17,true,2,3,1,41.94735,-87.71759
16994,1,17,true,3,3,0,41.94784,-87.74
227,1,17,true,20,30,10,41.94813,-87.66397
13235,1,17,true,118,116,-2,41.94814,-87.66396
304,1,17,true,25,29,4,41.94878,-87.64922
13253,1,17,true,47,46,-1,41.9488,-87.67527
257,1,17,true,2,2,0,41.9488,-87.67527
13325,1,17,true,148,179,31,41.94907,-87.64863
114,1,17,true,11,29,18,41.94935,-87.65451
TA1307000126,1,17,true,81,124,43,41.94936,-87.65451
232,1,17,true,18,28,10,41.94943,-87.64645
TA1307000150,1,17,true,147,199,52,41.94945,-87.64646
640,1,17,true,1,3,2,41.94993,-87.71396
18016,1,17,true,4,4,0,41.94993,-87.71395
347,1,17,true,4,4,0,41.95068,-87.6687
13319,1,17,true,34,55,21,41.95069,-87.6687
TA1307000127,1,17,true,96,104,8,41.9508,-87.65918
165,1,17,true,21,20,-1,41.95081,-87.65918
487,1,17,true,1,4,3,41.95216,-87.69806
15628,1,17,true,14,21,7,41.95216,-87.69806
318,1,17,true,13,13,0,41.95254,-87.6735
13323,1,17,true,86,76,-10,41.95282,-87.65
256,1,17,true,15,8,-7,41.95282,-87.65
15624,1,17,true,16,1,-15,41.95339,-87.73199
314,1,17,true,12,1,-11,41.9535,-87.69199
485,1,17,true,2,4,2,41.95361,-87.70933
KA1504000096,1,17,true,4,4,0,41.95361,-87.70932
590,1,17,true,2,2,0,41.95374,-87.74056
KA1504000139,1,17,true,4,6,2,41.954,-87.71909
TA1309000043,1,17,true,51,52,1,41.95417,-87.66434
13063,1,17,true,83,81,-2,41.95424,-87.65441
240,1,17,true,9,12,3,41.95424,-87.65441
486,1,17,true,3,1,-2,41.95431,-87.68607
KA1504000158,1,17,true,15,12,-3,41.95432,-87.68607
254,1,17,true,24,18,-6,41.95438,-87.64806
TA1308000022,1,17,true,125,107,-18,41.95438,-87.64805
16991,1,17,true,6,4,-2,41.95448,-87.7496
244,1,17,true,8,11,3,41.95466,-87.67391
TA1307000149,1,17,true,73,57,-16,41.95467,-87.67392
298,1,17,true,9,19,10,41.95601,-87.68021
TA1309000026,1,17,true,40,53,13,41.95601,-87.6802
246,1,17,true,4,4,0,41.95606,-87.66885
13249,1,17,true,9,17,8,41.95606,-87.66885
312,1,17,true,25,18,-7,41.95637,-87.6563
TA1308000047,1,17,true,24,18,-6,41.95709,-87.6642
292,1,17,true,6,3,-3,41.95709,-87.6642
13379,1,17,true,95,92,-3,41.95786,-87.6495
TA1309000018,1,17,true,41,19,-22,41.95791,-87.67357
316,1,17,true,5,9,4,41.95841,-87.69401
306,1,17,true,6,8,2,41.9585,-87.655
TA1309000027,1,17,true,61,71,10,41.9585,-87.65499
592,1,17,true,10,4,-6,41.96065,-87.74538
13389,1,17,true,73,81,8,41.961,-87.64958
245,1,17,true,12,18,6,41.96101,-87.64958
15621,1,17,true,19,9,-10,41.96103,-87.70586
480,1,17,true,6,1,-5,41.96104,-87.70586
KA1706005015,1,17,true,12,1,-11,41.96108,-87.73569
481,1,17,true,3,2,-1,41.96108,-87.69544
15622,1,17,true,22,29,7,41.96108,-87.69544
495,1,17,true,2,1,-1,41.96109,-87.72897
KA1504000164,1,17,true,2,2,0,41.96109,-87.72897
KA1504000097,1,17,true,15,12,-3,41.96116,-87.71658
238,1,17,true,3,10,7,41.96141,-87.6762
TA1307000144,1,17,true,38,46,8,41.96142,-87.6762
297,1,17,true,6,4,-2,41.9615,-87.67141
TA1309000021,1,17,true,17,26,9,41.9615,-87.6714
482,1,17,true,4,12,8,41.96154,-87.69117
15623,1,17,true,24,35,11,41.96154,-87.69117
234,1,17,true,8,6,-2,41.96158,-87.6661
KA1503000022,1,17,true,41,50,9,41.96158,-87.66609
231,1,17,true,16,23,7,41.96163,-87.65464
TA1307000107,1,17,true,113,115,2,41.96164,-87.65464
TA1307000156,1,17,true,42,44,2,41.96301,-87.68479
243,1,17,true,4,4,0,41.96302,-87.68479
TA1309000012,1,17,true,32,21,-11,41.96325,-87.67928
249,1,17,true,4,11,7,41.96398,-87.63818
TA1308000012,1,17,true,115,166,51,41.96398,-87.63818
293,1,17,true,17,12,-5,41.96521,-87.65822
13074,1,17,true,59,50,-9,41.96521,-87.6582
639,1,17,true,77,78,1,41.96584,-87.64538
KA1504000127,1,17,true,17,18,1,41.96587,-87.70083
KA1504000093,1,17,true,17,27,10,41.96587,-87.69365
478,1,17,true,2,6,4,41.96587,-87.69364
TA1307000140,1,17,true,28,64,36,41.96643,-87.68865
239,1,17,true,10,7,-3,41.9665,-87.68843
326,1,17,true,18,14,-4,41.96665,-87.67113
KA1504000126,1,17,true,2,7,5,41.96668,-87.70807
TA1309000014,1,17,true,58,89,31,41.96709,-87.66744
TA1307000158,1,17,true,60,33,-27,41.9671,-87.67904
242,1,17,true,10,3,-7,41.9671,-87.67904
TA1307000119,1,17,true,49,36,-13,41.96796,-87.65
251,1,17,true,16,8,-8,41.96796,-87.65
15615,1,17,true,16,7,-9,41.96835,-87.71183
323,1,17,true,6,7,1,41.96869,-87.66034
TA1308000021,1,17,true,49,44,-5,41.96883,-87.65765
253,1,17,true,4,3,-1,41.96883,-87.65765
475,1,17,true,7,11,4,41.96885,-87.69611
KA1504000080,1,17,true,17,46,29,41.96887,-87.69609
TA1309000015,1,17,true,24,13,-11,41.96889,-87.68401
311,1,17,true,7,3,-4,41.9689,-87.68402
TA1309000066,1,17,true,158,130,-28,41.9691,-87.67423
344,1,17,true,20,21,1,41.9691,-87.67423
TA1309000041,1,17,true,48,41,-7,41.96951,-87.65471
KA1504000171,1,17,true,57,44,-13,41.97161,-87.65016
465,1,17,true,9,15,6,41.97161,-87.65016
325,1,17,true,7,16,9,41.9728,-87.67186
TA1309000035,1,17,true,90,101,11,41.97335,-87.66785
295,1,17,true,15,11,-4,41.97378,-87.65972
13108,1,17,true,69,50,-19,41.97379,-87.65971
KA1504000078,1,17,true,13,35,22,41.97491,-87.69258
472,1,17,true,1,2,1,41.97492,-87.69262
464,1,17,true,3,8,5,41.97562,-87.67945
KA1504000149,1,17,true,13,37,24,41.97562,-87.67945
KA1504000160,1,17,true,18,9,-9,41.97564,-87.70143
471,1,17,true,2,4,2,41.97564,-87.70143
470,1,17,true,2,1,-1,41.97567,-87.70927
KA1504000128,1,17,true,7,6,-1,41.97567,-87.70927
KA1504000146,1,17,true,54,50,-4,41.978,-87.66805
463,1,17,true,7,10,3,41.978,-87.66805
294,1,17,true,18,12,-6,41.97835,-87.65976
13109,1,17,true,50,61,11,41.97835,-87.65976
KA1504000147,1,17,true,20,32,12,41.97976,-87.67754
655,1,17,true,23,8,-15,41.97987,-87.68194
KA1504000161,1,17,true,7,8,1,41.98038,-87.71612
KA1504000167,1,17,true,1,6,5,41.98206,-87.70895
494,1,17,true,2,1,-1,41.98234,-87.70892
460,1,17,true,12,7,-5,41.98358,-87.66916
KA1504000151,1,17,true,41,44,3,41.98359,-87.66916
15585,1,17,true,6,2,-4,41.98367,-87.69642
KA1504000152,1,17,true,138,119,-19,41.98403,-87.65231
459,1,17,true,15,21,6,41.98403,-87.65231
15578,1,17,true,64,61,-3,41.98405,-87.66027
461,1,17,true,6,5,-1,41.98405,-87.66027
353,1,17,true,2,1,-1,41.98656,-87.70761
15575,1,17,true,38,51,13,41.98975,-87.66014
458,1,17,true,8,13,5,41.98975,-87.66013
455,1,17,true,1,1,0,41.99024,-87.69338
KA1504000130,1,17,true,1,1,0,41.99024,-87.69338
457,1,17,true,1,8,7,41.99052,-87.66982
KA1504000148,1,17,true,24,35,11,41.99086,-87.66971
456,1,17,true,5,3,-2,41.99117,-87.68359
452,1,17,true,1,1,0,41.99417,-87.68945
KA1504000129,1,17,true,4,8,4,41.99417,-87.68945
15571,1,17,true,56,47,-9,41.99478,-87.66028
454,1,17,true,4,6,2,41.99478,-87.66027
453,1,17,true,9,2,-7,41.99925,-87.67137
KA1504000156,1,17,true,21,14,-7,41.99925,-87.67137
RP-009,1,17,true,28,30,2,42.00107,-87.66122
451,1,17,true,4,1,-3,42.00108,-87.66123
RP-001,1,17,true,5,1,-4,42.00179,-87.68883
449,1,17,true,1,4,3,42.00446,-87.67241
RP-008,1,17,true,16,25,9,42.00446,-87.6724
RP-002,1,17,true,2,7,5,42.00456,-87.68065
660,1,17,true,25,32,7,42.00458,-87.66143
354,1,17,true,3,5,2,42.00587,-87.66802
KA1504000175,1,17,true,40,28,-12,42.00797,-87.66549
447,1,17,true,2,3,1,42.00797,-87.66548
RP-005,1,17,true,22,12,-10,42.0086,-87.69047
467,1,17,true,7,3,-4,42.0086,-87.69047
432,1,17,true,2,3,1,42.00907,-87.67423
KA1504000162,1,17,true,28,15,-13,42.00907,-87.67422
KA1504000159,1,17,true,12,19,7,42.01059,-87.66241
RP-006,1,17,true,5,9,4,42.01213,-87.68292
RP-007,1,17,true,13,11,-2,42.01256,-87.67431
525,1,17,true,5,11,6,42.01272,-87.66605
517,1,17,true,20,17,-3,42.01597,-87.675
520,1,17,true,26,47,21,42.01597,-87.66859
519,1,17,true,1,3,2,42.01696,-87.67773
527,1,17,true,3,6,3,42.01892,-87.69004
515,1,17,true,22,13,-9,42.01915,-87.67356
514,1,17,true,2,8,6,42.01927,-87.68452
16806,1,17,true,3,10,7,42.01953,-87.66955
523,1,17,true,24,47,23,42.02089,-87.66505
662,1,17,true,6,4,-2,42.02354,-87.69961
598,1,17,true,4,3,-1,42.02578,-87.68411
597,1,17,true,4,6,2,42.03256,-87.67914
E002,1,17,true,28,31,3,42.03256,-87.67912
E011,1,17,true,2,4,2,42.03473,-87.69912
599,1,17,true,15,10,-5,42.03972,-87.69942
625,1,17,true,6,5,-1,42.04163,-87.6808
596,1,17,true,51,62,11,42.04822,-87.68348
600,1,17,true,13,9,-4,42.04831,-87.6983
E008,1,17,true,11,7,-4,42.05049,-87.67782
603,1,17,true,2,2,0,42.05049,-87.67782
605,1,17,true,29,10,-19,42.05294,-87.67342
661,1,17,true,1,9,8,42.05704,-87.68657
604,1,17,true,46,10,-36,42.05824,-87.67744
E006,1,17,true,7,5,-2,42.06367,-87.69871
601,1,17,true,6,6,0,42.06368,-87.69871
E007,1,17,true,7,11,4,42.06431,-87.68615
602,1,17,true,7,2,-5,42.06431,-87.68614
E014,1,17,true,7,13,6,42.06483,-87.71531
717,2,9,false,1,1,0,41.68588,-87.57376
20123,2,9,false,1,1,0,41.70461,-87.68115
20130,2,9,false,1,1,0,41.70534,-87.62903
20224,2,9,false,1,1,0,41.71371,-87.53083
20116,2,9,false,2,1,-1,41.73652,-87.60126
595,2,9,false,2,2,0,41.73663,-87.62264
20231,2,9,false,1,1,0,41.7368,-87.58282
582,2,9,false,1,1,0,41.74453,-87.56508
573,2,9,false,1,2,1,41.75079,-87.62444
576,2,9,false,1,2,1,41.75129,-87.59752
20234,2,9,false,3,1,-2,41.75223,-87.66378
572,2,9,false,1,1,0,41.75701,-87.62461
KA1503000019,2,9,false,2,2,0,41.75867,-87.5869
KA1503000002,2,9,false,3,1,-2,41.76641,-87.5657
KA1503000045,2,9,false,2,3,1,41.76649,-87.58647
KA1503000030,2,9,false,3,3,0,41.77352,-87.57722
KA1503000029,2,9,false,4,5,1,41.77364,-87.56747
KA1503000046,2,9,false,2,6,4,41.78041,-87.59141
KA1503000054,2,9,false,5,1,-4,41.78061,-87.60582
15491,2,9,false,5,4,-1,41.78096,-87.57624
KA1503000033,2,9,false,4,3,-1,41.78411,-87.61329
426,2,9,false,10,7,-3,41.7851,-87.60108
KA1503000014,2,9,false,22,22,0,41.7851,-87.60108
KA1503000070,2,9,false,2,7,5,41.78794,-87.58831
328,2,9,false,2,7,5,41.78872,-87.6013
TA1309000011,2,9,false,6,21,15,41.78873,-87.60131
423,2,9,false,2,11,9,41.79148,-87.59988
KA1503000071,2,9,false,13,25,12,41.79148,-87.59988
KA1503000074,2,9,false,6,12,6,41.79174,-87.58395
16943,2,9,false,1,1,0,41.79284,-87.66443
TA1309000063,2,9,false,8,4,-4,41.79325,-87.5878
345,2,9,false,5,1,-4,41.79326,-87.5878
421,2,9,false,1,1,0,41.79346,-87.61585
KA1504000076,2,9,false,10,10,0,41.7943,-87.60145
247,2,9,false,6,2,-4,41.79522,-87.58077
TA1308000009,2,9,false,27,16,-11,41.79522,-87.58075
TA1307000164,2,9,false,12,9,-3,41.79527,-87.59647
248,2,9,false,1,1,0,41.79528,-87.59647
KA1503000052,2,9,false,6,4,-2,41.79935,-87.60097
KA1503000059,2,9,false,32,10,-22,41.79952,-87.58643
419,2,9,false,1,1,0,41.79952,-87.58643
TA1309000037,2,9,false,15,8,-7,41.79957,-87.59474
556,2,9,false,3,3,0,41.79966,-87.65719
KA1503000010,2,9,false,1,1,0,41.8018,-87.64522
415,2,9,false,1,1,0,41.80228,-87.61807
417,2,9,false,1,2,1,41.80242,-87.5869
KA1503000007,2,9,false,19,3,-16,41.80242,-87.58689
13398,2,9,false,9,10,1,41.80256,-87.59035
TA1309000067,2,9,false,2,1,-1,41.80303,-87.60661
KA1503000069,2,9,false,2,1,-1,41.80579,-87.59247
KA1504000091,2,9,false,2,1,-1,41.80823,-87.6772
TA1308000035,2,9,false,4,5,1,41.80944,-87.59188
TA1308000002,2,9,false,10,4,-6,41.80983,-87.59937
TA1308000007,2,9,false,4,5,1,41.80984,-87.61628
TA1309000053,2,9,false,1,4,3,41.80985,-87.60675
KA1503000065,2,9,false,1,2,1,41.81409,-87.59701
TA1308000023,2,9,false,2,4,2,41.81649,-87.60659
KA1503000027,2,9,false,2,1,-1,41.81666,-87.61942
355,2,9,false,1,1,0,41.82217,-87.63032
TA1308000038,2,9,false,4,1,-3,41.82298,-87.6071
546,2,9,false,4,1,-3,41.82319,-87.67661
13420,2,9,false,4,4,0,41.82459,-87.61678
TA1308000043,2,9,false,1,5,4,41.83066,-87.64715
15446,2,9,false,2,2,0,41.83068,-87.65603
TA1307000129,2,9,false,2,9,7,41.83104,-87.62683
KA1503000004,2,9,false,10,6,-4,41.83127,-87.6088
406,2,9,false,1,1,0,41.83127,-87.6088
13345,2,9,false,2,3,1,41.83138,-87.61803
15445,2,9,false,1,1,0,41.83453,-87.63183
13216,2,9,false,3,4,1,41.83473,-87.62581
13215,2,9,false,6,4,-2,41.83634,-87.6135
TA1308000046,2,9,false,6,3,-3,41.83779,-87.65115
TA1309000055,2,9,false,9,21,12,41.8382,-87.64514
KA1503000038,2,9,false,6,4,-2,41.83845,-87.6354
TA1307000048,2,9,false,21,15,-6,41.83855,-87.60821
150,2,9,false,2,2,0,41.83855,-87.60821
TA1308000036,2,9,false,7,2,-5,41.83883,-87.62186
13213,2,9,false,3,4,1,41.84171,-87.62694
TA1307000139,2,9,false,5,4,-1,41.84205,-87.61698
15443,2,9,false,6,3,-3,41.84275,-87.63549
TA1307000153,2,9,false,3,2,-1,41.84358,-87.64538
15692,2,9,false,1,1,0,41.84404,-87.69531
TA1307000005,2,9,false,3,6,3,41.84569,-87.6225
TA1308000013,2,9,false,1,2,1,41.84719,-87.64681
281,2,9,false,3,1,-2,41.84847,-87.68513
TA1309000003,2,9,false,5,1,-4,41.84847,-87.68512
TA1308000026,2,9,false,2,1,-1,41.85008,-87.63214
TA1305000004,2,9,false,7,20,13,41.8514,-87.61884
42,2,9,false,1,1,0,41.85261,-87.62653
TA1305000001,2,9,false,9,8,-1,41.85262,-87.6265
13075,2,9,false,4,5,1,41.8531,-87.63192
120,2,9,false,1,4,3,41.8531,-87.63191
15686,2,9,false,1,1,0,41.85354,-87.70507
13162,2,9,false,3,6,3,41.85378,-87.64659
13096,2,9,false,2,2,0,41.8538,-87.69577
203,2,9,false,2,1,-1,41.85409,-87.68585
13091,2,9,false,1,1,0,41.85409,-87.68585
15546,2,9,false,7,3,-4,41.85416,-87.61916
13307,2,9,false,6,3,-3,41.85489,-87.66359
13089,2,9,false,3,2,-1,41.85497,-87.67567
13331,2,9,false,4,2,-2,41.85515,-87.65414
15545,2,9,false,17,13,-4,41.85627,-87.61334
SL-013,2,9,false,4,3,-1,41.85659,-87.62755
SL-006,2,9,false,2,3,1,41.8568,-87.63387
129,2,9,false,1,2,1,41.85752,-87.66158
13135,2,9,false,8,8,0,41.85753,-87.66157
338,2,9,false,1,1,0,41.85758,-87.61956
13102,2,9,false,21,7,-14,41.85762,-87.61942
13150,2,9,false,14,5,-9,41.85783,-87.62455
273,2,9,false,4,2,-2,41.85783,-87.62455
13099,2,9,false,5,4,-1,41.85784,-87.64627
TA1307000159,2,9,false,1,10,9,41.8579,-87.6687
TA1307000044,2,9,false,4,2,-2,41.85794,-87.64083
13163,2,9,false,3,4,1,41.85808,-87.65108
13164,2,9,false,11,3,-8,41.85818,-87.65648
SL-012,2,9,false,9,13,4,41.86038,-87.62581
13304,2,9,false,16,6,-10,41.86126,-87.65659
KA1504000109,2,9,false,4,6,2,41.86192,-87.69347
TA1306000002,2,9,false,5,3,-2,41.86238,-87.65108
TA1307000124,2,9,false,13,19,6,41.86411,-87.62372
168,2,9,false,1,3,2,41.86415,-87.62372
282,2,9,false,3,2,-1,41.86487,-87.64708
TA1309000001,2,9,false,10,6,-4,41.86488,-87.64708
13165,2,9,false,1,2,1,41.86505,-87.65697
13354,2,9,false,1,4,3,41.86524,-87.66651
13431,2,9,false,7,12,5,41.8661,-87.60728
15682,2,9,false,1,2,1,41.86651,-87.70649
WL-008,2,9,false,36,15,-21,41.86712,-87.64108
TA1305000002,2,9,false,43,22,-21,41.86721,-87.62597
59,2,9,false,6,4,-2,41.86721,-87.62597
15544,2,9,false,18,69,51,41.86723,-87.61536
TA1305000017,2,9,false,2,19,17,41.86734,-87.64863
KA1706005007,2,9,false,5,5,0,41.86749,-87.63219
SL-005,2,9,false,29,23,-6,41.8679,-87.62304
255,2,9,false,5,2,-3,41.86791,-87.62304
644,2,9,false,7,2,-5,41.86859,-87.68625
13139,2,9,false,3,3,0,41.86893,-87.65913
13285,2,9,false,7,9,2,41.86928,-87.67372
22,2,9,false,3,1,-2,41.86947,-87.65548
13160,2,9,false,4,4,0,41.86947,-87.65548
15550,2,9,false,2,5,3,41.87024,-87.63947
TA1309000010,2,9,false,24,14,-10,41.87074,-87.62574
SL-009,2,9,false,2,4,2,41.87081,-87.63121
TA1309000064,2,9,false,8,8,0,41.87127,-87.67369
TA1307000130,2,9,false,5,13,8,41.87178,-87.65103
TA1307000121,2,9,false,8,9,1,41.87184,-87.64664
41,2,9,false,1,1,0,41.87209,-87.62957
SL-008,2,9,false,17,15,-2,41.87209,-87.62956
13332,2,9,false,15,3,-12,41.87219,-87.6615
175,2,9,false,1,2,1,41.87255,-87.63359
SL-011,2,9,false,16,13,-3,41.87256,-87.63356
623,2,9,false,66,26,-40,41.87272,-87.62399
KA1504000104,2,9,false,4,11,7,41.87296,-87.66912
383,2,9,false,1,3,2,41.87297,-87.66912
SL-007,2,9,false,14,12,-2,41.87404,-87.6277
169,2,9,false,1,1,0,41.87424,-87.63959
13326,2,9,false,3,4,1,41.87425,-87.63958
321,2,9,false,5,6,1,41.87427,-87.63257
535,2,9,false,1,1,0,41.87433,-87.72582
TA1306000025,2,9,false,11,1,-10,41.87464,-87.65703
15668,2,9,false,4,1,-3,41.87471,-87.68642
13028,2,9,false,13,6,-7,41.87475,-87.64981
13081,2,9,false,2,2,0,41.87501,-87.67326
89,2,9,false,2,1,-1,41.87501,-87.6331
SL-010,2,9,false,1,5,4,41.87501,-87.63309
15541,2,9,false,17,9,-8,41.8758,-87.62086
13037,2,9,false,4,4,0,41.87588,-87.64078
TA1305000009,2,9,false,10,2,-8,41.87593,-87.63068
317,2,9,false,4,5,1,41.87603,-87.68195
TA1305000010,2,9,false,10,10,0,41.87623,-87.62444
624,2,9,false,17,19,2,41.87626,-87.62923
2,2,9,false,2,1,-1,41.87649,-87.62051
TA1305000035,2,9,false,21,16,-5,41.87716,-87.62787
13138,2,9,false,4,5,1,41.87723,-87.63941
631,2,9,false,5,1,-4,41.87761,-87.6739
15539,2,9,false,5,5,0,41.87763,-87.64405
13158,2,9,false,17,14,-3,41.87764,-87.64957
134,2,9,false,1,3,2,41.87764,-87.64954
21,2,9,false,1,1,0,41.87773,-87.6548
13157,2,9,false,8,10,2,41.87773,-87.6548
TA1305000025,2,9,false,16,45,29,41.87773,-87.63528
36,2,9,false,1,3,2,41.87776,-87.63525
284,2,9,false,1,5,4,41.87784,-87.62408
TA1309000002,2,9,false,7,11,4,41.87784,-87.62408
13206,2,9,false,4,2,-2,41.87794,-87.66201
TA1309000004,2,9,false,13,12,-1,41.87811,-87.63184
107,2,9,false,1,3,2,41.87822,-87.644
638,2,9,false,6,13,7,41.87827,-87.64078
TA1305000005,2,9,false,9,15,6,41.87924,-87.62975
13011,2,9,false,13,21,8,41.87931,-87.63993
TA1309000008,2,9,false,10,9,-1,41.87933,-87.6355
KA1503000034,2,9,false,13,4,-9,41.87938,-87.63197
39,2,9,false,2,4,2,41.87948,-87.62571
KA1503000015,2,9,false,11,17,6,41.87948,-87.6257
15667,2,9,false,2,1,-1,41.8798,-87.68609
16916,2,9,false,1,1,0,41.88012,-87.76323
540,2,9,false,1,1,0,41.88022,-87.75536
TA1309000007,2,9,false,18,39,21,41.88022,-87.63526
WL-011,2,9,false,16,10,-6,41.88034,-87.64273
80,2,9,false,1,1,0,41.88042,-87.65556
13156,2,9,false,7,6,-1,41.88042,-87.65554
13300,2,9,false,47,34,-13,41.88097,-87.61675
76,2,9,false,2,2,0,41.88098,-87.61675
13008,2,9,false,54,41,-13,41.88105,-87.62408
90,2,9,false,6,2,-4,41.88107,-87.62409
TA1305000006,2,9,false,12,21,9,41.88122,-87.6296
13134,2,9,false,2,2,0,41.88138,-87.67493
215,2,9,false,2,1,-1,41.88139,-87.67492
13056,2,9,false,5,13,8,41.88168,-87.63951
TA1307000120,2,9,false,26,16,-10,41.88188,-87.64879
13341,2,9,false,17,29,12,41.88208,-87.63985
174,2,9,false,1,4,3,41.88208,-87.63984
13036,2,9,false,14,20,6,41.8821,-87.62513
77,2,9,false,4,4,0,41.88214,-87.64108
TA1305000032,2,9,false,18,25,7,41.88218,-87.64109
98,2,9,false,1,2,1,41.88266,-87.63251
13006,2,9,false,15,22,7,41.88268,-87.63252
13353,2,9,false,2,10,8,41.88283,-87.6612
654,2,9,false,8,5,-3,41.88307,-87.65698
233,2,9,false,1,1,0,41.88309,-87.6511
13409,2,9,false,14,21,7,41.8831,-87.6511
18,2,9,false,1,3,2,41.88317,-87.63735
KA1503000072,2,9,false,18,22,4,41.88317,-87.63693
91,2,9,false,3,2,-1,41.88336,-87.64122
WL-012,2,9,false,44,22,-22,41.88337,-87.6412
13053,2,9,false,16,27,11,41.88365,-87.64863
43,2,9,false,3,9,6,41.88396,-87.62455
13001,2,9,false,42,43,1,41.88397,-87.62459
13155,2,9,false,6,9,3,41.88407,-87.65689
621,2,9,false,1,1,0,41.88412,-87.65427
18062,2,9,false,5,14,9,41.88412,-87.65427
81,2,9,false,3,9,6,41.88417,-87.6296
TA1306000010,2,9,false,24,33,9,41.88419,-87.62961
15666,2,9,false,1,2,1,41.88446,-87.6963
TA1305000030,2,9,false,27,29,2,41.88459,-87.63178
96,2,9,false,1,3,2,41.8846,-87.64455
15535,2,9,false,10,16,6,41.8846,-87.64455
51,2,9,false,1,3,2,41.88462,-87.63176
TA1305000029,2,9,false,28,30,2,41.88466,-87.62787
195,2,9,false,1,2,1,41.88466,-87.61952
13263,2,9,false,15,15,0,41.88467,-87.61952
44,2,9,false,3,3,0,41.88468,-87.62782
TA1306000015,2,9,false,15,32,17,41.88549,-87.65232
13021,2,9,false,18,27,9,41.88559,-87.64184
TA1307000111,2,9,false,13,15,2,41.88582,-87.63548
164,2,9,false,2,1,-1,41.88583,-87.63547
13073,2,9,false,11,9,-2,41.88592,-87.66717
KA17018054,2,9,false,2,6,4,41.88595,-87.67701
38,2,9,false,2,5,3,41.88599,-87.63089
KA1503000012,2,9,false,18,31,13,41.88599,-87.63089
52,2,9,false,4,7,3,41.886,-87.62421
TA1305000011,2,9,false,51,46,-5,41.886,-87.62418
7,2,9,false,6,2,-4,41.88627,-87.61751
15534,2,9,false,11,10,-1,41.88627,-87.61749
217,2,9,false,1,1,0,41.8866,-87.65821
13197,2,9,false,12,8,-4,41.8866,-87.65816
TA1308000029,2,9,false,36,16,-20,41.88673,-87.62225
TA1307000131,2,9,false,41,13,-28,41.88688,-87.62606
194,2,9,false,2,2,0,41.88688,-87.62606
6,2,9,false,6,2,-4,41.88697,-87.61281
KA1503000064,2,9,false,21,21,0,41.88697,-87.61281
100,2,9,false,3,2,-1,41.88814,-87.63657
TA1305000022,2,9,false,38,37,-1,41.88817,-87.63656
56,2,9,false,4,2,-2,41.88866,-87.64442
TA1306000003,2,9,false,22,10,-12,41.88867,-87.64442
KA1503000043,2,9,false,27,23,-4,41.88918,-87.63851
133,2,9,false,8,5,-3,41.88918,-87.63851
13050,2,9,false,27,26,-1,41.88919,-87.62775
47,2,9,false,1,4,3,41.88921,-87.62775
15664,2,9,false,1,1,0,41.8895,-87.68821
13432,2,9,false,5,6,1,41.88989,-87.67149
TA1307000151,2,9,false,33,43,10,41.88993,-87.63427
212,2,9,false,4,5,1,41.88995,-87.63427
636,2,9,false,14,10,-4,41.88997,-87.63662
125,2,9,false,1,5,4,41.89018,-87.62621
KA1503000044,2,9,false,12,23,11,41.89018,-87.6262
196,2,9,false,1,5,4,41.89053,-87.62205
13427,2,9,false,14,18,4,41.89054,-87.62205
13430,2,9,false,21,33,12,41.89077,-87.63169
181,2,9,false,1,6,5,41.89077,-87.63168
TA1306000013,2,9,false,22,28,6,41.89083,-87.61852
RN-,2,9,false,23,14,-9,41.89102,-87.63546
277,2,9,false,1,1,0,41.89108,-87.66665
13434,2,9,false,10,7,-3,41.89108,-87.66663
TA1308000006,2,9,false,9,9,0,41.89128,-87.67686
199,2,9,false,4,5,1,41.89143,-87.62676
TA1307000117,2,9,false,39,25,-14,41.89144,-87.62675
13033,2,9,false,11,16,5,41.8916,-87.64835
84,2,9,false,1,3,2,41.89161,-87.64833
13194,2,9,false,8,7,-1,41.8918,-87.65878
TA1305000003,2,9,false,31,37,6,41.89187,-87.62061
24,2,9,false,1,2,1,41.8919,-87.62063
643,2,9,false,2,1,-1,41.89203,-87.68939
35,2,9,false,3,9,6,41.89227,-87.61206
13022,2,9,false,82,63,-19,41.89227,-87.61205
TA1306000029,2,9,false,24,25,1,41.89256,-87.61449
13265,2,9,false,23,18,-5,41.89383,-87.64172
13045,2,9,false,35,29,-6,41.89403,-87.62931
110,2,9,false,1,5,4,41.89406,-87.6293
13016,2,9,false,65,36,-29,41.89431,-87.62277
211,2,9,false,5,13,8,41.89439,-87.62267
KA1503000041,2,9,false,46,30,-16,41.89452,-87.61798
142,2,9,false,1,5,4,41.89453,-87.61806
13196,2,9,false,16,5,-11,41.89455,-87.65345
TA1307000062,2,9,false,23,12,-11,41.89466,-87.63839
676,2,9,false,1,1,0,41.89475,-87.73085
TA1306000012,2,9,false,38,36,-2,41.89475,-87.63438
53,2,9,false,6,4,-2,41.89476,-87.63439
KP1705001026,2,9,false,29,16,-13,41.89483,-87.6323
16921,2,9,false,1,1,0,41.89488,-87.77459
KA1504000114,2,9,false,2,1,-1,41.89547,-87.70614
18058,2,9,false,4,2,-2,41.8955,-87.68201
659,2,9,false,1,1,0,41.8955,-87.68201
637,2,9,false,13,3,-10,41.89563,-87.67209
128,2,9,false,3,1,-2,41.89571,-87.67716
13132,2,9,false,22,7,-15,41.89573,-87.67718
161,2,9,false,4,3,-1,41.89574,-87.62599
15530,2,9,false,20,19,-1,41.89575,-87.62596
18003,2,9,false,26,8,-18,41.89575,-87.62011
635,2,9,false,1,1,0,41.89576,-87.62012
13247,2,9,false,13,12,-1,41.89597,-87.66775
350,2,9,false,2,5,3,41.89597,-87.66774
TA1305000020,2,9,false,25,10,-15,41.89636,-87.65406
54,2,9,false,4,3,-1,41.89637,-87.65407
13289,2,9,false,5,6,1,41.89638,-87.661
337,2,9,false,1,2,1,41.89659,-87.63096
13303,2,9,false,16,15,-1,41.89672,-87.63088
13017,2,9,false,20,16,-4,41.89676,-87.6357
31,2,9,false,2,1,-1,41.89677,-87.63572
13338,2,9,false,23,18,-5,41.89697,-87.62173
173,2,9,false,1,5,4,41.89704,-87.62173
TA1307000061,2,9,false,15,16,1,41.89745,-87.62873
106,2,9,false,2,2,0,41.89746,-87.62874
13034,2,9,false,12,15,3,41.89754,-87.62352
48,2,9,false,1,3,2,41.89772,-87.64302
TA1306000009,2,9,false,24,47,23,41.89772,-87.64299
620,2,9,false,21,28,7,41.89817,-87.63754
KA1504000103,2,9,false,20,3,-17,41.89842,-87.68659
374,2,9,false,2,1,-1,41.89842,-87.68659
145,2,9,false,1,1,0,41.89856,-87.62211
15529,2,9,false,27,25,-2,41.89858,-87.62206
140,2,9,false,5,3,-2,41.89895,-87.6299
TA1307000128,2,9,false,20,19,-1,41.89896,-87.6299
657,2,9,false,10,4,-6,41.89918,-87.6722
KA1504000117,2,9,false,1,2,1,41.89936,-87.64848
13248,2,9,false,4,2,-2,41.89964,-87.66788
46,2,9,false,4,4,0,41.89994,-87.63444
TA1306000011,2,9,false,17,4,-13,41.89994,-87.63443
364,2,9,false,3,1,-2,41.90023,-87.64299
KA1504000116,2,9,false,9,8,-1,41.90023,-87.64299
17660,2,9,false,4,1,-3,41.90036,-87.69671
13290,2,9,false,7,5,-2,41.90069,-87.66259
29,2,9,false,2,2,0,41.90069,-87.66259
13042,2,9,false,77,70,-7,41.90097,-87.62377
85,2,9,false,5,5,0,41.90098,-87.62375
183,2,9,false,2,2,0,41.90133,-87.67744
TA1307000070,2,9,false,6,4,-2,41.90133,-87.67742
KA1504000133,2,9,false,23,30,7,41.90234,-87.62773
172,2,9,false,1,3,2,41.90236,-87.62774
15654,2,9,false,4,1,-3,41.90271,-87.70923
305,2,9,false,4,1,-3,41.9028,-87.69005
13241,2,9,false,8,3,-5,41.9029,-87.68731
176,2,9,false,3,1,-2,41.90291,-87.63141
TA1306000006,2,9,false,5,8,3,41.90292,-87.63772
TA1307000039,2,9,false,27,47,20,41.90294,-87.63137
658,2,9,false,9,3,-6,41.903,-87.6838
13256,2,9,false,2,5,3,41.90302,-87.69749
TA1305000034,2,9,false,15,9,-6,41.90313,-87.67391
17,2,9,false,1,1,0,41.90313,-87.67391
182,2,9,false,7,5,-2,41.90317,-87.63442
KA1504000135,2,9,false,28,31,3,41.90319,-87.63439
13136,2,9,false,17,11,-6,41.90326,-87.67845
13061,2,9,false,21,14,-7,41.90342,-87.66779
KA1504000079,2,9,false,9,7,-2,41.9035,-87.64334
TA1307000115,2,9,false,7,4,-3,41.9046,-87.64056
291,2,9,false,5,5,0,41.90672,-87.63494
TA1308000049,2,9,false,18,19,1,41.90672,-87.6349
KA1504000134,2,9,false,21,15,-6,41.90687,-87.6262
180,2,9,false,2,1,-1,41.90687,-87.62618
13224,2,9,false,16,6,-10,41.90706,-87.66725
TA1307000143,2,9,false,10,5,-5,41.90762,-87.63854
61,2,9,false,3,2,-1,41.90764,-87.67254
13221,2,9,false,9,5,-4,41.90765,-87.67254
13245,2,9,false,4,4,0,41.90777,-87.68586
TA1309000024,2,9,false,11,14,3,41.908,-87.63152
69,2,9,false,1,4,3,41.90939,-87.6777
TA1305000041,2,9,false,21,14,-7,41.9094,-87.67769
15652,2,9,false,2,2,0,41.90965,-87.71664
331,2,9,false,16,18,2,41.90965,-87.64812
TA1305000037,2,9,false,5,14,9,41.91018,-87.67003
27,2,9,false,1,1,0,41.91019,-87.6435
TA1306000008,2,9,false,7,6,-1,41.9102,-87.6435
16,2,9,false,2,2,0,41.91035,-87.67008
213,2,9,false,2,2,0,41.91037,-87.68237
TA1308000005,2,9,false,11,8,-3,41.91042,-87.68238
13258,2,9,false,8,7,-1,41.91043,-87.69718
13257,2,9,false,19,5,-14,41.91054,-87.68956
13154,2,9,false,12,10,-2,41.91054,-87.65312
13058,2,9,false,4,8,4,41.91059,-87.64942
TA1307000038,2,9,false,18,4,-14,41.91138,-87.63868
118,2,9,false,2,1,-1,41.91138,-87.63868
LF-005,2,9,false,28,20,-8,41.91172,-87.62681
268,2,9,false,5,3,-2,41.91172,-87.62681
13128,2,9,false,12,14,2,41.91197,-87.63197
289,2,9,false,1,3,2,41.91209,-87.63472
TA1308000050,2,9,false,39,30,-9,41.91211,-87.6347
13243,2,9,false,10,12,2,41.91262,-87.6814
TA1309000032,2,9,false,3,4,1,41.91293,-87.66417
TA1306000032,2,9,false,11,6,-5,41.9137,-87.65285
93,2,9,false,2,2,0,41.91371,-87.65285
TA1307000166,2,9,false,5,5,0,41.91386,-87.64877
15655,2,9,false,14,8,-6,41.91401,-87.70514
18017,2,9,false,3,5,2,41.91416,-87.71676
18067,2,9,false,9,6,-3,41.9146,-87.66796
TA1306000007,2,9,false,2,3,1,41.91469,-87.64333
13068,2,9,false,4,15,11,41.91554,-87.68703
116,2,9,false,3,1,-2,41.91555,-87.68703
13179,2,9,false,17,18,1,41.9157,-87.63461
141,2,9,false,3,3,0,41.91571,-87.63461
13133,2,9,false,11,6,-5,41.91598,-87.67733
TA1305000039,2,9,false,20,11,-9,41.9163,-87.66749
15650,2,9,false,5,2,-3,41.91711,-87.71023
15651,2,9,false,2,4,2,41.91752,-87.70181
13266,2,9,false,4,5,1,41.91774,-87.69142
TA1309000029,2,9,false,8,4,-4,41.9178,-87.68245
309,2,9,false,1,1,0,41.91789,-87.6865
TA1309000006,2,9,false,8,4,-4,41.91809,-87.64375
288,2,9,false,1,1,0,41.91809,-87.64375
223,2,9,false,1,1,0,41.91821,-87.65698
TA1307000163,2,9,false,9,13,4,41.91821,-87.65696
94,2,9,false,3,1,-2,41.91831,-87.6363
13146,2,9,false,21,20,-1,41.91831,-87.63629
13059,2,9,false,15,14,-1,41.91845,-87.65222
113,2,9,false,6,1,-5,41.91846,-87.65222
13259,2,9,false,5,2,-3,41.91852,-87.69744
13192,2,9,false,11,11,0,41.91995,-87.64884
225,2,9,false,1,2,1,41.91995,-87.64884
13288,2,9,false,6,2,-4,41.92008,-87.67788
13242,2,9,false,3,8,5,41.92021,-87.69266
TA1309000030,2,9,false,8,14,6,41.92077,-87.66372
13292,2,9,false,9,3,-6,41.92152,-87.70733
TA1309000033,2,9,false,13,18,5,41.92158,-87.65381
13193,2,9,false,19,19,0,41.92182,-87.64412
144,2,9,false,7,4,-3,41.92182,-87.64411
13191,2,9,false,19,19,0,41.92217,-87.63891
13084,2,9,false,10,10,0,41.92268,-87.69715
LP-,2,9,false,7,10,3,41.92396,-87.63584
673,2,9,false,2,1,-1,41.92398,-87.63585
KA1504000140,2,9,false,5,8,3,41.92409,-87.67646
16010,2,9,false,2,3,1,41.92458,-87.72787
15648,2,9,false,9,1,-8,41.92464,-87.68931
KA1504000090,2,9,false,5,1,-4,41.92483,-87.7145
TA1307000001,2,9,false,8,1,-7,41.92535,-87.66581
TA1306000026,2,9,false,9,14,5,41.92558,-87.65842
87,2,9,false,1,2,1,41.92559,-87.65843
TA1306000016,2,9,false,11,15,4,41.9256,-87.65371
313,2,9,false,5,1,-4,41.9257,-87.64246
TA1309000019,2,9,false,25,21,-4,41.92586,-87.63897
TA1309000058,2,9,false,19,20,1,41.92591,-87.64927
127,2,9,false,1,2,1,41.92592,-87.64927
TA1308000001,2,9,false,26,26,0,41.92627,-87.63086
15646,2,9,false,4,4,0,41.92668,-87.6977
13124,2,9,false,7,6,-1,41.92675,-87.63444
TA1309000023,2,9,false,14,13,-1,41.9287,-87.65383
TA1307000113,2,9,false,8,2,-6,41.92878,-87.66391
190,2,9,false,1,1,0,41.92878,-87.6639
166,2,9,false,1,2,1,41.92883,-87.66853
13296,2,9,false,11,4,-7,41.92883,-87.66852
343,2,9,false,1,3,2,41.92889,-87.65898
TA1309000059,2,9,false,4,6,2,41.92889,-87.65898
349,2,9,false,1,1,0,41.92915,-87.6491
TA1309000061,2,9,false,10,12,2,41.92915,-87.64909
TA1308000031,2,9,false,6,13,7,41.92946,-87.68417
340,2,9,false,5,1,-4,41.92956,-87.64313
TA1305000014,2,9,false,14,24,10,41.92956,-87.64313
260,2,9,false,2,3,1,41.92958,-87.70791
13085,2,9,false,7,11,4,41.92958,-87.70789
TA1307000142,2,9,false,27,19,-8,41.93125,-87.64432
220,2,9,false,2,2,0,41.93125,-87.64431
13276,2,9,false,22,13,-9,41.93132,-87.63874
163,2,9,false,1,2,1,41.93191,-87.67784
13271,2,9,false,3,8,5,41.93192,-87.67784
152,2,9,false,1,3,2,41.93221,-87.65864
TA1307000064,2,9,false,17,13,-4,41.93222,-87.65864
TA1306000014,2,9,false,15,16,1,41.93242,-87.65271
TA1309000039,2,9,false,23,13,-10,41.93258,-87.63642
13294,2,9,false,9,4,-5,41.9326,-87.66595
319,2,9,false,1,1,0,41.93292,-87.67217
TA1309000036,2,9,false,3,10,7,41.93313,-87.64776
15644,2,9,false,3,6,3,41.93534,-87.71687
TA1307000006,2,9,false,14,14,0,41.93571,-87.6636
153,2,9,false,1,5,4,41.93575,-87.66364
13268,2,9,false,4,3,-1,41.93588,-87.67843
13269,2,9,false,9,10,1,41.93609,-87.66983
TA1307000052,2,9,false,14,7,-7,41.93628,-87.65266
115,2,9,false,1,1,0,41.93628,-87.65266
156,2,9,false,2,2,0,41.9365,-87.64756
TA1307000136,2,9,false,15,13,-2,41.9365,-87.64755
TA1307000041,2,9,false,26,15,-11,41.93669,-87.63683
157,2,9,false,2,1,-1,41.9367,-87.63683
13137,2,9,false,21,31,10,41.9376,-87.6441
300,2,9,false,3,1,-2,41.93761,-87.6441
154,2,9,false,1,2,1,41.93912,-87.66384
KA17018068,2,9,false,6,1,-5,41.93935,-87.68327
TA1309000042,2,9,false,9,7,-2,41.93937,-87.66836
131,2,9,false,3,2,-1,41.93937,-87.66835
KA150400009X,2,9,false,1,4,3,41.9394,-87.71159
15640,2,9,false,4,2,-2,41.93941,-87.72357
13229,2,9,false,14,29,15,41.93946,-87.66376
226,2,9,false,1,2,1,41.93972,-87.65886
TA1308000019,2,9,false,13,9,-4,41.93973,-87.65886
296,2,9,false,7,1,-6,41.9401,-87.64546
13277,2,9,false,13,19,6,41.9401,-87.64546
TA1307000134,2,9,false,5,26,21,41.94016,-87.65303
117,2,9,false,1,4,3,41.94016,-87.65302
13143,2,9,false,5,2,-3,41.94059,-87.67853
334,2,9,false,2,4,2,41.94076,-87.63919
TA1309000049,2,9,false,42,16,-26,41.94077,-87.63919
15634,2,9,false,4,2,-2,41.94304,-87.68729
TA1307000138,2,9,false,9,10,1,41.94334,-87.67094
13144,2,9,false,7,9,2,41.9434,-87.67964
TA1309000025,2,9,false,19,11,-8,41.94368,-87.64894
299,2,9,false,5,6,1,41.94368,-87.64894
229,2,9,false,2,1,-1,41.94372,-87.66401
13071,2,9,false,17,13,-4,41.94373,-87.66401
632,2,9,false,21,13,-8,41.94453,-87.6547
303,2,9,false,3,2,-1,41.94522,-87.64702
15631,2,9,false,5,2,-3,41.94524,-87.70665
13278,2,9,false,33,17,-16,41.94553,-87.64644
15632,2,9,false,3,2,-1,41.94664,-87.69463
227,2,9,false,5,2,-3,41.94813,-87.66397
13235,2,9,false,11,18,7,41.94814,-87.66396
304,2,9,false,3,6,3,41.94878,-87.64922
13253,2,9,false,7,2,-5,41.9488,-87.67527
13325,2,9,false,18,9,-9,41.94907,-87.64863
114,2,9,false,2,2,0,41.94935,-87.65451
TA1307000126,2,9,false,14,6,-8,41.94936,-87.65451
TA1307000150,2,9,false,20,5,-15,41.94945,-87.64646
18016,2,9,false,1,2,1,41.94993,-87.71395
13319,2,9,false,10,11,1,41.95069,-87.6687
TA1307000127,2,9,false,7,24,17,41.9508,-87.65918
13323,2,9,false,23,15,-8,41.95282,-87.65
256,2,9,false,4,2,-2,41.95282,-87.65
15624,2,9,false,4,2,-2,41.95339,-87.73199
KA1504000139,2,9,false,3,2,-1,41.954,-87.71909
TA1309000043,2,9,false,10,6,-4,41.95417,-87.66434
13063,2,9,false,14,15,1,41.95424,-87.65441
KA1504000158,2,9,false,5,3,-2,41.95432,-87.68607
TA1308000022,2,9,false,19,6,-13,41.95438,-87.64805
TA1307000149,2,9,false,11,6,-5,41.95467,-87.67392
TA1309000026,2,9,false,4,3,-1,41.95601,-87.6802
13249,2,9,false,4,2,-2,41.95606,-87.66885
312,2,9,false,2,2,0,41.95637,-87.6563
TA1308000047,2,9,false,6,3,-3,41.95709,-87.6642
292,2,9,false,1,1,0,41.95709,-87.6642
13379,2,9,false,13,7,-6,41.95786,-87.6495
TA1309000018,2,9,false,1,3,2,41.95791,-87.67357
306,2,9,false,1,1,0,41.9585,-87.655
TA1309000027,2,9,false,19,6,-13,41.9585,-87.65499
13389,2,9,false,15,8,-7,41.961,-87.64958
15621,2,9,false,1,3,2,41.96103,-87.70586
15622,2,9,false,1,5,4,41.96108,-87.69544
TA1307000144,2,9,false,4,6,2,41.96142,-87.6762
TA1309000021,2,9,false,2,2,0,41.9615,-87.6714
KA1503000022,2,9,false,7,2,-5,41.96158,-87.66609
231,2,9,false,3,3,0,41.96163,-87.65464
TA1307000107,2,9,false,23,15,-8,41.96164,-87.65464
TA1307000156,2,9,false,3,1,-2,41.96301,-87.68479
TA1309000012,2,9,false,2,2,0,41.96325,-87.67928
TA1308000012,2,9,false,13,14,1,41.96398,-87.63818
13074,2,9,false,17,13,-4,41.96521,-87.6582
639,2,9,false,11,5,-6,41.96584,-87.64538
KA1504000127,2,9,false,1,2,1,41.96587,-87.70083
KA1504000093,2,9,false,1,2,1,41.96587,-87.69365
TA1307000140,2,9,false,5,9,4,41.96643,-87.68865
239,2,9,false,1,1,0,41.9665,-87.68843
TA1309000014,2,9,false,13,5,-8,41.96709,-87.66744
TA1307000158,2,9,false,6,9,3,41.9671,-87.67904
TA1307000119,2,9,false,6,4,-2,41.96796,-87.65
15615,2,9,false,1,3,2,41.96835,-87.71183
TA1308000021,2,9,false,5,7,2,41.96883,-87.65765
TA1309000066,2,9,false,15,8,-7,41.9691,-87.67423
344,2,9,false,1,2,1,41.9691,-87.67423
TA1309000041,2,9,false,9,4,-5,41.96951,-87.65471
KA1504000171,2,9,false,6,3,-3,41.97161,-87.65016
325,2,9,false,3,2,-1,41.9728,-87.67186
TA1309000035,2,9,false,9,6,-3,41.97335,-87.66785
13108,2,9,false,10,7,-3,41.97379,-87.65971
KA1504000078,2,9,false,4,2,-2,41.97491,-87.69258
KA1504000149,2,9,false,6,2,-4,41.97562,-87.67945
KA1504000160,2,9,false,1,1,0,41.97564,-87.70143
KA1504000146,2,9,false,6,8,2,41.978,-87.66805
13109,2,9,false,4,11,7,41.97835,-87.65976
KA1504000147,2,9,false,3,2,-1,41.97976,-87.67754
655,2,9,false,1,2,1,41.97987,-87.68194
KA1504000151,2,9,false,12,12,0,41.98359,-87.66916
KA1504000152,2,9,false,21,16,-5,41.98403,-87.65231
459,2,9,false,2,1,-1,41.98403,-87.65231
15578,2,9,false,6,1,-5,41.98405,-87.66027
15575,2,9,false,9,8,-1,41.98975,-87.66014
458,2,9,false,1,3,2,41.98975,-87.66013
KA1504000148,2,9,false,1,5,4,41.99086,-87.66971
KA1504000155,2,9,false,1,1,0,41.99118,-87.68359
KA1504000129,2,9,false,2,4,2,41.99417,-87.68945
15571,2,9,false,12,3,-9,41.99478,-87.66028
KA1504000156,2,9,false,1,3,2,41.99925,-87.67137
RP-009,2,9,false,6,7,1,42.00107,-87.66122
RP-001,2,9,false,5,1,-4,42.00179,-87.68883
RP-002,2,9,false,1,3,2,42.00456,-87.68065
660,2,9,false,9,5,-4,42.00458,-87.66143
KA1504000175,2,9,false,7,6,-1,42.00797,-87.66549
RP-005,2,9,false,2,3,1,42.0086,-87.69047
525,2,9,false,1,2,1,42.01272,-87.66605
517,2,9,false,3,2,-1,42.01597,-87.675
520,2,9,false,5,6,1,42.01597,-87.66859
527,2,9,false,2,1,-1,42.01892,-87.69004
515,2,9,false,2,4,2,42.01915,-87.67356
514,2,9,false,7,1,-6,42.01927,-87.68452
523,2,9,false,1,2,1,42.02089,-87.66505
598,2,9,false,2,3,1,42.02578,-87.68411
E002,2,9,false,1,6,5,42.03256,-87.67912
596,2,9,false,10,11,1,42.04822,-87.68348
600,2,9,false,1,2,1,42.04831,-87.6983
E008,2,9,false,2,3,1,42.05049,-87.67782
605,2,9,false,2,1,-1,42.05294,-87.67342
661,2,9,false,10,2,-8,42.05704,-87.68657
604,2,9,false,6,15,9,42.05824,-87.67744
E006,2,9,false,4,1,-3,42.06367,-87.69871
E007,2,9,false,2,2,0,42.06431,-87.68615
E014,2,9,false,5,1,-4,42.06483,-87.71531
20223,2,9,true,1,1,0,41.71272,-87.53472
20231,2,9,true,2,3,1,41.7368,-87.58282
588,2,9,true,1,1,0,41.74392,-87.57522
583,2,9,true,2,2,0,41.74656,-87.58599
577,2,9,true,1,1,0,41.75117,-87.58534
576,2,9,true,1,1,0,41.75129,-87.59752
KA1503000019,2,9,true,1,1,0,41.75867,-87.5869
KA1503000020,2,9,true,1,2,1,41.76223,-87.55923
KA1503000002,2,9,true,6,4,-2,41.76641,-87.5657
KA1503000047,2,9,true,1,2,1,41.76929,-87.62821
KA1503000023,2,9,true,2,1,-1,41.77346,-87.58534
KA1503000029,2,9,true,2,1,-1,41.77364,-87.56747
KA1503000021,2,9,true,2,1,-1,41.77888,-87.58665
KA1503000054,2,9,true,1,1,0,41.78061,-87.60582
15491,2,9,true,1,1,0,41.78096,-87.57624
KA1503000033,2,9,true,1,1,0,41.78411,-87.61329
KA1503000014,2,9,true,94,47,-47,41.7851,-87.60108
426,2,9,true,9,14,5,41.7851,-87.60108
KA1503000070,2,9,true,19,22,3,41.78794,-87.58831
425,2,9,true,3,2,-1,41.78795,-87.58831
328,2,9,true,2,5,3,41.78872,-87.6013
TA1309000011,2,9,true,8,89,81,41.78873,-87.60131
423,2,9,true,2,33,31,41.79148,-87.59988
KA1503000071,2,9,true,14,136,122,41.79148,-87.59988
KA1503000075,2,9,true,3,3,0,41.79156,-87.60785
KA1503000074,2,9,true,9,6,-3,41.79174,-87.58395
TA1309000063,2,9,true,32,10,-22,41.79325,-87.5878
345,2,9,true,7,2,-5,41.79326,-87.5878
420,2,9,true,14,1,-13,41.79429,-87.60145
KA1504000076,2,9,true,50,97,47,41.7943,-87.60145
247,2,9,true,7,2,-5,41.79522,-87.58077
TA1308000009,2,9,true,40,18,-22,41.79522,-87.58075
TA1307000164,2,9,true,19,18,-1,41.79527,-87.59647
KA1503000052,2,9,true,30,5,-25,41.79935,-87.60097
418,2,9,true,5,3,-2,41.79936,-87.60097
KA1503000059,2,9,true,36,14,-22,41.79952,-87.58643
TA1309000037,2,9,true,49,13,-36,41.79957,-87.59474
15470,2,9,true,1,3,2,41.80228,-87.61807
417,2,9,true,6,1,-5,41.80242,-87.5869
KA1503000007,2,9,true,54,15,-39,41.80242,-87.58689
13398,2,9,true,36,6,-30,41.80256,-87.59035
121,2,9,true,9,3,-6,41.80256,-87.59035
TA1309000067,2,9,true,2,2,0,41.80303,-87.60661
322,2,9,true,8,11,3,41.80321,-87.59849
KA1503000069,2,9,true,7,2,-5,41.80579,-87.59247
KA1503000051,2,9,true,3,3,0,41.80815,-87.64563
16937,2,9,true,1,1,0,41.80887,-87.66453
267,2,9,true,1,1,0,41.80944,-87.59188
TA1308000035,2,9,true,4,7,3,41.80944,-87.59188
TA1308000002,2,9,true,11,5,-6,41.80983,-87.59937
TA1308000007,2,9,true,1,1,0,41.80984,-87.61628
TA1309000053,2,9,true,3,8,5,41.80985,-87.60675
271,2,9,true,2,2,0,41.81648,-87.60659
TA1308000023,2,9,true,2,3,1,41.81649,-87.60659
13083,2,9,true,5,2,-3,41.82167,-87.62153
TA1308000038,2,9,true,4,2,-2,41.82298,-87.6071
15449,2,9,true,1,7,6,41.82302,-87.62657
16932,2,9,true,1,1,0,41.82346,-87.66558
179,2,9,true,1,3,2,41.82458,-87.61678
13420,2,9,true,2,4,2,41.82459,-87.61678
18022,2,9,true,1,1,0,41.82672,-87.68315
TA1308000045,2,9,true,11,4,-7,41.83062,-87.64129
TA1308000043,2,9,true,3,5,2,41.83066,-87.64715
279,2,9,true,1,1,0,41.83067,-87.64715
15446,2,9,true,2,4,2,41.83068,-87.65603
KA1503000005,2,9,true,1,2,1,41.83079,-87.6325
184,2,9,true,1,1,0,41.83104,-87.62684
TA1307000129,2,9,true,13,24,11,41.83104,-87.62683
KA1503000004,2,9,true,3,1,-2,41.83127,-87.6088
13345,2,9,true,4,3,-1,41.83138,-87.61803
15445,2,9,true,7,13,6,41.83453,-87.63183
13216,2,9,true,11,90,79,41.83473,-87.62581
148,2,9,true,1,16,15,41.83474,-87.62581
149,2,9,true,3,1,-2,41.83486,-87.61791
13217,2,9,true,23,9,-14,41.83488,-87.61792
13215,2,9,true,5,4,-1,41.83634,-87.6135
TA1308000046,2,9,true,16,5,-11,41.83779,-87.65115
TA1309000055,2,9,true,22,18,-4,41.8382,-87.64514
KA1503000038,2,9,true,25,8,-17,41.83845,-87.6354
402,2,9,true,1,1,0,41.83845,-87.6354
150,2,9,true,4,3,-1,41.83855,-87.60821
TA1307000048,2,9,true,11,12,1,41.83855,-87.60821
272,2,9,true,2,5,3,41.83882,-87.62186
TA1308000036,2,9,true,36,16,-20,41.83883,-87.62186
KA1503000040,2,9,true,3,2,-1,41.84164,-87.65744
13213,2,9,true,4,9,5,41.84171,-87.62694
237,2,9,true,12,1,-11,41.84204,-87.61697
TA1307000139,2,9,true,59,20,-39,41.84205,-87.61698
15443,2,9,true,7,3,-4,41.84275,-87.63549
207,2,9,true,11,1,-10,41.84358,-87.64539
15692,2,9,true,2,2,0,41.84404,-87.69531
147,2,9,true,6,1,-5,41.84569,-87.62251
TA1307000005,2,9,true,12,13,1,41.84569,-87.6225
206,2,9,true,6,4,-2,41.84719,-87.64683
TA1308000013,2,9,true,4,16,12,41.84719,-87.64681
TA1309000003,2,9,true,6,6,0,41.84847,-87.68512
15689,2,9,true,9,4,-5,41.84912,-87.69515
TA1308000014,2,9,true,8,3,-5,41.84953,-87.64059
TA1308000026,2,9,true,2,11,9,41.85008,-87.63214
TA1305000004,2,9,true,5,3,-2,41.8514,-87.61884
42,2,9,true,2,1,-1,41.85261,-87.62653
TA1305000001,2,9,true,18,8,-10,41.85262,-87.6265
13075,2,9,true,6,30,24,41.8531,-87.63192
120,2,9,true,5,9,4,41.8531,-87.63191
13162,2,9,true,9,1,-8,41.85378,-87.64659
13096,2,9,true,8,8,0,41.8538,-87.69577
13091,2,9,true,20,3,-17,41.85409,-87.68585
203,2,9,true,4,1,-3,41.85409,-87.68585
370,2,9,true,3,1,-2,41.85415,-87.61917
15546,2,9,true,9,8,-1,41.85416,-87.61916
13307,2,9,true,7,3,-4,41.85489,-87.66359
13089,2,9,true,6,13,7,41.85497,-87.67567
13331,2,9,true,11,5,-6,41.85515,-87.65414
171,2,9,true,3,2,-1,41.85516,-87.65414
15545,2,9,true,35,32,-3,41.85627,-87.61334
4,2,9,true,5,5,0,41.85627,-87.61334
178,2,9,true,1,1,0,41.85657,-87.62755
SL-013,2,9,true,4,3,-1,41.85659,-87.62755
129,2,9,true,3,5,2,41.85752,-87.66158
13135,2,9,true,24,39,15,41.85753,-87.66157
338,2,9,true,9,3,-6,41.85758,-87.61956
13102,2,9,true,35,12,-23,41.85762,-87.61942
13150,2,9,true,35,19,-16,41.85783,-87.62455
273,2,9,true,7,3,-4,41.85783,-87.62455
13099,2,9,true,12,3,-9,41.85784,-87.64627
TA1307000159,2,9,true,36,14,-22,41.8579,-87.6687
205,2,9,true,7,2,-5,41.8579,-87.6687
170,2,9,true,1,5,4,41.85793,-87.64083
TA1307000044,2,9,true,22,10,-12,41.85794,-87.64083
13163,2,9,true,14,11,-3,41.85808,-87.65108
13164,2,9,true,38,12,-26,41.85818,-87.65648
15,2,9,true,8,1,-7,41.85819,-87.65648
SL-012,2,9,true,40,15,-25,41.86038,-87.62581
72,2,9,true,5,3,-2,41.86039,-87.62581
274,2,9,true,1,1,0,41.86126,-87.6566
13304,2,9,true,8,6,-2,41.86126,-87.65659
KA1504000109,2,9,true,1,8,7,41.86192,-87.69347
TA1306000002,2,9,true,20,17,-3,41.86238,-87.65108
137,2,9,true,1,1,0,41.86238,-87.65108
TA1307000124,2,9,true,51,30,-21,41.86411,-87.62372
168,2,9,true,10,8,-2,41.86415,-87.62372
282,2,9,true,2,4,2,41.86487,-87.64708
TA1309000001,2,9,true,35,19,-16,41.86488,-87.64708
136,2,9,true,1,1,0,41.86504,-87.65698
13165,2,9,true,2,1,-1,41.86505,-87.65697
275,2,9,true,2,2,0,41.86524,-87.66651
13354,2,9,true,4,9,5,41.86524,-87.66651
13029,2,9,true,7,10,3,41.86531,-87.6179
341,2,9,true,6,5,-1,41.86608,-87.60733
13431,2,9,true,9,12,3,41.8661,-87.60728
KA1504000101,2,9,true,5,2,-3,41.86651,-87.68466
KA1504000102,2,9,true,2,9,7,41.86664,-87.69453
WL-008,2,9,true,16,9,-7,41.86712,-87.64108
57,2,9,true,2,2,0,41.86712,-87.64107
TA1305000002,2,9,true,86,67,-19,41.86721,-87.62597
59,2,9,true,20,14,-6,41.86721,-87.62597
15544,2,9,true,20,25,5,41.86723,-87.61536
TA1305000017,2,9,true,14,28,14,41.86734,-87.64863
55,2,9,true,3,3,0,41.86735,-87.64863
626,2,9,true,5,5,0,41.86749,-87.63219
KA1706005007,2,9,true,9,16,7,41.86749,-87.63219
SL-005,2,9,true,79,18,-61,41.8679,-87.62304
255,2,9,true,24,4,-20,41.86791,-87.62304
644,2,9,true,21,8,-13,41.86859,-87.68625
19,2,9,true,1,4,3,41.86892,-87.65913
13139,2,9,true,31,7,-24,41.86893,-87.65913
13285,2,9,true,9,113,104,41.86928,-87.67372
13160,2,9,true,48,25,-23,41.86947,-87.65548
22,2,9,true,6,4,-2,41.86947,-87.65548
382,2,9,true,2,1,-1,41.8699,-87.68725
414,2,9,true,1,1,0,41.87023,-87.63947
15550,2,9,true,37,20,-17,41.87024,-87.63947
TA1309000010,2,9,true,45,45,0,41.87074,-87.62574
SL-009,2,9,true,20,2,-18,41.87081,-87.63121
342,2,9,true,3,16,13,41.87127,-87.6737
TA1309000064,2,9,true,40,95,55,41.87127,-87.67369
15542,2,9,true,9,40,31,41.87146,-87.64095
261,2,9,true,5,9,4,41.87151,-87.6699
TA1307000130,2,9,true,32,73,41,41.87178,-87.65103
241,2,9,true,5,15,10,41.8718,-87.65102
108,2,9,true,9,5,-4,41.87183,-87.64664
TA1307000121,2,9,true,71,76,5,41.87184,-87.64664
41,2,9,true,13,5,-8,41.87209,-87.62957
SL-008,2,9,true,47,36,-11,41.87209,-87.62956
13332,2,9,true,102,50,-52,41.87219,-87.6615
394,2,9,true,4,5,1,41.87226,-87.63484
175,2,9,true,2,3,1,41.87255,-87.63359
SL-011,2,9,true,28,36,8,41.87256,-87.63356
623,2,9,true,39,20,-19,41.87272,-87.62399
KA1504000104,2,9,true,38,93,55,41.87296,-87.66912
383,2,9,true,3,16,13,41.87297,-87.66912
320,2,9,true,17,7,-10,41.87327,-87.66402
5,2,9,true,8,5,-3,41.87403,-87.6277
SL-007,2,9,true,16,22,6,41.87404,-87.6277
169,2,9,true,2,1,-1,41.87424,-87.63959
13326,2,9,true,18,22,4,41.87425,-87.63958
321,2,9,true,16,15,-1,41.87427,-87.63257
TA1306000025,2,9,true,18,17,-1,41.87464,-87.65703
32,2,9,true,1,1,0,41.87464,-87.65703
15668,2,9,true,11,16,5,41.87471,-87.68642
13028,2,9,true,31,38,7,41.87475,-87.64981
13081,2,9,true,2,17,15,41.87501,-87.67326
89,2,9,true,1,2,1,41.87501,-87.6331
SL-010,2,9,true,9,24,15,41.87501,-87.63309
16907,2,9,true,1,1,0,41.87568,-87.71549
15541,2,9,true,2,4,2,41.8758,-87.62086
68,2,9,true,1,2,1,41.87587,-87.64077
13037,2,9,true,5,26,21,41.87588,-87.64078
50,2,9,true,2,2,0,41.87592,-87.6307
TA1305000009,2,9,true,18,15,-3,41.87593,-87.63068
317,2,9,true,2,28,26,41.87603,-87.68195
TA1305000010,2,9,true,7,17,10,41.87623,-87.62444
624,2,9,true,30,55,25,41.87626,-87.62923
33,2,9,true,2,6,4,41.87715,-87.62786
TA1305000035,2,9,true,29,59,30,41.87716,-87.62787
13138,2,9,true,26,61,35,41.87723,-87.63941
75,2,9,true,2,3,1,41.87724,-87.63937
631,2,9,true,3,21,18,41.87761,-87.6739
15539,2,9,true,45,59,14,41.87763,-87.64405
13158,2,9,true,52,35,-17,41.87764,-87.64957
134,2,9,true,11,3,-8,41.87764,-87.64954
13157,2,9,true,26,25,-1,41.87773,-87.6548
21,2,9,true,4,3,-1,41.87773,-87.6548
TA1305000025,2,9,true,57,145,88,41.87773,-87.63528
36,2,9,true,5,11,6,41.87776,-87.63525
TA1309000002,2,9,true,36,32,-4,41.87784,-87.62408
284,2,9,true,2,8,6,41.87784,-87.62408
13206,2,9,true,27,16,-11,41.87794,-87.66201
146,2,9,true,1,4,3,41.87794,-87.66201
283,2,9,true,3,26,23,41.87809,-87.63183
TA1309000004,2,9,true,26,90,64,41.87811,-87.63184
107,2,9,true,10,2,-8,41.87822,-87.644
638,2,9,true,53,95,42,41.87827,-87.64078
37,2,9,true,1,14,13,41.87921,-87.62975
TA1305000005,2,9,true,28,98,70,41.87924,-87.62975
13011,2,9,true,37,129,92,41.87931,-87.63993
TA1309000008,2,9,true,26,32,6,41.87933,-87.6355
192,2,9,true,8,21,13,41.87935,-87.63997
KA1503000034,2,9,true,5,53,48,41.87938,-87.63197
39,2,9,true,4,18,14,41.87948,-87.62571
KA1503000015,2,9,true,21,92,71,41.87948,-87.6257
381,2,9,true,3,3,0,41.87981,-87.68607
287,2,9,true,2,13,11,41.88017,-87.63527
TA1309000007,2,9,true,31,118,87,41.88022,-87.63526
WL-011,2,9,true,44,50,6,41.88034,-87.64273
73,2,9,true,2,7,5,41.8804,-87.64273
80,2,9,true,10,11,1,41.88042,-87.65556
13156,2,9,true,44,52,8,41.88042,-87.65554
13300,2,9,true,16,24,8,41.88097,-87.61675
76,2,9,true,3,7,4,41.88098,-87.61675
13008,2,9,true,20,65,45,41.88105,-87.62408
90,2,9,true,5,15,10,41.88107,-87.62409
49,2,9,true,9,25,16,41.88116,-87.62963
TA1305000006,2,9,true,20,124,104,41.88122,-87.6296
13134,2,9,true,9,4,-5,41.88138,-87.67493
215,2,9,true,1,2,1,41.88139,-87.67492
13056,2,9,true,46,80,34,41.88168,-87.63951
191,2,9,true,10,2,-8,41.88169,-87.63951
198,2,9,true,6,10,4,41.88187,-87.6488
TA1307000120,2,9,true,55,68,13,41.88188,-87.64879
13341,2,9,true,49,75,26,41.88208,-87.63985
174,2,9,true,4,16,12,41.88208,-87.63984
197,2,9,true,5,9,4,41.88208,-87.62513
13036,2,9,true,31,71,40,41.8821,-87.62513
77,2,9,true,13,6,-7,41.88214,-87.64108
TA1305000032,2,9,true,84,72,-12,41.88218,-87.64109
98,2,9,true,4,12,8,41.88266,-87.63251
13006,2,9,true,25,56,31,41.88268,-87.63252
13353,2,9,true,20,16,-4,41.88283,-87.6612
346,2,9,true,2,9,7,41.88284,-87.6612
654,2,9,true,25,23,-2,41.88307,-87.65698
233,2,9,true,5,3,-2,41.88309,-87.6511
13409,2,9,true,43,38,-5,41.8831,-87.6511
18,2,9,true,2,22,20,41.88317,-87.63735
KA1503000072,2,9,true,33,89,56,41.88317,-87.63693
91,2,9,true,12,9,-3,41.88336,-87.64122
WL-012,2,9,true,106,100,-6,41.88337,-87.6412
112,2,9,true,4,7,3,41.88362,-87.6486
13053,2,9,true,52,71,19,41.88365,-87.64863
43,2,9,true,6,19,13,41.88396,-87.62455
13001,2,9,true,45,78,33,41.88397,-87.62459
13155,2,9,true,11,26,15,41.88407,-87.65689
18062,2,9,true,42,34,-8,41.88412,-87.65427
621,2,9,true,4,6,2,41.88412,-87.65427
81,2,9,true,9,26,17,41.88417,-87.6296
TA1306000010,2,9,true,45,159,114,41.88419,-87.62961
15666,2,9,true,2,4,2,41.88446,-87.6963
KA1504000106,2,9,true,1,1,0,41.88459,-87.70631
TA1305000030,2,9,true,57,206,149,41.88459,-87.63178
96,2,9,true,2,4,2,41.8846,-87.64455
15535,2,9,true,30,43,13,41.8846,-87.64455
51,2,9,true,2,34,32,41.88462,-87.63176
TA1305000029,2,9,true,51,62,11,41.88466,-87.62787
195,2,9,true,18,10,-8,41.88466,-87.61952
13263,2,9,true,72,58,-14,41.88467,-87.61952
44,2,9,true,10,7,-3,41.88468,-87.62782
TA1306000015,2,9,true,49,83,34,41.88549,-87.65232
71,2,9,true,5,11,6,41.8855,-87.65233
66,2,9,true,6,5,-1,41.88557,-87.64186
13021,2,9,true,76,116,40,41.88559,-87.64184
TA1307000111,2,9,true,46,76,30,41.88582,-87.63548
164,2,9,true,8,15,7,41.88583,-87.63547
13073,2,9,true,6,13,7,41.88592,-87.66717
119,2,9,true,2,5,3,41.88593,-87.66717
KA17018054,2,9,true,2,20,18,41.88595,-87.67701
38,2,9,true,12,18,6,41.88599,-87.63089
KA1503000012,2,9,true,52,104,52,41.88599,-87.63089
52,2,9,true,5,6,1,41.886,-87.62421
TA1305000011,2,9,true,43,100,57,41.886,-87.62418
7,2,9,true,9,8,-1,41.88627,-87.61751
15534,2,9,true,35,17,-18,41.88627,-87.61749
217,2,9,true,3,5,2,41.8866,-87.65821
13197,2,9,true,21,48,27,41.8866,-87.65816
264,2,9,true,7,4,-3,41.8867,-87.62224
TA1308000029,2,9,true,43,46,3,41.88673,-87.62225
194,2,9,true,1,4,3,41.88688,-87.62606
TA1307000131,2,9,true,12,70,58,41.88688,-87.62606
6,2,9,true,1,3,2,41.88697,-87.61281
KA1503000064,2,9,true,12,25,13,41.88697,-87.61281
100,2,9,true,11,14,3,41.88814,-87.63657
TA1305000022,2,9,true,84,107,23,41.88817,-87.63656
56,2,9,true,8,13,5,41.88866,-87.64442
TA1306000003,2,9,true,61,53,-8,41.88867,-87.64442
KA1503000043,2,9,true,155,128,-27,41.88918,-87.63851
133,2,9,true,21,17,-4,41.88918,-87.63851
13050,2,9,true,54,97,43,41.88919,-87.62775
47,2,9,true,3,17,14,41.88921,-87.62775
376,2,9,true,3,3,0,41.88951,-87.68818
13432,2,9,true,10,32,22,41.88989,-87.67149
TA1307000151,2,9,true,86,125,39,41.88993,-87.63427
212,2,9,true,14,15,1,41.88995,-87.63427
636,2,9,true,51,43,-8,41.88997,-87.63662
125,2,9,true,3,3,0,41.89018,-87.62621
KA1503000044,2,9,true,11,37,26,41.89018,-87.6262
196,2,9,true,14,8,-6,41.89053,-87.62205
13427,2,9,true,44,53,9,41.89054,-87.62205
26,2,9,true,9,10,1,41.89057,-87.61798
13430,2,9,true,41,94,53,41.89077,-87.63169
181,2,9,true,3,17,14,41.89077,-87.63168
TA1306000013,2,9,true,35,26,-9,41.89083,-87.61852
RN-,2,9,true,46,80,34,41.89102,-87.63546
672,2,9,true,6,16,10,41.89102,-87.63545
13434,2,9,true,16,28,12,41.89108,-87.66663
TA1308000006,2,9,true,13,12,-1,41.89128,-87.67686
199,2,9,true,10,10,0,41.89143,-87.62676
TA1307000117,2,9,true,50,88,38,41.89144,-87.62675
13033,2,9,true,89,67,-22,41.8916,-87.64835
214,2,9,true,4,3,-1,41.89161,-87.67688
84,2,9,true,14,9,-5,41.89161,-87.64833
186,2,9,true,9,8,-1,41.8918,-87.65879
13194,2,9,true,64,31,-33,41.8918,-87.65878
TA1305000003,2,9,true,61,52,-9,41.89187,-87.62061
24,2,9,true,21,8,-13,41.8919,-87.62063
643,2,9,true,8,2,-6,41.89203,-87.68939
35,2,9,true,7,5,-2,41.89227,-87.61206
13022,2,9,true,61,41,-20,41.89227,-87.61205
99,2,9,true,9,8,-1,41.89255,-87.61449
TA1306000029,2,9,true,31,29,-2,41.89256,-87.61449
13265,2,9,true,58,58,0,41.89383,-87.64172
74,2,9,true,9,14,5,41.89384,-87.64173
13045,2,9,true,86,92,6,41.89403,-87.62931
110,2,9,true,11,19,8,41.89406,-87.6293
13016,2,9,true,91,144,53,41.89431,-87.62277
211,2,9,true,16,48,32,41.89439,-87.62267
KA1503000041,2,9,true,119,175,56,41.89452,-87.61798
142,2,9,true,12,32,20,41.89453,-87.61806
92,2,9,true,4,2,-2,41.89455,-87.65346
13196,2,9,true,37,17,-20,41.89455,-87.65345
TA1307000062,2,9,true,87,85,-2,41.89466,-87.63839
111,2,9,true,7,22,15,41.89466,-87.63837
TA1306000012,2,9,true,102,102,0,41.89475,-87.63438
53,2,9,true,26,15,-11,41.89476,-87.63439
627,2,9,true,5,2,-3,41.8948,-87.63231
KP1705001026,2,9,true,31,30,-1,41.89483,-87.6323
16921,2,9,true,1,1,0,41.89488,-87.77459
16920,2,9,true,3,2,-1,41.89495,-87.76491
KA1504000114,2,9,true,4,1,-3,41.89547,-87.70614
18058,2,9,true,16,1,-15,41.8955,-87.68201
637,2,9,true,27,14,-13,41.89563,-87.67209
128,2,9,true,8,1,-7,41.89571,-87.67716
13132,2,9,true,36,11,-25,41.89573,-87.67718
161,2,9,true,10,13,3,41.89574,-87.62599
15530,2,9,true,72,122,50,41.89575,-87.62596
18003,2,9,true,24,70,46,41.89575,-87.62011
13247,2,9,true,26,21,-5,41.89597,-87.66775
350,2,9,true,9,2,-7,41.89597,-87.66774
TA1305000020,2,9,true,26,61,35,41.89636,-87.65406
54,2,9,true,2,8,6,41.89637,-87.65407
13289,2,9,true,37,15,-22,41.89638,-87.661
86,2,9,true,5,1,-4,41.89639,-87.661
337,2,9,true,5,9,4,41.89659,-87.63096
13303,2,9,true,28,28,0,41.89672,-87.63088
13017,2,9,true,89,66,-23,41.89676,-87.6357
31,2,9,true,25,25,0,41.89677,-87.63572
13338,2,9,true,61,83,22,41.89697,-87.62173
173,2,9,true,4,8,4,41.89704,-87.62173
TA1307000061,2,9,true,38,46,8,41.89745,-87.62873
106,2,9,true,3,5,2,41.89746,-87.62874
25,2,9,true,4,6,2,41.89751,-87.62354
13034,2,9,true,18,35,17,41.89754,-87.62352
48,2,9,true,8,23,15,41.89772,-87.64302
TA1306000009,2,9,true,77,179,102,41.89772,-87.64299
620,2,9,true,51,37,-14,41.89817,-87.63754
KA1504000103,2,9,true,24,9,-15,41.89842,-87.68659
374,2,9,true,2,1,-1,41.89842,-87.68659
145,2,9,true,10,21,11,41.89856,-87.62211
15529,2,9,true,47,99,52,41.89858,-87.62206
140,2,9,true,9,19,10,41.89895,-87.6299
TA1307000128,2,9,true,52,46,-6,41.89896,-87.6299
657,2,9,true,28,19,-9,41.89918,-87.6722
KA1504000117,2,9,true,8,4,-4,41.89936,-87.64848
13248,2,9,true,21,8,-13,41.89964,-87.66788
46,2,9,true,5,5,0,41.89994,-87.63444
TA1306000011,2,9,true,26,16,-10,41.89994,-87.63443
364,2,9,true,3,3,0,41.90023,-87.64299
KA1504000116,2,9,true,16,29,13,41.90023,-87.64299
17660,2,9,true,8,11,3,41.90036,-87.69671
622,2,9,true,4,1,-3,41.90037,-87.69671
13290,2,9,true,35,19,-16,41.90069,-87.66259
13042,2,9,true,48,112,64,41.90097,-87.62377
85,2,9,true,5,15,10,41.90098,-87.62375
183,2,9,true,5,2,-3,41.90133,-87.67744
TA1307000070,2,9,true,17,3,-14,41.90133,-87.67742
KA1504000133,2,9,true,37,59,22,41.90234,-87.62773
172,2,9,true,9,13,4,41.90236,-87.62774
15654,2,9,true,7,5,-2,41.90271,-87.70923
305,2,9,true,3,2,-1,41.9028,-87.69005
13241,2,9,true,8,17,9,41.9029,-87.68731
176,2,9,true,21,12,-9,41.90291,-87.63141
TA1306000006,2,9,true,20,6,-14,41.90292,-87.63772
TA1307000039,2,9,true,71,73,2,41.90294,-87.63137
658,2,9,true,22,12,-10,41.903,-87.6838
216,2,9,true,4,1,-3,41.90302,-87.69749
13256,2,9,true,3,4,1,41.90302,-87.69749
TA1305000034,2,9,true,22,10,-12,41.90313,-87.67391
17,2,9,true,5,1,-4,41.90313,-87.67391
182,2,9,true,34,12,-22,41.90317,-87.63442
KA1504000135,2,9,true,77,59,-18,41.90319,-87.63439
13136,2,9,true,40,16,-24,41.90326,-87.67845
130,2,9,true,4,2,-2,41.90327,-87.67846
210,2,9,true,10,11,1,41.90342,-87.66781
13061,2,9,true,68,52,-16,41.90342,-87.66779
KA1504000079,2,9,true,21,28,7,41.9035,-87.64334
359,2,9,true,7,8,1,41.90458,-87.6497
138,2,9,true,1,1,0,41.9046,-87.64057
TA1307000115,2,9,true,11,13,2,41.9046,-87.64056
291,2,9,true,6,9,3,41.90672,-87.63494
TA1308000049,2,9,true,40,26,-14,41.90672,-87.6349
KA1504000134,2,9,true,42,29,-13,41.90687,-87.6262
180,2,9,true,5,3,-2,41.90687,-87.62618
13224,2,9,true,35,26,-9,41.90706,-87.66725
333,2,9,true,4,2,-2,41.90706,-87.66725
18069,2,9,true,1,19,18,41.90722,-87.65563
TA1307000143,2,9,true,34,2,-32,41.90762,-87.63854
236,2,9,true,8,1,-7,41.90762,-87.63853
61,2,9,true,6,7,1,41.90764,-87.67254
13221,2,9,true,23,22,-1,41.90765,-87.67254
13245,2,9,true,8,5,-3,41.90777,-87.68586
301,2,9,true,25,14,-11,41.90796,-87.63203
TA1309000024,2,9,true,62,41,-21,41.908,-87.63152
69,2,9,true,6,6,0,41.90939,-87.6777
TA1305000041,2,9,true,28,39,11,41.9094,-87.67769
331,2,9,true,73,63,-10,41.90965,-87.64812
15653,2,9,true,3,2,-1,41.90979,-87.7053
509,2,9,true,1,2,1,41.9098,-87.70531
TA1305000037,2,9,true,36,15,-21,41.91018,-87.67003
TA1306000008,2,9,true,22,18,-4,41.9102,-87.6435
16,2,9,true,10,2,-8,41.91035,-87.67008
213,2,9,true,1,1,0,41.91037,-87.68237
TA1308000005,2,9,true,17,7,-10,41.91042,-87.68238
13258,2,9,true,19,9,-10,41.91043,-87.69718
276,2,9,true,1,3,2,41.91043,-87.69718
160,2,9,true,1,1,0,41.91054,-87.68957
13257,2,9,true,10,5,-5,41.91054,-87.68956
13154,2,9,true,27,34,7,41.91054,-87.65312
20,2,9,true,3,3,0,41.91055,-87.65313
13058,2,9,true,27,15,-12,41.91059,-87.64942
60,2,9,true,5,2,-3,41.91059,-87.64942
TA1307000038,2,9,true,50,39,-11,41.91138,-87.63868
118,2,9,true,2,10,8,41.91138,-87.63868
LF-005,2,9,true,54,41,-13,41.91172,-87.62681
268,2,9,true,8,3,-5,41.91172,-87.62681
126,2,9,true,3,3,0,41.91196,-87.63197
13128,2,9,true,31,19,-12,41.91197,-87.63197
289,2,9,true,19,19,0,41.91209,-87.63472
TA1308000050,2,9,true,81,73,-8,41.91211,-87.6347
13243,2,9,true,36,13,-23,41.91262,-87.6814
158,2,9,true,4,1,-3,41.91262,-87.6814
315,2,9,true,1,2,1,41.91293,-87.66417
TA1309000032,2,9,true,1,4,3,41.91293,-87.66417
TA1306000032,2,9,true,26,14,-12,41.9137,-87.65285
93,2,9,true,2,2,0,41.91371,-87.65285
224,2,9,true,3,2,-1,41.91386,-87.64877
TA1307000166,2,9,true,13,32,19,41.91386,-87.64877
15655,2,9,true,20,4,-16,41.91401,-87.70514
18017,2,9,true,2,1,-1,41.91416,-87.71676
18067,2,9,true,20,18,-2,41.9146,-87.66796
628,2,9,true,1,1,0,41.9146,-87.66796
TA1306000007,2,9,true,15,7,-8,41.91469,-87.64333
28,2,9,true,2,3,1,41.91469,-87.64333
13068,2,9,true,26,41,15,41.91554,-87.68703
116,2,9,true,3,5,2,41.91555,-87.68703
13179,2,9,true,53,32,-21,41.9157,-87.63461
141,2,9,true,8,5,-3,41.91571,-87.63461
13133,2,9,true,30,20,-10,41.91598,-87.67733
58,2,9,true,1,5,4,41.91602,-87.66894
TA1305000039,2,9,true,28,14,-14,41.9163,-87.66749
15650,2,9,true,8,5,-3,41.91711,-87.71023
506,2,9,true,3,1,-2,41.91711,-87.71023
15651,2,9,true,9,4,-5,41.91752,-87.70181
185,2,9,true,2,1,-1,41.91774,-87.69143
13266,2,9,true,6,4,-2,41.91774,-87.69142
TA1309000029,2,9,true,11,6,-5,41.9178,-87.68245
309,2,9,true,1,1,0,41.91789,-87.6865
288,2,9,true,7,5,-2,41.91809,-87.64375
TA1309000006,2,9,true,30,40,10,41.91809,-87.64375
223,2,9,true,4,5,1,41.91821,-87.65698
TA1307000163,2,9,true,29,28,-1,41.91821,-87.65696
94,2,9,true,21,11,-10,41.91831,-87.6363
13146,2,9,true,50,34,-16,41.91831,-87.63629
13059,2,9,true,38,50,12,41.91845,-87.65222
113,2,9,true,6,5,-1,41.91846,-87.65222
13259,2,9,true,15,5,-10,41.91852,-87.69744
259,2,9,true,3,3,0,41.91853,-87.69745
13192,2,9,true,43,33,-10,41.91995,-87.64884
225,2,9,true,6,3,-3,41.91995,-87.64884
13288,2,9,true,32,9,-23,41.92008,-87.67788
13242,2,9,true,2,7,5,41.92021,-87.69266
222,2,9,true,1,1,0,41.92023,-87.69265
307,2,9,true,3,4,1,41.92077,-87.66373
TA1309000030,2,9,true,18,18,0,41.92077,-87.66372
290,2,9,true,2,2,0,41.92152,-87.70734
13292,2,9,true,11,10,-1,41.92152,-87.70733
TA1309000033,2,9,true,30,29,-1,41.92158,-87.65381
13193,2,9,true,51,29,-22,41.92182,-87.64412
144,2,9,true,8,6,-2,41.92182,-87.64411
13191,2,9,true,63,23,-40,41.92217,-87.63891
143,2,9,true,11,2,-9,41.92217,-87.63891
327,2,9,true,7,12,5,41.92225,-87.65783
13084,2,9,true,23,9,-14,41.92268,-87.69715
123,2,9,true,3,1,-2,41.92268,-87.69714
LP-,2,9,true,23,11,-12,41.92396,-87.63584
673,2,9,true,6,3,-3,41.92398,-87.63585
KA1504000140,2,9,true,9,13,4,41.92409,-87.67646
15648,2,9,true,3,3,0,41.92464,-87.68931
504,2,9,true,1,1,0,41.92464,-87.68931
TA1307000001,2,9,true,35,35,0,41.92535,-87.66581
188,2,9,true,1,4,3,41.92536,-87.66581
TA1306000026,2,9,true,25,76,51,41.92558,-87.65842
87,2,9,true,8,8,0,41.92559,-87.65843
67,2,9,true,6,4,-2,41.9256,-87.65371
TA1306000016,2,9,true,48,49,1,41.9256,-87.65371
313,2,9,true,8,7,-1,41.9257,-87.64246
TA1309000019,2,9,true,47,39,-8,41.92586,-87.63897
TA1309000058,2,9,true,40,58,18,41.92591,-87.64927
127,2,9,true,9,8,-1,41.92592,-87.64927
177,2,9,true,6,6,0,41.92627,-87.63086
TA1308000001,2,9,true,42,44,2,41.92627,-87.63086
15646,2,9,true,11,10,-1,41.92668,-87.6977
34,2,9,true,1,1,0,41.92675,-87.63444
13124,2,9,true,10,16,6,41.92675,-87.63444
302,2,9,true,5,4,-1,41.92859,-87.65421
TA1309000023,2,9,true,14,23,9,41.9287,-87.65383
TA1307000113,2,9,true,12,15,3,41.92878,-87.66391
166,2,9,true,3,1,-2,41.92883,-87.66853
13296,2,9,true,10,9,-1,41.92883,-87.66852
TA1309000059,2,9,true,26,14,-12,41.92889,-87.65898
343,2,9,true,5,1,-4,41.92889,-87.65898
349,2,9,true,4,2,-2,41.92915,-87.6491
TA1309000061,2,9,true,40,19,-21,41.92915,-87.64909
TA1308000031,2,9,true,10,8,-2,41.92946,-87.68417
258,2,9,true,1,2,1,41.92946,-87.68417
TA1305000014,2,9,true,72,41,-31,41.92956,-87.64313
340,2,9,true,4,6,2,41.92956,-87.64313
260,2,9,true,1,2,1,41.92958,-87.70791
13085,2,9,true,15,15,0,41.92958,-87.70789
15643,2,9,true,3,2,-1,41.93057,-87.7238
TA1307000142,2,9,true,45,39,-6,41.93125,-87.64432
220,2,9,true,9,12,3,41.93125,-87.64431
13276,2,9,true,55,30,-25,41.93132,-87.63874
324,2,9,true,8,7,-1,41.93173,-87.64179
15645,2,9,true,3,4,1,41.93191,-87.70121
163,2,9,true,1,1,0,41.93191,-87.67784
13271,2,9,true,7,6,-1,41.93192,-87.67784
152,2,9,true,2,10,8,41.93221,-87.65864
TA1307000064,2,9,true,30,34,4,41.93222,-87.65864
TA1306000014,2,9,true,26,26,0,41.93242,-87.65271
13,2,9,true,6,9,3,41.93242,-87.65271
TA1309000039,2,9,true,58,28,-30,41.93258,-87.63642
329,2,9,true,6,2,-4,41.93258,-87.63642
13294,2,9,true,9,4,-5,41.9326,-87.66595
TA1309000036,2,9,true,39,30,-9,41.93313,-87.64776
332,2,9,true,9,3,-6,41.93313,-87.64776
15644,2,9,true,1,2,1,41.93534,-87.71687
TA1307000006,2,9,true,27,39,12,41.93571,-87.6636
153,2,9,true,2,4,2,41.93575,-87.66364
162,2,9,true,3,1,-2,41.93588,-87.67844
13268,2,9,true,11,6,-5,41.93588,-87.67843
250,2,9,true,1,3,2,41.93609,-87.66984
13269,2,9,true,14,8,-6,41.93609,-87.66983
TA1307000052,2,9,true,41,44,3,41.93628,-87.65266
115,2,9,true,1,11,10,41.93628,-87.65266
156,2,9,true,18,11,-7,41.9365,-87.64756
TA1307000136,2,9,true,37,40,3,41.9365,-87.64755
TA1307000041,2,9,true,63,40,-23,41.93669,-87.63683
157,2,9,true,9,6,-3,41.9367,-87.63683
13137,2,9,true,109,50,-59,41.9376,-87.6441
300,2,9,true,17,6,-11,41.93761,-87.6441
15642,2,9,true,5,6,1,41.93843,-87.69801
154,2,9,true,3,4,1,41.93912,-87.66384
KA17018068,2,9,true,9,4,-5,41.93935,-87.68327
TA1309000042,2,9,true,14,21,7,41.93937,-87.66836
131,2,9,true,5,1,-4,41.93937,-87.66835
KA150400009X,2,9,true,1,2,1,41.9394,-87.71159
13229,2,9,true,14,21,7,41.93946,-87.66376
226,2,9,true,4,6,2,41.93972,-87.65886
TA1308000019,2,9,true,22,22,0,41.93973,-87.65886
13277,2,9,true,40,28,-12,41.9401,-87.64546
296,2,9,true,11,10,-1,41.9401,-87.64546
TA1307000134,2,9,true,37,40,3,41.94016,-87.65303
117,2,9,true,5,7,2,41.94016,-87.65302
13143,2,9,true,2,2,0,41.94059,-87.67853
334,2,9,true,7,6,-1,41.94076,-87.63919
TA1309000049,2,9,true,39,28,-11,41.94077,-87.63919
493,2,9,true,2,1,-1,41.94304,-87.68729
15634,2,9,true,3,3,0,41.94304,-87.68729
TA1307000138,2,9,true,22,36,14,41.94334,-87.67094
230,2,9,true,9,3,-6,41.94335,-87.67093
13144,2,9,true,8,11,3,41.9434,-87.67964
TA1309000025,2,9,true,37,32,-5,41.94368,-87.64894
299,2,9,true,7,5,-2,41.94368,-87.64894
229,2,9,true,11,7,-4,41.94372,-87.66401
13071,2,9,true,35,42,7,41.94373,-87.66401
632,2,9,true,31,33,2,41.94453,-87.6547
303,2,9,true,10,6,-4,41.94522,-87.64702
15631,2,9,true,3,5,2,41.94524,-87.70665
13278,2,9,true,42,32,-10,41.94553,-87.64644
330,2,9,true,3,1,-2,41.94618,-87.67331
TA1309000050,2,9,true,5,3,-2,41.94618,-87.67331
491,2,9,true,2,2,0,41.94664,-87.69463
15632,2,9,true,1,11,10,41.94664,-87.69463
KA1504000143,2,9,true,4,5,1,41.94664,-87.68337
227,2,9,true,6,9,3,41.94813,-87.66397
13235,2,9,true,59,48,-11,41.94814,-87.66396
304,2,9,true,7,8,1,41.94878,-87.64922
257,2,9,true,8,2,-6,41.9488,-87.67527
13253,2,9,true,8,14,6,41.9488,-87.67527
13325,2,9,true,33,73,40,41.94907,-87.64863
114,2,9,true,8,3,-5,41.94935,-87.65451
TA1307000126,2,9,true,27,39,12,41.94936,-87.65451
232,2,9,true,7,3,-4,41.94943,-87.64645
TA1307000150,2,9,true,55,30,-25,41.94945,-87.64646
18016,2,9,true,2,2,0,41.94993,-87.71395
347,2,9,true,4,1,-3,41.95068,-87.6687
13319,2,9,true,24,18,-6,41.95069,-87.6687
TA1307000127,2,9,true,45,30,-15,41.9508,-87.65918
165,2,9,true,4,1,-3,41.95081,-87.65918
15628,2,9,true,8,3,-5,41.95216,-87.69806
318,2,9,true,1,2,1,41.95254,-87.6735
13323,2,9,true,61,28,-33,41.95282,-87.65
256,2,9,true,7,5,-2,41.95282,-87.65
15624,2,9,true,2,5,3,41.95339,-87.73199
314,2,9,true,3,3,0,41.9535,-87.69199
KA1504000139,2,9,true,2,2,0,41.954,-87.71909
TA1309000043,2,9,true,28,21,-7,41.95417,-87.66434
13063,2,9,true,39,37,-2,41.95424,-87.65441
240,2,9,true,5,5,0,41.95424,-87.65441
KA1504000158,2,9,true,9,5,-4,41.95432,-87.68607
254,2,9,true,9,6,-3,41.95438,-87.64806
TA1308000022,2,9,true,34,17,-17,41.95438,-87.64805
244,2,9,true,8,10,2,41.95466,-87.67391
TA1307000149,2,9,true,23,25,2,41.95467,-87.67392
TA1309000026,2,9,true,13,13,0,41.95601,-87.6802
246,2,9,true,1,4,3,41.95606,-87.66885
312,2,9,true,6,8,2,41.95637,-87.6563
TA1308000047,2,9,true,8,4,-4,41.95709,-87.6642
292,2,9,true,3,2,-1,41.95709,-87.6642
13379,2,9,true,46,37,-9,41.95786,-87.6495
TA1309000018,2,9,true,37,24,-13,41.95791,-87.67357
306,2,9,true,8,3,-5,41.9585,-87.655
TA1309000027,2,9,true,43,20,-23,41.9585,-87.65499
592,2,9,true,2,1,-1,41.96065,-87.74538
13389,2,9,true,23,11,-12,41.961,-87.64958
245,2,9,true,8,4,-4,41.96101,-87.64958
15621,2,9,true,3,2,-1,41.96103,-87.70586
15622,2,9,true,12,3,-9,41.96108,-87.69544
KA1504000097,2,9,true,10,3,-7,41.96116,-87.71658
TA1307000144,2,9,true,11,14,3,41.96142,-87.6762
TA1309000021,2,9,true,7,5,-2,41.9615,-87.6714
482,2,9,true,9,1,-8,41.96154,-87.69117
15623,2,9,true,15,11,-4,41.96154,-87.69117
KA1503000022,2,9,true,11,10,-1,41.96158,-87.66609
231,2,9,true,6,4,-2,41.96163,-87.65464
TA1307000107,2,9,true,33,33,0,41.96164,-87.65464
TA1307000156,2,9,true,11,5,-6,41.96301,-87.68479
TA1309000012,2,9,true,4,10,6,41.96325,-87.67928
TA1308000012,2,9,true,20,12,-8,41.96398,-87.63818
249,2,9,true,3,1,-2,41.96398,-87.63818
293,2,9,true,2,5,3,41.96521,-87.65822
13074,2,9,true,19,29,10,41.96521,-87.6582
639,2,9,true,36,24,-12,41.96584,-87.64538
KA1504000127,2,9,true,12,5,-7,41.96587,-87.70083
KA1504000093,2,9,true,7,9,2,41.96587,-87.69365
TA1307000140,2,9,true,34,23,-11,41.96643,-87.68865
326,2,9,true,7,3,-4,41.96665,-87.67113
KA1504000126,2,9,true,3,1,-2,41.96668,-87.70807
TA1309000014,2,9,true,32,15,-17,41.96709,-87.66744
242,2,9,true,1,3,2,41.9671,-87.67904
TA1307000158,2,9,true,19,42,23,41.9671,-87.67904
251,2,9,true,7,8,1,41.96796,-87.65
TA1307000119,2,9,true,14,15,1,41.96796,-87.65
15615,2,9,true,2,9,7,41.96835,-87.71183
323,2,9,true,2,3,1,41.96869,-87.66034
TA1308000021,2,9,true,13,7,-6,41.96883,-87.65765
253,2,9,true,2,6,4,41.96883,-87.65765
475,2,9,true,1,1,0,41.96885,-87.69611
KA1504000080,2,9,true,5,2,-3,41.96887,-87.69609
TA1309000015,2,9,true,10,9,-1,41.96889,-87.68401
344,2,9,true,6,6,0,41.9691,-87.67423
TA1309000066,2,9,true,29,32,3,41.9691,-87.67423
TA1309000041,2,9,true,11,17,6,41.96951,-87.65471
465,2,9,true,4,5,1,41.97161,-87.65016
KA1504000171,2,9,true,17,22,5,41.97161,-87.65016
325,2,9,true,6,7,1,41.9728,-87.67186
TA1309000035,2,9,true,29,25,-4,41.97335,-87.66785
295,2,9,true,3,2,-1,41.97378,-87.65972
13108,2,9,true,21,12,-9,41.97379,-87.65971
KA1504000078,2,9,true,6,2,-4,41.97491,-87.69258
KA1504000149,2,9,true,10,7,-3,41.97562,-87.67945
471,2,9,true,1,1,0,41.97564,-87.70143
KA1504000160,2,9,true,8,8,0,41.97564,-87.70143
KA1504000128,2,9,true,2,8,6,41.97567,-87.70927
463,2,9,true,1,1,0,41.978,-87.66805
KA1504000146,2,9,true,19,23,4,41.978,-87.66805
13109,2,9,true,27,18,-9,41.97835,-87.65976
294,2,9,true,3,3,0,41.97835,-87.65976
KA1504000147,2,9,true,2,3,1,41.97976,-87.67754
655,2,9,true,4,4,0,41.97987,-87.68194
KA1504000161,2,9,true,3,5,2,41.98038,-87.71612
KA1504000167,2,9,true,3,3,0,41.98206,-87.70895
460,2,9,true,2,3,1,41.98358,-87.66916
KA1504000151,2,9,true,16,11,-5,41.98359,-87.66916
15585,2,9,true,4,2,-2,41.98367,-87.69642
KA1504000152,2,9,true,56,37,-19,41.98403,-87.65231
459,2,9,true,15,12,-3,41.98403,-87.65231
15578,2,9,true,17,20,3,41.98405,-87.66027
15575,2,9,true,22,12,-10,41.98975,-87.66014
458,2,9,true,1,1,0,41.98975,-87.66013
KA1504000130,2,9,true,3,1,-2,41.99024,-87.69338
457,2,9,true,3,4,1,41.99052,-87.66982
KA1504000148,2,9,true,9,6,-3,41.99086,-87.66971
KA1504000155,2,9,true,5,3,-2,41.99118,-87.68359
KA1504000129,2,9,true,2,2,0,41.99417,-87.68945
15571,2,9,true,23,11,-12,41.99478,-87.66028
454,2,9,true,5,2,-3,41.99478,-87.66027
KA1504000156,2,9,true,34,9,-25,41.99925,-87.67137
453,2,9,true,2,2,0,41.99925,-87.67137
RP-009,2,9,true,3,18,15,42.00107,-87.66122
451,2,9,true,1,1,0,42.00108,-87.66123
RP-008,2,9,true,19,13,-6,42.00446,-87.6724
RP-002,2,9,true,6,2,-4,42.00456,-87.68065
660,2,9,true,19,5,-14,42.00458,-87.66143
KA1504000175,2,9,true,11,16,5,42.00797,-87.66549
447,2,9,true,6,2,-4,42.00797,-87.66548
467,2,9,true,5,1,-4,42.0086,-87.69047
RP-005,2,9,true,2,1,-1,42.0086,-87.69047
432,2,9,true,3,3,0,42.00907,-87.67423
KA1504000162,2,9,true,7,7,0,42.00907,-87.67422
KA1504000159,2,9,true,17,5,-12,42.01059,-87.66241
RP-007,2,9,true,2,2,0,42.01256,-87.67431
525,2,9,true,2,3,1,42.01272,-87.66605
520,2,9,true,8,9,1,42.01597,-87.66859
515,2,9,true,4,12,8,42.01915,-87.67356
514,2,9,true,1,1,0,42.01927,-87.68452
523,2,9,true,14,3,-11,42.02089,-87.66505
598,2,9,true,4,2,-2,42.02578,-87.68411
597,2,9,true,8,2,-6,42.03256,-87.67914
625,2,9,true,1,2,1,42.04163,-87.6808
596,2,9,true,23,22,-1,42.04822,-87.68348
E008,2,9,true,4,8,4,42.05049,-87.67782
661,2,9,true,4,2,-2,42.05704,-87.68657
604,2,9,true,7,51,44,42.05824,-87.67744
E006,2,9,true,2,2,0,42.06367,-87.69871
E007,2,9,true,1,4,3,42.06431,-87.68615
E014,2,9,true,4,3,-1,42.06483,-87.71531
20214,2,17,false,1,2,1,41.65191,-87.53961
20210,2,17,false,2,3,1,41.67067,-87.62273
20206,2,17,false,2,3,1,41.68459,-87.6708
20232,2,17,false,7,4,-3,41.68588,-87.57378
20203,2,17,false,1,7,6,41.69131,-87.71286
20109,2,17,false,1,1,0,41.70018,-87.6123
20222,2,17,false,1,7,6,41.7046,-87.52832
20123,2,17,false,1,3,2,41.70461,-87.68115
696,2,17,false,1,1,0,41.70717,-87.61841
20202,2,17,false,2,2,0,41.71,-87.72
20223,2,17,false,1,1,0,41.71272,-87.53472
20226,2,17,false,2,3,1,41.71336,-87.56586
20224,2,17,false,5,4,-1,41.71371,-87.53083
20227,2,17,false,6,3,-3,41.7179,-87.56461
20104,2,17,false,2,2,0,41.72171,-87.62283
20119,2,17,false,3,3,0,41.72682,-87.6543
20103,2,17,false,6,2,-4,41.7281,-87.66757
20242,2,17,false,3,2,-1,41.7282,-87.54962
20120,2,17,false,4,4,0,41.74372,-87.63409
584,2,17,false,1,1,0,41.74412,-87.59905
573,2,17,false,4,1,-3,41.75079,-87.62444
574,2,17,false,5,2,-3,41.75095,-87.61379
577,2,17,false,1,2,1,41.75117,-87.58534
576,2,17,false,2,3,1,41.75129,-87.59752
580,2,17,false,1,1,0,41.75172,-87.55282
681,2,17,false,1,1,0,41.7525,-87.64381
570,2,17,false,3,1,-2,41.75849,-87.60642
KA1503000019,2,17,false,2,3,1,41.75867,-87.5869
569,2,17,false,1,1,0,41.75918,-87.59576
KA1503000020,2,17,false,1,5,4,41.76223,-87.55923
399,2,17,false,1,1,0,41.76225,-87.5592
651,2,17,false,1,4,3,41.76529,-87.62173
15599,2,17,false,1,2,1,41.76551,-87.61693
KA1503000003,2,17,false,3,2,-1,41.76572,-87.60498
KA1503000002,2,17,false,7,10,3,41.76641,-87.5657
KA1503000045,2,17,false,3,3,0,41.76649,-87.58647
KA1503000018,2,17,false,3,3,0,41.76663,-87.57645
567,2,17,false,2,2,0,41.76895,-87.65293
102,2,17,false,1,1,0,41.77345,-87.58533
KA1503000023,2,17,false,5,2,-3,41.77346,-87.58534
KA1503000030,2,17,false,2,2,0,41.77352,-87.57722
KA1503000029,2,17,false,11,10,-1,41.77364,-87.56747
16950,2,17,false,1,1,0,41.77408,-87.66378
KA1503000021,2,17,false,4,4,0,41.77888,-87.58665
649,2,17,false,2,1,-1,41.77984,-87.63477
18025,2,17,false,1,1,0,41.77989,-87.6509
KA1503000046,2,17,false,6,3,-3,41.78041,-87.59141
428,2,17,false,1,2,1,41.78041,-87.59139
653,2,17,false,3,5,2,41.78059,-87.58491
KA1503000054,2,17,false,7,3,-4,41.78061,-87.60582
15491,2,17,false,25,26,1,41.78096,-87.57624
101,2,17,false,2,1,-1,41.78105,-87.57611
KA1503000033,2,17,false,3,2,-1,41.78411,-87.61329
KA1503000014,2,17,false,39,33,-6,41.7851,-87.60108
426,2,17,false,7,6,-1,41.7851,-87.60108
647,2,17,false,1,1,0,41.78746,-87.65557
KA1503000070,2,17,false,11,3,-8,41.78794,-87.58831
TA1309000011,2,17,false,15,9,-6,41.78873,-87.60131
KA1503000071,2,17,false,57,24,-33,41.79148,-87.59988
423,2,17,false,7,5,-2,41.79148,-87.59988
KA1503000074,2,17,false,35,18,-17,41.79174,-87.58395
424,2,17,false,3,4,1,41.79174,-87.58395
KA1503000011,2,17,false,1,1,0,41.79296,-87.645
TA1309000063,2,17,false,23,27,4,41.79325,-87.5878
345,2,17,false,1,7,6,41.79326,-87.5878
KA1503000073,2,17,false,3,6,3,41.79345,-87.61585
559,2,17,false,2,3,1,41.79423,-87.65509
420,2,17,false,7,3,-4,41.79429,-87.60145
KA1504000076,2,17,false,31,25,-6,41.7943,-87.60145
TA1307000160,2,17,false,4,4,0,41.79485,-87.61873
247,2,17,false,7,16,9,41.79522,-87.58077
TA1308000009,2,17,false,64,87,23,41.79522,-87.58075
TA1307000164,2,17,false,30,23,-7,41.79527,-87.59647
248,2,17,false,1,3,2,41.79528,-87.59647
KA1503000052,2,17,false,17,14,-3,41.79935,-87.60097
418,2,17,false,1,2,1,41.79936,-87.60097
419,2,17,false,4,5,1,41.79952,-87.58643
KA1503000059,2,17,false,30,41,11,41.79952,-87.58643
TA1309000037,2,17,false,43,50,7,41.79957,-87.59474
KA1503000010,2,17,false,1,1,0,41.8018,-87.64522
15470,2,17,false,2,1,-1,41.80228,-87.61807
417,2,17,false,6,10,4,41.80242,-87.5869
KA1503000007,2,17,false,35,35,0,41.80242,-87.58689
121,2,17,false,2,2,0,41.80256,-87.59035
13398,2,17,false,20,22,2,41.80256,-87.59035
TA1309000067,2,17,false,9,14,5,41.80303,-87.60661
322,2,17,false,1,3,2,41.80321,-87.59849
594,2,17,false,5,2,-3,41.80567,-87.68337
416,2,17,false,1,1,0,41.80578,-87.59247
KA1503000069,2,17,false,7,7,0,41.80579,-87.59247
KA1503000051,2,17,false,4,4,0,41.80815,-87.64563
411,2,17,false,2,1,-1,41.80816,-87.64563
KA1503000009,2,17,false,4,3,-1,41.80932,-87.63346
TA1308000035,2,17,false,16,15,-1,41.80944,-87.59188
267,2,17,false,1,3,2,41.80944,-87.59188
252,2,17,false,1,6,5,41.80982,-87.59936
TA1308000002,2,17,false,19,9,-10,41.80983,-87.59937
TA1308000007,2,17,false,9,6,-3,41.80984,-87.61628
200,2,17,false,2,1,-1,41.80985,-87.61628
TA1309000053,2,17,false,4,7,3,41.80985,-87.60675
352,2,17,false,2,1,-1,41.8137,-87.63448
549,2,17,false,1,1,0,41.81401,-87.66662
413,2,17,false,3,2,-1,41.81408,-87.59701
KA1503000065,2,17,false,13,6,-7,41.81409,-87.59701
271,2,17,false,4,4,0,41.81648,-87.60659
TA1308000023,2,17,false,7,9,2,41.81649,-87.60659
KA1503000027,2,17,false,4,5,1,41.81666,-87.61942
KA1503000032,2,17,false,3,7,4,41.81912,-87.64328
265,2,17,false,3,3,0,41.82297,-87.6071
TA1308000038,2,17,false,20,16,-4,41.82298,-87.6071
546,2,17,false,6,5,-1,41.82319,-87.67661
16932,2,17,false,1,1,0,41.82346,-87.66558
179,2,17,false,1,2,1,41.82458,-87.61678
13420,2,17,false,5,8,3,41.82459,-87.61678
18022,2,17,false,4,1,-3,41.82672,-87.68315
TA1307000161,2,17,false,3,4,1,41.82707,-87.64572
KA1503000068,2,17,false,5,1,-4,41.82878,-87.68062
KA1503000066,2,17,false,3,7,4,41.83011,-87.67031
TA1308000045,2,17,false,5,7,2,41.83062,-87.64129
TA1308000043,2,17,false,6,7,1,41.83066,-87.64715
15446,2,17,false,2,14,12,41.83068,-87.65603
367,2,17,false,1,3,2,41.83069,-87.65604
KA1503000005,2,17,false,4,9,5,41.83079,-87.6325
184,2,17,false,1,1,0,41.83104,-87.62684
TA1307000129,2,17,false,8,2,-6,41.83104,-87.62683
406,2,17,false,3,4,1,41.83127,-87.6088
KA1503000004,2,17,false,18,19,1,41.83127,-87.6088
13345,2,17,false,5,6,1,41.83138,-87.61803
15445,2,17,false,5,5,0,41.83453,-87.63183
13216,2,17,false,9,8,-1,41.83473,-87.62581
13217,2,17,false,6,4,-2,41.83488,-87.61792
13215,2,17,false,14,16,2,41.83634,-87.6135
263,2,17,false,6,2,-4,41.8364,-87.61348
TA1308000046,2,17,false,9,12,3,41.83779,-87.65115
339,2,17,false,4,1,-3,41.83817,-87.64523
TA1309000055,2,17,false,5,9,4,41.8382,-87.64514
KA1503000038,2,17,false,6,4,-2,41.83845,-87.6354
402,2,17,false,2,3,1,41.83845,-87.6354
150,2,17,false,3,7,4,41.83855,-87.60821
TA1307000048,2,17,false,72,77,5,41.83855,-87.60821
TA1308000036,2,17,false,15,4,-11,41.83883,-87.62186
15442,2,17,false,2,5,3,41.83918,-87.66562
366,2,17,false,1,1,0,41.84164,-87.65744
KA1503000040,2,17,false,2,10,8,41.84164,-87.65744
13213,2,17,false,6,4,-2,41.84171,-87.62694
237,2,17,false,4,5,1,41.84204,-87.61697
TA1307000139,2,17,false,22,20,-2,41.84205,-87.61698
15443,2,17,false,5,10,5,41.84275,-87.63549
401,2,17,false,1,6,5,41.84276,-87.63549
TA1307000153,2,17,false,1,1,0,41.84358,-87.64538
15692,2,17,false,3,1,-2,41.84404,-87.69531
15691,2,17,false,1,1,0,41.84449,-87.70203
443,2,17,false,1,2,1,41.84456,-87.71603
147,2,17,false,1,1,0,41.84569,-87.62251
TA1307000005,2,17,false,10,9,-1,41.84569,-87.6225
TA1308000013,2,17,false,7,2,-5,41.84719,-87.64681
KA1504000086,2,17,false,2,1,-1,41.8482,-87.70542
TA1309000003,2,17,false,4,6,2,41.84847,-87.68512
15689,2,17,false,1,2,1,41.84912,-87.69515
TA1308000014,2,17,false,4,3,-1,41.84953,-87.64059
TA1308000026,2,17,false,4,9,5,41.85008,-87.63214
TA1305000004,2,17,false,14,5,-9,41.8514,-87.61884
TA1305000001,2,17,false,20,26,6,41.85262,-87.6265
13075,2,17,false,36,53,17,41.8531,-87.63192
120,2,17,false,6,2,-4,41.8531,-87.63191
439,2,17,false,1,1,0,41.85355,-87.70505
13162,2,17,false,12,8,-4,41.85378,-87.64659
13096,2,17,false,6,5,-1,41.8538,-87.69577
15685,2,17,false,3,3,0,41.85399,-87.71511
13091,2,17,false,2,8,6,41.85409,-87.68585
370,2,17,false,2,1,-1,41.85415,-87.61917
15546,2,17,false,18,11,-7,41.85416,-87.61916
13307,2,17,false,6,10,4,41.85489,-87.66359
124,2,17,false,2,1,-1,41.85492,-87.67609
13089,2,17,false,7,22,15,41.85497,-87.67567
13331,2,17,false,8,3,-5,41.85515,-87.65414
171,2,17,false,1,1,0,41.85516,-87.65414
15545,2,17,false,63,45,-18,41.85627,-87.61334
4,2,17,false,9,7,-2,41.85627,-87.61334
SL-013,2,17,false,21,14,-7,41.85659,-87.62755
SL-006,2,17,false,15,12,-3,41.8568,-87.63387
129,2,17,false,5,5,0,41.85752,-87.66158
13135,2,17,false,20,27,7,41.85753,-87.66157
338,2,17,false,11,2,-9,41.85758,-87.61956
13102,2,17,false,47,46,-1,41.85762,-87.61942
13150,2,17,false,31,29,-2,41.85783,-87.62455
273,2,17,false,3,5,2,41.85783,-87.62455
13099,2,17,false,18,13,-5,41.85784,-87.64627
TA1307000159,2,17,false,20,20,0,41.8579,-87.6687
205,2,17,false,3,4,1,41.8579,-87.6687
TA1307000044,2,17,false,11,12,1,41.85794,-87.64083
13163,2,17,false,24,12,-12,41.85808,-87.65108
13164,2,17,false,17,19,2,41.85818,-87.65648
15,2,17,false,2,3,1,41.85819,-87.65648
SL-012,2,17,false,45,49,4,41.86038,-87.62581
72,2,17,false,2,3,1,41.86039,-87.62581
274,2,17,false,1,1,0,41.86126,-87.6566
13304,2,17,false,17,11,-6,41.86126,-87.65659
437,2,17,false,2,1,-1,41.86192,-87.69348
KA1504000109,2,17,false,8,1,-7,41.86192,-87.69347
137,2,17,false,2,1,-1,41.86238,-87.65108
TA1306000002,2,17,false,12,15,3,41.86238,-87.65108
TA1307000124,2,17,false,65,48,-17,41.86411,-87.62372
168,2,17,false,10,12,2,41.86415,-87.62372
TA1309000001,2,17,false,36,15,-21,41.86488,-87.64708
13165,2,17,false,10,10,0,41.86505,-87.65697
13354,2,17,false,6,1,-5,41.86524,-87.66651
13029,2,17,false,42,16,-26,41.86531,-87.6179
97,2,17,false,3,2,-1,41.86531,-87.6179
341,2,17,false,3,7,4,41.86608,-87.60733
13431,2,17,false,99,99,0,41.8661,-87.60728
15682,2,17,false,1,2,1,41.86651,-87.70649
KA1504000101,2,17,false,7,4,-3,41.86651,-87.68466
434,2,17,false,4,3,-1,41.86651,-87.68465
KA1504000102,2,17,false,4,2,-2,41.86664,-87.69453
WL-008,2,17,false,30,36,6,41.86712,-87.64108
57,2,17,false,3,5,2,41.86712,-87.64107
TA1305000002,2,17,false,114,88,-26,41.86721,-87.62597
59,2,17,false,15,13,-2,41.86721,-87.62597
15544,2,17,false,161,113,-48,41.86723,-87.61536
3,2,17,false,9,8,-1,41.86723,-87.61536
TA1305000017,2,17,false,17,12,-5,41.86734,-87.64863
55,2,17,false,3,1,-2,41.86735,-87.64863
KA1706005007,2,17,false,24,29,5,41.86749,-87.63219
SL-005,2,17,false,184,160,-24,41.8679,-87.62304
255,2,17,false,21,17,-4,41.86791,-87.62304
644,2,17,false,12,8,-4,41.86859,-87.68625
19,2,17,false,3,7,4,41.86892,-87.65913
13139,2,17,false,15,21,6,41.86893,-87.65913
13285,2,17,false,25,7,-18,41.86928,-87.67372
22,2,17,false,1,2,1,41.86947,-87.65548
13160,2,17,false,26,37,11,41.86947,-87.65548
414,2,17,false,2,3,1,41.87023,-87.63947
15550,2,17,false,25,29,4,41.87024,-87.63947
TA1309000010,2,17,false,91,62,-29,41.87074,-87.62574
SL-009,2,17,false,42,48,6,41.87081,-87.63121
342,2,17,false,4,1,-3,41.87127,-87.6737
TA1309000064,2,17,false,22,12,-10,41.87127,-87.67369
15542,2,17,false,7,3,-4,41.87146,-87.64095
TA1307000130,2,17,false,13,12,-1,41.87178,-87.65103
241,2,17,false,3,7,4,41.8718,-87.65102
TA1307000121,2,17,false,26,14,-12,41.87184,-87.64664
41,2,17,false,13,10,-3,41.87209,-87.62957
SL-008,2,17,false,80,98,18,41.87209,-87.62956
16912,2,17,false,2,1,-1,41.87213,-87.74664
13332,2,17,false,28,23,-5,41.87219,-87.6615
394,2,17,false,7,10,3,41.87226,-87.63484
175,2,17,false,11,10,-1,41.87255,-87.63359
SL-011,2,17,false,82,70,-12,41.87256,-87.63356
623,2,17,false,103,80,-23,41.87272,-87.62399
KA1504000104,2,17,false,36,2,-34,41.87296,-87.66912
383,2,17,false,14,1,-13,41.87297,-87.66912
320,2,17,false,4,3,-1,41.87327,-87.66402
5,2,17,false,7,8,1,41.87403,-87.6277
SL-007,2,17,false,43,31,-12,41.87404,-87.6277
13326,2,17,false,8,8,0,41.87425,-87.63958
321,2,17,false,7,16,9,41.87427,-87.63257
535,2,17,false,1,1,0,41.87433,-87.72582
TA1306000025,2,17,false,20,8,-12,41.87464,-87.65703
15668,2,17,false,8,5,-3,41.87471,-87.68642
109,2,17,false,1,4,3,41.87475,-87.64981
13028,2,17,false,25,31,6,41.87475,-87.64981
13081,2,17,false,16,2,-14,41.87501,-87.67326
89,2,17,false,8,4,-4,41.87501,-87.6331
SL-010,2,17,false,29,17,-12,41.87501,-87.63309
15541,2,17,false,117,107,-10,41.8758,-87.62086
68,2,17,false,2,1,-1,41.87587,-87.64077
13037,2,17,false,21,10,-11,41.87588,-87.64078
50,2,17,false,3,2,-1,41.87592,-87.6307
TA1305000009,2,17,false,21,14,-7,41.87593,-87.63068
317,2,17,false,4,1,-3,41.87603,-87.68195
TA1305000010,2,17,false,19,24,5,41.87623,-87.62444
624,2,17,false,49,30,-19,41.87626,-87.62923
2,2,17,false,12,1,-11,41.87649,-87.62051
TA1305000035,2,17,false,45,36,-9,41.87716,-87.62787
13138,2,17,false,25,7,-18,41.87723,-87.63941
75,2,17,false,14,2,-12,41.87724,-87.63937
631,2,17,false,9,2,-7,41.87761,-87.6739
16913,2,17,false,1,1,0,41.87762,-87.7454
15539,2,17,false,32,23,-9,41.87763,-87.64405
13158,2,17,false,49,53,4,41.87764,-87.64957
134,2,17,false,7,5,-2,41.87764,-87.64954
13157,2,17,false,38,39,1,41.87773,-87.6548
21,2,17,false,5,11,6,41.87773,-87.6548
TA1305000025,2,17,false,116,72,-44,41.87773,-87.63528
36,2,17,false,13,5,-8,41.87776,-87.63525
TA1309000002,2,17,false,58,46,-12,41.87784,-87.62408
146,2,17,false,3,2,-1,41.87794,-87.66201
13206,2,17,false,23,23,0,41.87794,-87.66201
283,2,17,false,7,1,-6,41.87809,-87.63183
TA1309000004,2,17,false,54,24,-30,41.87811,-87.63184
107,2,17,false,3,9,6,41.87822,-87.644
638,2,17,false,64,28,-36,41.87827,-87.64078
TA1305000005,2,17,false,37,19,-18,41.87924,-87.62975
13011,2,17,false,119,53,-66,41.87931,-87.63993
TA1309000008,2,17,false,41,32,-9,41.87933,-87.6355
192,2,17,false,17,5,-12,41.87935,-87.63997
KA1503000034,2,17,false,22,8,-14,41.87938,-87.63197
39,2,17,false,11,3,-8,41.87948,-87.62571
KA1503000015,2,17,false,51,44,-7,41.87948,-87.6257
15667,2,17,false,11,9,-2,41.8798,-87.68609
381,2,17,false,1,1,0,41.87981,-87.68607
16916,2,17,false,1,1,0,41.88012,-87.76323
287,2,17,false,16,1,-15,41.88017,-87.63527
TA1309000007,2,17,false,84,13,-71,41.88022,-87.63526
WL-011,2,17,false,39,28,-11,41.88034,-87.64273
73,2,17,false,7,1,-6,41.8804,-87.64273
80,2,17,false,4,4,0,41.88042,-87.65556
13156,2,17,false,68,46,-22,41.88042,-87.65554
534,2,17,false,1,2,1,41.88085,-87.72793
13300,2,17,false,239,278,39,41.88097,-87.61675
76,2,17,false,40,20,-20,41.88098,-87.61675
13008,2,17,false,238,249,11,41.88105,-87.62408
90,2,17,false,13,15,2,41.88107,-87.62409
49,2,17,false,12,7,-5,41.88116,-87.62963
TA1305000006,2,17,false,72,37,-35,41.88122,-87.6296
13134,2,17,false,22,12,-10,41.88138,-87.67493
215,2,17,false,2,2,0,41.88139,-87.67492
13056,2,17,false,44,26,-18,41.88168,-87.63951
191,2,17,false,5,2,-3,41.88169,-87.63951
198,2,17,false,19,10,-9,41.88187,-87.6488
TA1307000120,2,17,false,121,102,-19,41.88188,-87.64879
13341,2,17,false,92,62,-30,41.88208,-87.63985
174,2,17,false,11,2,-9,41.88208,-87.63984
13036,2,17,false,80,59,-21,41.8821,-87.62513
77,2,17,false,12,9,-3,41.88214,-87.64108
TA1305000032,2,17,false,134,85,-49,41.88218,-87.64109
98,2,17,false,3,2,-1,41.88266,-87.63251
13006,2,17,false,39,23,-16,41.88268,-87.63252
13353,2,17,false,35,43,8,41.88283,-87.6612
346,2,17,false,2,7,5,41.88284,-87.6612
654,2,17,false,23,31,8,41.88307,-87.65698
233,2,17,false,2,4,2,41.88309,-87.6511
13409,2,17,false,54,44,-10,41.8831,-87.6511
KA1503000072,2,17,false,40,24,-16,41.88317,-87.63693
91,2,17,false,7,5,-2,41.88336,-87.64122
WL-012,2,17,false,161,78,-83,41.88337,-87.6412
112,2,17,false,4,8,4,41.88362,-87.6486
13053,2,17,false,90,105,15,41.88365,-87.64863
43,2,17,false,16,12,-4,41.88396,-87.62455
13001,2,17,false,104,111,7,41.88397,-87.62459
88,2,17,false,2,5,3,41.88407,-87.65691
13155,2,17,false,31,26,-5,41.88407,-87.65689
18062,2,17,false,59,28,-31,41.88412,-87.65427
621,2,17,false,3,4,1,41.88412,-87.65427
81,2,17,false,26,9,-17,41.88417,-87.6296
TA1306000010,2,17,false,123,49,-74,41.88419,-87.62961
15666,2,17,false,11,3,-8,41.88446,-87.6963
KA1504000106,2,17,false,3,2,-1,41.88459,-87.70631
TA1305000030,2,17,false,127,42,-85,41.88459,-87.63178
96,2,17,false,7,5,-2,41.8846,-87.64455
15535,2,17,false,59,73,14,41.8846,-87.64455
51,2,17,false,10,4,-6,41.88462,-87.63176
TA1305000029,2,17,false,97,111,14,41.88466,-87.62787
195,2,17,false,13,7,-6,41.88466,-87.61952
13263,2,17,false,88,71,-17,41.88467,-87.61952
44,2,17,false,7,5,-2,41.88468,-87.62782
TA1306000015,2,17,false,102,102,0,41.88549,-87.65232
518,2,17,false,3,3,0,41.8855,-87.71686
71,2,17,false,6,11,5,41.8855,-87.65233
66,2,17,false,8,5,-3,41.88557,-87.64186
13021,2,17,false,65,46,-19,41.88559,-87.64184
TA1307000111,2,17,false,97,55,-42,41.88582,-87.63548
164,2,17,false,17,2,-15,41.88583,-87.63547
13073,2,17,false,27,21,-6,41.88592,-87.66717
536,2,17,false,2,1,-1,41.88593,-87.7354
119,2,17,false,2,1,-1,41.88593,-87.66717
KA17018054,2,17,false,13,8,-5,41.88595,-87.67701
KA1503000012,2,17,false,98,52,-46,41.88599,-87.63089
38,2,17,false,15,13,-2,41.88599,-87.63089
52,2,17,false,20,21,1,41.886,-87.62421
TA1305000011,2,17,false,110,122,12,41.886,-87.62418
7,2,17,false,7,4,-3,41.88627,-87.61751
15534,2,17,false,64,60,-4,41.88627,-87.61749
13197,2,17,false,30,16,-14,41.8866,-87.65816
264,2,17,false,6,7,1,41.8867,-87.62224
TA1308000029,2,17,false,45,44,-1,41.88673,-87.62225
194,2,17,false,3,8,5,41.88688,-87.62606
TA1307000131,2,17,false,77,92,15,41.88688,-87.62606
KA1503000064,2,17,false,139,123,-16,41.88697,-87.61281
6,2,17,false,11,11,0,41.88697,-87.61281
16905,2,17,false,4,2,-2,41.88767,-87.76547
530,2,17,false,7,4,-3,41.88783,-87.75558
16906,2,17,false,3,4,1,41.88792,-87.77445
100,2,17,false,21,7,-14,41.88814,-87.63657
TA1305000022,2,17,false,81,59,-22,41.88817,-87.63656
56,2,17,false,20,10,-10,41.88866,-87.64442
TA1306000003,2,17,false,136,83,-53,41.88867,-87.64442
KA1503000043,2,17,false,180,129,-51,41.88918,-87.63851
133,2,17,false,21,5,-16,41.88918,-87.63851
13050,2,17,false,85,84,-1,41.88919,-87.62775
47,2,17,false,9,5,-4,41.88921,-87.62775
15664,2,17,false,5,7,2,41.8895,-87.68821
13432,2,17,false,16,15,-1,41.88989,-87.67149
285,2,17,false,1,1,0,41.88989,-87.67149
TA1307000151,2,17,false,116,77,-39,41.88993,-87.63427
Hubbard Bike-checking (LBS-WH-TEST),2,17,false,3,2,-1,41.88995,-87.68034
212,2,17,false,16,10,-6,41.88995,-87.63427
636,2,17,false,64,44,-20,41.88997,-87.63662
125,2,17,false,5,1,-4,41.89018,-87.62621
KA1503000044,2,17,false,51,32,-19,41.89018,-87.6262
KA1504000113,2,17,false,2,2,0,41.89049,-87.70262
196,2,17,false,9,13,4,41.89053,-87.62205
13427,2,17,false,73,52,-21,41.89054,-87.62205
26,2,17,false,10,11,1,41.89057,-87.61798
13430,2,17,false,125,137,12,41.89077,-87.63169
181,2,17,false,18,9,-9,41.89077,-87.63168
TA1306000013,2,17,false,137,127,-10,41.89083,-87.61852
RN-,2,17,false,86,78,-8,41.89102,-87.63546
672,2,17,false,13,10,-3,41.89102,-87.63545
13434,2,17,false,34,35,1,41.89108,-87.66663
TA1308000006,2,17,false,31,35,4,41.89128,-87.67686
199,2,17,false,18,20,2,41.89143,-87.62676
TA1307000117,2,17,false,138,153,15,41.89144,-87.62675
13033,2,17,false,100,92,-8,41.8916,-87.64835
214,2,17,false,2,2,0,41.89161,-87.67688
84,2,17,false,10,9,-1,41.89161,-87.64833
186,2,17,false,2,10,8,41.8918,-87.65879
13194,2,17,false,49,48,-1,41.8918,-87.65878
TA1305000003,2,17,false,119,122,3,41.89187,-87.62061
24,2,17,false,7,24,17,41.8919,-87.62063
643,2,17,false,7,32,25,41.89203,-87.68939
35,2,17,false,20,14,-6,41.89227,-87.61206
13022,2,17,false,556,523,-33,41.89227,-87.61205
99,2,17,false,5,10,5,41.89255,-87.61449
TA1306000029,2,17,false,136,110,-26,41.89256,-87.61449
13265,2,17,false,107,81,-26,41.89383,-87.64172
74,2,17,false,11,5,-6,41.89384,-87.64173
13045,2,17,false,166,114,-52,41.89403,-87.62931
110,2,17,false,21,17,-4,41.89406,-87.6293
13016,2,17,false,89,74,-15,41.89431,-87.62277
211,2,17,false,5,5,0,41.89439,-87.62267
KA1503000041,2,17,false,50,60,10,41.89452,-87.61798
142,2,17,false,3,10,7,41.89453,-87.61806
92,2,17,false,8,1,-7,41.89455,-87.65346
13196,2,17,false,60,47,-13,41.89455,-87.65345
TA1307000062,2,17,false,44,35,-9,41.89466,-87.63839
111,2,17,false,6,5,-1,41.89466,-87.63837
642,2,17,false,1,2,1,41.89473,-87.75689
TA1306000012,2,17,false,147,136,-11,41.89475,-87.63438
53,2,17,false,23,15,-8,41.89476,-87.63439
627,2,17,false,5,4,-1,41.8948,-87.63231
KP1705001026,2,17,false,64,80,16,41.89483,-87.6323
16921,2,17,false,1,1,0,41.89488,-87.77459
KA1504000114,2,17,false,3,3,0,41.89547,-87.70614
659,2,17,false,3,5,2,41.8955,-87.68201
18058,2,17,false,17,25,8,41.8955,-87.68201
637,2,17,false,33,39,6,41.89563,-87.67209
128,2,17,false,6,14,8,41.89571,-87.67716
13132,2,17,false,66,59,-7,41.89573,-87.67718
161,2,17,false,6,11,5,41.89574,-87.62599
15530,2,17,false,67,101,34,41.89575,-87.62596
18003,2,17,false,22,23,1,41.89575,-87.62011
635,2,17,false,4,2,-2,41.89576,-87.62012
13247,2,17,false,49,45,-4,41.89597,-87.66775
350,2,17,false,2,4,2,41.89597,-87.66774
TA1305000020,2,17,false,55,48,-7,41.89636,-87.65406
54,2,17,false,3,9,6,41.89637,-87.65407
13289,2,17,false,63,58,-5,41.89638,-87.661
86,2,17,false,8,9,1,41.89639,-87.661
337,2,17,false,9,2,-7,41.89659,-87.63096
13303,2,17,false,66,61,-5,41.89672,-87.63088
13017,2,17,false,54,50,-4,41.89676,-87.6357
31,2,17,false,14,6,-8,41.89677,-87.63572
13338,2,17,false,42,67,25,41.89697,-87.62173
173,2,17,false,7,7,0,41.89704,-87.62173
TA1307000061,2,17,false,34,39,5,41.89745,-87.62873
106,2,17,false,3,13,10,41.89746,-87.62874
25,2,17,false,12,5,-7,41.89751,-87.62354
13034,2,17,false,81,65,-16,41.89754,-87.62352
48,2,17,false,6,5,-1,41.89772,-87.64302
TA1306000009,2,17,false,57,46,-11,41.89772,-87.64299
620,2,17,false,89,68,-21,41.89817,-87.63754
KA1504000103,2,17,false,37,28,-9,41.89842,-87.68659
374,2,17,false,2,5,3,41.89842,-87.68659
145,2,17,false,13,7,-6,41.89856,-87.62211
15529,2,17,false,76,66,-10,41.89858,-87.62206
140,2,17,false,10,12,2,41.89895,-87.6299
TA1307000128,2,17,false,142,119,-23,41.89896,-87.6299
657,2,17,false,39,21,-18,41.89918,-87.6722
KA1504000117,2,17,false,8,15,7,41.89936,-87.64848
30,2,17,false,2,7,5,41.89964,-87.66789
13248,2,17,false,37,23,-14,41.89964,-87.66788
46,2,17,false,5,4,-1,41.89994,-87.63444
TA1306000011,2,17,false,50,40,-10,41.89994,-87.63443
KA1504000116,2,17,false,42,15,-27,41.90023,-87.64299
364,2,17,false,4,3,-1,41.90023,-87.64299
17660,2,17,false,42,25,-17,41.90036,-87.69671
622,2,17,false,2,2,0,41.90037,-87.69671
29,2,17,false,2,3,1,41.90069,-87.66259
13290,2,17,false,32,36,4,41.90069,-87.66259
13042,2,17,false,268,269,1,41.90097,-87.62377
85,2,17,false,36,13,-23,41.90098,-87.62375
183,2,17,false,6,3,-3,41.90133,-87.67744
TA1307000070,2,17,false,37,31,-6,41.90133,-87.67742
KA1504000133,2,17,false,102,99,-3,41.90234,-87.62773
172,2,17,false,6,13,7,41.90236,-87.62774
15654,2,17,false,9,13,4,41.90271,-87.70923
510,2,17,false,1,4,3,41.90272,-87.70923
305,2,17,false,2,3,1,41.9028,-87.69005
13241,2,17,false,23,19,-4,41.9029,-87.68731
176,2,17,false,34,20,-14,41.90291,-87.63141
23,2,17,false,2,1,-1,41.90292,-87.63772
TA1306000006,2,17,false,35,45,10,41.90292,-87.63772
TA1307000039,2,17,false,172,160,-12,41.90294,-87.63137
658,2,17,false,17,14,-3,41.903,-87.6838
216,2,17,false,1,2,1,41.90302,-87.69749
13256,2,17,false,11,25,14,41.90302,-87.69749
TA1305000034,2,17,false,49,44,-5,41.90313,-87.67391
17,2,17,false,5,5,0,41.90313,-87.67391
182,2,17,false,20,28,8,41.90317,-87.63442
KA1504000135,2,17,false,233,196,-37,41.90319,-87.63439
13136,2,17,false,57,37,-20,41.90326,-87.67845
130,2,17,false,4,4,0,41.90327,-87.67846
210,2,17,false,13,12,-1,41.90342,-87.66781
13061,2,17,false,124,82,-42,41.90342,-87.66779
KA1504000079,2,17,false,77,61,-16,41.9035,-87.64334
398,2,17,false,3,2,-1,41.90386,-87.70941
359,2,17,false,7,10,3,41.90458,-87.6497
138,2,17,false,2,5,3,41.9046,-87.64057
TA1307000115,2,17,false,31,32,1,41.9046,-87.64056
291,2,17,false,13,16,3,41.90672,-87.63494
TA1308000049,2,17,false,139,138,-1,41.90672,-87.6349
KA1504000134,2,17,false,73,74,1,41.90687,-87.6262
180,2,17,false,4,8,4,41.90687,-87.62618
13224,2,17,false,76,38,-38,41.90706,-87.66725
333,2,17,false,12,9,-3,41.90706,-87.66725
18069,2,17,false,22,4,-18,41.90722,-87.65563
666,2,17,false,2,1,-1,41.90723,-87.65564
TA1307000143,2,17,false,33,28,-5,41.90762,-87.63854
236,2,17,false,4,6,2,41.90762,-87.63853
61,2,17,false,11,9,-2,41.90764,-87.67254
13221,2,17,false,82,74,-8,41.90765,-87.67254
13245,2,17,false,22,18,-4,41.90777,-87.68586
159,2,17,false,3,1,-2,41.90777,-87.68586
301,2,17,false,19,18,-1,41.90796,-87.63203
TA1309000024,2,17,false,126,99,-27,41.908,-87.63152
69,2,17,false,12,14,2,41.90939,-87.6777
TA1305000041,2,17,false,89,74,-15,41.9094,-87.67769
15652,2,17,false,9,10,1,41.90965,-87.71664
331,2,17,false,93,117,24,41.90965,-87.64812
15653,2,17,false,17,15,-2,41.90979,-87.7053
TA1305000037,2,17,false,58,41,-17,41.91018,-87.67003
27,2,17,false,2,4,2,41.91019,-87.6435
TA1306000008,2,17,false,48,41,-7,41.9102,-87.6435
213,2,17,false,5,4,-1,41.91037,-87.68237
TA1308000005,2,17,false,39,20,-19,41.91042,-87.68238
276,2,17,false,3,3,0,41.91043,-87.69718
13258,2,17,false,16,28,12,41.91043,-87.69718
160,2,17,false,5,2,-3,41.91054,-87.68957
13257,2,17,false,47,26,-21,41.91054,-87.68956
13154,2,17,false,69,63,-6,41.91054,-87.65312
20,2,17,false,6,14,8,41.91055,-87.65313
60,2,17,false,5,4,-1,41.91059,-87.64942
13058,2,17,false,53,61,8,41.91059,-87.64942
118,2,17,false,6,8,2,41.91138,-87.63868
TA1307000038,2,17,false,64,87,23,41.91138,-87.63868
268,2,17,false,22,29,7,41.91172,-87.62681
LF-005,2,17,false,244,595,351,41.91172,-87.62681
126,2,17,false,8,18,10,41.91196,-87.63197
13128,2,17,false,48,118,70,41.91197,-87.63197
289,2,17,false,18,22,4,41.91209,-87.63472
TA1308000050,2,17,false,156,154,-2,41.91211,-87.6347
158,2,17,false,5,9,4,41.91262,-87.6814
13243,2,17,false,60,65,5,41.91262,-87.6814
TA1309000032,2,17,false,29,24,-5,41.91293,-87.66417
315,2,17,false,1,2,1,41.91293,-87.66417
TA1306000032,2,17,false,55,51,-4,41.9137,-87.65285
93,2,17,false,9,9,0,41.91371,-87.65285
224,2,17,false,3,9,6,41.91386,-87.64877
TA1307000166,2,17,false,43,49,6,41.91386,-87.64877
511,2,17,false,2,4,2,41.914,-87.70515
15655,2,17,false,13,10,-3,41.91401,-87.70514
18017,2,17,false,20,14,-6,41.91416,-87.71676
18067,2,17,false,42,37,-5,41.9146,-87.66796
628,2,17,false,4,1,-3,41.9146,-87.66796
TA1306000007,2,17,false,30,20,-10,41.91469,-87.64333
28,2,17,false,6,3,-3,41.91469,-87.64333
13068,2,17,false,33,30,-3,41.91554,-87.68703
116,2,17,false,5,1,-4,41.91555,-87.68703
13179,2,17,false,139,207,68,41.9157,-87.63461
141,2,17,false,14,22,8,41.91571,-87.63461
219,2,17,false,8,8,0,41.91598,-87.67733
13133,2,17,false,50,60,10,41.91598,-87.67733
58,2,17,false,6,4,-2,41.91602,-87.66894
TA1305000039,2,17,false,46,41,-5,41.9163,-87.66749
506,2,17,false,3,1,-2,41.91711,-87.71023
15650,2,17,false,12,23,11,41.91711,-87.71023
507,2,17,false,1,6,5,41.91752,-87.70181
15651,2,17,false,22,39,17,41.91752,-87.70181
13266,2,17,false,21,18,-3,41.91774,-87.69142
TA1309000029,2,17,false,33,17,-16,41.9178,-87.68245
TA1309000006,2,17,false,43,32,-11,41.91809,-87.64375
288,2,17,false,3,10,7,41.91809,-87.64375
223,2,17,false,10,4,-6,41.91821,-87.65698
TA1307000163,2,17,false,71,41,-30,41.91821,-87.65696
94,2,17,false,16,15,-1,41.91831,-87.6363
13146,2,17,false,131,111,-20,41.91831,-87.63629
13059,2,17,false,113,78,-35,41.91845,-87.65222
113,2,17,false,16,6,-10,41.91846,-87.65222
13259,2,17,false,14,27,13,41.91852,-87.69744
259,2,17,false,1,1,0,41.91853,-87.69745
310,2,17,false,7,2,-5,41.91984,-87.68083
225,2,17,false,10,9,-1,41.91995,-87.64884
13192,2,17,false,56,67,11,41.91995,-87.64884
13288,2,17,false,28,24,-4,41.92008,-87.67788
13242,2,17,false,5,16,11,41.92021,-87.69266
222,2,17,false,2,4,2,41.92023,-87.69265
307,2,17,false,1,2,1,41.92077,-87.66373
TA1309000030,2,17,false,35,66,31,41.92077,-87.66372
290,2,17,false,1,2,1,41.92152,-87.70734
13292,2,17,false,24,20,-4,41.92152,-87.70733
TA1309000033,2,17,false,80,75,-5,41.92158,-87.65381
13193,2,17,false,125,155,30,41.92182,-87.64412
144,2,17,false,8,9,1,41.92182,-87.64411
13191,2,17,false,71,71,0,41.92217,-87.63891
143,2,17,false,12,13,1,41.92217,-87.63891
327,2,17,false,9,5,-4,41.92225,-87.65783
13084,2,17,false,25,40,15,41.92268,-87.69715
123,2,17,false,6,7,1,41.92268,-87.69714
LP-,2,17,false,97,58,-39,41.92396,-87.63584
673,2,17,false,10,12,2,41.92398,-87.63585
KA1504000140,2,17,false,28,13,-15,41.92409,-87.67646
16010,2,17,false,4,12,8,41.92458,-87.72787
15648,2,17,false,11,11,0,41.92464,-87.68931
504,2,17,false,2,3,1,41.92464,-87.68931
503,2,17,false,1,5,4,41.92483,-87.71451
KA1504000090,2,17,false,7,13,6,41.92483,-87.7145
TA1307000001,2,17,false,56,69,13,41.92535,-87.66581
188,2,17,false,7,7,0,41.92536,-87.66581
TA1306000026,2,17,false,49,47,-2,41.92558,-87.65842
87,2,17,false,6,10,4,41.92559,-87.65843
TA1306000016,2,17,false,76,65,-11,41.9256,-87.65371
67,2,17,false,4,4,0,41.9256,-87.65371
313,2,17,false,15,22,7,41.9257,-87.64246
TA1309000019,2,17,false,159,152,-7,41.92586,-87.63897
TA1309000058,2,17,false,122,114,-8,41.92591,-87.64927
127,2,17,false,13,13,0,41.92592,-87.64927
177,2,17,false,12,20,8,41.92627,-87.63086
TA1308000001,2,17,false,191,212,21,41.92627,-87.63086
502,2,17,false,1,7,6,41.92667,-87.69772
15646,2,17,false,23,18,-5,41.92668,-87.6977
13124,2,17,false,47,56,9,41.92675,-87.63444
302,2,17,false,8,11,3,41.92859,-87.65421
TA1309000023,2,17,false,80,81,1,41.9287,-87.65383
TA1307000113,2,17,false,56,43,-13,41.92878,-87.66391
190,2,17,false,4,3,-1,41.92878,-87.6639
166,2,17,false,3,3,0,41.92883,-87.66853
13296,2,17,false,40,33,-7,41.92883,-87.66852
TA1309000059,2,17,false,49,26,-23,41.92889,-87.65898
343,2,17,false,4,9,5,41.92889,-87.65898
349,2,17,false,13,19,6,41.92915,-87.6491
TA1309000061,2,17,false,87,68,-19,41.92915,-87.64909
TA1308000031,2,17,false,35,33,-2,41.92946,-87.68417
TA1305000014,2,17,false,108,103,-5,41.92956,-87.64313
340,2,17,false,19,22,3,41.92956,-87.64313
260,2,17,false,10,5,-5,41.92958,-87.70791
13085,2,17,false,33,48,15,41.92958,-87.70789
499,2,17,false,1,5,4,41.93056,-87.72381
15643,2,17,false,16,6,-10,41.93057,-87.7238
TA1307000142,2,17,false,114,81,-33,41.93125,-87.64432
220,2,17,false,9,20,11,41.93125,-87.64431
13276,2,17,false,131,101,-30,41.93132,-87.63874
324,2,17,false,19,15,-4,41.93173,-87.64179
15645,2,17,false,7,12,5,41.93191,-87.70121
13271,2,17,false,35,34,-1,41.93192,-87.67784
152,2,17,false,13,8,-5,41.93221,-87.65864
TA1307000064,2,17,false,65,70,5,41.93222,-87.65864
TA1306000014,2,17,false,125,69,-56,41.93242,-87.65271
13,2,17,false,14,11,-3,41.93242,-87.65271
329,2,17,false,7,16,9,41.93258,-87.63642
TA1309000039,2,17,false,103,139,36,41.93258,-87.63642
13294,2,17,false,43,22,-21,41.9326,-87.66595
319,2,17,false,4,3,-1,41.93292,-87.67217
TA1309000036,2,17,false,71,47,-24,41.93313,-87.64776
332,2,17,false,6,13,7,41.93313,-87.64776
15644,2,17,false,12,4,-8,41.93534,-87.71687
500,2,17,false,1,2,1,41.93534,-87.71686
TA1307000006,2,17,false,64,46,-18,41.93571,-87.6636
153,2,17,false,7,5,-2,41.93575,-87.66364
162,2,17,false,5,13,8,41.93588,-87.67844
13268,2,17,false,33,34,1,41.93588,-87.67843
250,2,17,false,3,2,-1,41.93609,-87.66984
13269,2,17,false,22,10,-12,41.93609,-87.66983
115,2,17,false,16,12,-4,41.93628,-87.65266
TA1307000052,2,17,false,59,67,8,41.93628,-87.65266
156,2,17,false,7,13,6,41.9365,-87.64756
TA1307000136,2,17,false,89,83,-6,41.9365,-87.64755
TA1307000041,2,17,false,131,132,1,41.93669,-87.63683
157,2,17,false,9,20,11,41.9367,-87.63683
13137,2,17,false,162,99,-63,41.9376,-87.6441
300,2,17,false,12,22,10,41.93761,-87.6441
15642,2,17,false,12,18,6,41.93843,-87.69801
154,2,17,false,8,8,0,41.93912,-87.66384
664,2,17,false,8,3,-5,41.93934,-87.68327
KA17018068,2,17,false,26,19,-7,41.93935,-87.68327
TA1309000042,2,17,false,59,29,-30,41.93937,-87.66836
131,2,17,false,13,7,-6,41.93937,-87.66835
496,2,17,false,2,3,1,41.9394,-87.72356
KA150400009X,2,17,false,3,1,-2,41.9394,-87.71159
15640,2,17,false,6,5,-1,41.93941,-87.72357
13229,2,17,false,51,42,-9,41.93946,-87.66376
226,2,17,false,6,9,3,41.93972,-87.65886
TA1308000019,2,17,false,76,63,-13,41.93973,-87.65886
296,2,17,false,11,6,-5,41.9401,-87.64546
13277,2,17,false,77,86,9,41.9401,-87.64546
TA1307000134,2,17,false,131,113,-18,41.94016,-87.65303
117,2,17,false,23,19,-4,41.94016,-87.65302
228,2,17,false,2,2,0,41.94058,-87.67854
13143,2,17,false,19,15,-4,41.94059,-87.67853
334,2,17,false,14,27,13,41.94076,-87.63919
TA1309000049,2,17,false,135,108,-27,41.94077,-87.63919
15634,2,17,false,10,5,-5,41.94304,-87.68729
493,2,17,false,1,3,2,41.94304,-87.68729
TA1307000138,2,17,false,49,45,-4,41.94334,-87.67094
230,2,17,false,7,5,-2,41.94335,-87.67093
13144,2,17,false,29,20,-9,41.9434,-87.67964
299,2,17,false,10,10,0,41.94368,-87.64894
TA1309000025,2,17,false,122,141,19,41.94368,-87.64894
229,2,17,false,15,16,1,41.94372,-87.66401
13071,2,17,false,100,84,-16,41.94373,-87.66401
632,2,17,false,94,138,44,41.94453,-87.6547
303,2,17,false,12,9,-3,41.94522,-87.64702
15631,2,17,false,3,9,6,41.94524,-87.70665
13278,2,17,false,78,74,-4,41.94553,-87.64644
TA1309000050,2,17,false,13,14,1,41.94618,-87.67331
KA1504000141,2,17,false,7,1,-6,41.94627,-87.73105
15632,2,17,false,9,6,-3,41.94664,-87.69463
491,2,17,false,1,1,0,41.94664,-87.69463
KA1504000143,2,17,false,5,4,-1,41.94664,-87.68337
KA1504000142,2,17,false,7,3,-4,41.94735,-87.71759
16994,2,17,false,2,2,0,41.94784,-87.74
227,2,17,false,14,5,-9,41.94813,-87.66397
13235,2,17,false,69,85,16,41.94814,-87.66396
304,2,17,false,6,6,0,41.94878,-87.64922
13253,2,17,false,12,15,3,41.9488,-87.67527
13325,2,17,false,84,96,12,41.94907,-87.64863
114,2,17,false,5,9,4,41.94935,-87.65451
TA1307000126,2,17,false,51,154,103,41.94936,-87.65451
232,2,17,false,13,16,3,41.94943,-87.64645
TA1307000150,2,17,false,85,106,21,41.94945,-87.64646
18016,2,17,false,4,5,1,41.94993,-87.71395
347,2,17,false,2,3,1,41.95068,-87.6687
13319,2,17,false,27,29,2,41.95069,-87.6687
TA1307000127,2,17,false,91,130,39,41.9508,-87.65918
165,2,17,false,10,17,7,41.95081,-87.65918
487,2,17,false,4,2,-2,41.95216,-87.69806
15628,2,17,false,4,14,10,41.95216,-87.69806
318,2,17,false,2,1,-1,41.95254,-87.6735
13323,2,17,false,56,53,-3,41.95282,-87.65
256,2,17,false,3,7,4,41.95282,-87.65
15624,2,17,false,9,4,-5,41.95339,-87.73199
314,2,17,false,2,3,1,41.9535,-87.69199
KA1504000096,2,17,false,8,4,-4,41.95361,-87.70932
590,2,17,false,4,7,3,41.95374,-87.74056
KA1504000139,2,17,false,10,12,2,41.954,-87.71909
TA1309000043,2,17,false,28,26,-2,41.95417,-87.66434
240,2,17,false,11,4,-7,41.95424,-87.65441
13063,2,17,false,56,58,2,41.95424,-87.65441
486,2,17,false,6,2,-4,41.95431,-87.68607
KA1504000158,2,17,false,15,5,-10,41.95432,-87.68607
254,2,17,false,8,4,-4,41.95438,-87.64806
TA1308000022,2,17,false,64,55,-9,41.95438,-87.64805
16991,2,17,false,4,4,0,41.95448,-87.7496
TA1307000149,2,17,false,21,21,0,41.95467,-87.67392
298,2,17,false,3,3,0,41.95601,-87.68021
TA1309000026,2,17,false,19,25,6,41.95601,-87.6802
246,2,17,false,2,3,1,41.95606,-87.66885
13249,2,17,false,10,16,6,41.95606,-87.66885
312,2,17,false,6,9,3,41.95637,-87.6563
TA1308000047,2,17,false,10,10,0,41.95709,-87.6642
13379,2,17,false,54,34,-20,41.95786,-87.6495
TA1309000018,2,17,false,14,7,-7,41.95791,-87.67357
306,2,17,false,5,8,3,41.9585,-87.655
TA1309000027,2,17,false,28,14,-14,41.9585,-87.65499
13389,2,17,false,56,42,-14,41.961,-87.64958
245,2,17,false,14,2,-12,41.96101,-87.64958
15621,2,17,false,3,2,-1,41.96103,-87.70586
KA1706005015,2,17,false,1,3,2,41.96108,-87.73569
15622,2,17,false,13,11,-2,41.96108,-87.69544
481,2,17,false,3,1,-2,41.96108,-87.69544
KA1504000164,2,17,false,3,3,0,41.96109,-87.72897
KA1504000097,2,17,false,7,3,-4,41.96116,-87.71658
238,2,17,false,1,1,0,41.96141,-87.6762
TA1307000144,2,17,false,18,19,1,41.96142,-87.6762
297,2,17,false,2,2,0,41.9615,-87.67141
TA1309000021,2,17,false,15,9,-6,41.9615,-87.6714
482,2,17,false,1,4,3,41.96154,-87.69117
15623,2,17,false,4,9,5,41.96154,-87.69117
234,2,17,false,1,1,0,41.96158,-87.6661
KA1503000022,2,17,false,19,19,0,41.96158,-87.66609
231,2,17,false,10,10,0,41.96163,-87.65464
TA1307000107,2,17,false,59,51,-8,41.96164,-87.65464
TA1307000156,2,17,false,17,16,-1,41.96301,-87.68479
243,2,17,false,2,4,2,41.96302,-87.68479
TA1309000012,2,17,false,21,11,-10,41.96325,-87.67928
TA1308000012,2,17,false,96,89,-7,41.96398,-87.63818
249,2,17,false,6,5,-1,41.96398,-87.63818
293,2,17,false,3,6,3,41.96521,-87.65822
13074,2,17,false,39,32,-7,41.96521,-87.6582
639,2,17,false,46,59,13,41.96584,-87.64538
KA1504000127,2,17,false,8,5,-3,41.96587,-87.70083
477,2,17,false,2,2,0,41.96587,-87.70083
KA1504000093,2,17,false,5,8,3,41.96587,-87.69365
TA1307000140,2,17,false,18,15,-3,41.96643,-87.68865
239,2,17,false,2,2,0,41.9665,-87.68843
326,2,17,false,4,6,2,41.96665,-87.67113
KA1504000126,2,17,false,15,5,-10,41.96668,-87.70807
476,2,17,false,2,3,1,41.96668,-87.70807
TA1309000014,2,17,false,32,35,3,41.96709,-87.66744
TA1307000158,2,17,false,17,11,-6,41.9671,-87.67904
242,2,17,false,3,1,-2,41.9671,-87.67904
251,2,17,false,2,5,3,41.96796,-87.65
TA1307000119,2,17,false,28,32,4,41.96796,-87.65
15615,2,17,false,6,5,-1,41.96835,-87.71183
474,2,17,false,1,2,1,41.96835,-87.71182
323,2,17,false,8,10,2,41.96869,-87.66034
TA1308000021,2,17,false,40,21,-19,41.96883,-87.65765
253,2,17,false,2,2,0,41.96883,-87.65765
475,2,17,false,3,1,-2,41.96885,-87.69611
KA1504000080,2,17,false,10,9,-1,41.96887,-87.69609
TA1309000015,2,17,false,8,5,-3,41.96889,-87.68401
TA1309000066,2,17,false,49,45,-4,41.9691,-87.67423
344,2,17,false,7,9,2,41.9691,-87.67423
TA1309000041,2,17,false,32,11,-21,41.96951,-87.65471
KA1504000171,2,17,false,52,39,-13,41.97161,-87.65016
465,2,17,false,7,7,0,41.97161,-87.65016
325,2,17,false,2,3,1,41.9728,-87.67186
TA1309000035,2,17,false,45,49,4,41.97335,-87.66785
295,2,17,false,4,3,-1,41.97378,-87.65972
13108,2,17,false,28,34,6,41.97379,-87.65971
KA1504000078,2,17,false,12,14,2,41.97491,-87.69258
472,2,17,false,6,6,0,41.97492,-87.69262
464,2,17,false,5,1,-4,41.97562,-87.67945
KA1504000149,2,17,false,13,13,0,41.97562,-87.67945
KA1504000160,2,17,false,11,3,-8,41.97564,-87.70143
KA1504000128,2,17,false,9,6,-3,41.97567,-87.70927
463,2,17,false,4,3,-1,41.978,-87.66805
KA1504000146,2,17,false,26,43,17,41.978,-87.66805
13109,2,17,false,39,22,-17,41.97835,-87.65976
294,2,17,false,5,3,-2,41.97835,-87.65976
KA1504000147,2,17,false,3,1,-2,41.97976,-87.67754
655,2,17,false,2,6,4,41.97987,-87.68194
KA1504000161,2,17,false,9,4,-5,41.98038,-87.71612
KA1504000167,2,17,false,6,1,-5,41.98206,-87.70895
KA1504000151,2,17,false,18,21,3,41.98359,-87.66916
15585,2,17,false,4,3,-1,41.98367,-87.69642
KA1504000152,2,17,false,86,61,-25,41.98403,-87.65231
459,2,17,false,12,9,-3,41.98403,-87.65231
15578,2,17,false,25,17,-8,41.98405,-87.66027
461,2,17,false,6,2,-4,41.98405,-87.66027
353,2,17,false,2,3,1,41.98656,-87.70761
15575,2,17,false,37,25,-12,41.98975,-87.66014
458,2,17,false,5,5,0,41.98975,-87.66013
KA1504000130,2,17,false,1,4,3,41.99024,-87.69338
457,2,17,false,4,5,1,41.99052,-87.66982
KA1504000148,2,17,false,8,15,7,41.99086,-87.66971
KA1504000155,2,17,false,8,2,-6,41.99118,-87.68359
KA1504000129,2,17,false,9,9,0,41.99417,-87.68945
15571,2,17,false,32,33,1,41.99478,-87.66028
454,2,17,false,3,8,5,41.99478,-87.66027
KA1504000156,2,17,false,15,13,-2,41.99925,-87.67137
453,2,17,false,2,2,0,41.99925,-87.67137
RP-009,2,17,false,15,15,0,42.00107,-87.66122
451,2,17,false,3,9,6,42.00108,-87.66123
RP-001,2,17,false,12,11,-1,42.00179,-87.68883
449,2,17,false,1,1,0,42.00446,-87.67241
RP-008,2,17,false,4,7,3,42.00446,-87.6724
RP-002,2,17,false,2,7,5,42.00456,-87.68065
448,2,17,false,1,1,0,42.00456,-87.68064
660,2,17,false,24,16,-8,42.00458,-87.66143
KA1504000175,2,17,false,19,22,3,42.00797,-87.66549
447,2,17,false,3,3,0,42.00797,-87.66548
RP-005,2,17,false,6,2,-4,42.0086,-87.69047
432,2,17,false,2,2,0,42.00907,-87.67423
KA1504000162,2,17,false,5,7,2,42.00907,-87.67422
KA1504000159,2,17,false,10,9,-1,42.01059,-87.66241
RP-006,2,17,false,6,3,-3,42.01213,-87.68292
526,2,17,false,7,1,-6,42.01235,-87.68825
RP-007,2,17,false,3,1,-2,42.01256,-87.67431
525,2,17,false,5,9,4,42.01272,-87.66605
517,2,17,false,5,4,-1,42.01597,-87.675
520,2,17,false,13,13,0,42.01597,-87.66859
519,2,17,false,8,11,3,42.01696,-87.67773
527,2,17,false,3,3,0,42.01892,-87.69004
515,2,17,false,4,6,2,42.01915,-87.67356
514,2,17,false,5,4,-1,42.01927,-87.68452
16806,2,17,false,5,3,-2,42.01953,-87.66955
523,2,17,false,7,9,2,42.02089,-87.66505
662,2,17,false,1,5,4,42.02354,-87.69961
598,2,17,false,6,5,-1,42.02578,-87.68411
E002,2,17,false,8,11,3,42.03256,-87.67912
599,2,17,false,6,5,-1,42.03972,-87.69942
596,2,17,false,29,20,-9,42.04822,-87.68348
600,2,17,false,6,5,-1,42.04831,-87.6983
E008,2,17,false,22,19,-3,42.05049,-87.67782
603,2,17,false,3,4,1,42.05049,-87.67782
605,2,17,false,28,14,-14,42.05294,-87.67342
661,2,17,false,8,14,6,42.05704,-87.68657
604,2,17,false,36,27,-9,42.05824,-87.67744
E006,2,17,false,2,1,-1,42.06367,-87.69871
E007,2,17,false,1,3,2,42.06431,-87.68615
E014,2,17,false,3,3,0,42.06483,-87.71531
20124,2,17,true,1,1,0,41.70495,-87.657
20113,2,17,true,1,1,0,41.70728,-87.60767
20223,2,17,true,1,1,0,41.71272,-87.53472
20224,2,17,true,2,2,0,41.71371,-87.53083
20106,2,17,true,1,1,0,41.71897,-87.60833
684,2,17,true,1,1,0,41.72801,-87.6676
20229,2,17,true,5,1,-4,41.73734,-87.54849
20121,2,17,true,1,1,0,41.74152,-87.65842
574,2,17,true,1,1,0,41.75095,-87.61379
KA1503000049,2,17,true,2,2,0,41.75788,-87.54938
KA1503000019,2,17,true,1,1,0,41.75867,-87.5869
399,2,17,true,1,1,0,41.76225,-87.5592
KA1503000002,2,17,true,7,10,3,41.76641,-87.5657
650,2,17,true,3,1,-2,41.7689,-87.63586
KA1503000047,2,17,true,1,1,0,41.76929,-87.62821
KA1503000030,2,17,true,1,1,0,41.77352,-87.57722
KA1503000029,2,17,true,5,4,-1,41.77364,-87.56747
KA1503000053,2,17,true,1,1,0,41.78009,-87.61595
KA1503000046,2,17,true,1,3,2,41.78041,-87.59141
KA1503000054,2,17,true,1,1,0,41.78061,-87.60582
15491,2,17,true,4,2,-2,41.78096,-87.57624
KA1503000033,2,17,true,1,5,4,41.78411,-87.61329
426,2,17,true,14,24,10,41.7851,-87.60108
KA1503000014,2,17,true,68,106,38,41.7851,-87.60108
KA1503000070,2,17,true,16,16,0,41.78794,-87.58831
425,2,17,true,5,2,-3,41.78795,-87.58831
328,2,17,true,18,3,-15,41.78872,-87.6013
TA1309000011,2,17,true,89,19,-70,41.78873,-87.60131
KA1503000071,2,17,true,166,53,-113,41.79148,-87.59988
423,2,17,true,17,11,-6,41.79148,-87.59988
KA1503000075,2,17,true,2,1,-1,41.79156,-87.60785
KA1503000074,2,17,true,18,16,-2,41.79174,-87.58395
424,2,17,true,2,4,2,41.79174,-87.58395
TA1309000063,2,17,true,31,66,35,41.79325,-87.5878
345,2,17,true,10,12,2,41.79326,-87.5878
KA1503000073,2,17,true,2,2,0,41.79345,-87.61585
420,2,17,true,24,9,-15,41.79429,-87.60145
KA1504000076,2,17,true,95,59,-36,41.7943,-87.60145
TA1307000160,2,17,true,4,1,-3,41.79485,-87.61873
KA1503000013,2,17,true,3,2,-1,41.79498,-87.63312
247,2,17,true,10,23,13,41.79522,-87.58077
TA1308000009,2,17,true,42,81,39,41.79522,-87.58075
TA1307000164,2,17,true,28,57,29,41.79527,-87.59647
248,2,17,true,4,9,5,41.79528,-87.59647
KA1503000052,2,17,true,40,46,6,41.79935,-87.60097
418,2,17,true,6,7,1,41.79936,-87.60097
419,2,17,true,4,6,2,41.79952,-87.58643
KA1503000059,2,17,true,31,34,3,41.79952,-87.58643
TA1309000037,2,17,true,60,103,43,41.79957,-87.59474
554,2,17,true,1,1,0,41.80091,-87.67468
415,2,17,true,4,1,-3,41.80228,-87.61807
417,2,17,true,8,11,3,41.80242,-87.5869
KA1503000007,2,17,true,40,58,18,41.80242,-87.58689
121,2,17,true,10,6,-4,41.80256,-87.59035
13398,2,17,true,19,35,16,41.80256,-87.59035
TA1309000067,2,17,true,6,2,-4,41.80303,-87.60661
322,2,17,true,14,9,-5,41.80321,-87.59849
KA1503000069,2,17,true,4,7,3,41.80579,-87.59247
KA1503000051,2,17,true,7,1,-6,41.80815,-87.64563
KA1504000091,2,17,true,1,1,0,41.80823,-87.6772
KA1503000009,2,17,true,1,3,2,41.80932,-87.63346
TA1308000035,2,17,true,17,17,0,41.80944,-87.59188
267,2,17,true,1,3,2,41.80944,-87.59188
252,2,17,true,1,1,0,41.80982,-87.59936
TA1308000002,2,17,true,5,11,6,41.80983,-87.59937
TA1308000007,2,17,true,1,2,1,41.80984,-87.61628
TA1309000053,2,17,true,3,4,1,41.80985,-87.60675
336,2,17,true,1,3,2,41.80985,-87.60675
413,2,17,true,1,3,2,41.81408,-87.59701
KA1503000065,2,17,true,2,14,12,41.81409,-87.59701
271,2,17,true,2,2,0,41.81648,-87.60659
TA1308000023,2,17,true,1,2,1,41.81649,-87.60659
KA1503000027,2,17,true,1,3,2,41.81666,-87.61942
KA1503000032,2,17,true,2,1,-1,41.81912,-87.64328
408,2,17,true,2,1,-1,41.81914,-87.64328
13083,2,17,true,6,3,-3,41.82167,-87.62153
265,2,17,true,3,1,-2,41.82297,-87.6071
TA1308000038,2,17,true,4,5,1,41.82298,-87.6071
15449,2,17,true,5,1,-4,41.82302,-87.62657
407,2,17,true,1,1,0,41.82303,-87.62658
546,2,17,true,1,3,2,41.82319,-87.67661
179,2,17,true,3,2,-1,41.82458,-87.61678
13420,2,17,true,3,6,3,41.82459,-87.61678
TA1307000161,2,17,true,2,3,1,41.82707,-87.64572
KA1503000068,2,17,true,4,5,1,41.82878,-87.68062
9,2,17,true,2,5,3,41.82878,-87.68061
KA1503000066,2,17,true,3,8,5,41.83011,-87.67031
369,2,17,true,1,1,0,41.83012,-87.67031
278,2,17,true,3,4,1,41.83062,-87.64129
TA1308000045,2,17,true,18,33,15,41.83062,-87.64129
TA1308000043,2,17,true,13,14,1,41.83066,-87.64715
279,2,17,true,2,1,-1,41.83067,-87.64715
15446,2,17,true,7,15,8,41.83068,-87.65603
405,2,17,true,1,1,0,41.83078,-87.6325
KA1503000005,2,17,true,11,20,9,41.83079,-87.6325
184,2,17,true,11,9,-2,41.83104,-87.62684
TA1307000129,2,17,true,54,19,-35,41.83104,-87.62683
406,2,17,true,4,4,0,41.83127,-87.6088
KA1503000004,2,17,true,7,8,1,41.83127,-87.6088
13345,2,17,true,4,7,3,41.83138,-87.61803
335,2,17,true,1,3,2,41.83139,-87.61803
15445,2,17,true,25,21,-4,41.83453,-87.63183
403,2,17,true,2,4,2,41.83453,-87.63183
13216,2,17,true,84,47,-37,41.83473,-87.62581
148,2,17,true,13,8,-5,41.83474,-87.62581
149,2,17,true,6,10,4,41.83486,-87.61791
13217,2,17,true,27,51,24,41.83488,-87.61792
13215,2,17,true,42,35,-7,41.83634,-87.6135
263,2,17,true,4,3,-1,41.8364,-87.61348
TA1308000046,2,17,true,18,32,14,41.83779,-87.65115
339,2,17,true,7,9,2,41.83817,-87.64523
TA1309000055,2,17,true,31,48,17,41.8382,-87.64514
KA1503000038,2,17,true,25,25,0,41.83845,-87.6354
402,2,17,true,6,11,5,41.83845,-87.6354
TA1307000048,2,17,true,71,64,-7,41.83855,-87.60821
150,2,17,true,8,7,-1,41.83855,-87.60821
272,2,17,true,7,10,3,41.83882,-87.62186
TA1308000036,2,17,true,26,57,31,41.83883,-87.62186
368,2,17,true,1,4,3,41.83915,-87.66562
15442,2,17,true,11,7,-4,41.83918,-87.66562
KA1504000168,2,17,true,1,1,0,41.84152,-87.68514
KA1503000040,2,17,true,2,9,7,41.84164,-87.65744
13213,2,17,true,7,1,-6,41.84171,-87.62694
237,2,17,true,12,12,0,41.84204,-87.61697
TA1307000139,2,17,true,61,47,-14,41.84205,-87.61698
15443,2,17,true,8,12,4,41.84275,-87.63549
207,2,17,true,3,8,5,41.84358,-87.64539
TA1307000153,2,17,true,24,45,21,41.84358,-87.64538
444,2,17,true,1,1,0,41.8445,-87.70202
147,2,17,true,2,5,3,41.84569,-87.62251
TA1307000005,2,17,true,15,27,12,41.84569,-87.6225
TA1308000013,2,17,true,17,6,-11,41.84719,-87.64681
348,2,17,true,1,1,0,41.8477,-87.69448
KA1504000086,2,17,true,2,1,-1,41.8482,-87.70542
TA1309000003,2,17,true,10,4,-6,41.84847,-87.68512
15689,2,17,true,1,7,6,41.84912,-87.69515
TA1307000066,2,17,true,3,5,2,41.8492,-87.67564
TA1308000014,2,17,true,6,5,-1,41.84953,-87.64059
209,2,17,true,2,3,1,41.84953,-87.64058
TA1308000026,2,17,true,11,7,-4,41.85008,-87.63214
TA1305000004,2,17,true,4,30,26,41.8514,-87.61884
TA1305000001,2,17,true,17,28,11,41.85262,-87.6265
13075,2,17,true,60,62,2,41.8531,-87.63192
120,2,17,true,15,13,-2,41.8531,-87.63191
135,2,17,true,4,1,-3,41.85367,-87.64652
13162,2,17,true,9,12,3,41.85378,-87.64659
13096,2,17,true,5,12,7,41.8538,-87.69577
203,2,17,true,7,4,-3,41.85409,-87.68585
13091,2,17,true,11,13,2,41.85409,-87.68585
370,2,17,true,4,4,0,41.85415,-87.61917
15546,2,17,true,17,39,22,41.85416,-87.61916
351,2,17,true,5,7,2,41.85441,-87.67678
13307,2,17,true,15,20,5,41.85489,-87.66359
208,2,17,true,2,8,6,41.85489,-87.66359
124,2,17,true,5,2,-3,41.85492,-87.67609
13089,2,17,true,18,22,4,41.85497,-87.67567
13331,2,17,true,20,23,3,41.85515,-87.65414
171,2,17,true,6,1,-5,41.85516,-87.65414
15545,2,17,true,102,101,-1,41.85627,-87.61334
4,2,17,true,20,19,-1,41.85627,-87.61334
178,2,17,true,4,5,1,41.85657,-87.62755
SL-013,2,17,true,15,21,6,41.85659,-87.62755
218,2,17,true,1,2,1,41.85679,-87.63387
SL-006,2,17,true,20,14,-6,41.8568,-87.63387
129,2,17,true,5,11,6,41.85752,-87.66158
202,2,17,true,7,9,2,41.85752,-87.64621
13135,2,17,true,36,42,6,41.85753,-87.66157
338,2,17,true,3,19,16,41.85758,-87.61956
13102,2,17,true,57,126,69,41.85762,-87.61942
273,2,17,true,11,14,3,41.85783,-87.62455
13150,2,17,true,70,92,22,41.85783,-87.62455
13099,2,17,true,17,26,9,41.85784,-87.64627
205,2,17,true,3,5,2,41.8579,-87.6687
TA1307000159,2,17,true,25,43,18,41.8579,-87.6687
170,2,17,true,6,2,-4,41.85793,-87.64083
TA1307000044,2,17,true,35,19,-16,41.85794,-87.64083
14,2,17,true,2,2,0,41.85808,-87.65109
13163,2,17,true,16,55,39,41.85808,-87.65108
13164,2,17,true,22,77,55,41.85818,-87.65648
15,2,17,true,4,5,1,41.85819,-87.65648
SL-012,2,17,true,82,113,31,41.86038,-87.62581
72,2,17,true,10,12,2,41.86039,-87.62581
13304,2,17,true,14,49,35,41.86126,-87.65659
437,2,17,true,3,5,2,41.86192,-87.69348
KA1504000109,2,17,true,18,1,-17,41.86192,-87.69347
TA1306000002,2,17,true,48,51,3,41.86238,-87.65108
137,2,17,true,1,7,6,41.86238,-87.65108
TA1307000124,2,17,true,113,209,96,41.86411,-87.62372
168,2,17,true,12,43,31,41.86415,-87.62372
282,2,17,true,2,10,8,41.86487,-87.64708
TA1309000001,2,17,true,79,71,-8,41.86488,-87.64708
13165,2,17,true,6,10,4,41.86505,-87.65697
13354,2,17,true,28,23,-5,41.86524,-87.66651
275,2,17,true,4,4,0,41.86524,-87.66651
13029,2,17,true,10,10,0,41.86531,-87.6179
97,2,17,true,6,6,0,41.86531,-87.6179
341,2,17,true,11,9,-2,41.86608,-87.60733
13431,2,17,true,57,43,-14,41.8661,-87.60728
15682,2,17,true,1,1,0,41.86651,-87.70649
KA1504000101,2,17,true,10,7,-3,41.86651,-87.68466
434,2,17,true,4,3,-1,41.86651,-87.68465
KA1504000102,2,17,true,3,2,-1,41.86664,-87.69453
436,2,17,true,3,1,-2,41.86664,-87.69452
WL-008,2,17,true,48,84,36,41.86712,-87.64108
57,2,17,true,11,13,2,41.86712,-87.64107
59,2,17,true,37,42,5,41.86721,-87.62597
TA1305000002,2,17,true,180,298,118,41.86721,-87.62597
3,2,17,true,13,9,-4,41.86723,-87.61536
15544,2,17,true,28,56,28,41.86723,-87.61536
TA1305000017,2,17,true,51,30,-21,41.86734,-87.64863
55,2,17,true,5,5,0,41.86735,-87.64863
626,2,17,true,5,9,4,41.86749,-87.63219
KA1706005007,2,17,true,36,69,33,41.86749,-87.63219
SL-005,2,17,true,142,248,106,41.8679,-87.62304
255,2,17,true,30,26,-4,41.86791,-87.62304
644,2,17,true,37,58,21,41.86859,-87.68625
19,2,17,true,11,8,-3,41.86892,-87.65913
13139,2,17,true,51,50,-1,41.86893,-87.65913
13285,2,17,true,155,18,-137,41.86928,-87.67372
22,2,17,true,8,15,7,41.86947,-87.65548
13160,2,17,true,64,92,28,41.86947,-87.65548
382,2,17,true,2,2,0,41.8699,-87.68725
414,2,17,true,3,15,12,41.87023,-87.63947
15550,2,17,true,36,86,50,41.87024,-87.63947
TA1309000010,2,17,true,111,145,34,41.87074,-87.62574
SL-009,2,17,true,38,67,29,41.87081,-87.63121
342,2,17,true,28,3,-25,41.87127,-87.6737
TA1309000064,2,17,true,174,42,-132,41.87127,-87.67369
15542,2,17,true,46,7,-39,41.87146,-87.64095
103,2,17,true,9,1,-8,41.87146,-87.64094
261,2,17,true,17,3,-14,41.87151,-87.6699
TA1307000130,2,17,true,100,57,-43,41.87178,-87.65103
241,2,17,true,12,15,3,41.8718,-87.65102
108,2,17,true,17,28,11,41.87183,-87.64664
TA1307000121,2,17,true,83,107,24,41.87184,-87.64664
41,2,17,true,19,34,15,41.87209,-87.62957
SL-008,2,17,true,151,230,79,41.87209,-87.62956
13332,2,17,true,179,147,-32,41.87219,-87.6615
394,2,17,true,9,6,-3,41.87226,-87.63484
175,2,17,true,10,25,15,41.87255,-87.63359
SL-011,2,17,true,72,136,64,41.87256,-87.63356
623,2,17,true,64,78,14,41.87272,-87.62399
KA1504000104,2,17,true,139,20,-119,41.87296,-87.66912
383,2,17,true,40,2,-38,41.87297,-87.66912
320,2,17,true,22,18,-4,41.87327,-87.66402
5,2,17,true,5,9,4,41.87403,-87.6277
SL-007,2,17,true,58,82,24,41.87404,-87.6277
169,2,17,true,3,4,1,41.87424,-87.63959
13326,2,17,true,58,27,-31,41.87425,-87.63958
321,2,17,true,22,27,5,41.87427,-87.63257
TA1306000025,2,17,true,62,40,-22,41.87464,-87.65703
32,2,17,true,3,2,-1,41.87464,-87.65703
15668,2,17,true,14,21,7,41.87471,-87.68642
109,2,17,true,14,3,-11,41.87475,-87.64981
13028,2,17,true,63,52,-11,41.87475,-87.64981
13081,2,17,true,94,11,-83,41.87501,-87.67326
122,2,17,true,6,5,-1,41.87501,-87.67325
89,2,17,true,8,5,-3,41.87501,-87.6331
SL-010,2,17,true,61,77,16,41.87501,-87.63309
15541,2,17,true,16,20,4,41.8758,-87.62086
68,2,17,true,8,5,-3,41.87587,-87.64077
13037,2,17,true,53,17,-36,41.87588,-87.64078
50,2,17,true,13,22,9,41.87592,-87.6307
TA1305000009,2,17,true,95,92,-3,41.87593,-87.63068
317,2,17,true,26,3,-23,41.87603,-87.68195
TA1305000010,2,17,true,40,17,-23,41.87623,-87.62444
45,2,17,true,8,1,-7,41.87623,-87.62444
624,2,17,true,82,70,-12,41.87626,-87.62923
2,2,17,true,5,4,-1,41.87649,-87.62051
33,2,17,true,7,2,-5,41.87715,-87.62786
TA1305000035,2,17,true,122,38,-84,41.87716,-87.62787
13138,2,17,true,173,55,-118,41.87723,-87.63941
75,2,17,true,19,5,-14,41.87724,-87.63937
631,2,17,true,28,4,-24,41.87761,-87.6739
15539,2,17,true,101,122,21,41.87763,-87.64405
13158,2,17,true,114,170,56,41.87764,-87.64957
134,2,17,true,6,25,19,41.87764,-87.64954
21,2,17,true,17,24,7,41.87773,-87.6548
13157,2,17,true,81,106,25,41.87773,-87.6548
TA1305000025,2,17,true,242,51,-191,41.87773,-87.63528
36,2,17,true,29,16,-13,41.87776,-87.63525
TA1309000002,2,17,true,72,22,-50,41.87784,-87.62408
284,2,17,true,12,15,3,41.87784,-87.62408
13206,2,17,true,65,48,-17,41.87794,-87.66201
146,2,17,true,12,17,5,41.87794,-87.66201
283,2,17,true,30,5,-25,41.87809,-87.63183
TA1309000004,2,17,true,175,31,-144,41.87811,-87.63184
107,2,17,true,31,14,-17,41.87822,-87.644
638,2,17,true,296,176,-120,41.87827,-87.64078
37,2,17,true,34,7,-27,41.87921,-87.62975
TA1305000005,2,17,true,174,34,-140,41.87924,-87.62975
286,2,17,true,12,3,-9,41.8793,-87.6355
13011,2,17,true,332,227,-105,41.87931,-87.63993
TA1309000008,2,17,true,146,36,-110,41.87933,-87.6355
192,2,17,true,16,12,-4,41.87935,-87.63997
KA1503000034,2,17,true,81,2,-79,41.87938,-87.63197
40,2,17,true,22,1,-21,41.87944,-87.63197
39,2,17,true,20,7,-13,41.87948,-87.62571
KA1503000015,2,17,true,142,44,-98,41.87948,-87.6257
15667,2,17,true,27,22,-5,41.8798,-87.68609
381,2,17,true,1,4,3,41.87981,-87.68607
16916,2,17,true,1,4,3,41.88012,-87.76323
287,2,17,true,50,10,-40,41.88017,-87.63527
540,2,17,true,2,1,-1,41.88022,-87.75536
TA1309000007,2,17,true,270,26,-244,41.88022,-87.63526
WL-011,2,17,true,119,75,-44,41.88034,-87.64273
73,2,17,true,23,19,-4,41.8804,-87.64273
80,2,17,true,17,32,15,41.88042,-87.65556
13156,2,17,true,130,191,61,41.88042,-87.65554
13300,2,17,true,110,174,64,41.88097,-87.61675
76,2,17,true,25,17,-8,41.88098,-87.61675
13008,2,17,true,141,71,-70,41.88105,-87.62408
90,2,17,true,15,13,-2,41.88107,-87.62409
49,2,17,true,77,15,-62,41.88116,-87.62963
TA1305000006,2,17,true,297,73,-224,41.88122,-87.6296
13134,2,17,true,26,27,1,41.88138,-87.67493
215,2,17,true,4,4,0,41.88139,-87.67492
13056,2,17,true,136,113,-23,41.88168,-87.63951
191,2,17,true,12,18,6,41.88169,-87.63951
198,2,17,true,23,28,5,41.88187,-87.6488
TA1307000120,2,17,true,208,248,40,41.88188,-87.64879
13341,2,17,true,260,185,-75,41.88208,-87.63985
174,2,17,true,20,21,1,41.88208,-87.63984
197,2,17,true,22,8,-14,41.88208,-87.62513
13036,2,17,true,105,71,-34,41.8821,-87.62513
77,2,17,true,29,30,1,41.88214,-87.64108
TA1305000032,2,17,true,319,304,-15,41.88218,-87.64109
98,2,17,true,44,10,-34,41.88266,-87.63251
13006,2,17,true,243,35,-208,41.88268,-87.63252
13353,2,17,true,53,143,90,41.88283,-87.6612
346,2,17,true,12,19,7,41.88284,-87.6612
654,2,17,true,61,61,0,41.88307,-87.65698
233,2,17,true,6,14,8,41.88309,-87.6511
13409,2,17,true,75,94,19,41.8831,-87.6511
18,2,17,true,24,6,-18,41.88317,-87.63735
KA1503000072,2,17,true,147,33,-114,41.88317,-87.63693
91,2,17,true,45,36,-9,41.88336,-87.64122
WL-012,2,17,true,477,361,-116,41.88337,-87.6412
112,2,17,true,18,15,-3,41.88362,-87.6486
13053,2,17,true,153,145,-8,41.88365,-87.64863
43,2,17,true,23,20,-3,41.88396,-87.62455
13001,2,17,true,210,129,-81,41.88397,-87.62459
88,2,17,true,6,8,2,41.88407,-87.65691
13155,2,17,true,42,45,3,41.88407,-87.65689
18062,2,17,true,102,93,-9,41.88412,-87.65427
621,2,17,true,6,17,11,41.88412,-87.65427
81,2,17,true,59,23,-36,41.88417,-87.6296
TA1306000010,2,17,true,402,153,-249,41.88419,-87.62961
15666,2,17,true,5,6,1,41.88446,-87.6963
KA1504000106,2,17,true,1,1,0,41.88459,-87.70631
TA1305000030,2,17,true,369,58,-311,41.88459,-87.63178
15535,2,17,true,127,122,-5,41.8846,-87.64455
96,2,17,true,10,11,1,41.8846,-87.64455
51,2,17,true,49,6,-43,41.88462,-87.63176
TA1305000029,2,17,true,179,129,-50,41.88466,-87.62787
195,2,17,true,27,34,7,41.88466,-87.61952
13263,2,17,true,199,196,-3,41.88467,-87.61952
44,2,17,true,31,26,-5,41.88468,-87.62782
528,2,17,true,1,3,2,41.88537,-87.72661
TA1306000015,2,17,true,229,142,-87,41.88549,-87.65232
518,2,17,true,2,7,5,41.8855,-87.71686
71,2,17,true,20,15,-5,41.8855,-87.65233
66,2,17,true,22,23,1,41.88557,-87.64186
13021,2,17,true,246,153,-93,41.88559,-87.64184
TA1307000111,2,17,true,283,83,-200,41.88582,-87.63548
164,2,17,true,42,9,-33,41.88583,-87.63547
13073,2,17,true,32,30,-2,41.88592,-87.66717
536,2,17,true,3,2,-1,41.88593,-87.7354
119,2,17,true,11,5,-6,41.88593,-87.66717
KA17018054,2,17,true,40,14,-26,41.88595,-87.67701
656,2,17,true,6,3,-3,41.88595,-87.67701
KA1503000012,2,17,true,217,99,-118,41.88599,-87.63089
38,2,17,true,35,9,-26,41.88599,-87.63089
52,2,17,true,40,23,-17,41.886,-87.62421
TA1305000011,2,17,true,216,76,-140,41.886,-87.62418
7,2,17,true,12,13,1,41.88627,-87.61751
15534,2,17,true,107,118,11,41.88627,-87.61749
217,2,17,true,12,8,-4,41.8866,-87.65821
13197,2,17,true,89,58,-31,41.8866,-87.65816
264,2,17,true,26,15,-11,41.8867,-87.62224
TA1308000029,2,17,true,109,91,-18,41.88673,-87.62225
TA1307000131,2,17,true,142,48,-94,41.88688,-87.62606
194,2,17,true,15,8,-7,41.88688,-87.62606
6,2,17,true,4,10,6,41.88697,-87.61281
KA1503000064,2,17,true,77,115,38,41.88697,-87.61281
16906,2,17,true,2,19,17,41.88792,-87.77445
100,2,17,true,41,26,-15,41.88814,-87.63657
TA1305000022,2,17,true,261,134,-127,41.88817,-87.63656
56,2,17,true,37,41,4,41.88866,-87.64442
TA1306000003,2,17,true,268,267,-1,41.88867,-87.64442
KA1503000043,2,17,true,418,369,-49,41.88918,-87.63851
133,2,17,true,54,59,5,41.88918,-87.63851
13050,2,17,true,216,114,-102,41.88919,-87.62775
47,2,17,true,30,18,-12,41.88921,-87.62775
15664,2,17,true,18,20,2,41.8895,-87.68821
376,2,17,true,12,4,-8,41.88951,-87.68818
13432,2,17,true,79,42,-37,41.88989,-87.67149
285,2,17,true,5,5,0,41.88989,-87.67149
TA1307000151,2,17,true,279,191,-88,41.88993,-87.63427
212,2,17,true,53,27,-26,41.88995,-87.63427
636,2,17,true,166,104,-62,41.88997,-87.63662
125,2,17,true,24,19,-5,41.89018,-87.62621
KA1503000044,2,17,true,156,55,-101,41.89018,-87.6262
KA1504000113,2,17,true,2,2,0,41.89049,-87.70262
196,2,17,true,19,17,-2,41.89053,-87.62205
13427,2,17,true,119,93,-26,41.89054,-87.62205
26,2,17,true,16,20,4,41.89057,-87.61798
13430,2,17,true,210,138,-72,41.89077,-87.63169
181,2,17,true,30,16,-14,41.89077,-87.63168
TA1306000013,2,17,true,143,189,46,41.89083,-87.61852
RN-,2,17,true,153,144,-9,41.89102,-87.63546
672,2,17,true,14,21,7,41.89102,-87.63545
277,2,17,true,6,7,1,41.89108,-87.66665
13434,2,17,true,42,62,20,41.89108,-87.66663
TA1308000006,2,17,true,57,47,-10,41.89128,-87.67686
199,2,17,true,36,37,1,41.89143,-87.62676
TA1307000117,2,17,true,239,195,-44,41.89144,-87.62675
13033,2,17,true,164,174,10,41.8916,-87.64835
214,2,17,true,9,6,-3,41.89161,-87.67688
84,2,17,true,7,17,10,41.89161,-87.64833
186,2,17,true,22,22,0,41.8918,-87.65879
13194,2,17,true,87,98,11,41.8918,-87.65878
TA1305000003,2,17,true,178,170,-8,41.89187,-87.62061
24,2,17,true,33,47,14,41.8919,-87.62063
643,2,17,true,17,46,29,41.89203,-87.68939
35,2,17,true,14,28,14,41.89227,-87.61206
13022,2,17,true,242,212,-30,41.89227,-87.61205
99,2,17,true,19,16,-3,41.89255,-87.61449
TA1306000029,2,17,true,154,148,-6,41.89256,-87.61449
13265,2,17,true,301,269,-32,41.89383,-87.64172
74,2,17,true,24,31,7,41.89384,-87.64173
13045,2,17,true,304,355,51,41.89403,-87.62931
110,2,17,true,47,45,-2,41.89406,-87.6293
13016,2,17,true,389,74,-315,41.89431,-87.62277
211,2,17,true,86,7,-79,41.89439,-87.62267
KA1503000041,2,17,true,237,94,-143,41.89452,-87.61798
142,2,17,true,64,10,-54,41.89453,-87.61806
92,2,17,true,15,25,10,41.89455,-87.65346
13196,2,17,true,92,104,12,41.89455,-87.65345
TA1307000062,2,17,true,172,124,-48,41.89466,-87.63839
111,2,17,true,34,28,-6,41.89466,-87.63837
TA1306000012,2,17,true,298,255,-43,41.89475,-87.63438
53,2,17,true,56,34,-22,41.89476,-87.63439
627,2,17,true,22,17,-5,41.8948,-87.63231
KP1705001026,2,17,true,140,102,-38,41.89483,-87.6323
16920,2,17,true,4,2,-2,41.89495,-87.76491
550,2,17,true,1,1,0,41.89495,-87.76491
KA1504000114,2,17,true,5,11,6,41.89547,-87.70614
18058,2,17,true,37,34,-3,41.8955,-87.68201
637,2,17,true,60,102,42,41.89563,-87.67209
128,2,17,true,5,23,18,41.89571,-87.67716
13132,2,17,true,81,144,63,41.89573,-87.67718
161,2,17,true,25,25,0,41.89574,-87.62599
15530,2,17,true,166,120,-46,41.89575,-87.62596
18003,2,17,true,106,47,-59,41.89575,-87.62011
635,2,17,true,14,4,-10,41.89576,-87.62012
13247,2,17,true,72,109,37,41.89597,-87.66775
350,2,17,true,5,10,5,41.89597,-87.66774
TA1305000020,2,17,true,72,75,3,41.89636,-87.65406
54,2,17,true,16,18,2,41.89637,-87.65407
13289,2,17,true,55,106,51,41.89638,-87.661
86,2,17,true,11,17,6,41.89639,-87.661
337,2,17,true,28,20,-8,41.89659,-87.63096
13303,2,17,true,117,104,-13,41.89672,-87.63088
13017,2,17,true,160,136,-24,41.89676,-87.6357
31,2,17,true,35,22,-13,41.89677,-87.63572
13338,2,17,true,179,103,-76,41.89697,-87.62173
173,2,17,true,43,20,-23,41.89704,-87.62173
TA1307000061,2,17,true,83,99,16,41.89745,-87.62873
106,2,17,true,14,14,0,41.89746,-87.62874
25,2,17,true,22,15,-7,41.89751,-87.62354
13034,2,17,true,101,53,-48,41.89754,-87.62352
48,2,17,true,44,23,-21,41.89772,-87.64302
TA1306000009,2,17,true,237,99,-138,41.89772,-87.64299
620,2,17,true,132,115,-17,41.89817,-87.63754
374,2,17,true,10,14,4,41.89842,-87.68659
KA1504000103,2,17,true,53,94,41,41.89842,-87.68659
145,2,17,true,48,38,-10,41.89856,-87.62211
15529,2,17,true,210,117,-93,41.89858,-87.62206
140,2,17,true,37,39,2,41.89895,-87.6299
TA1307000128,2,17,true,221,254,33,41.89896,-87.6299
657,2,17,true,63,75,12,41.89918,-87.6722
KA1504000117,2,17,true,21,15,-6,41.89936,-87.64848
365,2,17,true,4,3,-1,41.89936,-87.64848
30,2,17,true,9,9,0,41.89964,-87.66789
13248,2,17,true,46,88,42,41.89964,-87.66788
46,2,17,true,11,13,2,41.89994,-87.63444
TA1306000011,2,17,true,67,70,3,41.89994,-87.63443
KA1504000116,2,17,true,116,101,-15,41.90023,-87.64299
364,2,17,true,7,10,3,41.90023,-87.64299
17660,2,17,true,35,48,13,41.90036,-87.69671
622,2,17,true,6,3,-3,41.90037,-87.69671
29,2,17,true,16,14,-2,41.90069,-87.66259
13290,2,17,true,77,95,18,41.90069,-87.66259
13042,2,17,true,254,143,-111,41.90097,-87.62377
85,2,17,true,36,21,-15,41.90098,-87.62375
183,2,17,true,13,13,0,41.90133,-87.67744
TA1307000070,2,17,true,52,89,37,41.90133,-87.67742
KA1504000133,2,17,true,143,147,4,41.90234,-87.62773
172,2,17,true,17,24,7,41.90236,-87.62774
15654,2,17,true,8,9,1,41.90271,-87.70923
305,2,17,true,9,8,-1,41.9028,-87.69005
13241,2,17,true,40,26,-14,41.9029,-87.68731
176,2,17,true,48,81,33,41.90291,-87.63141
23,2,17,true,5,11,6,41.90292,-87.63772
TA1306000006,2,17,true,42,77,35,41.90292,-87.63772
TA1307000039,2,17,true,313,451,138,41.90294,-87.63137
658,2,17,true,67,26,-41,41.903,-87.6838
13256,2,17,true,41,24,-17,41.90302,-87.69749
216,2,17,true,3,7,4,41.90302,-87.69749
17,2,17,true,12,13,1,41.90313,-87.67391
TA1305000034,2,17,true,57,65,8,41.90313,-87.67391
182,2,17,true,34,68,34,41.90317,-87.63442
KA1504000135,2,17,true,243,383,140,41.90319,-87.63439
13136,2,17,true,79,69,-10,41.90326,-87.67845
130,2,17,true,14,17,3,41.90327,-87.67846
210,2,17,true,27,21,-6,41.90342,-87.66781
13061,2,17,true,163,230,67,41.90342,-87.66779
KA1504000079,2,17,true,125,153,28,41.9035,-87.64334
359,2,17,true,18,23,5,41.90458,-87.6497
138,2,17,true,17,18,1,41.9046,-87.64057
TA1307000115,2,17,true,72,128,56,41.9046,-87.64056
291,2,17,true,14,20,6,41.90672,-87.63494
TA1308000049,2,17,true,134,218,84,41.90672,-87.6349
KA1504000134,2,17,true,82,142,60,41.90687,-87.6262
180,2,17,true,8,28,20,41.90687,-87.62618
333,2,17,true,12,22,10,41.90706,-87.66725
13224,2,17,true,74,126,52,41.90706,-87.66725
18069,2,17,true,81,7,-74,41.90722,-87.65563
666,2,17,true,3,1,-2,41.90723,-87.65564
TA1307000143,2,17,true,25,61,36,41.90762,-87.63854
236,2,17,true,2,10,8,41.90762,-87.63853
61,2,17,true,16,17,1,41.90764,-87.67254
13221,2,17,true,113,121,8,41.90765,-87.67254
13245,2,17,true,30,28,-2,41.90777,-87.68586
159,2,17,true,2,1,-1,41.90777,-87.68586
301,2,17,true,22,38,16,41.90796,-87.63203
TA1309000024,2,17,true,176,211,35,41.908,-87.63152
69,2,17,true,21,23,2,41.90939,-87.6777
TA1305000041,2,17,true,127,126,-1,41.9094,-87.67769
331,2,17,true,197,265,68,41.90965,-87.64812
15653,2,17,true,18,21,3,41.90979,-87.7053
509,2,17,true,1,1,0,41.9098,-87.70531
TA1305000037,2,17,true,65,103,38,41.91018,-87.67003
27,2,17,true,7,21,14,41.91019,-87.6435
TA1306000008,2,17,true,57,89,32,41.9102,-87.6435
16,2,17,true,14,13,-1,41.91035,-87.67008
213,2,17,true,8,7,-1,41.91037,-87.68237
TA1308000005,2,17,true,44,46,2,41.91042,-87.68238
276,2,17,true,6,8,2,41.91043,-87.69718
13258,2,17,true,25,42,17,41.91043,-87.69718
160,2,17,true,6,6,0,41.91054,-87.68957
13257,2,17,true,27,46,19,41.91054,-87.68956
13154,2,17,true,158,176,18,41.91054,-87.65312
20,2,17,true,25,36,11,41.91055,-87.65313
60,2,17,true,12,18,6,41.91059,-87.64942
13058,2,17,true,84,105,21,41.91059,-87.64942
118,2,17,true,28,20,-8,41.91138,-87.63868
TA1307000038,2,17,true,127,152,25,41.91138,-87.63868
268,2,17,true,26,42,16,41.91172,-87.62681
LF-005,2,17,true,194,506,312,41.91172,-87.62681
126,2,17,true,18,32,14,41.91196,-87.63197
13128,2,17,true,76,123,47,41.91197,-87.63197
289,2,17,true,49,49,0,41.91209,-87.63472
TA1308000050,2,17,true,262,377,115,41.91211,-87.6347
158,2,17,true,16,15,-1,41.91262,-87.6814
13243,2,17,true,84,140,56,41.91262,-87.6814
315,2,17,true,5,7,2,41.91293,-87.66417
TA1309000032,2,17,true,19,26,7,41.91293,-87.66417
TA1306000032,2,17,true,142,147,5,41.9137,-87.65285
93,2,17,true,22,18,-4,41.91371,-87.65285
TA1307000166,2,17,true,105,107,2,41.91386,-87.64877
224,2,17,true,16,26,10,41.91386,-87.64877
511,2,17,true,1,1,0,41.914,-87.70515
15655,2,17,true,39,48,9,41.91401,-87.70514
641,2,17,true,1,2,1,41.91416,-87.71676
18017,2,17,true,6,15,9,41.91416,-87.71676
18067,2,17,true,73,69,-4,41.9146,-87.66796
628,2,17,true,7,10,3,41.9146,-87.66796
28,2,17,true,5,14,9,41.91469,-87.64333
TA1306000007,2,17,true,41,76,35,41.91469,-87.64333
13068,2,17,true,65,58,-7,41.91554,-87.68703
116,2,17,true,9,15,6,41.91555,-87.68703
13179,2,17,true,196,285,89,41.9157,-87.63461
141,2,17,true,21,53,32,41.91571,-87.63461
219,2,17,true,17,15,-2,41.91598,-87.67733
13133,2,17,true,55,118,63,41.91598,-87.67733
58,2,17,true,6,22,16,41.91602,-87.66894
TA1305000039,2,17,true,75,105,30,41.9163,-87.66749
15650,2,17,true,20,25,5,41.91711,-87.71023
506,2,17,true,2,7,5,41.91711,-87.71023
15651,2,17,true,33,30,-3,41.91752,-87.70181
185,2,17,true,3,11,8,41.91774,-87.69143
13266,2,17,true,24,37,13,41.91774,-87.69142
TA1309000029,2,17,true,66,57,-9,41.9178,-87.68245
309,2,17,true,3,4,1,41.91789,-87.6865
288,2,17,true,21,19,-2,41.91809,-87.64375
TA1309000006,2,17,true,94,112,18,41.91809,-87.64375
223,2,17,true,20,18,-2,41.91821,-87.65698
TA1307000163,2,17,true,114,111,-3,41.91821,-87.65696
94,2,17,true,31,52,21,41.91831,-87.6363
13146,2,17,true,180,235,55,41.91831,-87.63629
13059,2,17,true,174,170,-4,41.91845,-87.65222
113,2,17,true,35,25,-10,41.91846,-87.65222
13259,2,17,true,20,21,1,41.91852,-87.69744
259,2,17,true,1,5,4,41.91853,-87.69745
310,2,17,true,3,11,8,41.91984,-87.68083
225,2,17,true,31,20,-11,41.91995,-87.64884
13192,2,17,true,97,150,53,41.91995,-87.64884
13288,2,17,true,35,53,18,41.92008,-87.67788
13242,2,17,true,22,34,12,41.92021,-87.69266
222,2,17,true,8,7,-1,41.92023,-87.69265
307,2,17,true,11,10,-1,41.92077,-87.66373
TA1309000030,2,17,true,70,94,24,41.92077,-87.66372
290,2,17,true,5,8,3,41.92152,-87.70734
13292,2,17,true,23,42,19,41.92152,-87.70733
TA1309000033,2,17,true,120,141,21,41.92158,-87.65381
13193,2,17,true,178,251,73,41.92182,-87.64412
144,2,17,true,33,43,10,41.92182,-87.64411
143,2,17,true,20,18,-2,41.92217,-87.63891
13191,2,17,true,104,113,9,41.92217,-87.63891
327,2,17,true,19,26,7,41.92225,-87.65783
13084,2,17,true,44,56,12,41.92268,-87.69715
123,2,17,true,9,9,0,41.92268,-87.69714
LP-,2,17,true,59,82,23,41.92396,-87.63584
673,2,17,true,12,7,-5,41.92398,-87.63585
KA1504000140,2,17,true,33,26,-7,41.92409,-87.67646
505,2,17,true,9,7,-2,41.92409,-87.67646
16010,2,17,true,4,12,8,41.92458,-87.72787
15648,2,17,true,20,19,-1,41.92464,-87.68931
504,2,17,true,8,7,-1,41.92464,-87.68931
503,2,17,true,2,2,0,41.92483,-87.71451
KA1504000090,2,17,true,5,17,12,41.92483,-87.7145
TA1307000001,2,17,true,102,101,-1,41.92535,-87.66581
188,2,17,true,24,19,-5,41.92536,-87.66581
TA1306000026,2,17,true,111,119,8,41.92558,-87.65842
87,2,17,true,13,21,8,41.92559,-87.65843
TA1306000016,2,17,true,190,112,-78,41.9256,-87.65371
67,2,17,true,15,15,0,41.9256,-87.65371
313,2,17,true,22,26,4,41.9257,-87.64246
TA1309000019,2,17,true,151,207,56,41.92586,-87.63897
TA1309000058,2,17,true,215,232,17,41.92591,-87.64927
127,2,17,true,28,27,-1,41.92592,-87.64927
177,2,17,true,51,46,-5,41.92627,-87.63086
TA1308000001,2,17,true,191,231,40,41.92627,-87.63086
502,2,17,true,3,3,0,41.92667,-87.69772
15646,2,17,true,18,36,18,41.92668,-87.6977
13124,2,17,true,37,26,-11,41.92675,-87.63444
34,2,17,true,6,7,1,41.92675,-87.63444
302,2,17,true,14,14,0,41.92859,-87.65421
TA1309000023,2,17,true,116,130,14,41.9287,-87.65383
TA1307000113,2,17,true,57,102,45,41.92878,-87.66391
190,2,17,true,15,8,-7,41.92878,-87.6639
166,2,17,true,3,10,7,41.92883,-87.66853
13296,2,17,true,49,46,-3,41.92883,-87.66852
TA1309000059,2,17,true,65,58,-7,41.92889,-87.65898
343,2,17,true,5,15,10,41.92889,-87.65898
349,2,17,true,29,38,9,41.92915,-87.6491
TA1309000061,2,17,true,119,155,36,41.92915,-87.64909
258,2,17,true,8,8,0,41.92946,-87.68417
TA1308000031,2,17,true,30,40,10,41.92946,-87.68417
340,2,17,true,40,37,-3,41.92956,-87.64313
TA1305000014,2,17,true,173,186,13,41.92956,-87.64313
260,2,17,true,6,15,9,41.92958,-87.70791
13085,2,17,true,43,58,15,41.92958,-87.70789
499,2,17,true,2,1,-1,41.93056,-87.72381
15643,2,17,true,8,8,0,41.93057,-87.7238
TA1307000142,2,17,true,156,180,24,41.93125,-87.64432
220,2,17,true,29,30,1,41.93125,-87.64431
13276,2,17,true,134,155,21,41.93132,-87.63874
324,2,17,true,22,26,4,41.93173,-87.64179
15645,2,17,true,15,18,3,41.93191,-87.70121
163,2,17,true,7,8,1,41.93191,-87.67784
13271,2,17,true,37,47,10,41.93192,-87.67784
152,2,17,true,25,34,9,41.93221,-87.65864
TA1307000064,2,17,true,185,138,-47,41.93222,-87.65864
TA1306000014,2,17,true,180,122,-58,41.93242,-87.65271
13,2,17,true,23,21,-2,41.93242,-87.65271
329,2,17,true,27,21,-6,41.93258,-87.63642
TA1309000039,2,17,true,158,204,46,41.93258,-87.63642
13294,2,17,true,70,57,-13,41.9326,-87.66595
319,2,17,true,6,8,2,41.93292,-87.67217
332,2,17,true,12,30,18,41.93313,-87.64776
TA1309000036,2,17,true,127,177,50,41.93313,-87.64776
15644,2,17,true,16,19,3,41.93534,-87.71687
500,2,17,true,2,1,-1,41.93534,-87.71686
TA1307000006,2,17,true,104,98,-6,41.93571,-87.6636
153,2,17,true,28,13,-15,41.93575,-87.66364
162,2,17,true,4,6,2,41.93588,-87.67844
13268,2,17,true,18,40,22,41.93588,-87.67843
250,2,17,true,18,9,-9,41.93609,-87.66984
13269,2,17,true,43,67,24,41.93609,-87.66983
TA1307000052,2,17,true,144,125,-19,41.93628,-87.65266
115,2,17,true,28,23,-5,41.93628,-87.65266
156,2,17,true,32,38,6,41.9365,-87.64756
TA1307000136,2,17,true,169,168,-1,41.9365,-87.64755
TA1307000041,2,17,true,155,218,63,41.93669,-87.63683
157,2,17,true,17,42,25,41.9367,-87.63683
13137,2,17,true,207,287,80,41.9376,-87.6441
300,2,17,true,42,55,13,41.93761,-87.6441
15642,2,17,true,11,18,7,41.93843,-87.69801
154,2,17,true,14,15,1,41.93912,-87.66384
664,2,17,true,2,8,6,41.93934,-87.68327
KA17018068,2,17,true,36,54,18,41.93935,-87.68327
TA1309000042,2,17,true,100,111,11,41.93937,-87.66836
131,2,17,true,14,29,15,41.93937,-87.66835
496,2,17,true,1,3,2,41.9394,-87.72356
KA150400009X,2,17,true,16,14,-2,41.9394,-87.71159
15640,2,17,true,4,4,0,41.93941,-87.72357
497,2,17,true,1,1,0,41.93941,-87.71159
13229,2,17,true,76,64,-12,41.93946,-87.66376
226,2,17,true,22,12,-10,41.93972,-87.65886
TA1308000019,2,17,true,99,89,-10,41.93973,-87.65886
296,2,17,true,24,30,6,41.9401,-87.64546
13277,2,17,true,141,191,50,41.9401,-87.64546
TA1307000134,2,17,true,222,212,-10,41.94016,-87.65303
117,2,17,true,35,26,-9,41.94016,-87.65302
228,2,17,true,2,2,0,41.94058,-87.67854
13143,2,17,true,16,21,5,41.94059,-87.67853
334,2,17,true,24,23,-1,41.94076,-87.63919
TA1309000049,2,17,true,150,166,16,41.94077,-87.63919
308,2,17,true,6,11,5,41.94152,-87.68471
15634,2,17,true,18,13,-5,41.94304,-87.68729
493,2,17,true,5,3,-2,41.94304,-87.68729
TA1307000138,2,17,true,110,128,18,41.94334,-87.67094
230,2,17,true,10,21,11,41.94335,-87.67093
13144,2,17,true,42,46,4,41.9434,-87.67964
299,2,17,true,20,35,15,41.94368,-87.64894
TA1309000025,2,17,true,128,172,44,41.94368,-87.64894
229,2,17,true,22,31,9,41.94372,-87.66401
13071,2,17,true,146,165,19,41.94373,-87.66401
632,2,17,true,147,152,5,41.94453,-87.6547
303,2,17,true,36,23,-13,41.94522,-87.64702
15631,2,17,true,12,22,10,41.94524,-87.70665
13278,2,17,true,140,145,5,41.94553,-87.64644
330,2,17,true,6,3,-3,41.94618,-87.67331
TA1309000050,2,17,true,32,31,-1,41.94618,-87.67331
492,2,17,true,1,3,2,41.94662,-87.68337
491,2,17,true,5,1,-4,41.94664,-87.69463
15632,2,17,true,12,9,-3,41.94664,-87.69463
KA1504000143,2,17,true,34,29,-5,41.94664,-87.68337
KA1504000142,2,17,true,12,5,-7,41.94735,-87.71759
489,2,17,true,1,1,0,41.94736,-87.7176
227,2,17,true,19,25,6,41.94813,-87.66397
13235,2,17,true,132,158,26,41.94814,-87.66396
304,2,17,true,29,37,8,41.94878,-87.64922
257,2,17,true,5,7,2,41.9488,-87.67527
13253,2,17,true,35,38,3,41.9488,-87.67527
13325,2,17,true,180,193,13,41.94907,-87.64863
114,2,17,true,22,28,6,41.94935,-87.65451
TA1307000126,2,17,true,104,172,68,41.94936,-87.65451
232,2,17,true,33,43,10,41.94943,-87.64645
TA1307000150,2,17,true,147,199,52,41.94945,-87.64646
18016,2,17,true,3,7,4,41.94993,-87.71395
347,2,17,true,4,8,4,41.95068,-87.6687
13319,2,17,true,39,60,21,41.95069,-87.6687
TA1307000127,2,17,true,80,139,59,41.9508,-87.65918
165,2,17,true,20,21,1,41.95081,-87.65918
15628,2,17,true,10,24,14,41.95216,-87.69806
318,2,17,true,11,16,5,41.95254,-87.6735
13323,2,17,true,87,67,-20,41.95282,-87.65
256,2,17,true,23,7,-16,41.95282,-87.65
15624,2,17,true,19,4,-15,41.95339,-87.73199
314,2,17,true,1,4,3,41.9535,-87.69199
485,2,17,true,1,2,1,41.95361,-87.70933
KA1504000096,2,17,true,4,8,4,41.95361,-87.70932
590,2,17,true,6,3,-3,41.95374,-87.74056
KA1504000139,2,17,true,6,4,-2,41.954,-87.71909
484,2,17,true,1,3,2,41.954,-87.71907
TA1309000043,2,17,true,46,56,10,41.95417,-87.66434
240,2,17,true,17,13,-4,41.95424,-87.65441
13063,2,17,true,116,121,5,41.95424,-87.65441
486,2,17,true,2,5,3,41.95431,-87.68607
KA1504000158,2,17,true,8,12,4,41.95432,-87.68607
254,2,17,true,31,24,-7,41.95438,-87.64806
TA1308000022,2,17,true,131,102,-29,41.95438,-87.64805
16991,2,17,true,5,7,2,41.95448,-87.7496
244,2,17,true,12,9,-3,41.95466,-87.67391
TA1307000149,2,17,true,63,68,5,41.95467,-87.67392
298,2,17,true,2,7,5,41.95601,-87.68021
TA1309000026,2,17,true,38,31,-7,41.95601,-87.6802
246,2,17,true,3,5,2,41.95606,-87.66885
13249,2,17,true,18,21,3,41.95606,-87.66885
312,2,17,true,19,22,3,41.95637,-87.6563
292,2,17,true,4,5,1,41.95709,-87.6642
TA1308000047,2,17,true,19,28,9,41.95709,-87.6642
13379,2,17,true,108,98,-10,41.95786,-87.6495
TA1309000018,2,17,true,33,24,-9,41.95791,-87.67357
316,2,17,true,4,2,-2,41.95841,-87.69401
306,2,17,true,6,15,9,41.9585,-87.655
TA1309000027,2,17,true,55,86,31,41.9585,-87.65499
592,2,17,true,10,3,-7,41.96065,-87.74538
13389,2,17,true,76,83,7,41.961,-87.64958
245,2,17,true,19,26,7,41.96101,-87.64958
15621,2,17,true,36,13,-23,41.96103,-87.70586
480,2,17,true,4,3,-1,41.96104,-87.70586
630,2,17,true,3,1,-2,41.96107,-87.73569
KA1706005015,2,17,true,8,3,-5,41.96108,-87.73569
481,2,17,true,6,3,-3,41.96108,-87.69544
15622,2,17,true,18,32,14,41.96108,-87.69544
KA1504000164,2,17,true,5,6,1,41.96109,-87.72897
495,2,17,true,2,4,2,41.96109,-87.72897
KA1504000097,2,17,true,13,3,-10,41.96116,-87.71658
479,2,17,true,3,2,-1,41.96116,-87.71658
238,2,17,true,7,14,7,41.96141,-87.6762
TA1307000144,2,17,true,51,57,6,41.96142,-87.6762
297,2,17,true,5,3,-2,41.9615,-87.67141
TA1309000021,2,17,true,23,36,13,41.9615,-87.6714
15623,2,17,true,25,28,3,41.96154,-87.69117
482,2,17,true,3,11,8,41.96154,-87.69117
234,2,17,true,6,13,7,41.96158,-87.6661
KA1503000022,2,17,true,30,36,6,41.96158,-87.66609
231,2,17,true,13,11,-2,41.96163,-87.65464
TA1307000107,2,17,true,105,117,12,41.96164,-87.65464
TA1307000156,2,17,true,39,48,9,41.96301,-87.68479
243,2,17,true,5,8,3,41.96302,-87.68479
TA1309000012,2,17,true,35,18,-17,41.96325,-87.67928
249,2,17,true,17,22,5,41.96398,-87.63818
TA1308000012,2,17,true,81,114,33,41.96398,-87.63818
293,2,17,true,11,17,6,41.96521,-87.65822
13074,2,17,true,86,70,-16,41.96521,-87.6582
639,2,17,true,77,97,20,41.96584,-87.64538
KA1504000127,2,17,true,15,13,-2,41.96587,-87.70083
477,2,17,true,1,2,1,41.96587,-87.70083
KA1504000093,2,17,true,31,39,8,41.96587,-87.69365
478,2,17,true,9,12,3,41.96587,-87.69364
TA1307000140,2,17,true,31,72,41,41.96643,-87.68865
239,2,17,true,14,13,-1,41.9665,-87.68843
326,2,17,true,15,14,-1,41.96665,-87.67113
476,2,17,true,1,1,0,41.96668,-87.70807
KA1504000126,2,17,true,7,10,3,41.96668,-87.70807
TA1309000014,2,17,true,57,91,34,41.96709,-87.66744
TA1307000158,2,17,true,68,31,-37,41.9671,-87.67904
242,2,17,true,13,2,-11,41.9671,-87.67904
251,2,17,true,11,5,-6,41.96796,-87.65
TA1307000119,2,17,true,40,47,7,41.96796,-87.65
15615,2,17,true,6,4,-2,41.96835,-87.71183
474,2,17,true,4,2,-2,41.96835,-87.71182
323,2,17,true,7,4,-3,41.96869,-87.66034
253,2,17,true,8,8,0,41.96883,-87.65765
TA1308000021,2,17,true,44,66,22,41.96883,-87.65765
475,2,17,true,4,10,6,41.96885,-87.69611
KA1504000080,2,17,true,22,54,32,41.96887,-87.69609
TA1309000015,2,17,true,12,16,4,41.96889,-87.68401
TA1309000066,2,17,true,200,131,-69,41.9691,-87.67423
344,2,17,true,23,24,1,41.9691,-87.67423
TA1309000041,2,17,true,49,35,-14,41.96951,-87.65471
465,2,17,true,14,7,-7,41.97161,-87.65016
KA1504000171,2,17,true,56,55,-1,41.97161,-87.65016
325,2,17,true,5,11,6,41.9728,-87.67186
TA1309000035,2,17,true,107,113,6,41.97335,-87.66785
295,2,17,true,9,6,-3,41.97378,-87.65972
13108,2,17,true,72,50,-22,41.97379,-87.65971
KA1504000078,2,17,true,19,29,10,41.97491,-87.69258
472,2,17,true,6,11,5,41.97492,-87.69262
KA1504000149,2,17,true,28,29,1,41.97562,-87.67945
464,2,17,true,2,7,5,41.97562,-87.67945
KA1504000160,2,17,true,27,16,-11,41.97564,-87.70143
471,2,17,true,5,4,-1,41.97564,-87.70143
KA1504000128,2,17,true,5,10,5,41.97567,-87.70927
KA1504000146,2,17,true,64,64,0,41.978,-87.66805
463,2,17,true,7,15,8,41.978,-87.66805
294,2,17,true,26,17,-9,41.97835,-87.65976
13109,2,17,true,76,79,3,41.97835,-87.65976
KA1504000147,2,17,true,8,42,34,41.97976,-87.67754
655,2,17,true,18,14,-4,41.97987,-87.68194
KA1504000161,2,17,true,8,2,-6,41.98038,-87.71612
KA1504000167,2,17,true,4,7,3,41.98206,-87.70895
494,2,17,true,2,2,0,41.98234,-87.70892
460,2,17,true,6,15,9,41.98358,-87.66916
KA1504000151,2,17,true,54,63,9,41.98359,-87.66916
468,2,17,true,3,2,-1,41.98367,-87.69642
459,2,17,true,33,42,9,41.98403,-87.65231
KA1504000152,2,17,true,128,140,12,41.98403,-87.65231
15578,2,17,true,53,47,-6,41.98405,-87.66027
461,2,17,true,8,6,-2,41.98405,-87.66027
353,2,17,true,1,1,0,41.98656,-87.70761
15575,2,17,true,52,57,5,41.98975,-87.66014
458,2,17,true,2,16,14,41.98975,-87.66013
455,2,17,true,2,2,0,41.99024,-87.69338
KA1504000130,2,17,true,1,4,3,41.99024,-87.69338
457,2,17,true,5,5,0,41.99052,-87.66982
KA1504000148,2,17,true,16,43,27,41.99086,-87.66971
KA1504000155,2,17,true,2,5,3,41.99118,-87.68359
452,2,17,true,1,2,1,41.99417,-87.68945
KA1504000129,2,17,true,4,6,2,41.99417,-87.68945
15571,2,17,true,56,44,-12,41.99478,-87.66028
454,2,17,true,15,17,2,41.99478,-87.66027
KA1504000156,2,17,true,19,7,-12,41.99925,-87.67137
453,2,17,true,7,6,-1,41.99925,-87.67137
RP-009,2,17,true,32,24,-8,42.00107,-87.66122
451,2,17,true,2,6,4,42.00108,-87.66123
RP-001,2,17,true,4,5,1,42.00179,-87.68883
449,2,17,true,1,1,0,42.00446,-87.67241
RP-008,2,17,true,10,13,3,42.00446,-87.6724
RP-002,2,17,true,5,5,0,42.00456,-87.68065
660,2,17,true,23,29,6,42.00458,-87.66143
354,2,17,true,6,8,2,42.00587,-87.66802
KA1504000175,2,17,true,37,25,-12,42.00797,-87.66549
447,2,17,true,3,3,0,42.00797,-87.66548
RP-005,2,17,true,17,16,-1,42.0086,-87.69047
467,2,17,true,1,2,1,42.0086,-87.69047
KA1504000162,2,17,true,28,16,-12,42.00907,-87.67422
KA1504000159,2,17,true,19,20,1,42.01059,-87.66241
RP-006,2,17,true,4,10,6,42.01213,-87.68292
RP-007,2,17,true,12,11,-1,42.01256,-87.67431
525,2,17,true,22,16,-6,42.01272,-87.66605
517,2,17,true,17,12,-5,42.01597,-87.675
520,2,17,true,21,36,15,42.01597,-87.66859
519,2,17,true,2,3,1,42.01696,-87.67773
527,2,17,true,3,3,0,42.01892,-87.69004
515,2,17,true,20,9,-11,42.01915,-87.67356
514,2,17,true,2,10,8,42.01927,-87.68452
16806,2,17,true,3,19,16,42.01953,-87.66955
522,2,17,true,3,1,-2,42.01954,-87.66954
523,2,17,true,25,40,15,42.02089,-87.66505
662,2,17,true,3,5,2,42.02354,-87.69961
598,2,17,true,4,6,2,42.02578,-87.68411
597,2,17,true,3,7,4,42.03256,-87.67914
E002,2,17,true,23,25,2,42.03256,-87.67912
E011,2,17,true,2,1,-1,42.03473,-87.69912
599,2,17,true,6,6,0,42.03972,-87.69942
625,2,17,true,2,3,1,42.04163,-87.6808
596,2,17,true,66,47,-19,42.04822,-87.68348
600,2,17,true,7,15,8,42.04831,-87.6983
E008,2,17,true,17,12,-5,42.05049,-87.67782
603,2,17,true,2,1,-1,42.05049,-87.67782
605,2,17,true,38,17,-21,42.05294,-87.67342
661,2,17,true,4,9,5,42.05704,-87.68657
604,2,17,true,51,26,-25,42.05824,-87.67744
E006,2,17,true,9,9,0,42.06367,-87.69871
601,2,17,true,3,3,0,42.06368,-87.69871
E007,2,17,true,8,14,6,42.06431,-87.68615
602,2,17,true,5,6,1,42.06431,-87.68614
E014,2,17,true,4,6,2,42.06483,-87.71531
20208,3,9,false,2,1,-1,41.66871,-87.63717
20131,3,9,false,1,1,0,41.69169,-87.61
20227,3,9,false,3,1,-2,41.7179,-87.56461
20238,3,9,false,3,2,-1,41.7187,-87.597
20242,3,9,false,1,2,1,41.7282,-87.54962
20116,3,9,false,1,1,0,41.73652,-87.60126
20230,3,9,false,1,1,0,41.73716,-87.57272
20120,3,9,false,1,3,2,41.74372,-87.63409
576,3,9,false,2,1,-1,41.75129,-87.59752
16970,3,9,false,2,1,-1,41.7518,-87.5785
KA1503000049,3,9,false,1,2,1,41.75788,-87.54938
KA1503000019,3,9,false,1,1,0,41.75867,-87.5869
652,3,9,false,3,1,-2,41.766,-87.61173
12,3,9,false,1,1,0,41.76641,-87.5657
KA1503000002,3,9,false,4,4,0,41.76641,-87.5657
KA1503000045,3,9,false,3,1,-2,41.76649,-87.58647
KA1503000030,3,9,false,1,1,0,41.77352,-87.57722
KA1503000029,3,9,false,7,3,-4,41.77364,-87.56747
KA1503000055,3,9,false,3,2,-1,41.77939,-87.64463
KA1503000046,3,9,false,2,3,1,41.78041,-87.59141
KA1503000054,3,9,false,3,2,-1,41.78061,-87.60582
15491,3,9,false,5,3,-2,41.78096,-87.57624
KA1503000033,3,9,false,10,4,-6,41.78411,-87.61329
426,3,9,false,6,2,-4,41.7851,-87.60108
KA1503000014,3,9,false,13,12,-1,41.7851,-87.60108
KA1503000070,3,9,false,4,4,0,41.78794,-87.58831
328,3,9,false,1,6,5,41.78872,-87.6013
TA1309000011,3,9,false,1,14,13,41.78873,-87.60131
KA1503000071,3,9,false,6,26,20,41.79148,-87.59988
KA1503000074,3,9,false,10,16,6,41.79174,-87.58395
TA1309000063,3,9,false,14,11,-3,41.79325,-87.5878
559,3,9,false,1,1,0,41.79423,-87.65509
KA1504000076,3,9,false,11,8,-3,41.7943,-87.60145
TA1307000160,3,9,false,5,1,-4,41.79485,-87.61873
TA1308000009,3,9,false,17,9,-8,41.79522,-87.58075
TA1307000164,3,9,false,1,8,7,41.79527,-87.59647
248,3,9,false,2,1,-1,41.79528,-87.59647
KA1503000052,3,9,false,9,5,-4,41.79935,-87.60097
KA1503000059,3,9,false,21,7,-14,41.79952,-87.58643
TA1309000037,3,9,false,9,11,2,41.79957,-87.59474
417,3,9,false,1,1,0,41.80242,-87.5869
KA1503000007,3,9,false,10,6,-4,41.80242,-87.58689
13398,3,9,false,14,11,-3,41.80256,-87.59035
121,3,9,false,1,1,0,41.80256,-87.59035
TA1309000067,3,9,false,3,2,-1,41.80303,-87.60661
322,3,9,false,2,4,2,41.80321,-87.59849
KA1503000069,3,9,false,3,3,0,41.80579,-87.59247
KA1503000009,3,9,false,4,2,-2,41.80932,-87.63346
TA1308000035,3,9,false,15,6,-9,41.80944,-87.59188
267,3,9,false,3,1,-2,41.80944,-87.59188
TA1308000002,3,9,false,6,2,-4,41.80983,-87.59937
TA1308000007,3,9,false,3,3,0,41.80984,-87.61628
200,3,9,false,2,2,0,41.80985,-87.61628
TA1309000053,3,9,false,2,3,1,41.80985,-87.60675
KA1503000065,3,9,false,3,3,0,41.81409,-87.59701
TA1308000023,3,9,false,1,1,0,41.81649,-87.60659
KA1503000027,3,9,false,7,2,-5,41.81666,-87.61942
13083,3,9,false,1,2,1,41.82167,-87.62153
265,3,9,false,2,1,-1,41.82297,-87.6071
TA1308000038,3,9,false,4,2,-2,41.82298,-87.6071
16933,3,9,false,1,2,1,41.82362,-87.65093
278,3,9,false,1,1,0,41.83062,-87.64129
TA1308000043,3,9,false,2,4,2,41.83066,-87.64715
15446,3,9,false,1,2,1,41.83068,-87.65603
KA1503000005,3,9,false,1,1,0,41.83079,-87.6325
184,3,9,false,1,2,1,41.83104,-87.62684
TA1307000129,3,9,false,3,5,2,41.83104,-87.62683
KA1503000004,3,9,false,12,2,-10,41.83127,-87.6088
13345,3,9,false,3,5,2,41.83138,-87.61803
13216,3,9,false,4,15,11,41.83473,-87.62581
149,3,9,false,1,1,0,41.83486,-87.61791
13217,3,9,false,9,2,-7,41.83488,-87.61792
13215,3,9,false,5,6,1,41.83634,-87.6135
280,3,9,false,3,1,-2,41.83779,-87.65116
TA1308000046,3,9,false,8,4,-4,41.83779,-87.65115
TA1309000055,3,9,false,3,17,14,41.8382,-87.64514
KA1503000038,3,9,false,5,1,-4,41.83845,-87.6354
TA1307000048,3,9,false,20,14,-6,41.83855,-87.60821
150,3,9,false,2,1,-1,41.83855,-87.60821
TA1308000036,3,9,false,6,1,-5,41.83883,-87.62186
KA1503000040,3,9,false,2,1,-1,41.84164,-87.65744
TA1307000139,3,9,false,11,5,-6,41.84205,-87.61698
TA1307000153,3,9,false,2,1,-1,41.84358,-87.64538
15691,3,9,false,1,1,0,41.84449,-87.70203
KA1504000110,3,9,false,1,1,0,41.84454,-87.71596
TA1307000005,3,9,false,2,1,-1,41.84569,-87.6225
TA1308000013,3,9,false,3,2,-1,41.84719,-87.64681
KA1504000086,3,9,false,2,1,-1,41.8482,-87.70542
TA1305000004,3,9,false,7,10,3,41.8514,-87.61884
TA1305000001,3,9,false,4,5,1,41.85262,-87.6265
13075,3,9,false,7,2,-5,41.8531,-87.63192
13162,3,9,false,3,3,0,41.85378,-87.64659
13096,3,9,false,3,2,-1,41.8538,-87.69577
15685,3,9,false,1,1,0,41.85399,-87.71511
15546,3,9,false,6,2,-4,41.85416,-87.61916
351,3,9,false,1,1,0,41.85441,-87.67678
13307,3,9,false,2,2,0,41.85489,-87.66359
13089,3,9,false,2,4,2,41.85497,-87.67567
13331,3,9,false,4,7,3,41.85515,-87.65414
171,3,9,false,1,1,0,41.85516,-87.65414
15545,3,9,false,16,11,-5,41.85627,-87.61334
4,3,9,false,2,2,0,41.85627,-87.61334
SL-013,3,9,false,1,4,3,41.85659,-87.62755
13135,3,9,false,16,3,-13,41.85753,-87.66157
13102,3,9,false,13,6,-7,41.85762,-87.61942
273,3,9,false,5,2,-3,41.85783,-87.62455
13150,3,9,false,17,16,-1,41.85783,-87.62455
13099,3,9,false,6,3,-3,41.85784,-87.64627
TA1307000159,3,9,false,7,13,6,41.8579,-87.6687
TA1307000044,3,9,false,1,1,0,41.85794,-87.64083
14,3,9,false,1,2,1,41.85808,-87.65109
13163,3,9,false,5,5,0,41.85808,-87.65108
13164,3,9,false,14,5,-9,41.85818,-87.65648
SL-012,3,9,false,11,8,-3,41.86038,-87.62581
72,3,9,false,5,4,-1,41.86039,-87.62581
13304,3,9,false,7,6,-1,41.86126,-87.65659
KA1504000109,3,9,false,2,1,-1,41.86192,-87.69347
TA1306000002,3,9,false,7,3,-4,41.86238,-87.65108
TA1307000124,3,9,false,9,19,10,41.86411,-87.62372
168,3,9,false,1,3,2,41.86415,-87.62372
TA1309000001,3,9,false,4,2,-2,41.86488,-87.64708
13354,3,9,false,1,2,1,41.86524,-87.66651
13029,3,9,false,11,10,-1,41.86531,-87.6179
97,3,9,false,1,7,6,41.86531,-87.6179
13431,3,9,false,11,10,-1,41.8661,-87.60728
KA1504000101,3,9,false,3,2,-1,41.86651,-87.68466
WL-008,3,9,false,32,16,-16,41.86712,-87.64108
TA1305000002,3,9,false,35,22,-13,41.86721,-87.62597
59,3,9,false,8,2,-6,41.86721,-87.62597
15544,3,9,false,17,66,49,41.86723,-87.61536
TA1305000017,3,9,false,6,3,-3,41.86734,-87.64863
KA1706005007,3,9,false,7,2,-5,41.86749,-87.63219
SL-005,3,9,false,39,19,-20,41.8679,-87.62304
255,3,9,false,2,4,2,41.86791,-87.62304
644,3,9,false,5,4,-1,41.86859,-87.68625
19,3,9,false,1,3,2,41.86892,-87.65913
13285,3,9,false,2,11,9,41.86928,-87.67372
13160,3,9,false,9,4,-5,41.86947,-87.65548
15550,3,9,false,4,11,7,41.87024,-87.63947
TA1309000010,3,9,false,14,10,-4,41.87074,-87.62574
SL-009,3,9,false,4,3,-1,41.87081,-87.63121
TA1309000064,3,9,false,13,10,-3,41.87127,-87.67369
15542,3,9,false,2,1,-1,41.87146,-87.64095
TA1307000130,3,9,false,5,9,4,41.87178,-87.65103
TA1307000121,3,9,false,2,15,13,41.87184,-87.64664
SL-008,3,9,false,15,10,-5,41.87209,-87.62956
13332,3,9,false,10,6,-4,41.87219,-87.6615
394,3,9,false,3,1,-2,41.87226,-87.63484
SL-011,3,9,false,12,8,-4,41.87256,-87.63356
623,3,9,false,49,18,-31,41.87272,-87.62399
KA1504000104,3,9,false,8,8,0,41.87296,-87.66912
383,3,9,false,1,3,2,41.87297,-87.66912
16915,3,9,false,1,1,0,41.873,-87.7645
SL-007,3,9,false,11,7,-4,41.87404,-87.6277
13326,3,9,false,6,5,-1,41.87425,-87.63958
535,3,9,false,1,1,0,41.87433,-87.72582
TA1306000025,3,9,false,5,3,-2,41.87464,-87.65703
15668,3,9,false,4,1,-3,41.87471,-87.68642
13028,3,9,false,8,17,9,41.87475,-87.64981
13081,3,9,false,1,5,4,41.87501,-87.67326
SL-010,3,9,false,9,10,1,41.87501,-87.63309
15541,3,9,false,21,11,-10,41.8758,-87.62086
13037,3,9,false,6,2,-4,41.87588,-87.64078
50,3,9,false,2,1,-1,41.87592,-87.6307
TA1305000009,3,9,false,9,1,-8,41.87593,-87.63068
TA1305000010,3,9,false,21,11,-10,41.87623,-87.62444
624,3,9,false,16,15,-1,41.87626,-87.62923
2,3,9,false,2,1,-1,41.87649,-87.62051
33,3,9,false,2,1,-1,41.87715,-87.62786
TA1305000035,3,9,false,13,16,3,41.87716,-87.62787
13138,3,9,false,7,6,-1,41.87723,-87.63941
16913,3,9,false,1,1,0,41.87762,-87.7454
15539,3,9,false,9,12,3,41.87763,-87.64405
13158,3,9,false,13,18,5,41.87764,-87.64957
134,3,9,false,3,1,-2,41.87764,-87.64954
13157,3,9,false,6,12,6,41.87773,-87.6548
TA1305000025,3,9,false,24,38,14,41.87773,-87.63528
36,3,9,false,1,2,1,41.87776,-87.63525
284,3,9,false,3,3,0,41.87784,-87.62408
TA1309000002,3,9,false,16,21,5,41.87784,-87.62408
13206,3,9,false,8,3,-5,41.87794,-87.66201
283,3,9,false,1,3,2,41.87809,-87.63183
TA1309000004,3,9,false,8,9,1,41.87811,-87.63184
638,3,9,false,14,10,-4,41.87827,-87.64078
TA1305000005,3,9,false,13,12,-1,41.87924,-87.62975
13011,3,9,false,17,28,11,41.87931,-87.63993
TA1309000008,3,9,false,8,12,4,41.87933,-87.6355
192,3,9,false,3,4,1,41.87935,-87.63997
KA1503000034,3,9,false,16,7,-9,41.87938,-87.63197
40,3,9,false,2,1,-1,41.87944,-87.63197
39,3,9,false,3,3,0,41.87948,-87.62571
KA1503000015,3,9,false,4,14,10,41.87948,-87.6257
287,3,9,false,1,4,3,41.88017,-87.63527
TA1309000007,3,9,false,13,45,32,41.88022,-87.63526
WL-011,3,9,false,12,8,-4,41.88034,-87.64273
13156,3,9,false,6,9,3,41.88042,-87.65554
13300,3,9,false,36,33,-3,41.88097,-87.61675
76,3,9,false,2,5,3,41.88098,-87.61675
13008,3,9,false,42,54,12,41.88105,-87.62408
90,3,9,false,1,3,2,41.88107,-87.62409
49,3,9,false,3,5,2,41.88116,-87.62963
TA1305000006,3,9,false,28,26,-2,41.88122,-87.6296
13134,3,9,false,6,3,-3,41.88138,-87.67493
13056,3,9,false,3,14,11,41.88168,-87.63951
TA1307000120,3,9,false,22,19,-3,41.88188,-87.64879
13341,3,9,false,21,23,2,41.88208,-87.63985
174,3,9,false,1,1,0,41.88208,-87.63984
13036,3,9,false,18,28,10,41.8821,-87.62513
77,3,9,false,1,3,2,41.88214,-87.64108
TA1305000032,3,9,false,22,31,9,41.88218,-87.64109
98,3,9,false,1,2,1,41.88266,-87.63251
13006,3,9,false,12,13,1,41.88268,-87.63252
13353,3,9,false,3,5,2,41.88283,-87.6612
346,3,9,false,1,1,0,41.88284,-87.6612
654,3,9,false,6,6,0,41.88307,-87.65698
13409,3,9,false,10,14,4,41.8831,-87.6511
KA1503000072,3,9,false,18,23,5,41.88317,-87.63693
WL-012,3,9,false,20,19,-1,41.88337,-87.6412
13053,3,9,false,16,36,20,41.88365,-87.64863
43,3,9,false,5,6,1,41.88396,-87.62455
13001,3,9,false,26,47,21,41.88397,-87.62459
13155,3,9,false,5,7,2,41.88407,-87.65689
18062,3,9,false,16,17,1,41.88412,-87.65427
TA1306000010,3,9,false,14,31,17,41.88419,-87.62961
15666,3,9,false,1,1,0,41.88446,-87.6963
KA1504000106,3,9,false,1,5,4,41.88459,-87.70631
TA1305000030,3,9,false,25,41,16,41.88459,-87.63178
15535,3,9,false,13,12,-1,41.8846,-87.64455
96,3,9,false,2,2,0,41.8846,-87.64455
51,3,9,false,3,5,2,41.88462,-87.63176
TA1305000029,3,9,false,14,25,11,41.88466,-87.62787
195,3,9,false,6,4,-2,41.88466,-87.61952
13263,3,9,false,21,30,9,41.88467,-87.61952
44,3,9,false,1,2,1,41.88468,-87.62782
528,3,9,false,1,1,0,41.88537,-87.72661
TA1306000015,3,9,false,23,38,15,41.88549,-87.65232
71,3,9,false,1,1,0,41.8855,-87.65233
13021,3,9,false,20,25,5,41.88559,-87.64184
TA1307000111,3,9,false,27,41,14,41.88582,-87.63548
164,3,9,false,1,3,2,41.88583,-87.63547
13073,3,9,false,8,7,-1,41.88592,-87.66717
KA17018054,3,9,false,3,5,2,41.88595,-87.67701
38,3,9,false,6,2,-4,41.88599,-87.63089
KA1503000012,3,9,false,19,35,16,41.88599,-87.63089
TA1305000011,3,9,false,50,37,-13,41.886,-87.62418
7,3,9,false,6,1,-5,41.88627,-87.61751
15534,3,9,false,25,10,-15,41.88627,-87.61749
13197,3,9,false,9,10,1,41.8866,-87.65816
264,3,9,false,5,2,-3,41.8867,-87.62224
TA1308000029,3,9,false,27,18,-9,41.88673,-87.62225
TA1307000131,3,9,false,32,23,-9,41.88688,-87.62606
194,3,9,false,4,4,0,41.88688,-87.62606
KA1503000064,3,9,false,27,18,-9,41.88697,-87.61281
6,3,9,false,3,2,-1,41.88697,-87.61281
100,3,9,false,1,3,2,41.88814,-87.63657
TA1305000022,3,9,false,36,45,9,41.88817,-87.63656
56,3,9,false,3,1,-2,41.88866,-87.64442
TA1306000003,3,9,false,15,18,3,41.88867,-87.64442
KA1503000043,3,9,false,29,24,-5,41.88918,-87.63851
133,3,9,false,8,5,-3,41.88918,-87.63851
13050,3,9,false,16,25,9,41.88919,-87.62775
47,3,9,false,2,3,1,41.88921,-87.62775
TA1307000151,3,9,false,42,46,4,41.88993,-87.63427
212,3,9,false,5,5,0,41.88995,-87.63427
636,3,9,false,17,12,-5,41.88997,-87.63662
KA1503000044,3,9,false,24,18,-6,41.89018,-87.6262
196,3,9,false,2,4,2,41.89053,-87.62205
13427,3,9,false,17,24,7,41.89054,-87.62205
26,3,9,false,1,2,1,41.89057,-87.61798
13430,3,9,false,43,30,-13,41.89077,-87.63169
TA1306000013,3,9,false,24,34,10,41.89083,-87.61852
RN-,3,9,false,30,10,-20,41.89102,-87.63546
672,3,9,false,2,3,1,41.89102,-87.63545
13434,3,9,false,7,6,-1,41.89108,-87.66663
TA1308000006,3,9,false,10,3,-7,41.89128,-87.67686
199,3,9,false,1,6,5,41.89143,-87.62676
TA1307000117,3,9,false,59,34,-25,41.89144,-87.62675
13033,3,9,false,13,22,9,41.8916,-87.64835
214,3,9,false,4,3,-1,41.89161,-87.67688
84,3,9,false,3,3,0,41.89161,-87.64833
13194,3,9,false,20,3,-17,41.8918,-87.65878
TA1305000003,3,9,false,27,29,2,41.89187,-87.62061
24,3,9,false,5,3,-2,41.8919,-87.62063
35,3,9,false,2,1,-1,41.89227,-87.61206
13022,3,9,false,89,67,-22,41.89227,-87.61205
99,3,9,false,6,4,-2,41.89255,-87.61449
TA1306000029,3,9,false,25,19,-6,41.89256,-87.61449
13265,3,9,false,19,19,0,41.89383,-87.64172
74,3,9,false,7,2,-5,41.89384,-87.64173
13045,3,9,false,43,34,-9,41.89403,-87.62931
110,3,9,false,6,9,3,41.89406,-87.6293
13016,3,9,false,33,43,10,41.89431,-87.62277
211,3,9,false,4,9,5,41.89439,-87.62267
KA1503000041,3,9,false,44,38,-6,41.89452,-87.61798
142,3,9,false,2,2,0,41.89453,-87.61806
92,3,9,false,3,3,0,41.89455,-87.65346
13196,3,9,false,17,13,-4,41.89455,-87.65345
TA1307000062,3,9,false,24,13,-11,41.89466,-87.63839
111,3,9,false,6,1,-5,41.89466,-87.63837
TA1306000012,3,9,false,31,31,0,41.89475,-87.63438
53,3,9,false,2,3,1,41.89476,-87.63439
KP1705001026,3,9,false,25,12,-13,41.89483,-87.6323
16921,3,9,false,1,1,0,41.89488,-87.77459
16920,3,9,false,1,2,1,41.89495,-87.76491
18058,3,9,false,12,8,-4,41.8955,-87.68201
637,3,9,false,6,1,-5,41.89563,-87.67209
128,3,9,false,2,2,0,41.89571,-87.67716
13132,3,9,false,19,11,-8,41.89573,-87.67718
161,3,9,false,3,3,0,41.89574,-87.62599
15530,3,9,false,35,18,-17,41.89575,-87.62596
18003,3,9,false,10,13,3,41.89575,-87.62011
635,3,9,false,2,2,0,41.89576,-87.62012
13247,3,9,false,13,10,-3,41.89597,-87.66775
350,3,9,false,1,1,0,41.89597,-87.66774
TA1305000020,3,9,false,18,13,-5,41.89636,-87.65406
54,3,9,false,1,3,2,41.89637,-87.65407
13289,3,9,false,18,2,-16,41.89638,-87.661
337,3,9,false,2,2,0,41.89659,-87.63096
13303,3,9,false,13,15,2,41.89672,-87.63088
13017,3,9,false,22,17,-5,41.89676,-87.6357
13338,3,9,false,23,17,-6,41.89697,-87.62173
173,3,9,false,3,3,0,41.89704,-87.62173
TA1307000061,3,9,false,25,11,-14,41.89745,-87.62873
106,3,9,false,1,2,1,41.89746,-87.62874
25,3,9,false,2,2,0,41.89751,-87.62354
13034,3,9,false,22,10,-12,41.89754,-87.62352
48,3,9,false,3,1,-2,41.89772,-87.64302
TA1306000009,3,9,false,42,42,0,41.89772,-87.64299
620,3,9,false,11,22,11,41.89817,-87.63754
KA1504000103,3,9,false,20,5,-15,41.89842,-87.68659
145,3,9,false,1,1,0,41.89856,-87.62211
15529,3,9,false,37,19,-18,41.89858,-87.62206
140,3,9,false,2,2,0,41.89895,-87.6299
TA1307000128,3,9,false,29,20,-9,41.89896,-87.6299
657,3,9,false,7,2,-5,41.89918,-87.6722
KA1504000117,3,9,false,4,7,3,41.89936,-87.64848
30,3,9,false,1,1,0,41.89964,-87.66789
13248,3,9,false,6,5,-1,41.89964,-87.66788
TA1306000011,3,9,false,11,3,-8,41.89994,-87.63443
KA1504000116,3,9,false,6,8,2,41.90023,-87.64299
17660,3,9,false,7,1,-6,41.90036,-87.69671
13290,3,9,false,9,3,-6,41.90069,-87.66259
13042,3,9,false,93,69,-24,41.90097,-87.62377
85,3,9,false,3,5,2,41.90098,-87.62375
TA1307000070,3,9,false,9,11,2,41.90133,-87.67742
KA1504000133,3,9,false,19,33,14,41.90234,-87.62773
172,3,9,false,4,9,5,41.90236,-87.62774
305,3,9,false,2,1,-1,41.9028,-87.69005
13241,3,9,false,9,3,-6,41.9029,-87.68731
176,3,9,false,3,2,-1,41.90291,-87.63141
TA1306000006,3,9,false,4,3,-1,41.90292,-87.63772
TA1307000039,3,9,false,24,45,21,41.90294,-87.63137
658,3,9,false,9,7,-2,41.903,-87.6838
13256,3,9,false,12,2,-10,41.90302,-87.69749
TA1305000034,3,9,false,12,9,-3,41.90313,-87.67391
182,3,9,false,6,4,-2,41.90317,-87.63442
KA1504000135,3,9,false,24,38,14,41.90319,-87.63439
13136,3,9,false,13,6,-7,41.90326,-87.67845
130,3,9,false,1,1,0,41.90327,-87.67846
210,3,9,false,4,1,-3,41.90342,-87.66781
13061,3,9,false,14,25,11,41.90342,-87.66779
KA1504000079,3,9,false,12,10,-2,41.9035,-87.64334
TA1307000115,3,9,false,9,3,-6,41.9046,-87.64056
291,3,9,false,6,5,-1,41.90672,-87.63494
TA1308000049,3,9,false,17,18,1,41.90672,-87.6349
KA1504000134,3,9,false,15,13,-2,41.90687,-87.6262
180,3,9,false,3,2,-1,41.90687,-87.62618
13224,3,9,false,16,9,-7,41.90706,-87.66725
333,3,9,false,1,3,2,41.90706,-87.66725
TA1307000143,3,9,false,4,2,-2,41.90762,-87.63854
61,3,9,false,1,4,3,41.90764,-87.67254
13221,3,9,false,4,8,4,41.90765,-87.67254
13245,3,9,false,7,6,-1,41.90777,-87.68586
TA1309000024,3,9,false,19,17,-2,41.908,-87.63152
TA1305000041,3,9,false,14,21,7,41.9094,-87.67769
508,3,9,false,1,1,0,41.90964,-87.71664
331,3,9,false,19,30,11,41.90965,-87.64812
15653,3,9,false,10,6,-4,41.90979,-87.7053
TA1305000037,3,9,false,9,11,2,41.91018,-87.67003
TA1306000008,3,9,false,7,8,1,41.9102,-87.6435
TA1308000005,3,9,false,7,4,-3,41.91042,-87.68238
13258,3,9,false,5,4,-1,41.91043,-87.69718
13257,3,9,false,14,12,-2,41.91054,-87.68956
13154,3,9,false,10,17,7,41.91054,-87.65312
20,3,9,false,2,3,1,41.91055,-87.65313
13058,3,9,false,10,10,0,41.91059,-87.64942
TA1307000038,3,9,false,16,9,-7,41.91138,-87.63868
LF-005,3,9,false,23,24,1,41.91172,-87.62681
13128,3,9,false,20,13,-7,41.91197,-87.63197
289,3,9,false,5,6,1,41.91209,-87.63472
TA1308000050,3,9,false,40,31,-9,41.91211,-87.6347
13243,3,9,false,9,13,4,41.91262,-87.6814
TA1309000032,3,9,false,1,2,1,41.91293,-87.66417
TA1306000032,3,9,false,13,5,-8,41.9137,-87.65285
TA1307000166,3,9,false,7,7,0,41.91386,-87.64877
15655,3,9,false,15,1,-14,41.91401,-87.70514
18017,3,9,false,3,3,0,41.91416,-87.71676
18067,3,9,false,8,4,-4,41.9146,-87.66796
TA1306000007,3,9,false,9,4,-5,41.91469,-87.64333
13068,3,9,false,13,11,-2,41.91554,-87.68703
116,3,9,false,4,3,-1,41.91555,-87.68703
13179,3,9,false,27,38,11,41.9157,-87.63461
141,3,9,false,1,3,2,41.91571,-87.63461
13133,3,9,false,7,9,2,41.91598,-87.67733
58,3,9,false,2,2,0,41.91602,-87.66894
TA1305000039,3,9,false,15,16,1,41.9163,-87.66749
15650,3,9,false,1,3,2,41.91711,-87.71023
15651,3,9,false,6,3,-3,41.91752,-87.70181
13266,3,9,false,7,4,-3,41.91774,-87.69142
TA1309000029,3,9,false,12,3,-9,41.9178,-87.68245
309,3,9,false,2,1,-1,41.91789,-87.6865
TA1309000006,3,9,false,7,5,-2,41.91809,-87.64375
288,3,9,false,1,1,0,41.91809,-87.64375
223,3,9,false,1,3,2,41.91821,-87.65698
TA1307000163,3,9,false,7,16,9,41.91821,-87.65696
94,3,9,false,9,8,-1,41.91831,-87.6363
13146,3,9,false,14,26,12,41.91831,-87.63629
13059,3,9,false,20,12,-8,41.91845,-87.65222
113,3,9,false,1,2,1,41.91846,-87.65222
13259,3,9,false,6,3,-3,41.91852,-87.69744
259,3,9,false,1,1,0,41.91853,-87.69745
225,3,9,false,1,1,0,41.91995,-87.64884
13192,3,9,false,7,17,10,41.91995,-87.64884
13288,3,9,false,6,4,-2,41.92008,-87.67788
13242,3,9,false,5,8,3,41.92021,-87.69266
307,3,9,false,1,1,0,41.92077,-87.66373
TA1309000030,3,9,false,15,14,-1,41.92077,-87.66372
13292,3,9,false,4,3,-1,41.92152,-87.70733
TA1309000033,3,9,false,17,12,-5,41.92158,-87.65381
13193,3,9,false,25,25,0,41.92182,-87.64412
13191,3,9,false,17,11,-6,41.92217,-87.63891
143,3,9,false,2,1,-1,41.92217,-87.63891
327,3,9,false,1,1,0,41.92225,-87.65783
13084,3,9,false,16,12,-4,41.92268,-87.69715
LP-,3,9,false,12,16,4,41.92396,-87.63584
505,3,9,false,2,1,-1,41.92409,-87.67646
KA1504000140,3,9,false,2,3,1,41.92409,-87.67646
619,3,9,false,1,1,0,41.92457,-87.7279
16010,3,9,false,3,1,-2,41.92458,-87.72787
15648,3,9,false,1,1,0,41.92464,-87.68931
503,3,9,false,3,1,-2,41.92483,-87.71451
KA1504000090,3,9,false,3,1,-2,41.92483,-87.7145
TA1307000001,3,9,false,5,4,-1,41.92535,-87.66581
TA1306000026,3,9,false,13,24,11,41.92558,-87.65842
67,3,9,false,1,1,0,41.9256,-87.65371
TA1306000016,3,9,false,11,19,8,41.9256,-87.65371
313,3,9,false,6,3,-3,41.9257,-87.64246
TA1309000019,3,9,false,41,43,2,41.92586,-87.63897
TA1309000058,3,9,false,28,23,-5,41.92591,-87.64927
127,3,9,false,2,7,5,41.92592,-87.64927
TA1308000001,3,9,false,32,29,-3,41.92627,-87.63086
177,3,9,false,1,2,1,41.92627,-87.63086
15646,3,9,false,3,5,2,41.92668,-87.6977
13124,3,9,false,11,8,-3,41.92675,-87.63444
302,3,9,false,7,2,-5,41.92859,-87.65421
TA1309000023,3,9,false,7,11,4,41.9287,-87.65383
TA1307000113,3,9,false,10,5,-5,41.92878,-87.66391
190,3,9,false,1,1,0,41.92878,-87.6639
166,3,9,false,2,2,0,41.92883,-87.66853
13296,3,9,false,14,5,-9,41.92883,-87.66852
TA1309000059,3,9,false,8,6,-2,41.92889,-87.65898
349,3,9,false,2,1,-1,41.92915,-87.6491
TA1309000061,3,9,false,10,6,-4,41.92915,-87.64909
TA1308000031,3,9,false,11,11,0,41.92946,-87.68417
340,3,9,false,2,6,4,41.92956,-87.64313
TA1305000014,3,9,false,17,25,8,41.92956,-87.64313
260,3,9,false,2,1,-1,41.92958,-87.70791
13085,3,9,false,16,19,3,41.92958,-87.70789
15643,3,9,false,7,3,-4,41.93057,-87.7238
TA1307000142,3,9,false,26,13,-13,41.93125,-87.64432
220,3,9,false,3,3,0,41.93125,-87.64431
13276,3,9,false,26,13,-13,41.93132,-87.63874
324,3,9,false,1,2,1,41.93173,-87.64179
15645,3,9,false,1,3,2,41.93191,-87.70121
13271,3,9,false,1,4,3,41.93192,-87.67784
152,3,9,false,5,5,0,41.93221,-87.65864
TA1307000064,3,9,false,17,22,5,41.93222,-87.65864
TA1306000014,3,9,false,17,17,0,41.93242,-87.65271
13,3,9,false,3,4,1,41.93242,-87.65271
TA1309000039,3,9,false,30,14,-16,41.93258,-87.63642
329,3,9,false,2,1,-1,41.93258,-87.63642
13294,3,9,false,9,5,-4,41.9326,-87.66595
319,3,9,false,5,2,-3,41.93292,-87.67217
332,3,9,false,4,1,-3,41.93313,-87.64776
TA1309000036,3,9,false,10,11,1,41.93313,-87.64776
15644,3,9,false,5,5,0,41.93534,-87.71687
TA1307000006,3,9,false,16,14,-2,41.93571,-87.6636
153,3,9,false,1,4,3,41.93575,-87.66364
162,3,9,false,1,1,0,41.93588,-87.67844
13268,3,9,false,4,2,-2,41.93588,-87.67843
13269,3,9,false,8,5,-3,41.93609,-87.66983
TA1307000052,3,9,false,12,15,3,41.93628,-87.65266
156,3,9,false,2,1,-1,41.9365,-87.64756
TA1307000136,3,9,false,11,6,-5,41.9365,-87.64755
TA1307000041,3,9,false,18,20,2,41.93669,-87.63683
157,3,9,false,3,2,-1,41.9367,-87.63683
13137,3,9,false,37,30,-7,41.9376,-87.6441
300,3,9,false,6,6,0,41.93761,-87.6441
15642,3,9,false,5,2,-3,41.93843,-87.69801
664,3,9,false,2,1,-1,41.93934,-87.68327
KA17018068,3,9,false,2,5,3,41.93935,-87.68327
TA1309000042,3,9,false,5,9,4,41.93937,-87.66836
131,3,9,false,1,3,2,41.93937,-87.66835
KA150400009X,3,9,false,4,6,2,41.9394,-87.71159
15640,3,9,false,4,3,-1,41.93941,-87.72357
13229,3,9,false,16,34,18,41.93946,-87.66376
TA1308000019,3,9,false,12,7,-5,41.93973,-87.65886
13277,3,9,false,11,8,-3,41.9401,-87.64546
296,3,9,false,5,4,-1,41.9401,-87.64546
TA1307000134,3,9,false,16,22,6,41.94016,-87.65303
13143,3,9,false,5,3,-2,41.94059,-87.67853
334,3,9,false,2,2,0,41.94076,-87.63919
TA1309000049,3,9,false,41,22,-19,41.94077,-87.63919
15634,3,9,false,4,2,-2,41.94304,-87.68729
TA1307000138,3,9,false,3,7,4,41.94334,-87.67094
230,3,9,false,1,4,3,41.94335,-87.67093
13144,3,9,false,4,9,5,41.9434,-87.67964
TA1309000025,3,9,false,17,11,-6,41.94368,-87.64894
299,3,9,false,3,3,0,41.94368,-87.64894
13071,3,9,false,13,18,5,41.94373,-87.66401
632,3,9,false,23,16,-7,41.94453,-87.6547
15631,3,9,false,4,3,-1,41.94524,-87.70665
13278,3,9,false,26,14,-12,41.94553,-87.64644
TA1309000050,3,9,false,1,4,3,41.94618,-87.67331
15632,3,9,false,2,2,0,41.94664,-87.69463
KA1504000143,3,9,false,3,1,-2,41.94664,-87.68337
KA1504000142,3,9,false,3,1,-2,41.94735,-87.71759
227,3,9,false,3,2,-1,41.94813,-87.66397
13235,3,9,false,11,16,5,41.94814,-87.66396
304,3,9,false,5,3,-2,41.94878,-87.64922
13253,3,9,false,4,1,-3,41.9488,-87.67527
13325,3,9,false,21,16,-5,41.94907,-87.64863
114,3,9,false,4,3,-1,41.94935,-87.65451
TA1307000126,3,9,false,9,17,8,41.94936,-87.65451
232,3,9,false,3,1,-2,41.94943,-87.64645
TA1307000150,3,9,false,11,13,2,41.94945,-87.64646
18016,3,9,false,3,1,-2,41.94993,-87.71395
13319,3,9,false,10,9,-1,41.95069,-87.6687
TA1307000127,3,9,false,27,25,-2,41.9508,-87.65918
165,3,9,false,1,1,0,41.95081,-87.65918
15628,3,9,false,2,2,0,41.95216,-87.69806
318,3,9,false,1,1,0,41.95254,-87.6735
13323,3,9,false,13,15,2,41.95282,-87.65
256,3,9,false,1,4,3,41.95282,-87.65
15624,3,9,false,2,2,0,41.95339,-87.73199
KA1504000096,3,9,false,8,2,-6,41.95361,-87.70932
TA1309000043,3,9,false,7,3,-4,41.95417,-87.66434
13063,3,9,false,22,11,-11,41.95424,-87.65441
240,3,9,false,2,1,-1,41.95424,-87.65441
KA1504000158,3,9,false,4,2,-2,41.95432,-87.68607
254,3,9,false,7,3,-4,41.95438,-87.64806
TA1308000022,3,9,false,18,7,-11,41.95438,-87.64805
TA1307000149,3,9,false,8,11,3,41.95467,-87.67392
TA1309000026,3,9,false,4,8,4,41.95601,-87.6802
13249,3,9,false,5,3,-2,41.95606,-87.66885
TA1308000047,3,9,false,4,2,-2,41.95709,-87.6642
13379,3,9,false,12,6,-6,41.95786,-87.6495
TA1309000018,3,9,false,2,7,5,41.95791,-87.67357
TA1309000027,3,9,false,21,13,-8,41.9585,-87.65499
13389,3,9,false,10,8,-2,41.961,-87.64958
245,3,9,false,1,1,0,41.96101,-87.64958
15621,3,9,false,2,2,0,41.96103,-87.70586
15622,3,9,false,4,3,-1,41.96108,-87.69544
238,3,9,false,1,1,0,41.96141,-87.6762
TA1307000144,3,9,false,2,12,10,41.96142,-87.6762
TA1309000021,3,9,false,1,3,2,41.9615,-87.6714
15623,3,9,false,2,1,-1,41.96154,-87.69117
KA1503000022,3,9,false,8,4,-4,41.96158,-87.66609
231,3,9,false,3,1,-2,41.96163,-87.65464
TA1307000107,3,9,false,19,13,-6,41.96164,-87.65464
TA1308000012,3,9,false,13,9,-4,41.96398,-87.63818
293,3,9,false,1,1,0,41.96521,-87.65822
13074,3,9,false,15,6,-9,41.96521,-87.6582
639,3,9,false,6,4,-2,41.96584,-87.64538
KA1504000127,3,9,false,1,1,0,41.96587,-87.70083
KA1504000093,3,9,false,1,1,0,41.96587,-87.69365
478,3,9,false,1,1,0,41.96587,-87.69364
326,3,9,false,1,2,1,41.96665,-87.67113
KA1504000126,3,9,false,4,2,-2,41.96668,-87.70807
TA1309000014,3,9,false,11,11,0,41.96709,-87.66744
TA1307000158,3,9,false,3,5,2,41.9671,-87.67904
TA1307000119,3,9,false,6,4,-2,41.96796,-87.65
TA1308000021,3,9,false,7,7,0,41.96883,-87.65765
KA1504000080,3,9,false,2,5,3,41.96887,-87.69609
TA1309000066,3,9,false,8,5,-3,41.9691,-87.67423
TA1309000041,3,9,false,7,2,-5,41.96951,-87.65471
KA1504000171,3,9,false,15,3,-12,41.97161,-87.65016
325,3,9,false,1,1,0,41.9728,-87.67186
TA1309000035,3,9,false,11,7,-4,41.97335,-87.66785
295,3,9,false,1,1,0,41.97378,-87.65972
13108,3,9,false,5,6,1,41.97379,-87.65971
KA1504000078,3,9,false,6,3,-3,41.97491,-87.69258
KA1504000149,3,9,false,3,3,0,41.97562,-87.67945
471,3,9,false,2,2,0,41.97564,-87.70143
KA1504000160,3,9,false,4,6,2,41.97564,-87.70143
463,3,9,false,1,3,2,41.978,-87.66805
KA1504000146,3,9,false,7,12,5,41.978,-87.66805
13109,3,9,false,4,6,2,41.97835,-87.65976
462,3,9,false,1,1,0,41.97977,-87.67755
655,3,9,false,1,1,0,41.97987,-87.68194
KA1504000167,3,9,false,2,1,-1,41.98206,-87.70895
460,3,9,false,2,1,-1,41.98358,-87.66916
KA1504000151,3,9,false,16,13,-3,41.98359,-87.66916
15585,3,9,false,1,4,3,41.98367,-87.69642
KA1504000152,3,9,false,17,13,-4,41.98403,-87.65231
459,3,9,false,2,1,-1,41.98403,-87.65231
15578,3,9,false,6,3,-3,41.98405,-87.66027
461,3,9,false,2,2,0,41.98405,-87.66027
15575,3,9,false,10,6,-4,41.98975,-87.66014
458,3,9,false,2,1,-1,41.98975,-87.66013
KA1504000148,3,9,false,4,1,-3,41.99086,-87.66971
15571,3,9,false,5,3,-2,41.99478,-87.66028
454,3,9,false,1,1,0,41.99478,-87.66027
KA1504000156,3,9,false,2,1,-1,41.99925,-87.67137
RP-009,3,9,false,3,6,3,42.00107,-87.66122
RP-001,3,9,false,3,1,-2,42.00179,-87.68883
449,3,9,false,1,1,0,42.00446,-87.67241
RP-008,3,9,false,4,4,0,42.00446,-87.6724
660,3,9,false,5,2,-3,42.00458,-87.66143
KA1504000175,3,9,false,5,3,-2,42.00797,-87.66549
KA1504000162,3,9,false,4,2,-2,42.00907,-87.67422
KA1504000159,3,9,false,8,3,-5,42.01059,-87.66241
RP-006,3,9,false,1,6,5,42.01213,-87.68292
RP-007,3,9,false,1,2,1,42.01256,-87.67431
520,3,9,false,1,1,0,42.01597,-87.66859
527,3,9,false,1,2,1,42.01892,-87.69004
515,3,9,false,5,5,0,42.01915,-87.67356
523,3,9,false,5,2,-3,42.02089,-87.66505
E002,3,9,false,3,4,1,42.03256,-87.67912
596,3,9,false,11,10,-1,42.04822,-87.68348
600,3,9,false,2,1,-1,42.04831,-87.6983
E008,3,9,false,11,3,-8,42.05049,-87.67782
605,3,9,false,3,4,1,42.05294,-87.67342
661,3,9,false,28,7,-21,42.05704,-87.68657
604,3,9,false,7,21,14,42.05824,-87.67744
E014,3,9,false,1,2,1,42.06483,-87.71531
20112,3,9,true,1,1,0,41.70717,-87.61842
20106,3,9,true,1,1,0,41.71897,-87.60833
20103,3,9,true,1,2,1,41.7281,-87.66757
595,3,9,true,1,1,0,41.73663,-87.62264
20231,3,9,true,1,2,1,41.7368,-87.58282
579,3,9,true,2,1,-1,41.75182,-87.56522
KA1503000019,3,9,true,1,1,0,41.75867,-87.5869
KA1503000024,3,9,true,1,1,0,41.75876,-87.56644
569,3,9,true,1,1,0,41.75918,-87.59576
KA1503000020,3,9,true,2,3,1,41.76223,-87.55923
399,3,9,true,1,1,0,41.76225,-87.5592
KA1503000002,3,9,true,5,3,-2,41.76641,-87.5657
12,3,9,true,6,7,1,41.76641,-87.5657
KA1503000018,3,9,true,1,1,0,41.76663,-87.57645
KA1503000023,3,9,true,1,1,0,41.77346,-87.58534
KA1503000029,3,9,true,6,2,-4,41.77364,-87.56747
649,3,9,true,2,1,-1,41.77984,-87.63477
KA1503000053,3,9,true,1,1,0,41.78009,-87.61595
KA1503000046,3,9,true,1,1,0,41.78041,-87.59141
15491,3,9,true,5,5,0,41.78096,-87.57624
KA1503000033,3,9,true,1,2,1,41.78411,-87.61329
KA1503000014,3,9,true,77,54,-23,41.7851,-87.60108
426,3,9,true,6,19,13,41.7851,-87.60108
KA1503000070,3,9,true,22,20,-2,41.78794,-87.58831
425,3,9,true,6,1,-5,41.78795,-87.58831
328,3,9,true,1,9,8,41.78872,-87.6013
TA1309000011,3,9,true,25,77,52,41.78873,-87.60131
423,3,9,true,3,15,12,41.79148,-87.59988
KA1503000071,3,9,true,28,153,125,41.79148,-87.59988
KA1503000075,3,9,true,1,1,0,41.79156,-87.60785
KA1503000074,3,9,true,16,12,-4,41.79174,-87.58395
TA1309000063,3,9,true,39,17,-22,41.79325,-87.5878
345,3,9,true,11,8,-3,41.79326,-87.5878
420,3,9,true,14,8,-6,41.79429,-87.60145
KA1504000076,3,9,true,54,81,27,41.7943,-87.60145
247,3,9,true,6,4,-2,41.79522,-87.58077
TA1308000009,3,9,true,35,14,-21,41.79522,-87.58075
TA1307000164,3,9,true,21,25,4,41.79527,-87.59647
248,3,9,true,6,1,-5,41.79528,-87.59647
KA1503000052,3,9,true,22,7,-15,41.79935,-87.60097
418,3,9,true,12,4,-8,41.79936,-87.60097
KA1503000059,3,9,true,30,13,-17,41.79952,-87.58643
TA1309000037,3,9,true,41,18,-23,41.79957,-87.59474
417,3,9,true,9,7,-2,41.80242,-87.5869
KA1503000007,3,9,true,43,10,-33,41.80242,-87.58689
13398,3,9,true,31,5,-26,41.80256,-87.59035
121,3,9,true,12,5,-7,41.80256,-87.59035
322,3,9,true,9,9,0,41.80321,-87.59849
594,3,9,true,1,1,0,41.80567,-87.68337
416,3,9,true,5,1,-4,41.80578,-87.59247
KA1503000009,3,9,true,1,1,0,41.80932,-87.63346
TA1308000035,3,9,true,7,4,-3,41.80944,-87.59188
267,3,9,true,1,1,0,41.80944,-87.59188
252,3,9,true,2,1,-1,41.80982,-87.59936
TA1308000002,3,9,true,9,4,-5,41.80983,-87.59937
TA1308000007,3,9,true,2,1,-1,41.80984,-87.61628
TA1309000053,3,9,true,4,2,-2,41.80985,-87.60675
KA1503000065,3,9,true,10,4,-6,41.81409,-87.59701
271,3,9,true,1,5,4,41.81648,-87.60659
TA1308000023,3,9,true,3,2,-1,41.81649,-87.60659
KA1503000027,3,9,true,4,3,-1,41.81666,-87.61942
13083,3,9,true,10,1,-9,41.82167,-87.62153
TA1308000038,3,9,true,3,4,1,41.82298,-87.6071
262,3,9,true,4,1,-3,41.82707,-87.64573
KA1503000068,3,9,true,1,1,0,41.82878,-87.68062
TA1308000045,3,9,true,17,6,-11,41.83062,-87.64129
TA1308000043,3,9,true,3,5,2,41.83066,-87.64715
15446,3,9,true,1,6,5,41.83068,-87.65603
405,3,9,true,1,1,0,41.83078,-87.6325
KA1503000005,3,9,true,2,4,2,41.83079,-87.6325
184,3,9,true,1,1,0,41.83104,-87.62684
TA1307000129,3,9,true,10,37,27,41.83104,-87.62683
KA1503000004,3,9,true,9,6,-3,41.83127,-87.6088
406,3,9,true,5,4,-1,41.83127,-87.6088
13345,3,9,true,3,9,6,41.83138,-87.61803
335,3,9,true,1,1,0,41.83139,-87.61803
15445,3,9,true,17,15,-2,41.83453,-87.63183
13216,3,9,true,25,99,74,41.83473,-87.62581
148,3,9,true,1,14,13,41.83474,-87.62581
149,3,9,true,1,1,0,41.83486,-87.61791
13217,3,9,true,35,16,-19,41.83488,-87.61792
13215,3,9,true,18,2,-16,41.83634,-87.6135
263,3,9,true,2,1,-1,41.8364,-87.61348
TA1308000046,3,9,true,15,13,-2,41.83779,-87.65115
339,3,9,true,9,2,-7,41.83817,-87.64523
TA1309000055,3,9,true,13,15,2,41.8382,-87.64514
KA1503000038,3,9,true,15,6,-9,41.83845,-87.6354
TA1307000048,3,9,true,17,10,-7,41.83855,-87.60821
150,3,9,true,4,3,-1,41.83855,-87.60821
272,3,9,true,2,1,-1,41.83882,-87.62186
TA1308000036,3,9,true,37,17,-20,41.83883,-87.62186
15442,3,9,true,4,2,-2,41.83918,-87.66562
KA1503000040,3,9,true,4,5,1,41.84164,-87.65744
13213,3,9,true,3,12,9,41.84171,-87.62694
237,3,9,true,8,3,-5,41.84204,-87.61697
TA1307000139,3,9,true,61,11,-50,41.84205,-87.61698
15443,3,9,true,7,3,-4,41.84275,-87.63549
147,3,9,true,3,2,-1,41.84569,-87.62251
TA1307000005,3,9,true,15,11,-4,41.84569,-87.6225
206,3,9,true,1,5,4,41.84719,-87.64683
TA1308000013,3,9,true,6,9,3,41.84719,-87.64681
348,3,9,true,1,1,0,41.8477,-87.69448
TA1309000003,3,9,true,6,6,0,41.84847,-87.68512
15689,3,9,true,17,3,-14,41.84912,-87.69515
TA1307000066,3,9,true,1,1,0,41.8492,-87.67564
TA1308000014,3,9,true,7,2,-5,41.84953,-87.64059
TA1308000026,3,9,true,4,11,7,41.85008,-87.63214
TA1305000004,3,9,true,6,5,-1,41.8514,-87.61884
42,3,9,true,1,2,1,41.85261,-87.62653
TA1305000001,3,9,true,12,7,-5,41.85262,-87.6265
13075,3,9,true,6,28,22,41.8531,-87.63192
120,3,9,true,5,9,4,41.8531,-87.63191
15686,3,9,true,1,1,0,41.85354,-87.70507
13162,3,9,true,9,5,-4,41.85378,-87.64659
13096,3,9,true,8,12,4,41.8538,-87.69577
13091,3,9,true,19,4,-15,41.85409,-87.68585
203,3,9,true,6,1,-5,41.85409,-87.68585
370,3,9,true,1,1,0,41.85415,-87.61917
15546,3,9,true,6,1,-5,41.85416,-87.61916
351,3,9,true,2,4,2,41.85441,-87.67678
13307,3,9,true,5,2,-3,41.85489,-87.66359
13089,3,9,true,3,9,6,41.85497,-87.67567
13331,3,9,true,7,9,2,41.85515,-87.65414
171,3,9,true,5,5,0,41.85516,-87.65414
15545,3,9,true,34,32,-2,41.85627,-87.61334
4,3,9,true,7,7,0,41.85627,-87.61334
178,3,9,true,2,1,-1,41.85657,-87.62755
SL-013,3,9,true,3,5,2,41.85659,-87.62755
SL-006,3,9,true,1,20,19,41.8568,-87.63387
129,3,9,true,2,3,1,41.85752,-87.66158
13135,3,9,true,29,11,-18,41.85753,-87.66157
338,3,9,true,9,3,-6,41.85758,-87.61956
13102,3,9,true,45,12,-33,41.85762,-87.61942
13150,3,9,true,39,32,-7,41.85783,-87.62455
273,3,9,true,6,3,-3,41.85783,-87.62455
13099,3,9,true,7,5,-2,41.85784,-87.64627
TA1307000159,3,9,true,33,14,-19,41.8579,-87.6687
205,3,9,true,3,2,-1,41.8579,-87.6687
TA1307000044,3,9,true,11,6,-5,41.85794,-87.64083
13163,3,9,true,15,16,1,41.85808,-87.65108
13164,3,9,true,33,21,-12,41.85818,-87.65648
15,3,9,true,7,3,-4,41.85819,-87.65648
SL-012,3,9,true,33,17,-16,41.86038,-87.62581
72,3,9,true,8,7,-1,41.86039,-87.62581
13304,3,9,true,8,2,-6,41.86126,-87.65659
KA1504000109,3,9,true,6,7,1,41.86192,-87.69347
TA1306000002,3,9,true,24,11,-13,41.86238,-87.65108
137,3,9,true,1,2,1,41.86238,-87.65108
TA1307000124,3,9,true,33,34,1,41.86411,-87.62372
168,3,9,true,16,3,-13,41.86415,-87.62372
282,3,9,true,1,1,0,41.86487,-87.64708
TA1309000001,3,9,true,26,27,1,41.86488,-87.64708
13165,3,9,true,4,2,-2,41.86505,-87.65697
13354,3,9,true,4,15,11,41.86524,-87.66651
97,3,9,true,3,1,-2,41.86531,-87.6179
13029,3,9,true,7,11,4,41.86531,-87.6179
341,3,9,true,1,4,3,41.86608,-87.60733
13431,3,9,true,16,20,4,41.8661,-87.60728
KA1504000101,3,9,true,6,3,-3,41.86651,-87.68466
434,3,9,true,4,1,-3,41.86651,-87.68465
KA1504000102,3,9,true,1,8,7,41.86664,-87.69453
WL-008,3,9,true,10,6,-4,41.86712,-87.64108
57,3,9,true,3,3,0,41.86712,-87.64107
TA1305000002,3,9,true,92,58,-34,41.86721,-87.62597
59,3,9,true,12,17,5,41.86721,-87.62597
3,3,9,true,4,7,3,41.86723,-87.61536
15544,3,9,true,19,23,4,41.86723,-87.61536
TA1305000017,3,9,true,33,38,5,41.86734,-87.64863
55,3,9,true,6,4,-2,41.86735,-87.64863
KA1706005007,3,9,true,14,10,-4,41.86749,-87.63219
626,3,9,true,1,1,0,41.86749,-87.63219
SL-005,3,9,true,75,23,-52,41.8679,-87.62304
255,3,9,true,26,3,-23,41.86791,-87.62304
644,3,9,true,32,9,-23,41.86859,-87.68625
19,3,9,true,2,11,9,41.86892,-87.65913
13139,3,9,true,28,12,-16,41.86893,-87.65913
13285,3,9,true,17,105,88,41.86928,-87.67372
13160,3,9,true,36,20,-16,41.86947,-87.65548
22,3,9,true,4,5,1,41.86947,-87.65548
382,3,9,true,1,1,0,41.8699,-87.68725
414,3,9,true,3,3,0,41.87023,-87.63947
15550,3,9,true,14,30,16,41.87024,-87.63947
TA1309000010,3,9,true,71,54,-17,41.87074,-87.62574
SL-009,3,9,true,16,23,7,41.87081,-87.63121
342,3,9,true,2,19,17,41.87127,-87.6737
TA1309000064,3,9,true,37,95,58,41.87127,-87.67369
15542,3,9,true,8,37,29,41.87146,-87.64095
261,3,9,true,3,8,5,41.87151,-87.6699
TA1307000130,3,9,true,50,68,18,41.87178,-87.65103
241,3,9,true,10,6,-4,41.8718,-87.65102
108,3,9,true,9,17,8,41.87183,-87.64664
TA1307000121,3,9,true,43,59,16,41.87184,-87.64664
41,3,9,true,6,6,0,41.87209,-87.62957
SL-008,3,9,true,50,23,-27,41.87209,-87.62956
13332,3,9,true,114,54,-60,41.87219,-87.6615
394,3,9,true,3,3,0,41.87226,-87.63484
SL-011,3,9,true,36,29,-7,41.87256,-87.63356
623,3,9,true,41,30,-11,41.87272,-87.62399
KA1504000104,3,9,true,25,109,84,41.87296,-87.66912
383,3,9,true,6,26,20,41.87297,-87.66912
320,3,9,true,13,9,-4,41.87327,-87.66402
5,3,9,true,3,2,-1,41.87403,-87.6277
SL-007,3,9,true,34,21,-13,41.87404,-87.6277
169,3,9,true,2,1,-1,41.87424,-87.63959
13326,3,9,true,13,11,-2,41.87425,-87.63958
321,3,9,true,17,11,-6,41.87427,-87.63257
TA1306000025,3,9,true,30,17,-13,41.87464,-87.65703
32,3,9,true,3,3,0,41.87464,-87.65703
15668,3,9,true,7,9,2,41.87471,-87.68642
109,3,9,true,10,3,-7,41.87475,-87.64981
13028,3,9,true,28,37,9,41.87475,-87.64981
13081,3,9,true,7,31,24,41.87501,-87.67326
89,3,9,true,2,2,0,41.87501,-87.6331
SL-010,3,9,true,16,19,3,41.87501,-87.63309
15541,3,9,true,14,4,-10,41.8758,-87.62086
68,3,9,true,1,1,0,41.87587,-87.64077
13037,3,9,true,7,34,27,41.87588,-87.64078
TA1305000009,3,9,true,22,17,-5,41.87593,-87.63068
TA1305000010,3,9,true,12,18,6,41.87623,-87.62444
624,3,9,true,40,32,-8,41.87626,-87.62923
TA1305000035,3,9,true,23,30,7,41.87716,-87.62787
13138,3,9,true,16,45,29,41.87723,-87.63941
75,3,9,true,1,2,1,41.87724,-87.63937
631,3,9,true,3,10,7,41.87761,-87.6739
15539,3,9,true,40,41,1,41.87763,-87.64405
13158,3,9,true,42,49,7,41.87764,-87.64957
134,3,9,true,16,8,-8,41.87764,-87.64954
13157,3,9,true,27,23,-4,41.87773,-87.6548
21,3,9,true,2,4,2,41.87773,-87.6548
TA1305000025,3,9,true,55,123,68,41.87773,-87.63528
36,3,9,true,7,11,4,41.87776,-87.63525
TA1309000002,3,9,true,35,29,-6,41.87784,-87.62408
13206,3,9,true,25,18,-7,41.87794,-87.66201
TA1309000004,3,9,true,26,91,65,41.87811,-87.63184
107,3,9,true,4,7,3,41.87822,-87.644
638,3,9,true,55,108,53,41.87827,-87.64078
37,3,9,true,2,22,20,41.87921,-87.62975
TA1305000005,3,9,true,29,94,65,41.87924,-87.62975
286,3,9,true,2,4,2,41.8793,-87.6355
13011,3,9,true,53,124,71,41.87931,-87.63993
TA1309000008,3,9,true,24,41,17,41.87933,-87.6355
192,3,9,true,13,22,9,41.87935,-87.63997
KA1503000034,3,9,true,13,45,32,41.87938,-87.63197
40,3,9,true,1,6,5,41.87944,-87.63197
39,3,9,true,3,12,9,41.87948,-87.62571
KA1503000015,3,9,true,19,76,57,41.87948,-87.6257
15667,3,9,true,1,1,0,41.8798,-87.68609
542,3,9,true,1,1,0,41.88013,-87.76322
287,3,9,true,3,27,24,41.88017,-87.63527
TA1309000007,3,9,true,34,159,125,41.88022,-87.63526
WL-011,3,9,true,32,20,-12,41.88034,-87.64273
73,3,9,true,5,4,-1,41.8804,-87.64273
80,3,9,true,7,4,-3,41.88042,-87.65556
13156,3,9,true,36,27,-9,41.88042,-87.65554
13300,3,9,true,25,29,4,41.88097,-87.61675
76,3,9,true,5,7,2,41.88098,-87.61675
13008,3,9,true,19,61,42,41.88105,-87.62408
90,3,9,true,5,11,6,41.88107,-87.62409
49,3,9,true,3,30,27,41.88116,-87.62963
TA1305000006,3,9,true,43,129,86,41.88122,-87.6296
13134,3,9,true,5,6,1,41.88138,-87.67493
13056,3,9,true,39,83,44,41.88168,-87.63951
191,3,9,true,11,5,-6,41.88169,-87.63951
198,3,9,true,8,12,4,41.88187,-87.6488
TA1307000120,3,9,true,57,67,10,41.88188,-87.64879
13341,3,9,true,54,112,58,41.88208,-87.63985
197,3,9,true,1,11,10,41.88208,-87.62513
13036,3,9,true,28,84,56,41.8821,-87.62513
77,3,9,true,8,6,-2,41.88214,-87.64108
TA1305000032,3,9,true,91,95,4,41.88218,-87.64109
98,3,9,true,2,19,17,41.88266,-87.63251
13006,3,9,true,28,72,44,41.88268,-87.63252
13353,3,9,true,29,22,-7,41.88283,-87.6612
346,3,9,true,7,5,-2,41.88284,-87.6612
654,3,9,true,21,19,-2,41.88307,-87.65698
233,3,9,true,7,7,0,41.88309,-87.6511
13409,3,9,true,39,42,3,41.8831,-87.6511
18,3,9,true,5,27,22,41.88317,-87.63735
KA1503000072,3,9,true,31,83,52,41.88317,-87.63693
91,3,9,true,13,11,-2,41.88336,-87.64122
WL-012,3,9,true,114,140,26,41.88337,-87.6412
112,3,9,true,5,7,2,41.88362,-87.6486
13053,3,9,true,45,77,32,41.88365,-87.64863
43,3,9,true,11,24,13,41.88396,-87.62455
13001,3,9,true,44,100,56,41.88397,-87.62459
13155,3,9,true,16,28,12,41.88407,-87.65689
621,3,9,true,6,3,-3,41.88412,-87.65427
18062,3,9,true,44,42,-2,41.88412,-87.65427
81,3,9,true,7,37,30,41.88417,-87.6296
TA1306000010,3,9,true,48,161,113,41.88419,-87.62961
TA1305000030,3,9,true,58,205,147,41.88459,-87.63178
96,3,9,true,6,5,-1,41.8846,-87.64455
15535,3,9,true,24,28,4,41.8846,-87.64455
51,3,9,true,3,27,24,41.88462,-87.63176
TA1305000029,3,9,true,32,68,36,41.88466,-87.62787
195,3,9,true,17,15,-2,41.88466,-87.61952
13263,3,9,true,70,57,-13,41.88467,-87.61952
44,3,9,true,5,4,-1,41.88468,-87.62782
TA1306000015,3,9,true,55,103,48,41.88549,-87.65232
71,3,9,true,8,16,8,41.8855,-87.65233
66,3,9,true,10,11,1,41.88557,-87.64186
13021,3,9,true,77,135,58,41.88559,-87.64184
TA1307000111,3,9,true,57,91,34,41.88582,-87.63548
164,3,9,true,8,18,10,41.88583,-87.63547
13073,3,9,true,9,18,9,41.88592,-87.66717
KA17018054,3,9,true,2,16,14,41.88595,-87.67701
38,3,9,true,9,20,11,41.88599,-87.63089
KA1503000012,3,9,true,61,101,40,41.88599,-87.63089
52,3,9,true,6,14,8,41.886,-87.62421
TA1305000011,3,9,true,52,103,51,41.886,-87.62418
7,3,9,true,7,2,-5,41.88627,-87.61751
15534,3,9,true,30,31,1,41.88627,-87.61749
217,3,9,true,5,7,2,41.8866,-87.65821
13197,3,9,true,9,46,37,41.8866,-87.65816
264,3,9,true,6,10,4,41.8867,-87.62224
TA1308000029,3,9,true,33,39,6,41.88673,-87.62225
194,3,9,true,3,10,7,41.88688,-87.62606
TA1307000131,3,9,true,9,61,52,41.88688,-87.62606
6,3,9,true,1,2,1,41.88697,-87.61281
KA1503000064,3,9,true,20,25,5,41.88697,-87.61281
100,3,9,true,6,7,1,41.88814,-87.63657
TA1305000022,3,9,true,89,131,42,41.88817,-87.63656
56,3,9,true,14,14,0,41.88866,-87.64442
TA1306000003,3,9,true,42,45,3,41.88867,-87.64442
KA1503000043,3,9,true,153,106,-47,41.88918,-87.63851
133,3,9,true,16,22,6,41.88918,-87.63851
13050,3,9,true,56,92,36,41.88919,-87.62775
47,3,9,true,7,20,13,41.88921,-87.62775
15664,3,9,true,11,1,-10,41.8895,-87.68821
13432,3,9,true,16,21,5,41.88989,-87.67149
TA1307000151,3,9,true,100,125,25,41.88993,-87.63427
212,3,9,true,13,25,12,41.88995,-87.63427
636,3,9,true,51,65,14,41.88997,-87.63662
125,3,9,true,1,9,8,41.89018,-87.62621
KA1503000044,3,9,true,24,44,20,41.89018,-87.6262
196,3,9,true,4,14,10,41.89053,-87.62205
13427,3,9,true,35,37,2,41.89054,-87.62205
26,3,9,true,11,4,-7,41.89057,-87.61798
13430,3,9,true,33,86,53,41.89077,-87.63169
181,3,9,true,3,22,19,41.89077,-87.63168
TA1306000013,3,9,true,51,31,-20,41.89083,-87.61852
RN-,3,9,true,43,79,36,41.89102,-87.63546
672,3,9,true,8,9,1,41.89102,-87.63545
277,3,9,true,2,1,-1,41.89108,-87.66665
13434,3,9,true,20,21,1,41.89108,-87.66663
TA1308000006,3,9,true,25,13,-12,41.89128,-87.67686
199,3,9,true,13,19,6,41.89143,-87.62676
TA1307000117,3,9,true,57,99,42,41.89144,-87.62675
13033,3,9,true,60,41,-19,41.8916,-87.64835
214,3,9,true,6,3,-3,41.89161,-87.67688
84,3,9,true,14,4,-10,41.89161,-87.64833
186,3,9,true,9,3,-6,41.8918,-87.65879
13194,3,9,true,51,28,-23,41.8918,-87.65878
TA1305000003,3,9,true,59,52,-7,41.89187,-87.62061
24,3,9,true,11,8,-3,41.8919,-87.62063
643,3,9,true,5,6,1,41.89203,-87.68939
35,3,9,true,10,2,-8,41.89227,-87.61206
13022,3,9,true,41,49,8,41.89227,-87.61205
99,3,9,true,10,3,-7,41.89255,-87.61449
TA1306000029,3,9,true,44,27,-17,41.89256,-87.61449
13265,3,9,true,76,62,-14,41.89383,-87.64172
74,3,9,true,14,12,-2,41.89384,-87.64173
13045,3,9,true,83,81,-2,41.89403,-87.62931
110,3,9,true,12,17,5,41.89406,-87.6293
13016,3,9,true,87,153,66,41.89431,-87.62277
211,3,9,true,9,39,30,41.89439,-87.62267
KA1503000041,3,9,true,85,159,74,41.89452,-87.61798
142,3,9,true,16,24,8,41.89453,-87.61806
92,3,9,true,6,1,-5,41.89455,-87.65346
13196,3,9,true,33,12,-21,41.89455,-87.65345
TA1307000062,3,9,true,73,70,-3,41.89466,-87.63839
111,3,9,true,20,17,-3,41.89466,-87.63837
TA1306000012,3,9,true,107,124,17,41.89475,-87.63438
53,3,9,true,23,20,-3,41.89476,-87.63439
627,3,9,true,2,9,7,41.8948,-87.63231
KP1705001026,3,9,true,49,40,-9,41.89483,-87.6323
KA1504000114,3,9,true,4,2,-2,41.89547,-87.70614
18058,3,9,true,19,5,-14,41.8955,-87.68201
659,3,9,true,9,1,-8,41.8955,-87.68201
637,3,9,true,30,11,-19,41.89563,-87.67209
128,3,9,true,5,1,-4,41.89571,-87.67716
13132,3,9,true,42,20,-22,41.89573,-87.67718
161,3,9,true,10,18,8,41.89574,-87.62599
15530,3,9,true,76,108,32,41.89575,-87.62596
18003,3,9,true,23,45,22,41.89575,-87.62011
635,3,9,true,5,11,6,41.89576,-87.62012
13247,3,9,true,25,22,-3,41.89597,-87.66775
TA1305000020,3,9,true,30,43,13,41.89636,-87.65406
54,3,9,true,6,11,5,41.89637,-87.65407
13289,3,9,true,29,8,-21,41.89638,-87.661
337,3,9,true,4,2,-2,41.89659,-87.63096
13303,3,9,true,39,29,-10,41.89672,-87.63088
13017,3,9,true,91,65,-26,41.89676,-87.6357
31,3,9,true,17,22,5,41.89677,-87.63572
13338,3,9,true,59,95,36,41.89697,-87.62173
173,3,9,true,10,11,1,41.89704,-87.62173
TA1307000061,3,9,true,42,47,5,41.89745,-87.62873
106,3,9,true,7,5,-2,41.89746,-87.62874
25,3,9,true,1,5,4,41.89751,-87.62354
13034,3,9,true,18,52,34,41.89754,-87.62352
48,3,9,true,16,36,20,41.89772,-87.64302
TA1306000009,3,9,true,70,171,101,41.89772,-87.64299
620,3,9,true,58,21,-37,41.89817,-87.63754
KA1504000103,3,9,true,21,2,-19,41.89842,-87.68659
145,3,9,true,10,20,10,41.89856,-87.62211
15529,3,9,true,35,95,60,41.89858,-87.62206
140,3,9,true,6,23,17,41.89895,-87.6299
TA1307000128,3,9,true,34,52,18,41.89896,-87.6299
657,3,9,true,25,11,-14,41.89918,-87.6722
KA1504000117,3,9,true,9,6,-3,41.89936,-87.64848
13248,3,9,true,22,23,1,41.89964,-87.66788
46,3,9,true,5,3,-2,41.89994,-87.63444
TA1306000011,3,9,true,23,17,-6,41.89994,-87.63443
KA1504000116,3,9,true,22,21,-1,41.90023,-87.64299
364,3,9,true,1,5,4,41.90023,-87.64299
17660,3,9,true,11,11,0,41.90036,-87.69671
622,3,9,true,5,2,-3,41.90037,-87.69671
29,3,9,true,7,3,-4,41.90069,-87.66259
13290,3,9,true,22,29,7,41.90069,-87.66259
13042,3,9,true,55,124,69,41.90097,-87.62377
85,3,9,true,11,19,8,41.90098,-87.62375
183,3,9,true,5,4,-1,41.90133,-87.67744
TA1307000070,3,9,true,24,4,-20,41.90133,-87.67742
KA1504000133,3,9,true,41,42,1,41.90234,-87.62773
172,3,9,true,11,12,1,41.90236,-87.62774
15654,3,9,true,2,2,0,41.90271,-87.70923
305,3,9,true,2,7,5,41.9028,-87.69005
13241,3,9,true,11,26,15,41.9029,-87.68731
176,3,9,true,17,18,1,41.90291,-87.63141
TA1306000006,3,9,true,14,8,-6,41.90292,-87.63772
TA1307000039,3,9,true,90,70,-20,41.90294,-87.63137
658,3,9,true,14,27,13,41.903,-87.6838
13256,3,9,true,9,6,-3,41.90302,-87.69749
216,3,9,true,4,2,-2,41.90302,-87.69749
TA1305000034,3,9,true,20,13,-7,41.90313,-87.67391
17,3,9,true,2,5,3,41.90313,-87.67391
182,3,9,true,22,11,-11,41.90317,-87.63442
KA1504000135,3,9,true,69,59,-10,41.90319,-87.63439
13136,3,9,true,49,17,-32,41.90326,-87.67845
210,3,9,true,15,11,-4,41.90342,-87.66781
13061,3,9,true,77,58,-19,41.90342,-87.66779
KA1504000079,3,9,true,31,28,-3,41.9035,-87.64334
359,3,9,true,6,4,-2,41.90458,-87.6497
138,3,9,true,4,5,1,41.9046,-87.64057
TA1307000115,3,9,true,21,17,-4,41.9046,-87.64056
291,3,9,true,18,16,-2,41.90672,-87.63494
TA1308000049,3,9,true,37,31,-6,41.90672,-87.6349
KA1504000134,3,9,true,38,25,-13,41.90687,-87.6262
180,3,9,true,2,1,-1,41.90687,-87.62618
13224,3,9,true,28,14,-14,41.90706,-87.66725
333,3,9,true,5,8,3,41.90706,-87.66725
18069,3,9,true,2,18,16,41.90722,-87.65563
TA1307000143,3,9,true,29,2,-27,41.90762,-87.63854
236,3,9,true,3,2,-1,41.90762,-87.63853
61,3,9,true,5,3,-2,41.90764,-87.67254
13221,3,9,true,39,24,-15,41.90765,-87.67254
13245,3,9,true,6,7,1,41.90777,-87.68586
301,3,9,true,20,3,-17,41.90796,-87.63203
TA1309000024,3,9,true,56,29,-27,41.908,-87.63152
69,3,9,true,4,4,0,41.90939,-87.6777
TA1305000041,3,9,true,27,39,12,41.9094,-87.67769
331,3,9,true,76,57,-19,41.90965,-87.64812
15653,3,9,true,5,7,2,41.90979,-87.7053
TA1305000037,3,9,true,36,21,-15,41.91018,-87.67003
27,3,9,true,7,3,-4,41.91019,-87.6435
TA1306000008,3,9,true,24,19,-5,41.9102,-87.6435
16,3,9,true,13,2,-11,41.91035,-87.67008
213,3,9,true,4,3,-1,41.91037,-87.68237
TA1308000005,3,9,true,18,9,-9,41.91042,-87.68238
13258,3,9,true,10,5,-5,41.91043,-87.69718
276,3,9,true,2,2,0,41.91043,-87.69718
13257,3,9,true,19,6,-13,41.91054,-87.68956
13154,3,9,true,38,27,-11,41.91054,-87.65312
20,3,9,true,4,5,1,41.91055,-87.65313
60,3,9,true,9,4,-5,41.91059,-87.64942
13058,3,9,true,35,31,-4,41.91059,-87.64942
TA1307000038,3,9,true,39,30,-9,41.91138,-87.63868
118,3,9,true,8,4,-4,41.91138,-87.63868
LF-005,3,9,true,40,33,-7,41.91172,-87.62681
268,3,9,true,8,6,-2,41.91172,-87.62681
126,3,9,true,7,4,-3,41.91196,-87.63197
13128,3,9,true,19,23,4,41.91197,-87.63197
289,3,9,true,18,13,-5,41.91209,-87.63472
TA1308000050,3,9,true,75,79,4,41.91211,-87.6347
13243,3,9,true,30,22,-8,41.91262,-87.6814
158,3,9,true,7,6,-1,41.91262,-87.6814
TA1309000032,3,9,true,3,4,1,41.91293,-87.66417
TA1306000032,3,9,true,32,23,-9,41.9137,-87.65285
93,3,9,true,6,8,2,41.91371,-87.65285
TA1307000166,3,9,true,37,31,-6,41.91386,-87.64877
224,3,9,true,8,5,-3,41.91386,-87.64877
15655,3,9,true,18,9,-9,41.91401,-87.70514
18017,3,9,true,4,1,-3,41.91416,-87.71676
18067,3,9,true,10,7,-3,41.9146,-87.66796
628,3,9,true,2,2,0,41.9146,-87.66796
TA1306000007,3,9,true,25,10,-15,41.91469,-87.64333
28,3,9,true,4,3,-1,41.91469,-87.64333
13068,3,9,true,17,40,23,41.91554,-87.68703
116,3,9,true,8,5,-3,41.91555,-87.68703
13179,3,9,true,60,79,19,41.9157,-87.63461
141,3,9,true,8,6,-2,41.91571,-87.63461
13133,3,9,true,35,16,-19,41.91598,-87.67733
219,3,9,true,4,1,-3,41.91598,-87.67733
58,3,9,true,5,2,-3,41.91602,-87.66894
TA1305000039,3,9,true,22,14,-8,41.9163,-87.66749
15650,3,9,true,8,9,1,41.91711,-87.71023
15651,3,9,true,13,9,-4,41.91752,-87.70181
507,3,9,true,2,1,-1,41.91752,-87.70181
13266,3,9,true,7,3,-4,41.91774,-87.69142
TA1309000029,3,9,true,7,4,-3,41.9178,-87.68245
309,3,9,true,2,2,0,41.91789,-87.6865
TA1309000006,3,9,true,30,28,-2,41.91809,-87.64375
288,3,9,true,5,6,1,41.91809,-87.64375
223,3,9,true,4,4,0,41.91821,-87.65698
TA1307000163,3,9,true,18,25,7,41.91821,-87.65696
94,3,9,true,27,9,-18,41.91831,-87.6363
13146,3,9,true,67,38,-29,41.91831,-87.63629
13059,3,9,true,47,45,-2,41.91845,-87.65222
113,3,9,true,8,8,0,41.91846,-87.65222
13259,3,9,true,16,5,-11,41.91852,-87.69744
259,3,9,true,5,2,-3,41.91853,-87.69745
310,3,9,true,4,1,-3,41.91984,-87.68083
13192,3,9,true,45,30,-15,41.91995,-87.64884
225,3,9,true,4,5,1,41.91995,-87.64884
13288,3,9,true,12,9,-3,41.92008,-87.67788
13242,3,9,true,11,9,-2,41.92021,-87.69266
222,3,9,true,2,2,0,41.92023,-87.69265
307,3,9,true,4,2,-2,41.92077,-87.66373
TA1309000030,3,9,true,20,25,5,41.92077,-87.66372
290,3,9,true,2,3,1,41.92152,-87.70734
13292,3,9,true,7,3,-4,41.92152,-87.70733
TA1309000033,3,9,true,24,27,3,41.92158,-87.65381
13193,3,9,true,49,44,-5,41.92182,-87.64412
144,3,9,true,7,9,2,41.92182,-87.64411
13191,3,9,true,49,23,-26,41.92217,-87.63891
143,3,9,true,5,5,0,41.92217,-87.63891
327,3,9,true,5,2,-3,41.92225,-87.65783
13084,3,9,true,24,10,-14,41.92268,-87.69715
123,3,9,true,6,2,-4,41.92268,-87.69714
LP-,3,9,true,32,22,-10,41.92396,-87.63584
673,3,9,true,4,5,1,41.92398,-87.63585
KA1504000140,3,9,true,17,14,-3,41.92409,-87.67646
15648,3,9,true,9,3,-6,41.92464,-87.68931
504,3,9,true,1,1,0,41.92464,-87.68931
503,3,9,true,1,1,0,41.92483,-87.71451
KA1504000090,3,9,true,6,1,-5,41.92483,-87.7145
TA1307000001,3,9,true,35,37,2,41.92535,-87.66581
188,3,9,true,5,16,11,41.92536,-87.66581
TA1306000026,3,9,true,49,93,44,41.92558,-87.65842
87,3,9,true,11,9,-2,41.92559,-87.65843
TA1306000016,3,9,true,45,46,1,41.9256,-87.65371
67,3,9,true,4,8,4,41.9256,-87.65371
313,3,9,true,9,11,2,41.9257,-87.64246
TA1309000019,3,9,true,60,28,-32,41.92586,-87.63897
TA1309000058,3,9,true,42,55,13,41.92591,-87.64927
127,3,9,true,13,13,0,41.92592,-87.64927
177,3,9,true,7,6,-1,41.92627,-87.63086
TA1308000001,3,9,true,46,56,10,41.92627,-87.63086
15646,3,9,true,8,4,-4,41.92668,-87.6977
13124,3,9,true,8,10,2,41.92675,-87.63444
302,3,9,true,5,4,-1,41.92859,-87.65421
TA1309000023,3,9,true,19,27,8,41.9287,-87.65383
TA1307000113,3,9,true,15,12,-3,41.92878,-87.66391
190,3,9,true,1,1,0,41.92878,-87.6639
13296,3,9,true,13,7,-6,41.92883,-87.66852
TA1309000059,3,9,true,31,17,-14,41.92889,-87.65898
343,3,9,true,7,1,-6,41.92889,-87.65898
349,3,9,true,10,4,-6,41.92915,-87.6491
TA1309000061,3,9,true,28,24,-4,41.92915,-87.64909
258,3,9,true,7,4,-3,41.92946,-87.68417
TA1308000031,3,9,true,8,9,1,41.92946,-87.68417
TA1305000014,3,9,true,77,49,-28,41.92956,-87.64313
340,3,9,true,19,11,-8,41.92956,-87.64313
260,3,9,true,5,4,-1,41.92958,-87.70791
13085,3,9,true,9,15,6,41.92958,-87.70789
15643,3,9,true,4,2,-2,41.93057,-87.7238
TA1307000142,3,9,true,47,30,-17,41.93125,-87.64432
220,3,9,true,6,2,-4,41.93125,-87.64431
13276,3,9,true,65,33,-32,41.93132,-87.63874
324,3,9,true,14,11,-3,41.93173,-87.64179
501,3,9,true,1,1,0,41.93191,-87.70121
15645,3,9,true,3,5,2,41.93191,-87.70121
163,3,9,true,1,5,4,41.93191,-87.67784
13271,3,9,true,9,18,9,41.93192,-87.67784
152,3,9,true,4,9,5,41.93221,-87.65864
TA1307000064,3,9,true,34,56,22,41.93222,-87.65864
TA1306000014,3,9,true,43,32,-11,41.93242,-87.65271
13,3,9,true,5,7,2,41.93242,-87.65271
TA1309000039,3,9,true,61,25,-36,41.93258,-87.63642
329,3,9,true,11,9,-2,41.93258,-87.63642
13294,3,9,true,12,14,2,41.9326,-87.66595
319,3,9,true,4,4,0,41.93292,-87.67217
TA1309000036,3,9,true,37,33,-4,41.93313,-87.64776
332,3,9,true,6,7,1,41.93313,-87.64776
15644,3,9,true,3,1,-2,41.93534,-87.71687
500,3,9,true,1,1,0,41.93534,-87.71686
TA1307000006,3,9,true,22,40,18,41.93571,-87.6636
153,3,9,true,4,6,2,41.93575,-87.66364
13268,3,9,true,27,11,-16,41.93588,-87.67843
250,3,9,true,2,4,2,41.93609,-87.66984
13269,3,9,true,17,9,-8,41.93609,-87.66983
TA1307000052,3,9,true,36,40,4,41.93628,-87.65266
115,3,9,true,7,18,11,41.93628,-87.65266
156,3,9,true,4,10,6,41.9365,-87.64756
TA1307000136,3,9,true,40,53,13,41.9365,-87.64755
TA1307000041,3,9,true,56,30,-26,41.93669,-87.63683
157,3,9,true,11,4,-7,41.9367,-87.63683
13137,3,9,true,100,59,-41,41.9376,-87.6441
300,3,9,true,28,22,-6,41.93761,-87.6441
15642,3,9,true,2,2,0,41.93843,-87.69801
154,3,9,true,2,3,1,41.93912,-87.66384
KA17018068,3,9,true,10,4,-6,41.93935,-87.68327
TA1309000042,3,9,true,17,18,1,41.93937,-87.66836
131,3,9,true,6,9,3,41.93937,-87.66835
KA150400009X,3,9,true,3,5,2,41.9394,-87.71159
497,3,9,true,1,1,0,41.93941,-87.71159
13229,3,9,true,31,20,-11,41.93946,-87.66376
226,3,9,true,4,1,-3,41.93972,-87.65886
TA1308000019,3,9,true,20,18,-2,41.93973,-87.65886
13277,3,9,true,46,29,-17,41.9401,-87.64546
296,3,9,true,4,12,8,41.9401,-87.64546
TA1307000134,3,9,true,31,55,24,41.94016,-87.65303
117,3,9,true,4,7,3,41.94016,-87.65302
228,3,9,true,1,1,0,41.94058,-87.67854
13143,3,9,true,8,7,-1,41.94059,-87.67853
334,3,9,true,6,5,-1,41.94076,-87.63919
TA1309000049,3,9,true,55,26,-29,41.94077,-87.63919
15634,3,9,true,6,6,0,41.94304,-87.68729
TA1307000138,3,9,true,35,40,5,41.94334,-87.67094
230,3,9,true,8,11,3,41.94335,-87.67093
13144,3,9,true,4,20,16,41.9434,-87.67964
TA1309000025,3,9,true,47,32,-15,41.94368,-87.64894
299,3,9,true,8,8,0,41.94368,-87.64894
229,3,9,true,12,2,-10,41.94372,-87.66401
13071,3,9,true,33,43,10,41.94373,-87.66401
632,3,9,true,25,39,14,41.94453,-87.6547
303,3,9,true,11,2,-9,41.94522,-87.64702
490,3,9,true,1,1,0,41.94523,-87.70664
15631,3,9,true,2,8,6,41.94524,-87.70665
13278,3,9,true,49,49,0,41.94553,-87.64644
330,3,9,true,1,1,0,41.94618,-87.67331
TA1309000050,3,9,true,5,6,1,41.94618,-87.67331
15632,3,9,true,2,14,12,41.94664,-87.69463
KA1504000143,3,9,true,10,13,3,41.94664,-87.68337
227,3,9,true,6,10,4,41.94813,-87.66397
13235,3,9,true,53,61,8,41.94814,-87.66396
304,3,9,true,17,11,-6,41.94878,-87.64922
13253,3,9,true,17,8,-9,41.9488,-87.67527
257,3,9,true,3,2,-1,41.9488,-87.67527
13325,3,9,true,53,81,28,41.94907,-87.64863
114,3,9,true,9,3,-6,41.94935,-87.65451
TA1307000126,3,9,true,35,27,-8,41.94936,-87.65451
232,3,9,true,9,1,-8,41.94943,-87.64645
TA1307000150,3,9,true,49,26,-23,41.94945,-87.64646
18016,3,9,true,3,2,-1,41.94993,-87.71395
347,3,9,true,3,2,-1,41.95068,-87.6687
13319,3,9,true,27,26,-1,41.95069,-87.6687
TA1307000127,3,9,true,46,33,-13,41.9508,-87.65918
15628,3,9,true,9,8,-1,41.95216,-87.69806
318,3,9,true,3,3,0,41.95254,-87.6735
13323,3,9,true,55,20,-35,41.95282,-87.65
256,3,9,true,16,11,-5,41.95282,-87.65
15624,3,9,true,1,1,0,41.95339,-87.73199
314,3,9,true,7,5,-2,41.9535,-87.69199
KA1504000139,3,9,true,1,2,1,41.954,-87.71909
484,3,9,true,1,1,0,41.954,-87.71907
TA1309000043,3,9,true,26,12,-14,41.95417,-87.66434
240,3,9,true,8,10,2,41.95424,-87.65441
13063,3,9,true,24,32,8,41.95424,-87.65441
KA1504000158,3,9,true,4,2,-2,41.95432,-87.68607
254,3,9,true,14,1,-13,41.95438,-87.64806
TA1308000022,3,9,true,28,28,0,41.95438,-87.64805
16991,3,9,true,1,4,3,41.95448,-87.7496
TA1307000149,3,9,true,17,28,11,41.95467,-87.67392
298,3,9,true,2,2,0,41.95601,-87.68021
TA1309000026,3,9,true,11,14,3,41.95601,-87.6802
13249,3,9,true,6,3,-3,41.95606,-87.66885
312,3,9,true,2,10,8,41.95637,-87.6563
TA1308000047,3,9,true,9,7,-2,41.95709,-87.6642
292,3,9,true,2,1,-1,41.95709,-87.6642
13379,3,9,true,29,31,2,41.95786,-87.6495
TA1309000018,3,9,true,32,25,-7,41.95791,-87.67357
316,3,9,true,1,1,0,41.95841,-87.69401
306,3,9,true,7,1,-6,41.9585,-87.655
TA1309000027,3,9,true,41,25,-16,41.9585,-87.65499
13389,3,9,true,41,23,-18,41.961,-87.64958
245,3,9,true,13,5,-8,41.96101,-87.64958
15621,3,9,true,4,3,-1,41.96103,-87.70586
15622,3,9,true,12,7,-5,41.96108,-87.69544
481,3,9,true,2,1,-1,41.96108,-87.69544
KA1504000097,3,9,true,7,3,-4,41.96116,-87.71658
238,3,9,true,3,6,3,41.96141,-87.6762
TA1307000144,3,9,true,26,21,-5,41.96142,-87.6762
TA1309000021,3,9,true,3,11,8,41.9615,-87.6714
15623,3,9,true,21,6,-15,41.96154,-87.69117
234,3,9,true,3,5,2,41.96158,-87.6661
KA1503000022,3,9,true,16,20,4,41.96158,-87.66609
231,3,9,true,7,8,1,41.96163,-87.65464
TA1307000107,3,9,true,34,23,-11,41.96164,-87.65464
TA1307000156,3,9,true,34,12,-22,41.96301,-87.68479
243,3,9,true,2,3,1,41.96302,-87.68479
TA1309000012,3,9,true,8,10,2,41.96325,-87.67928
249,3,9,true,2,1,-1,41.96398,-87.63818
TA1308000012,3,9,true,20,20,0,41.96398,-87.63818
293,3,9,true,5,3,-2,41.96521,-87.65822
13074,3,9,true,22,25,3,41.96521,-87.6582
639,3,9,true,17,12,-5,41.96584,-87.64538
KA1504000127,3,9,true,13,5,-8,41.96587,-87.70083
KA1504000093,3,9,true,3,5,2,41.96587,-87.69365
478,3,9,true,4,3,-1,41.96587,-87.69364
TA1307000140,3,9,true,22,8,-14,41.96643,-87.68865
239,3,9,true,2,1,-1,41.9665,-87.68843
326,3,9,true,4,4,0,41.96665,-87.67113
KA1504000126,3,9,true,1,1,0,41.96668,-87.70807
TA1309000014,3,9,true,35,18,-17,41.96709,-87.66744
242,3,9,true,2,6,4,41.9671,-87.67904
TA1307000158,3,9,true,12,39,27,41.9671,-87.67904
TA1307000119,3,9,true,22,13,-9,41.96796,-87.65
251,3,9,true,3,5,2,41.96796,-87.65
15615,3,9,true,5,11,6,41.96835,-87.71183
323,3,9,true,1,2,1,41.96869,-87.66034
TA1308000021,3,9,true,9,9,0,41.96883,-87.65765
KA1504000080,3,9,true,11,7,-4,41.96887,-87.69609
TA1309000015,3,9,true,8,6,-2,41.96889,-87.68401
344,3,9,true,3,7,4,41.9691,-87.67423
TA1309000066,3,9,true,23,27,4,41.9691,-87.67423
TA1309000041,3,9,true,12,12,0,41.96951,-87.65471
465,3,9,true,5,2,-3,41.97161,-87.65016
KA1504000171,3,9,true,16,20,4,41.97161,-87.65016
325,3,9,true,5,2,-3,41.9728,-87.67186
TA1309000035,3,9,true,19,14,-5,41.97335,-87.66785
295,3,9,true,3,2,-1,41.97378,-87.65972
13108,3,9,true,22,12,-10,41.97379,-87.65971
KA1504000078,3,9,true,2,10,8,41.97491,-87.69258
472,3,9,true,1,1,0,41.97492,-87.69262
KA1504000149,3,9,true,9,3,-6,41.97562,-87.67945
464,3,9,true,2,1,-1,41.97562,-87.67945
471,3,9,true,2,3,1,41.97564,-87.70143
KA1504000160,3,9,true,6,10,4,41.97564,-87.70143
470,3,9,true,1,1,0,41.97567,-87.70927
KA1504000128,3,9,true,1,4,3,41.97567,-87.70927
463,3,9,true,2,5,3,41.978,-87.66805
KA1504000146,3,9,true,18,35,17,41.978,-87.66805
13109,3,9,true,32,18,-14,41.97835,-87.65976
294,3,9,true,3,3,0,41.97835,-87.65976
KA1504000147,3,9,true,6,4,-2,41.97976,-87.67754
655,3,9,true,5,9,4,41.97987,-87.68194
KA1504000161,3,9,true,2,5,3,41.98038,-87.71612
KA1504000167,3,9,true,4,5,1,41.98206,-87.70895
460,3,9,true,3,3,0,41.98358,-87.66916
KA1504000151,3,9,true,15,20,5,41.98359,-87.66916
15585,3,9,true,4,1,-3,41.98367,-87.69642
KA1504000152,3,9,true,54,34,-20,41.98403,-87.65231
459,3,9,true,14,10,-4,41.98403,-87.65231
15578,3,9,true,17,20,3,41.98405,-87.66027
15575,3,9,true,21,17,-4,41.98975,-87.66014
458,3,9,true,2,4,2,41.98975,-87.66013
KA1504000130,3,9,true,1,4,3,41.99024,-87.69338
457,3,9,true,4,1,-3,41.99052,-87.66982
KA1504000148,3,9,true,17,2,-15,41.99086,-87.66971
456,3,9,true,1,1,0,41.99117,-87.68359
KA1504000155,3,9,true,3,1,-2,41.99118,-87.68359
KA1504000129,3,9,true,2,4,2,41.99417,-87.68945
15571,3,9,true,43,17,-26,41.99478,-87.66028
454,3,9,true,8,3,-5,41.99478,-87.66027
KA1504000156,3,9,true,31,14,-17,41.99925,-87.67137
453,3,9,true,2,1,-1,41.99925,-87.67137
RP-009,3,9,true,15,16,1,42.00107,-87.66122
451,3,9,true,3,4,1,42.00108,-87.66123
449,3,9,true,2,1,-1,42.00446,-87.67241
RP-008,3,9,true,15,14,-1,42.00446,-87.6724
448,3,9,true,2,1,-1,42.00456,-87.68064
660,3,9,true,5,7,2,42.00458,-87.66143
KA1504000175,3,9,true,18,24,6,42.00797,-87.66549
447,3,9,true,6,3,-3,42.00797,-87.66548
RP-005,3,9,true,1,1,0,42.0086,-87.69047
432,3,9,true,1,2,1,42.00907,-87.67423
KA1504000162,3,9,true,8,3,-5,42.00907,-87.67422
KA1504000159,3,9,true,10,2,-8,42.01059,-87.66241
RP-007,3,9,true,5,5,0,42.01256,-87.67431
525,3,9,true,6,2,-4,42.01272,-87.66605
520,3,9,true,14,12,-2,42.01597,-87.66859
515,3,9,true,4,13,9,42.01915,-87.67356
514,3,9,true,1,3,2,42.01927,-87.68452
16806,3,9,true,2,2,0,42.01953,-87.66955
523,3,9,true,16,3,-13,42.02089,-87.66505
662,3,9,true,2,1,-1,42.02354,-87.69961
598,3,9,true,6,2,-4,42.02578,-87.68411
597,3,9,true,6,2,-4,42.03256,-87.67914
E002,3,9,true,17,8,-9,42.03256,-87.67912
625,3,9,true,4,3,-1,42.04163,-87.6808
596,3,9,true,28,8,-20,42.04822,-87.68348
E008,3,9,true,6,10,4,42.05049,-87.67782
605,3,9,true,1,43,42,42.05294,-87.67342
661,3,9,true,12,7,-5,42.05704,-87.68657
604,3,9,true,4,56,52,42.05824,-87.67744
E006,3,9,true,2,1,-1,42.06367,-87.69871
E007,3,9,true,2,3,1,42.06431,-87.68615
E014,3,9,true,4,2,-2,42.06483,-87.71531
20214,3,17,false,1,1,0,41.65191,-87.53961
20218,3,17,false,3,2,-1,41.68103,-87.53798
20232,3,17,false,5,2,-3,41.68588,-87.57378
20203,3,17,false,2,2,0,41.69131,-87.71286
20127,3,17,false,1,3,2,41.69228,-87.64268
20108,3,17,false,2,1,-1,41.69921,-87.66888
20126,3,17,false,2,1,-1,41.7,-87.65
20109,3,17,false,1,1,0,41.70018,-87.6123
20123,3,17,false,1,2,1,41.70461,-87.68115
20125,3,17,false,3,1,-2,41.70517,-87.64242
20130,3,17,false,3,2,-1,41.70534,-87.62903
20107,3,17,false,2,2,0,41.7122,-87.66772
20225,3,17,false,3,1,-2,41.71331,-87.55119
20226,3,17,false,1,1,0,41.71336,-87.56586
20224,3,17,false,1,4,3,41.71371,-87.53083
20238,3,17,false,4,2,-2,41.7187,-87.597
20106,3,17,false,2,2,0,41.71897,-87.60833
20105,3,17,false,1,1,0,41.71972,-87.6429
20104,3,17,false,2,6,4,41.72171,-87.62283
20119,3,17,false,2,2,0,41.72682,-87.6543
20118,3,17,false,3,1,-2,41.72762,-87.63487
20103,3,17,false,2,2,0,41.7281,-87.66757
20242,3,17,false,1,3,2,41.7282,-87.54962
20110,3,17,false,1,3,2,41.72933,-87.61076
595,3,17,false,2,4,2,41.73663,-87.62264
20231,3,17,false,2,2,0,41.7368,-87.58282
20101,3,17,false,1,3,2,41.73785,-87.64489
20121,3,17,false,2,1,-1,41.74152,-87.65842
585,3,17,false,1,4,3,41.74344,-87.60485
583,3,17,false,2,1,-1,41.74656,-87.58599
573,3,17,false,1,1,0,41.75079,-87.62444
574,3,17,false,1,1,0,41.75095,-87.61379
576,3,17,false,1,1,0,41.75129,-87.59752
KA1503000019,3,17,false,3,4,1,41.75867,-87.5869
KA1503000020,3,17,false,5,3,-2,41.76223,-87.55923
15599,3,17,false,1,1,0,41.76551,-87.61693
KA1503000002,3,17,false,7,8,1,41.76641,-87.5657
KA1503000045,3,17,false,4,5,1,41.76649,-87.58647
11,3,17,false,1,3,2,41.76662,-87.57646
650,3,17,false,1,3,2,41.7689,-87.63586
KA1503000023,3,17,false,2,4,2,41.77346,-87.58534
KA1503000030,3,17,false,2,4,2,41.77352,-87.57722
KA1503000029,3,17,false,14,4,-10,41.77364,-87.56747
KA1503000031,3,17,false,1,3,2,41.77373,-87.60564
KA1503000021,3,17,false,3,4,1,41.77888,-87.58665
KA1503000025,3,17,false,2,1,-1,41.78008,-87.62977
KA1503000053,3,17,false,2,2,0,41.78009,-87.61595
KA1503000046,3,17,false,2,2,0,41.78041,-87.59141
653,3,17,false,2,7,5,41.78059,-87.58491
KA1503000054,3,17,false,4,5,1,41.78061,-87.60582
15491,3,17,false,22,13,-9,41.78096,-87.57624
101,3,17,false,4,2,-2,41.78105,-87.57611
KA1503000033,3,17,false,1,2,1,41.78411,-87.61329
426,3,17,false,7,10,3,41.7851,-87.60108
KA1503000014,3,17,false,21,34,13,41.7851,-87.60108
KA1503000070,3,17,false,10,7,-3,41.78794,-87.58831
328,3,17,false,3,2,-1,41.78872,-87.6013
TA1309000011,3,17,false,16,3,-13,41.78873,-87.60131
KA1503000071,3,17,false,42,19,-23,41.79148,-87.59988
423,3,17,false,6,6,0,41.79148,-87.59988
422,3,17,false,1,1,0,41.79156,-87.60785
KA1503000075,3,17,false,3,3,0,41.79156,-87.60785
KA1503000074,3,17,false,63,13,-50,41.79174,-87.58395
KA1503000011,3,17,false,1,1,0,41.79296,-87.645
TA1309000063,3,17,false,20,31,11,41.79325,-87.5878
345,3,17,false,11,11,0,41.79326,-87.5878
559,3,17,false,1,1,0,41.79423,-87.65509
420,3,17,false,5,7,2,41.79429,-87.60145
KA1504000076,3,17,false,26,12,-14,41.7943,-87.60145
TA1307000160,3,17,false,7,9,2,41.79485,-87.61873
KA1503000013,3,17,false,1,2,1,41.79498,-87.63312
247,3,17,false,11,7,-4,41.79522,-87.58077
TA1308000009,3,17,false,71,78,7,41.79522,-87.58075
TA1307000164,3,17,false,29,9,-20,41.79527,-87.59647
248,3,17,false,1,7,6,41.79528,-87.59647
646,3,17,false,2,4,2,41.79663,-87.62592
KA1503000052,3,17,false,15,17,2,41.79935,-87.60097
418,3,17,false,4,2,-2,41.79936,-87.60097
419,3,17,false,3,5,2,41.79952,-87.58643
KA1503000059,3,17,false,25,32,7,41.79952,-87.58643
TA1309000037,3,17,false,35,32,-3,41.79957,-87.59474
15470,3,17,false,2,3,1,41.80228,-87.61807
417,3,17,false,7,3,-4,41.80242,-87.5869
KA1503000007,3,17,false,24,33,9,41.80242,-87.58689
13398,3,17,false,18,14,-4,41.80256,-87.59035
121,3,17,false,3,8,5,41.80256,-87.59035
TA1309000067,3,17,false,8,13,5,41.80303,-87.60661
322,3,17,false,8,7,-1,41.80321,-87.59849
594,3,17,false,3,1,-2,41.80567,-87.68337
416,3,17,false,2,1,-1,41.80578,-87.59247
KA1503000069,3,17,false,1,4,3,41.80579,-87.59247
KA1503000051,3,17,false,5,3,-2,41.80815,-87.64563
KA1504000091,3,17,false,3,1,-2,41.80823,-87.6772
16937,3,17,false,1,3,2,41.80887,-87.66453
KA1503000009,3,17,false,2,1,-1,41.80932,-87.63346
TA1308000035,3,17,false,16,11,-5,41.80944,-87.59188
267,3,17,false,3,6,3,41.80944,-87.59188
252,3,17,false,3,3,0,41.80982,-87.59936
TA1308000002,3,17,false,10,7,-3,41.80983,-87.59937
TA1308000007,3,17,false,7,9,2,41.80984,-87.61628
TA1309000053,3,17,false,10,8,-2,41.80985,-87.60675
352,3,17,false,3,2,-1,41.8137,-87.63448
549,3,17,false,1,1,0,41.81401,-87.66662
413,3,17,false,1,2,1,41.81408,-87.59701
KA1503000065,3,17,false,9,9,0,41.81409,-87.59701
271,3,17,false,1,1,0,41.81648,-87.60659
TA1308000023,3,17,false,8,7,-1,41.81649,-87.60659
KA1503000027,3,17,false,10,7,-3,41.81666,-87.61942
13083,3,17,false,4,2,-2,41.82167,-87.62153
265,3,17,false,2,2,0,41.82297,-87.6071
TA1308000038,3,17,false,15,15,0,41.82298,-87.6071
546,3,17,false,4,4,0,41.82319,-87.67661
13420,3,17,false,11,8,-3,41.82459,-87.61678
18022,3,17,false,6,3,-3,41.82672,-87.68315
TA1307000161,3,17,false,4,3,-1,41.82707,-87.64572
KA1503000068,3,17,false,4,2,-2,41.82878,-87.68062
KA1503000066,3,17,false,3,6,3,41.83011,-87.67031
TA1308000045,3,17,false,8,5,-3,41.83062,-87.64129
TA1308000043,3,17,false,8,10,2,41.83066,-87.64715
15446,3,17,false,3,1,-2,41.83068,-87.65603
KA1503000005,3,17,false,3,9,6,41.83079,-87.6325
184,3,17,false,3,1,-2,41.83104,-87.62684
TA1307000129,3,17,false,10,7,-3,41.83104,-87.62683
406,3,17,false,7,8,1,41.83127,-87.6088
KA1503000004,3,17,false,21,24,3,41.83127,-87.6088
13345,3,17,false,4,13,9,41.83138,-87.61803
15445,3,17,false,7,3,-4,41.83453,-87.63183
13216,3,17,false,10,9,-1,41.83473,-87.62581
148,3,17,false,5,2,-3,41.83474,-87.62581
149,3,17,false,3,1,-2,41.83486,-87.61791
13217,3,17,false,8,6,-2,41.83488,-87.61792
13215,3,17,false,14,11,-3,41.83634,-87.6135
263,3,17,false,7,1,-6,41.8364,-87.61348
TA1308000046,3,17,false,10,5,-5,41.83779,-87.65115
339,3,17,false,2,5,3,41.83817,-87.64523
TA1309000055,3,17,false,15,11,-4,41.8382,-87.64514
KA1503000038,3,17,false,7,5,-2,41.83845,-87.6354
TA1307000048,3,17,false,62,47,-15,41.83855,-87.60821
150,3,17,false,9,6,-3,41.83855,-87.60821
272,3,17,false,3,1,-2,41.83882,-87.62186
TA1308000036,3,17,false,14,6,-8,41.83883,-87.62186
KA1503000040,3,17,false,5,11,6,41.84164,-87.65744
237,3,17,false,3,2,-1,41.84204,-87.61697
TA1307000139,3,17,false,16,17,1,41.84205,-87.61698
15443,3,17,false,2,17,15,41.84275,-87.63549
401,3,17,false,1,8,7,41.84276,-87.63549
TA1307000153,3,17,false,3,6,3,41.84358,-87.64538
KA1504000110,3,17,false,2,2,0,41.84454,-87.71596
TA1307000005,3,17,false,11,10,-1,41.84569,-87.6225
TA1308000013,3,17,false,7,3,-4,41.84719,-87.64681
KA1504000086,3,17,false,1,2,1,41.8482,-87.70542
TA1307000066,3,17,false,3,4,1,41.8492,-87.67564
TA1308000014,3,17,false,2,5,3,41.84953,-87.64059
TA1308000026,3,17,false,12,9,-3,41.85008,-87.63214
TA1305000004,3,17,false,6,12,6,41.8514,-87.61884
42,3,17,false,2,2,0,41.85261,-87.62653
TA1305000001,3,17,false,15,25,10,41.85262,-87.6265
13075,3,17,false,28,66,38,41.8531,-87.63192
15686,3,17,false,4,4,0,41.85354,-87.70507
13162,3,17,false,9,13,4,41.85378,-87.64659
13096,3,17,false,5,5,0,41.8538,-87.69577
15685,3,17,false,2,4,2,41.85399,-87.71511
13091,3,17,false,2,7,5,41.85409,-87.68585
370,3,17,false,2,2,0,41.85415,-87.61917
15546,3,17,false,12,16,4,41.85416,-87.61916
13307,3,17,false,7,8,1,41.85489,-87.66359
124,3,17,false,1,5,4,41.85492,-87.67609
13089,3,17,false,12,22,10,41.85497,-87.67567
13331,3,17,false,16,7,-9,41.85515,-87.65414
4,3,17,false,3,6,3,41.85627,-87.61334
15545,3,17,false,49,60,11,41.85627,-87.61334
SL-013,3,17,false,18,12,-6,41.85659,-87.62755
218,3,17,false,2,2,0,41.85679,-87.63387
SL-006,3,17,false,11,8,-3,41.8568,-87.63387
129,3,17,false,4,4,0,41.85752,-87.66158
202,3,17,false,3,5,2,41.85752,-87.64621
13135,3,17,false,31,23,-8,41.85753,-87.66157
338,3,17,false,5,5,0,41.85758,-87.61956
13102,3,17,false,39,12,-27,41.85762,-87.61942
13150,3,17,false,42,27,-15,41.85783,-87.62455
273,3,17,false,5,7,2,41.85783,-87.62455
13099,3,17,false,16,22,6,41.85784,-87.64627
205,3,17,false,3,3,0,41.8579,-87.6687
TA1307000159,3,17,false,12,21,9,41.8579,-87.6687
TA1307000044,3,17,false,20,13,-7,41.85794,-87.64083
14,3,17,false,3,5,2,41.85808,-87.65109
13163,3,17,false,26,17,-9,41.85808,-87.65108
13164,3,17,false,22,24,2,41.85818,-87.65648
15,3,17,false,2,5,3,41.85819,-87.65648
SL-012,3,17,false,32,38,6,41.86038,-87.62581
72,3,17,false,3,3,0,41.86039,-87.62581
13304,3,17,false,15,13,-2,41.86126,-87.65659
KA1504000109,3,17,false,10,1,-9,41.86192,-87.69347
TA1306000002,3,17,false,6,15,9,41.86238,-87.65108
TA1307000124,3,17,false,69,46,-23,41.86411,-87.62372
168,3,17,false,12,4,-8,41.86415,-87.62372
282,3,17,false,1,6,5,41.86487,-87.64708
TA1309000001,3,17,false,24,24,0,41.86488,-87.64708
13165,3,17,false,5,5,0,41.86505,-87.65697
13354,3,17,false,7,4,-3,41.86524,-87.66651
13029,3,17,false,60,28,-32,41.86531,-87.6179
97,3,17,false,5,1,-4,41.86531,-87.6179
341,3,17,false,10,6,-4,41.86608,-87.60733
13431,3,17,false,89,85,-4,41.8661,-87.60728
435,3,17,false,3,1,-2,41.8665,-87.70649
15682,3,17,false,1,2,1,41.86651,-87.70649
KA1504000101,3,17,false,8,6,-2,41.86651,-87.68466
KA1504000102,3,17,false,2,5,3,41.86664,-87.69453
WL-008,3,17,false,23,31,8,41.86712,-87.64108
57,3,17,false,7,5,-2,41.86712,-87.64107
TA1305000002,3,17,false,95,100,5,41.86721,-87.62597
59,3,17,false,5,20,15,41.86721,-87.62597
15544,3,17,false,208,167,-41,41.86723,-87.61536
3,3,17,false,11,8,-3,41.86723,-87.61536
TA1305000017,3,17,false,15,7,-8,41.86734,-87.64863
626,3,17,false,6,1,-5,41.86749,-87.63219
KA1706005007,3,17,false,27,30,3,41.86749,-87.63219
SL-005,3,17,false,200,150,-50,41.8679,-87.62304
255,3,17,false,29,24,-5,41.86791,-87.62304
644,3,17,false,9,9,0,41.86859,-87.68625
19,3,17,false,5,5,0,41.86892,-87.65913
13139,3,17,false,19,21,2,41.86893,-87.65913
13285,3,17,false,15,6,-9,41.86928,-87.67372
13160,3,17,false,34,31,-3,41.86947,-87.65548
22,3,17,false,4,2,-2,41.86947,-87.65548
414,3,17,false,7,7,0,41.87023,-87.63947
15550,3,17,false,19,33,14,41.87024,-87.63947
TA1309000010,3,17,false,75,66,-9,41.87074,-87.62574
SL-009,3,17,false,35,44,9,41.87081,-87.63121
TA1309000064,3,17,false,20,13,-7,41.87127,-87.67369
15542,3,17,false,4,4,0,41.87146,-87.64095
TA1307000130,3,17,false,23,15,-8,41.87178,-87.65103
241,3,17,false,1,4,3,41.8718,-87.65102
108,3,17,false,1,1,0,41.87183,-87.64664
TA1307000121,3,17,false,20,14,-6,41.87184,-87.64664
41,3,17,false,22,33,11,41.87209,-87.62957
SL-008,3,17,false,113,99,-14,41.87209,-87.62956
16912,3,17,false,1,1,0,41.87213,-87.74664
13332,3,17,false,20,31,11,41.87219,-87.6615
394,3,17,false,10,7,-3,41.87226,-87.63484
175,3,17,false,5,8,3,41.87255,-87.63359
SL-011,3,17,false,80,83,3,41.87256,-87.63356
623,3,17,false,74,112,38,41.87272,-87.62399
KA1504000104,3,17,false,37,10,-27,41.87296,-87.66912
383,3,17,false,4,1,-3,41.87297,-87.66912
16915,3,17,false,1,1,0,41.873,-87.7645
320,3,17,false,3,3,0,41.87327,-87.66402
KA1504000082,3,17,false,1,4,3,41.87361,-87.70488
5,3,17,false,4,6,2,41.87403,-87.6277
SL-007,3,17,false,42,25,-17,41.87404,-87.6277
13326,3,17,false,12,3,-9,41.87425,-87.63958
321,3,17,false,20,15,-5,41.87427,-87.63257
TA1306000025,3,17,false,17,5,-12,41.87464,-87.65703
15668,3,17,false,16,7,-9,41.87471,-87.68642
13028,3,17,false,27,12,-15,41.87475,-87.64981
109,3,17,false,3,4,1,41.87475,-87.64981
13081,3,17,false,12,6,-6,41.87501,-87.67326
89,3,17,false,6,6,0,41.87501,-87.6331
SL-010,3,17,false,16,22,6,41.87501,-87.63309
15541,3,17,false,83,100,17,41.8758,-87.62086
13037,3,17,false,16,12,-4,41.87588,-87.64078
50,3,17,false,4,9,5,41.87592,-87.6307
TA1305000009,3,17,false,37,17,-20,41.87593,-87.63068
TA1305000010,3,17,false,38,26,-12,41.87623,-87.62444
45,3,17,false,2,1,-1,41.87623,-87.62444
624,3,17,false,53,56,3,41.87626,-87.62923
2,3,17,false,10,5,-5,41.87649,-87.62051
33,3,17,false,4,6,2,41.87715,-87.62786
TA1305000035,3,17,false,43,33,-10,41.87716,-87.62787
13138,3,17,false,25,8,-17,41.87723,-87.63941
75,3,17,false,7,1,-6,41.87724,-87.63937
631,3,17,false,9,6,-3,41.87761,-87.6739
16913,3,17,false,2,1,-1,41.87762,-87.7454
15539,3,17,false,48,26,-22,41.87763,-87.64405
13158,3,17,false,78,50,-28,41.87764,-87.64957
134,3,17,false,9,7,-2,41.87764,-87.64954
21,3,17,false,6,8,2,41.87773,-87.6548
13157,3,17,false,33,43,10,41.87773,-87.6548
TA1305000025,3,17,false,112,72,-40,41.87773,-87.63528
36,3,17,false,12,3,-9,41.87776,-87.63525
284,3,17,false,11,11,0,41.87784,-87.62408
TA1309000002,3,17,false,46,66,20,41.87784,-87.62408
146,3,17,false,1,5,4,41.87794,-87.66201
13206,3,17,false,16,25,9,41.87794,-87.66201
283,3,17,false,16,4,-12,41.87809,-87.63183
TA1309000004,3,17,false,49,16,-33,41.87811,-87.63184
107,3,17,false,3,4,1,41.87822,-87.644
638,3,17,false,76,22,-54,41.87827,-87.64078
TA1305000005,3,17,false,43,20,-23,41.87924,-87.62975
286,3,17,false,4,1,-3,41.8793,-87.6355
13011,3,17,false,126,51,-75,41.87931,-87.63993
TA1309000008,3,17,false,29,42,13,41.87933,-87.6355
192,3,17,false,21,4,-17,41.87935,-87.63997
KA1503000034,3,17,false,20,9,-11,41.87938,-87.63197
39,3,17,false,8,6,-2,41.87948,-87.62571
KA1503000015,3,17,false,66,33,-33,41.87948,-87.6257
15667,3,17,false,4,11,7,41.8798,-87.68609
287,3,17,false,19,1,-18,41.88017,-87.63527
TA1309000007,3,17,false,78,14,-64,41.88022,-87.63526
WL-011,3,17,false,40,22,-18,41.88034,-87.64273
73,3,17,false,5,4,-1,41.8804,-87.64273
80,3,17,false,3,5,2,41.88042,-87.65556
13156,3,17,false,49,36,-13,41.88042,-87.65554
13300,3,17,false,232,231,-1,41.88097,-87.61675
76,3,17,false,22,30,8,41.88098,-87.61675
13008,3,17,false,246,228,-18,41.88105,-87.62408
90,3,17,false,19,12,-7,41.88107,-87.62409
49,3,17,false,17,6,-11,41.88116,-87.62963
TA1305000006,3,17,false,70,45,-25,41.88122,-87.6296
13134,3,17,false,12,7,-5,41.88138,-87.67493
13056,3,17,false,33,24,-9,41.88168,-87.63951
191,3,17,false,2,3,1,41.88169,-87.63951
198,3,17,false,17,12,-5,41.88187,-87.6488
TA1307000120,3,17,false,160,123,-37,41.88188,-87.64879
13341,3,17,false,99,53,-46,41.88208,-87.63985
174,3,17,false,13,5,-8,41.88208,-87.63984
197,3,17,false,4,7,3,41.88208,-87.62513
13036,3,17,false,55,58,3,41.8821,-87.62513
77,3,17,false,14,6,-8,41.88214,-87.64108
TA1305000032,3,17,false,111,64,-47,41.88218,-87.64109
98,3,17,false,10,2,-8,41.88266,-87.63251
13006,3,17,false,29,29,0,41.88268,-87.63252
13353,3,17,false,34,49,15,41.88283,-87.6612
346,3,17,false,5,8,3,41.88284,-87.6612
654,3,17,false,33,26,-7,41.88307,-87.65698
233,3,17,false,10,5,-5,41.88309,-87.6511
13409,3,17,false,55,44,-11,41.8831,-87.6511
KA1503000072,3,17,false,41,22,-19,41.88317,-87.63693
91,3,17,false,9,8,-1,41.88336,-87.64122
WL-012,3,17,false,144,74,-70,41.88337,-87.6412
112,3,17,false,8,17,9,41.88362,-87.6486
13053,3,17,false,96,128,32,41.88365,-87.64863
43,3,17,false,16,20,4,41.88396,-87.62455
13001,3,17,false,110,81,-29,41.88397,-87.62459
88,3,17,false,6,3,-3,41.88407,-87.65691
13155,3,17,false,25,17,-8,41.88407,-87.65689
18062,3,17,false,66,22,-44,41.88412,-87.65427
621,3,17,false,5,2,-3,41.88412,-87.65427
81,3,17,false,22,8,-14,41.88417,-87.6296
TA1306000010,3,17,false,97,41,-56,41.88419,-87.62961
15666,3,17,false,4,7,3,41.88446,-87.6963
KA1504000106,3,17,false,11,6,-5,41.88459,-87.70631
TA1305000030,3,17,false,140,47,-93,41.88459,-87.63178
15535,3,17,false,60,52,-8,41.8846,-87.64455
96,3,17,false,1,5,4,41.8846,-87.64455
51,3,17,false,11,8,-3,41.88462,-87.63176
TA1305000029,3,17,false,124,77,-47,41.88466,-87.62787
195,3,17,false,16,4,-12,41.88466,-87.61952
13263,3,17,false,115,61,-54,41.88467,-87.61952
44,3,17,false,14,12,-2,41.88468,-87.62782
TA1306000015,3,17,false,94,103,9,41.88549,-87.65232
518,3,17,false,12,9,-3,41.8855,-87.71686
71,3,17,false,7,12,5,41.8855,-87.65233
66,3,17,false,12,10,-2,41.88557,-87.64186
13021,3,17,false,90,68,-22,41.88559,-87.64184
TA1307000111,3,17,false,72,47,-25,41.88582,-87.63548
164,3,17,false,22,5,-17,41.88583,-87.63547
13073,3,17,false,23,15,-8,41.88592,-87.66717
536,3,17,false,2,1,-1,41.88593,-87.7354
119,3,17,false,3,8,5,41.88593,-87.66717
KA17018054,3,17,false,20,13,-7,41.88595,-87.67701
KA1503000012,3,17,false,113,65,-48,41.88599,-87.63089
38,3,17,false,7,5,-2,41.88599,-87.63089
52,3,17,false,16,10,-6,41.886,-87.62421
TA1305000011,3,17,false,99,92,-7,41.886,-87.62418
7,3,17,false,5,3,-2,41.88627,-87.61751
15534,3,17,false,58,47,-11,41.88627,-87.61749
217,3,17,false,2,3,1,41.8866,-87.65821
13197,3,17,false,30,14,-16,41.8866,-87.65816
264,3,17,false,5,7,2,41.8867,-87.62224
TA1308000029,3,17,false,52,41,-11,41.88673,-87.62225
194,3,17,false,9,10,1,41.88688,-87.62606
TA1307000131,3,17,false,68,87,19,41.88688,-87.62606
6,3,17,false,11,4,-7,41.88697,-87.61281
KA1503000064,3,17,false,187,199,12,41.88697,-87.61281
16905,3,17,false,1,2,1,41.88767,-87.76547
531,3,17,false,1,1,0,41.88767,-87.76546
530,3,17,false,4,1,-3,41.88783,-87.75558
16906,3,17,false,3,2,-1,41.88792,-87.77445
100,3,17,false,12,3,-9,41.88814,-87.63657
TA1305000022,3,17,false,77,51,-26,41.88817,-87.63656
56,3,17,false,25,22,-3,41.88866,-87.64442
TA1306000003,3,17,false,117,96,-21,41.88867,-87.64442
KA1503000043,3,17,false,147,121,-26,41.88918,-87.63851
133,3,17,false,20,15,-5,41.88918,-87.63851
13050,3,17,false,94,100,6,41.88919,-87.62775
47,3,17,false,8,9,1,41.88921,-87.62775
15664,3,17,false,3,7,4,41.8895,-87.68821
285,3,17,false,9,1,-8,41.88989,-87.67149
13432,3,17,false,28,27,-1,41.88989,-87.67149
TA1307000151,3,17,false,103,67,-36,41.88993,-87.63427
212,3,17,false,17,12,-5,41.88995,-87.63427
636,3,17,false,41,41,0,41.88997,-87.63662
378,3,17,false,4,1,-3,41.89014,-87.71289
125,3,17,false,14,2,-12,41.89018,-87.62621
KA1503000044,3,17,false,41,37,-4,41.89018,-87.6262
196,3,17,false,9,7,-2,41.89053,-87.62205
13427,3,17,false,56,47,-9,41.89054,-87.62205
26,3,17,false,10,6,-4,41.89057,-87.61798
13430,3,17,false,135,117,-18,41.89077,-87.63169
181,3,17,false,14,12,-2,41.89077,-87.63168
TA1306000013,3,17,false,142,137,-5,41.89083,-87.61852
RN-,3,17,false,74,75,1,41.89102,-87.63546
672,3,17,false,17,9,-8,41.89102,-87.63545
277,3,17,false,2,4,2,41.89108,-87.66665
13434,3,17,false,19,20,1,41.89108,-87.66663
TA1308000006,3,17,false,28,39,11,41.89128,-87.67686
199,3,17,false,17,21,4,41.89143,-87.62676
TA1307000117,3,17,false,131,148,17,41.89144,-87.62675
13033,3,17,false,120,76,-44,41.8916,-87.64835
214,3,17,false,6,6,0,41.89161,-87.67688
84,3,17,false,8,11,3,41.89161,-87.64833
186,3,17,false,5,5,0,41.8918,-87.65879
13194,3,17,false,37,53,16,41.8918,-87.65878
TA1305000003,3,17,false,97,127,30,41.89187,-87.62061
24,3,17,false,15,27,12,41.8919,-87.62063
643,3,17,false,14,22,8,41.89203,-87.68939
35,3,17,false,27,31,4,41.89227,-87.61206
13022,3,17,false,609,594,-15,41.89227,-87.61205
99,3,17,false,18,14,-4,41.89255,-87.61449
TA1306000029,3,17,false,112,88,-24,41.89256,-87.61449
13265,3,17,false,108,98,-10,41.89383,-87.64172
74,3,17,false,10,8,-2,41.89384,-87.64173
13045,3,17,false,157,106,-51,41.89403,-87.62931
110,3,17,false,23,23,0,41.89406,-87.6293
13016,3,17,false,124,68,-56,41.89431,-87.62277
211,3,17,false,11,10,-1,41.89439,-87.62267
KA1503000041,3,17,false,60,58,-2,41.89452,-87.61798
142,3,17,false,11,5,-6,41.89453,-87.61806
92,3,17,false,6,9,3,41.89455,-87.65346
13196,3,17,false,66,52,-14,41.89455,-87.65345
TA1307000062,3,17,false,54,35,-19,41.89466,-87.63839
111,3,17,false,9,6,-3,41.89466,-87.63837
TA1306000012,3,17,false,164,118,-46,41.89475,-87.63438
53,3,17,false,28,17,-11,41.89476,-87.63439
627,3,17,false,7,13,6,41.8948,-87.63231
KP1705001026,3,17,false,69,77,8,41.89483,-87.6323
16921,3,17,false,2,7,5,41.89488,-87.77459
KA1504000114,3,17,false,3,1,-2,41.89547,-87.70614
659,3,17,false,1,3,2,41.8955,-87.68201
18058,3,17,false,23,29,6,41.8955,-87.68201
637,3,17,false,43,53,10,41.89563,-87.67209
128,3,17,false,10,5,-5,41.89571,-87.67716
13132,3,17,false,55,76,21,41.89573,-87.67718
161,3,17,false,26,16,-10,41.89574,-87.62599
15530,3,17,false,65,84,19,41.89575,-87.62596
18003,3,17,false,37,31,-6,41.89575,-87.62011
13247,3,17,false,30,27,-3,41.89597,-87.66775
350,3,17,false,2,3,1,41.89597,-87.66774
TA1305000020,3,17,false,86,54,-32,41.89636,-87.65406
54,3,17,false,11,2,-9,41.89637,-87.65407
13289,3,17,false,60,62,2,41.89638,-87.661
86,3,17,false,4,7,3,41.89639,-87.661
337,3,17,false,13,7,-6,41.89659,-87.63096
13303,3,17,false,85,73,-12,41.89672,-87.63088
13017,3,17,false,90,53,-37,41.89676,-87.6357
31,3,17,false,15,11,-4,41.89677,-87.63572
13338,3,17,false,37,66,29,41.89697,-87.62173
173,3,17,false,4,7,3,41.89704,-87.62173
TA1307000061,3,17,false,51,41,-10,41.89745,-87.62873
106,3,17,false,10,8,-2,41.89746,-87.62874
25,3,17,false,13,11,-2,41.89751,-87.62354
13034,3,17,false,62,57,-5,41.89754,-87.62352
48,3,17,false,14,3,-11,41.89772,-87.64302
TA1306000009,3,17,false,72,36,-36,41.89772,-87.64299
620,3,17,false,83,68,-15,41.89817,-87.63754
374,3,17,false,7,2,-5,41.89842,-87.68659
KA1504000103,3,17,false,21,22,1,41.89842,-87.68659
145,3,17,false,7,4,-3,41.89856,-87.62211
15529,3,17,false,53,48,-5,41.89858,-87.62206
140,3,17,false,12,17,5,41.89895,-87.6299
TA1307000128,3,17,false,141,108,-33,41.89896,-87.6299
657,3,17,false,36,21,-15,41.89918,-87.6722
KA1504000117,3,17,false,22,13,-9,41.89936,-87.64848
13248,3,17,false,41,23,-18,41.89964,-87.66788
46,3,17,false,6,14,8,41.89994,-87.63444
TA1306000011,3,17,false,65,42,-23,41.89994,-87.63443
KA1504000116,3,17,false,39,21,-18,41.90023,-87.64299
364,3,17,false,5,1,-4,41.90023,-87.64299
17660,3,17,false,22,21,-1,41.90036,-87.69671
13290,3,17,false,36,39,3,41.90069,-87.66259
29,3,17,false,1,5,4,41.90069,-87.66259
13042,3,17,false,214,257,43,41.90097,-87.62377
85,3,17,false,17,28,11,41.90098,-87.62375
183,3,17,false,2,1,-1,41.90133,-87.67744
TA1307000070,3,17,false,36,31,-5,41.90133,-87.67742
KA1504000133,3,17,false,107,83,-24,41.90234,-87.62773
172,3,17,false,11,11,0,41.90236,-87.62774
15654,3,17,false,9,10,1,41.90271,-87.70923
305,3,17,false,1,6,5,41.9028,-87.69005
13241,3,17,false,36,20,-16,41.9029,-87.68731
176,3,17,false,33,26,-7,41.90291,-87.63141
23,3,17,false,4,8,4,41.90292,-87.63772
TA1306000006,3,17,false,25,36,11,41.90292,-87.63772
TA1307000039,3,17,false,154,182,28,41.90294,-87.63137
658,3,17,false,20,10,-10,41.903,-87.6838
216,3,17,false,2,4,2,41.90302,-87.69749
13256,3,17,false,12,22,10,41.90302,-87.69749
17,3,17,false,10,10,0,41.90313,-87.67391
TA1305000034,3,17,false,43,58,15,41.90313,-87.67391
182,3,17,false,23,27,4,41.90317,-87.63442
KA1504000135,3,17,false,251,209,-42,41.90319,-87.63439
13136,3,17,false,42,33,-9,41.90326,-87.67845
130,3,17,false,10,2,-8,41.90327,-87.67846
210,3,17,false,14,9,-5,41.90342,-87.66781
13061,3,17,false,114,105,-9,41.90342,-87.66779
KA1504000079,3,17,false,54,60,6,41.9035,-87.64334
359,3,17,false,7,10,3,41.90458,-87.6497
138,3,17,false,4,5,1,41.9046,-87.64057
TA1307000115,3,17,false,31,40,9,41.9046,-87.64056
291,3,17,false,15,14,-1,41.90672,-87.63494
TA1308000049,3,17,false,135,155,20,41.90672,-87.6349
KA1504000134,3,17,false,96,78,-18,41.90687,-87.6262
180,3,17,false,13,13,0,41.90687,-87.62618
13224,3,17,false,58,46,-12,41.90706,-87.66725
333,3,17,false,7,5,-2,41.90706,-87.66725
18069,3,17,false,22,3,-19,41.90722,-87.65563
TA1307000143,3,17,false,27,30,3,41.90762,-87.63854
61,3,17,false,12,10,-2,41.90764,-87.67254
13221,3,17,false,81,78,-3,41.90765,-87.67254
13245,3,17,false,14,4,-10,41.90777,-87.68586
301,3,17,false,22,11,-11,41.90796,-87.63203
TA1309000024,3,17,false,111,96,-15,41.908,-87.63152
69,3,17,false,10,11,1,41.90939,-87.6777
TA1305000041,3,17,false,105,116,11,41.9094,-87.67769
15652,3,17,false,9,6,-3,41.90965,-87.71664
331,3,17,false,91,145,54,41.90965,-87.64812
15653,3,17,false,6,8,2,41.90979,-87.7053
TA1305000037,3,17,false,56,55,-1,41.91018,-87.67003
27,3,17,false,4,2,-2,41.91019,-87.6435
TA1306000008,3,17,false,38,52,14,41.9102,-87.6435
16,3,17,false,6,7,1,41.91035,-87.67008
213,3,17,false,6,4,-2,41.91037,-87.68237
TA1308000005,3,17,false,35,32,-3,41.91042,-87.68238
276,3,17,false,5,3,-2,41.91043,-87.69718
13258,3,17,false,18,21,3,41.91043,-87.69718
160,3,17,false,4,3,-1,41.91054,-87.68957
13257,3,17,false,36,31,-5,41.91054,-87.68956
13154,3,17,false,68,81,13,41.91054,-87.65312
20,3,17,false,5,7,2,41.91055,-87.65313
60,3,17,false,3,10,7,41.91059,-87.64942
13058,3,17,false,65,81,16,41.91059,-87.64942
118,3,17,false,17,14,-3,41.91138,-87.63868
TA1307000038,3,17,false,93,108,15,41.91138,-87.63868
268,3,17,false,13,35,22,41.91172,-87.62681
LF-005,3,17,false,231,721,490,41.91172,-87.62681
126,3,17,false,7,20,13,41.91196,-87.63197
13128,3,17,false,60,109,49,41.91197,-87.63197
289,3,17,false,16,26,10,41.91209,-87.63472
TA1308000050,3,17,false,208,209,1,41.91211,-87.6347
13243,3,17,false,71,50,-21,41.91262,-87.6814
158,3,17,false,9,9,0,41.91262,-87.6814
TA1309000032,3,17,false,21,19,-2,41.91293,-87.66417
315,3,17,false,1,5,4,41.91293,-87.66417
TA1306000032,3,17,false,65,48,-17,41.9137,-87.65285
93,3,17,false,7,8,1,41.91371,-87.65285
TA1307000166,3,17,false,54,50,-4,41.91386,-87.64877
224,3,17,false,4,4,0,41.91386,-87.64877
15655,3,17,false,18,24,6,41.91401,-87.70514
18017,3,17,false,13,20,7,41.91416,-87.71676
18067,3,17,false,38,27,-11,41.9146,-87.66796
628,3,17,false,8,3,-5,41.9146,-87.66796
28,3,17,false,9,8,-1,41.91469,-87.64333
TA1306000007,3,17,false,30,32,2,41.91469,-87.64333
13068,3,17,false,45,35,-10,41.91554,-87.68703
116,3,17,false,3,2,-1,41.91555,-87.68703
13179,3,17,false,166,181,15,41.9157,-87.63461
141,3,17,false,13,30,17,41.91571,-87.63461
13133,3,17,false,82,61,-21,41.91598,-87.67733
219,3,17,false,7,4,-3,41.91598,-87.67733
58,3,17,false,4,5,1,41.91602,-87.66894
TA1305000039,3,17,false,58,49,-9,41.9163,-87.66749
506,3,17,false,1,1,0,41.91711,-87.71023
15650,3,17,false,23,29,6,41.91711,-87.71023
507,3,17,false,4,2,-2,41.91752,-87.70181
15651,3,17,false,27,27,0,41.91752,-87.70181
185,3,17,false,3,5,2,41.91774,-87.69143
13266,3,17,false,25,17,-8,41.91774,-87.69142
TA1309000029,3,17,false,26,20,-6,41.9178,-87.68245
309,3,17,false,1,3,2,41.91789,-87.6865
288,3,17,false,12,5,-7,41.91809,-87.64375
TA1309000006,3,17,false,49,51,2,41.91809,-87.64375
223,3,17,false,4,5,1,41.91821,-87.65698
TA1307000163,3,17,false,46,51,5,41.91821,-87.65696
94,3,17,false,17,21,4,41.91831,-87.6363
13146,3,17,false,153,161,8,41.91831,-87.63629
13059,3,17,false,123,93,-30,41.91845,-87.65222
113,3,17,false,18,11,-7,41.91846,-87.65222
13259,3,17,false,22,21,-1,41.91852,-87.69744
259,3,17,false,2,8,6,41.91853,-87.69745
310,3,17,false,2,6,4,41.91984,-87.68083
225,3,17,false,4,16,12,41.91995,-87.64884
13192,3,17,false,58,88,30,41.91995,-87.64884
13288,3,17,false,35,18,-17,41.92008,-87.67788
13242,3,17,false,13,26,13,41.92021,-87.69266
222,3,17,false,5,2,-3,41.92023,-87.69265
307,3,17,false,3,7,4,41.92077,-87.66373
TA1309000030,3,17,false,38,72,34,41.92077,-87.66372
290,3,17,false,1,2,1,41.92152,-87.70734
13292,3,17,false,21,18,-3,41.92152,-87.70733
TA1309000033,3,17,false,77,68,-9,41.92158,-87.65381
13193,3,17,false,102,140,38,41.92182,-87.64412
144,3,17,false,15,21,6,41.92182,-87.64411
13191,3,17,false,74,64,-10,41.92217,-87.63891
143,3,17,false,7,17,10,41.92217,-87.63891
327,3,17,false,9,15,6,41.92225,-87.65783
13084,3,17,false,48,41,-7,41.92268,-87.69715
123,3,17,false,12,6,-6,41.92268,-87.69714
LP-,3,17,false,92,61,-31,41.92396,-87.63584
673,3,17,false,17,6,-11,41.92398,-87.63585
KA1504000140,3,17,false,23,14,-9,41.92409,-87.67646
505,3,17,false,1,1,0,41.92409,-87.67646
619,3,17,false,1,2,1,41.92457,-87.7279
16010,3,17,false,5,4,-1,41.92458,-87.72787
504,3,17,false,8,3,-5,41.92464,-87.68931
15648,3,17,false,11,21,10,41.92464,-87.68931
KA1504000090,3,17,false,7,12,5,41.92483,-87.7145
TA1307000001,3,17,false,78,59,-19,41.92535,-87.66581
188,3,17,false,8,5,-3,41.92536,-87.66581
TA1306000026,3,17,false,86,64,-22,41.92558,-87.65842
87,3,17,false,8,10,2,41.92559,-87.65843
67,3,17,false,6,6,0,41.9256,-87.65371
TA1306000016,3,17,false,80,84,4,41.9256,-87.65371
313,3,17,false,25,19,-6,41.9257,-87.64246
TA1309000019,3,17,false,114,107,-7,41.92586,-87.63897
TA1309000058,3,17,false,128,114,-14,41.92591,-87.64927
127,3,17,false,11,15,4,41.92592,-87.64927
177,3,17,false,22,33,11,41.92627,-87.63086
TA1308000001,3,17,false,142,225,83,41.92627,-87.63086
502,3,17,false,4,1,-3,41.92667,-87.69772
15646,3,17,false,19,21,2,41.92668,-87.6977
34,3,17,false,1,5,4,41.92675,-87.63444
13124,3,17,false,36,42,6,41.92675,-87.63444
302,3,17,false,9,10,1,41.92859,-87.65421
TA1309000023,3,17,false,70,71,1,41.9287,-87.65383
TA1307000113,3,17,false,71,59,-12,41.92878,-87.66391
190,3,17,false,3,8,5,41.92878,-87.6639
13296,3,17,false,49,33,-16,41.92883,-87.66852
TA1309000059,3,17,false,49,22,-27,41.92889,-87.65898
343,3,17,false,3,3,0,41.92889,-87.65898
349,3,17,false,7,13,6,41.92915,-87.6491
TA1309000061,3,17,false,104,80,-24,41.92915,-87.64909
258,3,17,false,2,3,1,41.92946,-87.68417
TA1308000031,3,17,false,23,43,20,41.92946,-87.68417
TA1305000014,3,17,false,134,107,-27,41.92956,-87.64313
340,3,17,false,21,17,-4,41.92956,-87.64313
260,3,17,false,6,8,2,41.92958,-87.70791
13085,3,17,false,51,62,11,41.92958,-87.70789
15643,3,17,false,16,16,0,41.93057,-87.7238
TA1307000142,3,17,false,154,120,-34,41.93125,-87.64432
220,3,17,false,20,8,-12,41.93125,-87.64431
13276,3,17,false,99,75,-24,41.93132,-87.63874
324,3,17,false,10,17,7,41.93173,-87.64179
15645,3,17,false,12,8,-4,41.93191,-87.70121
501,3,17,false,1,2,1,41.93191,-87.70121
163,3,17,false,4,4,0,41.93191,-87.67784
13271,3,17,false,47,19,-28,41.93192,-87.67784
152,3,17,false,11,13,2,41.93221,-87.65864
TA1307000064,3,17,false,84,62,-22,41.93222,-87.65864
TA1306000014,3,17,false,107,75,-32,41.93242,-87.65271
13,3,17,false,15,10,-5,41.93242,-87.65271
329,3,17,false,17,13,-4,41.93258,-87.63642
TA1309000039,3,17,false,102,125,23,41.93258,-87.63642
13294,3,17,false,44,36,-8,41.9326,-87.66595
319,3,17,false,4,3,-1,41.93292,-87.67217
TA1309000036,3,17,false,67,60,-7,41.93313,-87.64776
332,3,17,false,8,4,-4,41.93313,-87.64776
15644,3,17,false,10,3,-7,41.93534,-87.71687
500,3,17,false,2,3,1,41.93534,-87.71686
TA1307000006,3,17,false,55,49,-6,41.93571,-87.6636
153,3,17,false,6,6,0,41.93575,-87.66364
162,3,17,false,1,10,9,41.93588,-87.67844
13268,3,17,false,43,34,-9,41.93588,-87.67843
250,3,17,false,2,3,1,41.93609,-87.66984
13269,3,17,false,31,12,-19,41.93609,-87.66983
TA1307000052,3,17,false,105,82,-23,41.93628,-87.65266
115,3,17,false,8,8,0,41.93628,-87.65266
156,3,17,false,7,11,4,41.9365,-87.64756
TA1307000136,3,17,false,103,65,-38,41.9365,-87.64755
TA1307000041,3,17,false,153,113,-40,41.93669,-87.63683
157,3,17,false,17,20,3,41.9367,-87.63683
13137,3,17,false,160,104,-56,41.9376,-87.6441
300,3,17,false,23,25,2,41.93761,-87.6441
15642,3,17,false,11,31,20,41.93843,-87.69801
154,3,17,false,11,5,-6,41.93912,-87.66384
KA17018068,3,17,false,28,16,-12,41.93935,-87.68327
TA1309000042,3,17,false,67,45,-22,41.93937,-87.66836
131,3,17,false,7,3,-4,41.93937,-87.66835
496,3,17,false,1,2,1,41.9394,-87.72356
KA150400009X,3,17,false,9,5,-4,41.9394,-87.71159
15640,3,17,false,6,8,2,41.93941,-87.72357
13229,3,17,false,73,43,-30,41.93946,-87.66376
226,3,17,false,7,3,-4,41.93972,-87.65886
TA1308000019,3,17,false,86,74,-12,41.93973,-87.65886
13277,3,17,false,83,65,-18,41.9401,-87.64546
296,3,17,false,7,7,0,41.9401,-87.64546
TA1307000134,3,17,false,138,112,-26,41.94016,-87.65303
117,3,17,false,25,11,-14,41.94016,-87.65302
13143,3,17,false,22,12,-10,41.94059,-87.67853
334,3,17,false,15,17,2,41.94076,-87.63919
TA1309000049,3,17,false,157,101,-56,41.94077,-87.63919
308,3,17,false,3,9,6,41.94152,-87.68471
15634,3,17,false,17,6,-11,41.94304,-87.68729
493,3,17,false,1,1,0,41.94304,-87.68729
TA1307000138,3,17,false,67,43,-24,41.94334,-87.67094
230,3,17,false,16,4,-12,41.94335,-87.67093
13144,3,17,false,21,35,14,41.9434,-87.67964
TA1309000025,3,17,false,111,92,-19,41.94368,-87.64894
299,3,17,false,8,15,7,41.94368,-87.64894
229,3,17,false,8,12,4,41.94372,-87.66401
13071,3,17,false,108,84,-24,41.94373,-87.66401
632,3,17,false,125,122,-3,41.94453,-87.6547
303,3,17,false,19,21,2,41.94522,-87.64702
15631,3,17,false,9,16,7,41.94524,-87.70665
13278,3,17,false,97,63,-34,41.94553,-87.64644
330,3,17,false,1,3,2,41.94618,-87.67331
TA1309000050,3,17,false,13,20,7,41.94618,-87.67331
KA1504000141,3,17,false,4,2,-2,41.94627,-87.73105
15632,3,17,false,4,5,1,41.94664,-87.69463
KA1504000143,3,17,false,12,11,-1,41.94664,-87.68337
KA1504000142,3,17,false,4,4,0,41.94735,-87.71759
16994,3,17,false,4,3,-1,41.94784,-87.74
227,3,17,false,17,8,-9,41.94813,-87.66397
13235,3,17,false,77,95,18,41.94814,-87.66396
304,3,17,false,11,15,4,41.94878,-87.64922
257,3,17,false,5,4,-1,41.9488,-87.67527
13253,3,17,false,9,14,5,41.9488,-87.67527
13325,3,17,false,84,81,-3,41.94907,-87.64863
114,3,17,false,15,14,-1,41.94935,-87.65451
TA1307000126,3,17,false,92,157,65,41.94936,-87.65451
232,3,17,false,10,22,12,41.94943,-87.64645
TA1307000150,3,17,false,90,103,13,41.94945,-87.64646
640,3,17,false,1,1,0,41.94993,-87.71396
18016,3,17,false,6,2,-4,41.94993,-87.71395
347,3,17,false,4,2,-2,41.95068,-87.6687
13319,3,17,false,35,32,-3,41.95069,-87.6687
TA1307000127,3,17,false,79,112,33,41.9508,-87.65918
165,3,17,false,6,14,8,41.95081,-87.65918
15628,3,17,false,19,13,-6,41.95216,-87.69806
487,3,17,false,2,1,-1,41.95216,-87.69806
318,3,17,false,4,5,1,41.95254,-87.6735
13323,3,17,false,55,46,-9,41.95282,-87.65
256,3,17,false,2,8,6,41.95282,-87.65
15624,3,17,false,12,9,-3,41.95339,-87.73199
483,3,17,false,1,2,1,41.9534,-87.73199
314,3,17,false,3,1,-2,41.9535,-87.69199
485,3,17,false,2,3,1,41.95361,-87.70933
KA1504000096,3,17,false,10,9,-1,41.95361,-87.70932
590,3,17,false,2,4,2,41.95374,-87.74056
KA1504000139,3,17,false,4,20,16,41.954,-87.71909
TA1309000043,3,17,false,27,21,-6,41.95417,-87.66434
240,3,17,false,7,4,-3,41.95424,-87.65441
13063,3,17,false,44,45,1,41.95424,-87.65441
486,3,17,false,2,2,0,41.95431,-87.68607
KA1504000158,3,17,false,14,6,-8,41.95432,-87.68607
254,3,17,false,11,13,2,41.95438,-87.64806
TA1308000022,3,17,false,60,64,4,41.95438,-87.64805
16991,3,17,false,3,5,2,41.95448,-87.7496
244,3,17,false,4,1,-3,41.95466,-87.67391
TA1307000149,3,17,false,31,16,-15,41.95467,-87.67392
298,3,17,false,5,1,-4,41.95601,-87.68021
TA1309000026,3,17,false,21,21,0,41.95601,-87.6802
13249,3,17,false,16,12,-4,41.95606,-87.66885
312,3,17,false,7,7,0,41.95637,-87.6563
292,3,17,false,4,1,-3,41.95709,-87.6642
TA1308000047,3,17,false,8,14,6,41.95709,-87.6642
13379,3,17,false,87,50,-37,41.95786,-87.6495
TA1309000018,3,17,false,22,11,-11,41.95791,-87.67357
316,3,17,false,2,2,0,41.95841,-87.69401
306,3,17,false,5,6,1,41.9585,-87.655
TA1309000027,3,17,false,29,29,0,41.9585,-87.65499
592,3,17,false,9,2,-7,41.96065,-87.74538
13389,3,17,false,45,42,-3,41.961,-87.64958
245,3,17,false,7,3,-4,41.96101,-87.64958
15621,3,17,false,6,6,0,41.96103,-87.70586
KA1706005015,3,17,false,4,4,0,41.96108,-87.73569
15622,3,17,false,13,13,0,41.96108,-87.69544
KA1504000164,3,17,false,3,3,0,41.96109,-87.72897
238,3,17,false,5,4,-1,41.96141,-87.6762
TA1307000144,3,17,false,26,15,-11,41.96142,-87.6762
TA1309000021,3,17,false,13,13,0,41.9615,-87.6714
15623,3,17,false,8,13,5,41.96154,-87.69117
234,3,17,false,5,3,-2,41.96158,-87.6661
KA1503000022,3,17,false,22,19,-3,41.96158,-87.66609
231,3,17,false,7,7,0,41.96163,-87.65464
TA1307000107,3,17,false,48,60,12,41.96164,-87.65464
TA1307000156,3,17,false,10,21,11,41.96301,-87.68479
243,3,17,false,1,2,1,41.96302,-87.68479
TA1309000012,3,17,false,15,8,-7,41.96325,-87.67928
249,3,17,false,7,17,10,41.96398,-87.63818
TA1308000012,3,17,false,113,155,42,41.96398,-87.63818
293,3,17,false,5,4,-1,41.96521,-87.65822
13074,3,17,false,42,35,-7,41.96521,-87.6582
639,3,17,false,42,52,10,41.96584,-87.64538
KA1504000127,3,17,false,9,4,-5,41.96587,-87.70083
477,3,17,false,1,4,3,41.96587,-87.70083
KA1504000093,3,17,false,4,4,0,41.96587,-87.69365
478,3,17,false,1,3,2,41.96587,-87.69364
TA1307000140,3,17,false,17,21,4,41.96643,-87.68865
239,3,17,false,3,4,1,41.9665,-87.68843
326,3,17,false,6,6,0,41.96665,-87.67113
476,3,17,false,1,1,0,41.96668,-87.70807
KA1504000126,3,17,false,7,8,1,41.96668,-87.70807
TA1309000014,3,17,false,39,41,2,41.96709,-87.66744
TA1307000158,3,17,false,13,11,-2,41.9671,-87.67904
242,3,17,false,3,2,-1,41.9671,-87.67904
TA1307000119,3,17,false,34,19,-15,41.96796,-87.65
251,3,17,false,3,2,-1,41.96796,-87.65
15615,3,17,false,7,9,2,41.96835,-87.71183
474,3,17,false,1,3,2,41.96835,-87.71182
323,3,17,false,4,6,2,41.96869,-87.66034
TA1308000021,3,17,false,31,23,-8,41.96883,-87.65765
475,3,17,false,5,3,-2,41.96885,-87.69611
KA1504000080,3,17,false,11,13,2,41.96887,-87.69609
TA1309000015,3,17,false,15,9,-6,41.96889,-87.68401
311,3,17,false,2,1,-1,41.9689,-87.68402
TA1309000066,3,17,false,69,39,-30,41.9691,-87.67423
344,3,17,false,8,5,-3,41.9691,-87.67423
TA1309000041,3,17,false,31,12,-19,41.96951,-87.65471
465,3,17,false,1,5,4,41.97161,-87.65016
KA1504000171,3,17,false,34,40,6,41.97161,-87.65016
325,3,17,false,4,5,1,41.9728,-87.67186
TA1309000035,3,17,false,46,44,-2,41.97335,-87.66785
295,3,17,false,2,6,4,41.97378,-87.65972
13108,3,17,false,48,36,-12,41.97379,-87.65971
KA1504000078,3,17,false,10,9,-1,41.97491,-87.69258
472,3,17,false,3,5,2,41.97492,-87.69262
464,3,17,false,3,6,3,41.97562,-87.67945
KA1504000149,3,17,false,6,18,12,41.97562,-87.67945
KA1504000160,3,17,false,7,7,0,41.97564,-87.70143
470,3,17,false,1,1,0,41.97567,-87.70927
KA1504000128,3,17,false,2,4,2,41.97567,-87.70927
463,3,17,false,10,12,2,41.978,-87.66805
KA1504000146,3,17,false,35,48,13,41.978,-87.66805
13109,3,17,false,30,27,-3,41.97835,-87.65976
294,3,17,false,1,2,1,41.97835,-87.65976
KA1504000147,3,17,false,6,7,1,41.97976,-87.67754
462,3,17,false,1,3,2,41.97977,-87.67755
655,3,17,false,4,4,0,41.97987,-87.68194
KA1504000161,3,17,false,7,4,-3,41.98038,-87.71612
KA1504000167,3,17,false,5,1,-4,41.98206,-87.70895
494,3,17,false,1,3,2,41.98234,-87.70892
460,3,17,false,1,2,1,41.98358,-87.66916
KA1504000151,3,17,false,24,34,10,41.98359,-87.66916
15585,3,17,false,7,6,-1,41.98367,-87.69642
KA1504000152,3,17,false,67,59,-8,41.98403,-87.65231
459,3,17,false,12,7,-5,41.98403,-87.65231
15578,3,17,false,20,16,-4,41.98405,-87.66027
461,3,17,false,3,6,3,41.98405,-87.66027
15575,3,17,false,12,23,11,41.98975,-87.66014
458,3,17,false,2,3,1,41.98975,-87.66013
KA1504000130,3,17,false,3,2,-1,41.99024,-87.69338
457,3,17,false,1,2,1,41.99052,-87.66982
KA1504000148,3,17,false,12,8,-4,41.99086,-87.66971
KA1504000129,3,17,false,4,6,2,41.99417,-87.68945
15571,3,17,false,28,21,-7,41.99478,-87.66028
454,3,17,false,6,3,-3,41.99478,-87.66027
KA1504000156,3,17,false,10,11,1,41.99925,-87.67137
RP-009,3,17,false,17,17,0,42.00107,-87.66122
RP-001,3,17,false,14,12,-2,42.00179,-87.68883
450,3,17,false,1,5,4,42.00179,-87.68883
449,3,17,false,2,3,1,42.00446,-87.67241
RP-008,3,17,false,3,7,4,42.00446,-87.6724
RP-002,3,17,false,5,5,0,42.00456,-87.68065
448,3,17,false,1,1,0,42.00456,-87.68064
660,3,17,false,20,18,-2,42.00458,-87.66143
354,3,17,false,1,1,0,42.00587,-87.66802
KA1504000175,3,17,false,21,13,-8,42.00797,-87.66549
447,3,17,false,2,1,-1,42.00797,-87.66548
RP-005,3,17,false,2,3,1,42.0086,-87.69047
432,3,17,false,1,1,0,42.00907,-87.67423
KA1504000162,3,17,false,8,5,-3,42.00907,-87.67422
KA1504000159,3,17,false,8,15,7,42.01059,-87.66241
466,3,17,false,1,1,0,42.01213,-87.68292
RP-006,3,17,false,2,2,0,42.01213,-87.68292
RP-004,3,17,false,7,2,-5,42.01234,-87.68825
526,3,17,false,3,1,-2,42.01235,-87.68825
RP-007,3,17,false,3,3,0,42.01256,-87.67431
525,3,17,false,9,12,3,42.01272,-87.66605
517,3,17,false,2,2,0,42.01597,-87.675
520,3,17,false,5,6,1,42.01597,-87.66859
519,3,17,false,4,2,-2,42.01696,-87.67773
527,3,17,false,10,6,-4,42.01892,-87.69004
515,3,17,false,4,2,-2,42.01915,-87.67356
514,3,17,false,4,2,-2,42.01927,-87.68452
16806,3,17,false,6,1,-5,42.01953,-87.66955
522,3,17,false,1,1,0,42.01954,-87.66954
523,3,17,false,14,5,-9,42.02089,-87.66505
662,3,17,false,10,12,2,42.02354,-87.69961
598,3,17,false,3,3,0,42.02578,-87.68411
597,3,17,false,2,6,4,42.03256,-87.67914
E002,3,17,false,8,11,3,42.03256,-87.67912
E011,3,17,false,4,1,-3,42.03473,-87.69912
599,3,17,false,6,4,-2,42.03972,-87.69942
625,3,17,false,1,5,4,42.04163,-87.6808
596,3,17,false,35,31,-4,42.04822,-87.68348
600,3,17,false,3,1,-2,42.04831,-87.6983
E008,3,17,false,29,18,-11,42.05049,-87.67782
603,3,17,false,1,2,1,42.05049,-87.67782
605,3,17,false,11,20,9,42.05294,-87.67342
661,3,17,false,13,16,3,42.05704,-87.68657
604,3,17,false,29,19,-10,42.05824,-87.67744
601,3,17,false,2,1,-1,42.06368,-87.69871
E007,3,17,false,2,1,-1,42.06431,-87.68615
E014,3,17,false,2,2,0,42.06483,-87.71531
20215,3,17,true,1,1,0,41.64856,-87.54618
20222,3,17,true,1,1,0,41.7046,-87.52832
20224,3,17,true,1,1,0,41.71371,-87.53083
684,3,17,true,2,1,-1,41.72801,-87.6676
588,3,17,true,3,2,-1,41.74392,-87.57522
582,3,17,true,1,1,0,41.74453,-87.56508
579,3,17,true,2,1,-1,41.75182,-87.56522
270,3,17,true,1,1,0,41.75867,-87.58692
KA1503000020,3,17,true,1,2,1,41.76223,-87.55923
KA1503000002,3,17,true,4,7,3,41.76641,-87.5657
102,3,17,true,1,1,0,41.77345,-87.58533
KA1503000021,3,17,true,1,2,1,41.77888,-87.58665
KA1503000025,3,17,true,1,1,0,41.78008,-87.62977
653,3,17,true,2,3,1,41.78059,-87.58491
KA1503000054,3,17,true,4,2,-2,41.78061,-87.60582
15491,3,17,true,3,6,3,41.78096,-87.57624
101,3,17,true,1,1,0,41.78105,-87.57611
KA1503000033,3,17,true,2,2,0,41.78411,-87.61329
426,3,17,true,24,31,7,41.7851,-87.60108
KA1503000014,3,17,true,77,116,39,41.7851,-87.60108
KA1503000070,3,17,true,19,18,-1,41.78794,-87.58831
425,3,17,true,4,3,-1,41.78795,-87.58831
328,3,17,true,20,4,-16,41.78872,-87.6013
TA1309000011,3,17,true,83,27,-56,41.78873,-87.60131
KA1503000071,3,17,true,174,65,-109,41.79148,-87.59988
423,3,17,true,25,6,-19,41.79148,-87.59988
KA1503000075,3,17,true,4,1,-3,41.79156,-87.60785
424,3,17,true,1,1,0,41.79174,-87.58395
KA1503000074,3,17,true,16,19,3,41.79174,-87.58395
TA1309000063,3,17,true,33,89,56,41.79325,-87.5878
345,3,17,true,14,13,-1,41.79326,-87.5878
421,3,17,true,1,3,2,41.79346,-87.61585
420,3,17,true,23,21,-2,41.79429,-87.60145
KA1504000076,3,17,true,96,49,-47,41.7943,-87.60145
TA1307000160,3,17,true,3,6,3,41.79485,-87.61873
KA1503000013,3,17,true,2,6,4,41.79498,-87.63312
247,3,17,true,13,18,5,41.79522,-87.58077
TA1308000009,3,17,true,40,77,37,41.79522,-87.58075
TA1307000164,3,17,true,27,48,21,41.79527,-87.59647
248,3,17,true,9,3,-6,41.79528,-87.59647
646,3,17,true,1,1,0,41.79663,-87.62592
KA1503000052,3,17,true,31,45,14,41.79935,-87.60097
418,3,17,true,7,17,10,41.79936,-87.60097
KA1503000059,3,17,true,35,33,-2,41.79952,-87.58643
419,3,17,true,2,2,0,41.79952,-87.58643
TA1309000037,3,17,true,55,89,34,41.79957,-87.59474
554,3,17,true,2,2,0,41.80091,-87.67468
415,3,17,true,1,2,1,41.80228,-87.61807
15470,3,17,true,2,7,5,41.80228,-87.61807
417,3,17,true,8,20,12,41.80242,-87.5869
KA1503000007,3,17,true,35,58,23,41.80242,-87.58689
121,3,17,true,8,10,2,41.80256,-87.59035
13398,3,17,true,26,37,11,41.80256,-87.59035
TA1309000067,3,17,true,8,6,-2,41.80303,-87.60661
322,3,17,true,14,27,13,41.80321,-87.59849
594,3,17,true,3,1,-2,41.80567,-87.68337
416,3,17,true,1,2,1,41.80578,-87.59247
KA1503000069,3,17,true,12,10,-2,41.80579,-87.59247
KA1503000051,3,17,true,8,3,-5,41.80815,-87.64563
411,3,17,true,1,2,1,41.80816,-87.64563
551,3,17,true,2,1,-1,41.80822,-87.67721
KA1504000091,3,17,true,1,5,4,41.80823,-87.6772
553,3,17,true,1,1,0,41.8084,-87.65653
KA1503000009,3,17,true,2,6,4,41.80932,-87.63346
267,3,17,true,4,2,-2,41.80944,-87.59188
TA1308000035,3,17,true,11,14,3,41.80944,-87.59188
252,3,17,true,3,2,-1,41.80982,-87.59936
TA1308000002,3,17,true,9,8,-1,41.80983,-87.59937
TA1308000007,3,17,true,2,4,2,41.80984,-87.61628
TA1309000053,3,17,true,5,2,-3,41.80985,-87.60675
336,3,17,true,1,1,0,41.80985,-87.60675
549,3,17,true,2,3,1,41.81401,-87.66662
KA1503000065,3,17,true,6,14,8,41.81409,-87.59701
TA1308000023,3,17,true,6,3,-3,41.81649,-87.60659
410,3,17,true,1,1,0,41.81666,-87.61942
KA1503000027,3,17,true,3,5,2,41.81666,-87.61942
KA1503000032,3,17,true,3,3,0,41.81912,-87.64328
13083,3,17,true,4,9,5,41.82167,-87.62153
355,3,17,true,1,3,2,41.82217,-87.63032
265,3,17,true,3,1,-2,41.82297,-87.6071
TA1308000038,3,17,true,7,8,1,41.82298,-87.6071
16933,3,17,true,1,1,0,41.82362,-87.65093
179,3,17,true,1,2,1,41.82458,-87.61678
13420,3,17,true,10,8,-2,41.82459,-87.61678
262,3,17,true,2,5,3,41.82707,-87.64573
TA1307000161,3,17,true,7,5,-2,41.82707,-87.64572
KA1503000068,3,17,true,10,8,-2,41.82878,-87.68062
9,3,17,true,2,3,1,41.82878,-87.68061
KA1503000066,3,17,true,1,1,0,41.83011,-87.67031
278,3,17,true,6,3,-3,41.83062,-87.64129
TA1308000045,3,17,true,10,13,3,41.83062,-87.64129
TA1308000043,3,17,true,9,14,5,41.83066,-87.64715
15446,3,17,true,4,7,3,41.83068,-87.65603
367,3,17,true,1,1,0,41.83069,-87.65604
KA1503000005,3,17,true,6,16,10,41.83079,-87.6325
184,3,17,true,12,5,-7,41.83104,-87.62684
TA1307000129,3,17,true,71,17,-54,41.83104,-87.62683
KA1503000004,3,17,true,10,13,3,41.83127,-87.6088
13345,3,17,true,7,7,0,41.83138,-87.61803
15445,3,17,true,27,18,-9,41.83453,-87.63183
13216,3,17,true,95,43,-52,41.83473,-87.62581
148,3,17,true,14,7,-7,41.83474,-87.62581
149,3,17,true,6,7,1,41.83486,-87.61791
13217,3,17,true,39,69,30,41.83488,-87.61792
13215,3,17,true,19,39,20,41.83634,-87.6135
263,3,17,true,9,2,-7,41.8364,-87.61348
280,3,17,true,1,2,1,41.83779,-87.65116
TA1308000046,3,17,true,16,36,20,41.83779,-87.65115
339,3,17,true,4,9,5,41.83817,-87.64523
TA1309000055,3,17,true,37,64,27,41.8382,-87.64514
KA1503000038,3,17,true,29,21,-8,41.83845,-87.6354
402,3,17,true,3,10,7,41.83845,-87.6354
150,3,17,true,9,7,-2,41.83855,-87.60821
TA1307000048,3,17,true,51,49,-2,41.83855,-87.60821
272,3,17,true,4,4,0,41.83882,-87.62186
TA1308000036,3,17,true,26,51,25,41.83883,-87.62186
15442,3,17,true,10,9,-1,41.83918,-87.66562
KA1503000040,3,17,true,4,27,23,41.84164,-87.65744
13213,3,17,true,7,2,-5,41.84171,-87.62694
237,3,17,true,17,10,-7,41.84204,-87.61697
TA1307000139,3,17,true,66,47,-19,41.84205,-87.61698
15443,3,17,true,11,6,-5,41.84275,-87.63549
207,3,17,true,5,4,-1,41.84358,-87.64539
TA1307000153,3,17,true,16,32,16,41.84358,-87.64538
15692,3,17,true,2,1,-1,41.84404,-87.69531
15691,3,17,true,1,1,0,41.84449,-87.70203
147,3,17,true,2,8,6,41.84569,-87.62251
TA1307000005,3,17,true,27,21,-6,41.84569,-87.6225
206,3,17,true,1,1,0,41.84719,-87.64683
TA1308000013,3,17,true,11,6,-5,41.84719,-87.64681
TA1309000003,3,17,true,9,6,-3,41.84847,-87.68512
442,3,17,true,2,1,-1,41.84912,-87.69515
15689,3,17,true,3,7,4,41.84912,-87.69515
TA1307000066,3,17,true,3,2,-1,41.8492,-87.67564
TA1308000014,3,17,true,5,11,6,41.84953,-87.64059
209,3,17,true,1,4,3,41.84953,-87.64058
132,3,17,true,1,2,1,41.85008,-87.63215
TA1308000026,3,17,true,12,8,-4,41.85008,-87.63214
TA1305000004,3,17,true,10,12,2,41.8514,-87.61884
62,3,17,true,1,2,1,41.85141,-87.61884
42,3,17,true,3,1,-2,41.85261,-87.62653
TA1305000001,3,17,true,10,29,19,41.85262,-87.6265
13075,3,17,true,64,36,-28,41.8531,-87.63192
120,3,17,true,19,6,-13,41.8531,-87.63191
135,3,17,true,2,3,1,41.85367,-87.64652
13162,3,17,true,5,16,11,41.85378,-87.64659
13096,3,17,true,5,13,8,41.8538,-87.69577
13091,3,17,true,25,10,-15,41.85409,-87.68585
203,3,17,true,6,9,3,41.85409,-87.68585
370,3,17,true,5,4,-1,41.85415,-87.61917
15546,3,17,true,16,31,15,41.85416,-87.61916
351,3,17,true,6,3,-3,41.85441,-87.67678
13307,3,17,true,11,12,1,41.85489,-87.66359
124,3,17,true,3,2,-1,41.85492,-87.67609
13089,3,17,true,20,17,-3,41.85497,-87.67567
13331,3,17,true,4,13,9,41.85515,-87.65414
171,3,17,true,11,4,-7,41.85516,-87.65414
4,3,17,true,29,26,-3,41.85627,-87.61334
15545,3,17,true,101,112,11,41.85627,-87.61334
178,3,17,true,5,3,-2,41.85657,-87.62755
SL-013,3,17,true,31,39,8,41.85659,-87.62755
218,3,17,true,1,5,4,41.85679,-87.63387
SL-006,3,17,true,23,24,1,41.8568,-87.63387
129,3,17,true,7,12,5,41.85752,-87.66158
202,3,17,true,1,2,1,41.85752,-87.64621
13135,3,17,true,36,62,26,41.85753,-87.66157
338,3,17,true,5,7,2,41.85758,-87.61956
13102,3,17,true,63,115,52,41.85762,-87.61942
273,3,17,true,17,14,-3,41.85783,-87.62455
13150,3,17,true,80,100,20,41.85783,-87.62455
13099,3,17,true,33,22,-11,41.85784,-87.64627
205,3,17,true,5,11,6,41.8579,-87.6687
TA1307000159,3,17,true,11,48,37,41.8579,-87.6687
TA1307000044,3,17,true,41,21,-20,41.85794,-87.64083
14,3,17,true,6,3,-3,41.85808,-87.65109
13163,3,17,true,26,45,19,41.85808,-87.65108
13164,3,17,true,41,83,42,41.85818,-87.65648
15,3,17,true,6,11,5,41.85819,-87.65648
SL-012,3,17,true,69,92,23,41.86038,-87.62581
72,3,17,true,7,18,11,41.86039,-87.62581
274,3,17,true,2,6,4,41.86126,-87.6566
13304,3,17,true,23,31,8,41.86126,-87.65659
137,3,17,true,3,8,5,41.86238,-87.65108
TA1306000002,3,17,true,32,82,50,41.86238,-87.65108
TA1307000124,3,17,true,116,207,91,41.86411,-87.62372
168,3,17,true,25,40,15,41.86415,-87.62372
282,3,17,true,11,11,0,41.86487,-87.64708
TA1309000001,3,17,true,50,72,22,41.86488,-87.64708
136,3,17,true,1,2,1,41.86504,-87.65698
13165,3,17,true,8,23,15,41.86505,-87.65697
13354,3,17,true,25,27,2,41.86524,-87.66651
275,3,17,true,5,7,2,41.86524,-87.66651
13029,3,17,true,22,19,-3,41.86531,-87.6179
341,3,17,true,12,11,-1,41.86608,-87.60733
13431,3,17,true,46,45,-1,41.8661,-87.60728
KA1504000101,3,17,true,24,8,-16,41.86651,-87.68466
434,3,17,true,2,3,1,41.86651,-87.68465
KA1504000102,3,17,true,4,1,-3,41.86664,-87.69453
436,3,17,true,2,1,-1,41.86664,-87.69452
WL-008,3,17,true,61,87,26,41.86712,-87.64108
57,3,17,true,17,15,-2,41.86712,-87.64107
59,3,17,true,31,46,15,41.86721,-87.62597
TA1305000002,3,17,true,166,312,146,41.86721,-87.62597
3,3,17,true,6,7,1,41.86723,-87.61536
15544,3,17,true,54,82,28,41.86723,-87.61536
TA1305000017,3,17,true,67,21,-46,41.86734,-87.64863
55,3,17,true,1,4,3,41.86735,-87.64863
KA1706005007,3,17,true,50,44,-6,41.86749,-87.63219
626,3,17,true,9,4,-5,41.86749,-87.63219
SL-005,3,17,true,173,228,55,41.8679,-87.62304
255,3,17,true,21,29,8,41.86791,-87.62304
644,3,17,true,37,39,2,41.86859,-87.68625
19,3,17,true,8,6,-2,41.86892,-87.65913
13139,3,17,true,77,58,-19,41.86893,-87.65913
13285,3,17,true,164,29,-135,41.86928,-87.67372
22,3,17,true,9,16,7,41.86947,-87.65548
13160,3,17,true,87,101,14,41.86947,-87.65548
382,3,17,true,4,3,-1,41.8699,-87.68725
414,3,17,true,1,10,9,41.87023,-87.63947
15550,3,17,true,46,66,20,41.87024,-87.63947
TA1309000010,3,17,true,95,180,85,41.87074,-87.62574
SL-009,3,17,true,27,75,48,41.87081,-87.63121
342,3,17,true,28,7,-21,41.87127,-87.6737
TA1309000064,3,17,true,173,50,-123,41.87127,-87.67369
15542,3,17,true,43,7,-36,41.87146,-87.64095
261,3,17,true,17,6,-11,41.87151,-87.6699
TA1307000130,3,17,true,83,85,2,41.87178,-87.65103
241,3,17,true,13,20,7,41.8718,-87.65102
108,3,17,true,16,25,9,41.87183,-87.64664
TA1307000121,3,17,true,83,113,30,41.87184,-87.64664
41,3,17,true,18,34,16,41.87209,-87.62957
SL-008,3,17,true,139,232,93,41.87209,-87.62956
13332,3,17,true,187,179,-8,41.87219,-87.6615
394,3,17,true,5,9,4,41.87226,-87.63484
175,3,17,true,16,22,6,41.87255,-87.63359
SL-011,3,17,true,74,135,61,41.87256,-87.63356
623,3,17,true,80,108,28,41.87272,-87.62399
KA1504000104,3,17,true,131,20,-111,41.87296,-87.66912
383,3,17,true,34,6,-28,41.87297,-87.66912
16915,3,17,true,1,1,0,41.873,-87.7645
320,3,17,true,23,36,13,41.87327,-87.66402
5,3,17,true,10,11,1,41.87403,-87.6277
SL-007,3,17,true,46,72,26,41.87404,-87.6277
169,3,17,true,1,3,2,41.87424,-87.63959
13326,3,17,true,41,11,-30,41.87425,-87.63958
321,3,17,true,9,26,17,41.87427,-87.63257
TA1306000025,3,17,true,40,35,-5,41.87464,-87.65703
32,3,17,true,5,5,0,41.87464,-87.65703
15668,3,17,true,16,10,-6,41.87471,-87.68642
109,3,17,true,8,13,5,41.87475,-87.64981
13028,3,17,true,59,67,8,41.87475,-87.64981
13081,3,17,true,83,16,-67,41.87501,-87.67326
122,3,17,true,9,5,-4,41.87501,-87.67325
89,3,17,true,10,11,1,41.87501,-87.6331
SL-010,3,17,true,91,83,-8,41.87501,-87.63309
15541,3,17,true,28,30,2,41.8758,-87.62086
68,3,17,true,11,2,-9,41.87587,-87.64077
13037,3,17,true,52,19,-33,41.87588,-87.64078
50,3,17,true,14,11,-3,41.87592,-87.6307
TA1305000009,3,17,true,91,71,-20,41.87593,-87.63068
317,3,17,true,55,4,-51,41.87603,-87.68195
TA1305000010,3,17,true,35,23,-12,41.87623,-87.62444
45,3,17,true,10,6,-4,41.87623,-87.62444
624,3,17,true,131,87,-44,41.87626,-87.62923
2,3,17,true,7,4,-3,41.87649,-87.62051
33,3,17,true,16,6,-10,41.87715,-87.62786
TA1305000035,3,17,true,124,50,-74,41.87716,-87.62787
13138,3,17,true,157,51,-106,41.87723,-87.63941
75,3,17,true,11,15,4,41.87724,-87.63937
631,3,17,true,25,3,-22,41.87761,-87.6739
15539,3,17,true,108,109,1,41.87763,-87.64405
13158,3,17,true,102,201,99,41.87764,-87.64957
134,3,17,true,23,17,-6,41.87764,-87.64954
21,3,17,true,19,22,3,41.87773,-87.6548
13157,3,17,true,95,133,38,41.87773,-87.6548
TA1305000025,3,17,true,172,69,-103,41.87773,-87.63528
36,3,17,true,28,11,-17,41.87776,-87.63525
TA1309000002,3,17,true,68,32,-36,41.87784,-87.62408
284,3,17,true,15,7,-8,41.87784,-87.62408
146,3,17,true,5,13,8,41.87794,-87.66201
13206,3,17,true,72,82,10,41.87794,-87.66201
283,3,17,true,31,6,-25,41.87809,-87.63183
TA1309000004,3,17,true,158,34,-124,41.87811,-87.63184
107,3,17,true,26,37,11,41.87822,-87.644
638,3,17,true,276,178,-98,41.87827,-87.64078
37,3,17,true,30,8,-22,41.87921,-87.62975
TA1305000005,3,17,true,200,33,-167,41.87924,-87.62975
286,3,17,true,25,2,-23,41.8793,-87.6355
13011,3,17,true,351,240,-111,41.87931,-87.63993
TA1309000008,3,17,true,112,32,-80,41.87933,-87.6355
192,3,17,true,26,18,-8,41.87935,-87.63997
KA1503000034,3,17,true,89,7,-82,41.87938,-87.63197
40,3,17,true,14,1,-13,41.87944,-87.63197
39,3,17,true,17,10,-7,41.87948,-87.62571
KA1503000015,3,17,true,120,52,-68,41.87948,-87.6257
15667,3,17,true,16,16,0,41.8798,-87.68609
381,3,17,true,1,4,3,41.87981,-87.68607
16916,3,17,true,2,6,4,41.88012,-87.76323
542,3,17,true,1,2,1,41.88013,-87.76322
287,3,17,true,58,13,-45,41.88017,-87.63527
TA1309000007,3,17,true,277,29,-248,41.88022,-87.63526
WL-011,3,17,true,85,69,-16,41.88034,-87.64273
73,3,17,true,16,20,4,41.8804,-87.64273
80,3,17,true,14,29,15,41.88042,-87.65556
13156,3,17,true,125,194,69,41.88042,-87.65554
13300,3,17,true,130,200,70,41.88097,-87.61675
76,3,17,true,33,39,6,41.88098,-87.61675
13008,3,17,true,167,88,-79,41.88105,-87.62408
90,3,17,true,16,12,-4,41.88107,-87.62409
49,3,17,true,57,10,-47,41.88116,-87.62963
TA1305000006,3,17,true,329,88,-241,41.88122,-87.6296
13134,3,17,true,17,23,6,41.88138,-87.67493
215,3,17,true,7,3,-4,41.88139,-87.67492
396,3,17,true,2,2,0,41.88159,-87.7044
13056,3,17,true,115,97,-18,41.88168,-87.63951
191,3,17,true,10,16,6,41.88169,-87.63951
198,3,17,true,22,40,18,41.88187,-87.6488
TA1307000120,3,17,true,202,261,59,41.88188,-87.64879
13341,3,17,true,254,153,-101,41.88208,-87.63985
174,3,17,true,23,14,-9,41.88208,-87.63984
197,3,17,true,17,7,-10,41.88208,-87.62513
13036,3,17,true,104,60,-44,41.8821,-87.62513
77,3,17,true,47,34,-13,41.88214,-87.64108
TA1305000032,3,17,true,303,289,-14,41.88218,-87.64109
98,3,17,true,38,15,-23,41.88266,-87.63251
13006,3,17,true,186,33,-153,41.88268,-87.63252
13353,3,17,true,56,97,41,41.88283,-87.6612
346,3,17,true,17,19,2,41.88284,-87.6612
654,3,17,true,60,67,7,41.88307,-87.65698
233,3,17,true,13,24,11,41.88309,-87.6511
13409,3,17,true,107,117,10,41.8831,-87.6511
18,3,17,true,24,8,-16,41.88317,-87.63735
KA1503000072,3,17,true,136,40,-96,41.88317,-87.63693
91,3,17,true,36,32,-4,41.88336,-87.64122
WL-012,3,17,true,468,357,-111,41.88337,-87.6412
112,3,17,true,26,25,-1,41.88362,-87.6486
13053,3,17,true,174,182,8,41.88365,-87.64863
43,3,17,true,16,22,6,41.88396,-87.62455
13001,3,17,true,238,115,-123,41.88397,-87.62459
88,3,17,true,2,10,8,41.88407,-87.65691
13155,3,17,true,53,45,-8,41.88407,-87.65689
621,3,17,true,14,15,1,41.88412,-87.65427
18062,3,17,true,103,110,7,41.88412,-87.65427
81,3,17,true,58,32,-26,41.88417,-87.6296
TA1306000010,3,17,true,342,129,-213,41.88419,-87.62961
15666,3,17,true,1,5,4,41.88446,-87.6963
KA1504000106,3,17,true,5,7,2,41.88459,-87.70631
TA1305000030,3,17,true,370,67,-303,41.88459,-87.63178
15535,3,17,true,119,100,-19,41.8846,-87.64455
96,3,17,true,12,23,11,41.8846,-87.64455
51,3,17,true,33,6,-27,41.88462,-87.63176
TA1305000029,3,17,true,213,125,-88,41.88466,-87.62787
195,3,17,true,45,47,2,41.88466,-87.61952
13263,3,17,true,177,217,40,41.88467,-87.61952
44,3,17,true,20,21,1,41.88468,-87.62782
528,3,17,true,1,5,4,41.88537,-87.72661
TA1306000015,3,17,true,195,141,-54,41.88549,-87.65232
71,3,17,true,17,18,1,41.8855,-87.65233
66,3,17,true,23,19,-4,41.88557,-87.64186
13021,3,17,true,270,176,-94,41.88559,-87.64184
TA1307000111,3,17,true,223,64,-159,41.88582,-87.63548
164,3,17,true,37,5,-32,41.88583,-87.63547
13073,3,17,true,34,43,9,41.88592,-87.66717
119,3,17,true,8,11,3,41.88593,-87.66717
KA17018054,3,17,true,35,14,-21,41.88595,-87.67701
656,3,17,true,10,6,-4,41.88595,-87.67701
KA1503000012,3,17,true,243,82,-161,41.88599,-87.63089
38,3,17,true,40,11,-29,41.88599,-87.63089
52,3,17,true,50,19,-31,41.886,-87.62421
TA1305000011,3,17,true,214,84,-130,41.886,-87.62418
7,3,17,true,16,22,6,41.88627,-87.61751
15534,3,17,true,105,118,13,41.88627,-87.61749
217,3,17,true,13,6,-7,41.8866,-87.65821
13197,3,17,true,79,52,-27,41.8866,-87.65816
264,3,17,true,24,8,-16,41.8867,-87.62224
TA1308000029,3,17,true,91,50,-41,41.88673,-87.62225
TA1307000131,3,17,true,163,53,-110,41.88688,-87.62606
194,3,17,true,25,2,-23,41.88688,-87.62606
6,3,17,true,8,15,7,41.88697,-87.61281
KA1503000064,3,17,true,96,221,125,41.88697,-87.61281
16905,3,17,true,1,1,0,41.88767,-87.76547
16906,3,17,true,1,13,12,41.88792,-87.77445
100,3,17,true,52,31,-21,41.88814,-87.63657
TA1305000022,3,17,true,246,130,-116,41.88817,-87.63656
56,3,17,true,64,43,-21,41.88866,-87.64442
TA1306000003,3,17,true,269,278,9,41.88867,-87.64442
KA1503000043,3,17,true,401,335,-66,41.88918,-87.63851
133,3,17,true,47,62,15,41.88918,-87.63851
13050,3,17,true,229,106,-123,41.88919,-87.62775
47,3,17,true,38,16,-22,41.88921,-87.62775
15664,3,17,true,14,19,5,41.8895,-87.68821
376,3,17,true,11,3,-8,41.88951,-87.68818
13432,3,17,true,86,52,-34,41.88989,-87.67149
285,3,17,true,12,7,-5,41.88989,-87.67149
TA1307000151,3,17,true,325,196,-129,41.88993,-87.63427
212,3,17,true,71,29,-42,41.88995,-87.63427
636,3,17,true,147,99,-48,41.88997,-87.63662
378,3,17,true,1,1,0,41.89014,-87.71289
125,3,17,true,23,14,-9,41.89018,-87.62621
KA1503000044,3,17,true,105,70,-35,41.89018,-87.6262
196,3,17,true,26,21,-5,41.89053,-87.62205
13427,3,17,true,111,90,-21,41.89054,-87.62205
26,3,17,true,22,36,14,41.89057,-87.61798
13430,3,17,true,232,201,-31,41.89077,-87.63169
181,3,17,true,26,14,-12,41.89077,-87.63168
TA1306000013,3,17,true,142,207,65,41.89083,-87.61852
RN-,3,17,true,175,145,-30,41.89102,-87.63546
672,3,17,true,27,26,-1,41.89102,-87.63545
277,3,17,true,11,10,-1,41.89108,-87.66665
13434,3,17,true,29,49,20,41.89108,-87.66663
TA1308000006,3,17,true,46,60,14,41.89128,-87.67686
199,3,17,true,32,30,-2,41.89143,-87.62676
TA1307000117,3,17,true,252,179,-73,41.89144,-87.62675
13033,3,17,true,166,167,1,41.8916,-87.64835
214,3,17,true,11,11,0,41.89161,-87.67688
84,3,17,true,12,18,6,41.89161,-87.64833
186,3,17,true,12,17,5,41.8918,-87.65879
13194,3,17,true,89,116,27,41.8918,-87.65878
TA1305000003,3,17,true,164,168,4,41.89187,-87.62061
24,3,17,true,29,30,1,41.8919,-87.62063
643,3,17,true,8,23,15,41.89203,-87.68939
35,3,17,true,26,36,10,41.89227,-87.61206
13022,3,17,true,220,201,-19,41.89227,-87.61205
99,3,17,true,20,22,2,41.89255,-87.61449
TA1306000029,3,17,true,146,140,-6,41.89256,-87.61449
13265,3,17,true,260,231,-29,41.89383,-87.64172
74,3,17,true,22,50,28,41.89384,-87.64173
13045,3,17,true,272,318,46,41.89403,-87.62931
110,3,17,true,41,37,-4,41.89406,-87.6293
13016,3,17,true,385,110,-275,41.89431,-87.62277
211,3,17,true,95,10,-85,41.89439,-87.62267
KA1503000041,3,17,true,192,118,-74,41.89452,-87.61798
142,3,17,true,71,25,-46,41.89453,-87.61806
92,3,17,true,15,23,8,41.89455,-87.65346
13196,3,17,true,84,103,19,41.89455,-87.65345
TA1307000062,3,17,true,165,108,-57,41.89466,-87.63839
111,3,17,true,36,14,-22,41.89466,-87.63837
TA1306000012,3,17,true,285,262,-23,41.89475,-87.63438
53,3,17,true,50,62,12,41.89476,-87.63439
627,3,17,true,17,21,4,41.8948,-87.63231
KP1705001026,3,17,true,150,118,-32,41.89483,-87.6323
16920,3,17,true,2,2,0,41.89495,-87.76491
550,3,17,true,1,1,0,41.89495,-87.76491
659,3,17,true,2,9,7,41.8955,-87.68201
18058,3,17,true,24,43,19,41.8955,-87.68201
637,3,17,true,62,104,42,41.89563,-87.67209
128,3,17,true,10,27,17,41.89571,-87.67716
13132,3,17,true,82,133,51,41.89573,-87.67718
161,3,17,true,31,28,-3,41.89574,-87.62599
15530,3,17,true,153,130,-23,41.89575,-87.62596
18003,3,17,true,132,80,-52,41.89575,-87.62011
635,3,17,true,20,10,-10,41.89576,-87.62012
13247,3,17,true,56,97,41,41.89597,-87.66775
350,3,17,true,16,18,2,41.89597,-87.66774
TA1305000020,3,17,true,87,103,16,41.89636,-87.65406
54,3,17,true,12,26,14,41.89637,-87.65407
13289,3,17,true,65,117,52,41.89638,-87.661
86,3,17,true,12,13,1,41.89639,-87.661
337,3,17,true,34,14,-20,41.89659,-87.63096
13303,3,17,true,125,110,-15,41.89672,-87.63088
13017,3,17,true,158,142,-16,41.89676,-87.6357
31,3,17,true,32,32,0,41.89677,-87.63572
13338,3,17,true,156,64,-92,41.89697,-87.62173
173,3,17,true,48,15,-33,41.89704,-87.62173
TA1307000061,3,17,true,76,87,11,41.89745,-87.62873
106,3,17,true,19,16,-3,41.89746,-87.62874
25,3,17,true,27,16,-11,41.89751,-87.62354
13034,3,17,true,120,64,-56,41.89754,-87.62352
48,3,17,true,50,11,-39,41.89772,-87.64302
TA1306000009,3,17,true,264,82,-182,41.89772,-87.64299
620,3,17,true,136,119,-17,41.89817,-87.63754
KA1504000103,3,17,true,62,67,5,41.89842,-87.68659
374,3,17,true,7,21,14,41.89842,-87.68659
145,3,17,true,39,34,-5,41.89856,-87.62211
15529,3,17,true,194,112,-82,41.89858,-87.62206
140,3,17,true,41,46,5,41.89895,-87.6299
TA1307000128,3,17,true,245,295,50,41.89896,-87.6299
657,3,17,true,63,91,28,41.89918,-87.6722
KA1504000117,3,17,true,15,16,1,41.89936,-87.64848
30,3,17,true,10,10,0,41.89964,-87.66789
13248,3,17,true,46,93,47,41.89964,-87.66788
46,3,17,true,16,23,7,41.89994,-87.63444
TA1306000011,3,17,true,83,110,27,41.89994,-87.63443
KA1504000116,3,17,true,94,95,1,41.90023,-87.64299
364,3,17,true,6,13,7,41.90023,-87.64299
17660,3,17,true,38,44,6,41.90036,-87.69671
622,3,17,true,7,7,0,41.90037,-87.69671
29,3,17,true,17,11,-6,41.90069,-87.66259
13290,3,17,true,78,80,2,41.90069,-87.66259
13042,3,17,true,233,153,-80,41.90097,-87.62377
85,3,17,true,43,24,-19,41.90098,-87.62375
183,3,17,true,10,14,4,41.90133,-87.67744
TA1307000070,3,17,true,72,89,17,41.90133,-87.67742
KA1504000133,3,17,true,167,152,-15,41.90234,-87.62773
172,3,17,true,26,29,3,41.90236,-87.62774
15654,3,17,true,8,6,-2,41.90271,-87.70923
510,3,17,true,3,1,-2,41.90272,-87.70923
305,3,17,true,11,5,-6,41.9028,-87.69005
13241,3,17,true,51,35,-16,41.9029,-87.68731
176,3,17,true,53,96,43,41.90291,-87.63141
23,3,17,true,7,20,13,41.90292,-87.63772
TA1306000006,3,17,true,27,67,40,41.90292,-87.63772
TA1307000039,3,17,true,296,466,170,41.90294,-87.63137
658,3,17,true,72,36,-36,41.903,-87.6838
13256,3,17,true,42,19,-23,41.90302,-87.69749
216,3,17,true,9,11,2,41.90302,-87.69749
17,3,17,true,20,17,-3,41.90313,-87.67391
TA1305000034,3,17,true,86,83,-3,41.90313,-87.67391
182,3,17,true,41,56,15,41.90317,-87.63442
KA1504000135,3,17,true,287,406,119,41.90319,-87.63439
13136,3,17,true,70,100,30,41.90326,-87.67845
130,3,17,true,14,21,7,41.90327,-87.67846
210,3,17,true,18,36,18,41.90342,-87.66781
13061,3,17,true,200,198,-2,41.90342,-87.66779
KA1504000079,3,17,true,105,141,36,41.9035,-87.64334
359,3,17,true,19,22,3,41.90458,-87.6497
138,3,17,true,8,26,18,41.9046,-87.64057
TA1307000115,3,17,true,67,66,-1,41.9046,-87.64056
291,3,17,true,32,32,0,41.90672,-87.63494
TA1308000049,3,17,true,108,200,92,41.90672,-87.6349
KA1504000134,3,17,true,93,147,54,41.90687,-87.6262
180,3,17,true,13,23,10,41.90687,-87.62618
333,3,17,true,25,26,1,41.90706,-87.66725
13224,3,17,true,93,105,12,41.90706,-87.66725
18069,3,17,true,80,1,-79,41.90722,-87.65563
666,3,17,true,4,1,-3,41.90723,-87.65564
TA1307000143,3,17,true,27,61,34,41.90762,-87.63854
236,3,17,true,6,14,8,41.90762,-87.63853
61,3,17,true,21,24,3,41.90764,-87.67254
13221,3,17,true,128,158,30,41.90765,-87.67254
13245,3,17,true,27,16,-11,41.90777,-87.68586
159,3,17,true,4,1,-3,41.90777,-87.68586
301,3,17,true,31,43,12,41.90796,-87.63203
TA1309000024,3,17,true,152,247,95,41.908,-87.63152
69,3,17,true,11,31,20,41.90939,-87.6777
TA1305000041,3,17,true,137,172,35,41.9094,-87.67769
508,3,17,true,8,2,-6,41.90964,-87.71664
15652,3,17,true,8,4,-4,41.90965,-87.71664
331,3,17,true,172,267,95,41.90965,-87.64812
15653,3,17,true,17,19,2,41.90979,-87.7053
509,3,17,true,2,2,0,41.9098,-87.70531
TA1305000037,3,17,true,60,89,29,41.91018,-87.67003
27,3,17,true,10,21,11,41.91019,-87.6435
TA1306000008,3,17,true,62,75,13,41.9102,-87.6435
16,3,17,true,20,17,-3,41.91035,-87.67008
213,3,17,true,6,7,1,41.91037,-87.68237
TA1308000005,3,17,true,54,63,9,41.91042,-87.68238
276,3,17,true,9,10,1,41.91043,-87.69718
13258,3,17,true,23,27,4,41.91043,-87.69718
160,3,17,true,5,10,5,41.91054,-87.68957
13257,3,17,true,39,61,22,41.91054,-87.68956
13154,3,17,true,147,190,43,41.91054,-87.65312
20,3,17,true,25,30,5,41.91055,-87.65313
60,3,17,true,12,12,0,41.91059,-87.64942
13058,3,17,true,91,114,23,41.91059,-87.64942
TA1307000038,3,17,true,129,120,-9,41.91138,-87.63868
118,3,17,true,21,25,4,41.91138,-87.63868
268,3,17,true,31,67,36,41.91172,-87.62681
LF-005,3,17,true,179,560,381,41.91172,-87.62681
126,3,17,true,20,27,7,41.91196,-87.63197
13128,3,17,true,77,127,50,41.91197,-87.63197
289,3,17,true,34,46,12,41.91209,-87.63472
TA1308000050,3,17,true,313,364,51,41.91211,-87.6347
158,3,17,true,14,26,12,41.91262,-87.6814
13243,3,17,true,107,143,36,41.91262,-87.6814
315,3,17,true,5,9,4,41.91293,-87.66417
TA1309000032,3,17,true,30,39,9,41.91293,-87.66417
TA1306000032,3,17,true,165,165,0,41.9137,-87.65285
93,3,17,true,26,21,-5,41.91371,-87.65285
TA1307000166,3,17,true,112,95,-17,41.91386,-87.64877
224,3,17,true,13,15,2,41.91386,-87.64877
511,3,17,true,1,2,1,41.914,-87.70515
15655,3,17,true,35,44,9,41.91401,-87.70514
641,3,17,true,2,3,1,41.91416,-87.71676
18017,3,17,true,10,16,6,41.91416,-87.71676
628,3,17,true,7,3,-4,41.9146,-87.66796
18067,3,17,true,49,49,0,41.9146,-87.66796
28,3,17,true,9,19,10,41.91469,-87.64333
TA1306000007,3,17,true,44,65,21,41.91469,-87.64333
13068,3,17,true,79,70,-9,41.91554,-87.68703
116,3,17,true,16,15,-1,41.91555,-87.68703
13179,3,17,true,214,319,105,41.9157,-87.63461
141,3,17,true,32,57,25,41.91571,-87.63461
219,3,17,true,11,21,10,41.91598,-87.67733
13133,3,17,true,65,148,83,41.91598,-87.67733
58,3,17,true,19,14,-5,41.91602,-87.66894
TA1305000039,3,17,true,97,102,5,41.9163,-87.66749
15650,3,17,true,42,23,-19,41.91711,-87.71023
506,3,17,true,4,6,2,41.91711,-87.71023
507,3,17,true,5,9,4,41.91752,-87.70181
15651,3,17,true,36,42,6,41.91752,-87.70181
185,3,17,true,7,12,5,41.91774,-87.69143
13266,3,17,true,23,31,8,41.91774,-87.69142
TA1309000029,3,17,true,41,49,8,41.9178,-87.68245
309,3,17,true,10,6,-4,41.91789,-87.6865
288,3,17,true,9,15,6,41.91809,-87.64375
TA1309000006,3,17,true,80,92,12,41.91809,-87.64375
223,3,17,true,16,27,11,41.91821,-87.65698
TA1307000163,3,17,true,94,112,18,41.91821,-87.65696
94,3,17,true,31,45,14,41.91831,-87.6363
13146,3,17,true,208,246,38,41.91831,-87.63629
13059,3,17,true,188,178,-10,41.91845,-87.65222
113,3,17,true,16,30,14,41.91846,-87.65222
13259,3,17,true,20,25,5,41.91852,-87.69744
259,3,17,true,7,3,-4,41.91853,-87.69745
310,3,17,true,5,9,4,41.91984,-87.68083
225,3,17,true,27,21,-6,41.91995,-87.64884
13192,3,17,true,115,180,65,41.91995,-87.64884
13288,3,17,true,41,63,22,41.92008,-87.67788
13242,3,17,true,26,29,3,41.92021,-87.69266
222,3,17,true,4,4,0,41.92023,-87.69265
307,3,17,true,9,14,5,41.92077,-87.66373
TA1309000030,3,17,true,68,71,3,41.92077,-87.66372
290,3,17,true,5,9,4,41.92152,-87.70734
13292,3,17,true,20,37,17,41.92152,-87.70733
TA1309000033,3,17,true,147,125,-22,41.92158,-87.65381
13193,3,17,true,175,247,72,41.92182,-87.64412
144,3,17,true,50,51,1,41.92182,-87.64411
13191,3,17,true,127,134,7,41.92217,-87.63891
143,3,17,true,11,22,11,41.92217,-87.63891
327,3,17,true,23,27,4,41.92225,-87.65783
13084,3,17,true,64,79,15,41.92268,-87.69715
123,3,17,true,11,11,0,41.92268,-87.69714
LP-,3,17,true,89,95,6,41.92396,-87.63584
673,3,17,true,12,12,0,41.92398,-87.63585
KA1504000140,3,17,true,44,25,-19,41.92409,-87.67646
505,3,17,true,3,5,2,41.92409,-87.67646
619,3,17,true,1,1,0,41.92457,-87.7279
16010,3,17,true,7,14,7,41.92458,-87.72787
504,3,17,true,6,3,-3,41.92464,-87.68931
15648,3,17,true,27,26,-1,41.92464,-87.68931
KA1504000090,3,17,true,8,21,13,41.92483,-87.7145
TA1307000001,3,17,true,110,107,-3,41.92535,-87.66581
188,3,17,true,13,11,-2,41.92536,-87.66581
TA1306000026,3,17,true,137,113,-24,41.92558,-87.65842
87,3,17,true,10,25,15,41.92559,-87.65843
TA1306000016,3,17,true,192,135,-57,41.9256,-87.65371
67,3,17,true,13,12,-1,41.9256,-87.65371
313,3,17,true,26,32,6,41.9257,-87.64246
TA1309000019,3,17,true,157,158,1,41.92586,-87.63897
TA1309000058,3,17,true,194,252,58,41.92591,-87.64927
127,3,17,true,26,33,7,41.92592,-87.64927
177,3,17,true,73,64,-9,41.92627,-87.63086
TA1308000001,3,17,true,248,290,42,41.92627,-87.63086
502,3,17,true,4,7,3,41.92667,-87.69772
15646,3,17,true,17,26,9,41.92668,-87.6977
13124,3,17,true,34,28,-6,41.92675,-87.63444
34,3,17,true,4,4,0,41.92675,-87.63444
302,3,17,true,24,18,-6,41.92859,-87.65421
TA1309000023,3,17,true,113,126,13,41.9287,-87.65383
TA1307000113,3,17,true,72,106,34,41.92878,-87.66391
190,3,17,true,9,19,10,41.92878,-87.6639
166,3,17,true,7,15,8,41.92883,-87.66853
13296,3,17,true,61,65,4,41.92883,-87.66852
343,3,17,true,12,15,3,41.92889,-87.65898
TA1309000059,3,17,true,58,73,15,41.92889,-87.65898
349,3,17,true,26,15,-11,41.92915,-87.6491
TA1309000061,3,17,true,157,161,4,41.92915,-87.64909
258,3,17,true,12,11,-1,41.92946,-87.68417
TA1308000031,3,17,true,41,43,2,41.92946,-87.68417
340,3,17,true,38,37,-1,41.92956,-87.64313
TA1305000014,3,17,true,173,213,40,41.92956,-87.64313
260,3,17,true,7,13,6,41.92958,-87.70791
13085,3,17,true,50,55,5,41.92958,-87.70789
499,3,17,true,4,5,1,41.93056,-87.72381
15643,3,17,true,11,9,-2,41.93057,-87.7238
TA1307000142,3,17,true,183,206,23,41.93125,-87.64432
220,3,17,true,38,41,3,41.93125,-87.64431
13276,3,17,true,138,146,8,41.93132,-87.63874
324,3,17,true,29,32,3,41.93173,-87.64179
501,3,17,true,2,2,0,41.93191,-87.70121
15645,3,17,true,15,21,6,41.93191,-87.70121
163,3,17,true,8,10,2,41.93191,-87.67784
13271,3,17,true,55,39,-16,41.93192,-87.67784
152,3,17,true,20,30,10,41.93221,-87.65864
TA1307000064,3,17,true,194,134,-60,41.93222,-87.65864
TA1306000014,3,17,true,173,138,-35,41.93242,-87.65271
13,3,17,true,28,23,-5,41.93242,-87.65271
329,3,17,true,25,28,3,41.93258,-87.63642
TA1309000039,3,17,true,138,183,45,41.93258,-87.63642
13294,3,17,true,67,61,-6,41.9326,-87.66595
319,3,17,true,12,8,-4,41.93292,-87.67217
332,3,17,true,19,30,11,41.93313,-87.64776
TA1309000036,3,17,true,116,181,65,41.93313,-87.64776
15644,3,17,true,15,20,5,41.93534,-87.71687
500,3,17,true,3,7,4,41.93534,-87.71686
TA1307000006,3,17,true,89,97,8,41.93571,-87.6636
153,3,17,true,21,12,-9,41.93575,-87.66364
162,3,17,true,3,15,12,41.93588,-87.67844
13268,3,17,true,35,34,-1,41.93588,-87.67843
250,3,17,true,4,11,7,41.93609,-87.66984
13269,3,17,true,47,58,11,41.93609,-87.66983
TA1307000052,3,17,true,164,130,-34,41.93628,-87.65266
115,3,17,true,33,22,-11,41.93628,-87.65266
156,3,17,true,40,44,4,41.9365,-87.64756
TA1307000136,3,17,true,184,207,23,41.9365,-87.64755
TA1307000041,3,17,true,139,205,66,41.93669,-87.63683
157,3,17,true,42,45,3,41.9367,-87.63683
13137,3,17,true,207,268,61,41.9376,-87.6441
300,3,17,true,51,48,-3,41.93761,-87.6441
15642,3,17,true,16,16,0,41.93843,-87.69801
498,3,17,true,2,6,4,41.93843,-87.69801
154,3,17,true,14,13,-1,41.93912,-87.66384
664,3,17,true,6,5,-1,41.93934,-87.68327
KA17018068,3,17,true,26,43,17,41.93935,-87.68327
TA1309000042,3,17,true,91,111,20,41.93937,-87.66836
131,3,17,true,15,20,5,41.93937,-87.66835
KA150400009X,3,17,true,19,11,-8,41.9394,-87.71159
15640,3,17,true,3,11,8,41.93941,-87.72357
497,3,17,true,2,2,0,41.93941,-87.71159
13229,3,17,true,80,77,-3,41.93946,-87.66376
226,3,17,true,20,11,-9,41.93972,-87.65886
TA1308000019,3,17,true,120,89,-31,41.93973,-87.65886
360,3,17,true,1,1,0,41.94,-87.74
296,3,17,true,32,32,0,41.9401,-87.64546
13277,3,17,true,138,151,13,41.9401,-87.64546
TA1307000134,3,17,true,248,171,-77,41.94016,-87.65303
117,3,17,true,46,47,1,41.94016,-87.65302
228,3,17,true,4,4,0,41.94058,-87.67854
13143,3,17,true,16,27,11,41.94059,-87.67853
334,3,17,true,40,39,-1,41.94076,-87.63919
TA1309000049,3,17,true,146,157,11,41.94077,-87.63919
308,3,17,true,6,7,1,41.94152,-87.68471
15634,3,17,true,17,12,-5,41.94304,-87.68729
493,3,17,true,6,8,2,41.94304,-87.68729
TA1307000138,3,17,true,88,121,33,41.94334,-87.67094
230,3,17,true,14,25,11,41.94335,-87.67093
13144,3,17,true,38,48,10,41.9434,-87.67964
TA1309000025,3,17,true,158,138,-20,41.94368,-87.64894
299,3,17,true,19,31,12,41.94368,-87.64894
229,3,17,true,14,19,5,41.94372,-87.66401
13071,3,17,true,150,161,11,41.94373,-87.66401
632,3,17,true,137,151,14,41.94453,-87.6547
303,3,17,true,28,33,5,41.94522,-87.64702
490,3,17,true,2,7,5,41.94523,-87.70664
15631,3,17,true,9,21,12,41.94524,-87.70665
13278,3,17,true,149,151,2,41.94553,-87.64644
TA1309000050,3,17,true,33,26,-7,41.94618,-87.67331
330,3,17,true,3,4,1,41.94618,-87.67331
KA1504000141,3,17,true,1,4,3,41.94627,-87.73105
492,3,17,true,2,5,3,41.94662,-87.68337
491,3,17,true,3,1,-2,41.94664,-87.69463
15632,3,17,true,10,17,7,41.94664,-87.69463
KA1504000143,3,17,true,13,34,21,41.94664,-87.68337
KA1504000142,3,17,true,6,5,-1,41.94735,-87.71759
489,3,17,true,2,2,0,41.94736,-87.7176
16994,3,17,true,2,5,3,41.94784,-87.74
227,3,17,true,19,30,11,41.94813,-87.66397
13235,3,17,true,170,148,-22,41.94814,-87.66396
304,3,17,true,30,40,10,41.94878,-87.64922
257,3,17,true,6,11,5,41.9488,-87.67527
13253,3,17,true,55,61,6,41.9488,-87.67527
13325,3,17,true,147,185,38,41.94907,-87.64863
114,3,17,true,20,17,-3,41.94935,-87.65451
TA1307000126,3,17,true,103,164,61,41.94936,-87.65451
232,3,17,true,33,55,22,41.94943,-87.64645
TA1307000150,3,17,true,162,227,65,41.94945,-87.64646
640,3,17,true,1,3,2,41.94993,-87.71396
18016,3,17,true,8,8,0,41.94993,-87.71395
347,3,17,true,9,11,2,41.95068,-87.6687
13319,3,17,true,64,47,-17,41.95069,-87.6687
TA1307000127,3,17,true,106,117,11,41.9508,-87.65918
165,3,17,true,21,22,1,41.95081,-87.65918
487,3,17,true,3,3,0,41.95216,-87.69806
15628,3,17,true,9,16,7,41.95216,-87.69806
318,3,17,true,14,8,-6,41.95254,-87.6735
256,3,17,true,17,12,-5,41.95282,-87.65
13323,3,17,true,79,98,19,41.95282,-87.65
15624,3,17,true,16,2,-14,41.95339,-87.73199
483,3,17,true,4,2,-2,41.9534,-87.73199
314,3,17,true,6,3,-3,41.9535,-87.69199
485,3,17,true,1,4,3,41.95361,-87.70933
KA1504000096,3,17,true,2,2,0,41.95361,-87.70932
KA1504000139,3,17,true,4,4,0,41.954,-87.71909
TA1309000043,3,17,true,54,65,11,41.95417,-87.66434
240,3,17,true,13,15,2,41.95424,-87.65441
13063,3,17,true,99,102,3,41.95424,-87.65441
486,3,17,true,2,1,-1,41.95431,-87.68607
KA1504000158,3,17,true,17,15,-2,41.95432,-87.68607
254,3,17,true,34,26,-8,41.95438,-87.64806
TA1308000022,3,17,true,141,127,-14,41.95438,-87.64805
589,3,17,true,1,2,1,41.95447,-87.7496
16991,3,17,true,1,5,4,41.95448,-87.7496
244,3,17,true,12,8,-4,41.95466,-87.67391
TA1307000149,3,17,true,97,56,-41,41.95467,-87.67392
298,3,17,true,7,13,6,41.95601,-87.68021
TA1309000026,3,17,true,44,42,-2,41.95601,-87.6802
246,3,17,true,4,3,-1,41.95606,-87.66885
13249,3,17,true,12,20,8,41.95606,-87.66885
312,3,17,true,24,22,-2,41.95637,-87.6563
292,3,17,true,3,1,-2,41.95709,-87.6642
TA1308000047,3,17,true,26,26,0,41.95709,-87.6642
13379,3,17,true,121,129,8,41.95786,-87.6495
TA1309000018,3,17,true,51,29,-22,41.95791,-87.67357
316,3,17,true,7,7,0,41.95841,-87.69401
306,3,17,true,12,14,2,41.9585,-87.655
TA1309000027,3,17,true,58,86,28,41.9585,-87.65499
592,3,17,true,7,1,-6,41.96065,-87.74538
13389,3,17,true,85,102,17,41.961,-87.64958
245,3,17,true,12,20,8,41.96101,-87.64958
15621,3,17,true,23,15,-8,41.96103,-87.70586
480,3,17,true,5,3,-2,41.96104,-87.70586
KA1706005015,3,17,true,3,3,0,41.96108,-87.73569
481,3,17,true,5,8,3,41.96108,-87.69544
15622,3,17,true,8,34,26,41.96108,-87.69544
KA1504000097,3,17,true,19,13,-6,41.96116,-87.71658
238,3,17,true,16,17,1,41.96141,-87.6762
TA1307000144,3,17,true,45,46,1,41.96142,-87.6762
297,3,17,true,2,8,6,41.9615,-87.67141
TA1309000021,3,17,true,32,35,3,41.9615,-87.6714
482,3,17,true,7,11,4,41.96154,-87.69117
15623,3,17,true,20,33,13,41.96154,-87.69117
234,3,17,true,10,8,-2,41.96158,-87.6661
KA1503000022,3,17,true,51,53,2,41.96158,-87.66609
231,3,17,true,27,30,3,41.96163,-87.65464
TA1307000107,3,17,true,124,112,-12,41.96164,-87.65464
TA1307000156,3,17,true,39,54,15,41.96301,-87.68479
243,3,17,true,10,3,-7,41.96302,-87.68479
TA1309000012,3,17,true,37,34,-3,41.96325,-87.67928
249,3,17,true,34,32,-2,41.96398,-87.63818
TA1308000012,3,17,true,79,147,68,41.96398,-87.63818
293,3,17,true,17,9,-8,41.96521,-87.65822
13074,3,17,true,110,78,-32,41.96521,-87.6582
639,3,17,true,94,127,33,41.96584,-87.64538
477,3,17,true,9,4,-5,41.96587,-87.70083
KA1504000127,3,17,true,12,12,0,41.96587,-87.70083
KA1504000093,3,17,true,29,34,5,41.96587,-87.69365
478,3,17,true,3,8,5,41.96587,-87.69364
TA1307000140,3,17,true,32,62,30,41.96643,-87.68865
239,3,17,true,14,20,6,41.9665,-87.68843
326,3,17,true,19,10,-9,41.96665,-87.67113
476,3,17,true,1,2,1,41.96668,-87.70807
KA1504000126,3,17,true,4,13,9,41.96668,-87.70807
TA1309000014,3,17,true,80,82,2,41.96709,-87.66744
TA1307000158,3,17,true,56,38,-18,41.9671,-87.67904
242,3,17,true,5,12,7,41.9671,-87.67904
251,3,17,true,16,13,-3,41.96796,-87.65
TA1307000119,3,17,true,34,42,8,41.96796,-87.65
15615,3,17,true,10,8,-2,41.96835,-87.71183
474,3,17,true,1,2,1,41.96835,-87.71182
323,3,17,true,13,9,-4,41.96869,-87.66034
253,3,17,true,10,8,-2,41.96883,-87.65765
TA1308000021,3,17,true,36,42,6,41.96883,-87.65765
475,3,17,true,11,17,6,41.96885,-87.69611
KA1504000080,3,17,true,34,50,16,41.96887,-87.69609
TA1309000015,3,17,true,26,23,-3,41.96889,-87.68401
311,3,17,true,2,7,5,41.9689,-87.68402
TA1309000066,3,17,true,191,121,-70,41.9691,-87.67423
344,3,17,true,32,28,-4,41.9691,-87.67423
TA1309000041,3,17,true,52,45,-7,41.96951,-87.65471
KA1504000171,3,17,true,55,54,-1,41.97161,-87.65016
465,3,17,true,9,19,10,41.97161,-87.65016
325,3,17,true,7,15,8,41.9728,-87.67186
TA1309000035,3,17,true,102,122,20,41.97335,-87.66785
295,3,17,true,14,13,-1,41.97378,-87.65972
13108,3,17,true,75,47,-28,41.97379,-87.65971
KA1504000078,3,17,true,18,30,12,41.97491,-87.69258
472,3,17,true,4,8,4,41.97492,-87.69262
464,3,17,true,3,6,3,41.97562,-87.67945
KA1504000149,3,17,true,30,37,7,41.97562,-87.67945
471,3,17,true,4,5,1,41.97564,-87.70143
KA1504000160,3,17,true,10,19,9,41.97564,-87.70143
470,3,17,true,1,2,1,41.97567,-87.70927
KA1504000128,3,17,true,5,8,3,41.97567,-87.70927
463,3,17,true,12,23,11,41.978,-87.66805
KA1504000146,3,17,true,50,79,29,41.978,-87.66805
294,3,17,true,24,21,-3,41.97835,-87.65976
13109,3,17,true,49,61,12,41.97835,-87.65976
KA1504000147,3,17,true,15,29,14,41.97976,-87.67754
655,3,17,true,14,13,-1,41.97987,-87.68194
KA1504000161,3,17,true,7,8,1,41.98038,-87.71612
KA1504000167,3,17,true,3,8,5,41.98206,-87.70895
460,3,17,true,5,11,6,41.98358,-87.66916
KA1504000151,3,17,true,51,90,39,41.98359,-87.66916
15585,3,17,true,5,3,-2,41.98367,-87.69642
459,3,17,true,22,33,11,41.98403,-87.65231
KA1504000152,3,17,true,105,127,22,41.98403,-87.65231
15578,3,17,true,57,51,-6,41.98405,-87.66027
461,3,17,true,13,8,-5,41.98405,-87.66027
353,3,17,true,1,3,2,41.98656,-87.70761
15575,3,17,true,51,62,11,41.98975,-87.66014
458,3,17,true,14,7,-7,41.98975,-87.66013
457,3,17,true,5,3,-2,41.99052,-87.66982
KA1504000148,3,17,true,15,36,21,41.99086,-87.66971
KA1504000155,3,17,true,5,5,0,41.99118,-87.68359
452,3,17,true,1,3,2,41.99417,-87.68945
KA1504000129,3,17,true,5,9,4,41.99417,-87.68945
15571,3,17,true,79,48,-31,41.99478,-87.66028
454,3,17,true,15,8,-7,41.99478,-87.66027
KA1504000156,3,17,true,26,13,-13,41.99925,-87.67137
453,3,17,true,6,3,-3,41.99925,-87.67137
RP-009,3,17,true,43,27,-16,42.00107,-87.66122
451,3,17,true,6,7,1,42.00108,-87.66123
RP-001,3,17,true,7,7,0,42.00179,-87.68883
449,3,17,true,2,3,1,42.00446,-87.67241
RP-008,3,17,true,25,25,0,42.00446,-87.6724
RP-002,3,17,true,6,6,0,42.00456,-87.68065
660,3,17,true,22,27,5,42.00458,-87.66143
KA1504000175,3,17,true,50,47,-3,42.00797,-87.66549
447,3,17,true,5,4,-1,42.00797,-87.66548
RP-005,3,17,true,22,13,-9,42.0086,-87.69047
467,3,17,true,9,5,-4,42.0086,-87.69047
KA1504000162,3,17,true,28,13,-15,42.00907,-87.67422
KA1504000159,3,17,true,10,24,14,42.01059,-87.66241
RP-006,3,17,true,3,12,9,42.01213,-87.68292
RP-004,3,17,true,3,3,0,42.01234,-87.68825
RP-007,3,17,true,13,13,0,42.01256,-87.67431
525,3,17,true,15,19,4,42.01272,-87.66605
517,3,17,true,20,15,-5,42.01597,-87.675
520,3,17,true,29,32,3,42.01597,-87.66859
519,3,17,true,2,2,0,42.01696,-87.67773
527,3,17,true,1,4,3,42.01892,-87.69004
515,3,17,true,15,10,-5,42.01915,-87.67356
514,3,17,true,1,4,3,42.01927,-87.68452
16806,3,17,true,1,20,19,42.01953,-87.66955
523,3,17,true,22,26,4,42.02089,-87.66505
662,3,17,true,3,2,-1,42.02354,-87.69961
598,3,17,true,5,12,7,42.02578,-87.68411
597,3,17,true,4,16,12,42.03256,-87.67914
E002,3,17,true,20,46,26,42.03256,-87.67912
E011,3,17,true,6,3,-3,42.03473,-87.69912
599,3,17,true,20,7,-13,42.03972,-87.69942
625,3,17,true,5,1,-4,42.04163,-87.6808
596,3,17,true,63,76,13,42.04822,-87.68348
600,3,17,true,11,10,-1,42.04831,-87.6983
603,3,17,true,2,2,0,42.05049,-87.67782
E008,3,17,true,15,17,2,42.05049,-87.67782
605,3,17,true,49,8,-41,42.05294,-87.67342
661,3,17,true,16,2,-14,42.05704,-87.68657
604,3,17,true,62,18,-44,42.05824,-87.67744
E006,3,17,true,6,8,2,42.06367,-87.69871
601,3,17,true,5,2,-3,42.06368,-87.69871
E007,3,17,true,4,14,10,42.06431,-87.68615
602,3,17,true,5,5,0,42.06431,-87.68614
E014,3,17,true,1,10,9,42.06483,-87.71531
20232,4,9,false,1,1,0,41.68588,-87.57378
20243,4,9,false,1,1,0,41.68701,-87.62111
20125,4,9,false,1,2,1,41.70517,-87.64242
20134,4,9,false,1,1,0,41.71,-87.6
20226,4,9,false,1,1,0,41.71336,-87.56586
20227,4,9,false,3,1,-2,41.7179,-87.56461
20238,4,9,false,2,1,-1,41.7187,-87.597
20118,4,9,false,1,1,0,41.72762,-87.63487
692,4,9,false,1,2,1,41.7337,-87.55844
20116,4,9,false,1,2,1,41.73652,-87.60126
20120,4,9,false,1,1,0,41.74372,-87.63409
584,4,9,false,1,2,1,41.74412,-87.59905
583,4,9,false,1,2,1,41.74656,-87.58599
576,4,9,false,1,2,1,41.75129,-87.59752
KA1503000028,4,9,false,4,1,-3,41.75712,-87.57585
12,4,9,false,1,1,0,41.76641,-87.5657
KA1503000002,4,9,false,1,2,1,41.76641,-87.5657
KA1503000045,4,9,false,1,1,0,41.76649,-87.58647
KA1503000018,4,9,false,1,1,0,41.76663,-87.57645
KA1503000030,4,9,false,2,3,1,41.77352,-87.57722
KA1503000029,4,9,false,1,3,2,41.77364,-87.56747
KA1503000031,4,9,false,4,3,-1,41.77373,-87.60564
429,4,9,false,1,5,4,41.77373,-87.60564
564,4,9,false,1,1,0,41.7754,-87.6543
KA1503000053,4,9,false,2,1,-1,41.78009,-87.61595
KA1503000054,4,9,false,1,5,4,41.78061,-87.60582
15491,4,9,false,6,1,-5,41.78096,-87.57624
562,4,9,false,2,1,-1,41.78319,-87.65437
426,4,9,false,11,3,-8,41.7851,-87.60108
KA1503000014,4,9,false,18,14,-4,41.7851,-87.60108
561,4,9,false,1,1,0,41.7857,-87.67409
KA1503000070,4,9,false,5,2,-3,41.78794,-87.58831
328,4,9,false,1,9,8,41.78872,-87.6013
TA1309000011,4,9,false,4,13,9,41.78873,-87.60131
423,4,9,false,5,10,5,41.79148,-87.59988
KA1503000071,4,9,false,5,34,29,41.79148,-87.59988
424,4,9,false,1,1,0,41.79174,-87.58395
KA1503000074,4,9,false,14,16,2,41.79174,-87.58395
TA1309000063,4,9,false,10,8,-2,41.79325,-87.5878
KA1503000073,4,9,false,1,2,1,41.79345,-87.61585
559,4,9,false,1,2,1,41.79423,-87.65509
420,4,9,false,1,4,3,41.79429,-87.60145
KA1504000076,4,9,false,10,12,2,41.7943,-87.60145
TA1307000160,4,9,false,3,3,0,41.79485,-87.61873
247,4,9,false,2,1,-1,41.79522,-87.58077
TA1308000009,4,9,false,16,15,-1,41.79522,-87.58075
TA1307000164,4,9,false,5,3,-2,41.79527,-87.59647
KA1503000052,4,9,false,12,5,-7,41.79935,-87.60097
419,4,9,false,4,2,-2,41.79952,-87.58643
KA1503000059,4,9,false,9,10,1,41.79952,-87.58643
TA1309000037,4,9,false,24,9,-15,41.79957,-87.59474
15470,4,9,false,5,4,-1,41.80228,-87.61807
417,4,9,false,1,1,0,41.80242,-87.5869
KA1503000007,4,9,false,13,3,-10,41.80242,-87.58689
121,4,9,false,2,2,0,41.80256,-87.59035
13398,4,9,false,9,14,5,41.80256,-87.59035
TA1309000067,4,9,false,1,3,2,41.80303,-87.60661
322,4,9,false,6,1,-5,41.80321,-87.59849
594,4,9,false,1,3,2,41.80567,-87.68337
KA1503000069,4,9,false,4,1,-3,41.80579,-87.59247
KA1504000091,4,9,false,1,3,2,41.80823,-87.6772
TA1308000035,4,9,false,4,1,-3,41.80944,-87.59188
TA1308000002,4,9,false,7,3,-4,41.80983,-87.59937
TA1308000007,4,9,false,6,1,-5,41.80984,-87.61628
TA1309000053,4,9,false,2,1,-1,41.80985,-87.60675
KA1503000065,4,9,false,1,6,5,41.81409,-87.59701
TA1308000023,4,9,false,2,2,0,41.81649,-87.60659
KA1503000032,4,9,false,2,1,-1,41.81912,-87.64328
TA1308000038,4,9,false,4,6,2,41.82298,-87.6071
13420,4,9,false,3,2,-1,41.82459,-87.61678
18022,4,9,false,2,2,0,41.82672,-87.68315
TA1308000045,4,9,false,2,3,1,41.83062,-87.64129
TA1308000043,4,9,false,1,2,1,41.83066,-87.64715
279,4,9,false,1,1,0,41.83067,-87.64715
15446,4,9,false,2,2,0,41.83068,-87.65603
TA1307000129,4,9,false,2,11,9,41.83104,-87.62683
KA1503000004,4,9,false,12,3,-9,41.83127,-87.6088
13345,4,9,false,3,6,3,41.83138,-87.61803
13216,4,9,false,3,5,2,41.83473,-87.62581
13217,4,9,false,11,4,-7,41.83488,-87.61792
13215,4,9,false,4,4,0,41.83634,-87.6135
263,4,9,false,1,1,0,41.8364,-87.61348
280,4,9,false,1,1,0,41.83779,-87.65116
TA1308000046,4,9,false,4,2,-2,41.83779,-87.65115
339,4,9,false,1,2,1,41.83817,-87.64523
TA1309000055,4,9,false,5,15,10,41.8382,-87.64514
KA1503000038,4,9,false,3,4,1,41.83845,-87.6354
150,4,9,false,2,1,-1,41.83855,-87.60821
TA1307000048,4,9,false,4,8,4,41.83855,-87.60821
272,4,9,false,3,1,-2,41.83882,-87.62186
TA1308000036,4,9,false,8,1,-7,41.83883,-87.62186
KA1504000168,4,9,false,1,1,0,41.84152,-87.68514
TA1307000139,4,9,false,2,1,-1,41.84205,-87.61698
15443,4,9,false,3,1,-2,41.84275,-87.63549
TA1307000153,4,9,false,2,1,-1,41.84358,-87.64538
15692,4,9,false,1,4,3,41.84404,-87.69531
147,4,9,false,1,1,0,41.84569,-87.62251
TA1307000005,4,9,false,5,4,-1,41.84569,-87.6225
TA1308000026,4,9,false,3,2,-1,41.85008,-87.63214
TA1305000004,4,9,false,11,9,-2,41.8514,-87.61884
TA1305000001,4,9,false,7,1,-6,41.85262,-87.6265
13075,4,9,false,6,6,0,41.8531,-87.63192
13162,4,9,false,4,6,2,41.85378,-87.64659
13096,4,9,false,1,3,2,41.8538,-87.69577
15546,4,9,false,3,2,-1,41.85416,-87.61916
208,4,9,false,1,1,0,41.85489,-87.66359
13307,4,9,false,2,3,1,41.85489,-87.66359
13331,4,9,false,5,5,0,41.85515,-87.65414
15545,4,9,false,11,12,1,41.85627,-87.61334
218,4,9,false,1,1,0,41.85679,-87.63387
13135,4,9,false,9,6,-3,41.85753,-87.66157
13102,4,9,false,10,4,-6,41.85762,-87.61942
13150,4,9,false,16,14,-2,41.85783,-87.62455
205,4,9,false,3,2,-1,41.8579,-87.6687
TA1307000159,4,9,false,5,12,7,41.8579,-87.6687
TA1307000044,4,9,false,3,4,1,41.85794,-87.64083
14,4,9,false,2,2,0,41.85808,-87.65109
13163,4,9,false,7,3,-4,41.85808,-87.65108
13164,4,9,false,18,5,-13,41.85818,-87.65648
SL-012,4,9,false,13,15,2,41.86038,-87.62581
72,4,9,false,5,3,-2,41.86039,-87.62581
13304,4,9,false,11,3,-8,41.86126,-87.65659
TA1306000002,4,9,false,5,1,-4,41.86238,-87.65108
TA1307000124,4,9,false,14,22,8,41.86411,-87.62372
168,4,9,false,1,7,6,41.86415,-87.62372
TA1309000001,4,9,false,8,4,-4,41.86488,-87.64708
13165,4,9,false,5,3,-2,41.86505,-87.65697
13029,4,9,false,7,11,4,41.86531,-87.6179
341,4,9,false,1,3,2,41.86608,-87.60733
13431,4,9,false,3,9,6,41.8661,-87.60728
KA1504000101,4,9,false,2,2,0,41.86651,-87.68466
WL-008,4,9,false,31,14,-17,41.86712,-87.64108
57,4,9,false,1,2,1,41.86712,-87.64107
59,4,9,false,5,2,-3,41.86721,-87.62597
TA1305000002,4,9,false,15,20,5,41.86721,-87.62597
3,4,9,false,3,4,1,41.86723,-87.61536
15544,4,9,false,22,61,39,41.86723,-87.61536
TA1305000017,4,9,false,4,10,6,41.86734,-87.64863
KA1706005007,4,9,false,6,4,-2,41.86749,-87.63219
SL-005,4,9,false,29,29,0,41.8679,-87.62304
255,4,9,false,9,2,-7,41.86791,-87.62304
644,4,9,false,6,2,-4,41.86859,-87.68625
13139,4,9,false,2,1,-1,41.86893,-87.65913
13160,4,9,false,4,4,0,41.86947,-87.65548
414,4,9,false,1,2,1,41.87023,-87.63947
15550,4,9,false,9,12,3,41.87024,-87.63947
TA1309000010,4,9,false,23,11,-12,41.87074,-87.62574
SL-009,4,9,false,9,2,-7,41.87081,-87.63121
342,4,9,false,3,4,1,41.87127,-87.6737
TA1309000064,4,9,false,5,8,3,41.87127,-87.67369
TA1307000130,4,9,false,2,11,9,41.87178,-87.65103
108,4,9,false,1,1,0,41.87183,-87.64664
TA1307000121,4,9,false,11,14,3,41.87184,-87.64664
41,4,9,false,2,2,0,41.87209,-87.62957
SL-008,4,9,false,9,15,6,41.87209,-87.62956
13332,4,9,false,15,4,-11,41.87219,-87.6615
394,4,9,false,5,1,-4,41.87226,-87.63484
SL-011,4,9,false,11,9,-2,41.87256,-87.63356
623,4,9,false,49,33,-16,41.87272,-87.62399
KA1504000104,4,9,false,3,10,7,41.87296,-87.66912
383,4,9,false,2,5,3,41.87297,-87.66912
KA1504000082,4,9,false,2,1,-1,41.87361,-87.70488
SL-007,4,9,false,12,19,7,41.87404,-87.6277
13326,4,9,false,5,3,-2,41.87425,-87.63958
321,4,9,false,5,2,-3,41.87427,-87.63257
535,4,9,false,3,1,-2,41.87433,-87.72582
TA1306000025,4,9,false,2,7,5,41.87464,-87.65703
15668,4,9,false,4,2,-2,41.87471,-87.68642
13028,4,9,false,12,9,-3,41.87475,-87.64981
109,4,9,false,1,1,0,41.87475,-87.64981
13081,4,9,false,1,3,2,41.87501,-87.67326
SL-010,4,9,false,7,4,-3,41.87501,-87.63309
15541,4,9,false,25,7,-18,41.8758,-87.62086
13037,4,9,false,7,2,-5,41.87588,-87.64078
TA1305000009,4,9,false,8,7,-1,41.87593,-87.63068
317,4,9,false,1,3,2,41.87603,-87.68195
45,4,9,false,5,3,-2,41.87623,-87.62444
TA1305000010,4,9,false,18,17,-1,41.87623,-87.62444
624,4,9,false,10,9,-1,41.87626,-87.62923
2,4,9,false,4,1,-3,41.87649,-87.62051
33,4,9,false,1,4,3,41.87715,-87.62786
TA1305000035,4,9,false,19,8,-11,41.87716,-87.62787
13138,4,9,false,11,11,0,41.87723,-87.63941
631,4,9,false,2,2,0,41.87761,-87.6739
15539,4,9,false,13,16,3,41.87763,-87.64405
13158,4,9,false,15,17,2,41.87764,-87.64957
134,4,9,false,3,3,0,41.87764,-87.64954
21,4,9,false,2,1,-1,41.87773,-87.6548
13157,4,9,false,6,13,7,41.87773,-87.6548
TA1305000025,4,9,false,25,49,24,41.87773,-87.63528
TA1309000002,4,9,false,22,11,-11,41.87784,-87.62408
284,4,9,false,1,3,2,41.87784,-87.62408
146,4,9,false,1,2,1,41.87794,-87.66201
283,4,9,false,2,3,1,41.87809,-87.63183
TA1309000004,4,9,false,11,12,1,41.87811,-87.63184
107,4,9,false,4,1,-3,41.87822,-87.644
638,4,9,false,12,11,-1,41.87827,-87.64078
TA1305000005,4,9,false,15,13,-2,41.87924,-87.62975
286,4,9,false,1,3,2,41.8793,-87.6355
13011,4,9,false,20,24,4,41.87931,-87.63993
TA1309000008,4,9,false,13,19,6,41.87933,-87.6355
192,4,9,false,1,4,3,41.87935,-87.63997
KA1503000034,4,9,false,8,10,2,41.87938,-87.63197
39,4,9,false,4,1,-3,41.87948,-87.62571
KA1503000015,4,9,false,12,30,18,41.87948,-87.6257
15667,4,9,false,4,1,-3,41.8798,-87.68609
287,4,9,false,1,7,6,41.88017,-87.63527
TA1309000007,4,9,false,17,31,14,41.88022,-87.63526
WL-011,4,9,false,13,12,-1,41.88034,-87.64273
13156,4,9,false,9,6,-3,41.88042,-87.65554
534,4,9,false,1,1,0,41.88085,-87.72793
13300,4,9,false,52,23,-29,41.88097,-87.61675
76,4,9,false,3,1,-2,41.88098,-87.61675
13008,4,9,false,41,50,9,41.88105,-87.62408
49,4,9,false,2,2,0,41.88116,-87.62963
TA1305000006,4,9,false,17,24,7,41.88122,-87.6296
13134,4,9,false,2,3,1,41.88138,-87.67493
13056,4,9,false,10,24,14,41.88168,-87.63951
198,4,9,false,2,5,3,41.88187,-87.6488
TA1307000120,4,9,false,27,20,-7,41.88188,-87.64879
13341,4,9,false,23,16,-7,41.88208,-87.63985
174,4,9,false,1,2,1,41.88208,-87.63984
197,4,9,false,1,2,1,41.88208,-87.62513
13036,4,9,false,14,25,11,41.8821,-87.62513
77,4,9,false,2,3,1,41.88214,-87.64108
TA1305000032,4,9,false,26,31,5,41.88218,-87.64109
98,4,9,false,2,2,0,41.88266,-87.63251
13006,4,9,false,21,23,2,41.88268,-87.63252
13353,4,9,false,9,5,-4,41.88283,-87.6612
654,4,9,false,2,10,8,41.88307,-87.65698
233,4,9,false,6,2,-4,41.88309,-87.6511
13409,4,9,false,9,20,11,41.8831,-87.6511
KA1503000072,4,9,false,14,20,6,41.88317,-87.63693
91,4,9,false,5,1,-4,41.88336,-87.64122
WL-012,4,9,false,34,22,-12,41.88337,-87.6412
112,4,9,false,3,4,1,41.88362,-87.6486
13053,4,9,false,6,29,23,41.88365,-87.64863
43,4,9,false,2,3,1,41.88396,-87.62455
13001,4,9,false,44,46,2,41.88397,-87.62459
13155,4,9,false,2,13,11,41.88407,-87.65689
621,4,9,false,1,1,0,41.88412,-87.65427
18062,4,9,false,6,15,9,41.88412,-87.65427
81,4,9,false,6,11,5,41.88417,-87.6296
TA1306000010,4,9,false,13,38,25,41.88419,-87.62961
KA1504000106,4,9,false,4,4,0,41.88459,-87.70631
TA1305000030,4,9,false,29,42,13,41.88459,-87.63178
96,4,9,false,1,1,0,41.8846,-87.64455
15535,4,9,false,9,10,1,41.8846,-87.64455
51,4,9,false,2,4,2,41.88462,-87.63176
TA1305000029,4,9,false,14,21,7,41.88466,-87.62787
195,4,9,false,3,5,2,41.88466,-87.61952
13263,4,9,false,20,20,0,41.88467,-87.61952
44,4,9,false,4,4,0,41.88468,-87.62782
TA1306000015,4,9,false,16,25,9,41.88549,-87.65232
518,4,9,false,3,1,-2,41.8855,-87.71686
71,4,9,false,2,7,5,41.8855,-87.65233
66,4,9,false,2,4,2,41.88557,-87.64186
13021,4,9,false,23,15,-8,41.88559,-87.64184
TA1307000111,4,9,false,11,20,9,41.88582,-87.63548
164,4,9,false,1,4,3,41.88583,-87.63547
13073,4,9,false,6,8,2,41.88592,-87.66717
KA17018054,4,9,false,3,9,6,41.88595,-87.67701
38,4,9,false,5,15,10,41.88599,-87.63089
KA1503000012,4,9,false,23,36,13,41.88599,-87.63089
52,4,9,false,4,2,-2,41.886,-87.62421
TA1305000011,4,9,false,44,32,-12,41.886,-87.62418
15534,4,9,false,20,15,-5,41.88627,-87.61749
217,4,9,false,1,1,0,41.8866,-87.65821
13197,4,9,false,10,10,0,41.8866,-87.65816
264,4,9,false,4,1,-3,41.8867,-87.62224
TA1308000029,4,9,false,21,12,-9,41.88673,-87.62225
TA1307000131,4,9,false,37,20,-17,41.88688,-87.62606
194,4,9,false,4,5,1,41.88688,-87.62606
KA1503000064,4,9,false,31,31,0,41.88697,-87.61281
6,4,9,false,1,5,4,41.88697,-87.61281
377,4,9,false,1,1,0,41.88719,-87.71697
100,4,9,false,5,2,-3,41.88814,-87.63657
TA1305000022,4,9,false,28,32,4,41.88817,-87.63656
56,4,9,false,8,6,-2,41.88866,-87.64442
TA1306000003,4,9,false,26,17,-9,41.88867,-87.64442
KA1503000043,4,9,false,43,29,-14,41.88918,-87.63851
133,4,9,false,10,2,-8,41.88918,-87.63851
13050,4,9,false,28,22,-6,41.88919,-87.62775
15664,4,9,false,2,1,-1,41.8895,-87.68821
13432,4,9,false,7,9,2,41.88989,-87.67149
TA1307000151,4,9,false,25,56,31,41.88993,-87.63427
212,4,9,false,4,15,11,41.88995,-87.63427
636,4,9,false,15,13,-2,41.88997,-87.63662
378,4,9,false,1,1,0,41.89014,-87.71289
KA1503000044,4,9,false,15,16,1,41.89018,-87.6262
13427,4,9,false,17,18,1,41.89054,-87.62205
13430,4,9,false,26,29,3,41.89077,-87.63169
181,4,9,false,7,5,-2,41.89077,-87.63168
TA1306000013,4,9,false,27,28,1,41.89083,-87.61852
RN-,4,9,false,24,12,-12,41.89102,-87.63546
672,4,9,false,1,4,3,41.89102,-87.63545
277,4,9,false,1,2,1,41.89108,-87.66665
13434,4,9,false,11,5,-6,41.89108,-87.66663
TA1308000006,4,9,false,5,6,1,41.89128,-87.67686
199,4,9,false,1,11,10,41.89143,-87.62676
TA1307000117,4,9,false,39,29,-10,41.89144,-87.62675
13033,4,9,false,6,23,17,41.8916,-87.64835
84,4,9,false,4,6,2,41.89161,-87.64833
186,4,9,false,2,1,-1,41.8918,-87.65879
13194,4,9,false,14,8,-6,41.8918,-87.65878
TA1305000003,4,9,false,13,20,7,41.89187,-87.62061
24,4,9,false,5,11,6,41.8919,-87.62063
13022,4,9,false,51,57,6,41.89227,-87.61205
99,4,9,false,5,2,-3,41.89255,-87.61449
TA1306000029,4,9,false,24,17,-7,41.89256,-87.61449
13265,4,9,false,15,25,10,41.89383,-87.64172
74,4,9,false,7,4,-3,41.89384,-87.64173
13045,4,9,false,33,38,5,41.89403,-87.62931
110,4,9,false,6,8,2,41.89406,-87.6293
13016,4,9,false,40,35,-5,41.89431,-87.62277
211,4,9,false,5,7,2,41.89439,-87.62267
KA1503000041,4,9,false,24,25,1,41.89452,-87.61798
142,4,9,false,4,5,1,41.89453,-87.61806
13196,4,9,false,10,5,-5,41.89455,-87.65345
TA1307000062,4,9,false,20,16,-4,41.89466,-87.63839
111,4,9,false,4,4,0,41.89466,-87.63837
TA1306000012,4,9,false,29,28,-1,41.89475,-87.63438
53,4,9,false,11,10,-1,41.89476,-87.63439
627,4,9,false,11,1,-10,41.8948,-87.63231
KP1705001026,4,9,false,10,10,0,41.89483,-87.6323
373,4,9,false,2,1,-1,41.89548,-87.70614
18058,4,9,false,7,5,-2,41.8955,-87.68201
637,4,9,false,6,4,-2,41.89563,-87.67209
128,4,9,false,1,2,1,41.89571,-87.67716
13132,4,9,false,15,13,-2,41.89573,-87.67718
161,4,9,false,3,2,-1,41.89574,-87.62599
15530,4,9,false,22,28,6,41.89575,-87.62596
18003,4,9,false,11,13,2,41.89575,-87.62011
13247,4,9,false,11,10,-1,41.89597,-87.66775
350,4,9,false,3,5,2,41.89597,-87.66774
TA1305000020,4,9,false,20,4,-16,41.89636,-87.65406
54,4,9,false,6,1,-5,41.89637,-87.65407
13289,4,9,false,12,6,-6,41.89638,-87.661
337,4,9,false,3,5,2,41.89659,-87.63096
13303,4,9,false,13,10,-3,41.89672,-87.63088
13017,4,9,false,15,13,-2,41.89676,-87.6357
31,4,9,false,1,3,2,41.89677,-87.63572
13338,4,9,false,24,18,-6,41.89697,-87.62173
173,4,9,false,1,5,4,41.89704,-87.62173
TA1307000061,4,9,false,20,17,-3,41.89745,-87.62873
106,4,9,false,4,4,0,41.89746,-87.62874
25,4,9,false,1,4,3,41.89751,-87.62354
13034,4,9,false,13,19,6,41.89754,-87.62352
TA1306000009,4,9,false,35,47,12,41.89772,-87.64299
620,4,9,false,8,22,14,41.89817,-87.63754
KA1504000103,4,9,false,20,3,-17,41.89842,-87.68659
145,4,9,false,3,1,-2,41.89856,-87.62211
15529,4,9,false,22,16,-6,41.89858,-87.62206
140,4,9,false,5,4,-1,41.89895,-87.6299
TA1307000128,4,9,false,25,30,5,41.89896,-87.6299
657,4,9,false,7,5,-2,41.89918,-87.6722
KA1504000117,4,9,false,3,2,-1,41.89936,-87.64848
13248,4,9,false,8,8,0,41.89964,-87.66788
46,4,9,false,3,3,0,41.89994,-87.63444
TA1306000011,4,9,false,6,4,-2,41.89994,-87.63443
364,4,9,false,4,1,-3,41.90023,-87.64299
KA1504000116,4,9,false,11,14,3,41.90023,-87.64299
17660,4,9,false,9,3,-6,41.90036,-87.69671
13290,4,9,false,12,8,-4,41.90069,-87.66259
29,4,9,false,4,1,-3,41.90069,-87.66259
13042,4,9,false,69,58,-11,41.90097,-87.62377
85,4,9,false,5,5,0,41.90098,-87.62375
TA1307000070,4,9,false,13,7,-6,41.90133,-87.67742
KA1504000133,4,9,false,21,27,6,41.90234,-87.62773
172,4,9,false,3,5,2,41.90236,-87.62774
15654,4,9,false,3,4,1,41.90271,-87.70923
305,4,9,false,3,1,-2,41.9028,-87.69005
13241,4,9,false,12,2,-10,41.9029,-87.68731
176,4,9,false,4,2,-2,41.90291,-87.63141
TA1306000006,4,9,false,2,1,-1,41.90292,-87.63772
TA1307000039,4,9,false,34,34,0,41.90294,-87.63137
658,4,9,false,6,3,-3,41.903,-87.6838
13256,4,9,false,7,7,0,41.90302,-87.69749
TA1305000034,4,9,false,2,3,1,41.90313,-87.67391
182,4,9,false,12,6,-6,41.90317,-87.63442
KA1504000135,4,9,false,24,32,8,41.90319,-87.63439
13136,4,9,false,6,4,-2,41.90326,-87.67845
210,4,9,false,4,4,0,41.90342,-87.66781
13061,4,9,false,22,26,4,41.90342,-87.66779
KA1504000079,4,9,false,10,9,-1,41.9035,-87.64334
138,4,9,false,4,2,-2,41.9046,-87.64057
TA1307000115,4,9,false,13,2,-11,41.9046,-87.64056
291,4,9,false,8,13,5,41.90672,-87.63494
TA1308000049,4,9,false,17,22,5,41.90672,-87.6349
KA1504000134,4,9,false,16,14,-2,41.90687,-87.6262
180,4,9,false,3,2,-1,41.90687,-87.62618
13224,4,9,false,19,11,-8,41.90706,-87.66725
333,4,9,false,2,4,2,41.90706,-87.66725
TA1307000143,4,9,false,7,10,3,41.90762,-87.63854
61,4,9,false,6,1,-5,41.90764,-87.67254
13221,4,9,false,17,6,-11,41.90765,-87.67254
13245,4,9,false,5,3,-2,41.90777,-87.68586
159,4,9,false,1,1,0,41.90777,-87.68586
301,4,9,false,4,2,-2,41.90796,-87.63203
TA1309000024,4,9,false,21,19,-2,41.908,-87.63152
69,4,9,false,2,1,-1,41.90939,-87.6777
TA1305000041,4,9,false,25,19,-6,41.9094,-87.67769
331,4,9,false,17,29,12,41.90965,-87.64812
15653,4,9,false,6,3,-3,41.90979,-87.7053
TA1305000037,4,9,false,8,9,1,41.91018,-87.67003
27,4,9,false,1,2,1,41.91019,-87.6435
TA1306000008,4,9,false,10,6,-4,41.9102,-87.6435
16,4,9,false,1,3,2,41.91035,-87.67008
TA1308000005,4,9,false,4,4,0,41.91042,-87.68238
13258,4,9,false,8,2,-6,41.91043,-87.69718
13257,4,9,false,7,6,-1,41.91054,-87.68956
13154,4,9,false,10,8,-2,41.91054,-87.65312
20,4,9,false,3,2,-1,41.91055,-87.65313
60,4,9,false,2,5,3,41.91059,-87.64942
13058,4,9,false,7,13,6,41.91059,-87.64942
118,4,9,false,3,2,-1,41.91138,-87.63868
TA1307000038,4,9,false,14,13,-1,41.91138,-87.63868
268,4,9,false,3,2,-1,41.91172,-87.62681
LF-005,4,9,false,22,38,16,41.91172,-87.62681
126,4,9,false,5,2,-3,41.91196,-87.63197
13128,4,9,false,15,8,-7,41.91197,-87.63197
289,4,9,false,4,4,0,41.91209,-87.63472
TA1308000050,4,9,false,30,30,0,41.91211,-87.6347
13243,4,9,false,13,9,-4,41.91262,-87.6814
158,4,9,false,1,2,1,41.91262,-87.6814
TA1309000032,4,9,false,4,6,2,41.91293,-87.66417
TA1306000032,4,9,false,14,9,-5,41.9137,-87.65285
93,4,9,false,1,2,1,41.91371,-87.65285
224,4,9,false,2,1,-1,41.91386,-87.64877
TA1307000166,4,9,false,5,4,-1,41.91386,-87.64877
511,4,9,false,1,3,2,41.914,-87.70515
15655,4,9,false,9,3,-6,41.91401,-87.70514
18017,4,9,false,4,2,-2,41.91416,-87.71676
18067,4,9,false,6,4,-2,41.9146,-87.66796
628,4,9,false,1,1,0,41.9146,-87.66796
13068,4,9,false,8,12,4,41.91554,-87.68703
13179,4,9,false,19,19,0,41.9157,-87.63461
141,4,9,false,2,6,4,41.91571,-87.63461
13133,4,9,false,7,6,-1,41.91598,-87.67733
219,4,9,false,2,2,0,41.91598,-87.67733
58,4,9,false,1,1,0,41.91602,-87.66894
TA1305000039,4,9,false,11,13,2,41.9163,-87.66749
15650,4,9,false,6,2,-4,41.91711,-87.71023
15651,4,9,false,6,2,-4,41.91752,-87.70181
13266,4,9,false,5,3,-2,41.91774,-87.69142
TA1309000029,4,9,false,14,3,-11,41.9178,-87.68245
TA1309000006,4,9,false,12,8,-4,41.91809,-87.64375
223,4,9,false,3,5,2,41.91821,-87.65698
TA1307000163,4,9,false,7,11,4,41.91821,-87.65696
94,4,9,false,6,4,-2,41.91831,-87.6363
13146,4,9,false,16,19,3,41.91831,-87.63629
13059,4,9,false,9,21,12,41.91845,-87.65222
113,4,9,false,4,3,-1,41.91846,-87.65222
13259,4,9,false,1,3,2,41.91852,-87.69744
259,4,9,false,2,1,-1,41.91853,-87.69745
310,4,9,false,1,1,0,41.91984,-87.68083
225,4,9,false,2,1,-1,41.91995,-87.64884
13192,4,9,false,11,15,4,41.91995,-87.64884
13288,4,9,false,10,6,-4,41.92008,-87.67788
13242,4,9,false,3,4,1,41.92021,-87.69266
307,4,9,false,6,4,-2,41.92077,-87.66373
TA1309000030,4,9,false,9,17,8,41.92077,-87.66372
13292,4,9,false,7,3,-4,41.92152,-87.70733
TA1309000033,4,9,false,14,22,8,41.92158,-87.65381
13193,4,9,false,22,12,-10,41.92182,-87.64412
144,4,9,false,2,3,1,41.92182,-87.64411
13191,4,9,false,21,11,-10,41.92217,-87.63891
327,4,9,false,1,2,1,41.92225,-87.65783
13084,4,9,false,15,13,-2,41.92268,-87.69715
LP-,4,9,false,33,17,-16,41.92396,-87.63584
KA1504000140,4,9,false,4,7,3,41.92409,-87.67646
16010,4,9,false,1,1,0,41.92458,-87.72787
15648,4,9,false,5,2,-3,41.92464,-87.68931
KA1504000090,4,9,false,1,3,2,41.92483,-87.7145
TA1307000001,4,9,false,11,3,-8,41.92535,-87.66581
188,4,9,false,3,3,0,41.92536,-87.66581
TA1306000026,4,9,false,13,17,4,41.92558,-87.65842
87,4,9,false,2,2,0,41.92559,-87.65843
TA1306000016,4,9,false,21,15,-6,41.9256,-87.65371
67,4,9,false,2,2,0,41.9256,-87.65371
313,4,9,false,8,2,-6,41.9257,-87.64246
TA1309000019,4,9,false,29,21,-8,41.92586,-87.63897
TA1309000058,4,9,false,20,9,-11,41.92591,-87.64927
127,4,9,false,2,4,2,41.92592,-87.64927
TA1308000001,4,9,false,23,13,-10,41.92627,-87.63086
177,4,9,false,1,1,0,41.92627,-87.63086
15646,4,9,false,5,5,0,41.92668,-87.6977
13124,4,9,false,12,11,-1,41.92675,-87.63444
34,4,9,false,1,1,0,41.92675,-87.63444
TA1309000023,4,9,false,17,9,-8,41.9287,-87.65383
TA1307000113,4,9,false,11,4,-7,41.92878,-87.66391
166,4,9,false,1,2,1,41.92883,-87.66853
13296,4,9,false,5,3,-2,41.92883,-87.66852
TA1309000059,4,9,false,11,8,-3,41.92889,-87.65898
349,4,9,false,3,5,2,41.92915,-87.6491
TA1309000061,4,9,false,9,16,7,41.92915,-87.64909
258,4,9,false,1,4,3,41.92946,-87.68417
TA1308000031,4,9,false,4,10,6,41.92946,-87.68417
340,4,9,false,3,4,1,41.92956,-87.64313
TA1305000014,4,9,false,11,22,11,41.92956,-87.64313
260,4,9,false,1,2,1,41.92958,-87.70791
13085,4,9,false,11,15,4,41.92958,-87.70789
TA1307000142,4,9,false,24,12,-12,41.93125,-87.64432
220,4,9,false,8,3,-5,41.93125,-87.64431
13276,4,9,false,25,12,-13,41.93132,-87.63874
324,4,9,false,5,1,-4,41.93173,-87.64179
15645,4,9,false,1,5,4,41.93191,-87.70121
13271,4,9,false,3,6,3,41.93192,-87.67784
152,4,9,false,3,3,0,41.93221,-87.65864
TA1307000064,4,9,false,19,15,-4,41.93222,-87.65864
TA1306000014,4,9,false,17,16,-1,41.93242,-87.65271
13,4,9,false,3,4,1,41.93242,-87.65271
TA1309000039,4,9,false,29,15,-14,41.93258,-87.63642
329,4,9,false,4,1,-3,41.93258,-87.63642
13294,4,9,false,12,5,-7,41.9326,-87.66595
332,4,9,false,2,1,-1,41.93313,-87.64776
TA1309000036,4,9,false,9,14,5,41.93313,-87.64776
15644,4,9,false,5,2,-3,41.93534,-87.71687
TA1307000006,4,9,false,20,12,-8,41.93571,-87.6636
153,4,9,false,2,5,3,41.93575,-87.66364
250,4,9,false,2,2,0,41.93609,-87.66984
13269,4,9,false,3,5,2,41.93609,-87.66983
115,4,9,false,4,2,-2,41.93628,-87.65266
TA1307000052,4,9,false,12,15,3,41.93628,-87.65266
156,4,9,false,3,1,-2,41.9365,-87.64756
TA1307000136,4,9,false,13,14,1,41.9365,-87.64755
TA1307000041,4,9,false,24,9,-15,41.93669,-87.63683
157,4,9,false,2,2,0,41.9367,-87.63683
13137,4,9,false,35,25,-10,41.9376,-87.6441
300,4,9,false,4,7,3,41.93761,-87.6441
15642,4,9,false,5,3,-2,41.93843,-87.69801
154,4,9,false,4,1,-3,41.93912,-87.66384
KA17018068,4,9,false,2,2,0,41.93935,-87.68327
TA1309000042,4,9,false,8,11,3,41.93937,-87.66836
131,4,9,false,1,5,4,41.93937,-87.66835
KA150400009X,4,9,false,1,3,2,41.9394,-87.71159
15640,4,9,false,2,3,1,41.93941,-87.72357
13229,4,9,false,16,33,17,41.93946,-87.66376
226,4,9,false,3,5,2,41.93972,-87.65886
TA1308000019,4,9,false,12,16,4,41.93973,-87.65886
13277,4,9,false,20,13,-7,41.9401,-87.64546
296,4,9,false,5,1,-4,41.9401,-87.64546
TA1307000134,4,9,false,24,32,8,41.94016,-87.65303
117,4,9,false,1,2,1,41.94016,-87.65302
13143,4,9,false,7,1,-6,41.94059,-87.67853
334,4,9,false,1,2,1,41.94076,-87.63919
TA1309000049,4,9,false,29,13,-16,41.94077,-87.63919
15634,4,9,false,3,4,1,41.94304,-87.68729
TA1307000138,4,9,false,7,11,4,41.94334,-87.67094
230,4,9,false,2,2,0,41.94335,-87.67093
13144,4,9,false,3,8,5,41.9434,-87.67964
299,4,9,false,3,1,-2,41.94368,-87.64894
TA1309000025,4,9,false,11,21,10,41.94368,-87.64894
229,4,9,false,1,2,1,41.94372,-87.66401
13071,4,9,false,9,13,4,41.94373,-87.66401
632,4,9,false,13,14,1,41.94453,-87.6547
303,4,9,false,11,3,-8,41.94522,-87.64702
490,4,9,false,2,1,-1,41.94523,-87.70664
13278,4,9,false,36,13,-23,41.94553,-87.64644
TA1309000050,4,9,false,2,1,-1,41.94618,-87.67331
KA1504000141,4,9,false,2,1,-1,41.94627,-87.73105
15632,4,9,false,5,5,0,41.94664,-87.69463
KA1504000143,4,9,false,5,1,-4,41.94664,-87.68337
13235,4,9,false,9,10,1,41.94814,-87.66396
304,4,9,false,4,5,1,41.94878,-87.64922
13253,4,9,false,4,3,-1,41.9488,-87.67527
13325,4,9,false,15,14,-1,41.94907,-87.64863
TA1307000126,4,9,false,17,25,8,41.94936,-87.65451
232,4,9,false,4,2,-2,41.94943,-87.64645
TA1307000150,4,9,false,22,11,-11,41.94945,-87.64646
18016,4,9,false,1,1,0,41.94993,-87.71395
347,4,9,false,1,2,1,41.95068,-87.6687
13319,4,9,false,5,4,-1,41.95069,-87.6687
TA1307000127,4,9,false,18,30,12,41.9508,-87.65918
165,4,9,false,2,3,1,41.95081,-87.65918
15628,4,9,false,2,1,-1,41.95216,-87.69806
256,4,9,false,4,1,-3,41.95282,-87.65
13323,4,9,false,18,18,0,41.95282,-87.65
15624,4,9,false,1,1,0,41.95339,-87.73199
KA1504000096,4,9,false,7,2,-5,41.95361,-87.70932
590,4,9,false,2,1,-1,41.95374,-87.74056
KA1504000139,4,9,false,2,2,0,41.954,-87.71909
TA1309000043,4,9,false,10,3,-7,41.95417,-87.66434
240,4,9,false,3,1,-2,41.95424,-87.65441
13063,4,9,false,4,14,10,41.95424,-87.65441
KA1504000158,4,9,false,2,1,-1,41.95432,-87.68607
254,4,9,false,5,3,-2,41.95438,-87.64806
TA1308000022,4,9,false,23,12,-11,41.95438,-87.64805
16991,4,9,false,3,3,0,41.95448,-87.7496
TA1307000149,4,9,false,4,5,1,41.95467,-87.67392
TA1309000026,4,9,false,5,8,3,41.95601,-87.6802
13249,4,9,false,5,3,-2,41.95606,-87.66885
312,4,9,false,1,1,0,41.95637,-87.6563
TA1308000047,4,9,false,4,2,-2,41.95709,-87.6642
292,4,9,false,1,2,1,41.95709,-87.6642
13379,4,9,false,12,8,-4,41.95786,-87.6495
TA1309000018,4,9,false,4,2,-2,41.95791,-87.67357
306,4,9,false,2,1,-1,41.9585,-87.655
TA1309000027,4,9,false,18,7,-11,41.9585,-87.65499
592,4,9,false,1,1,0,41.96065,-87.74538
13389,4,9,false,16,4,-12,41.961,-87.64958
15621,4,9,false,1,1,0,41.96103,-87.70586
KA1504000164,4,9,false,3,3,0,41.96109,-87.72897
TA1307000144,4,9,false,2,3,1,41.96142,-87.6762
TA1309000021,4,9,false,1,2,1,41.9615,-87.6714
KA1503000022,4,9,false,6,4,-2,41.96158,-87.66609
231,4,9,false,2,1,-1,41.96163,-87.65464
TA1307000107,4,9,false,20,14,-6,41.96164,-87.65464
TA1307000156,4,9,false,2,3,1,41.96301,-87.68479
TA1309000012,4,9,false,4,4,0,41.96325,-87.67928
TA1308000012,4,9,false,13,14,1,41.96398,-87.63818
293,4,9,false,2,2,0,41.96521,-87.65822
13074,4,9,false,6,2,-4,41.96521,-87.6582
639,4,9,false,10,13,3,41.96584,-87.64538
KA1504000093,4,9,false,4,1,-3,41.96587,-87.69365
TA1307000140,4,9,false,11,4,-7,41.96643,-87.68865
239,4,9,false,3,3,0,41.9665,-87.68843
326,4,9,false,2,5,3,41.96665,-87.67113
KA1504000126,4,9,false,2,2,0,41.96668,-87.70807
TA1309000014,4,9,false,15,6,-9,41.96709,-87.66744
TA1307000158,4,9,false,6,3,-3,41.9671,-87.67904
TA1307000119,4,9,false,8,9,1,41.96796,-87.65
15615,4,9,false,1,3,2,41.96835,-87.71183
TA1308000021,4,9,false,13,3,-10,41.96883,-87.65765
KA1504000080,4,9,false,2,3,1,41.96887,-87.69609
TA1309000015,4,9,false,2,2,0,41.96889,-87.68401
TA1309000066,4,9,false,17,9,-8,41.9691,-87.67423
TA1309000041,4,9,false,7,2,-5,41.96951,-87.65471
KA1504000171,4,9,false,9,4,-5,41.97161,-87.65016
465,4,9,false,2,2,0,41.97161,-87.65016
TA1309000035,4,9,false,13,14,1,41.97335,-87.66785
13108,4,9,false,11,12,1,41.97379,-87.65971
KA1504000078,4,9,false,1,3,2,41.97491,-87.69258
KA1504000149,4,9,false,7,3,-4,41.97562,-87.67945
KA1504000160,4,9,false,2,2,0,41.97564,-87.70143
KA1504000146,4,9,false,8,12,4,41.978,-87.66805
294,4,9,false,1,2,1,41.97835,-87.65976
13109,4,9,false,4,9,5,41.97835,-87.65976
KA1504000151,4,9,false,11,9,-2,41.98359,-87.66916
15585,4,9,false,2,6,4,41.98367,-87.69642
KA1504000152,4,9,false,18,13,-5,41.98403,-87.65231
15578,4,9,false,5,10,5,41.98405,-87.66027
15575,4,9,false,10,7,-3,41.98975,-87.66014
458,4,9,false,3,1,-2,41.98975,-87.66013
KA1504000148,4,9,false,6,1,-5,41.99086,-87.66971
15571,4,9,false,9,10,1,41.99478,-87.66028
KA1504000156,4,9,false,4,2,-2,41.99925,-87.67137
RP-009,4,9,false,4,7,3,42.00107,-87.66122
451,4,9,false,1,1,0,42.00108,-87.66123
RP-001,4,9,false,1,4,3,42.00179,-87.68883
RP-008,4,9,false,3,2,-1,42.00446,-87.6724
RP-002,4,9,false,3,3,0,42.00456,-87.68065
660,4,9,false,15,1,-14,42.00458,-87.66143
354,4,9,false,2,2,0,42.00587,-87.66802
KA1504000175,4,9,false,3,7,4,42.00797,-87.66549
447,4,9,false,5,4,-1,42.00797,-87.66548
RP-005,4,9,false,2,5,3,42.0086,-87.69047
KA1504000162,4,9,false,5,3,-2,42.00907,-87.67422
KA1504000159,4,9,false,11,3,-8,42.01059,-87.66241
517,4,9,false,1,1,0,42.01597,-87.675
520,4,9,false,7,1,-6,42.01597,-87.66859
515,4,9,false,2,5,3,42.01915,-87.67356
514,4,9,false,2,1,-1,42.01927,-87.68452
662,4,9,false,1,1,0,42.02354,-87.69961
598,4,9,false,1,1,0,42.02578,-87.68411
E002,4,9,false,5,4,-1,42.03256,-87.67912
596,4,9,false,12,8,-4,42.04822,-87.68348
600,4,9,false,1,1,0,42.04831,-87.6983
E008,4,9,false,11,2,-9,42.05049,-87.67782
603,4,9,false,1,1,0,42.05049,-87.67782
605,4,9,false,1,3,2,42.05294,-87.67342
661,4,9,false,17,2,-15,42.05704,-87.68657
604,4,9,false,2,20,18,42.05824,-87.67744
E006,4,9,false,1,2,1,42.06367,-87.69871
20242,4,9,true,2,1,-1,41.7282,-87.54962
20231,4,9,true,1,1,0,41.7368,-87.58282
573,4,9,true,1,1,0,41.75079,-87.62444
576,4,9,true,1,1,0,41.75129,-87.59752
579,4,9,true,5,4,-1,41.75182,-87.56522
KA1503000019,4,9,true,1,1,0,41.75867,-87.5869
20245,4,9,true,1,1,0,41.7592,-87.66348
KA1503000020,4,9,true,1,2,1,41.76223,-87.55923
12,4,9,true,5,2,-3,41.76641,-87.5657
KA1503000002,4,9,true,3,5,2,41.76641,-87.5657
KA1503000053,4,9,true,1,4,3,41.78009,-87.61595
430,4,9,true,1,1,0,41.7801,-87.61595
653,4,9,true,2,1,-1,41.78059,-87.58491
KA1503000054,4,9,true,1,2,1,41.78061,-87.60582
15491,4,9,true,2,3,1,41.78096,-87.57624
KA1503000014,4,9,true,57,37,-20,41.7851,-87.60108
426,4,9,true,15,11,-4,41.7851,-87.60108
KA1503000070,4,9,true,29,23,-6,41.78794,-87.58831
425,4,9,true,15,5,-10,41.78795,-87.58831
328,4,9,true,10,23,13,41.78872,-87.6013
TA1309000011,4,9,true,27,87,60,41.78873,-87.60131
423,4,9,true,7,37,30,41.79148,-87.59988
KA1503000071,4,9,true,14,144,130,41.79148,-87.59988
KA1503000074,4,9,true,18,5,-13,41.79174,-87.58395
424,4,9,true,2,2,0,41.79174,-87.58395
TA1309000063,4,9,true,40,16,-24,41.79325,-87.5878
345,4,9,true,14,1,-13,41.79326,-87.5878
420,4,9,true,8,12,4,41.79429,-87.60145
KA1504000076,4,9,true,42,37,-5,41.7943,-87.60145
TA1307000160,4,9,true,1,1,0,41.79485,-87.61873
KA1503000013,4,9,true,2,1,-1,41.79498,-87.63312
247,4,9,true,8,4,-4,41.79522,-87.58077
TA1308000009,4,9,true,27,13,-14,41.79522,-87.58075
TA1307000164,4,9,true,20,20,0,41.79527,-87.59647
248,4,9,true,8,3,-5,41.79528,-87.59647
KA1503000052,4,9,true,28,12,-16,41.79935,-87.60097
418,4,9,true,9,1,-8,41.79936,-87.60097
KA1503000059,4,9,true,22,13,-9,41.79952,-87.58643
419,4,9,true,5,3,-2,41.79952,-87.58643
TA1309000037,4,9,true,45,13,-32,41.79957,-87.59474
417,4,9,true,11,2,-9,41.80242,-87.5869
KA1503000007,4,9,true,54,14,-40,41.80242,-87.58689
13398,4,9,true,28,5,-23,41.80256,-87.59035
121,4,9,true,14,3,-11,41.80256,-87.59035
TA1309000067,4,9,true,2,1,-1,41.80303,-87.60661
322,4,9,true,9,11,2,41.80321,-87.59849
KA1503000069,4,9,true,4,4,0,41.80579,-87.59247
KA1503000051,4,9,true,2,1,-1,41.80815,-87.64563
16937,4,9,true,1,1,0,41.80887,-87.66453
TA1308000035,4,9,true,3,1,-2,41.80944,-87.59188
TA1308000002,4,9,true,9,5,-4,41.80983,-87.59937
336,4,9,true,2,1,-1,41.80985,-87.60675
352,4,9,true,1,1,0,41.8137,-87.63448
549,4,9,true,1,2,1,41.81401,-87.66662
413,4,9,true,1,1,0,41.81408,-87.59701
KA1503000065,4,9,true,7,1,-6,41.81409,-87.59701
271,4,9,true,1,2,1,41.81648,-87.60659
410,4,9,true,1,1,0,41.81666,-87.61942
KA1503000032,4,9,true,4,1,-3,41.81912,-87.64328
13083,4,9,true,2,1,-1,41.82167,-87.62153
TA1308000038,4,9,true,3,4,1,41.82298,-87.6071
15449,4,9,true,1,6,5,41.82302,-87.62657
16932,4,9,true,1,1,0,41.82346,-87.66558
179,4,9,true,1,1,0,41.82458,-87.61678
13420,4,9,true,4,2,-2,41.82459,-87.61678
TA1308000045,4,9,true,14,1,-13,41.83062,-87.64129
TA1308000043,4,9,true,7,6,-1,41.83066,-87.64715
KA1503000005,4,9,true,3,3,0,41.83079,-87.6325
TA1307000129,4,9,true,7,47,40,41.83104,-87.62683
13345,4,9,true,3,1,-2,41.83138,-87.61803
335,4,9,true,1,1,0,41.83139,-87.61803
15445,4,9,true,17,11,-6,41.83453,-87.63183
13216,4,9,true,15,111,96,41.83473,-87.62581
148,4,9,true,3,13,10,41.83474,-87.62581
149,4,9,true,1,3,2,41.83486,-87.61791
13217,4,9,true,40,4,-36,41.83488,-87.61792
13215,4,9,true,21,3,-18,41.83634,-87.6135
263,4,9,true,7,1,-6,41.8364,-87.61348
280,4,9,true,1,5,4,41.83779,-87.65116
TA1308000046,4,9,true,31,13,-18,41.83779,-87.65115
TA1309000055,4,9,true,19,10,-9,41.8382,-87.64514
KA1503000038,4,9,true,19,9,-10,41.83845,-87.6354
TA1307000048,4,9,true,16,15,-1,41.83855,-87.60821
150,4,9,true,2,4,2,41.83855,-87.60821
TA1308000036,4,9,true,34,19,-15,41.83883,-87.62186
15442,4,9,true,3,3,0,41.83918,-87.66562
KA1503000040,4,9,true,8,6,-2,41.84164,-87.65744
13213,4,9,true,2,11,9,41.84171,-87.62694
237,4,9,true,12,3,-9,41.84204,-87.61697
TA1307000139,4,9,true,64,14,-50,41.84205,-87.61698
15443,4,9,true,4,3,-1,41.84275,-87.63549
207,4,9,true,7,1,-6,41.84358,-87.64539
TA1307000153,4,9,true,12,2,-10,41.84358,-87.64538
15692,4,9,true,1,1,0,41.84404,-87.69531
15691,4,9,true,3,1,-2,41.84449,-87.70203
147,4,9,true,2,1,-1,41.84569,-87.62251
TA1307000005,4,9,true,10,5,-5,41.84569,-87.6225
206,4,9,true,7,5,-2,41.84719,-87.64683
TA1308000013,4,9,true,2,21,19,41.84719,-87.64681
TA1309000003,4,9,true,4,2,-2,41.84847,-87.68512
15689,4,9,true,10,3,-7,41.84912,-87.69515
TA1307000066,4,9,true,1,1,0,41.8492,-87.67564
TA1308000014,4,9,true,11,2,-9,41.84953,-87.64059
209,4,9,true,3,1,-2,41.84953,-87.64058
TA1308000026,4,9,true,5,10,5,41.85008,-87.63214
TA1305000004,4,9,true,7,5,-2,41.8514,-87.61884
42,4,9,true,5,2,-3,41.85261,-87.62653
TA1305000001,4,9,true,16,7,-9,41.85262,-87.6265
13075,4,9,true,18,35,17,41.8531,-87.63192
120,4,9,true,4,8,4,41.8531,-87.63191
13162,4,9,true,8,3,-5,41.85378,-87.64659
13096,4,9,true,11,11,0,41.8538,-87.69577
13091,4,9,true,17,8,-9,41.85409,-87.68585
203,4,9,true,4,1,-3,41.85409,-87.68585
370,4,9,true,2,1,-1,41.85415,-87.61917
13307,4,9,true,8,3,-5,41.85489,-87.66359
208,4,9,true,1,1,0,41.85489,-87.66359
13089,4,9,true,8,8,0,41.85497,-87.67567
13331,4,9,true,3,6,3,41.85515,-87.65414
171,4,9,true,2,3,1,41.85516,-87.65414
4,4,9,true,10,7,-3,41.85627,-87.61334
15545,4,9,true,20,22,2,41.85627,-87.61334
178,4,9,true,4,3,-1,41.85657,-87.62755
SL-013,4,9,true,4,5,1,41.85659,-87.62755
SL-006,4,9,true,2,21,19,41.8568,-87.63387
129,4,9,true,5,9,4,41.85752,-87.66158
202,4,9,true,3,5,2,41.85752,-87.64621
13135,4,9,true,27,12,-15,41.85753,-87.66157
338,4,9,true,12,1,-11,41.85758,-87.61956
13102,4,9,true,26,13,-13,41.85762,-87.61942
13150,4,9,true,43,29,-14,41.85783,-87.62455
273,4,9,true,11,10,-1,41.85783,-87.62455
13099,4,9,true,9,3,-6,41.85784,-87.64627
TA1307000159,4,9,true,37,11,-26,41.8579,-87.6687
205,4,9,true,10,3,-7,41.8579,-87.6687
170,4,9,true,1,7,6,41.85793,-87.64083
TA1307000044,4,9,true,6,14,8,41.85794,-87.64083
14,4,9,true,3,1,-2,41.85808,-87.65109
13163,4,9,true,8,13,5,41.85808,-87.65108
13164,4,9,true,35,11,-24,41.85818,-87.65648
15,4,9,true,4,3,-1,41.85819,-87.65648
SL-012,4,9,true,40,28,-12,41.86038,-87.62581
72,4,9,true,15,4,-11,41.86039,-87.62581
13304,4,9,true,13,3,-10,41.86126,-87.65659
KA1504000109,4,9,true,1,6,5,41.86192,-87.69347
TA1306000002,4,9,true,21,13,-8,41.86238,-87.65108
137,4,9,true,4,3,-1,41.86238,-87.65108
TA1307000124,4,9,true,48,43,-5,41.86411,-87.62372
168,4,9,true,19,11,-8,41.86415,-87.62372
282,4,9,true,4,4,0,41.86487,-87.64708
TA1309000001,4,9,true,35,16,-19,41.86488,-87.64708
13165,4,9,true,4,2,-2,41.86505,-87.65697
275,4,9,true,1,4,3,41.86524,-87.66651
13354,4,9,true,6,17,11,41.86524,-87.66651
13029,4,9,true,2,7,5,41.86531,-87.6179
341,4,9,true,6,2,-4,41.86608,-87.60733
13431,4,9,true,6,14,8,41.8661,-87.60728
KA1504000101,4,9,true,1,1,0,41.86651,-87.68466
434,4,9,true,2,1,-1,41.86651,-87.68465
WL-008,4,9,true,20,18,-2,41.86712,-87.64108
57,4,9,true,6,2,-4,41.86712,-87.64107
TA1305000002,4,9,true,63,54,-9,41.86721,-87.62597
59,4,9,true,16,16,0,41.86721,-87.62597
3,4,9,true,4,6,2,41.86723,-87.61536
15544,4,9,true,16,29,13,41.86723,-87.61536
TA1305000017,4,9,true,20,33,13,41.86734,-87.64863
55,4,9,true,8,4,-4,41.86735,-87.64863
KA1706005007,4,9,true,17,10,-7,41.86749,-87.63219
626,4,9,true,3,3,0,41.86749,-87.63219
SL-005,4,9,true,74,11,-63,41.8679,-87.62304
255,4,9,true,16,5,-11,41.86791,-87.62304
644,4,9,true,19,5,-14,41.86859,-87.68625
19,4,9,true,1,8,7,41.86892,-87.65913
13139,4,9,true,31,16,-15,41.86893,-87.65913
13285,4,9,true,19,98,79,41.86928,-87.67372
13160,4,9,true,30,26,-4,41.86947,-87.65548
22,4,9,true,6,7,1,41.86947,-87.65548
414,4,9,true,1,5,4,41.87023,-87.63947
15550,4,9,true,14,18,4,41.87024,-87.63947
TA1309000010,4,9,true,60,46,-14,41.87074,-87.62574
SL-009,4,9,true,25,4,-21,41.87081,-87.63121
342,4,9,true,5,32,27,41.87127,-87.6737
TA1309000064,4,9,true,25,78,53,41.87127,-87.67369
15542,4,9,true,9,9,0,41.87146,-87.64095
261,4,9,true,3,12,9,41.87151,-87.6699
TA1307000130,4,9,true,52,81,29,41.87178,-87.65103
241,4,9,true,14,17,3,41.8718,-87.65102
108,4,9,true,9,9,0,41.87183,-87.64664
TA1307000121,4,9,true,50,72,22,41.87184,-87.64664
41,4,9,true,14,6,-8,41.87209,-87.62957
SL-008,4,9,true,50,23,-27,41.87209,-87.62956
13332,4,9,true,93,58,-35,41.87219,-87.6615
394,4,9,true,7,1,-6,41.87226,-87.63484
175,4,9,true,2,6,4,41.87255,-87.63359
SL-011,4,9,true,42,45,3,41.87256,-87.63356
623,4,9,true,52,24,-28,41.87272,-87.62399
KA1504000104,4,9,true,27,83,56,41.87296,-87.66912
383,4,9,true,3,24,21,41.87297,-87.66912
16915,4,9,true,1,1,0,41.873,-87.7645
320,4,9,true,13,3,-10,41.87327,-87.66402
5,4,9,true,8,2,-6,41.87403,-87.6277
SL-007,4,9,true,32,24,-8,41.87404,-87.6277
169,4,9,true,5,3,-2,41.87424,-87.63959
13326,4,9,true,11,11,0,41.87425,-87.63958
321,4,9,true,20,14,-6,41.87427,-87.63257
32,4,9,true,3,2,-1,41.87464,-87.65703
TA1306000025,4,9,true,16,21,5,41.87464,-87.65703
15668,4,9,true,10,6,-4,41.87471,-87.68642
109,4,9,true,5,8,3,41.87475,-87.64981
13028,4,9,true,24,36,12,41.87475,-87.64981
13081,4,9,true,4,40,36,41.87501,-87.67326
122,4,9,true,1,1,0,41.87501,-87.67325
SL-010,4,9,true,17,14,-3,41.87501,-87.63309
533,4,9,true,2,1,-1,41.87568,-87.71549
15541,4,9,true,12,8,-4,41.8758,-87.62086
13037,4,9,true,7,27,20,41.87588,-87.64078
50,4,9,true,2,3,1,41.87592,-87.6307
TA1305000009,4,9,true,23,19,-4,41.87593,-87.63068
317,4,9,true,2,15,13,41.87603,-87.68195
45,4,9,true,1,3,2,41.87623,-87.62444
TA1305000010,4,9,true,6,16,10,41.87623,-87.62444
624,4,9,true,57,38,-19,41.87626,-87.62923
33,4,9,true,3,17,14,41.87715,-87.62786
TA1305000035,4,9,true,33,43,10,41.87716,-87.62787
13138,4,9,true,13,41,28,41.87723,-87.63941
75,4,9,true,1,2,1,41.87724,-87.63937
631,4,9,true,5,8,3,41.87761,-87.6739
15539,4,9,true,52,30,-22,41.87763,-87.64405
13158,4,9,true,50,43,-7,41.87764,-87.64957
134,4,9,true,11,3,-8,41.87764,-87.64954
13157,4,9,true,28,17,-11,41.87773,-87.6548
21,4,9,true,5,2,-3,41.87773,-87.6548
TA1305000025,4,9,true,46,128,82,41.87773,-87.63528
36,4,9,true,2,21,19,41.87776,-87.63525
TA1309000002,4,9,true,30,20,-10,41.87784,-87.62408
284,4,9,true,6,7,1,41.87784,-87.62408
13206,4,9,true,25,12,-13,41.87794,-87.66201
146,4,9,true,5,1,-4,41.87794,-87.66201
283,4,9,true,3,16,13,41.87809,-87.63183
TA1309000004,4,9,true,17,80,63,41.87811,-87.63184
107,4,9,true,4,5,1,41.87822,-87.644
638,4,9,true,56,91,35,41.87827,-87.64078
TA1305000005,4,9,true,20,112,92,41.87924,-87.62975
13011,4,9,true,50,117,67,41.87931,-87.63993
TA1309000008,4,9,true,22,60,38,41.87933,-87.6355
192,4,9,true,7,25,18,41.87935,-87.63997
KA1503000034,4,9,true,6,40,34,41.87938,-87.63197
40,4,9,true,1,8,7,41.87944,-87.63197
39,4,9,true,3,12,9,41.87948,-87.62571
KA1503000015,4,9,true,21,79,58,41.87948,-87.6257
15667,4,9,true,3,3,0,41.8798,-87.68609
287,4,9,true,9,16,7,41.88017,-87.63527
540,4,9,true,1,3,2,41.88022,-87.75536
TA1309000007,4,9,true,29,127,98,41.88022,-87.63526
WL-011,4,9,true,45,31,-14,41.88034,-87.64273
73,4,9,true,5,10,5,41.8804,-87.64273
80,4,9,true,7,12,5,41.88042,-87.65556
13156,4,9,true,54,51,-3,41.88042,-87.65554
537,4,9,true,1,1,0,41.8807,-87.74102
13300,4,9,true,14,17,3,41.88097,-87.61675
76,4,9,true,4,8,4,41.88098,-87.61675
13008,4,9,true,27,76,49,41.88105,-87.62408
90,4,9,true,6,12,6,41.88107,-87.62409
49,4,9,true,8,28,20,41.88116,-87.62963
TA1305000006,4,9,true,38,170,132,41.88122,-87.6296
13134,4,9,true,9,5,-4,41.88138,-87.67493
396,4,9,true,1,1,0,41.88159,-87.7044
13056,4,9,true,33,78,45,41.88168,-87.63951
191,4,9,true,5,1,-4,41.88169,-87.63951
198,4,9,true,7,11,4,41.88187,-87.6488
TA1307000120,4,9,true,57,73,16,41.88188,-87.64879
13341,4,9,true,44,77,33,41.88208,-87.63985
174,4,9,true,5,8,3,41.88208,-87.63984
197,4,9,true,4,10,6,41.88208,-87.62513
13036,4,9,true,22,82,60,41.8821,-87.62513
77,4,9,true,14,10,-4,41.88214,-87.64108
TA1305000032,4,9,true,96,91,-5,41.88218,-87.64109
98,4,9,true,2,19,17,41.88266,-87.63251
13006,4,9,true,46,54,8,41.88268,-87.63252
13353,4,9,true,29,24,-5,41.88283,-87.6612
346,4,9,true,6,4,-2,41.88284,-87.6612
654,4,9,true,16,13,-3,41.88307,-87.65698
233,4,9,true,13,7,-6,41.88309,-87.6511
13409,4,9,true,38,42,4,41.8831,-87.6511
18,4,9,true,2,26,24,41.88317,-87.63735
KA1503000072,4,9,true,33,76,43,41.88317,-87.63693
91,4,9,true,19,13,-6,41.88336,-87.64122
WL-012,4,9,true,100,109,9,41.88337,-87.6412
112,4,9,true,10,16,6,41.88362,-87.6486
13053,4,9,true,52,69,17,41.88365,-87.64863
43,4,9,true,7,23,16,41.88396,-87.62455
13001,4,9,true,46,96,50,41.88397,-87.62459
88,4,9,true,2,3,1,41.88407,-87.65691
13155,4,9,true,21,18,-3,41.88407,-87.65689
621,4,9,true,2,9,7,41.88412,-87.65427
18062,4,9,true,23,37,14,41.88412,-87.65427
81,4,9,true,7,29,22,41.88417,-87.6296
TA1306000010,4,9,true,42,143,101,41.88419,-87.62961
15666,4,9,true,2,5,3,41.88446,-87.6963
KA1504000106,4,9,true,2,2,0,41.88459,-87.70631
TA1305000030,4,9,true,57,236,179,41.88459,-87.63178
96,4,9,true,2,4,2,41.8846,-87.64455
15535,4,9,true,29,35,6,41.8846,-87.64455
51,4,9,true,3,48,45,41.88462,-87.63176
TA1305000029,4,9,true,33,61,28,41.88466,-87.62787
195,4,9,true,26,13,-13,41.88466,-87.61952
13263,4,9,true,78,46,-32,41.88467,-87.61952
44,4,9,true,2,5,3,41.88468,-87.62782
TA1306000015,4,9,true,37,108,71,41.88549,-87.65232
71,4,9,true,6,14,8,41.8855,-87.65233
66,4,9,true,9,12,3,41.88557,-87.64186
13021,4,9,true,98,115,17,41.88559,-87.64184
TA1307000111,4,9,true,44,90,46,41.88582,-87.63548
164,4,9,true,7,18,11,41.88583,-87.63547
13073,4,9,true,7,14,7,41.88592,-87.66717
119,4,9,true,2,4,2,41.88593,-87.66717
656,4,9,true,1,1,0,41.88595,-87.67701
KA17018054,4,9,true,2,10,8,41.88595,-87.67701
38,4,9,true,10,17,7,41.88599,-87.63089
KA1503000012,4,9,true,57,84,27,41.88599,-87.63089
52,4,9,true,6,21,15,41.886,-87.62421
TA1305000011,4,9,true,56,101,45,41.886,-87.62418
7,4,9,true,10,5,-5,41.88627,-87.61751
15534,4,9,true,44,28,-16,41.88627,-87.61749
217,4,9,true,6,12,6,41.8866,-87.65821
13197,4,9,true,20,40,20,41.8866,-87.65816
264,4,9,true,10,15,5,41.8867,-87.62224
TA1308000029,4,9,true,49,39,-10,41.88673,-87.62225
194,4,9,true,1,8,7,41.88688,-87.62606
TA1307000131,4,9,true,17,41,24,41.88688,-87.62606
6,4,9,true,5,3,-2,41.88697,-87.61281
KA1503000064,4,9,true,15,19,4,41.88697,-87.61281
532,4,9,true,2,1,-1,41.88792,-87.77446
100,4,9,true,16,20,4,41.88814,-87.63657
TA1305000022,4,9,true,81,112,31,41.88817,-87.63656
56,4,9,true,22,15,-7,41.88866,-87.64442
TA1306000003,4,9,true,59,41,-18,41.88867,-87.64442
KA1503000043,4,9,true,158,134,-24,41.88918,-87.63851
133,4,9,true,26,19,-7,41.88918,-87.63851
13050,4,9,true,54,99,45,41.88919,-87.62775
47,4,9,true,7,15,8,41.88921,-87.62775
376,4,9,true,3,1,-2,41.88951,-87.68818
285,4,9,true,1,7,6,41.88989,-87.67149
13432,4,9,true,13,28,15,41.88989,-87.67149
TA1307000151,4,9,true,79,135,56,41.88993,-87.63427
212,4,9,true,12,20,8,41.88995,-87.63427
636,4,9,true,60,54,-6,41.88997,-87.63662
378,4,9,true,1,4,3,41.89014,-87.71289
125,4,9,true,1,12,11,41.89018,-87.62621
KA1503000044,4,9,true,23,38,15,41.89018,-87.6262
196,4,9,true,6,16,10,41.89053,-87.62205
13427,4,9,true,35,33,-2,41.89054,-87.62205
26,4,9,true,16,8,-8,41.89057,-87.61798
13430,4,9,true,44,88,44,41.89077,-87.63169
181,4,9,true,7,22,15,41.89077,-87.63168
TA1306000013,4,9,true,46,46,0,41.89083,-87.61852
RN-,4,9,true,47,73,26,41.89102,-87.63546
672,4,9,true,8,13,5,41.89102,-87.63545
13434,4,9,true,19,15,-4,41.89108,-87.66663
TA1308000006,4,9,true,20,14,-6,41.89128,-87.67686
199,4,9,true,7,19,12,41.89143,-87.62676
TA1307000117,4,9,true,49,90,41,41.89144,-87.62675
13033,4,9,true,70,45,-25,41.8916,-87.64835
214,4,9,true,2,5,3,41.89161,-87.67688
84,4,9,true,9,6,-3,41.89161,-87.64833
186,4,9,true,10,13,3,41.8918,-87.65879
13194,4,9,true,56,34,-22,41.8918,-87.65878
TA1305000003,4,9,true,60,64,4,41.89187,-87.62061
24,4,9,true,14,12,-2,41.8919,-87.62063
643,4,9,true,4,2,-2,41.89203,-87.68939
35,4,9,true,9,4,-5,41.89227,-87.61206
13022,4,9,true,39,41,2,41.89227,-87.61205
99,4,9,true,6,1,-5,41.89255,-87.61449
TA1306000029,4,9,true,36,30,-6,41.89256,-87.61449
375,4,9,true,2,2,0,41.89367,-87.71191
13265,4,9,true,63,61,-2,41.89383,-87.64172
74,4,9,true,13,10,-3,41.89384,-87.64173
13045,4,9,true,103,84,-19,41.89403,-87.62931
110,4,9,true,19,18,-1,41.89406,-87.6293
13016,4,9,true,77,144,67,41.89431,-87.62277
211,4,9,true,18,52,34,41.89439,-87.62267
KA1503000041,4,9,true,96,128,32,41.89452,-87.61798
142,4,9,true,17,41,24,41.89453,-87.61806
92,4,9,true,8,5,-3,41.89455,-87.65346
13196,4,9,true,35,25,-10,41.89455,-87.65345
TA1307000062,4,9,true,90,106,16,41.89466,-87.63839
111,4,9,true,11,12,1,41.89466,-87.63837
TA1306000012,4,9,true,91,113,22,41.89475,-87.63438
53,4,9,true,28,26,-2,41.89476,-87.63439
627,4,9,true,8,6,-2,41.8948,-87.63231
KP1705001026,4,9,true,25,31,6,41.89483,-87.6323
KA1504000114,4,9,true,1,2,1,41.89547,-87.70614
18058,4,9,true,24,12,-12,41.8955,-87.68201
637,4,9,true,22,12,-10,41.89563,-87.67209
13132,4,9,true,31,18,-13,41.89573,-87.67718
161,4,9,true,12,20,8,41.89574,-87.62599
15530,4,9,true,77,95,18,41.89575,-87.62596
18003,4,9,true,31,64,33,41.89575,-87.62011
635,4,9,true,1,10,9,41.89576,-87.62012
13247,4,9,true,22,17,-5,41.89597,-87.66775
350,4,9,true,4,3,-1,41.89597,-87.66774
TA1305000020,4,9,true,28,45,17,41.89636,-87.65406
54,4,9,true,5,9,4,41.89637,-87.65407
13289,4,9,true,35,16,-19,41.89638,-87.661
86,4,9,true,5,1,-4,41.89639,-87.661
337,4,9,true,6,16,10,41.89659,-87.63096
13303,4,9,true,40,34,-6,41.89672,-87.63088
13017,4,9,true,85,54,-31,41.89676,-87.6357
31,4,9,true,29,22,-7,41.89677,-87.63572
13338,4,9,true,58,99,41,41.89697,-87.62173
173,4,9,true,12,12,0,41.89704,-87.62173
TA1307000061,4,9,true,42,45,3,41.89745,-87.62873
106,4,9,true,4,6,2,41.89746,-87.62874
25,4,9,true,4,14,10,41.89751,-87.62354
13034,4,9,true,15,48,33,41.89754,-87.62352
48,4,9,true,13,25,12,41.89772,-87.64302
TA1306000009,4,9,true,72,154,82,41.89772,-87.64299
620,4,9,true,40,22,-18,41.89817,-87.63754
KA1504000103,4,9,true,26,6,-20,41.89842,-87.68659
374,4,9,true,3,2,-1,41.89842,-87.68659
145,4,9,true,12,9,-3,41.89856,-87.62211
15529,4,9,true,34,83,49,41.89858,-87.62206
140,4,9,true,22,24,2,41.89895,-87.6299
TA1307000128,4,9,true,43,76,33,41.89896,-87.6299
657,4,9,true,22,14,-8,41.89918,-87.6722
KA1504000117,4,9,true,5,3,-2,41.89936,-87.64848
365,4,9,true,1,2,1,41.89936,-87.64848
30,4,9,true,3,3,0,41.89964,-87.66789
13248,4,9,true,26,13,-13,41.89964,-87.66788
46,4,9,true,14,7,-7,41.89994,-87.63444
TA1306000011,4,9,true,23,20,-3,41.89994,-87.63443
364,4,9,true,7,2,-5,41.90023,-87.64299
KA1504000116,4,9,true,23,19,-4,41.90023,-87.64299
17660,4,9,true,13,9,-4,41.90036,-87.69671
622,4,9,true,5,4,-1,41.90037,-87.69671
13290,4,9,true,36,21,-15,41.90069,-87.66259
29,4,9,true,3,4,1,41.90069,-87.66259
13042,4,9,true,39,102,63,41.90097,-87.62377
85,4,9,true,8,16,8,41.90098,-87.62375
183,4,9,true,2,2,0,41.90133,-87.67744
TA1307000070,4,9,true,24,3,-21,41.90133,-87.67742
KA1504000133,4,9,true,46,51,5,41.90234,-87.62773
172,4,9,true,6,12,6,41.90236,-87.62774
15654,4,9,true,5,4,-1,41.90271,-87.70923
510,4,9,true,1,1,0,41.90272,-87.70923
305,4,9,true,2,1,-1,41.9028,-87.69005
13241,4,9,true,16,8,-8,41.9029,-87.68731
176,4,9,true,30,16,-14,41.90291,-87.63141
TA1306000006,4,9,true,14,8,-6,41.90292,-87.63772
23,4,9,true,4,3,-1,41.90292,-87.63772
TA1307000039,4,9,true,89,70,-19,41.90294,-87.63137
658,4,9,true,28,27,-1,41.903,-87.6838
216,4,9,true,8,1,-7,41.90302,-87.69749
13256,4,9,true,4,4,0,41.90302,-87.69749
17,4,9,true,4,3,-1,41.90313,-87.67391
TA1305000034,4,9,true,18,23,5,41.90313,-87.67391
182,4,9,true,27,12,-15,41.90317,-87.63442
KA1504000135,4,9,true,87,53,-34,41.90319,-87.63439
13136,4,9,true,38,21,-17,41.90326,-87.67845
130,4,9,true,11,1,-10,41.90327,-87.67846
210,4,9,true,18,17,-1,41.90342,-87.66781
13061,4,9,true,50,64,14,41.90342,-87.66779
KA1504000079,4,9,true,21,23,2,41.9035,-87.64334
359,4,9,true,4,1,-3,41.90458,-87.6497
138,4,9,true,6,1,-5,41.9046,-87.64057
TA1307000115,4,9,true,19,17,-2,41.9046,-87.64056
291,4,9,true,15,11,-4,41.90672,-87.63494
TA1308000049,4,9,true,44,30,-14,41.90672,-87.6349
KA1504000134,4,9,true,31,13,-18,41.90687,-87.6262
180,4,9,true,10,2,-8,41.90687,-87.62618
13224,4,9,true,30,13,-17,41.90706,-87.66725
333,4,9,true,5,1,-4,41.90706,-87.66725
18069,4,9,true,1,26,25,41.90722,-87.65563
TA1307000143,4,9,true,34,5,-29,41.90762,-87.63854
236,4,9,true,4,1,-3,41.90762,-87.63853
61,4,9,true,3,4,1,41.90764,-87.67254
13221,4,9,true,32,19,-13,41.90765,-87.67254
13245,4,9,true,3,5,2,41.90777,-87.68586
301,4,9,true,20,6,-14,41.90796,-87.63203
TA1309000024,4,9,true,70,41,-29,41.908,-87.63152
69,4,9,true,9,8,-1,41.90939,-87.6777
TA1305000041,4,9,true,27,26,-1,41.9094,-87.67769
331,4,9,true,58,60,2,41.90965,-87.64812
15653,4,9,true,5,10,5,41.90979,-87.7053
509,4,9,true,1,2,1,41.9098,-87.70531
TA1305000037,4,9,true,25,12,-13,41.91018,-87.67003
27,4,9,true,4,4,0,41.91019,-87.6435
TA1306000008,4,9,true,35,15,-20,41.9102,-87.6435
16,4,9,true,4,3,-1,41.91035,-87.67008
213,4,9,true,3,4,1,41.91037,-87.68237
TA1308000005,4,9,true,22,9,-13,41.91042,-87.68238
13258,4,9,true,16,12,-4,41.91043,-87.69718
276,4,9,true,1,1,0,41.91043,-87.69718
160,4,9,true,3,1,-2,41.91054,-87.68957
13257,4,9,true,23,9,-14,41.91054,-87.68956
13154,4,9,true,22,36,14,41.91054,-87.65312
20,4,9,true,9,3,-6,41.91055,-87.65313
13058,4,9,true,21,17,-4,41.91059,-87.64942
60,4,9,true,1,6,5,41.91059,-87.64942
TA1307000038,4,9,true,44,34,-10,41.91138,-87.63868
118,4,9,true,10,5,-5,41.91138,-87.63868
LF-005,4,9,true,40,25,-15,41.91172,-87.62681
268,4,9,true,8,3,-5,41.91172,-87.62681
126,4,9,true,9,4,-5,41.91196,-87.63197
13128,4,9,true,9,16,7,41.91197,-87.63197
289,4,9,true,20,16,-4,41.91209,-87.63472
TA1308000050,4,9,true,68,91,23,41.91211,-87.6347
13243,4,9,true,32,20,-12,41.91262,-87.6814
158,4,9,true,5,2,-3,41.91262,-87.6814
315,4,9,true,2,1,-1,41.91293,-87.66417
TA1309000032,4,9,true,10,17,7,41.91293,-87.66417
TA1306000032,4,9,true,44,23,-21,41.9137,-87.65285
93,4,9,true,8,9,1,41.91371,-87.65285
224,4,9,true,5,6,1,41.91386,-87.64877
TA1307000166,4,9,true,24,32,8,41.91386,-87.64877
511,4,9,true,4,1,-3,41.914,-87.70515
15655,4,9,true,17,5,-12,41.91401,-87.70514
18017,4,9,true,6,2,-4,41.91416,-87.71676
641,4,9,true,1,1,0,41.91416,-87.71676
18067,4,9,true,9,5,-4,41.9146,-87.66796
TA1306000007,4,9,true,19,8,-11,41.91469,-87.64333
28,4,9,true,1,1,0,41.91469,-87.64333
13068,4,9,true,21,38,17,41.91554,-87.68703
116,4,9,true,5,4,-1,41.91555,-87.68703
13179,4,9,true,38,35,-3,41.9157,-87.63461
141,4,9,true,8,7,-1,41.91571,-87.63461
13133,4,9,true,37,13,-24,41.91598,-87.67733
58,4,9,true,8,5,-3,41.91602,-87.66894
TA1305000039,4,9,true,18,24,6,41.9163,-87.66749
506,4,9,true,8,1,-7,41.91711,-87.71023
15650,4,9,true,4,6,2,41.91711,-87.71023
15651,4,9,true,12,1,-11,41.91752,-87.70181
507,4,9,true,1,1,0,41.91752,-87.70181
13266,4,9,true,11,8,-3,41.91774,-87.69142
TA1309000029,4,9,true,6,4,-2,41.9178,-87.68245
309,4,9,true,2,3,1,41.91789,-87.6865
TA1309000006,4,9,true,42,29,-13,41.91809,-87.64375
288,4,9,true,15,4,-11,41.91809,-87.64375
223,4,9,true,9,12,3,41.91821,-87.65698
TA1307000163,4,9,true,32,26,-6,41.91821,-87.65696
94,4,9,true,27,17,-10,41.91831,-87.6363
13146,4,9,true,62,32,-30,41.91831,-87.63629
13059,4,9,true,32,42,10,41.91845,-87.65222
113,4,9,true,5,14,9,41.91846,-87.65222
13259,4,9,true,12,11,-1,41.91852,-87.69744
259,4,9,true,7,5,-2,41.91853,-87.69745
310,4,9,true,4,2,-2,41.91984,-87.68083
13192,4,9,true,45,31,-14,41.91995,-87.64884
225,4,9,true,12,2,-10,41.91995,-87.64884
13288,4,9,true,20,7,-13,41.92008,-87.67788
13242,4,9,true,8,9,1,41.92021,-87.69266
307,4,9,true,4,5,1,41.92077,-87.66373
TA1309000030,4,9,true,12,26,14,41.92077,-87.66372
290,4,9,true,3,1,-2,41.92152,-87.70734
13292,4,9,true,5,8,3,41.92152,-87.70733
TA1309000033,4,9,true,28,36,8,41.92158,-87.65381
13193,4,9,true,52,41,-11,41.92182,-87.64412
144,4,9,true,7,13,6,41.92182,-87.64411
13191,4,9,true,44,23,-21,41.92217,-87.63891
143,4,9,true,11,3,-8,41.92217,-87.63891
327,4,9,true,3,5,2,41.92225,-87.65783
13084,4,9,true,27,19,-8,41.92268,-87.69715
123,4,9,true,4,7,3,41.92268,-87.69714
LP-,4,9,true,42,14,-28,41.92396,-87.63584
673,4,9,true,5,3,-2,41.92398,-87.63585
KA1504000140,4,9,true,12,8,-4,41.92409,-87.67646
504,4,9,true,1,1,0,41.92464,-87.68931
15648,4,9,true,6,7,1,41.92464,-87.68931
KA1504000090,4,9,true,9,3,-6,41.92483,-87.7145
TA1307000001,4,9,true,41,20,-21,41.92535,-87.66581
188,4,9,true,2,10,8,41.92536,-87.66581
TA1306000026,4,9,true,28,92,64,41.92558,-87.65842
87,4,9,true,2,7,5,41.92559,-87.65843
67,4,9,true,5,3,-2,41.9256,-87.65371
TA1306000016,4,9,true,49,60,11,41.9256,-87.65371
313,4,9,true,10,11,1,41.9257,-87.64246
TA1309000019,4,9,true,59,10,-49,41.92586,-87.63897
TA1309000058,4,9,true,55,51,-4,41.92591,-87.64927
127,4,9,true,6,9,3,41.92592,-87.64927
TA1308000001,4,9,true,47,41,-6,41.92627,-87.63086
177,4,9,true,7,6,-1,41.92627,-87.63086
502,4,9,true,1,1,0,41.92667,-87.69772
15646,4,9,true,9,4,-5,41.92668,-87.6977
34,4,9,true,1,1,0,41.92675,-87.63444
13124,4,9,true,9,10,1,41.92675,-87.63444
302,4,9,true,6,3,-3,41.92859,-87.65421
TA1309000023,4,9,true,14,23,9,41.9287,-87.65383
TA1307000113,4,9,true,16,12,-4,41.92878,-87.66391
190,4,9,true,4,4,0,41.92878,-87.6639
166,4,9,true,2,2,0,41.92883,-87.66853
13296,4,9,true,8,3,-5,41.92883,-87.66852
TA1309000059,4,9,true,27,24,-3,41.92889,-87.65898
343,4,9,true,4,5,1,41.92889,-87.65898
349,4,9,true,7,8,1,41.92915,-87.6491
TA1309000061,4,9,true,46,44,-2,41.92915,-87.64909
258,4,9,true,1,2,1,41.92946,-87.68417
TA1308000031,4,9,true,7,12,5,41.92946,-87.68417
TA1305000014,4,9,true,80,63,-17,41.92956,-87.64313
340,4,9,true,15,10,-5,41.92956,-87.64313
260,4,9,true,3,4,1,41.92958,-87.70791
13085,4,9,true,12,23,11,41.92958,-87.70789
15643,4,9,true,3,4,1,41.93057,-87.7238
TA1307000142,4,9,true,49,27,-22,41.93125,-87.64432
220,4,9,true,11,11,0,41.93125,-87.64431
13276,4,9,true,41,25,-16,41.93132,-87.63874
324,4,9,true,7,16,9,41.93173,-87.64179
15645,4,9,true,3,5,2,41.93191,-87.70121
163,4,9,true,1,3,2,41.93191,-87.67784
13271,4,9,true,10,12,2,41.93192,-87.67784
152,4,9,true,13,6,-7,41.93221,-87.65864
TA1307000064,4,9,true,37,54,17,41.93222,-87.65864
TA1306000014,4,9,true,38,30,-8,41.93242,-87.65271
13,4,9,true,12,13,1,41.93242,-87.65271
TA1309000039,4,9,true,67,22,-45,41.93258,-87.63642
329,4,9,true,11,7,-4,41.93258,-87.63642
13294,4,9,true,11,8,-3,41.9326,-87.66595
319,4,9,true,2,2,0,41.93292,-87.67217
332,4,9,true,6,3,-3,41.93313,-87.64776
TA1309000036,4,9,true,33,32,-1,41.93313,-87.64776
15644,4,9,true,1,1,0,41.93534,-87.71687
TA1307000006,4,9,true,26,47,21,41.93571,-87.6636
153,4,9,true,5,9,4,41.93575,-87.66364
13268,4,9,true,15,8,-7,41.93588,-87.67843
250,4,9,true,2,1,-1,41.93609,-87.66984
13269,4,9,true,16,11,-5,41.93609,-87.66983
115,4,9,true,12,2,-10,41.93628,-87.65266
TA1307000052,4,9,true,42,33,-9,41.93628,-87.65266
156,4,9,true,10,10,0,41.9365,-87.64756
TA1307000136,4,9,true,36,40,4,41.9365,-87.64755
TA1307000041,4,9,true,62,32,-30,41.93669,-87.63683
157,4,9,true,22,7,-15,41.9367,-87.63683
13137,4,9,true,77,62,-15,41.9376,-87.6441
300,4,9,true,22,14,-8,41.93761,-87.6441
15642,4,9,true,6,4,-2,41.93843,-87.69801
498,4,9,true,1,1,0,41.93843,-87.69801
154,4,9,true,3,7,4,41.93912,-87.66384
KA17018068,4,9,true,5,5,0,41.93935,-87.68327
TA1309000042,4,9,true,12,18,6,41.93937,-87.66836
131,4,9,true,8,7,-1,41.93937,-87.66835
KA150400009X,4,9,true,5,4,-1,41.9394,-87.71159
13229,4,9,true,22,17,-5,41.93946,-87.66376
226,4,9,true,3,4,1,41.93972,-87.65886
TA1308000019,4,9,true,25,14,-11,41.93973,-87.65886
13277,4,9,true,45,34,-11,41.9401,-87.64546
296,4,9,true,3,7,4,41.9401,-87.64546
TA1307000134,4,9,true,35,46,11,41.94016,-87.65303
117,4,9,true,9,6,-3,41.94016,-87.65302
13143,4,9,true,7,3,-4,41.94059,-87.67853
334,4,9,true,12,11,-1,41.94076,-87.63919
TA1309000049,4,9,true,34,27,-7,41.94077,-87.63919
493,4,9,true,2,1,-1,41.94304,-87.68729
15634,4,9,true,6,6,0,41.94304,-87.68729
TA1307000138,4,9,true,21,36,15,41.94334,-87.67094
230,4,9,true,11,7,-4,41.94335,-87.67093
13144,4,9,true,3,17,14,41.9434,-87.67964
TA1309000025,4,9,true,63,32,-31,41.94368,-87.64894
299,4,9,true,5,2,-3,41.94368,-87.64894
229,4,9,true,12,7,-5,41.94372,-87.66401
13071,4,9,true,36,50,14,41.94373,-87.66401
632,4,9,true,27,40,13,41.94453,-87.6547
303,4,9,true,10,7,-3,41.94522,-87.64702
490,4,9,true,1,2,1,41.94523,-87.70664
15631,4,9,true,2,2,0,41.94524,-87.70665
13278,4,9,true,53,38,-15,41.94553,-87.64644
TA1309000050,4,9,true,9,3,-6,41.94618,-87.67331
492,4,9,true,3,4,1,41.94662,-87.68337
491,4,9,true,2,4,2,41.94664,-87.69463
15632,4,9,true,3,13,10,41.94664,-87.69463
KA1504000143,4,9,true,7,15,8,41.94664,-87.68337
KA1504000142,4,9,true,1,1,0,41.94735,-87.71759
489,4,9,true,1,1,0,41.94736,-87.7176
227,4,9,true,7,8,1,41.94813,-87.66397
13235,4,9,true,65,50,-15,41.94814,-87.66396
304,4,9,true,11,8,-3,41.94878,-87.64922
13253,4,9,true,19,7,-12,41.9488,-87.67527
257,4,9,true,4,2,-2,41.9488,-87.67527
13325,4,9,true,40,109,69,41.94907,-87.64863
114,4,9,true,9,3,-6,41.94935,-87.65451
TA1307000126,4,9,true,50,50,0,41.94936,-87.65451
232,4,9,true,14,9,-5,41.94943,-87.64645
TA1307000150,4,9,true,44,42,-2,41.94945,-87.64646
18016,4,9,true,4,1,-3,41.94993,-87.71395
13319,4,9,true,13,16,3,41.95069,-87.6687
TA1307000127,4,9,true,50,26,-24,41.9508,-87.65918
165,4,9,true,6,2,-4,41.95081,-87.65918
487,4,9,true,2,2,0,41.95216,-87.69806
15628,4,9,true,2,4,2,41.95216,-87.69806
318,4,9,true,3,4,1,41.95254,-87.6735
13323,4,9,true,66,24,-42,41.95282,-87.65
256,4,9,true,15,10,-5,41.95282,-87.65
314,4,9,true,5,4,-1,41.9535,-87.69199
KA1504000096,4,9,true,1,1,0,41.95361,-87.70932
590,4,9,true,1,1,0,41.95374,-87.74056
KA1504000139,4,9,true,2,1,-1,41.954,-87.71909
TA1309000043,4,9,true,39,18,-21,41.95417,-87.66434
240,4,9,true,2,6,4,41.95424,-87.65441
13063,4,9,true,27,42,15,41.95424,-87.65441
486,4,9,true,1,2,1,41.95431,-87.68607
KA1504000158,4,9,true,8,3,-5,41.95432,-87.68607
254,4,9,true,7,8,1,41.95438,-87.64806
TA1308000022,4,9,true,49,19,-30,41.95438,-87.64805
16991,4,9,true,1,1,0,41.95448,-87.7496
244,4,9,true,8,11,3,41.95466,-87.67391
TA1307000149,4,9,true,28,28,0,41.95467,-87.67392
298,4,9,true,5,5,0,41.95601,-87.68021
TA1309000026,4,9,true,12,18,6,41.95601,-87.6802
13249,4,9,true,7,2,-5,41.95606,-87.66885
246,4,9,true,1,1,0,41.95606,-87.66885
312,4,9,true,2,11,9,41.95637,-87.6563
TA1308000047,4,9,true,10,8,-2,41.95709,-87.6642
292,4,9,true,1,2,1,41.95709,-87.6642
13379,4,9,true,32,34,2,41.95786,-87.6495
TA1309000018,4,9,true,30,27,-3,41.95791,-87.67357
316,4,9,true,3,3,0,41.95841,-87.69401
306,4,9,true,12,4,-8,41.9585,-87.655
TA1309000027,4,9,true,38,19,-19,41.9585,-87.65499
13389,4,9,true,33,18,-15,41.961,-87.64958
245,4,9,true,9,2,-7,41.96101,-87.64958
15621,4,9,true,3,2,-1,41.96103,-87.70586
15622,4,9,true,12,4,-8,41.96108,-87.69544
481,4,9,true,2,1,-1,41.96108,-87.69544
KA1504000097,4,9,true,7,2,-5,41.96116,-87.71658
238,4,9,true,4,3,-1,41.96141,-87.6762
TA1307000144,4,9,true,11,17,6,41.96142,-87.6762
297,4,9,true,2,2,0,41.9615,-87.67141
TA1309000021,4,9,true,3,9,6,41.9615,-87.6714
15623,4,9,true,14,9,-5,41.96154,-87.69117
482,4,9,true,4,1,-3,41.96154,-87.69117
KA1503000022,4,9,true,20,16,-4,41.96158,-87.66609
231,4,9,true,3,10,7,41.96163,-87.65464
TA1307000107,4,9,true,38,32,-6,41.96164,-87.65464
TA1307000156,4,9,true,22,13,-9,41.96301,-87.68479
TA1309000012,4,9,true,6,16,10,41.96325,-87.67928
TA1308000012,4,9,true,25,20,-5,41.96398,-87.63818
249,4,9,true,8,5,-3,41.96398,-87.63818
293,4,9,true,2,5,3,41.96521,-87.65822
13074,4,9,true,15,38,23,41.96521,-87.6582
639,4,9,true,23,13,-10,41.96584,-87.64538
KA1504000127,4,9,true,7,4,-3,41.96587,-87.70083
477,4,9,true,1,1,0,41.96587,-87.70083
KA1504000093,4,9,true,11,11,0,41.96587,-87.69365
478,4,9,true,1,3,2,41.96587,-87.69364
TA1307000140,4,9,true,18,11,-7,41.96643,-87.68865
239,4,9,true,2,2,0,41.9665,-87.68843
326,4,9,true,7,6,-1,41.96665,-87.67113
KA1504000126,4,9,true,4,2,-2,41.96668,-87.70807
TA1309000014,4,9,true,40,12,-28,41.96709,-87.66744
242,4,9,true,7,5,-2,41.9671,-87.67904
TA1307000158,4,9,true,17,26,9,41.9671,-87.67904
251,4,9,true,7,14,7,41.96796,-87.65
TA1307000119,4,9,true,15,27,12,41.96796,-87.65
15615,4,9,true,5,8,3,41.96835,-87.71183
253,4,9,true,7,4,-3,41.96883,-87.65765
TA1308000021,4,9,true,7,6,-1,41.96883,-87.65765
KA1504000080,4,9,true,5,4,-1,41.96887,-87.69609
TA1309000015,4,9,true,10,11,1,41.96889,-87.68401
311,4,9,true,2,1,-1,41.9689,-87.68402
TA1309000066,4,9,true,27,30,3,41.9691,-87.67423
344,4,9,true,1,9,8,41.9691,-87.67423
TA1309000041,4,9,true,13,8,-5,41.96951,-87.65471
465,4,9,true,2,2,0,41.97161,-87.65016
KA1504000171,4,9,true,18,22,4,41.97161,-87.65016
325,4,9,true,14,8,-6,41.9728,-87.67186
TA1309000035,4,9,true,28,24,-4,41.97335,-87.66785
295,4,9,true,3,4,1,41.97378,-87.65972
13108,4,9,true,13,27,14,41.97379,-87.65971
KA1504000078,4,9,true,2,1,-1,41.97491,-87.69258
KA1504000149,4,9,true,12,6,-6,41.97562,-87.67945
KA1504000160,4,9,true,4,2,-2,41.97564,-87.70143
471,4,9,true,4,4,0,41.97564,-87.70143
KA1504000128,4,9,true,4,5,1,41.97567,-87.70927
463,4,9,true,1,3,2,41.978,-87.66805
KA1504000146,4,9,true,13,32,19,41.978,-87.66805
13109,4,9,true,38,13,-25,41.97835,-87.65976
294,4,9,true,6,5,-1,41.97835,-87.65976
KA1504000147,4,9,true,5,4,-1,41.97976,-87.67754
655,4,9,true,3,1,-2,41.97987,-87.68194
KA1504000161,4,9,true,4,11,7,41.98038,-87.71612
KA1504000167,4,9,true,3,3,0,41.98206,-87.70895
460,4,9,true,4,1,-3,41.98358,-87.66916
KA1504000151,4,9,true,13,18,5,41.98359,-87.66916
15585,4,9,true,6,1,-5,41.98367,-87.69642
KA1504000152,4,9,true,53,29,-24,41.98403,-87.65231
459,4,9,true,11,6,-5,41.98403,-87.65231
15578,4,9,true,24,13,-11,41.98405,-87.66027
461,4,9,true,7,3,-4,41.98405,-87.66027
15575,4,9,true,24,8,-16,41.98975,-87.66014
458,4,9,true,4,2,-2,41.98975,-87.66013
KA1504000130,4,9,true,1,1,0,41.99024,-87.69338
457,4,9,true,5,4,-1,41.99052,-87.66982
KA1504000148,4,9,true,8,3,-5,41.99086,-87.66971
KA1504000155,4,9,true,5,5,0,41.99118,-87.68359
KA1504000129,4,9,true,3,6,3,41.99417,-87.68945
15571,4,9,true,22,24,2,41.99478,-87.66028
454,4,9,true,9,5,-4,41.99478,-87.66027
KA1504000156,4,9,true,23,10,-13,41.99925,-87.67137
453,4,9,true,3,5,2,41.99925,-87.67137
RP-009,4,9,true,7,14,7,42.00107,-87.66122
451,4,9,true,4,3,-1,42.00108,-87.66123
RP-001,4,9,true,2,1,-1,42.00179,-87.68883
449,4,9,true,2,1,-1,42.00446,-87.67241
RP-008,4,9,true,15,7,-8,42.00446,-87.6724
RP-002,4,9,true,2,2,0,42.00456,-87.68065
660,4,9,true,8,5,-3,42.00458,-87.66143
KA1504000175,4,9,true,8,11,3,42.00797,-87.66549
447,4,9,true,10,9,-1,42.00797,-87.66548
432,4,9,true,1,1,0,42.00907,-87.67423
KA1504000162,4,9,true,9,9,0,42.00907,-87.67422
RP-007,4,9,true,3,1,-2,42.01256,-87.67431
525,4,9,true,2,2,0,42.01272,-87.66605
517,4,9,true,3,1,-2,42.01597,-87.675
520,4,9,true,7,6,-1,42.01597,-87.66859
515,4,9,true,1,11,10,42.01915,-87.67356
523,4,9,true,18,3,-15,42.02089,-87.66505
598,4,9,true,3,1,-2,42.02578,-87.68411
E002,4,9,true,13,3,-10,42.03256,-87.67912
596,4,9,true,31,13,-18,42.04822,-87.68348
E008,4,9,true,8,8,0,42.05049,-87.67782
605,4,9,true,1,47,46,42.05294,-87.67342
661,4,9,true,6,15,9,42.05704,-87.68657
604,4,9,true,10,57,47,42.05824,-87.67744
E006,4,9,true,3,4,1,42.06367,-87.69871
E007,4,9,true,1,2,1,42.06431,-87.68615
602,4,9,true,1,4,3,42.06431,-87.68614
E014,4,9,true,2,1,-1,42.06483,-87.71531
663,4,9,true,1,1,0,42.06483,-87.71531
20212,4,17,false,4,3,-1,41.65693,-87.59883
20232,4,17,false,1,1,0,41.68588,-87.57378
20205,4,17,false,1,1,0,41.69121,-87.6813
20203,4,17,false,1,2,1,41.69131,-87.71286
20131,4,17,false,3,1,-2,41.69169,-87.61
711,4,17,false,2,1,-1,41.69229,-87.64269
20109,4,17,false,3,1,-2,41.70018,-87.6123
20222,4,17,false,2,4,2,41.7046,-87.52832
20113,4,17,false,1,1,0,41.70728,-87.60767
20223,4,17,false,1,2,1,41.71272,-87.53472
20224,4,17,false,3,5,2,41.71371,-87.53083
20238,4,17,false,1,2,1,41.7187,-87.597
703,4,17,false,3,5,2,41.71871,-87.59699
20106,4,17,false,2,1,-1,41.71897,-87.60833
20104,4,17,false,1,2,1,41.72171,-87.62283
20119,4,17,false,3,3,0,41.72682,-87.6543
20103,4,17,false,1,5,4,41.7281,-87.66757
20242,4,17,false,1,2,1,41.7282,-87.54962
20110,4,17,false,1,1,0,41.72933,-87.61076
20116,4,17,false,2,2,0,41.73652,-87.60126
595,4,17,false,6,4,-2,41.73663,-87.62264
693,4,17,false,1,1,0,41.73734,-87.54849
20121,4,17,false,1,2,1,41.74152,-87.65842
585,4,17,false,2,2,0,41.74344,-87.60485
573,4,17,false,3,2,-1,41.75079,-87.62444
576,4,17,false,3,2,-1,41.75129,-87.59752
575,4,17,false,1,2,1,41.75318,-87.60502
395,4,17,false,1,1,0,41.75713,-87.57585
KA1503000049,4,17,false,4,1,-3,41.75788,-87.54938
571,4,17,false,1,2,1,41.75836,-87.61415
570,4,17,false,1,1,0,41.75849,-87.60642
KA1503000020,4,17,false,7,2,-5,41.76223,-87.55923
KA1503000002,4,17,false,10,4,-6,41.76641,-87.5657
KA1503000018,4,17,false,2,1,-1,41.76663,-87.57645
KA1503000023,4,17,false,1,3,2,41.77346,-87.58534
KA1503000030,4,17,false,5,5,0,41.77352,-87.57722
KA1503000029,4,17,false,4,8,4,41.77364,-87.56747
16950,4,17,false,2,2,0,41.77408,-87.66378
KA1503000021,4,17,false,1,1,0,41.77888,-87.58665
KA1503000055,4,17,false,2,1,-1,41.77939,-87.64463
KA1503000025,4,17,false,3,1,-2,41.78008,-87.62977
KA1503000053,4,17,false,1,1,0,41.78009,-87.61595
KA1503000046,4,17,false,2,4,2,41.78041,-87.59141
428,4,17,false,4,1,-3,41.78041,-87.59139
653,4,17,false,1,3,2,41.78059,-87.58491
427,4,17,false,2,2,0,41.78061,-87.60602
KA1503000054,4,17,false,5,5,0,41.78061,-87.60582
15491,4,17,false,7,16,9,41.78096,-87.57624
101,4,17,false,4,2,-2,41.78105,-87.57611
KA1503000033,4,17,false,3,4,1,41.78411,-87.61329
426,4,17,false,8,5,-3,41.7851,-87.60108
KA1503000014,4,17,false,33,40,7,41.7851,-87.60108
647,4,17,false,1,1,0,41.78746,-87.65557
KA1503000070,4,17,false,10,9,-1,41.78794,-87.58831
425,4,17,false,4,1,-3,41.78795,-87.58831
328,4,17,false,9,5,-4,41.78872,-87.6013
TA1309000011,4,17,false,23,10,-13,41.78873,-87.60131
KA1503000071,4,17,false,43,17,-26,41.79148,-87.59988
423,4,17,false,4,6,2,41.79148,-87.59988
KA1503000075,4,17,false,11,3,-8,41.79156,-87.60785
KA1503000074,4,17,false,48,8,-40,41.79174,-87.58395
424,4,17,false,2,1,-1,41.79174,-87.58395
TA1309000063,4,17,false,25,30,5,41.79325,-87.5878
345,4,17,false,5,4,-1,41.79326,-87.5878
KA1503000073,4,17,false,2,3,1,41.79345,-87.61585
420,4,17,false,2,5,3,41.79429,-87.60145
KA1504000076,4,17,false,24,22,-2,41.7943,-87.60145
TA1307000160,4,17,false,6,6,0,41.79485,-87.61873
KA1503000013,4,17,false,3,2,-1,41.79498,-87.63312
247,4,17,false,10,17,7,41.79522,-87.58077
TA1308000009,4,17,false,56,59,3,41.79522,-87.58075
TA1307000164,4,17,false,30,27,-3,41.79527,-87.59647
248,4,17,false,1,5,4,41.79528,-87.59647
646,4,17,false,1,4,3,41.79663,-87.62592
KA1503000052,4,17,false,16,16,0,41.79935,-87.60097
418,4,17,false,5,6,1,41.79936,-87.60097
419,4,17,false,8,3,-5,41.79952,-87.58643
KA1503000059,4,17,false,21,30,9,41.79952,-87.58643
TA1309000037,4,17,false,29,27,-2,41.79957,-87.59474
15470,4,17,false,2,3,1,41.80228,-87.61807
417,4,17,false,9,6,-3,41.80242,-87.5869
KA1503000007,4,17,false,21,26,5,41.80242,-87.58689
121,4,17,false,5,2,-3,41.80256,-87.59035
13398,4,17,false,22,27,5,41.80256,-87.59035
16940,4,17,false,4,2,-2,41.80302,-87.66469
TA1309000067,4,17,false,10,4,-6,41.80303,-87.60661
322,4,17,false,6,5,-1,41.80321,-87.59849
594,4,17,false,1,3,2,41.80567,-87.68337
KA1503000069,4,17,false,4,10,6,41.80579,-87.59247
KA1503000051,4,17,false,2,4,2,41.80815,-87.64563
411,4,17,false,1,1,0,41.80816,-87.64563
KA1504000091,4,17,false,2,2,0,41.80823,-87.6772
16937,4,17,false,1,1,0,41.80887,-87.66453
KA1503000009,4,17,false,6,2,-4,41.80932,-87.63346
267,4,17,false,2,3,1,41.80944,-87.59188
TA1308000035,4,17,false,6,13,7,41.80944,-87.59188
TA1308000002,4,17,false,8,12,4,41.80983,-87.59937
TA1308000007,4,17,false,5,2,-3,41.80984,-87.61628
TA1309000053,4,17,false,4,3,-1,41.80985,-87.60675
KA1503000065,4,17,false,9,7,-2,41.81409,-87.59701
KA1503000001,4,17,false,1,2,1,41.8162,-87.63468
TA1308000023,4,17,false,5,7,2,41.81649,-87.60659
410,4,17,false,2,2,0,41.81666,-87.61942
KA1503000027,4,17,false,4,5,1,41.81666,-87.61942
KA1503000032,4,17,false,3,3,0,41.81912,-87.64328
13083,4,17,false,2,2,0,41.82167,-87.62153
355,4,17,false,6,3,-3,41.82217,-87.63032
TA1308000038,4,17,false,9,4,-5,41.82298,-87.6071
546,4,17,false,3,3,0,41.82319,-87.67661
16932,4,17,false,3,2,-1,41.82346,-87.66558
13420,4,17,false,6,1,-5,41.82459,-87.61678
18022,4,17,false,3,2,-1,41.82672,-87.68315
KA1503000068,4,17,false,6,2,-4,41.82878,-87.68062
KA1503000066,4,17,false,2,6,4,41.83011,-87.67031
TA1308000045,4,17,false,9,6,-3,41.83062,-87.64129
TA1308000043,4,17,false,11,4,-7,41.83066,-87.64715
15446,4,17,false,4,3,-1,41.83068,-87.65603
367,4,17,false,1,2,1,41.83069,-87.65604
KA1503000005,4,17,false,13,3,-10,41.83079,-87.6325
TA1307000129,4,17,false,8,6,-2,41.83104,-87.62683
406,4,17,false,1,6,5,41.83127,-87.6088
KA1503000004,4,17,false,14,21,7,41.83127,-87.6088
13345,4,17,false,5,5,0,41.83138,-87.61803
15445,4,17,false,7,8,1,41.83453,-87.63183
13216,4,17,false,18,12,-6,41.83473,-87.62581
148,4,17,false,1,6,5,41.83474,-87.62581
13217,4,17,false,12,8,-4,41.83488,-87.61792
13215,4,17,false,6,10,4,41.83634,-87.6135
TA1308000046,4,17,false,8,12,4,41.83779,-87.65115
339,4,17,false,2,1,-1,41.83817,-87.64523
TA1309000055,4,17,false,11,10,-1,41.8382,-87.64514
KA1503000038,4,17,false,6,1,-5,41.83845,-87.6354
150,4,17,false,6,15,9,41.83855,-87.60821
TA1307000048,4,17,false,50,61,11,41.83855,-87.60821
TA1308000036,4,17,false,13,8,-5,41.83883,-87.62186
15442,4,17,false,2,1,-1,41.83918,-87.66562
KA1504000168,4,17,false,1,1,0,41.84152,-87.68514
366,4,17,false,2,1,-1,41.84164,-87.65744
KA1503000040,4,17,false,2,7,5,41.84164,-87.65744
13213,4,17,false,6,5,-1,41.84171,-87.62694
237,4,17,false,5,4,-1,41.84204,-87.61697
TA1307000139,4,17,false,15,14,-1,41.84205,-87.61698
15443,4,17,false,8,13,5,41.84275,-87.63549
401,4,17,false,5,6,1,41.84276,-87.63549
207,4,17,false,2,1,-1,41.84358,-87.64539
TA1307000153,4,17,false,6,6,0,41.84358,-87.64538
15691,4,17,false,1,5,4,41.84449,-87.70203
KA1504000110,4,17,false,2,1,-1,41.84454,-87.71596
TA1307000005,4,17,false,6,7,1,41.84569,-87.6225
TA1308000013,4,17,false,5,5,0,41.84719,-87.64681
TA1309000003,4,17,false,6,11,5,41.84847,-87.68512
15689,4,17,false,1,1,0,41.84912,-87.69515
TA1307000066,4,17,false,1,2,1,41.8492,-87.67564
TA1308000014,4,17,false,3,7,4,41.84953,-87.64059
TA1308000026,4,17,false,3,4,1,41.85008,-87.63214
TA1305000004,4,17,false,21,17,-4,41.8514,-87.61884
42,4,17,false,2,1,-1,41.85261,-87.62653
TA1305000001,4,17,false,20,12,-8,41.85262,-87.6265
13075,4,17,false,42,57,15,41.8531,-87.63192
120,4,17,false,2,7,5,41.8531,-87.63191
13162,4,17,false,4,10,6,41.85378,-87.64659
13096,4,17,false,3,5,2,41.8538,-87.69577
13091,4,17,false,4,9,5,41.85409,-87.68585
370,4,17,false,2,3,1,41.85415,-87.61917
15546,4,17,false,12,7,-5,41.85416,-87.61916
13307,4,17,false,6,10,4,41.85489,-87.66359
13089,4,17,false,10,14,4,41.85497,-87.67567
13331,4,17,false,8,6,-2,41.85515,-87.65414
171,4,17,false,3,3,0,41.85516,-87.65414
15545,4,17,false,48,38,-10,41.85627,-87.61334
4,4,17,false,7,3,-4,41.85627,-87.61334
SL-013,4,17,false,16,10,-6,41.85659,-87.62755
SL-006,4,17,false,13,15,2,41.8568,-87.63387
129,4,17,false,2,2,0,41.85752,-87.66158
202,4,17,false,7,3,-4,41.85752,-87.64621
13135,4,17,false,13,24,11,41.85753,-87.66157
13102,4,17,false,37,29,-8,41.85762,-87.61942
13150,4,17,false,39,34,-5,41.85783,-87.62455
273,4,17,false,5,5,0,41.85783,-87.62455
13099,4,17,false,11,9,-2,41.85784,-87.64627
TA1307000159,4,17,false,18,13,-5,41.8579,-87.6687
205,4,17,false,1,3,2,41.8579,-87.6687
170,4,17,false,3,1,-2,41.85793,-87.64083
TA1307000044,4,17,false,19,17,-2,41.85794,-87.64083
13163,4,17,false,29,24,-5,41.85808,-87.65108
13164,4,17,false,23,32,9,41.85818,-87.65648
15,4,17,false,1,2,1,41.85819,-87.65648
SL-012,4,17,false,36,39,3,41.86038,-87.62581
72,4,17,false,4,3,-1,41.86039,-87.62581
13304,4,17,false,10,10,0,41.86126,-87.65659
KA1504000109,4,17,false,5,3,-2,41.86192,-87.69347
TA1306000002,4,17,false,6,5,-1,41.86238,-87.65108
TA1307000124,4,17,false,80,69,-11,41.86411,-87.62372
168,4,17,false,5,6,1,41.86415,-87.62372
282,4,17,false,7,1,-6,41.86487,-87.64708
TA1309000001,4,17,false,33,24,-9,41.86488,-87.64708
13165,4,17,false,8,2,-6,41.86505,-87.65697
13029,4,17,false,58,31,-27,41.86531,-87.6179
97,4,17,false,9,7,-2,41.86531,-87.6179
341,4,17,false,6,17,11,41.86608,-87.60733
13431,4,17,false,66,65,-1,41.8661,-87.60728
15682,4,17,false,4,4,0,41.86651,-87.70649
KA1504000101,4,17,false,9,3,-6,41.86651,-87.68466
KA1504000102,4,17,false,5,3,-2,41.86664,-87.69453
WL-008,4,17,false,20,46,26,41.86712,-87.64108
57,4,17,false,7,6,-1,41.86712,-87.64107
TA1305000002,4,17,false,95,72,-23,41.86721,-87.62597
59,4,17,false,17,20,3,41.86721,-87.62597
15544,4,17,false,161,117,-44,41.86723,-87.61536
3,4,17,false,23,5,-18,41.86723,-87.61536
TA1305000017,4,17,false,15,8,-7,41.86734,-87.64863
KA1706005007,4,17,false,28,24,-4,41.86749,-87.63219
626,4,17,false,2,2,0,41.86749,-87.63219
SL-005,4,17,false,155,160,5,41.8679,-87.62304
255,4,17,false,20,38,18,41.86791,-87.62304
644,4,17,false,6,12,6,41.86859,-87.68625
13139,4,17,false,13,20,7,41.86893,-87.65913
13285,4,17,false,10,5,-5,41.86928,-87.67372
13160,4,17,false,32,22,-10,41.86947,-87.65548
22,4,17,false,3,4,1,41.86947,-87.65548
382,4,17,false,4,2,-2,41.8699,-87.68725
414,4,17,false,3,1,-2,41.87023,-87.63947
15550,4,17,false,22,31,9,41.87024,-87.63947
TA1309000010,4,17,false,122,54,-68,41.87074,-87.62574
SL-009,4,17,false,47,27,-20,41.87081,-87.63121
TA1309000064,4,17,false,13,14,1,41.87127,-87.67369
15542,4,17,false,5,6,1,41.87146,-87.64095
103,4,17,false,1,1,0,41.87146,-87.64094
TA1307000130,4,17,false,17,16,-1,41.87178,-87.65103
241,4,17,false,1,2,1,41.8718,-87.65102
108,4,17,false,2,1,-1,41.87183,-87.64664
TA1307000121,4,17,false,18,27,9,41.87184,-87.64664
41,4,17,false,14,18,4,41.87209,-87.62957
SL-008,4,17,false,96,92,-4,41.87209,-87.62956
16912,4,17,false,1,1,0,41.87213,-87.74664
13332,4,17,false,34,31,-3,41.87219,-87.6615
394,4,17,false,8,12,4,41.87226,-87.63484
175,4,17,false,15,9,-6,41.87255,-87.63359
SL-011,4,17,false,84,70,-14,41.87256,-87.63356
623,4,17,false,84,102,18,41.87272,-87.62399
KA1504000104,4,17,false,39,20,-19,41.87296,-87.66912
383,4,17,false,15,1,-14,41.87297,-87.66912
320,4,17,false,3,6,3,41.87327,-87.66402
KA1504000082,4,17,false,1,1,0,41.87361,-87.70488
5,4,17,false,10,4,-6,41.87403,-87.6277
SL-007,4,17,false,45,29,-16,41.87404,-87.6277
13326,4,17,false,10,7,-3,41.87425,-87.63958
321,4,17,false,15,13,-2,41.87427,-87.63257
TA1306000025,4,17,false,12,7,-5,41.87464,-87.65703
15668,4,17,false,13,9,-4,41.87471,-87.68642
109,4,17,false,4,4,0,41.87475,-87.64981
13028,4,17,false,22,26,4,41.87475,-87.64981
13081,4,17,false,11,2,-9,41.87501,-87.67326
89,4,17,false,9,7,-2,41.87501,-87.6331
SL-010,4,17,false,34,17,-17,41.87501,-87.63309
16907,4,17,false,4,1,-3,41.87568,-87.71549
15541,4,17,false,74,97,23,41.8758,-87.62086
68,4,17,false,3,1,-2,41.87587,-87.64077
13037,4,17,false,16,5,-11,41.87588,-87.64078
50,4,17,false,3,1,-2,41.87592,-87.6307
TA1305000009,4,17,false,27,17,-10,41.87593,-87.63068
317,4,17,false,3,1,-2,41.87603,-87.68195
45,4,17,false,6,5,-1,41.87623,-87.62444
TA1305000010,4,17,false,31,39,8,41.87623,-87.62444
624,4,17,false,34,30,-4,41.87626,-87.62923
2,4,17,false,6,10,4,41.87649,-87.62051
33,4,17,false,8,2,-6,41.87715,-87.62786
TA1305000035,4,17,false,28,32,4,41.87716,-87.62787
13138,4,17,false,25,15,-10,41.87723,-87.63941
75,4,17,false,14,1,-13,41.87724,-87.63937
631,4,17,false,13,12,-1,41.87761,-87.6739
539,4,17,false,1,1,0,41.87762,-87.7454
15539,4,17,false,34,24,-10,41.87763,-87.64405
13158,4,17,false,94,56,-38,41.87764,-87.64957
134,4,17,false,5,6,1,41.87764,-87.64954
13157,4,17,false,36,37,1,41.87773,-87.6548
21,4,17,false,3,7,4,41.87773,-87.6548
TA1305000025,4,17,false,94,35,-59,41.87773,-87.63528
36,4,17,false,9,5,-4,41.87776,-87.63525
TA1309000002,4,17,false,79,49,-30,41.87784,-87.62408
284,4,17,false,4,3,-1,41.87784,-87.62408
13206,4,17,false,32,19,-13,41.87794,-87.66201
146,4,17,false,2,6,4,41.87794,-87.66201
283,4,17,false,12,2,-10,41.87809,-87.63183
TA1309000004,4,17,false,49,29,-20,41.87811,-87.63184
107,4,17,false,4,7,3,41.87822,-87.644
638,4,17,false,68,37,-31,41.87827,-87.64078
37,4,17,false,4,5,1,41.87921,-87.62975
TA1305000005,4,17,false,42,16,-26,41.87924,-87.62975
286,4,17,false,12,3,-9,41.8793,-87.6355
13011,4,17,false,111,59,-52,41.87931,-87.63993
TA1309000008,4,17,false,45,34,-11,41.87933,-87.6355
192,4,17,false,12,2,-10,41.87935,-87.63997
KA1503000034,4,17,false,28,11,-17,41.87938,-87.63197
39,4,17,false,10,1,-9,41.87948,-87.62571
KA1503000015,4,17,false,64,33,-31,41.87948,-87.6257
15667,4,17,false,6,7,1,41.8798,-87.68609
381,4,17,false,1,2,1,41.87981,-87.68607
16916,4,17,false,2,2,0,41.88012,-87.76323
287,4,17,false,13,1,-12,41.88017,-87.63527
540,4,17,false,1,5,4,41.88022,-87.75536
TA1309000007,4,17,false,70,16,-54,41.88022,-87.63526
16918,4,17,false,4,1,-3,41.88028,-87.77447
WL-011,4,17,false,41,29,-12,41.88034,-87.64273
73,4,17,false,6,2,-4,41.8804,-87.64273
80,4,17,false,3,7,4,41.88042,-87.65556
13156,4,17,false,53,49,-4,41.88042,-87.65554
13300,4,17,false,292,255,-37,41.88097,-87.61675
76,4,17,false,19,36,17,41.88098,-87.61675
13008,4,17,false,242,266,24,41.88105,-87.62408
90,4,17,false,16,35,19,41.88107,-87.62409
49,4,17,false,16,6,-10,41.88116,-87.62963
TA1305000006,4,17,false,74,35,-39,41.88122,-87.6296
13134,4,17,false,20,17,-3,41.88138,-87.67493
13056,4,17,false,32,39,7,41.88168,-87.63951
191,4,17,false,1,1,0,41.88169,-87.63951
198,4,17,false,12,18,6,41.88187,-87.6488
TA1307000120,4,17,false,126,128,2,41.88188,-87.64879
13341,4,17,false,78,64,-14,41.88208,-87.63985
174,4,17,false,11,2,-9,41.88208,-87.63984
197,4,17,false,10,6,-4,41.88208,-87.62513
13036,4,17,false,71,38,-33,41.8821,-87.62513
77,4,17,false,13,6,-7,41.88214,-87.64108
TA1305000032,4,17,false,126,74,-52,41.88218,-87.64109
13006,4,17,false,20,18,-2,41.88268,-87.63252
13353,4,17,false,35,48,13,41.88283,-87.6612
346,4,17,false,1,4,3,41.88284,-87.6612
654,4,17,false,24,20,-4,41.88307,-87.65698
233,4,17,false,3,5,2,41.88309,-87.6511
13409,4,17,false,57,51,-6,41.8831,-87.6511
18,4,17,false,11,2,-9,41.88317,-87.63735
KA1503000072,4,17,false,23,19,-4,41.88317,-87.63693
91,4,17,false,8,3,-5,41.88336,-87.64122
WL-012,4,17,false,157,72,-85,41.88337,-87.6412
112,4,17,false,7,10,3,41.88362,-87.6486
13053,4,17,false,93,151,58,41.88365,-87.64863
43,4,17,false,20,10,-10,41.88396,-87.62455
13001,4,17,false,139,101,-38,41.88397,-87.62459
88,4,17,false,2,4,2,41.88407,-87.65691
13155,4,17,false,26,34,8,41.88407,-87.65689
18062,4,17,false,48,37,-11,41.88412,-87.65427
621,4,17,false,6,2,-4,41.88412,-87.65427
81,4,17,false,18,12,-6,41.88417,-87.6296
TA1306000010,4,17,false,116,58,-58,41.88419,-87.62961
15666,4,17,false,5,4,-1,41.88446,-87.6963
KA1504000106,4,17,false,3,2,-1,41.88459,-87.70631
TA1305000030,4,17,false,99,38,-61,41.88459,-87.63178
96,4,17,false,8,11,3,41.8846,-87.64455
15535,4,17,false,60,69,9,41.8846,-87.64455
51,4,17,false,11,6,-5,41.88462,-87.63176
TA1305000029,4,17,false,91,87,-4,41.88466,-87.62787
195,4,17,false,14,8,-6,41.88466,-87.61952
13263,4,17,false,103,71,-32,41.88467,-87.61952
44,4,17,false,14,14,0,41.88468,-87.62782
TA1306000015,4,17,false,99,133,34,41.88549,-87.65232
71,4,17,false,6,7,1,41.8855,-87.65233
66,4,17,false,11,8,-3,41.88557,-87.64186
13021,4,17,false,82,57,-25,41.88559,-87.64184
TA1307000111,4,17,false,76,43,-33,41.88582,-87.63548
164,4,17,false,18,6,-12,41.88583,-87.63547
13073,4,17,false,33,27,-6,41.88592,-87.66717
KA17018054,4,17,false,13,10,-3,41.88595,-87.67701
656,4,17,false,4,4,0,41.88595,-87.67701
KA1503000012,4,17,false,92,76,-16,41.88599,-87.63089
38,4,17,false,18,5,-13,41.88599,-87.63089
52,4,17,false,24,18,-6,41.886,-87.62421
TA1305000011,4,17,false,99,126,27,41.886,-87.62418
7,4,17,false,12,7,-5,41.88627,-87.61751
15534,4,17,false,71,52,-19,41.88627,-87.61749
217,4,17,false,4,5,1,41.8866,-87.65821
13197,4,17,false,34,25,-9,41.8866,-87.65816
264,4,17,false,7,5,-2,41.8867,-87.62224
TA1308000029,4,17,false,46,44,-2,41.88673,-87.62225
16903,4,17,false,3,1,-2,41.88686,-87.74531
194,4,17,false,3,9,6,41.88688,-87.62606
TA1307000131,4,17,false,68,102,34,41.88688,-87.62606
KA1503000064,4,17,false,155,147,-8,41.88697,-87.61281
6,4,17,false,11,19,8,41.88697,-87.61281
530,4,17,false,1,1,0,41.88783,-87.75558
100,4,17,false,11,10,-1,41.88814,-87.63657
TA1305000022,4,17,false,70,50,-20,41.88817,-87.63656
56,4,17,false,29,15,-14,41.88866,-87.64442
TA1306000003,4,17,false,125,86,-39,41.88867,-87.64442
KA1503000043,4,17,false,160,119,-41,41.88918,-87.63851
133,4,17,false,15,4,-11,41.88918,-87.63851
13050,4,17,false,113,109,-4,41.88919,-87.62775
47,4,17,false,8,16,8,41.88921,-87.62775
15664,4,17,false,10,5,-5,41.8895,-87.68821
285,4,17,false,5,8,3,41.88989,-87.67149
13432,4,17,false,21,30,9,41.88989,-87.67149
TA1307000151,4,17,false,133,96,-37,41.88993,-87.63427
212,4,17,false,8,11,3,41.88995,-87.63427
636,4,17,false,40,41,1,41.88997,-87.63662
125,4,17,false,9,5,-4,41.89018,-87.62621
KA1503000044,4,17,false,46,42,-4,41.89018,-87.6262
196,4,17,false,7,5,-2,41.89053,-87.62205
13427,4,17,false,65,54,-11,41.89054,-87.62205
26,4,17,false,5,15,10,41.89057,-87.61798
13430,4,17,false,138,142,4,41.89077,-87.63169
181,4,17,false,11,7,-4,41.89077,-87.63168
TA1306000013,4,17,false,120,118,-2,41.89083,-87.61852
RN-,4,17,false,102,86,-16,41.89102,-87.63546
672,4,17,false,10,9,-1,41.89102,-87.63545
277,4,17,false,4,7,3,41.89108,-87.66665
13434,4,17,false,31,42,11,41.89108,-87.66663
TA1308000006,4,17,false,37,32,-5,41.89128,-87.67686
199,4,17,false,30,22,-8,41.89143,-87.62676
TA1307000117,4,17,false,132,138,6,41.89144,-87.62675
13033,4,17,false,110,93,-17,41.8916,-87.64835
214,4,17,false,2,5,3,41.89161,-87.67688
84,4,17,false,18,10,-8,41.89161,-87.64833
186,4,17,false,7,8,1,41.8918,-87.65879
13194,4,17,false,63,46,-17,41.8918,-87.65878
TA1305000003,4,17,false,104,132,28,41.89187,-87.62061
24,4,17,false,15,16,1,41.8919,-87.62063
643,4,17,false,10,21,11,41.89203,-87.68939
35,4,17,false,23,26,3,41.89227,-87.61206
13022,4,17,false,528,597,69,41.89227,-87.61205
99,4,17,false,17,18,1,41.89255,-87.61449
TA1306000029,4,17,false,111,93,-18,41.89256,-87.61449
13265,4,17,false,105,90,-15,41.89383,-87.64172
74,4,17,false,18,6,-12,41.89384,-87.64173
13045,4,17,false,164,130,-34,41.89403,-87.62931
110,4,17,false,20,25,5,41.89406,-87.6293
13016,4,17,false,78,65,-13,41.89431,-87.62277
211,4,17,false,13,9,-4,41.89439,-87.62267
KA1503000041,4,17,false,44,57,13,41.89452,-87.61798
142,4,17,false,15,10,-5,41.89453,-87.61806
92,4,17,false,6,11,5,41.89455,-87.65346
13196,4,17,false,59,48,-11,41.89455,-87.65345
TA1307000062,4,17,false,53,30,-23,41.89466,-87.63839
111,4,17,false,8,6,-2,41.89466,-87.63837
642,4,17,false,2,1,-1,41.89473,-87.75689
TA1306000012,4,17,false,157,140,-17,41.89475,-87.63438
53,4,17,false,32,25,-7,41.89476,-87.63439
627,4,17,false,6,8,2,41.8948,-87.63231
KP1705001026,4,17,false,78,73,-5,41.89483,-87.6323
16920,4,17,false,3,2,-1,41.89495,-87.76491
KA1504000114,4,17,false,2,7,5,41.89547,-87.70614
659,4,17,false,3,6,3,41.8955,-87.68201
18058,4,17,false,15,25,10,41.8955,-87.68201
637,4,17,false,37,46,9,41.89563,-87.67209
128,4,17,false,1,5,4,41.89571,-87.67716
13132,4,17,false,44,52,8,41.89573,-87.67718
161,4,17,false,10,5,-5,41.89574,-87.62599
15530,4,17,false,95,93,-2,41.89575,-87.62596
18003,4,17,false,18,21,3,41.89575,-87.62011
635,4,17,false,5,1,-4,41.89576,-87.62012
13247,4,17,false,38,37,-1,41.89597,-87.66775
350,4,17,false,6,4,-2,41.89597,-87.66774
TA1305000020,4,17,false,54,58,4,41.89636,-87.65406
54,4,17,false,7,4,-3,41.89637,-87.65407
13289,4,17,false,52,49,-3,41.89638,-87.661
86,4,17,false,1,16,15,41.89639,-87.661
337,4,17,false,12,4,-8,41.89659,-87.63096
13303,4,17,false,66,64,-2,41.89672,-87.63088
13017,4,17,false,52,47,-5,41.89676,-87.6357
31,4,17,false,12,4,-8,41.89677,-87.63572
13338,4,17,false,30,49,19,41.89697,-87.62173
173,4,17,false,8,2,-6,41.89704,-87.62173
TA1307000061,4,17,false,60,31,-29,41.89745,-87.62873
106,4,17,false,6,6,0,41.89746,-87.62874
25,4,17,false,6,13,7,41.89751,-87.62354
13034,4,17,false,65,80,15,41.89754,-87.62352
48,4,17,false,6,5,-1,41.89772,-87.64302
TA1306000009,4,17,false,63,36,-27,41.89772,-87.64299
620,4,17,false,71,65,-6,41.89817,-87.63754
374,4,17,false,8,8,0,41.89842,-87.68659
KA1504000103,4,17,false,30,33,3,41.89842,-87.68659
145,4,17,false,8,6,-2,41.89856,-87.62211
15529,4,17,false,62,54,-8,41.89858,-87.62206
140,4,17,false,22,22,0,41.89895,-87.6299
TA1307000128,4,17,false,143,124,-19,41.89896,-87.6299
657,4,17,false,50,28,-22,41.89918,-87.6722
KA1504000117,4,17,false,11,9,-2,41.89936,-87.64848
30,4,17,false,5,6,1,41.89964,-87.66789
13248,4,17,false,47,26,-21,41.89964,-87.66788
46,4,17,false,7,8,1,41.89994,-87.63444
TA1306000011,4,17,false,48,37,-11,41.89994,-87.63443
KA1504000116,4,17,false,36,20,-16,41.90023,-87.64299
364,4,17,false,3,5,2,41.90023,-87.64299
17660,4,17,false,35,35,0,41.90036,-87.69671
622,4,17,false,1,4,3,41.90037,-87.69671
13290,4,17,false,47,28,-19,41.90069,-87.66259
29,4,17,false,6,6,0,41.90069,-87.66259
13042,4,17,false,240,259,19,41.90097,-87.62377
85,4,17,false,24,32,8,41.90098,-87.62375
183,4,17,false,4,5,1,41.90133,-87.67744
TA1307000070,4,17,false,45,34,-11,41.90133,-87.67742
KA1504000133,4,17,false,103,109,6,41.90234,-87.62773
172,4,17,false,7,11,4,41.90236,-87.62774
15654,4,17,false,10,7,-3,41.90271,-87.70923
510,4,17,false,1,1,0,41.90272,-87.70923
305,4,17,false,4,4,0,41.9028,-87.69005
13241,4,17,false,23,16,-7,41.9029,-87.68731
176,4,17,false,34,22,-12,41.90291,-87.63141
23,4,17,false,1,8,7,41.90292,-87.63772
TA1306000006,4,17,false,28,66,38,41.90292,-87.63772
TA1307000039,4,17,false,200,200,0,41.90294,-87.63137
658,4,17,false,22,12,-10,41.903,-87.6838
216,4,17,false,1,1,0,41.90302,-87.69749
13256,4,17,false,14,17,3,41.90302,-87.69749
17,4,17,false,4,4,0,41.90313,-87.67391
TA1305000034,4,17,false,65,68,3,41.90313,-87.67391
182,4,17,false,21,33,12,41.90317,-87.63442
KA1504000135,4,17,false,214,235,21,41.90319,-87.63439
13136,4,17,false,45,24,-21,41.90326,-87.67845
130,4,17,false,9,4,-5,41.90327,-87.67846
210,4,17,false,13,15,2,41.90342,-87.66781
13061,4,17,false,113,103,-10,41.90342,-87.66779
KA1504000079,4,17,false,74,54,-20,41.9035,-87.64334
359,4,17,false,13,17,4,41.90458,-87.6497
TA1307000115,4,17,false,29,33,4,41.9046,-87.64056
291,4,17,false,27,32,5,41.90672,-87.63494
TA1308000049,4,17,false,125,161,36,41.90672,-87.6349
KA1504000134,4,17,false,72,80,8,41.90687,-87.6262
180,4,17,false,15,12,-3,41.90687,-87.62618
13224,4,17,false,74,40,-34,41.90706,-87.66725
333,4,17,false,7,10,3,41.90706,-87.66725
18069,4,17,false,25,3,-22,41.90722,-87.65563
TA1307000143,4,17,false,39,34,-5,41.90762,-87.63854
236,4,17,false,5,4,-1,41.90762,-87.63853
61,4,17,false,10,17,7,41.90764,-87.67254
13221,4,17,false,66,73,7,41.90765,-87.67254
13245,4,17,false,14,8,-6,41.90777,-87.68586
159,4,17,false,4,1,-3,41.90777,-87.68586
301,4,17,false,13,11,-2,41.90796,-87.63203
TA1309000024,4,17,false,106,83,-23,41.908,-87.63152
69,4,17,false,6,15,9,41.90939,-87.6777
TA1305000041,4,17,false,108,108,0,41.9094,-87.67769
15652,4,17,false,5,8,3,41.90965,-87.71664
331,4,17,false,104,106,2,41.90965,-87.64812
15653,4,17,false,10,6,-4,41.90979,-87.7053
509,4,17,false,3,3,0,41.9098,-87.70531
TA1305000037,4,17,false,50,50,0,41.91018,-87.67003
27,4,17,false,8,6,-2,41.91019,-87.6435
TA1306000008,4,17,false,39,31,-8,41.9102,-87.6435
16,4,17,false,5,7,2,41.91035,-87.67008
213,4,17,false,3,3,0,41.91037,-87.68237
TA1308000005,4,17,false,16,16,0,41.91042,-87.68238
13258,4,17,false,35,26,-9,41.91043,-87.69718
276,4,17,false,3,3,0,41.91043,-87.69718
160,4,17,false,7,2,-5,41.91054,-87.68957
13257,4,17,false,28,32,4,41.91054,-87.68956
13154,4,17,false,44,63,19,41.91054,-87.65312
20,4,17,false,7,6,-1,41.91055,-87.65313
60,4,17,false,12,9,-3,41.91059,-87.64942
13058,4,17,false,61,59,-2,41.91059,-87.64942
118,4,17,false,7,13,6,41.91138,-87.63868
TA1307000038,4,17,false,82,88,6,41.91138,-87.63868
268,4,17,false,20,29,9,41.91172,-87.62681
LF-005,4,17,false,242,692,450,41.91172,-87.62681
126,4,17,false,11,17,6,41.91196,-87.63197
13128,4,17,false,47,110,63,41.91197,-87.63197
289,4,17,false,21,28,7,41.91209,-87.63472
TA1308000050,4,17,false,185,242,57,41.91211,-87.6347
13243,4,17,false,70,40,-30,41.91262,-87.6814
158,4,17,false,5,8,3,41.91262,-87.6814
TA1309000032,4,17,false,21,14,-7,41.91293,-87.66417
315,4,17,false,3,2,-1,41.91293,-87.66417
TA1306000032,4,17,false,55,44,-11,41.9137,-87.65285
93,4,17,false,15,15,0,41.91371,-87.65285
224,4,17,false,8,7,-1,41.91386,-87.64877
TA1307000166,4,17,false,40,41,1,41.91386,-87.64877
511,4,17,false,3,4,1,41.914,-87.70515
15655,4,17,false,19,20,1,41.91401,-87.70514
641,4,17,false,1,1,0,41.91416,-87.71676
18017,4,17,false,11,16,5,41.91416,-87.71676
18067,4,17,false,45,42,-3,41.9146,-87.66796
628,4,17,false,6,3,-3,41.9146,-87.66796
TA1306000007,4,17,false,34,16,-18,41.91469,-87.64333
28,4,17,false,6,2,-4,41.91469,-87.64333
13068,4,17,false,56,29,-27,41.91554,-87.68703
116,4,17,false,14,4,-10,41.91555,-87.68703
13179,4,17,false,130,242,112,41.9157,-87.63461
141,4,17,false,20,23,3,41.91571,-87.63461
13133,4,17,false,67,65,-2,41.91598,-87.67733
219,4,17,false,6,9,3,41.91598,-87.67733
58,4,17,false,5,4,-1,41.91602,-87.66894
TA1305000039,4,17,false,55,74,19,41.9163,-87.66749
506,4,17,false,2,1,-1,41.91711,-87.71023
15650,4,17,false,8,26,18,41.91711,-87.71023
15651,4,17,false,41,21,-20,41.91752,-87.70181
507,4,17,false,4,5,1,41.91752,-87.70181
185,4,17,false,6,1,-5,41.91774,-87.69143
13266,4,17,false,31,20,-11,41.91774,-87.69142
TA1309000029,4,17,false,21,16,-5,41.9178,-87.68245
309,4,17,false,2,3,1,41.91789,-87.6865
TA1309000006,4,17,false,64,39,-25,41.91809,-87.64375
288,4,17,false,6,8,2,41.91809,-87.64375
223,4,17,false,2,3,1,41.91821,-87.65698
TA1307000163,4,17,false,70,58,-12,41.91821,-87.65696
94,4,17,false,20,17,-3,41.91831,-87.6363
13146,4,17,false,154,139,-15,41.91831,-87.63629
13059,4,17,false,117,78,-39,41.91845,-87.65222
113,4,17,false,13,16,3,41.91846,-87.65222
13259,4,17,false,17,21,4,41.91852,-87.69744
259,4,17,false,2,1,-1,41.91853,-87.69745
310,4,17,false,4,5,1,41.91984,-87.68083
225,4,17,false,8,13,5,41.91995,-87.64884
13192,4,17,false,72,101,29,41.91995,-87.64884
13288,4,17,false,42,25,-17,41.92008,-87.67788
13242,4,17,false,21,25,4,41.92021,-87.69266
222,4,17,false,3,4,1,41.92023,-87.69265
307,4,17,false,4,7,3,41.92077,-87.66373
TA1309000030,4,17,false,43,81,38,41.92077,-87.66372
290,4,17,false,4,1,-3,41.92152,-87.70734
13292,4,17,false,24,15,-9,41.92152,-87.70733
TA1309000033,4,17,false,83,88,5,41.92158,-87.65381
13193,4,17,false,149,177,28,41.92182,-87.64412
144,4,17,false,10,22,12,41.92182,-87.64411
13191,4,17,false,90,65,-25,41.92217,-87.63891
143,4,17,false,8,8,0,41.92217,-87.63891
327,4,17,false,12,10,-2,41.92225,-87.65783
13084,4,17,false,42,58,16,41.92268,-87.69715
123,4,17,false,4,5,1,41.92268,-87.69714
LP-,4,17,false,75,52,-23,41.92396,-87.63584
673,4,17,false,12,4,-8,41.92398,-87.63585
KA1504000140,4,17,false,22,16,-6,41.92409,-87.67646
505,4,17,false,1,3,2,41.92409,-87.67646
16010,4,17,false,7,9,2,41.92458,-87.72787
504,4,17,false,2,3,1,41.92464,-87.68931
15648,4,17,false,16,22,6,41.92464,-87.68931
503,4,17,false,3,4,1,41.92483,-87.71451
KA1504000090,4,17,false,5,9,4,41.92483,-87.7145
TA1307000001,4,17,false,64,83,19,41.92535,-87.66581
188,4,17,false,9,12,3,41.92536,-87.66581
TA1306000026,4,17,false,73,52,-21,41.92558,-87.65842
87,4,17,false,5,6,1,41.92559,-87.65843
TA1306000016,4,17,false,93,90,-3,41.9256,-87.65371
67,4,17,false,13,12,-1,41.9256,-87.65371
313,4,17,false,20,17,-3,41.9257,-87.64246
TA1309000019,4,17,false,140,114,-26,41.92586,-87.63897
TA1309000058,4,17,false,99,115,16,41.92591,-87.64927
127,4,17,false,19,13,-6,41.92592,-87.64927
177,4,17,false,27,30,3,41.92627,-87.63086
TA1308000001,4,17,false,128,171,43,41.92627,-87.63086
502,4,17,false,2,3,1,41.92667,-87.69772
15646,4,17,false,24,23,-1,41.92668,-87.6977
34,4,17,false,2,4,2,41.92675,-87.63444
13124,4,17,false,26,37,11,41.92675,-87.63444
302,4,17,false,2,10,8,41.92859,-87.65421
TA1309000023,4,17,false,102,83,-19,41.9287,-87.65383
TA1307000113,4,17,false,83,85,2,41.92878,-87.66391
190,4,17,false,8,6,-2,41.92878,-87.6639
166,4,17,false,2,6,4,41.92883,-87.66853
13296,4,17,false,44,32,-12,41.92883,-87.66852
TA1309000059,4,17,false,42,20,-22,41.92889,-87.65898
343,4,17,false,4,4,0,41.92889,-87.65898
349,4,17,false,16,9,-7,41.92915,-87.6491
TA1309000061,4,17,false,122,85,-37,41.92915,-87.64909
258,4,17,false,2,8,6,41.92946,-87.68417
TA1308000031,4,17,false,22,30,8,41.92946,-87.68417
TA1305000014,4,17,false,132,97,-35,41.92956,-87.64313
340,4,17,false,16,14,-2,41.92956,-87.64313
260,4,17,false,5,8,3,41.92958,-87.70791
13085,4,17,false,41,49,8,41.92958,-87.70789
499,4,17,false,4,3,-1,41.93056,-87.72381
15643,4,17,false,13,15,2,41.93057,-87.7238
TA1307000142,4,17,false,136,83,-53,41.93125,-87.64432
220,4,17,false,20,10,-10,41.93125,-87.64431
13276,4,17,false,108,75,-33,41.93132,-87.63874
324,4,17,false,23,14,-9,41.93173,-87.64179
15645,4,17,false,14,12,-2,41.93191,-87.70121
13271,4,17,false,27,16,-11,41.93192,-87.67784
152,4,17,false,15,15,0,41.93221,-87.65864
TA1307000064,4,17,false,89,64,-25,41.93222,-87.65864
TA1306000014,4,17,false,143,85,-58,41.93242,-87.65271
13,4,17,false,14,12,-2,41.93242,-87.65271
TA1309000039,4,17,false,141,127,-14,41.93258,-87.63642
329,4,17,false,17,18,1,41.93258,-87.63642
13294,4,17,false,39,22,-17,41.9326,-87.66595
TA1309000036,4,17,false,79,43,-36,41.93313,-87.64776
332,4,17,false,11,6,-5,41.93313,-87.64776
15644,4,17,false,8,8,0,41.93534,-87.71687
500,4,17,false,2,2,0,41.93534,-87.71686
TA1307000006,4,17,false,68,27,-41,41.93571,-87.6636
153,4,17,false,19,6,-13,41.93575,-87.66364
162,4,17,false,2,11,9,41.93588,-87.67844
13268,4,17,false,32,45,13,41.93588,-87.67843
250,4,17,false,3,2,-1,41.93609,-87.66984
13269,4,17,false,26,16,-10,41.93609,-87.66983
TA1307000052,4,17,false,86,71,-15,41.93628,-87.65266
115,4,17,false,18,15,-3,41.93628,-87.65266
156,4,17,false,13,14,1,41.9365,-87.64756
TA1307000136,4,17,false,99,66,-33,41.9365,-87.64755
TA1307000041,4,17,false,116,92,-24,41.93669,-87.63683
157,4,17,false,17,25,8,41.9367,-87.63683
13137,4,17,false,161,111,-50,41.9376,-87.6441
300,4,17,false,21,20,-1,41.93761,-87.6441
498,4,17,false,2,1,-1,41.93843,-87.69801
15642,4,17,false,20,33,13,41.93843,-87.69801
154,4,17,false,11,13,2,41.93912,-87.66384
664,4,17,false,4,4,0,41.93934,-87.68327
KA17018068,4,17,false,29,21,-8,41.93935,-87.68327
TA1309000042,4,17,false,64,47,-17,41.93937,-87.66836
131,4,17,false,11,4,-7,41.93937,-87.66835
KA150400009X,4,17,false,6,9,3,41.9394,-87.71159
15640,4,17,false,6,14,8,41.93941,-87.72357
497,4,17,false,1,1,0,41.93941,-87.71159
13229,4,17,false,90,48,-42,41.93946,-87.66376
226,4,17,false,7,11,4,41.93972,-87.65886
TA1308000019,4,17,false,84,75,-9,41.93973,-87.65886
473,4,17,false,1,2,1,41.94,-87.77013
296,4,17,false,11,9,-2,41.9401,-87.64546
13277,4,17,false,74,82,8,41.9401,-87.64546
TA1307000134,4,17,false,157,91,-66,41.94016,-87.65303
117,4,17,false,20,21,1,41.94016,-87.65302
228,4,17,false,1,2,1,41.94058,-87.67854
13143,4,17,false,23,8,-15,41.94059,-87.67853
334,4,17,false,17,11,-6,41.94076,-87.63919
TA1309000049,4,17,false,120,107,-13,41.94077,-87.63919
308,4,17,false,1,1,0,41.94152,-87.68471
493,4,17,false,1,1,0,41.94304,-87.68729
15634,4,17,false,4,5,1,41.94304,-87.68729
TA1307000138,4,17,false,50,52,2,41.94334,-87.67094
230,4,17,false,8,4,-4,41.94335,-87.67093
13144,4,17,false,14,32,18,41.9434,-87.67964
TA1309000025,4,17,false,133,106,-27,41.94368,-87.64894
299,4,17,false,7,10,3,41.94368,-87.64894
229,4,17,false,14,12,-2,41.94372,-87.66401
13071,4,17,false,88,65,-23,41.94373,-87.66401
632,4,17,false,123,111,-12,41.94453,-87.6547
303,4,17,false,15,15,0,41.94522,-87.64702
490,4,17,false,1,1,0,41.94523,-87.70664
15631,4,17,false,8,18,10,41.94524,-87.70665
13278,4,17,false,70,64,-6,41.94553,-87.64644
TA1309000050,4,17,false,13,14,1,41.94618,-87.67331
KA1504000141,4,17,false,1,1,0,41.94627,-87.73105
488,4,17,false,1,2,1,41.94627,-87.73105
15632,4,17,false,10,8,-2,41.94664,-87.69463
491,4,17,false,1,1,0,41.94664,-87.69463
KA1504000143,4,17,false,10,10,0,41.94664,-87.68337
KA1504000142,4,17,false,7,2,-5,41.94735,-87.71759
16994,4,17,false,2,3,1,41.94784,-87.74
227,4,17,false,8,6,-2,41.94813,-87.66397
13235,4,17,false,68,78,10,41.94814,-87.66396
304,4,17,false,8,13,5,41.94878,-87.64922
257,4,17,false,3,2,-1,41.9488,-87.67527
13253,4,17,false,11,11,0,41.9488,-87.67527
13325,4,17,false,79,76,-3,41.94907,-87.64863
114,4,17,false,11,9,-2,41.94935,-87.65451
TA1307000126,4,17,false,110,117,7,41.94936,-87.65451
232,4,17,false,7,15,8,41.94943,-87.64645
TA1307000150,4,17,false,92,102,10,41.94945,-87.64646
18016,4,17,false,12,3,-9,41.94993,-87.71395
13319,4,17,false,27,25,-2,41.95069,-87.6687
TA1307000127,4,17,false,111,99,-12,41.9508,-87.65918
165,4,17,false,11,7,-4,41.95081,-87.65918
487,4,17,false,2,2,0,41.95216,-87.69806
15628,4,17,false,6,8,2,41.95216,-87.69806
318,4,17,false,1,4,3,41.95254,-87.6735
13323,4,17,false,72,36,-36,41.95282,-87.65
256,4,17,false,8,4,-4,41.95282,-87.65
15624,4,17,false,12,5,-7,41.95339,-87.73199
483,4,17,false,1,3,2,41.9534,-87.73199
314,4,17,false,5,2,-3,41.9535,-87.69199
485,4,17,false,1,3,2,41.95361,-87.70933
KA1504000096,4,17,false,8,7,-1,41.95361,-87.70932
590,4,17,false,2,3,1,41.95374,-87.74056
KA1504000139,4,17,false,10,6,-4,41.954,-87.71909
484,4,17,false,3,3,0,41.954,-87.71907
TA1309000043,4,17,false,29,29,0,41.95417,-87.66434
240,4,17,false,3,2,-1,41.95424,-87.65441
13063,4,17,false,60,61,1,41.95424,-87.65441
486,4,17,false,1,1,0,41.95431,-87.68607
KA1504000158,4,17,false,12,11,-1,41.95432,-87.68607
254,4,17,false,11,11,0,41.95438,-87.64806
TA1308000022,4,17,false,65,62,-3,41.95438,-87.64805
16991,4,17,false,2,4,2,41.95448,-87.7496
TA1307000149,4,17,false,28,18,-10,41.95467,-87.67392
298,4,17,false,1,1,0,41.95601,-87.68021
TA1309000026,4,17,false,20,25,5,41.95601,-87.6802
246,4,17,false,4,3,-1,41.95606,-87.66885
13249,4,17,false,13,15,2,41.95606,-87.66885
312,4,17,false,7,6,-1,41.95637,-87.6563
TA1308000047,4,17,false,19,13,-6,41.95709,-87.6642
13379,4,17,false,48,40,-8,41.95786,-87.6495
TA1309000018,4,17,false,11,19,8,41.95791,-87.67357
316,4,17,false,3,3,0,41.95841,-87.69401
306,4,17,false,4,2,-2,41.9585,-87.655
TA1309000027,4,17,false,34,27,-7,41.9585,-87.65499
592,4,17,false,8,6,-2,41.96065,-87.74538
13389,4,17,false,56,48,-8,41.961,-87.64958
245,4,17,false,6,8,2,41.96101,-87.64958
15621,4,17,false,11,5,-6,41.96103,-87.70586
480,4,17,false,1,2,1,41.96104,-87.70586
KA1706005015,4,17,false,6,1,-5,41.96108,-87.73569
15622,4,17,false,5,8,3,41.96108,-87.69544
KA1504000164,4,17,false,1,2,1,41.96109,-87.72897
KA1504000097,4,17,false,8,6,-2,41.96116,-87.71658
238,4,17,false,4,2,-2,41.96141,-87.6762
TA1307000144,4,17,false,16,12,-4,41.96142,-87.6762
TA1309000021,4,17,false,15,11,-4,41.9615,-87.6714
482,4,17,false,1,1,0,41.96154,-87.69117
15623,4,17,false,3,8,5,41.96154,-87.69117
234,4,17,false,3,3,0,41.96158,-87.6661
KA1503000022,4,17,false,25,13,-12,41.96158,-87.66609
231,4,17,false,5,4,-1,41.96163,-87.65464
TA1307000107,4,17,false,62,42,-20,41.96164,-87.65464
TA1307000156,4,17,false,15,21,6,41.96301,-87.68479
243,4,17,false,2,2,0,41.96302,-87.68479
TA1309000012,4,17,false,17,17,0,41.96325,-87.67928
249,4,17,false,6,6,0,41.96398,-87.63818
TA1308000012,4,17,false,82,93,11,41.96398,-87.63818
293,4,17,false,5,2,-3,41.96521,-87.65822
13074,4,17,false,52,40,-12,41.96521,-87.6582
639,4,17,false,35,54,19,41.96584,-87.64538
KA1504000127,4,17,false,7,10,3,41.96587,-87.70083
KA1504000093,4,17,false,9,11,2,41.96587,-87.69365
478,4,17,false,1,1,0,41.96587,-87.69364
TA1307000140,4,17,false,22,32,10,41.96643,-87.68865
239,4,17,false,2,3,1,41.9665,-87.68843
326,4,17,false,1,7,6,41.96665,-87.67113
KA1504000126,4,17,false,14,3,-11,41.96668,-87.70807
TA1309000014,4,17,false,38,35,-3,41.96709,-87.66744
TA1307000158,4,17,false,15,8,-7,41.9671,-87.67904
242,4,17,false,1,4,3,41.9671,-87.67904
TA1307000119,4,17,false,24,25,1,41.96796,-87.65
251,4,17,false,3,5,2,41.96796,-87.65
15615,4,17,false,8,5,-3,41.96835,-87.71183
474,4,17,false,4,8,4,41.96835,-87.71182
TA1308000021,4,17,false,28,28,0,41.96883,-87.65765
253,4,17,false,2,3,1,41.96883,-87.65765
475,4,17,false,3,6,3,41.96885,-87.69611
KA1504000080,4,17,false,15,10,-5,41.96887,-87.69609
TA1309000015,4,17,false,18,10,-8,41.96889,-87.68401
311,4,17,false,2,1,-1,41.9689,-87.68402
TA1309000066,4,17,false,69,44,-25,41.9691,-87.67423
344,4,17,false,10,8,-2,41.9691,-87.67423
TA1309000041,4,17,false,29,13,-16,41.96951,-87.65471
KA1504000171,4,17,false,46,31,-15,41.97161,-87.65016
465,4,17,false,6,5,-1,41.97161,-87.65016
TA1309000035,4,17,false,36,40,4,41.97335,-87.66785
295,4,17,false,3,6,3,41.97378,-87.65972
13108,4,17,false,26,32,6,41.97379,-87.65971
KA1504000078,4,17,false,11,5,-6,41.97491,-87.69258
472,4,17,false,2,6,4,41.97492,-87.69262
464,4,17,false,1,2,1,41.97562,-87.67945
KA1504000149,4,17,false,10,16,6,41.97562,-87.67945
KA1504000160,4,17,false,15,11,-4,41.97564,-87.70143
KA1504000128,4,17,false,3,5,2,41.97567,-87.70927
463,4,17,false,3,11,8,41.978,-87.66805
KA1504000146,4,17,false,31,46,15,41.978,-87.66805
13109,4,17,false,30,19,-11,41.97835,-87.65976
294,4,17,false,3,1,-2,41.97835,-87.65976
KA1504000147,4,17,false,10,9,-1,41.97976,-87.67754
655,4,17,false,11,2,-9,41.97987,-87.68194
KA1504000161,4,17,false,2,1,-1,41.98038,-87.71612
KA1504000167,4,17,false,8,4,-4,41.98206,-87.70895
494,4,17,false,3,4,1,41.98234,-87.70892
460,4,17,false,4,2,-2,41.98358,-87.66916
KA1504000151,4,17,false,22,35,13,41.98359,-87.66916
15585,4,17,false,4,4,0,41.98367,-87.69642
KA1504000152,4,17,false,92,60,-32,41.98403,-87.65231
459,4,17,false,10,10,0,41.98403,-87.65231
15578,4,17,false,33,27,-6,41.98405,-87.66027
353,4,17,false,3,2,-1,41.98656,-87.70761
15575,4,17,false,16,23,7,41.98975,-87.66014
458,4,17,false,6,6,0,41.98975,-87.66013
KA1504000130,4,17,false,2,3,1,41.99024,-87.69338
457,4,17,false,1,1,0,41.99052,-87.66982
KA1504000148,4,17,false,12,12,0,41.99086,-87.66971
456,4,17,false,3,1,-2,41.99117,-87.68359
KA1504000129,4,17,false,7,3,-4,41.99417,-87.68945
452,4,17,false,1,2,1,41.99417,-87.68945
15571,4,17,false,32,27,-5,41.99478,-87.66028
454,4,17,false,2,2,0,41.99478,-87.66027
KA1504000156,4,17,false,15,7,-8,41.99925,-87.67137
RP-009,4,17,false,12,23,11,42.00107,-87.66122
451,4,17,false,3,5,2,42.00108,-87.66123
450,4,17,false,2,1,-1,42.00179,-87.68883
RP-001,4,17,false,10,9,-1,42.00179,-87.68883
RP-008,4,17,false,5,9,4,42.00446,-87.6724
RP-002,4,17,false,1,2,1,42.00456,-87.68065
660,4,17,false,11,16,5,42.00458,-87.66143
354,4,17,false,1,1,0,42.00587,-87.66802
KA1504000175,4,17,false,13,5,-8,42.00797,-87.66549
447,4,17,false,2,8,6,42.00797,-87.66548
467,4,17,false,1,3,2,42.0086,-87.69047
RP-005,4,17,false,2,4,2,42.0086,-87.69047
432,4,17,false,2,1,-1,42.00907,-87.67423
KA1504000162,4,17,false,6,7,1,42.00907,-87.67422
KA1504000159,4,17,false,8,5,-3,42.01059,-87.66241
RP-006,4,17,false,4,1,-3,42.01213,-87.68292
RP-004,4,17,false,16,3,-13,42.01234,-87.68825
RP-007,4,17,false,3,1,-2,42.01256,-87.67431
525,4,17,false,10,12,2,42.01272,-87.66605
517,4,17,false,5,5,0,42.01597,-87.675
520,4,17,false,2,3,1,42.01597,-87.66859
519,4,17,false,4,2,-2,42.01696,-87.67773
527,4,17,false,4,6,2,42.01892,-87.69004
515,4,17,false,6,8,2,42.01915,-87.67356
514,4,17,false,2,5,3,42.01927,-87.68452
16806,4,17,false,5,2,-3,42.01953,-87.66955
523,4,17,false,11,8,-3,42.02089,-87.66505
662,4,17,false,5,5,0,42.02354,-87.69961
597,4,17,false,4,1,-3,42.03256,-87.67914
E002,4,17,false,18,15,-3,42.03256,-87.67912
E011,4,17,false,4,2,-2,42.03473,-87.69912
599,4,17,false,5,5,0,42.03972,-87.69942
596,4,17,false,21,30,9,42.04822,-87.68348
600,4,17,false,3,4,1,42.04831,-87.6983
E008,4,17,false,35,13,-22,42.05049,-87.67782
605,4,17,false,10,14,4,42.05294,-87.67342
661,4,17,false,7,6,-1,42.05704,-87.68657
604,4,17,false,30,23,-7,42.05824,-87.67744
E006,4,17,false,2,6,4,42.06367,-87.69871
E007,4,17,false,1,1,0,42.06431,-87.68615
E014,4,17,false,1,4,3,42.06483,-87.71531
20207,4,17,true,1,1,0,41.68496,-87.6453
20224,4,17,true,2,2,0,41.71371,-87.53083
20110,4,17,true,1,1,0,41.72933,-87.61076
692,4,17,true,1,1,0,41.7337,-87.55844
20229,4,17,true,1,1,0,41.73734,-87.54849
20121,4,17,true,1,1,0,41.74152,-87.65842
585,4,17,true,2,1,-1,41.74344,-87.60485
395,4,17,true,1,1,0,41.75713,-87.57585
KA1503000024,4,17,true,1,1,0,41.75876,-87.56644
KA1503000020,4,17,true,3,2,-1,41.76223,-87.55923
KA1503000002,4,17,true,6,10,4,41.76641,-87.5657
KA1503000029,4,17,true,3,6,3,41.77364,-87.56747
KA1503000021,4,17,true,2,3,1,41.77888,-87.58665
KA1503000055,4,17,true,1,1,0,41.77939,-87.64463
KA1503000053,4,17,true,3,1,-2,41.78009,-87.61595
KA1503000054,4,17,true,4,3,-1,41.78061,-87.60582
15491,4,17,true,2,2,0,41.78096,-87.57624
101,4,17,true,2,1,-1,41.78105,-87.57611
562,4,17,true,1,1,0,41.78319,-87.65437
KA1503000033,4,17,true,1,1,0,41.78411,-87.61329
KA1503000014,4,17,true,79,65,-14,41.7851,-87.60108
426,4,17,true,20,32,12,41.7851,-87.60108
KA1503000070,4,17,true,14,13,-1,41.78794,-87.58831
425,4,17,true,8,2,-6,41.78795,-87.58831
328,4,17,true,18,4,-14,41.78872,-87.6013
TA1309000011,4,17,true,66,25,-41,41.78873,-87.60131
KA1503000071,4,17,true,154,49,-105,41.79148,-87.59988
423,4,17,true,16,10,-6,41.79148,-87.59988
KA1503000075,4,17,true,5,1,-4,41.79156,-87.60785
424,4,17,true,2,1,-1,41.79174,-87.58395
KA1503000074,4,17,true,10,12,2,41.79174,-87.58395
TA1309000063,4,17,true,27,77,50,41.79325,-87.5878
345,4,17,true,12,15,3,41.79326,-87.5878
420,4,17,true,15,20,5,41.79429,-87.60145
KA1504000076,4,17,true,76,54,-22,41.7943,-87.60145
TA1307000160,4,17,true,3,3,0,41.79485,-87.61873
KA1503000013,4,17,true,1,2,1,41.79498,-87.63312
247,4,17,true,8,19,11,41.79522,-87.58077
TA1308000009,4,17,true,34,67,33,41.79522,-87.58075
TA1307000164,4,17,true,37,41,4,41.79527,-87.59647
248,4,17,true,9,11,2,41.79528,-87.59647
646,4,17,true,1,2,1,41.79663,-87.62592
KA1503000052,4,17,true,35,41,6,41.79935,-87.60097
418,4,17,true,14,10,-4,41.79936,-87.60097
419,4,17,true,7,5,-2,41.79952,-87.58643
KA1503000059,4,17,true,18,29,11,41.79952,-87.58643
TA1309000037,4,17,true,50,108,58,41.79957,-87.59474
415,4,17,true,2,1,-1,41.80228,-87.61807
15470,4,17,true,1,5,4,41.80228,-87.61807
417,4,17,true,5,5,0,41.80242,-87.5869
KA1503000007,4,17,true,29,56,27,41.80242,-87.58689
121,4,17,true,11,9,-2,41.80256,-87.59035
13398,4,17,true,24,35,11,41.80256,-87.59035
TA1309000067,4,17,true,7,8,1,41.80303,-87.60661
322,4,17,true,11,14,3,41.80321,-87.59849
594,4,17,true,2,1,-1,41.80567,-87.68337
416,4,17,true,2,1,-1,41.80578,-87.59247
KA1503000069,4,17,true,11,12,1,41.80579,-87.59247
KA1503000051,4,17,true,6,1,-5,41.80815,-87.64563
KA1503000009,4,17,true,1,3,2,41.80932,-87.63346
267,4,17,true,2,2,0,41.80944,-87.59188
TA1308000035,4,17,true,15,17,2,41.80944,-87.59188
252,4,17,true,3,3,0,41.80982,-87.59936
TA1308000002,4,17,true,5,9,4,41.80983,-87.59937
TA1308000007,4,17,true,2,2,0,41.80984,-87.61628
200,4,17,true,2,2,0,41.80985,-87.61628
TA1309000053,4,17,true,6,3,-3,41.80985,-87.60675
413,4,17,true,2,3,1,41.81408,-87.59701
KA1503000065,4,17,true,7,8,1,41.81409,-87.59701
KA1503000027,4,17,true,3,9,6,41.81666,-87.61942
KA1503000032,4,17,true,5,1,-4,41.81912,-87.64328
13083,4,17,true,2,5,3,41.82167,-87.62153
265,4,17,true,2,1,-1,41.82297,-87.6071
TA1308000038,4,17,true,5,4,-1,41.82298,-87.6071
15449,4,17,true,11,1,-10,41.82302,-87.62657
546,4,17,true,9,3,-6,41.82319,-87.67661
179,4,17,true,3,7,4,41.82458,-87.61678
13420,4,17,true,2,9,7,41.82459,-87.61678
18022,4,17,true,1,2,1,41.82672,-87.68315
262,4,17,true,1,5,4,41.82707,-87.64573
TA1307000161,4,17,true,1,1,0,41.82707,-87.64572
KA1503000068,4,17,true,8,5,-3,41.82878,-87.68062
KA1503000066,4,17,true,6,4,-2,41.83011,-87.67031
278,4,17,true,6,3,-3,41.83062,-87.64129
TA1308000045,4,17,true,8,20,12,41.83062,-87.64129
TA1308000043,4,17,true,12,8,-4,41.83066,-87.64715
279,4,17,true,2,3,1,41.83067,-87.64715
15446,4,17,true,6,9,3,41.83068,-87.65603
405,4,17,true,2,1,-1,41.83078,-87.6325
KA1503000005,4,17,true,16,10,-6,41.83079,-87.6325
184,4,17,true,13,2,-11,41.83104,-87.62684
TA1307000129,4,17,true,49,6,-43,41.83104,-87.62683
406,4,17,true,6,2,-4,41.83127,-87.6088
KA1503000004,4,17,true,7,7,0,41.83127,-87.6088
13345,4,17,true,8,4,-4,41.83138,-87.61803
15445,4,17,true,24,17,-7,41.83453,-87.63183
403,4,17,true,1,3,2,41.83453,-87.63183
13216,4,17,true,115,49,-66,41.83473,-87.62581
148,4,17,true,19,2,-17,41.83474,-87.62581
149,4,17,true,1,5,4,41.83486,-87.61791
13217,4,17,true,35,58,23,41.83488,-87.61792
13215,4,17,true,26,32,6,41.83634,-87.6135
263,4,17,true,2,2,0,41.8364,-87.61348
280,4,17,true,2,4,2,41.83779,-87.65116
TA1308000046,4,17,true,13,43,30,41.83779,-87.65115
339,4,17,true,5,15,10,41.83817,-87.64523
TA1309000055,4,17,true,24,69,45,41.8382,-87.64514
402,4,17,true,6,10,4,41.83845,-87.6354
KA1503000038,4,17,true,11,20,9,41.83845,-87.6354
150,4,17,true,13,10,-3,41.83855,-87.60821
TA1307000048,4,17,true,44,45,1,41.83855,-87.60821
272,4,17,true,2,4,2,41.83882,-87.62186
TA1308000036,4,17,true,30,56,26,41.83883,-87.62186
368,4,17,true,1,2,1,41.83915,-87.66562
15442,4,17,true,8,2,-6,41.83918,-87.66562
KA1504000168,4,17,true,4,3,-1,41.84152,-87.68514
366,4,17,true,1,1,0,41.84164,-87.65744
KA1503000040,4,17,true,8,18,10,41.84164,-87.65744
13213,4,17,true,16,3,-13,41.84171,-87.62694
237,4,17,true,7,12,5,41.84204,-87.61697
TA1307000139,4,17,true,62,67,5,41.84205,-87.61698
15443,4,17,true,6,10,4,41.84275,-87.63549
207,4,17,true,3,10,7,41.84358,-87.64539
TA1307000153,4,17,true,15,37,22,41.84358,-87.64538
15691,4,17,true,2,3,1,41.84449,-87.70203
444,4,17,true,1,1,0,41.8445,-87.70202
KA1504000110,4,17,true,1,1,0,41.84454,-87.71596
147,4,17,true,9,7,-2,41.84569,-87.62251
TA1307000005,4,17,true,11,23,12,41.84569,-87.6225
TA1308000013,4,17,true,20,9,-11,41.84719,-87.64681
15687,4,17,true,1,1,0,41.8481,-87.71508
441,4,17,true,1,1,0,41.8482,-87.70543
TA1309000003,4,17,true,8,4,-4,41.84847,-87.68512
15689,4,17,true,1,9,8,41.84912,-87.69515
TA1307000066,4,17,true,2,10,8,41.8492,-87.67564
TA1308000014,4,17,true,6,13,7,41.84953,-87.64059
209,4,17,true,2,6,4,41.84953,-87.64058
132,4,17,true,4,3,-1,41.85008,-87.63215
TA1308000026,4,17,true,6,14,8,41.85008,-87.63214
TA1305000004,4,17,true,8,6,-2,41.8514,-87.61884
62,4,17,true,2,5,3,41.85141,-87.61884
42,4,17,true,4,7,3,41.85261,-87.62653
TA1305000001,4,17,true,13,26,13,41.85262,-87.6265
13075,4,17,true,62,43,-19,41.8531,-87.63192
120,4,17,true,19,13,-6,41.8531,-87.63191
13162,4,17,true,3,17,14,41.85378,-87.64659
13096,4,17,true,9,13,4,41.8538,-87.69577
15685,4,17,true,7,1,-6,41.85399,-87.71511
13091,4,17,true,17,12,-5,41.85409,-87.68585
203,4,17,true,3,1,-2,41.85409,-87.68585
370,4,17,true,2,3,1,41.85415,-87.61917
15546,4,17,true,18,27,9,41.85416,-87.61916
208,4,17,true,1,3,2,41.85489,-87.66359
13307,4,17,true,16,19,3,41.85489,-87.66359
124,4,17,true,1,1,0,41.85492,-87.67609
13089,4,17,true,21,15,-6,41.85497,-87.67567
13331,4,17,true,18,13,-5,41.85515,-87.65414
171,4,17,true,8,4,-4,41.85516,-87.65414
4,4,17,true,26,21,-5,41.85627,-87.61334
15545,4,17,true,95,98,3,41.85627,-87.61334
178,4,17,true,1,5,4,41.85657,-87.62755
SL-013,4,17,true,21,40,19,41.85659,-87.62755
218,4,17,true,4,4,0,41.85679,-87.63387
SL-006,4,17,true,24,21,-3,41.8568,-87.63387
129,4,17,true,4,10,6,41.85752,-87.66158
202,4,17,true,2,3,1,41.85752,-87.64621
13135,4,17,true,27,48,21,41.85753,-87.66157
338,4,17,true,2,12,10,41.85758,-87.61956
13102,4,17,true,77,127,50,41.85762,-87.61942
273,4,17,true,25,17,-8,41.85783,-87.62455
13150,4,17,true,84,121,37,41.85783,-87.62455
13099,4,17,true,24,21,-3,41.85784,-87.64627
205,4,17,true,4,11,7,41.8579,-87.6687
TA1307000159,4,17,true,25,42,17,41.8579,-87.6687
170,4,17,true,7,1,-6,41.85793,-87.64083
TA1307000044,4,17,true,35,10,-25,41.85794,-87.64083
14,4,17,true,1,7,6,41.85808,-87.65109
13163,4,17,true,23,50,27,41.85808,-87.65108
13164,4,17,true,40,54,14,41.85818,-87.65648
15,4,17,true,1,6,5,41.85819,-87.65648
SL-012,4,17,true,66,105,39,41.86038,-87.62581
72,4,17,true,13,16,3,41.86039,-87.62581
13304,4,17,true,26,27,1,41.86126,-87.65659
KA1504000109,4,17,true,14,2,-12,41.86192,-87.69347
TA1306000002,4,17,true,44,45,1,41.86238,-87.65108
137,4,17,true,7,11,4,41.86238,-87.65108
TA1307000124,4,17,true,110,158,48,41.86411,-87.62372
168,4,17,true,20,37,17,41.86415,-87.62372
282,4,17,true,4,8,4,41.86487,-87.64708
TA1309000001,4,17,true,67,66,-1,41.86488,-87.64708
136,4,17,true,2,1,-1,41.86504,-87.65698
13165,4,17,true,5,13,8,41.86505,-87.65697
275,4,17,true,5,11,6,41.86524,-87.66651
13354,4,17,true,22,36,14,41.86524,-87.66651
97,4,17,true,6,2,-4,41.86531,-87.6179
13029,4,17,true,10,13,3,41.86531,-87.6179
341,4,17,true,30,23,-7,41.86608,-87.60733
13431,4,17,true,58,51,-7,41.8661,-87.60728
KA1504000101,4,17,true,16,10,-6,41.86651,-87.68466
434,4,17,true,1,4,3,41.86651,-87.68465
KA1504000102,4,17,true,9,3,-6,41.86664,-87.69453
WL-008,4,17,true,44,85,41,41.86712,-87.64108
57,4,17,true,18,26,8,41.86712,-87.64107
59,4,17,true,41,50,9,41.86721,-87.62597
TA1305000002,4,17,true,174,249,75,41.86721,-87.62597
3,4,17,true,10,10,0,41.86723,-87.61536
15544,4,17,true,38,42,4,41.86723,-87.61536
TA1305000017,4,17,true,45,21,-24,41.86734,-87.64863
55,4,17,true,9,2,-7,41.86735,-87.64863
626,4,17,true,15,5,-10,41.86749,-87.63219
KA1706005007,4,17,true,36,39,3,41.86749,-87.63219
SL-005,4,17,true,128,192,64,41.8679,-87.62304
255,4,17,true,25,21,-4,41.86791,-87.62304
644,4,17,true,45,47,2,41.86859,-87.68625
19,4,17,true,13,12,-1,41.86892,-87.65913
13139,4,17,true,52,58,6,41.86893,-87.65913
13285,4,17,true,159,19,-140,41.86928,-87.67372
22,4,17,true,11,18,7,41.86947,-87.65548
13160,4,17,true,82,108,26,41.86947,-87.65548
382,4,17,true,4,6,2,41.8699,-87.68725
414,4,17,true,6,17,11,41.87023,-87.63947
15550,4,17,true,28,69,41,41.87024,-87.63947
TA1309000010,4,17,true,102,137,35,41.87074,-87.62574
SL-009,4,17,true,44,64,20,41.87081,-87.63121
342,4,17,true,28,9,-19,41.87127,-87.6737
TA1309000064,4,17,true,162,38,-124,41.87127,-87.67369
15542,4,17,true,14,5,-9,41.87146,-87.64095
261,4,17,true,22,5,-17,41.87151,-87.6699
13080,4,17,true,6,1,-5,41.87151,-87.66989
TA1307000130,4,17,true,71,74,3,41.87178,-87.65103
241,4,17,true,14,11,-3,41.8718,-87.65102
108,4,17,true,7,18,11,41.87183,-87.64664
TA1307000121,4,17,true,95,108,13,41.87184,-87.64664
41,4,17,true,20,48,28,41.87209,-87.62957
SL-008,4,17,true,117,209,92,41.87209,-87.62956
13332,4,17,true,150,142,-8,41.87219,-87.6615
394,4,17,true,9,6,-3,41.87226,-87.63484
175,4,17,true,15,22,7,41.87255,-87.63359
SL-011,4,17,true,67,107,40,41.87256,-87.63356
623,4,17,true,49,93,44,41.87272,-87.62399
KA1504000104,4,17,true,132,22,-110,41.87296,-87.66912
383,4,17,true,46,4,-42,41.87297,-87.66912
320,4,17,true,20,24,4,41.87327,-87.66402
5,4,17,true,9,8,-1,41.87403,-87.6277
SL-007,4,17,true,55,67,12,41.87404,-87.6277
169,4,17,true,7,6,-1,41.87424,-87.63959
13326,4,17,true,47,19,-28,41.87425,-87.63958
321,4,17,true,17,24,7,41.87427,-87.63257
TA1306000025,4,17,true,38,28,-10,41.87464,-87.65703
32,4,17,true,8,5,-3,41.87464,-87.65703
15668,4,17,true,19,17,-2,41.87471,-87.68642
13028,4,17,true,65,53,-12,41.87475,-87.64981
109,4,17,true,10,9,-1,41.87475,-87.64981
13081,4,17,true,60,17,-43,41.87501,-87.67326
122,4,17,true,12,6,-6,41.87501,-87.67325
89,4,17,true,8,7,-1,41.87501,-87.6331
SL-010,4,17,true,70,70,0,41.87501,-87.63309
15541,4,17,true,21,16,-5,41.8758,-87.62086
68,4,17,true,18,1,-17,41.87587,-87.64077
13037,4,17,true,34,24,-10,41.87588,-87.64078
50,4,17,true,22,19,-3,41.87592,-87.6307
TA1305000009,4,17,true,90,66,-24,41.87593,-87.63068
317,4,17,true,35,8,-27,41.87603,-87.68195
TA1305000010,4,17,true,34,17,-17,41.87623,-87.62444
45,4,17,true,8,6,-2,41.87623,-87.62444
624,4,17,true,77,60,-17,41.87626,-87.62923
2,4,17,true,5,5,0,41.87649,-87.62051
33,4,17,true,13,2,-11,41.87715,-87.62786
TA1305000035,4,17,true,88,41,-47,41.87716,-87.62787
13138,4,17,true,109,30,-79,41.87723,-87.63941
75,4,17,true,12,8,-4,41.87724,-87.63937
631,4,17,true,26,7,-19,41.87761,-87.6739
15539,4,17,true,99,107,8,41.87763,-87.64405
13158,4,17,true,99,151,52,41.87764,-87.64957
134,4,17,true,19,34,15,41.87764,-87.64954
21,4,17,true,10,22,12,41.87773,-87.6548
13157,4,17,true,85,113,28,41.87773,-87.6548
TA1305000025,4,17,true,172,60,-112,41.87773,-87.63528
36,4,17,true,48,5,-43,41.87776,-87.63525
TA1309000002,4,17,true,58,46,-12,41.87784,-87.62408
284,4,17,true,11,13,2,41.87784,-87.62408
146,4,17,true,11,19,8,41.87794,-87.66201
13206,4,17,true,61,72,11,41.87794,-87.66201
283,4,17,true,36,5,-31,41.87809,-87.63183
TA1309000004,4,17,true,192,31,-161,41.87811,-87.63184
107,4,17,true,26,32,6,41.87822,-87.644
638,4,17,true,244,157,-87,41.87827,-87.64078
37,4,17,true,37,4,-33,41.87921,-87.62975
TA1305000005,4,17,true,208,38,-170,41.87924,-87.62975
286,4,17,true,20,2,-18,41.8793,-87.6355
13011,4,17,true,277,267,-10,41.87931,-87.63993
TA1309000008,4,17,true,130,29,-101,41.87933,-87.6355
192,4,17,true,25,32,7,41.87935,-87.63997
KA1503000034,4,17,true,89,13,-76,41.87938,-87.63197
39,4,17,true,19,7,-12,41.87948,-87.62571
KA1503000015,4,17,true,125,55,-70,41.87948,-87.6257
15667,4,17,true,18,16,-2,41.8798,-87.68609
381,4,17,true,2,1,-1,41.87981,-87.68607
287,4,17,true,46,5,-41,41.88017,-87.63527
TA1309000007,4,17,true,204,29,-175,41.88022,-87.63526
16918,4,17,true,1,2,1,41.88028,-87.77447
WL-011,4,17,true,104,69,-35,41.88034,-87.64273
73,4,17,true,25,18,-7,41.8804,-87.64273
80,4,17,true,16,26,10,41.88042,-87.65556
13156,4,17,true,79,162,83,41.88042,-87.65554
13300,4,17,true,105,138,33,41.88097,-87.61675
76,4,17,true,37,36,-1,41.88098,-87.61675
13008,4,17,true,148,74,-74,41.88105,-87.62408
90,4,17,true,19,17,-2,41.88107,-87.62409
49,4,17,true,80,5,-75,41.88116,-87.62963
TA1305000006,4,17,true,327,81,-246,41.88122,-87.6296
13134,4,17,true,13,19,6,41.88138,-87.67493
215,4,17,true,6,3,-3,41.88139,-87.67492
13056,4,17,true,126,95,-31,41.88168,-87.63951
191,4,17,true,11,19,8,41.88169,-87.63951
198,4,17,true,28,41,13,41.88187,-87.6488
TA1307000120,4,17,true,190,257,67,41.88188,-87.64879
13341,4,17,true,244,162,-82,41.88208,-87.63985
174,4,17,true,22,20,-2,41.88208,-87.63984
197,4,17,true,14,7,-7,41.88208,-87.62513
13036,4,17,true,102,56,-46,41.8821,-87.62513
77,4,17,true,44,43,-1,41.88214,-87.64108
TA1305000032,4,17,true,265,240,-25,41.88218,-87.64109
98,4,17,true,34,6,-28,41.88266,-87.63251
13006,4,17,true,177,31,-146,41.88268,-87.63252
13353,4,17,true,50,90,40,41.88283,-87.6612
346,4,17,true,7,12,5,41.88284,-87.6612
654,4,17,true,53,51,-2,41.88307,-87.65698
233,4,17,true,10,18,8,41.88309,-87.6511
13409,4,17,true,85,96,11,41.8831,-87.6511
18,4,17,true,32,10,-22,41.88317,-87.63735
KA1503000072,4,17,true,116,34,-82,41.88317,-87.63693
91,4,17,true,37,33,-4,41.88336,-87.64122
WL-012,4,17,true,392,316,-76,41.88337,-87.6412
112,4,17,true,15,31,16,41.88362,-87.6486
13053,4,17,true,163,162,-1,41.88365,-87.64863
43,4,17,true,31,19,-12,41.88396,-87.62455
13001,4,17,true,211,119,-92,41.88397,-87.62459
88,4,17,true,1,10,9,41.88407,-87.65691
13155,4,17,true,35,44,9,41.88407,-87.65689
18062,4,17,true,87,78,-9,41.88412,-87.65427
621,4,17,true,12,18,6,41.88412,-87.65427
81,4,17,true,50,26,-24,41.88417,-87.6296
TA1306000010,4,17,true,334,145,-189,41.88419,-87.62961
15666,4,17,true,6,6,0,41.88446,-87.6963
KA1504000106,4,17,true,1,1,0,41.88459,-87.70631
TA1305000030,4,17,true,285,58,-227,41.88459,-87.63178
15535,4,17,true,116,101,-15,41.8846,-87.64455
96,4,17,true,23,20,-3,41.8846,-87.64455
51,4,17,true,32,8,-24,41.88462,-87.63176
TA1305000029,4,17,true,173,124,-49,41.88466,-87.62787
195,4,17,true,53,38,-15,41.88466,-87.61952
13263,4,17,true,192,181,-11,41.88467,-87.61952
44,4,17,true,29,28,-1,41.88468,-87.62782
528,4,17,true,1,3,2,41.88537,-87.72661
TA1306000015,4,17,true,165,134,-31,41.88549,-87.65232
518,4,17,true,1,2,1,41.8855,-87.71686
71,4,17,true,24,38,14,41.8855,-87.65233
66,4,17,true,37,22,-15,41.88557,-87.64186
13021,4,17,true,212,158,-54,41.88559,-87.64184
TA1307000111,4,17,true,208,82,-126,41.88582,-87.63548
164,4,17,true,44,5,-39,41.88583,-87.63547
13073,4,17,true,21,31,10,41.88592,-87.66717
536,4,17,true,1,1,0,41.88593,-87.7354
119,4,17,true,8,7,-1,41.88593,-87.66717
KA17018054,4,17,true,32,16,-16,41.88595,-87.67701
656,4,17,true,10,2,-8,41.88595,-87.67701
KA1503000012,4,17,true,187,89,-98,41.88599,-87.63089
38,4,17,true,41,13,-28,41.88599,-87.63089
52,4,17,true,52,25,-27,41.886,-87.62421
TA1305000011,4,17,true,194,73,-121,41.886,-87.62418
7,4,17,true,19,26,7,41.88627,-87.61751
15534,4,17,true,86,98,12,41.88627,-87.61749
217,4,17,true,14,7,-7,41.8866,-87.65821
13197,4,17,true,73,57,-16,41.8866,-87.65816
264,4,17,true,28,13,-15,41.8867,-87.62224
TA1308000029,4,17,true,117,76,-41,41.88673,-87.62225
16903,4,17,true,1,1,0,41.88686,-87.74531
TA1307000131,4,17,true,137,54,-83,41.88688,-87.62606
194,4,17,true,31,11,-20,41.88688,-87.62606
6,4,17,true,5,11,6,41.88697,-87.61281
KA1503000064,4,17,true,65,89,24,41.88697,-87.61281
530,4,17,true,6,1,-5,41.88783,-87.75558
100,4,17,true,29,20,-9,41.88814,-87.63657
TA1305000022,4,17,true,204,107,-97,41.88817,-87.63656
56,4,17,true,62,46,-16,41.88866,-87.64442
TA1306000003,4,17,true,231,230,-1,41.88867,-87.64442
KA1503000043,4,17,true,376,340,-36,41.88918,-87.63851
133,4,17,true,66,64,-2,41.88918,-87.63851
13050,4,17,true,243,131,-112,41.88919,-87.62775
47,4,17,true,43,24,-19,41.88921,-87.62775
15664,4,17,true,19,23,4,41.8895,-87.68821
376,4,17,true,10,4,-6,41.88951,-87.68818
13432,4,17,true,56,49,-7,41.88989,-87.67149
285,4,17,true,6,14,8,41.88989,-87.67149
TA1307000151,4,17,true,287,185,-102,41.88993,-87.63427
Hubbard Bike-checking (LBS-WH-TEST),4,17,true,9,1,-8,41.88995,-87.68034
212,4,17,true,50,25,-25,41.88995,-87.63427
636,4,17,true,123,100,-23,41.88997,-87.63662
125,4,17,true,23,25,2,41.89018,-87.62621
KA1503000044,4,17,true,109,86,-23,41.89018,-87.6262
KA1504000113,4,17,true,2,1,-1,41.89049,-87.70262
196,4,17,true,14,15,1,41.89053,-87.62205
13427,4,17,true,103,94,-9,41.89054,-87.62205
26,4,17,true,13,38,25,41.89057,-87.61798
13430,4,17,true,213,162,-51,41.89077,-87.63169
181,4,17,true,38,29,-9,41.89077,-87.63168
TA1306000013,4,17,true,141,163,22,41.89083,-87.61852
RN-,4,17,true,163,120,-43,41.89102,-87.63546
672,4,17,true,32,27,-5,41.89102,-87.63545
277,4,17,true,8,15,7,41.89108,-87.66665
13434,4,17,true,29,82,53,41.89108,-87.66663
TA1308000006,4,17,true,46,39,-7,41.89128,-87.67686
199,4,17,true,41,42,1,41.89143,-87.62676
TA1307000117,4,17,true,248,196,-52,41.89144,-87.62675
13033,4,17,true,140,168,28,41.8916,-87.64835
214,4,17,true,7,6,-1,41.89161,-87.67688
84,4,17,true,25,24,-1,41.89161,-87.64833
186,4,17,true,16,26,10,41.8918,-87.65879
13194,4,17,true,74,103,29,41.8918,-87.65878
TA1305000003,4,17,true,174,135,-39,41.89187,-87.62061
24,4,17,true,45,33,-12,41.8919,-87.62063
643,4,17,true,17,31,14,41.89203,-87.68939
35,4,17,true,23,29,6,41.89227,-87.61206
13022,4,17,true,173,161,-12,41.89227,-87.61205
99,4,17,true,20,24,4,41.89255,-87.61449
TA1306000029,4,17,true,119,141,22,41.89256,-87.61449
13265,4,17,true,223,212,-11,41.89383,-87.64172
74,4,17,true,35,70,35,41.89384,-87.64173
13045,4,17,true,263,342,79,41.89403,-87.62931
110,4,17,true,64,59,-5,41.89406,-87.6293
13016,4,17,true,392,75,-317,41.89431,-87.62277
211,4,17,true,79,13,-66,41.89439,-87.62267
KA1503000041,4,17,true,182,118,-64,41.89452,-87.61798
142,4,17,true,56,22,-34,41.89453,-87.61806
92,4,17,true,16,21,5,41.89455,-87.65346
13196,4,17,true,103,110,7,41.89455,-87.65345
TA1307000062,4,17,true,152,98,-54,41.89466,-87.63839
111,4,17,true,34,14,-20,41.89466,-87.63837
TA1306000012,4,17,true,280,246,-34,41.89475,-87.63438
53,4,17,true,77,65,-12,41.89476,-87.63439
627,4,17,true,23,16,-7,41.8948,-87.63231
KP1705001026,4,17,true,140,132,-8,41.89483,-87.6323
16921,4,17,true,2,1,-1,41.89488,-87.77459
550,4,17,true,1,2,1,41.89495,-87.76491
16920,4,17,true,4,7,3,41.89495,-87.76491
KA1504000114,4,17,true,1,9,8,41.89547,-87.70614
18058,4,17,true,35,37,2,41.8955,-87.68201
659,4,17,true,3,16,13,41.8955,-87.68201
637,4,17,true,63,88,25,41.89563,-87.67209
128,4,17,true,6,18,12,41.89571,-87.67716
13132,4,17,true,68,119,51,41.89573,-87.67718
161,4,17,true,27,22,-5,41.89574,-87.62599
15530,4,17,true,131,119,-12,41.89575,-87.62596
18003,4,17,true,105,41,-64,41.89575,-87.62011
635,4,17,true,28,7,-21,41.89576,-87.62012
13247,4,17,true,59,86,27,41.89597,-87.66775
350,4,17,true,11,16,5,41.89597,-87.66774
TA1305000020,4,17,true,97,109,12,41.89636,-87.65406
54,4,17,true,19,24,5,41.89637,-87.65407
13289,4,17,true,45,103,58,41.89638,-87.661
86,4,17,true,10,14,4,41.89639,-87.661
337,4,17,true,27,14,-13,41.89659,-87.63096
13303,4,17,true,114,115,1,41.89672,-87.63088
13017,4,17,true,138,124,-14,41.89676,-87.6357
31,4,17,true,42,32,-10,41.89677,-87.63572
13338,4,17,true,125,66,-59,41.89697,-87.62173
173,4,17,true,46,19,-27,41.89704,-87.62173
TA1307000061,4,17,true,72,59,-13,41.89745,-87.62873
106,4,17,true,14,14,0,41.89746,-87.62874
25,4,17,true,27,17,-10,41.89751,-87.62354
13034,4,17,true,118,60,-58,41.89754,-87.62352
48,4,17,true,35,18,-17,41.89772,-87.64302
TA1306000009,4,17,true,208,86,-122,41.89772,-87.64299
620,4,17,true,147,113,-34,41.89817,-87.63754
374,4,17,true,7,17,10,41.89842,-87.68659
KA1504000103,4,17,true,57,76,19,41.89842,-87.68659
145,4,17,true,43,24,-19,41.89856,-87.62211
15529,4,17,true,185,121,-64,41.89858,-87.62206
140,4,17,true,59,44,-15,41.89895,-87.6299
TA1307000128,4,17,true,204,224,20,41.89896,-87.6299
657,4,17,true,48,71,23,41.89918,-87.6722
KA1504000117,4,17,true,29,17,-12,41.89936,-87.64848
365,4,17,true,6,2,-4,41.89936,-87.64848
30,4,17,true,4,4,0,41.89964,-87.66789
13248,4,17,true,56,101,45,41.89964,-87.66788
46,4,17,true,23,14,-9,41.89994,-87.63444
TA1306000011,4,17,true,80,102,22,41.89994,-87.63443
KA1504000116,4,17,true,76,65,-11,41.90023,-87.64299
364,4,17,true,15,15,0,41.90023,-87.64299
17660,4,17,true,40,37,-3,41.90036,-87.69671
622,4,17,true,8,4,-4,41.90037,-87.69671
13290,4,17,true,71,72,1,41.90069,-87.66259
29,4,17,true,11,17,6,41.90069,-87.66259
13042,4,17,true,180,154,-26,41.90097,-87.62377
85,4,17,true,28,28,0,41.90098,-87.62375
183,4,17,true,8,24,16,41.90133,-87.67744
TA1307000070,4,17,true,66,66,0,41.90133,-87.67742
KA1504000133,4,17,true,149,127,-22,41.90234,-87.62773
172,4,17,true,25,30,5,41.90236,-87.62774
15654,4,17,true,12,10,-2,41.90271,-87.70923
510,4,17,true,7,5,-2,41.90272,-87.70923
305,4,17,true,16,8,-8,41.9028,-87.69005
13241,4,17,true,50,32,-18,41.9029,-87.68731
176,4,17,true,57,82,25,41.90291,-87.63141
23,4,17,true,6,21,15,41.90292,-87.63772
TA1306000006,4,17,true,43,98,55,41.90292,-87.63772
TA1307000039,4,17,true,294,401,107,41.90294,-87.63137
658,4,17,true,74,31,-43,41.903,-87.6838
13256,4,17,true,38,28,-10,41.90302,-87.69749
216,4,17,true,9,8,-1,41.90302,-87.69749
17,4,17,true,15,21,6,41.90313,-87.67391
TA1305000034,4,17,true,69,81,12,41.90313,-87.67391
182,4,17,true,48,70,22,41.90317,-87.63442
KA1504000135,4,17,true,295,395,100,41.90319,-87.63439
13136,4,17,true,77,82,5,41.90326,-87.67845
130,4,17,true,28,19,-9,41.90327,-87.67846
210,4,17,true,46,28,-18,41.90342,-87.66781
13061,4,17,true,171,173,2,41.90342,-87.66779
KA1504000079,4,17,true,91,138,47,41.9035,-87.64334
359,4,17,true,20,27,7,41.90458,-87.6497
138,4,17,true,13,19,6,41.9046,-87.64057
TA1307000115,4,17,true,65,93,28,41.9046,-87.64056
291,4,17,true,25,42,17,41.90672,-87.63494
TA1308000049,4,17,true,126,184,58,41.90672,-87.6349
KA1504000134,4,17,true,103,131,28,41.90687,-87.6262
180,4,17,true,11,30,19,41.90687,-87.62618
333,4,17,true,12,24,12,41.90706,-87.66725
13224,4,17,true,81,123,42,41.90706,-87.66725
18069,4,17,true,84,7,-77,41.90722,-87.65563
666,4,17,true,6,2,-4,41.90723,-87.65564
TA1307000143,4,17,true,31,51,20,41.90762,-87.63854
236,4,17,true,5,7,2,41.90762,-87.63853
61,4,17,true,20,17,-3,41.90764,-87.67254
13221,4,17,true,119,111,-8,41.90765,-87.67254
159,4,17,true,3,2,-1,41.90777,-87.68586
13245,4,17,true,18,22,4,41.90777,-87.68586
301,4,17,true,25,43,18,41.90796,-87.63203
TA1309000024,4,17,true,149,225,76,41.908,-87.63152
69,4,17,true,28,50,22,41.90939,-87.6777
TA1305000041,4,17,true,136,146,10,41.9094,-87.67769
15652,4,17,true,7,5,-2,41.90965,-87.71664
331,4,17,true,199,240,41,41.90965,-87.64812
15653,4,17,true,20,17,-3,41.90979,-87.7053
509,4,17,true,2,3,1,41.9098,-87.70531
TA1305000037,4,17,true,71,105,34,41.91018,-87.67003
27,4,17,true,9,18,9,41.91019,-87.6435
TA1306000008,4,17,true,50,92,42,41.9102,-87.6435
16,4,17,true,19,21,2,41.91035,-87.67008
213,4,17,true,9,10,1,41.91037,-87.68237
TA1308000005,4,17,true,41,50,9,41.91042,-87.68238
276,4,17,true,9,7,-2,41.91043,-87.69718
13258,4,17,true,27,40,13,41.91043,-87.69718
160,4,17,true,4,4,0,41.91054,-87.68957
13257,4,17,true,29,42,13,41.91054,-87.68956
13154,4,17,true,139,155,16,41.91054,-87.65312
20,4,17,true,25,25,0,41.91055,-87.65313
60,4,17,true,10,15,5,41.91059,-87.64942
13058,4,17,true,82,89,7,41.91059,-87.64942
118,4,17,true,30,19,-11,41.91138,-87.63868
TA1307000038,4,17,true,114,131,17,41.91138,-87.63868
268,4,17,true,29,45,16,41.91172,-87.62681
LF-005,4,17,true,160,515,355,41.91172,-87.62681
126,4,17,true,20,31,11,41.91196,-87.63197
13128,4,17,true,68,106,38,41.91197,-87.63197
289,4,17,true,54,38,-16,41.91209,-87.63472
TA1308000050,4,17,true,275,367,92,41.91211,-87.6347
158,4,17,true,13,21,8,41.91262,-87.6814
13243,4,17,true,65,117,52,41.91262,-87.6814
315,4,17,true,2,6,4,41.91293,-87.66417
TA1309000032,4,17,true,28,32,4,41.91293,-87.66417
TA1306000032,4,17,true,118,137,19,41.9137,-87.65285
93,4,17,true,18,18,0,41.91371,-87.65285
TA1307000166,4,17,true,97,97,0,41.91386,-87.64877
224,4,17,true,15,17,2,41.91386,-87.64877
511,4,17,true,6,5,-1,41.914,-87.70515
15655,4,17,true,42,44,2,41.91401,-87.70514
641,4,17,true,2,1,-1,41.91416,-87.71676
18017,4,17,true,7,18,11,41.91416,-87.71676
628,4,17,true,3,4,1,41.9146,-87.66796
18067,4,17,true,60,77,17,41.9146,-87.66796
28,4,17,true,12,14,2,41.91469,-87.64333
TA1306000007,4,17,true,49,75,26,41.91469,-87.64333
13068,4,17,true,60,63,3,41.91554,-87.68703
116,4,17,true,17,11,-6,41.91555,-87.68703
13179,4,17,true,188,257,69,41.9157,-87.63461
141,4,17,true,28,35,7,41.91571,-87.63461
219,4,17,true,17,19,2,41.91598,-87.67733
13133,4,17,true,69,135,66,41.91598,-87.67733
58,4,17,true,14,25,11,41.91602,-87.66894
TA1305000039,4,17,true,77,88,11,41.9163,-87.66749
506,4,17,true,4,4,0,41.91711,-87.71023
15650,4,17,true,13,30,17,41.91711,-87.71023
507,4,17,true,3,11,8,41.91752,-87.70181
15651,4,17,true,30,39,9,41.91752,-87.70181
185,4,17,true,6,5,-1,41.91774,-87.69143
13266,4,17,true,21,29,8,41.91774,-87.69142
TA1309000029,4,17,true,40,50,10,41.9178,-87.68245
309,4,17,true,9,8,-1,41.91789,-87.6865
288,4,17,true,21,23,2,41.91809,-87.64375
TA1309000006,4,17,true,84,107,23,41.91809,-87.64375
223,4,17,true,20,18,-2,41.91821,-87.65698
TA1307000163,4,17,true,98,114,16,41.91821,-87.65696
94,4,17,true,23,40,17,41.91831,-87.6363
13146,4,17,true,194,263,69,41.91831,-87.63629
13059,4,17,true,169,156,-13,41.91845,-87.65222
113,4,17,true,24,27,3,41.91846,-87.65222
13259,4,17,true,28,24,-4,41.91852,-87.69744
259,4,17,true,5,7,2,41.91853,-87.69745
310,4,17,true,6,5,-1,41.91984,-87.68083
225,4,17,true,22,16,-6,41.91995,-87.64884
13192,4,17,true,95,144,49,41.91995,-87.64884
13288,4,17,true,40,55,15,41.92008,-87.67788
13242,4,17,true,25,34,9,41.92021,-87.69266
222,4,17,true,5,5,0,41.92023,-87.69265
307,4,17,true,6,10,4,41.92077,-87.66373
TA1309000030,4,17,true,84,101,17,41.92077,-87.66372
290,4,17,true,1,8,7,41.92152,-87.70734
13292,4,17,true,19,33,14,41.92152,-87.70733
TA1309000033,4,17,true,114,100,-14,41.92158,-87.65381
13193,4,17,true,208,240,32,41.92182,-87.64412
144,4,17,true,50,50,0,41.92182,-87.64411
143,4,17,true,21,21,0,41.92217,-87.63891
13191,4,17,true,108,110,2,41.92217,-87.63891
327,4,17,true,26,20,-6,41.92225,-87.65783
13084,4,17,true,60,68,8,41.92268,-87.69715
123,4,17,true,9,17,8,41.92268,-87.69714
LP-,4,17,true,75,69,-6,41.92396,-87.63584
673,4,17,true,9,8,-1,41.92398,-87.63585
KA1504000140,4,17,true,22,22,0,41.92409,-87.67646
505,4,17,true,5,7,2,41.92409,-87.67646
16010,4,17,true,5,11,6,41.92458,-87.72787
504,4,17,true,7,2,-5,41.92464,-87.68931
15648,4,17,true,26,28,2,41.92464,-87.68931
KA1504000090,4,17,true,10,13,3,41.92483,-87.7145
TA1307000001,4,17,true,118,91,-27,41.92535,-87.66581
188,4,17,true,23,19,-4,41.92536,-87.66581
TA1306000026,4,17,true,95,149,54,41.92558,-87.65842
87,4,17,true,15,24,9,41.92559,-87.65843
TA1306000016,4,17,true,218,113,-105,41.9256,-87.65371
67,4,17,true,9,11,2,41.9256,-87.65371
313,4,17,true,29,45,16,41.9257,-87.64246
TA1309000019,4,17,true,151,181,30,41.92586,-87.63897
TA1309000058,4,17,true,208,196,-12,41.92591,-87.64927
127,4,17,true,29,43,14,41.92592,-87.64927
177,4,17,true,50,48,-2,41.92627,-87.63086
TA1308000001,4,17,true,222,222,0,41.92627,-87.63086
502,4,17,true,3,3,0,41.92667,-87.69772
15646,4,17,true,21,32,11,41.92668,-87.6977
13124,4,17,true,32,27,-5,41.92675,-87.63444
34,4,17,true,3,7,4,41.92675,-87.63444
302,4,17,true,26,23,-3,41.92859,-87.65421
TA1309000023,4,17,true,101,102,1,41.9287,-87.65383
TA1307000113,4,17,true,59,107,48,41.92878,-87.66391
190,4,17,true,12,10,-2,41.92878,-87.6639
166,4,17,true,6,7,1,41.92883,-87.66853
13296,4,17,true,42,40,-2,41.92883,-87.66852
343,4,17,true,6,14,8,41.92889,-87.65898
TA1309000059,4,17,true,51,60,9,41.92889,-87.65898
349,4,17,true,29,21,-8,41.92915,-87.6491
TA1309000061,4,17,true,147,165,18,41.92915,-87.64909
TA1308000031,4,17,true,34,29,-5,41.92946,-87.68417
258,4,17,true,3,11,8,41.92946,-87.68417
340,4,17,true,30,32,2,41.92956,-87.64313
TA1305000014,4,17,true,164,174,10,41.92956,-87.64313
260,4,17,true,9,11,2,41.92958,-87.70791
13085,4,17,true,42,52,10,41.92958,-87.70789
499,4,17,true,2,4,2,41.93056,-87.72381
15643,4,17,true,8,7,-1,41.93057,-87.7238
TA1307000142,4,17,true,161,174,13,41.93125,-87.64432
220,4,17,true,43,27,-16,41.93125,-87.64431
13276,4,17,true,113,141,28,41.93132,-87.63874
324,4,17,true,25,27,2,41.93173,-87.64179
15645,4,17,true,29,13,-16,41.93191,-87.70121
501,4,17,true,3,3,0,41.93191,-87.70121
163,4,17,true,8,10,2,41.93191,-87.67784
13271,4,17,true,50,39,-11,41.93192,-87.67784
152,4,17,true,26,27,1,41.93221,-87.65864
TA1307000064,4,17,true,179,123,-56,41.93222,-87.65864
TA1306000014,4,17,true,176,111,-65,41.93242,-87.65271
13,4,17,true,17,28,11,41.93242,-87.65271
329,4,17,true,29,28,-1,41.93258,-87.63642
TA1309000039,4,17,true,125,166,41,41.93258,-87.63642
13294,4,17,true,64,46,-18,41.9326,-87.66595
319,4,17,true,13,6,-7,41.93292,-87.67217
332,4,17,true,11,25,14,41.93313,-87.64776
TA1309000036,4,17,true,97,138,41,41.93313,-87.64776
15644,4,17,true,9,13,4,41.93534,-87.71687
TA1307000006,4,17,true,85,82,-3,41.93571,-87.6636
153,4,17,true,22,14,-8,41.93575,-87.66364
162,4,17,true,6,10,4,41.93588,-87.67844
13268,4,17,true,28,50,22,41.93588,-87.67843
250,4,17,true,10,16,6,41.93609,-87.66984
13269,4,17,true,44,75,31,41.93609,-87.66983
TA1307000052,4,17,true,135,113,-22,41.93628,-87.65266
115,4,17,true,26,25,-1,41.93628,-87.65266
156,4,17,true,33,35,2,41.9365,-87.64756
TA1307000136,4,17,true,174,154,-20,41.9365,-87.64755
TA1307000041,4,17,true,136,195,59,41.93669,-87.63683
157,4,17,true,40,47,7,41.9367,-87.63683
13137,4,17,true,192,233,41,41.9376,-87.6441
300,4,17,true,47,57,10,41.93761,-87.6441
498,4,17,true,3,1,-2,41.93843,-87.69801
15642,4,17,true,16,24,8,41.93843,-87.69801
154,4,17,true,18,14,-4,41.93912,-87.66384
664,4,17,true,4,13,9,41.93934,-87.68327
KA17018068,4,17,true,29,46,17,41.93935,-87.68327
TA1309000042,4,17,true,101,110,9,41.93937,-87.66836
131,4,17,true,10,24,14,41.93937,-87.66835
KA150400009X,4,17,true,16,8,-8,41.9394,-87.71159
15640,4,17,true,7,7,0,41.93941,-87.72357
13229,4,17,true,59,55,-4,41.93946,-87.66376
226,4,17,true,20,24,4,41.93972,-87.65886
TA1308000019,4,17,true,103,93,-10,41.93973,-87.65886
13277,4,17,true,120,114,-6,41.9401,-87.64546
296,4,17,true,38,39,1,41.9401,-87.64546
TA1307000134,4,17,true,193,149,-44,41.94016,-87.65303
117,4,17,true,34,29,-5,41.94016,-87.65302
228,4,17,true,5,2,-3,41.94058,-87.67854
13143,4,17,true,17,15,-2,41.94059,-87.67853
334,4,17,true,24,33,9,41.94076,-87.63919
TA1309000049,4,17,true,125,132,7,41.94077,-87.63919
308,4,17,true,6,13,7,41.94152,-87.68471
15634,4,17,true,14,12,-2,41.94304,-87.68729
493,4,17,true,3,3,0,41.94304,-87.68729
TA1307000138,4,17,true,89,122,33,41.94334,-87.67094
230,4,17,true,9,23,14,41.94335,-87.67093
13144,4,17,true,36,41,5,41.9434,-87.67964
TA1309000025,4,17,true,155,156,1,41.94368,-87.64894
299,4,17,true,33,47,14,41.94368,-87.64894
229,4,17,true,16,20,4,41.94372,-87.66401
13071,4,17,true,154,150,-4,41.94373,-87.66401
632,4,17,true,122,152,30,41.94453,-87.6547
303,4,17,true,34,35,1,41.94522,-87.64702
490,4,17,true,1,4,3,41.94523,-87.70664
15631,4,17,true,14,27,13,41.94524,-87.70665
13278,4,17,true,131,142,11,41.94553,-87.64644
TA1309000050,4,17,true,25,30,5,41.94618,-87.67331
330,4,17,true,1,7,6,41.94618,-87.67331
488,4,17,true,1,3,2,41.94627,-87.73105
KA1504000141,4,17,true,1,6,5,41.94627,-87.73105
492,4,17,true,1,1,0,41.94662,-87.68337
491,4,17,true,5,1,-4,41.94664,-87.69463
15632,4,17,true,6,20,14,41.94664,-87.69463
KA1504000143,4,17,true,16,26,10,41.94664,-87.68337
KA1504000142,4,17,true,14,4,-10,41.94735,-87.71759
489,4,17,true,1,1,0,41.94736,-87.7176
227,4,17,true,22,27,5,41.94813,-87.66397
13235,4,17,true,122,125,3,41.94814,-87.66396
304,4,17,true,29,37,8,41.94878,-87.64922
257,4,17,true,19,13,-6,41.9488,-87.67527
13253,4,17,true,30,47,17,41.9488,-87.67527
13325,4,17,true,134,162,28,41.94907,-87.64863
114,4,17,true,11,26,15,41.94935,-87.65451
TA1307000126,4,17,true,81,106,25,41.94936,-87.65451
232,4,17,true,37,43,6,41.94943,-87.64645
TA1307000150,4,17,true,158,189,31,41.94945,-87.64646
18016,4,17,true,9,10,1,41.94993,-87.71395
347,4,17,true,2,5,3,41.95068,-87.6687
13319,4,17,true,50,63,13,41.95069,-87.6687
TA1307000127,4,17,true,95,115,20,41.9508,-87.65918
165,4,17,true,16,23,7,41.95081,-87.65918
15628,4,17,true,10,21,11,41.95216,-87.69806
318,4,17,true,9,10,1,41.95254,-87.6735
13323,4,17,true,95,79,-16,41.95282,-87.65
256,4,17,true,17,22,5,41.95282,-87.65
15624,4,17,true,11,7,-4,41.95339,-87.73199
483,4,17,true,3,3,0,41.9534,-87.73199
314,4,17,true,10,9,-1,41.9535,-87.69199
485,4,17,true,1,6,5,41.95361,-87.70933
KA1504000096,4,17,true,3,6,3,41.95361,-87.70932
KA1504000139,4,17,true,4,9,5,41.954,-87.71909
484,4,17,true,1,2,1,41.954,-87.71907
TA1309000043,4,17,true,35,58,23,41.95417,-87.66434
240,4,17,true,24,13,-11,41.95424,-87.65441
13063,4,17,true,94,92,-2,41.95424,-87.65441
486,4,17,true,4,4,0,41.95431,-87.68607
KA1504000158,4,17,true,14,13,-1,41.95432,-87.68607
254,4,17,true,37,27,-10,41.95438,-87.64806
TA1308000022,4,17,true,126,109,-17,41.95438,-87.64805
16991,4,17,true,1,2,1,41.95448,-87.7496
244,4,17,true,16,6,-10,41.95466,-87.67391
TA1307000149,4,17,true,86,52,-34,41.95467,-87.67392
298,4,17,true,13,12,-1,41.95601,-87.68021
TA1309000026,4,17,true,57,51,-6,41.95601,-87.6802
13249,4,17,true,16,10,-6,41.95606,-87.66885
246,4,17,true,2,13,11,41.95606,-87.66885
312,4,17,true,29,15,-14,41.95637,-87.6563
TA1308000047,4,17,true,29,19,-10,41.95709,-87.6642
292,4,17,true,6,3,-3,41.95709,-87.6642
13379,4,17,true,94,79,-15,41.95786,-87.6495
TA1309000018,4,17,true,34,26,-8,41.95791,-87.67357
316,4,17,true,9,5,-4,41.95841,-87.69401
306,4,17,true,12,18,6,41.9585,-87.655
TA1309000027,4,17,true,54,77,23,41.9585,-87.65499
592,4,17,true,8,4,-4,41.96065,-87.74538
13389,4,17,true,66,72,6,41.961,-87.64958
245,4,17,true,18,25,7,41.96101,-87.64958
15621,4,17,true,15,14,-1,41.96103,-87.70586
480,4,17,true,8,5,-3,41.96104,-87.70586
630,4,17,true,3,1,-2,41.96107,-87.73569
KA1706005015,4,17,true,4,5,1,41.96108,-87.73569
481,4,17,true,1,6,5,41.96108,-87.69544
15622,4,17,true,11,28,17,41.96108,-87.69544
KA1504000164,4,17,true,3,1,-2,41.96109,-87.72897
KA1504000097,4,17,true,15,5,-10,41.96116,-87.71658
479,4,17,true,2,3,1,41.96116,-87.71658
238,4,17,true,12,17,5,41.96141,-87.6762
TA1307000144,4,17,true,40,39,-1,41.96142,-87.6762
297,4,17,true,3,4,1,41.9615,-87.67141
TA1309000021,4,17,true,26,30,4,41.9615,-87.6714
482,4,17,true,6,13,7,41.96154,-87.69117
15623,4,17,true,18,27,9,41.96154,-87.69117
234,4,17,true,10,15,5,41.96158,-87.6661
KA1503000022,4,17,true,48,45,-3,41.96158,-87.66609
231,4,17,true,18,23,5,41.96163,-87.65464
TA1307000107,4,17,true,127,122,-5,41.96164,-87.65464
TA1307000156,4,17,true,42,48,6,41.96301,-87.68479
243,4,17,true,4,12,8,41.96302,-87.68479
TA1309000012,4,17,true,40,25,-15,41.96325,-87.67928
249,4,17,true,20,19,-1,41.96398,-87.63818
TA1308000012,4,17,true,71,109,38,41.96398,-87.63818
293,4,17,true,5,15,10,41.96521,-87.65822
13074,4,17,true,83,49,-34,41.96521,-87.6582
639,4,17,true,78,88,10,41.96584,-87.64538
KA1504000127,4,17,true,10,15,5,41.96587,-87.70083
477,4,17,true,3,10,7,41.96587,-87.70083
KA1504000093,4,17,true,17,15,-2,41.96587,-87.69365
478,4,17,true,3,10,7,41.96587,-87.69364
TA1307000140,4,17,true,37,83,46,41.96643,-87.68865
239,4,17,true,14,18,4,41.9665,-87.68843
326,4,17,true,17,17,0,41.96665,-87.67113
476,4,17,true,2,1,-1,41.96668,-87.70807
KA1504000126,4,17,true,4,9,5,41.96668,-87.70807
TA1309000014,4,17,true,66,75,9,41.96709,-87.66744
TA1307000158,4,17,true,57,30,-27,41.9671,-87.67904
242,4,17,true,8,4,-4,41.9671,-87.67904
251,4,17,true,12,3,-9,41.96796,-87.65
TA1307000119,4,17,true,39,33,-6,41.96796,-87.65
15615,4,17,true,12,7,-5,41.96835,-87.71183
323,4,17,true,13,7,-6,41.96869,-87.66034
253,4,17,true,7,7,0,41.96883,-87.65765
TA1308000021,4,17,true,26,51,25,41.96883,-87.65765
475,4,17,true,8,7,-1,41.96885,-87.69611
KA1504000080,4,17,true,20,38,18,41.96887,-87.69609
TA1309000015,4,17,true,20,25,5,41.96889,-87.68401
311,4,17,true,1,7,6,41.9689,-87.68402
TA1309000066,4,17,true,175,107,-68,41.9691,-87.67423
344,4,17,true,31,26,-5,41.9691,-87.67423
TA1309000041,4,17,true,50,37,-13,41.96951,-87.65471
KA1504000171,4,17,true,75,39,-36,41.97161,-87.65016
465,4,17,true,11,7,-4,41.97161,-87.65016
325,4,17,true,14,17,3,41.9728,-87.67186
TA1309000035,4,17,true,97,118,21,41.97335,-87.66785
295,4,17,true,12,11,-1,41.97378,-87.65972
13108,4,17,true,71,63,-8,41.97379,-87.65971
KA1504000078,4,17,true,19,31,12,41.97491,-87.69258
472,4,17,true,2,4,2,41.97492,-87.69262
464,4,17,true,5,11,6,41.97562,-87.67945
KA1504000149,4,17,true,13,29,16,41.97562,-87.67945
471,4,17,true,4,4,0,41.97564,-87.70143
KA1504000160,4,17,true,16,16,0,41.97564,-87.70143
470,4,17,true,3,2,-1,41.97567,-87.70927
KA1504000146,4,17,true,82,79,-3,41.978,-87.66805
463,4,17,true,12,11,-1,41.978,-87.66805
294,4,17,true,24,16,-8,41.97835,-87.65976
13109,4,17,true,56,51,-5,41.97835,-87.65976
KA1504000147,4,17,true,5,17,12,41.97976,-87.67754
655,4,17,true,14,15,1,41.97987,-87.68194
KA1504000161,4,17,true,8,7,-1,41.98038,-87.71612
KA1504000167,4,17,true,7,8,1,41.98206,-87.70895
494,4,17,true,1,1,0,41.98234,-87.70892
460,4,17,true,9,23,14,41.98358,-87.66916
KA1504000151,4,17,true,42,70,28,41.98359,-87.66916
15585,4,17,true,8,3,-5,41.98367,-87.69642
KA1504000152,4,17,true,114,91,-23,41.98403,-87.65231
459,4,17,true,24,27,3,41.98403,-87.65231
15578,4,17,true,54,32,-22,41.98405,-87.66027
461,4,17,true,11,8,-3,41.98405,-87.66027
353,4,17,true,1,2,1,41.98656,-87.70761
15575,4,17,true,55,54,-1,41.98975,-87.66014
458,4,17,true,4,2,-2,41.98975,-87.66013
KA1504000130,4,17,true,1,4,3,41.99024,-87.69338
457,4,17,true,7,7,0,41.99052,-87.66982
KA1504000148,4,17,true,16,42,26,41.99086,-87.66971
456,4,17,true,2,3,1,41.99117,-87.68359
KA1504000155,4,17,true,7,4,-3,41.99118,-87.68359
452,4,17,true,2,2,0,41.99417,-87.68945
KA1504000129,4,17,true,2,10,8,41.99417,-87.68945
15571,4,17,true,45,56,11,41.99478,-87.66028
454,4,17,true,9,11,2,41.99478,-87.66027
KA1504000156,4,17,true,23,11,-12,41.99925,-87.67137
453,4,17,true,7,6,-1,41.99925,-87.67137
RP-009,4,17,true,32,21,-11,42.00107,-87.66122
451,4,17,true,5,8,3,42.00108,-87.66123
RP-001,4,17,true,1,4,3,42.00179,-87.68883
449,4,17,true,1,2,1,42.00446,-87.67241
RP-008,4,17,true,21,24,3,42.00446,-87.6724
RP-002,4,17,true,3,3,0,42.00456,-87.68065
660,4,17,true,21,41,20,42.00458,-87.66143
354,4,17,true,5,6,1,42.00587,-87.66802
KA1504000175,4,17,true,18,24,6,42.00797,-87.66549
447,4,17,true,8,3,-5,42.00797,-87.66548
467,4,17,true,3,2,-1,42.0086,-87.69047
RP-005,4,17,true,9,16,7,42.0086,-87.69047
432,4,17,true,2,4,2,42.00907,-87.67423
KA1504000162,4,17,true,28,12,-16,42.00907,-87.67422
KA1504000159,4,17,true,17,26,9,42.01059,-87.66241
466,4,17,true,1,1,0,42.01213,-87.68292
RP-006,4,17,true,3,11,8,42.01213,-87.68292
RP-004,4,17,true,2,4,2,42.01234,-87.68825
RP-007,4,17,true,10,5,-5,42.01256,-87.67431
525,4,17,true,7,18,11,42.01272,-87.66605
517,4,17,true,19,12,-7,42.01597,-87.675
520,4,17,true,28,28,0,42.01597,-87.66859
519,4,17,true,1,3,2,42.01696,-87.67773
527,4,17,true,2,2,0,42.01892,-87.69004
515,4,17,true,23,13,-10,42.01915,-87.67356
514,4,17,true,4,10,6,42.01927,-87.68452
16806,4,17,true,5,17,12,42.01953,-87.66955
522,4,17,true,2,1,-1,42.01954,-87.66954
523,4,17,true,25,38,13,42.02089,-87.66505
662,4,17,true,3,3,0,42.02354,-87.69961
598,4,17,true,6,6,0,42.02578,-87.68411
597,4,17,true,3,5,2,42.03256,-87.67914
E002,4,17,true,26,39,13,42.03256,-87.67912
599,4,17,true,20,10,-10,42.03972,-87.69942
625,4,17,true,1,6,5,42.04163,-87.6808
596,4,17,true,68,53,-15,42.04822,-87.68348
600,4,17,true,2,13,11,42.04831,-87.6983
E008,4,17,true,14,12,-2,42.05049,-87.67782
603,4,17,true,2,1,-1,42.05049,-87.67782
605,4,17,true,35,4,-31,42.05294,-87.67342
661,4,17,true,10,7,-3,42.05704,-87.68657
604,4,17,true,58,15,-43,42.05824,-87.67744
E006,4,17,true,13,13,0,42.06367,-87.69871
601,4,17,true,3,4,1,42.06368,-87.69871
E007,4,17,true,6,17,11,42.06431,-87.68615
602,4,17,true,3,4,1,42.06431,-87.68614
E014,4,17,true,3,13,10,42.06483,-87.71531
20206,5,9,false,5,2,-3,41.68459,-87.6708
20232,5,9,false,1,1,0,41.68588,-87.57378
20205,5,9,false,2,2,0,41.69121,-87.6813
20203,5,9,false,5,3,-2,41.69131,-87.71286
20134,5,9,false,1,1,0,41.71,-87.6
20230,5,9,false,2,1,-1,41.73716,-87.57272
584,5,9,false,2,1,-1,41.74412,-87.59905
576,5,9,false,2,4,2,41.75129,-87.59752
575,5,9,false,1,1,0,41.75318,-87.60502
16953,5,9,false,2,2,0,41.75796,-87.6312
KA1503000019,5,9,false,3,4,1,41.75867,-87.5869
652,5,9,false,2,3,1,41.766,-87.61173
KA1503000002,5,9,false,6,3,-3,41.76641,-87.5657
102,5,9,false,1,1,0,41.77345,-87.58533
KA1503000023,5,9,false,1,2,1,41.77346,-87.58534
KA1503000030,5,9,false,1,1,0,41.77352,-87.57722
KA1503000029,5,9,false,4,2,-2,41.77364,-87.56747
16948,5,9,false,1,1,0,41.77937,-87.6649
KA1503000055,5,9,false,2,1,-1,41.77939,-87.64463
KA1503000046,5,9,false,4,2,-2,41.78041,-87.59141
KA1503000054,5,9,false,4,6,2,41.78061,-87.60582
15491,5,9,false,4,3,-1,41.78096,-87.57624
KA1503000033,5,9,false,4,1,-3,41.78411,-87.61329
426,5,9,false,4,1,-3,41.7851,-87.60108
KA1503000014,5,9,false,11,9,-2,41.7851,-87.60108
561,5,9,false,1,1,0,41.7857,-87.67409
KA1503000070,5,9,false,5,6,1,41.78794,-87.58831
328,5,9,false,3,10,7,41.78872,-87.6013
TA1309000011,5,9,false,8,21,13,41.78873,-87.60131
423,5,9,false,3,3,0,41.79148,-87.59988
KA1503000071,5,9,false,8,30,22,41.79148,-87.59988
424,5,9,false,1,1,0,41.79174,-87.58395
KA1503000074,5,9,false,4,13,9,41.79174,-87.58395
TA1309000063,5,9,false,8,2,-6,41.79325,-87.5878
KA1503000073,5,9,false,1,1,0,41.79345,-87.61585
559,5,9,false,1,1,0,41.79423,-87.65509
KA1504000076,5,9,false,12,17,5,41.7943,-87.60145
TA1307000160,5,9,false,1,1,0,41.79485,-87.61873
247,5,9,false,4,2,-2,41.79522,-87.58077
TA1308000009,5,9,false,11,12,1,41.79522,-87.58075
TA1307000164,5,9,false,9,8,-1,41.79527,-87.59647
248,5,9,false,2,1,-1,41.79528,-87.59647
646,5,9,false,1,1,0,41.79663,-87.62592
KA1503000052,5,9,false,9,2,-7,41.79935,-87.60097
KA1503000059,5,9,false,27,9,-18,41.79952,-87.58643
419,5,9,false,2,1,-1,41.79952,-87.58643
TA1309000037,5,9,false,21,8,-13,41.79957,-87.59474
15470,5,9,false,7,2,-5,41.80228,-87.61807
417,5,9,false,2,1,-1,41.80242,-87.5869
KA1503000007,5,9,false,13,9,-4,41.80242,-87.58689
13398,5,9,false,9,5,-4,41.80256,-87.59035
TA1309000067,5,9,false,3,3,0,41.80303,-87.60661
KA1503000009,5,9,false,3,1,-2,41.80932,-87.63346
TA1308000035,5,9,false,6,1,-5,41.80944,-87.59188
267,5,9,false,2,1,-1,41.80944,-87.59188
TA1308000002,5,9,false,2,2,0,41.80983,-87.59937
TA1308000007,5,9,false,2,1,-1,41.80984,-87.61628
KA1503000065,5,9,false,1,5,4,41.81409,-87.59701
TA1308000023,5,9,false,1,1,0,41.81649,-87.60659
KA1503000027,5,9,false,4,1,-3,41.81666,-87.61942
410,5,9,false,2,1,-1,41.81666,-87.61942
265,5,9,false,3,2,-1,41.82297,-87.6071
TA1308000043,5,9,false,2,4,2,41.83066,-87.64715
KA1503000005,5,9,false,2,4,2,41.83079,-87.6325
TA1307000129,5,9,false,2,3,1,41.83104,-87.62683
KA1503000004,5,9,false,7,4,-3,41.83127,-87.6088
406,5,9,false,2,1,-1,41.83127,-87.6088
13345,5,9,false,2,3,1,41.83138,-87.61803
15445,5,9,false,4,1,-3,41.83453,-87.63183
13216,5,9,false,2,5,3,41.83473,-87.62581
13217,5,9,false,4,5,1,41.83488,-87.61792
13215,5,9,false,5,2,-3,41.83634,-87.6135
263,5,9,false,1,1,0,41.8364,-87.61348
TA1308000046,5,9,false,1,2,1,41.83779,-87.65115
TA1309000055,5,9,false,7,21,14,41.8382,-87.64514
KA1503000038,5,9,false,3,1,-2,41.83845,-87.6354
TA1307000048,5,9,false,14,14,0,41.83855,-87.60821
TA1308000036,5,9,false,3,2,-1,41.83883,-87.62186
13213,5,9,false,1,1,0,41.84171,-87.62694
TA1307000139,5,9,false,6,3,-3,41.84205,-87.61698
401,5,9,false,1,1,0,41.84276,-87.63549
15692,5,9,false,2,1,-1,41.84404,-87.69531
15691,5,9,false,1,1,0,41.84449,-87.70203
TA1307000005,5,9,false,1,1,0,41.84569,-87.6225
TA1308000013,5,9,false,2,2,0,41.84719,-87.64681
KA1504000086,5,9,false,2,1,-1,41.8482,-87.70542
281,5,9,false,1,1,0,41.84847,-87.68513
TA1307000066,5,9,false,4,2,-2,41.8492,-87.67564
TA1305000004,5,9,false,22,10,-12,41.8514,-87.61884
TA1305000001,5,9,false,10,3,-7,41.85262,-87.6265
13075,5,9,false,1,6,5,41.8531,-87.63192
13162,5,9,false,3,3,0,41.85378,-87.64659
13096,5,9,false,1,2,1,41.8538,-87.69577
15546,5,9,false,12,2,-10,41.85416,-87.61916
13307,5,9,false,4,2,-2,41.85489,-87.66359
124,5,9,false,3,1,-2,41.85492,-87.67609
13089,5,9,false,3,2,-1,41.85497,-87.67567
13331,5,9,false,4,2,-2,41.85515,-87.65414
171,5,9,false,1,1,0,41.85516,-87.65414
15545,5,9,false,11,10,-1,41.85627,-87.61334
4,5,9,false,1,1,0,41.85627,-87.61334
178,5,9,false,2,1,-1,41.85657,-87.62755
SL-013,5,9,false,10,3,-7,41.85659,-87.62755
129,5,9,false,2,1,-1,41.85752,-87.66158
13135,5,9,false,10,10,0,41.85753,-87.66157
13102,5,9,false,17,7,-10,41.85762,-87.61942
13150,5,9,false,19,7,-12,41.85783,-87.62455
273,5,9,false,2,4,2,41.85783,-87.62455
13099,5,9,false,2,1,-1,41.85784,-87.64627
TA1307000159,5,9,false,6,13,7,41.8579,-87.6687
TA1307000044,5,9,false,1,2,1,41.85794,-87.64083
13163,5,9,false,4,2,-2,41.85808,-87.65108
13164,5,9,false,17,3,-14,41.85818,-87.65648
SL-012,5,9,false,8,8,0,41.86038,-87.62581
13304,5,9,false,6,4,-2,41.86126,-87.65659
TA1306000002,5,9,false,6,1,-5,41.86238,-87.65108
137,5,9,false,2,1,-1,41.86238,-87.65108
TA1307000124,5,9,false,14,18,4,41.86411,-87.62372
168,5,9,false,2,5,3,41.86415,-87.62372
TA1309000001,5,9,false,9,2,-7,41.86488,-87.64708
136,5,9,false,1,2,1,41.86504,-87.65698
13165,5,9,false,3,2,-1,41.86505,-87.65697
275,5,9,false,2,2,0,41.86524,-87.66651
13029,5,9,false,5,14,9,41.86531,-87.6179
13431,5,9,false,10,18,8,41.8661,-87.60728
KA1504000101,5,9,false,1,3,2,41.86651,-87.68466
WL-008,5,9,false,30,9,-21,41.86712,-87.64108
59,5,9,false,9,6,-3,41.86721,-87.62597
TA1305000002,5,9,false,24,21,-3,41.86721,-87.62597
3,5,9,false,1,5,4,41.86723,-87.61536
15544,5,9,false,44,93,49,41.86723,-87.61536
TA1305000017,5,9,false,7,3,-4,41.86734,-87.64863
KA1706005007,5,9,false,6,3,-3,41.86749,-87.63219
626,5,9,false,1,1,0,41.86749,-87.63219
SL-005,5,9,false,49,27,-22,41.8679,-87.62304
255,5,9,false,14,2,-12,41.86791,-87.62304
644,5,9,false,6,5,-1,41.86859,-87.68625
13139,5,9,false,6,5,-1,41.86893,-87.65913
13160,5,9,false,3,5,2,41.86947,-87.65548
15550,5,9,false,4,11,7,41.87024,-87.63947
TA1309000010,5,9,false,20,22,2,41.87074,-87.62574
SL-009,5,9,false,6,4,-2,41.87081,-87.63121
TA1309000064,5,9,false,4,17,13,41.87127,-87.67369
15542,5,9,false,1,2,1,41.87146,-87.64095
261,5,9,false,1,3,2,41.87151,-87.6699
TA1307000130,5,9,false,10,8,-2,41.87178,-87.65103
TA1307000121,5,9,false,10,14,4,41.87184,-87.64664
41,5,9,false,1,2,1,41.87209,-87.62957
SL-008,5,9,false,11,8,-3,41.87209,-87.62956
13332,5,9,false,19,6,-13,41.87219,-87.6615
394,5,9,false,8,2,-6,41.87226,-87.63484
175,5,9,false,4,2,-2,41.87255,-87.63359
SL-011,5,9,false,16,18,2,41.87256,-87.63356
623,5,9,false,85,33,-52,41.87272,-87.62399
KA1504000104,5,9,false,7,11,4,41.87296,-87.66912
SL-007,5,9,false,10,11,1,41.87404,-87.6277
169,5,9,false,1,2,1,41.87424,-87.63959
13326,5,9,false,7,4,-3,41.87425,-87.63958
321,5,9,false,2,4,2,41.87427,-87.63257
TA1306000025,5,9,false,7,5,-2,41.87464,-87.65703
15668,5,9,false,2,1,-1,41.87471,-87.68642
13028,5,9,false,12,15,3,41.87475,-87.64981
13081,5,9,false,3,3,0,41.87501,-87.67326
89,5,9,false,4,1,-3,41.87501,-87.6331
SL-010,5,9,false,3,1,-2,41.87501,-87.63309
16907,5,9,false,2,2,0,41.87568,-87.71549
15541,5,9,false,23,21,-2,41.8758,-87.62086
13037,5,9,false,7,3,-4,41.87588,-87.64078
50,5,9,false,1,2,1,41.87592,-87.6307
TA1305000009,5,9,false,3,3,0,41.87593,-87.63068
TA1305000010,5,9,false,26,19,-7,41.87623,-87.62444
45,5,9,false,2,1,-1,41.87623,-87.62444
624,5,9,false,7,8,1,41.87626,-87.62923
TA1305000035,5,9,false,15,7,-8,41.87716,-87.62787
13138,5,9,false,6,2,-4,41.87723,-87.63941
631,5,9,false,2,7,5,41.87761,-87.6739
15539,5,9,false,13,6,-7,41.87763,-87.64405
13158,5,9,false,14,22,8,41.87764,-87.64957
134,5,9,false,2,1,-1,41.87764,-87.64954
21,5,9,false,1,2,1,41.87773,-87.6548
13157,5,9,false,9,13,4,41.87773,-87.6548
TA1305000025,5,9,false,19,30,11,41.87773,-87.63528
TA1309000002,5,9,false,29,25,-4,41.87784,-87.62408
545,5,9,false,1,1,0,41.87792,-87.73583
13206,5,9,false,8,3,-5,41.87794,-87.66201
146,5,9,false,1,1,0,41.87794,-87.66201
283,5,9,false,1,1,0,41.87809,-87.63183
TA1309000004,5,9,false,20,15,-5,41.87811,-87.63184
107,5,9,false,4,4,0,41.87822,-87.644
638,5,9,false,30,14,-16,41.87827,-87.64078
TA1305000005,5,9,false,12,13,1,41.87924,-87.62975
13011,5,9,false,15,18,3,41.87931,-87.63993
TA1309000008,5,9,false,12,22,10,41.87933,-87.6355
KA1503000034,5,9,false,8,18,10,41.87938,-87.63197
39,5,9,false,2,2,0,41.87948,-87.62571
KA1503000015,5,9,false,34,10,-24,41.87948,-87.6257
15667,5,9,false,4,2,-2,41.8798,-87.68609
287,5,9,false,2,2,0,41.88017,-87.63527
TA1309000007,5,9,false,14,27,13,41.88022,-87.63526
WL-011,5,9,false,11,12,1,41.88034,-87.64273
13156,5,9,false,10,4,-6,41.88042,-87.65554
13300,5,9,false,79,56,-23,41.88097,-87.61675
76,5,9,false,4,9,5,41.88098,-87.61675
13008,5,9,false,58,56,-2,41.88105,-87.62408
90,5,9,false,11,17,6,41.88107,-87.62409
49,5,9,false,1,3,2,41.88116,-87.62963
TA1305000006,5,9,false,38,27,-11,41.88122,-87.6296
13134,5,9,false,3,6,3,41.88138,-87.67493
13056,5,9,false,14,8,-6,41.88168,-87.63951
198,5,9,false,1,1,0,41.88187,-87.6488
TA1307000120,5,9,false,31,29,-2,41.88188,-87.64879
13341,5,9,false,16,9,-7,41.88208,-87.63985
174,5,9,false,2,3,1,41.88208,-87.63984
197,5,9,false,3,6,3,41.88208,-87.62513
13036,5,9,false,15,19,4,41.8821,-87.62513
77,5,9,false,4,4,0,41.88214,-87.64108
TA1305000032,5,9,false,31,29,-2,41.88218,-87.64109
13006,5,9,false,18,15,-3,41.88268,-87.63252
13353,5,9,false,11,6,-5,41.88283,-87.6612
346,5,9,false,1,2,1,41.88284,-87.6612
654,5,9,false,9,6,-3,41.88307,-87.65698
13409,5,9,false,7,11,4,41.8831,-87.6511
KA1503000072,5,9,false,17,16,-1,41.88317,-87.63693
WL-012,5,9,false,40,16,-24,41.88337,-87.6412
112,5,9,false,4,8,4,41.88362,-87.6486
13053,5,9,false,14,26,12,41.88365,-87.64863
43,5,9,false,8,6,-2,41.88396,-87.62455
13001,5,9,false,26,35,9,41.88397,-87.62459
13155,5,9,false,4,11,7,41.88407,-87.65689
621,5,9,false,1,2,1,41.88412,-87.65427
18062,5,9,false,12,17,5,41.88412,-87.65427
81,5,9,false,4,11,7,41.88417,-87.6296
TA1306000010,5,9,false,16,22,6,41.88419,-87.62961
15666,5,9,false,2,4,2,41.88446,-87.6963
KA1504000106,5,9,false,2,2,0,41.88459,-87.70631
TA1305000030,5,9,false,33,25,-8,41.88459,-87.63178
15535,5,9,false,13,10,-3,41.8846,-87.64455
51,5,9,false,1,6,5,41.88462,-87.63176
TA1305000029,5,9,false,19,14,-5,41.88466,-87.62787
195,5,9,false,5,1,-4,41.88466,-87.61952
13263,5,9,false,30,16,-14,41.88467,-87.61952
44,5,9,false,9,5,-4,41.88468,-87.62782
TA1306000015,5,9,false,27,30,3,41.88549,-87.65232
518,5,9,false,1,2,1,41.8855,-87.71686
71,5,9,false,1,2,1,41.8855,-87.65233
66,5,9,false,1,2,1,41.88557,-87.64186
13021,5,9,false,16,15,-1,41.88559,-87.64184
TA1307000111,5,9,false,18,22,4,41.88582,-87.63548
164,5,9,false,1,3,2,41.88583,-87.63547
13073,5,9,false,4,7,3,41.88592,-87.66717
KA17018054,5,9,false,5,9,4,41.88595,-87.67701
KA1503000012,5,9,false,34,30,-4,41.88599,-87.63089
38,5,9,false,5,4,-1,41.88599,-87.63089
52,5,9,false,10,4,-6,41.886,-87.62421
TA1305000011,5,9,false,65,51,-14,41.886,-87.62418
7,5,9,false,1,1,0,41.88627,-87.61751
15534,5,9,false,20,9,-11,41.88627,-87.61749
13197,5,9,false,11,8,-3,41.8866,-87.65816
264,5,9,false,4,2,-2,41.8867,-87.62224
TA1308000029,5,9,false,27,14,-13,41.88673,-87.62225
TA1307000131,5,9,false,54,25,-29,41.88688,-87.62606
194,5,9,false,7,6,-1,41.88688,-87.62606
KA1503000064,5,9,false,39,25,-14,41.88697,-87.61281
6,5,9,false,3,1,-2,41.88697,-87.61281
16905,5,9,false,1,1,0,41.88767,-87.76547
100,5,9,false,2,2,0,41.88814,-87.63657
TA1305000022,5,9,false,24,32,8,41.88817,-87.63656
56,5,9,false,6,1,-5,41.88866,-87.64442
TA1306000003,5,9,false,22,24,2,41.88867,-87.64442
KA1503000043,5,9,false,41,25,-16,41.88918,-87.63851
133,5,9,false,3,4,1,41.88918,-87.63851
13050,5,9,false,32,39,7,41.88919,-87.62775
47,5,9,false,3,6,3,41.88921,-87.62775
13432,5,9,false,2,6,4,41.88989,-87.67149
TA1307000151,5,9,false,39,38,-1,41.88993,-87.63427
212,5,9,false,4,4,0,41.88995,-87.63427
636,5,9,false,18,14,-4,41.88997,-87.63662
125,5,9,false,1,3,2,41.89018,-87.62621
KA1503000044,5,9,false,16,23,7,41.89018,-87.6262
196,5,9,false,7,2,-5,41.89053,-87.62205
13427,5,9,false,24,13,-11,41.89054,-87.62205
26,5,9,false,3,4,1,41.89057,-87.61798
13430,5,9,false,27,36,9,41.89077,-87.63169
TA1306000013,5,9,false,21,19,-2,41.89083,-87.61852
RN-,5,9,false,26,14,-12,41.89102,-87.63546
13434,5,9,false,5,17,12,41.89108,-87.66663
TA1308000006,5,9,false,4,5,1,41.89128,-87.67686
199,5,9,false,6,6,0,41.89143,-87.62676
TA1307000117,5,9,false,36,43,7,41.89144,-87.62675
13033,5,9,false,18,17,-1,41.8916,-87.64835
214,5,9,false,2,1,-1,41.89161,-87.67688
84,5,9,false,1,1,0,41.89161,-87.64833
186,5,9,false,4,1,-3,41.8918,-87.65879
13194,5,9,false,14,12,-2,41.8918,-87.65878
TA1305000003,5,9,false,29,32,3,41.89187,-87.62061
24,5,9,false,7,4,-3,41.8919,-87.62063
643,5,9,false,8,1,-7,41.89203,-87.68939
35,5,9,false,6,2,-4,41.89227,-87.61206
13022,5,9,false,93,77,-16,41.89227,-87.61205
99,5,9,false,11,2,-9,41.89255,-87.61449
TA1306000029,5,9,false,43,40,-3,41.89256,-87.61449
13265,5,9,false,28,7,-21,41.89383,-87.64172
74,5,9,false,5,1,-4,41.89384,-87.64173
13045,5,9,false,30,35,5,41.89403,-87.62931
110,5,9,false,4,4,0,41.89406,-87.6293
13016,5,9,false,50,42,-8,41.89431,-87.62277
211,5,9,false,2,14,12,41.89439,-87.62267
KA1503000041,5,9,false,39,33,-6,41.89452,-87.61798
142,5,9,false,4,4,0,41.89453,-87.61806
92,5,9,false,1,2,1,41.89455,-87.65346
13196,5,9,false,18,6,-12,41.89455,-87.65345
TA1307000062,5,9,false,14,12,-2,41.89466,-87.63839
111,5,9,false,2,2,0,41.89466,-87.63837
TA1306000012,5,9,false,30,44,14,41.89475,-87.63438
53,5,9,false,10,11,1,41.89476,-87.63439
KP1705001026,5,9,false,29,15,-14,41.89483,-87.6323
18058,5,9,false,8,4,-4,41.8955,-87.68201
637,5,9,false,18,6,-12,41.89563,-87.67209
13132,5,9,false,25,19,-6,41.89573,-87.67718
161,5,9,false,1,2,1,41.89574,-87.62599
15530,5,9,false,30,16,-14,41.89575,-87.62596
18003,5,9,false,20,12,-8,41.89575,-87.62011
635,5,9,false,1,2,1,41.89576,-87.62012
13247,5,9,false,15,14,-1,41.89597,-87.66775
TA1305000020,5,9,false,12,9,-3,41.89636,-87.65406
54,5,9,false,1,3,2,41.89637,-87.65407
13289,5,9,false,5,6,1,41.89638,-87.661
86,5,9,false,4,1,-3,41.89639,-87.661
337,5,9,false,1,5,4,41.89659,-87.63096
13303,5,9,false,16,16,0,41.89672,-87.63088
13017,5,9,false,24,18,-6,41.89676,-87.6357
31,5,9,false,3,2,-1,41.89677,-87.63572
13338,5,9,false,37,25,-12,41.89697,-87.62173
173,5,9,false,2,4,2,41.89704,-87.62173
TA1307000061,5,9,false,31,10,-21,41.89745,-87.62873
106,5,9,false,1,4,3,41.89746,-87.62874
13034,5,9,false,28,27,-1,41.89754,-87.62352
48,5,9,false,3,4,1,41.89772,-87.64302
TA1306000009,5,9,false,28,40,12,41.89772,-87.64299
620,5,9,false,20,17,-3,41.89817,-87.63754
KA1504000103,5,9,false,21,4,-17,41.89842,-87.68659
145,5,9,false,2,1,-1,41.89856,-87.62211
15529,5,9,false,35,19,-16,41.89858,-87.62206
140,5,9,false,3,3,0,41.89895,-87.6299
TA1307000128,5,9,false,26,31,5,41.89896,-87.6299
657,5,9,false,7,9,2,41.89918,-87.6722
KA1504000117,5,9,false,3,8,5,41.89936,-87.64848
13248,5,9,false,5,5,0,41.89964,-87.66788
TA1306000011,5,9,false,13,4,-9,41.89994,-87.63443
364,5,9,false,3,2,-1,41.90023,-87.64299
KA1504000116,5,9,false,5,11,6,41.90023,-87.64299
17660,5,9,false,11,2,-9,41.90036,-87.69671
13290,5,9,false,18,12,-6,41.90069,-87.66259
29,5,9,false,3,2,-1,41.90069,-87.66259
13042,5,9,false,99,68,-31,41.90097,-87.62377
85,5,9,false,5,6,1,41.90098,-87.62375
TA1307000070,5,9,false,11,6,-5,41.90133,-87.67742
KA1504000133,5,9,false,26,41,15,41.90234,-87.62773
172,5,9,false,8,7,-1,41.90236,-87.62774
15654,5,9,false,6,1,-5,41.90271,-87.70923
305,5,9,false,3,1,-2,41.9028,-87.69005
13241,5,9,false,6,2,-4,41.9029,-87.68731
TA1306000006,5,9,false,4,4,0,41.90292,-87.63772
TA1307000039,5,9,false,47,48,1,41.90294,-87.63137
658,5,9,false,2,3,1,41.903,-87.6838
13256,5,9,false,8,9,1,41.90302,-87.69749
TA1305000034,5,9,false,8,5,-3,41.90313,-87.67391
17,5,9,false,2,1,-1,41.90313,-87.67391
182,5,9,false,3,2,-1,41.90317,-87.63442
KA1504000135,5,9,false,35,52,17,41.90319,-87.63439
13136,5,9,false,14,16,2,41.90326,-87.67845
210,5,9,false,4,4,0,41.90342,-87.66781
13061,5,9,false,23,27,4,41.90342,-87.66779
KA1504000079,5,9,false,13,18,5,41.9035,-87.64334
138,5,9,false,1,1,0,41.9046,-87.64057
TA1307000115,5,9,false,8,9,1,41.9046,-87.64056
291,5,9,false,7,2,-5,41.90672,-87.63494
TA1308000049,5,9,false,30,31,1,41.90672,-87.6349
KA1504000134,5,9,false,13,17,4,41.90687,-87.6262
180,5,9,false,2,2,0,41.90687,-87.62618
13224,5,9,false,20,15,-5,41.90706,-87.66725
333,5,9,false,6,4,-2,41.90706,-87.66725
18069,5,9,false,2,3,1,41.90722,-87.65563
TA1307000143,5,9,false,6,7,1,41.90762,-87.63854
13221,5,9,false,18,12,-6,41.90765,-87.67254
13245,5,9,false,10,3,-7,41.90777,-87.68586
301,5,9,false,2,2,0,41.90796,-87.63203
TA1309000024,5,9,false,14,14,0,41.908,-87.63152
69,5,9,false,3,3,0,41.90939,-87.6777
TA1305000041,5,9,false,19,24,5,41.9094,-87.67769
15652,5,9,false,5,1,-4,41.90965,-87.71664
331,5,9,false,29,40,11,41.90965,-87.64812
15653,5,9,false,7,2,-5,41.90979,-87.7053
TA1305000037,5,9,false,12,9,-3,41.91018,-87.67003
TA1306000008,5,9,false,11,4,-7,41.9102,-87.6435
16,5,9,false,1,1,0,41.91035,-87.67008
TA1308000005,5,9,false,13,6,-7,41.91042,-87.68238
13258,5,9,false,4,1,-3,41.91043,-87.69718
276,5,9,false,3,1,-2,41.91043,-87.69718
13257,5,9,false,21,6,-15,41.91054,-87.68956
13154,5,9,false,19,14,-5,41.91054,-87.65312
13058,5,9,false,11,11,0,41.91059,-87.64942
60,5,9,false,2,4,2,41.91059,-87.64942
TA1307000038,5,9,false,19,7,-12,41.91138,-87.63868
118,5,9,false,1,3,2,41.91138,-87.63868
268,5,9,false,7,3,-4,41.91172,-87.62681
LF-005,5,9,false,43,42,-1,41.91172,-87.62681
126,5,9,false,2,2,0,41.91196,-87.63197
13128,5,9,false,16,16,0,41.91197,-87.63197
289,5,9,false,1,6,5,41.91209,-87.63472
TA1308000050,5,9,false,43,55,12,41.91211,-87.6347
13243,5,9,false,10,9,-1,41.91262,-87.6814
158,5,9,false,1,1,0,41.91262,-87.6814
TA1309000032,5,9,false,1,2,1,41.91293,-87.66417
TA1306000032,5,9,false,17,11,-6,41.9137,-87.65285
93,5,9,false,3,2,-1,41.91371,-87.65285
224,5,9,false,1,1,0,41.91386,-87.64877
TA1307000166,5,9,false,10,10,0,41.91386,-87.64877
15655,5,9,false,10,5,-5,41.91401,-87.70514
18017,5,9,false,8,4,-4,41.91416,-87.71676
18067,5,9,false,7,6,-1,41.9146,-87.66796
TA1306000007,5,9,false,6,3,-3,41.91469,-87.64333
13068,5,9,false,12,10,-2,41.91554,-87.68703
13179,5,9,false,33,23,-10,41.9157,-87.63461
141,5,9,false,2,2,0,41.91571,-87.63461
13133,5,9,false,11,6,-5,41.91598,-87.67733
219,5,9,false,4,2,-2,41.91598,-87.67733
58,5,9,false,3,5,2,41.91602,-87.66894
TA1305000039,5,9,false,14,12,-2,41.9163,-87.66749
15650,5,9,false,2,5,3,41.91711,-87.71023
13266,5,9,false,3,4,1,41.91774,-87.69142
TA1309000029,5,9,false,16,2,-14,41.9178,-87.68245
TA1309000006,5,9,false,18,12,-6,41.91809,-87.64375
288,5,9,false,1,3,2,41.91809,-87.64375
223,5,9,false,2,1,-1,41.91821,-87.65698
TA1307000163,5,9,false,19,14,-5,41.91821,-87.65696
94,5,9,false,3,11,8,41.91831,-87.6363
13146,5,9,false,43,27,-16,41.91831,-87.63629
13059,5,9,false,21,28,7,41.91845,-87.65222
113,5,9,false,9,2,-7,41.91846,-87.65222
310,5,9,false,1,1,0,41.91984,-87.68083
13192,5,9,false,13,12,-1,41.91995,-87.64884
225,5,9,false,2,2,0,41.91995,-87.64884
13288,5,9,false,7,5,-2,41.92008,-87.67788
13242,5,9,false,5,10,5,41.92021,-87.69266
307,5,9,false,1,2,1,41.92077,-87.66373
TA1309000030,5,9,false,6,20,14,41.92077,-87.66372
290,5,9,false,2,1,-1,41.92152,-87.70734
13292,5,9,false,2,3,1,41.92152,-87.70733
TA1309000033,5,9,false,12,10,-2,41.92158,-87.65381
13193,5,9,false,17,19,2,41.92182,-87.64412
144,5,9,false,7,3,-4,41.92182,-87.64411
143,5,9,false,7,1,-6,41.92217,-87.63891
13191,5,9,false,16,15,-1,41.92217,-87.63891
327,5,9,false,1,3,2,41.92225,-87.65783
13084,5,9,false,9,8,-1,41.92268,-87.69715
123,5,9,false,1,2,1,41.92268,-87.69714
LP-,5,9,false,19,15,-4,41.92396,-87.63584
673,5,9,false,3,4,1,41.92398,-87.63585
KA1504000140,5,9,false,3,6,3,41.92409,-87.67646
619,5,9,false,1,1,0,41.92457,-87.7279
15648,5,9,false,2,1,-1,41.92464,-87.68931
504,5,9,false,1,1,0,41.92464,-87.68931
KA1504000090,5,9,false,1,1,0,41.92483,-87.7145
TA1307000001,5,9,false,15,15,0,41.92535,-87.66581
188,5,9,false,4,2,-2,41.92536,-87.66581
TA1306000026,5,9,false,9,14,5,41.92558,-87.65842
87,5,9,false,1,1,0,41.92559,-87.65843
TA1306000016,5,9,false,17,17,0,41.9256,-87.65371
313,5,9,false,6,2,-4,41.9257,-87.64246
TA1309000019,5,9,false,35,22,-13,41.92586,-87.63897
TA1309000058,5,9,false,27,22,-5,41.92591,-87.64927
127,5,9,false,2,2,0,41.92592,-87.64927
177,5,9,false,2,3,1,41.92627,-87.63086
TA1308000001,5,9,false,20,21,1,41.92627,-87.63086
502,5,9,false,2,1,-1,41.92667,-87.69772
15646,5,9,false,6,5,-1,41.92668,-87.6977
13124,5,9,false,10,3,-7,41.92675,-87.63444
TA1309000023,5,9,false,6,21,15,41.9287,-87.65383
TA1307000113,5,9,false,14,13,-1,41.92878,-87.66391
13296,5,9,false,23,4,-19,41.92883,-87.66852
TA1309000059,5,9,false,8,6,-2,41.92889,-87.65898
349,5,9,false,1,3,2,41.92915,-87.6491
TA1309000061,5,9,false,13,7,-6,41.92915,-87.64909
TA1308000031,5,9,false,10,12,2,41.92946,-87.68417
TA1305000014,5,9,false,26,24,-2,41.92956,-87.64313
340,5,9,false,3,4,1,41.92956,-87.64313
260,5,9,false,1,1,0,41.92958,-87.70791
13085,5,9,false,16,18,2,41.92958,-87.70789
15643,5,9,false,3,2,-1,41.93057,-87.7238
TA1307000142,5,9,false,40,30,-10,41.93125,-87.64432
220,5,9,false,5,5,0,41.93125,-87.64431
13276,5,9,false,36,11,-25,41.93132,-87.63874
324,5,9,false,7,5,-2,41.93173,-87.64179
15645,5,9,false,1,4,3,41.93191,-87.70121
163,5,9,false,1,1,0,41.93191,-87.67784
13271,5,9,false,6,7,1,41.93192,-87.67784
152,5,9,false,2,4,2,41.93221,-87.65864
TA1307000064,5,9,false,26,28,2,41.93222,-87.65864
13,5,9,false,4,3,-1,41.93242,-87.65271
TA1306000014,5,9,false,20,22,2,41.93242,-87.65271
TA1309000039,5,9,false,15,14,-1,41.93258,-87.63642
13294,5,9,false,18,12,-6,41.9326,-87.66595
319,5,9,false,2,1,-1,41.93292,-87.67217
332,5,9,false,2,3,1,41.93313,-87.64776
TA1309000036,5,9,false,13,23,10,41.93313,-87.64776
15644,5,9,false,4,4,0,41.93534,-87.71687
TA1307000006,5,9,false,14,12,-2,41.93571,-87.6636
153,5,9,false,3,5,2,41.93575,-87.66364
162,5,9,false,1,2,1,41.93588,-87.67844
13268,5,9,false,8,7,-1,41.93588,-87.67843
13269,5,9,false,8,11,3,41.93609,-87.66983
TA1307000052,5,9,false,13,21,8,41.93628,-87.65266
156,5,9,false,6,4,-2,41.9365,-87.64756
TA1307000136,5,9,false,21,21,0,41.9365,-87.64755
TA1307000041,5,9,false,29,14,-15,41.93669,-87.63683
157,5,9,false,4,1,-3,41.9367,-87.63683
13137,5,9,false,54,28,-26,41.9376,-87.6441
300,5,9,false,7,4,-3,41.93761,-87.6441
15642,5,9,false,8,6,-2,41.93843,-87.69801
154,5,9,false,4,2,-2,41.93912,-87.66384
KA17018068,5,9,false,6,5,-1,41.93935,-87.68327
TA1309000042,5,9,false,4,12,8,41.93937,-87.66836
131,5,9,false,2,3,1,41.93937,-87.66835
KA150400009X,5,9,false,3,6,3,41.9394,-87.71159
13229,5,9,false,13,24,11,41.93946,-87.66376
TA1308000019,5,9,false,10,20,10,41.93973,-87.65886
296,5,9,false,4,1,-3,41.9401,-87.64546
13277,5,9,false,14,22,8,41.9401,-87.64546
TA1307000134,5,9,false,35,29,-6,41.94016,-87.65303
13143,5,9,false,9,2,-7,41.94059,-87.67853
334,5,9,false,6,4,-2,41.94076,-87.63919
TA1309000049,5,9,false,46,24,-22,41.94077,-87.63919
15634,5,9,false,3,4,1,41.94304,-87.68729
TA1307000138,5,9,false,12,9,-3,41.94334,-87.67094
230,5,9,false,1,3,2,41.94335,-87.67093
13144,5,9,false,7,7,0,41.9434,-87.67964
299,5,9,false,5,2,-3,41.94368,-87.64894
TA1309000025,5,9,false,18,16,-2,41.94368,-87.64894
229,5,9,false,1,2,1,41.94372,-87.66401
13071,5,9,false,18,9,-9,41.94373,-87.66401
632,5,9,false,19,23,4,41.94453,-87.6547
303,5,9,false,8,1,-7,41.94522,-87.64702
490,5,9,false,1,2,1,41.94523,-87.70664
15631,5,9,false,4,7,3,41.94524,-87.70665
13278,5,9,false,40,19,-21,41.94553,-87.64644
TA1309000050,5,9,false,4,3,-1,41.94618,-87.67331
KA1504000141,5,9,false,6,2,-4,41.94627,-87.73105
KA1504000143,5,9,false,4,2,-2,41.94664,-87.68337
227,5,9,false,2,3,1,41.94813,-87.66397
13235,5,9,false,17,28,11,41.94814,-87.66396
13253,5,9,false,4,4,0,41.9488,-87.67527
13325,5,9,false,26,15,-11,41.94907,-87.64863
114,5,9,false,6,1,-5,41.94935,-87.65451
TA1307000126,5,9,false,25,44,19,41.94936,-87.65451
232,5,9,false,3,2,-1,41.94943,-87.64645
TA1307000150,5,9,false,40,12,-28,41.94945,-87.64646
13319,5,9,false,2,12,10,41.95069,-87.6687
TA1307000127,5,9,false,19,26,7,41.9508,-87.65918
165,5,9,false,3,5,2,41.95081,-87.65918
15628,5,9,false,4,4,0,41.95216,-87.69806
13323,5,9,false,19,12,-7,41.95282,-87.65
256,5,9,false,8,2,-6,41.95282,-87.65
15624,5,9,false,2,4,2,41.95339,-87.73199
485,5,9,false,1,1,0,41.95361,-87.70933
KA1504000096,5,9,false,5,1,-4,41.95361,-87.70932
590,5,9,false,2,1,-1,41.95374,-87.74056
KA1504000139,5,9,false,4,2,-2,41.954,-87.71909
TA1309000043,5,9,false,6,8,2,41.95417,-87.66434
13063,5,9,false,24,12,-12,41.95424,-87.65441
240,5,9,false,4,3,-1,41.95424,-87.65441
TA1308000022,5,9,false,19,5,-14,41.95438,-87.64805
589,5,9,false,1,1,0,41.95447,-87.7496
TA1307000149,5,9,false,2,10,8,41.95467,-87.67392
TA1309000026,5,9,false,3,4,1,41.95601,-87.6802
TA1308000047,5,9,false,6,2,-4,41.95709,-87.6642
13379,5,9,false,17,4,-13,41.95786,-87.6495
TA1309000018,5,9,false,4,5,1,41.95791,-87.67357
316,5,9,false,5,1,-4,41.95841,-87.69401
TA1309000027,5,9,false,16,9,-7,41.9585,-87.65499
592,5,9,false,1,1,0,41.96065,-87.74538
13389,5,9,false,11,9,-2,41.961,-87.64958
245,5,9,false,2,1,-1,41.96101,-87.64958
15621,5,9,false,1,3,2,41.96103,-87.70586
15622,5,9,false,4,3,-1,41.96108,-87.69544
KA1504000164,5,9,false,3,1,-2,41.96109,-87.72897
TA1307000144,5,9,false,3,7,4,41.96142,-87.6762
TA1309000021,5,9,false,2,3,1,41.9615,-87.6714
KA1503000022,5,9,false,6,3,-3,41.96158,-87.66609
231,5,9,false,5,1,-4,41.96163,-87.65464
TA1307000107,5,9,false,25,8,-17,41.96164,-87.65464
TA1307000156,5,9,false,1,1,0,41.96301,-87.68479
TA1309000012,5,9,false,9,3,-6,41.96325,-87.67928
TA1308000012,5,9,false,5,12,7,41.96398,-87.63818
13074,5,9,false,13,8,-5,41.96521,-87.6582
639,5,9,false,7,11,4,41.96584,-87.64538
KA1504000127,5,9,false,1,3,2,41.96587,-87.70083
KA1504000093,5,9,false,1,4,3,41.96587,-87.69365
TA1307000140,5,9,false,7,3,-4,41.96643,-87.68865
326,5,9,false,2,3,1,41.96665,-87.67113
TA1309000014,5,9,false,15,1,-14,41.96709,-87.66744
TA1307000158,5,9,false,3,3,0,41.9671,-87.67904
TA1307000119,5,9,false,9,2,-7,41.96796,-87.65
TA1308000021,5,9,false,4,6,2,41.96883,-87.65765
TA1309000015,5,9,false,2,1,-1,41.96889,-87.68401
TA1309000066,5,9,false,17,10,-7,41.9691,-87.67423
TA1309000041,5,9,false,6,3,-3,41.96951,-87.65471
KA1504000171,5,9,false,10,6,-4,41.97161,-87.65016
465,5,9,false,4,1,-3,41.97161,-87.65016
325,5,9,false,1,2,1,41.9728,-87.67186
TA1309000035,5,9,false,22,8,-14,41.97335,-87.66785
295,5,9,false,1,2,1,41.97378,-87.65972
13108,5,9,false,10,8,-2,41.97379,-87.65971
KA1504000149,5,9,false,8,3,-5,41.97562,-87.67945
471,5,9,false,1,1,0,41.97564,-87.70143
KA1504000128,5,9,false,2,1,-1,41.97567,-87.70927
463,5,9,false,1,1,0,41.978,-87.66805
KA1504000146,5,9,false,10,12,2,41.978,-87.66805
13109,5,9,false,10,8,-2,41.97835,-87.65976
KA1504000161,5,9,false,1,2,1,41.98038,-87.71612
460,5,9,false,2,1,-1,41.98358,-87.66916
KA1504000151,5,9,false,4,17,13,41.98359,-87.66916
15585,5,9,false,1,4,3,41.98367,-87.69642
KA1504000152,5,9,false,16,9,-7,41.98403,-87.65231
459,5,9,false,2,4,2,41.98403,-87.65231
15578,5,9,false,5,8,3,41.98405,-87.66027
15575,5,9,false,6,5,-1,41.98975,-87.66014
KA1504000148,5,9,false,4,2,-2,41.99086,-87.66971
KA1504000129,5,9,false,1,1,0,41.99417,-87.68945
15571,5,9,false,9,6,-3,41.99478,-87.66028
453,5,9,false,1,3,2,41.99925,-87.67137
RP-009,5,9,false,1,8,7,42.00107,-87.66122
RP-008,5,9,false,2,2,0,42.00446,-87.6724
660,5,9,false,7,1,-6,42.00458,-87.66143
KA1504000175,5,9,false,7,4,-3,42.00797,-87.66549
RP-005,5,9,false,2,3,1,42.0086,-87.69047
KA1504000162,5,9,false,4,3,-1,42.00907,-87.67422
KA1504000159,5,9,false,3,2,-1,42.01059,-87.66241
525,5,9,false,2,1,-1,42.01272,-87.66605
517,5,9,false,3,1,-2,42.01597,-87.675
520,5,9,false,3,2,-1,42.01597,-87.66859
519,5,9,false,3,1,-2,42.01696,-87.67773
515,5,9,false,2,1,-1,42.01915,-87.67356
E002,5,9,false,4,6,2,42.03256,-87.67912
596,5,9,false,11,7,-4,42.04822,-87.68348
600,5,9,false,3,1,-2,42.04831,-87.6983
E008,5,9,false,7,4,-3,42.05049,-87.67782
605,5,9,false,2,2,0,42.05294,-87.67342
661,5,9,false,15,2,-13,42.05704,-87.68657
604,5,9,false,11,18,7,42.05824,-87.67744
E006,5,9,false,3,4,1,42.06367,-87.69871
E014,5,9,false,1,1,0,42.06483,-87.71531
20222,5,9,true,2,1,-1,41.7046,-87.52832
20107,5,9,true,3,1,-2,41.7122,-87.66772
20223,5,9,true,1,1,0,41.71272,-87.53472
20103,5,9,true,1,1,0,41.7281,-87.66757
588,5,9,true,1,1,0,41.74392,-87.57522
583,5,9,true,1,3,2,41.74656,-87.58599
20234,5,9,true,2,1,-1,41.75223,-87.66378
575,5,9,true,1,1,0,41.75318,-87.60502
KA1503000049,5,9,true,1,1,0,41.75788,-87.54938
KA1503000019,5,9,true,2,1,-1,41.75867,-87.5869
20245,5,9,true,1,2,1,41.7592,-87.66348
KA1503000020,5,9,true,1,1,0,41.76223,-87.55923
KA1503000002,5,9,true,3,2,-1,41.76641,-87.5657
12,5,9,true,1,1,0,41.76641,-87.5657
KA1503000029,5,9,true,4,1,-3,41.77364,-87.56747
KA1503000055,5,9,true,1,1,0,41.77939,-87.64463
KA1503000053,5,9,true,1,1,0,41.78009,-87.61595
KA1503000046,5,9,true,3,1,-2,41.78041,-87.59141
15491,5,9,true,3,6,3,41.78096,-87.57624
101,5,9,true,1,1,0,41.78105,-87.57611
KA1503000014,5,9,true,68,37,-31,41.7851,-87.60108
426,5,9,true,7,11,4,41.7851,-87.60108
KA1503000070,5,9,true,25,24,-1,41.78794,-87.58831
425,5,9,true,4,1,-3,41.78795,-87.58831
328,5,9,true,6,15,9,41.78872,-87.6013
TA1309000011,5,9,true,10,54,44,41.78873,-87.60131
423,5,9,true,4,19,15,41.79148,-87.59988
KA1503000071,5,9,true,33,122,89,41.79148,-87.59988
KA1503000074,5,9,true,10,8,-2,41.79174,-87.58395
TA1309000063,5,9,true,28,21,-7,41.79325,-87.5878
345,5,9,true,4,5,1,41.79326,-87.5878
420,5,9,true,11,5,-6,41.79429,-87.60145
KA1504000076,5,9,true,28,75,47,41.7943,-87.60145
247,5,9,true,7,3,-4,41.79522,-87.58077
TA1308000009,5,9,true,46,18,-28,41.79522,-87.58075
TA1307000164,5,9,true,21,27,6,41.79527,-87.59647
248,5,9,true,8,6,-2,41.79528,-87.59647
KA1503000052,5,9,true,30,17,-13,41.79935,-87.60097
418,5,9,true,1,1,0,41.79936,-87.60097
KA1503000059,5,9,true,23,10,-13,41.79952,-87.58643
419,5,9,true,6,1,-5,41.79952,-87.58643
TA1309000037,5,9,true,42,17,-25,41.79957,-87.59474
417,5,9,true,10,3,-7,41.80242,-87.5869
KA1503000007,5,9,true,50,8,-42,41.80242,-87.58689
13398,5,9,true,32,8,-24,41.80256,-87.59035
121,5,9,true,5,5,0,41.80256,-87.59035
TA1309000067,5,9,true,2,2,0,41.80303,-87.60661
322,5,9,true,9,10,1,41.80321,-87.59849
594,5,9,true,1,1,0,41.80567,-87.68337
416,5,9,true,2,1,-1,41.80578,-87.59247
KA1503000069,5,9,true,5,2,-3,41.80579,-87.59247
KA1503000009,5,9,true,1,1,0,41.80932,-87.63346
TA1308000035,5,9,true,3,5,2,41.80944,-87.59188
252,5,9,true,6,1,-5,41.80982,-87.59936
TA1308000002,5,9,true,4,4,0,41.80983,-87.59937
TA1309000053,5,9,true,1,1,0,41.80985,-87.60675
413,5,9,true,4,2,-2,41.81408,-87.59701
KA1503000065,5,9,true,11,2,-9,41.81409,-87.59701
TA1308000023,5,9,true,1,1,0,41.81649,-87.60659
13083,5,9,true,2,1,-1,41.82167,-87.62153
265,5,9,true,4,2,-2,41.82297,-87.6071
TA1308000038,5,9,true,3,2,-1,41.82298,-87.6071
16932,5,9,true,1,1,0,41.82346,-87.66558
179,5,9,true,1,2,1,41.82458,-87.61678
13420,5,9,true,2,1,-1,41.82459,-87.61678
KA1503000066,5,9,true,2,1,-1,41.83011,-87.67031
TA1308000045,5,9,true,20,4,-16,41.83062,-87.64129
TA1308000043,5,9,true,3,5,2,41.83066,-87.64715
KA1503000005,5,9,true,3,3,0,41.83079,-87.6325
TA1307000129,5,9,true,5,29,24,41.83104,-87.62683
13345,5,9,true,4,1,-3,41.83138,-87.61803
15445,5,9,true,8,10,2,41.83453,-87.63183
13216,5,9,true,12,72,60,41.83473,-87.62581
148,5,9,true,9,12,3,41.83474,-87.62581
149,5,9,true,2,1,-1,41.83486,-87.61791
13217,5,9,true,18,12,-6,41.83488,-87.61792
13215,5,9,true,31,7,-24,41.83634,-87.6135
TA1308000046,5,9,true,16,7,-9,41.83779,-87.65115
TA1309000055,5,9,true,19,13,-6,41.8382,-87.64514
KA1503000038,5,9,true,14,6,-8,41.83845,-87.6354
402,5,9,true,2,6,4,41.83845,-87.6354
150,5,9,true,6,6,0,41.83855,-87.60821
TA1307000048,5,9,true,12,14,2,41.83855,-87.60821
272,5,9,true,1,1,0,41.83882,-87.62186
TA1308000036,5,9,true,31,15,-16,41.83883,-87.62186
15442,5,9,true,3,1,-2,41.83918,-87.66562
KA1503000040,5,9,true,5,3,-2,41.84164,-87.65744
193,5,9,true,1,1,0,41.84171,-87.62695
13213,5,9,true,3,9,6,41.84171,-87.62694
237,5,9,true,9,1,-8,41.84204,-87.61697
TA1307000139,5,9,true,39,12,-27,41.84205,-87.61698
15443,5,9,true,5,3,-2,41.84275,-87.63549
207,5,9,true,1,1,0,41.84358,-87.64539
TA1307000153,5,9,true,11,4,-7,41.84358,-87.64538
15692,5,9,true,1,1,0,41.84404,-87.69531
15691,5,9,true,1,2,1,41.84449,-87.70203
147,5,9,true,3,3,0,41.84569,-87.62251
TA1307000005,5,9,true,10,6,-4,41.84569,-87.6225
TA1308000013,5,9,true,5,14,9,41.84719,-87.64681
348,5,9,true,1,1,0,41.8477,-87.69448
TA1309000003,5,9,true,3,1,-2,41.84847,-87.68512
15689,5,9,true,4,1,-3,41.84912,-87.69515
TA1308000014,5,9,true,4,6,2,41.84953,-87.64059
209,5,9,true,1,1,0,41.84953,-87.64058
132,5,9,true,1,2,1,41.85008,-87.63215
TA1305000004,5,9,true,7,6,-1,41.8514,-87.61884
42,5,9,true,2,2,0,41.85261,-87.62653
TA1305000001,5,9,true,19,13,-6,41.85262,-87.6265
13075,5,9,true,14,28,14,41.8531,-87.63192
120,5,9,true,3,7,4,41.8531,-87.63191
13162,5,9,true,8,3,-5,41.85378,-87.64659
13091,5,9,true,14,7,-7,41.85409,-87.68585
370,5,9,true,2,1,-1,41.85415,-87.61917
15546,5,9,true,3,2,-1,41.85416,-87.61916
13307,5,9,true,10,2,-8,41.85489,-87.66359
208,5,9,true,1,1,0,41.85489,-87.66359
13089,5,9,true,5,6,1,41.85497,-87.67567
13331,5,9,true,7,6,-1,41.85515,-87.65414
171,5,9,true,8,2,-6,41.85516,-87.65414
15545,5,9,true,33,27,-6,41.85627,-87.61334
4,5,9,true,5,7,2,41.85627,-87.61334
SL-013,5,9,true,10,8,-2,41.85659,-87.62755
SL-006,5,9,true,2,4,2,41.8568,-87.63387
129,5,9,true,2,2,0,41.85752,-87.66158
13135,5,9,true,21,27,6,41.85753,-87.66157
338,5,9,true,5,1,-4,41.85758,-87.61956
13102,5,9,true,40,14,-26,41.85762,-87.61942
13150,5,9,true,37,34,-3,41.85783,-87.62455
273,5,9,true,8,8,0,41.85783,-87.62455
13099,5,9,true,18,11,-7,41.85784,-87.64627
TA1307000159,5,9,true,31,7,-24,41.8579,-87.6687
170,5,9,true,1,5,4,41.85793,-87.64083
TA1307000044,5,9,true,18,5,-13,41.85794,-87.64083
13163,5,9,true,12,18,6,41.85808,-87.65108
13164,5,9,true,34,13,-21,41.85818,-87.65648
15,5,9,true,6,3,-3,41.85819,-87.65648
SL-012,5,9,true,40,20,-20,41.86038,-87.62581
72,5,9,true,10,5,-5,41.86039,-87.62581
274,5,9,true,1,1,0,41.86126,-87.6566
13304,5,9,true,7,6,-1,41.86126,-87.65659
437,5,9,true,1,1,0,41.86192,-87.69348
KA1504000109,5,9,true,1,8,7,41.86192,-87.69347
TA1306000002,5,9,true,18,9,-9,41.86238,-87.65108
137,5,9,true,3,2,-1,41.86238,-87.65108
TA1307000124,5,9,true,43,42,-1,41.86411,-87.62372
168,5,9,true,15,5,-10,41.86415,-87.62372
282,5,9,true,7,7,0,41.86487,-87.64708
TA1309000001,5,9,true,15,23,8,41.86488,-87.64708
13354,5,9,true,7,18,11,41.86524,-87.66651
13029,5,9,true,2,12,10,41.86531,-87.6179
341,5,9,true,2,4,2,41.86608,-87.60733
13431,5,9,true,9,18,9,41.8661,-87.60728
KA1504000101,5,9,true,5,5,0,41.86651,-87.68466
434,5,9,true,1,1,0,41.86651,-87.68465
WL-008,5,9,true,23,10,-13,41.86712,-87.64108
57,5,9,true,4,4,0,41.86712,-87.64107
TA1305000002,5,9,true,67,58,-9,41.86721,-87.62597
59,5,9,true,16,24,8,41.86721,-87.62597
3,5,9,true,6,1,-5,41.86723,-87.61536
15544,5,9,true,16,35,19,41.86723,-87.61536
TA1305000017,5,9,true,11,26,15,41.86734,-87.64863
55,5,9,true,3,6,3,41.86735,-87.64863
626,5,9,true,8,1,-7,41.86749,-87.63219
KA1706005007,5,9,true,12,8,-4,41.86749,-87.63219
SL-005,5,9,true,87,40,-47,41.8679,-87.62304
255,5,9,true,18,4,-14,41.86791,-87.62304
644,5,9,true,21,5,-16,41.86859,-87.68625
19,5,9,true,3,4,1,41.86892,-87.65913
13139,5,9,true,13,9,-4,41.86893,-87.65913
13285,5,9,true,12,103,91,41.86928,-87.67372
13160,5,9,true,32,10,-22,41.86947,-87.65548
22,5,9,true,10,2,-8,41.86947,-87.65548
414,5,9,true,2,4,2,41.87023,-87.63947
15550,5,9,true,12,17,5,41.87024,-87.63947
TA1309000010,5,9,true,68,44,-24,41.87074,-87.62574
SL-009,5,9,true,21,17,-4,41.87081,-87.63121
342,5,9,true,6,19,13,41.87127,-87.6737
TA1309000064,5,9,true,24,71,47,41.87127,-87.67369
15542,5,9,true,4,5,1,41.87146,-87.64095
261,5,9,true,1,20,19,41.87151,-87.6699
TA1307000130,5,9,true,40,54,14,41.87178,-87.65103
241,5,9,true,11,6,-5,41.8718,-87.65102
108,5,9,true,3,11,8,41.87183,-87.64664
TA1307000121,5,9,true,61,47,-14,41.87184,-87.64664
41,5,9,true,16,4,-12,41.87209,-87.62957
SL-008,5,9,true,64,30,-34,41.87209,-87.62956
13332,5,9,true,70,33,-37,41.87219,-87.6615
394,5,9,true,4,6,2,41.87226,-87.63484
175,5,9,true,6,3,-3,41.87255,-87.63359
SL-011,5,9,true,35,14,-21,41.87256,-87.63356
623,5,9,true,43,20,-23,41.87272,-87.62399
KA1504000104,5,9,true,27,82,55,41.87296,-87.66912
383,5,9,true,3,13,10,41.87297,-87.66912
320,5,9,true,15,8,-7,41.87327,-87.66402
5,5,9,true,3,2,-1,41.87403,-87.6277
SL-007,5,9,true,23,21,-2,41.87404,-87.6277
13326,5,9,true,2,11,9,41.87425,-87.63958
321,5,9,true,17,9,-8,41.87427,-87.63257
TA1306000025,5,9,true,13,16,3,41.87464,-87.65703
15668,5,9,true,9,7,-2,41.87471,-87.68642
109,5,9,true,4,3,-1,41.87475,-87.64981
13028,5,9,true,26,26,0,41.87475,-87.64981
13081,5,9,true,2,14,12,41.87501,-87.67326
89,5,9,true,6,3,-3,41.87501,-87.6331
SL-010,5,9,true,18,14,-4,41.87501,-87.63309
15541,5,9,true,9,9,0,41.8758,-87.62086
13037,5,9,true,6,16,10,41.87588,-87.64078
50,5,9,true,3,1,-2,41.87592,-87.6307
TA1305000009,5,9,true,18,8,-10,41.87593,-87.63068
317,5,9,true,1,25,24,41.87603,-87.68195
45,5,9,true,4,3,-1,41.87623,-87.62444
TA1305000010,5,9,true,11,18,7,41.87623,-87.62444
624,5,9,true,31,17,-14,41.87626,-87.62923
2,5,9,true,1,1,0,41.87649,-87.62051
TA1305000035,5,9,true,27,34,7,41.87716,-87.62787
13138,5,9,true,12,36,24,41.87723,-87.63941
75,5,9,true,2,4,2,41.87724,-87.63937
15539,5,9,true,42,27,-15,41.87763,-87.64405
13158,5,9,true,50,46,-4,41.87764,-87.64957
134,5,9,true,16,5,-11,41.87764,-87.64954
13157,5,9,true,37,16,-21,41.87773,-87.6548
21,5,9,true,9,6,-3,41.87773,-87.6548
TA1305000025,5,9,true,31,85,54,41.87773,-87.63528
36,5,9,true,4,7,3,41.87776,-87.63525
TA1309000002,5,9,true,20,22,2,41.87784,-87.62408
13206,5,9,true,21,15,-6,41.87794,-87.66201
146,5,9,true,8,3,-5,41.87794,-87.66201
283,5,9,true,1,13,12,41.87809,-87.63183
TA1309000004,5,9,true,29,38,9,41.87811,-87.63184
107,5,9,true,6,5,-1,41.87822,-87.644
638,5,9,true,45,69,24,41.87827,-87.64078
37,5,9,true,2,16,14,41.87921,-87.62975
TA1305000005,5,9,true,17,125,108,41.87924,-87.62975
286,5,9,true,1,5,4,41.8793,-87.6355
13011,5,9,true,29,74,45,41.87931,-87.63993
TA1309000008,5,9,true,29,64,35,41.87933,-87.6355
192,5,9,true,6,11,5,41.87935,-87.63997
KA1503000034,5,9,true,11,39,28,41.87938,-87.63197
40,5,9,true,1,13,12,41.87944,-87.63197
39,5,9,true,1,13,12,41.87948,-87.62571
KA1503000015,5,9,true,15,48,33,41.87948,-87.6257
15667,5,9,true,5,3,-2,41.8798,-87.68609
287,5,9,true,4,10,6,41.88017,-87.63527
540,5,9,true,1,6,5,41.88022,-87.75536
TA1309000007,5,9,true,29,93,64,41.88022,-87.63526
544,5,9,true,3,1,-2,41.88028,-87.77448
WL-011,5,9,true,44,32,-12,41.88034,-87.64273
73,5,9,true,11,5,-6,41.8804,-87.64273
80,5,9,true,8,4,-4,41.88042,-87.65556
13156,5,9,true,46,30,-16,41.88042,-87.65554
534,5,9,true,1,1,0,41.88085,-87.72793
13300,5,9,true,11,18,7,41.88097,-87.61675
76,5,9,true,4,2,-2,41.88098,-87.61675
13008,5,9,true,20,50,30,41.88105,-87.62408
90,5,9,true,4,12,8,41.88107,-87.62409
49,5,9,true,6,31,25,41.88116,-87.62963
TA1305000006,5,9,true,33,154,121,41.88122,-87.6296
13134,5,9,true,6,6,0,41.88138,-87.67493
13056,5,9,true,24,43,19,41.88168,-87.63951
191,5,9,true,8,3,-5,41.88169,-87.63951
198,5,9,true,10,18,8,41.88187,-87.6488
TA1307000120,5,9,true,57,71,14,41.88188,-87.64879
13341,5,9,true,31,61,30,41.88208,-87.63985
174,5,9,true,5,9,4,41.88208,-87.63984
197,5,9,true,4,7,3,41.88208,-87.62513
13036,5,9,true,34,62,28,41.8821,-87.62513
77,5,9,true,11,6,-5,41.88214,-87.64108
TA1305000032,5,9,true,70,64,-6,41.88218,-87.64109
98,5,9,true,1,11,10,41.88266,-87.63251
13006,5,9,true,27,72,45,41.88268,-87.63252
13353,5,9,true,24,19,-5,41.88283,-87.6612
346,5,9,true,3,3,0,41.88284,-87.6612
654,5,9,true,20,10,-10,41.88307,-87.65698
233,5,9,true,13,4,-9,41.88309,-87.6511
13409,5,9,true,28,31,3,41.8831,-87.6511
18,5,9,true,2,11,9,41.88317,-87.63735
KA1503000072,5,9,true,14,68,54,41.88317,-87.63693
91,5,9,true,5,11,6,41.88336,-87.64122
WL-012,5,9,true,74,91,17,41.88337,-87.6412
112,5,9,true,7,10,3,41.88362,-87.6486
13053,5,9,true,33,58,25,41.88365,-87.64863
43,5,9,true,8,12,4,41.88396,-87.62455
13001,5,9,true,45,57,12,41.88397,-87.62459
88,5,9,true,1,6,5,41.88407,-87.65691
13155,5,9,true,9,17,8,41.88407,-87.65689
621,5,9,true,3,2,-1,41.88412,-87.65427
18062,5,9,true,24,25,1,41.88412,-87.65427
81,5,9,true,11,39,28,41.88417,-87.6296
TA1306000010,5,9,true,31,123,92,41.88419,-87.62961
15666,5,9,true,1,3,2,41.88446,-87.6963
TA1305000030,5,9,true,38,172,134,41.88459,-87.63178
15535,5,9,true,29,33,4,41.8846,-87.64455
51,5,9,true,1,35,34,41.88462,-87.63176
TA1305000029,5,9,true,32,63,31,41.88466,-87.62787
195,5,9,true,22,9,-13,41.88466,-87.61952
13263,5,9,true,52,37,-15,41.88467,-87.61952
44,5,9,true,3,11,8,41.88468,-87.62782
TA1306000015,5,9,true,38,92,54,41.88549,-87.65232
71,5,9,true,8,11,3,41.8855,-87.65233
66,5,9,true,10,14,4,41.88557,-87.64186
13021,5,9,true,53,71,18,41.88559,-87.64184
TA1307000111,5,9,true,48,82,34,41.88582,-87.63548
164,5,9,true,4,12,8,41.88583,-87.63547
13073,5,9,true,13,12,-1,41.88592,-87.66717
119,5,9,true,1,2,1,41.88593,-87.66717
KA17018054,5,9,true,6,13,7,41.88595,-87.67701
38,5,9,true,17,19,2,41.88599,-87.63089
KA1503000012,5,9,true,56,67,11,41.88599,-87.63089
52,5,9,true,9,16,7,41.886,-87.62421
TA1305000011,5,9,true,61,101,40,41.886,-87.62418
7,5,9,true,8,3,-5,41.88627,-87.61751
15534,5,9,true,27,27,0,41.88627,-87.61749
217,5,9,true,8,6,-2,41.8866,-87.65821
13197,5,9,true,16,13,-3,41.8866,-87.65816
264,5,9,true,7,9,2,41.8867,-87.62224
TA1308000029,5,9,true,28,35,7,41.88673,-87.62225
194,5,9,true,2,13,11,41.88688,-87.62606
TA1307000131,5,9,true,14,42,28,41.88688,-87.62606
6,5,9,true,1,4,3,41.88697,-87.61281
KA1503000064,5,9,true,16,30,14,41.88697,-87.61281
532,5,9,true,2,1,-1,41.88792,-87.77446
16906,5,9,true,1,2,1,41.88792,-87.77445
100,5,9,true,13,9,-4,41.88814,-87.63657
TA1305000022,5,9,true,83,76,-7,41.88817,-87.63656
56,5,9,true,15,16,1,41.88866,-87.64442
TA1306000003,5,9,true,40,41,1,41.88867,-87.64442
KA1503000043,5,9,true,120,112,-8,41.88918,-87.63851
133,5,9,true,25,24,-1,41.88918,-87.63851
13050,5,9,true,49,75,26,41.88919,-87.62775
47,5,9,true,13,19,6,41.88921,-87.62775
15664,5,9,true,5,4,-1,41.8895,-87.68821
13432,5,9,true,16,38,22,41.88989,-87.67149
TA1307000151,5,9,true,70,96,26,41.88993,-87.63427
212,5,9,true,19,29,10,41.88995,-87.63427
636,5,9,true,41,45,4,41.88997,-87.63662
125,5,9,true,1,11,10,41.89018,-87.62621
KA1503000044,5,9,true,19,34,15,41.89018,-87.6262
196,5,9,true,2,10,8,41.89053,-87.62205
13427,5,9,true,37,40,3,41.89054,-87.62205
26,5,9,true,12,3,-9,41.89057,-87.61798
13430,5,9,true,54,78,24,41.89077,-87.63169
181,5,9,true,7,26,19,41.89077,-87.63168
TA1306000013,5,9,true,57,30,-27,41.89083,-87.61852
RN-,5,9,true,38,48,10,41.89102,-87.63546
672,5,9,true,10,9,-1,41.89102,-87.63545
13434,5,9,true,15,12,-3,41.89108,-87.66663
TA1308000006,5,9,true,8,9,1,41.89128,-87.67686
199,5,9,true,9,20,11,41.89143,-87.62676
TA1307000117,5,9,true,37,95,58,41.89144,-87.62675
13033,5,9,true,53,50,-3,41.8916,-87.64835
214,5,9,true,2,2,0,41.89161,-87.67688
84,5,9,true,11,13,2,41.89161,-87.64833
186,5,9,true,9,12,3,41.8918,-87.65879
13194,5,9,true,48,41,-7,41.8918,-87.65878
TA1305000003,5,9,true,55,94,39,41.89187,-87.62061
24,5,9,true,14,13,-1,41.8919,-87.62063
643,5,9,true,15,8,-7,41.89203,-87.68939
35,5,9,true,6,3,-3,41.89227,-87.61206
13022,5,9,true,51,42,-9,41.89227,-87.61205
99,5,9,true,15,4,-11,41.89255,-87.61449
TA1306000029,5,9,true,51,38,-13,41.89256,-87.61449
13265,5,9,true,58,43,-15,41.89383,-87.64172
74,5,9,true,11,7,-4,41.89384,-87.64173
13045,5,9,true,90,101,11,41.89403,-87.62931
110,5,9,true,12,22,10,41.89406,-87.6293
13016,5,9,true,71,120,49,41.89431,-87.62277
211,5,9,true,15,44,29,41.89439,-87.62267
KA1503000041,5,9,true,95,131,36,41.89452,-87.61798
142,5,9,true,15,30,15,41.89453,-87.61806
92,5,9,true,5,5,0,41.89455,-87.65346
13196,5,9,true,37,15,-22,41.89455,-87.65345
TA1307000062,5,9,true,61,55,-6,41.89466,-87.63839
111,5,9,true,8,13,5,41.89466,-87.63837
TA1306000012,5,9,true,103,103,0,41.89475,-87.63438
53,5,9,true,27,20,-7,41.89476,-87.63439
627,5,9,true,11,10,-1,41.8948,-87.63231
KP1705001026,5,9,true,34,36,2,41.89483,-87.6323
16920,5,9,true,1,1,0,41.89495,-87.76491
373,5,9,true,1,2,1,41.89548,-87.70614
18058,5,9,true,19,6,-13,41.8955,-87.68201
659,5,9,true,8,1,-7,41.8955,-87.68201
637,5,9,true,23,12,-11,41.89563,-87.67209
128,5,9,true,3,4,1,41.89571,-87.67716
13132,5,9,true,24,18,-6,41.89573,-87.67718
161,5,9,true,8,26,18,41.89574,-87.62599
15530,5,9,true,45,88,43,41.89575,-87.62596
18003,5,9,true,34,53,19,41.89575,-87.62011
635,5,9,true,5,10,5,41.89576,-87.62012
13247,5,9,true,18,16,-2,41.89597,-87.66775
350,5,9,true,4,5,1,41.89597,-87.66774
TA1305000020,5,9,true,43,49,6,41.89636,-87.65406
54,5,9,true,6,10,4,41.89637,-87.65407
13289,5,9,true,22,9,-13,41.89638,-87.661
86,5,9,true,5,4,-1,41.89639,-87.661
337,5,9,true,10,11,1,41.89659,-87.63096
13303,5,9,true,26,31,5,41.89672,-87.63088
13017,5,9,true,61,72,11,41.89676,-87.6357
31,5,9,true,13,15,2,41.89677,-87.63572
13338,5,9,true,45,78,33,41.89697,-87.62173
173,5,9,true,15,14,-1,41.89704,-87.62173
TA1307000061,5,9,true,34,35,1,41.89745,-87.62873
106,5,9,true,4,6,2,41.89746,-87.62874
25,5,9,true,4,7,3,41.89751,-87.62354
13034,5,9,true,13,36,23,41.89754,-87.62352
48,5,9,true,11,26,15,41.89772,-87.64302
TA1306000009,5,9,true,55,133,78,41.89772,-87.64299
620,5,9,true,28,36,8,41.89817,-87.63754
KA1504000103,5,9,true,14,6,-8,41.89842,-87.68659
374,5,9,true,5,4,-1,41.89842,-87.68659
145,5,9,true,13,18,5,41.89856,-87.62211
15529,5,9,true,49,89,40,41.89858,-87.62206
140,5,9,true,13,25,12,41.89895,-87.6299
TA1307000128,5,9,true,54,54,0,41.89896,-87.6299
657,5,9,true,29,25,-4,41.89918,-87.6722
KA1504000117,5,9,true,2,4,2,41.89936,-87.64848
30,5,9,true,4,1,-3,41.89964,-87.66789
13248,5,9,true,20,20,0,41.89964,-87.66788
46,5,9,true,5,2,-3,41.89994,-87.63444
TA1306000011,5,9,true,30,19,-11,41.89994,-87.63443
KA1504000116,5,9,true,22,16,-6,41.90023,-87.64299
364,5,9,true,4,3,-1,41.90023,-87.64299
17660,5,9,true,17,5,-12,41.90036,-87.69671
622,5,9,true,3,2,-1,41.90037,-87.69671
13290,5,9,true,28,20,-8,41.90069,-87.66259
29,5,9,true,5,1,-4,41.90069,-87.66259
13042,5,9,true,40,119,79,41.90097,-87.62377
85,5,9,true,5,13,8,41.90098,-87.62375
183,5,9,true,3,3,0,41.90133,-87.67744
TA1307000070,5,9,true,24,3,-21,41.90133,-87.67742
KA1504000133,5,9,true,41,49,8,41.90234,-87.62773
172,5,9,true,6,17,11,41.90236,-87.62774
15654,5,9,true,5,2,-3,41.90271,-87.70923
305,5,9,true,3,3,0,41.9028,-87.69005
13241,5,9,true,11,5,-6,41.9029,-87.68731
176,5,9,true,25,23,-2,41.90291,-87.63141
TA1306000006,5,9,true,16,8,-8,41.90292,-87.63772
23,5,9,true,4,1,-3,41.90292,-87.63772
TA1307000039,5,9,true,91,67,-24,41.90294,-87.63137
658,5,9,true,15,24,9,41.903,-87.6838
216,5,9,true,8,1,-7,41.90302,-87.69749
13256,5,9,true,7,4,-3,41.90302,-87.69749
17,5,9,true,3,1,-2,41.90313,-87.67391
TA1305000034,5,9,true,17,19,2,41.90313,-87.67391
182,5,9,true,31,13,-18,41.90317,-87.63442
KA1504000135,5,9,true,115,86,-29,41.90319,-87.63439
13136,5,9,true,19,23,4,41.90326,-87.67845
130,5,9,true,4,3,-1,41.90327,-87.67846
210,5,9,true,18,14,-4,41.90342,-87.66781
13061,5,9,true,66,47,-19,41.90342,-87.66779
KA1504000079,5,9,true,31,24,-7,41.9035,-87.64334
359,5,9,true,4,6,2,41.90458,-87.6497
138,5,9,true,4,1,-3,41.9046,-87.64057
TA1307000115,5,9,true,15,14,-1,41.9046,-87.64056
291,5,9,true,10,12,2,41.90672,-87.63494
TA1308000049,5,9,true,54,47,-7,41.90672,-87.6349
KA1504000134,5,9,true,39,25,-14,41.90687,-87.6262
180,5,9,true,4,2,-2,41.90687,-87.62618
13224,5,9,true,22,17,-5,41.90706,-87.66725
333,5,9,true,7,2,-5,41.90706,-87.66725
18069,5,9,true,3,3,0,41.90722,-87.65563
TA1307000143,5,9,true,29,3,-26,41.90762,-87.63854
61,5,9,true,14,5,-9,41.90764,-87.67254
13221,5,9,true,35,25,-10,41.90765,-87.67254
159,5,9,true,1,3,2,41.90777,-87.68586
13245,5,9,true,7,11,4,41.90777,-87.68586
301,5,9,true,25,7,-18,41.90796,-87.63203
TA1309000024,5,9,true,86,44,-42,41.908,-87.63152
69,5,9,true,7,10,3,41.90939,-87.6777
TA1305000041,5,9,true,36,37,1,41.9094,-87.67769
508,5,9,true,2,4,2,41.90964,-87.71664
15652,5,9,true,4,4,0,41.90965,-87.71664
331,5,9,true,52,60,8,41.90965,-87.64812
15653,5,9,true,4,5,1,41.90979,-87.7053
TA1305000037,5,9,true,32,19,-13,41.91018,-87.67003
27,5,9,true,4,2,-2,41.91019,-87.6435
TA1306000008,5,9,true,37,10,-27,41.9102,-87.6435
16,5,9,true,12,4,-8,41.91035,-87.67008
213,5,9,true,2,1,-1,41.91037,-87.68237
TA1308000005,5,9,true,20,12,-8,41.91042,-87.68238
13258,5,9,true,11,6,-5,41.91043,-87.69718
276,5,9,true,1,2,1,41.91043,-87.69718
160,5,9,true,2,1,-1,41.91054,-87.68957
13257,5,9,true,15,8,-7,41.91054,-87.68956
13154,5,9,true,30,49,19,41.91054,-87.65312
20,5,9,true,8,8,0,41.91055,-87.65313
13058,5,9,true,33,32,-1,41.91059,-87.64942
60,5,9,true,5,4,-1,41.91059,-87.64942
TA1307000038,5,9,true,35,25,-10,41.91138,-87.63868
118,5,9,true,13,10,-3,41.91138,-87.63868
268,5,9,true,8,4,-4,41.91172,-87.62681
LF-005,5,9,true,43,42,-1,41.91172,-87.62681
126,5,9,true,6,2,-4,41.91196,-87.63197
13128,5,9,true,17,12,-5,41.91197,-87.63197
289,5,9,true,28,17,-11,41.91209,-87.63472
TA1308000050,5,9,true,97,113,16,41.91211,-87.6347
13243,5,9,true,32,23,-9,41.91262,-87.6814
158,5,9,true,8,3,-5,41.91262,-87.6814
315,5,9,true,2,3,1,41.91293,-87.66417
TA1309000032,5,9,true,4,9,5,41.91293,-87.66417
TA1306000032,5,9,true,36,26,-10,41.9137,-87.65285
93,5,9,true,3,7,4,41.91371,-87.65285
TA1307000166,5,9,true,35,23,-12,41.91386,-87.64877
224,5,9,true,4,4,0,41.91386,-87.64877
511,5,9,true,2,1,-1,41.914,-87.70515
15655,5,9,true,18,5,-13,41.91401,-87.70514
18017,5,9,true,4,4,0,41.91416,-87.71676
628,5,9,true,1,3,2,41.9146,-87.66796
18067,5,9,true,13,17,4,41.9146,-87.66796
TA1306000007,5,9,true,22,11,-11,41.91469,-87.64333
28,5,9,true,6,1,-5,41.91469,-87.64333
13068,5,9,true,20,38,18,41.91554,-87.68703
116,5,9,true,4,3,-1,41.91555,-87.68703
13179,5,9,true,33,35,2,41.9157,-87.63461
141,5,9,true,16,12,-4,41.91571,-87.63461
219,5,9,true,12,5,-7,41.91598,-87.67733
13133,5,9,true,19,15,-4,41.91598,-87.67733
58,5,9,true,5,3,-2,41.91602,-87.66894
TA1305000039,5,9,true,14,12,-2,41.9163,-87.66749
15650,5,9,true,7,4,-3,41.91711,-87.71023
506,5,9,true,3,1,-2,41.91711,-87.71023
15651,5,9,true,6,4,-2,41.91752,-87.70181
507,5,9,true,2,1,-1,41.91752,-87.70181
185,5,9,true,1,1,0,41.91774,-87.69143
13266,5,9,true,12,9,-3,41.91774,-87.69142
TA1309000029,5,9,true,17,5,-12,41.9178,-87.68245
309,5,9,true,6,2,-4,41.91789,-87.6865
TA1309000006,5,9,true,41,32,-9,41.91809,-87.64375
288,5,9,true,8,7,-1,41.91809,-87.64375
223,5,9,true,6,6,0,41.91821,-87.65698
TA1307000163,5,9,true,26,27,1,41.91821,-87.65696
94,5,9,true,18,12,-6,41.91831,-87.6363
13146,5,9,true,67,41,-26,41.91831,-87.63629
13059,5,9,true,44,49,5,41.91845,-87.65222
113,5,9,true,9,10,1,41.91846,-87.65222
13259,5,9,true,15,2,-13,41.91852,-87.69744
310,5,9,true,6,1,-5,41.91984,-87.68083
13192,5,9,true,52,28,-24,41.91995,-87.64884
225,5,9,true,6,3,-3,41.91995,-87.64884
13288,5,9,true,24,11,-13,41.92008,-87.67788
13242,5,9,true,9,10,1,41.92021,-87.69266
307,5,9,true,3,4,1,41.92077,-87.66373
TA1309000030,5,9,true,14,27,13,41.92077,-87.66372
290,5,9,true,6,2,-4,41.92152,-87.70734
13292,5,9,true,12,3,-9,41.92152,-87.70733
TA1309000033,5,9,true,31,32,1,41.92158,-87.65381
13193,5,9,true,46,35,-11,41.92182,-87.64412
144,5,9,true,10,12,2,41.92182,-87.64411
143,5,9,true,16,2,-14,41.92217,-87.63891
13191,5,9,true,45,37,-8,41.92217,-87.63891
327,5,9,true,3,6,3,41.92225,-87.65783
13084,5,9,true,18,19,1,41.92268,-87.69715
123,5,9,true,4,4,0,41.92268,-87.69714
LP-,5,9,true,32,12,-20,41.92396,-87.63584
673,5,9,true,9,3,-6,41.92398,-87.63585
KA1504000140,5,9,true,11,8,-3,41.92409,-87.67646
15648,5,9,true,6,4,-2,41.92464,-87.68931
KA1504000090,5,9,true,6,1,-5,41.92483,-87.7145
TA1307000001,5,9,true,38,12,-26,41.92535,-87.66581
188,5,9,true,10,7,-3,41.92536,-87.66581
TA1306000026,5,9,true,62,97,35,41.92558,-87.65842
87,5,9,true,13,12,-1,41.92559,-87.65843
TA1306000016,5,9,true,47,32,-15,41.9256,-87.65371
67,5,9,true,5,5,0,41.9256,-87.65371
313,5,9,true,9,8,-1,41.9257,-87.64246
TA1309000019,5,9,true,53,34,-19,41.92586,-87.63897
TA1309000058,5,9,true,44,49,5,41.92591,-87.64927
127,5,9,true,5,11,6,41.92592,-87.64927
TA1308000001,5,9,true,36,33,-3,41.92627,-87.63086
177,5,9,true,6,6,0,41.92627,-87.63086
15646,5,9,true,8,3,-5,41.92668,-87.6977
13124,5,9,true,3,11,8,41.92675,-87.63444
302,5,9,true,3,7,4,41.92859,-87.65421
TA1309000023,5,9,true,16,29,13,41.9287,-87.65383
TA1307000113,5,9,true,13,16,3,41.92878,-87.66391
190,5,9,true,4,2,-2,41.92878,-87.6639
166,5,9,true,1,2,1,41.92883,-87.66853
13296,5,9,true,10,7,-3,41.92883,-87.66852
TA1309000059,5,9,true,29,14,-15,41.92889,-87.65898
343,5,9,true,8,4,-4,41.92889,-87.65898
349,5,9,true,11,10,-1,41.92915,-87.6491
TA1309000061,5,9,true,46,31,-15,41.92915,-87.64909
TA1308000031,5,9,true,8,6,-2,41.92946,-87.68417
258,5,9,true,2,2,0,41.92946,-87.68417
TA1305000014,5,9,true,68,55,-13,41.92956,-87.64313
340,5,9,true,23,14,-9,41.92956,-87.64313
260,5,9,true,3,4,1,41.92958,-87.70791
13085,5,9,true,9,18,9,41.92958,-87.70789
15643,5,9,true,2,1,-1,41.93057,-87.7238
TA1307000142,5,9,true,44,37,-7,41.93125,-87.64432
220,5,9,true,9,9,0,41.93125,-87.64431
13276,5,9,true,61,26,-35,41.93132,-87.63874
324,5,9,true,28,11,-17,41.93173,-87.64179
163,5,9,true,3,3,0,41.93191,-87.67784
13271,5,9,true,5,10,5,41.93192,-87.67784
152,5,9,true,16,12,-4,41.93221,-87.65864
TA1307000064,5,9,true,40,49,9,41.93222,-87.65864
TA1306000014,5,9,true,46,38,-8,41.93242,-87.65271
13,5,9,true,12,17,5,41.93242,-87.65271
TA1309000039,5,9,true,55,27,-28,41.93258,-87.63642
329,5,9,true,6,5,-1,41.93258,-87.63642
13294,5,9,true,13,13,0,41.9326,-87.66595
319,5,9,true,1,1,0,41.93292,-87.67217
TA1309000036,5,9,true,32,19,-13,41.93313,-87.64776
332,5,9,true,6,5,-1,41.93313,-87.64776
15644,5,9,true,2,2,0,41.93534,-87.71687
TA1307000006,5,9,true,23,29,6,41.93571,-87.6636
153,5,9,true,3,7,4,41.93575,-87.66364
162,5,9,true,2,2,0,41.93588,-87.67844
13268,5,9,true,17,6,-11,41.93588,-87.67843
250,5,9,true,8,7,-1,41.93609,-87.66984
13269,5,9,true,11,21,10,41.93609,-87.66983
TA1307000052,5,9,true,35,38,3,41.93628,-87.65266
115,5,9,true,5,10,5,41.93628,-87.65266
156,5,9,true,6,8,2,41.9365,-87.64756
TA1307000136,5,9,true,40,38,-2,41.9365,-87.64755
TA1307000041,5,9,true,58,37,-21,41.93669,-87.63683
157,5,9,true,13,5,-8,41.9367,-87.63683
13137,5,9,true,63,60,-3,41.9376,-87.6441
300,5,9,true,16,19,3,41.93761,-87.6441
15642,5,9,true,8,4,-4,41.93843,-87.69801
154,5,9,true,4,2,-2,41.93912,-87.66384
664,5,9,true,2,1,-1,41.93934,-87.68327
KA17018068,5,9,true,16,8,-8,41.93935,-87.68327
TA1309000042,5,9,true,22,29,7,41.93937,-87.66836
131,5,9,true,12,8,-4,41.93937,-87.66835
15640,5,9,true,4,2,-2,41.93941,-87.72357
13229,5,9,true,23,13,-10,41.93946,-87.66376
226,5,9,true,6,11,5,41.93972,-87.65886
TA1308000019,5,9,true,41,34,-7,41.93973,-87.65886
13277,5,9,true,46,36,-10,41.9401,-87.64546
296,5,9,true,12,11,-1,41.9401,-87.64546
TA1307000134,5,9,true,47,48,1,41.94016,-87.65303
117,5,9,true,5,9,4,41.94016,-87.65302
228,5,9,true,1,1,0,41.94058,-87.67854
13143,5,9,true,4,3,-1,41.94059,-87.67853
334,5,9,true,8,6,-2,41.94076,-87.63919
TA1309000049,5,9,true,39,31,-8,41.94077,-87.63919
493,5,9,true,3,1,-2,41.94304,-87.68729
15634,5,9,true,4,4,0,41.94304,-87.68729
TA1307000138,5,9,true,25,42,17,41.94334,-87.67094
230,5,9,true,12,6,-6,41.94335,-87.67093
13144,5,9,true,9,6,-3,41.9434,-87.67964
299,5,9,true,8,6,-2,41.94368,-87.64894
TA1309000025,5,9,true,34,35,1,41.94368,-87.64894
229,5,9,true,10,9,-1,41.94372,-87.66401
13071,5,9,true,42,51,9,41.94373,-87.66401
632,5,9,true,43,48,5,41.94453,-87.6547
303,5,9,true,11,10,-1,41.94522,-87.64702
490,5,9,true,2,1,-1,41.94523,-87.70664
15631,5,9,true,2,1,-1,41.94524,-87.70665
13278,5,9,true,40,34,-6,41.94553,-87.64644
TA1309000050,5,9,true,6,10,4,41.94618,-87.67331
492,5,9,true,1,2,1,41.94662,-87.68337
15632,5,9,true,1,12,11,41.94664,-87.69463
KA1504000143,5,9,true,4,1,-3,41.94664,-87.68337
KA1504000142,5,9,true,1,3,2,41.94735,-87.71759
227,5,9,true,5,13,8,41.94813,-87.66397
13235,5,9,true,53,39,-14,41.94814,-87.66396
304,5,9,true,14,12,-2,41.94878,-87.64922
13253,5,9,true,17,13,-4,41.9488,-87.67527
257,5,9,true,2,2,0,41.9488,-87.67527
13325,5,9,true,62,57,-5,41.94907,-87.64863
114,5,9,true,11,2,-9,41.94935,-87.65451
TA1307000126,5,9,true,34,41,7,41.94936,-87.65451
232,5,9,true,8,5,-3,41.94943,-87.64645
TA1307000150,5,9,true,39,34,-5,41.94945,-87.64646
18016,5,9,true,3,4,1,41.94993,-87.71395
347,5,9,true,6,2,-4,41.95068,-87.6687
13319,5,9,true,21,15,-6,41.95069,-87.6687
TA1307000127,5,9,true,54,31,-23,41.9508,-87.65918
165,5,9,true,5,6,1,41.95081,-87.65918
15628,5,9,true,8,2,-6,41.95216,-87.69806
318,5,9,true,3,1,-2,41.95254,-87.6735
13323,5,9,true,41,28,-13,41.95282,-87.65
15624,5,9,true,1,4,3,41.95339,-87.73199
314,5,9,true,8,6,-2,41.9535,-87.69199
TA1309000043,5,9,true,26,13,-13,41.95417,-87.66434
240,5,9,true,5,7,2,41.95424,-87.65441
13063,5,9,true,41,54,13,41.95424,-87.65441
486,5,9,true,2,1,-1,41.95431,-87.68607
KA1504000158,5,9,true,4,3,-1,41.95432,-87.68607
254,5,9,true,8,6,-2,41.95438,-87.64806
TA1308000022,5,9,true,48,25,-23,41.95438,-87.64805
16991,5,9,true,1,2,1,41.95448,-87.7496
244,5,9,true,3,10,7,41.95466,-87.67391
TA1307000149,5,9,true,24,15,-9,41.95467,-87.67392
298,5,9,true,2,2,0,41.95601,-87.68021
TA1309000026,5,9,true,9,12,3,41.95601,-87.6802
312,5,9,true,5,7,2,41.95637,-87.6563
TA1308000047,5,9,true,10,6,-4,41.95709,-87.6642
292,5,9,true,1,2,1,41.95709,-87.6642
13379,5,9,true,21,39,18,41.95786,-87.6495
TA1309000018,5,9,true,23,31,8,41.95791,-87.67357
316,5,9,true,1,2,1,41.95841,-87.69401
306,5,9,true,8,3,-5,41.9585,-87.655
TA1309000027,5,9,true,31,9,-22,41.9585,-87.65499
592,5,9,true,4,2,-2,41.96065,-87.74538
13389,5,9,true,36,12,-24,41.961,-87.64958
245,5,9,true,8,8,0,41.96101,-87.64958
15621,5,9,true,2,3,1,41.96103,-87.70586
15622,5,9,true,8,3,-5,41.96108,-87.69544
KA1504000164,5,9,true,2,2,0,41.96109,-87.72897
KA1504000097,5,9,true,14,2,-12,41.96116,-87.71658
238,5,9,true,1,5,4,41.96141,-87.6762
TA1307000144,5,9,true,26,18,-8,41.96142,-87.6762
TA1309000021,5,9,true,4,7,3,41.9615,-87.6714
15623,5,9,true,19,8,-11,41.96154,-87.69117
234,5,9,true,1,2,1,41.96158,-87.6661
KA1503000022,5,9,true,17,15,-2,41.96158,-87.66609
231,5,9,true,9,3,-6,41.96163,-87.65464
TA1307000107,5,9,true,27,27,0,41.96164,-87.65464
TA1307000156,5,9,true,12,21,9,41.96301,-87.68479
TA1309000012,5,9,true,8,7,-1,41.96325,-87.67928
TA1308000012,5,9,true,22,19,-3,41.96398,-87.63818
249,5,9,true,1,2,1,41.96398,-87.63818
293,5,9,true,3,7,4,41.96521,-87.65822
13074,5,9,true,14,24,10,41.96521,-87.6582
639,5,9,true,15,10,-5,41.96584,-87.64538
KA1504000127,5,9,true,7,1,-6,41.96587,-87.70083
477,5,9,true,1,2,1,41.96587,-87.70083
KA1504000093,5,9,true,9,7,-2,41.96587,-87.69365
478,5,9,true,1,1,0,41.96587,-87.69364
TA1307000140,5,9,true,17,9,-8,41.96643,-87.68865
239,5,9,true,5,4,-1,41.9665,-87.68843
326,5,9,true,5,3,-2,41.96665,-87.67113
476,5,9,true,1,2,1,41.96668,-87.70807
KA1504000126,5,9,true,2,3,1,41.96668,-87.70807
TA1309000014,5,9,true,29,22,-7,41.96709,-87.66744
242,5,9,true,5,11,6,41.9671,-87.67904
TA1307000158,5,9,true,17,39,22,41.9671,-87.67904
251,5,9,true,5,6,1,41.96796,-87.65
TA1307000119,5,9,true,15,17,2,41.96796,-87.65
15615,5,9,true,3,10,7,41.96835,-87.71183
474,5,9,true,3,4,1,41.96835,-87.71182
323,5,9,true,4,1,-3,41.96869,-87.66034
253,5,9,true,1,1,0,41.96883,-87.65765
TA1308000021,5,9,true,5,8,3,41.96883,-87.65765
475,5,9,true,2,1,-1,41.96885,-87.69611
KA1504000080,5,9,true,8,5,-3,41.96887,-87.69609
TA1309000015,5,9,true,10,9,-1,41.96889,-87.68401
344,5,9,true,8,2,-6,41.9691,-87.67423
TA1309000066,5,9,true,18,22,4,41.9691,-87.67423
TA1309000041,5,9,true,11,10,-1,41.96951,-87.65471
KA1504000171,5,9,true,15,5,-10,41.97161,-87.65016
325,5,9,true,3,4,1,41.9728,-87.67186
TA1309000035,5,9,true,36,20,-16,41.97335,-87.66785
295,5,9,true,5,2,-3,41.97378,-87.65972
13108,5,9,true,23,26,3,41.97379,-87.65971
KA1504000078,5,9,true,10,3,-7,41.97491,-87.69258
464,5,9,true,2,1,-1,41.97562,-87.67945
KA1504000149,5,9,true,4,4,0,41.97562,-87.67945
KA1504000160,5,9,true,10,7,-3,41.97564,-87.70143
471,5,9,true,1,1,0,41.97564,-87.70143
470,5,9,true,1,1,0,41.97567,-87.70927
KA1504000128,5,9,true,1,9,8,41.97567,-87.70927
463,5,9,true,5,6,1,41.978,-87.66805
KA1504000146,5,9,true,22,31,9,41.978,-87.66805
13109,5,9,true,29,16,-13,41.97835,-87.65976
294,5,9,true,5,5,0,41.97835,-87.65976
KA1504000147,5,9,true,2,3,1,41.97976,-87.67754
655,5,9,true,2,6,4,41.97987,-87.68194
460,5,9,true,5,4,-1,41.98358,-87.66916
KA1504000151,5,9,true,22,26,4,41.98359,-87.66916
15585,5,9,true,5,2,-3,41.98367,-87.69642
KA1504000152,5,9,true,55,35,-20,41.98403,-87.65231
459,5,9,true,13,9,-4,41.98403,-87.65231
15578,5,9,true,32,18,-14,41.98405,-87.66027
461,5,9,true,1,3,2,41.98405,-87.66027
15575,5,9,true,19,6,-13,41.98975,-87.66014
458,5,9,true,2,3,1,41.98975,-87.66013
457,5,9,true,3,1,-2,41.99052,-87.66982
KA1504000148,5,9,true,7,6,-1,41.99086,-87.66971
KA1504000155,5,9,true,2,2,0,41.99118,-87.68359
KA1504000129,5,9,true,2,3,1,41.99417,-87.68945
15571,5,9,true,39,14,-25,41.99478,-87.66028
454,5,9,true,5,3,-2,41.99478,-87.66027
KA1504000156,5,9,true,10,7,-3,41.99925,-87.67137
453,5,9,true,2,3,1,41.99925,-87.67137
RP-009,5,9,true,5,15,10,42.00107,-87.66122
451,5,9,true,1,1,0,42.00108,-87.66123
RP-001,5,9,true,1,1,0,42.00179,-87.68883
RP-008,5,9,true,5,2,-3,42.00446,-87.6724
RP-002,5,9,true,6,4,-2,42.00456,-87.68065
660,5,9,true,17,10,-7,42.00458,-87.66143
354,5,9,true,8,2,-6,42.00587,-87.66802
KA1504000175,5,9,true,22,19,-3,42.00797,-87.66549
RP-005,5,9,true,3,2,-1,42.0086,-87.69047
KA1504000162,5,9,true,8,5,-3,42.00907,-87.67422
KA1504000159,5,9,true,12,2,-10,42.01059,-87.66241
RP-007,5,9,true,1,1,0,42.01256,-87.67431
525,5,9,true,8,1,-7,42.01272,-87.66605
517,5,9,true,4,3,-1,42.01597,-87.675
520,5,9,true,11,10,-1,42.01597,-87.66859
527,5,9,true,2,3,1,42.01892,-87.69004
515,5,9,true,6,18,12,42.01915,-87.67356
523,5,9,true,23,3,-20,42.02089,-87.66505
662,5,9,true,1,1,0,42.02354,-87.69961
597,5,9,true,8,4,-4,42.03256,-87.67914
E002,5,9,true,17,7,-10,42.03256,-87.67912
E011,5,9,true,1,2,1,42.03473,-87.69912
599,5,9,true,2,1,-1,42.03972,-87.69942
625,5,9,true,3,2,-1,42.04163,-87.6808
596,5,9,true,24,19,-5,42.04822,-87.68348
E008,5,9,true,6,5,-1,42.05049,-87.67782
603,5,9,true,1,1,0,42.05049,-87.67782
661,5,9,true,3,3,0,42.05704,-87.68657
604,5,9,true,3,43,40,42.05824,-87.67744
E007,5,9,true,1,2,1,42.06431,-87.68615
E014,5,9,true,5,1,-4,42.06483,-87.71531
20211,5,17,false,1,1,0,41.65807,-87.61076
20213,5,17,false,1,1,0,41.65915,-87.55078
722,5,17,false,1,1,0,41.65915,-87.55078
20208,5,17,false,4,4,0,41.66871,-87.63717
719,5,17,false,2,1,-1,41.68102,-87.53794
717,5,17,false,4,4,0,41.68588,-87.57376
20243,5,17,false,1,1,0,41.68701,-87.62111
20203,5,17,false,2,1,-1,41.69131,-87.71286
20131,5,17,false,2,3,1,41.69169,-87.61
20108,5,17,false,3,10,7,41.69921,-87.66888
699,5,17,false,1,1,0,41.70022,-87.61233
20123,5,17,false,3,3,0,41.70461,-87.68115
20125,5,17,false,1,1,0,41.70517,-87.64242
20112,5,17,false,1,2,1,41.70717,-87.61842
20227,5,17,false,4,3,-1,41.7179,-87.56461
703,5,17,false,2,2,0,41.71871,-87.59699
20106,5,17,false,1,1,0,41.71897,-87.60833
20105,5,17,false,1,1,0,41.71972,-87.6429
20104,5,17,false,2,1,-1,41.72171,-87.62283
20237,5,17,false,6,1,-5,41.72616,-87.56634
20119,5,17,false,7,2,-5,41.72682,-87.6543
20118,5,17,false,4,3,-1,41.72762,-87.63487
20103,5,17,false,4,5,1,41.7281,-87.66757
20242,5,17,false,4,3,-1,41.7282,-87.54962
20110,5,17,false,7,6,-1,41.72933,-87.61076
20236,5,17,false,1,1,0,41.7314,-87.58577
20239,5,17,false,1,1,0,41.73367,-87.5584
20116,5,17,false,2,2,0,41.73652,-87.60126
20230,5,17,false,1,1,0,41.73716,-87.57272
20229,5,17,false,1,1,0,41.73734,-87.54849
687,5,17,false,1,1,0,41.7415,-87.65841
20121,5,17,false,1,1,0,41.74152,-87.65842
585,5,17,false,2,2,0,41.74344,-87.60485
583,5,17,false,1,1,0,41.74656,-87.58599
573,5,17,false,1,1,0,41.75079,-87.62444
576,5,17,false,1,2,1,41.75129,-87.59752
579,5,17,false,4,3,-1,41.75182,-87.56522
20233,5,17,false,1,1,0,41.75251,-87.64378
570,5,17,false,2,4,2,41.75849,-87.60642
KA1503000019,5,17,false,2,1,-1,41.75867,-87.5869
KA1503000024,5,17,false,3,1,-2,41.75876,-87.56644
KA1503000020,5,17,false,10,9,-1,41.76223,-87.55923
KA1503000002,5,17,false,6,16,10,41.76641,-87.5657
KA1503000018,5,17,false,3,2,-1,41.76663,-87.57645
KA1503000023,5,17,false,4,4,0,41.77346,-87.58534
KA1503000030,5,17,false,4,3,-1,41.77352,-87.57722
KA1503000029,5,17,false,7,2,-5,41.77364,-87.56747
KA1503000031,5,17,false,1,2,1,41.77373,-87.60564
18025,5,17,false,1,1,0,41.77989,-87.6509
KA1503000025,5,17,false,4,2,-2,41.78008,-87.62977
KA1503000053,5,17,false,1,5,4,41.78009,-87.61595
KA1503000046,5,17,false,2,2,0,41.78041,-87.59141
KA1503000054,5,17,false,4,4,0,41.78061,-87.60582
15491,5,17,false,9,20,11,41.78096,-87.57624
101,5,17,false,4,5,1,41.78105,-87.57611
KA1503000033,5,17,false,5,8,3,41.78411,-87.61329
KA1503000014,5,17,false,43,39,-4,41.7851,-87.60108
426,5,17,false,7,17,10,41.7851,-87.60108
593,5,17,false,1,1,0,41.78756,-87.64488
KA1503000070,5,17,false,9,6,-3,41.78794,-87.58831
328,5,17,false,2,1,-1,41.78872,-87.6013
TA1309000011,5,17,false,17,8,-9,41.78873,-87.60131
423,5,17,false,11,5,-6,41.79148,-87.59988
KA1503000071,5,17,false,32,27,-5,41.79148,-87.59988
KA1503000074,5,17,false,46,14,-32,41.79174,-87.58395
424,5,17,false,3,6,3,41.79174,-87.58395
TA1309000063,5,17,false,22,25,3,41.79325,-87.5878
345,5,17,false,2,6,4,41.79326,-87.5878
KA1503000073,5,17,false,5,5,0,41.79345,-87.61585
420,5,17,false,8,4,-4,41.79429,-87.60145
KA1504000076,5,17,false,34,23,-11,41.7943,-87.60145
204,5,17,false,2,1,-1,41.79485,-87.61874
TA1307000160,5,17,false,8,4,-4,41.79485,-87.61873
247,5,17,false,16,19,3,41.79522,-87.58077
TA1308000009,5,17,false,72,85,13,41.79522,-87.58075
TA1307000164,5,17,false,24,20,-4,41.79527,-87.59647
248,5,17,false,3,5,2,41.79528,-87.59647
646,5,17,false,2,1,-1,41.79663,-87.62592
KA1503000052,5,17,false,22,9,-13,41.79935,-87.60097
418,5,17,false,3,4,1,41.79936,-87.60097
419,5,17,false,8,3,-5,41.79952,-87.58643
KA1503000059,5,17,false,46,45,-1,41.79952,-87.58643
TA1309000037,5,17,false,48,55,7,41.79957,-87.59474
556,5,17,false,1,1,0,41.79966,-87.65719
KA1503000010,5,17,false,2,2,0,41.8018,-87.64522
15470,5,17,false,4,6,2,41.80228,-87.61807
417,5,17,false,3,5,2,41.80242,-87.5869
KA1503000007,5,17,false,28,30,2,41.80242,-87.58689
13398,5,17,false,26,10,-16,41.80256,-87.59035
121,5,17,false,6,8,2,41.80256,-87.59035
555,5,17,false,2,1,-1,41.80302,-87.6647
TA1309000067,5,17,false,6,9,3,41.80303,-87.60661
322,5,17,false,11,11,0,41.80321,-87.59849
KA1503000069,5,17,false,6,3,-3,41.80579,-87.59247
KA1503000051,5,17,false,2,3,1,41.80815,-87.64563
16937,5,17,false,3,3,0,41.80887,-87.66453
KA1503000009,5,17,false,4,2,-2,41.80932,-87.63346
TA1308000035,5,17,false,12,8,-4,41.80944,-87.59188
267,5,17,false,2,2,0,41.80944,-87.59188
TA1308000002,5,17,false,11,9,-2,41.80983,-87.59937
TA1308000007,5,17,false,4,4,0,41.80984,-87.61628
200,5,17,false,2,2,0,41.80985,-87.61628
TA1309000053,5,17,false,9,6,-3,41.80985,-87.60675
413,5,17,false,1,1,0,41.81408,-87.59701
KA1503000065,5,17,false,3,4,1,41.81409,-87.59701
TA1308000023,5,17,false,6,2,-4,41.81649,-87.60659
410,5,17,false,4,2,-2,41.81666,-87.61942
KA1503000027,5,17,false,6,11,5,41.81666,-87.61942
KA1503000032,5,17,false,2,5,3,41.81912,-87.64328
13083,5,17,false,4,2,-2,41.82167,-87.62153
TA1308000038,5,17,false,13,8,-5,41.82298,-87.6071
15449,5,17,false,1,1,0,41.82302,-87.62657
179,5,17,false,1,1,0,41.82458,-87.61678
13420,5,17,false,2,5,3,41.82459,-87.61678
18022,5,17,false,1,2,1,41.82672,-87.68315
262,5,17,false,3,3,0,41.82707,-87.64573
TA1307000161,5,17,false,3,1,-2,41.82707,-87.64572
KA1503000068,5,17,false,6,1,-5,41.82878,-87.68062
KA1503000066,5,17,false,2,4,2,41.83011,-87.67031
TA1308000045,5,17,false,8,4,-4,41.83062,-87.64129
TA1308000043,5,17,false,6,18,12,41.83066,-87.64715
15446,5,17,false,7,5,-2,41.83068,-87.65603
KA1503000005,5,17,false,9,6,-3,41.83079,-87.6325
184,5,17,false,1,1,0,41.83104,-87.62684
TA1307000129,5,17,false,11,17,6,41.83104,-87.62683
KA1503000004,5,17,false,24,18,-6,41.83127,-87.6088
406,5,17,false,9,6,-3,41.83127,-87.6088
13345,5,17,false,5,8,3,41.83138,-87.61803
15445,5,17,false,8,16,8,41.83453,-87.63183
13216,5,17,false,12,6,-6,41.83473,-87.62581
148,5,17,false,3,4,1,41.83474,-87.62581
149,5,17,false,1,2,1,41.83486,-87.61791
13217,5,17,false,18,5,-13,41.83488,-87.61792
13215,5,17,false,12,10,-2,41.83634,-87.6135
263,5,17,false,2,2,0,41.8364,-87.61348
280,5,17,false,1,2,1,41.83779,-87.65116
TA1308000046,5,17,false,8,10,2,41.83779,-87.65115
339,5,17,false,1,9,8,41.83817,-87.64523
TA1309000055,5,17,false,9,12,3,41.8382,-87.64514
KA1503000038,5,17,false,5,7,2,41.83845,-87.6354
TA1307000048,5,17,false,65,53,-12,41.83855,-87.60821
150,5,17,false,6,11,5,41.83855,-87.60821
272,5,17,false,2,1,-1,41.83882,-87.62186
TA1308000036,5,17,false,12,12,0,41.83883,-87.62186
368,5,17,false,1,3,2,41.83915,-87.66562
15442,5,17,false,3,4,1,41.83918,-87.66562
KA1503000040,5,17,false,6,12,6,41.84164,-87.65744
193,5,17,false,3,1,-2,41.84171,-87.62695
TA1307000139,5,17,false,15,14,-1,41.84205,-87.61698
15443,5,17,false,9,11,2,41.84275,-87.63549
401,5,17,false,2,1,-1,41.84276,-87.63549
207,5,17,false,1,3,2,41.84358,-87.64539
TA1307000153,5,17,false,5,16,11,41.84358,-87.64538
KA1504000110,5,17,false,2,6,4,41.84454,-87.71596
443,5,17,false,2,2,0,41.84456,-87.71603
TA1307000005,5,17,false,1,16,15,41.84569,-87.6225
TA1308000013,5,17,false,12,4,-8,41.84719,-87.64681
348,5,17,false,2,2,0,41.8477,-87.69448
15687,5,17,false,3,3,0,41.8481,-87.71508
440,5,17,false,1,1,0,41.8481,-87.71507
TA1309000003,5,17,false,4,4,0,41.84847,-87.68512
15689,5,17,false,2,5,3,41.84912,-87.69515
TA1307000066,5,17,false,4,4,0,41.8492,-87.67564
TA1308000014,5,17,false,4,8,4,41.84953,-87.64059
209,5,17,false,1,4,3,41.84953,-87.64058
132,5,17,false,1,1,0,41.85008,-87.63215
TA1308000026,5,17,false,4,4,0,41.85008,-87.63214
TA1305000004,5,17,false,22,30,8,41.8514,-87.61884
TA1305000001,5,17,false,14,19,5,41.85262,-87.6265
13075,5,17,false,49,45,-4,41.8531,-87.63192
120,5,17,false,3,11,8,41.8531,-87.63191
15686,5,17,false,1,3,2,41.85354,-87.70507
13162,5,17,false,17,13,-4,41.85378,-87.64659
13096,5,17,false,6,12,6,41.8538,-87.69577
15685,5,17,false,3,1,-2,41.85399,-87.71511
203,5,17,false,4,2,-2,41.85409,-87.68585
13091,5,17,false,4,16,12,41.85409,-87.68585
15546,5,17,false,16,11,-5,41.85416,-87.61916
13307,5,17,false,11,9,-2,41.85489,-87.66359
124,5,17,false,1,3,2,41.85492,-87.67609
13089,5,17,false,8,13,5,41.85497,-87.67567
13331,5,17,false,3,15,12,41.85515,-87.65414
4,5,17,false,7,4,-3,41.85627,-87.61334
15545,5,17,false,59,73,14,41.85627,-87.61334
178,5,17,false,1,2,1,41.85657,-87.62755
SL-013,5,17,false,28,13,-15,41.85659,-87.62755
SL-006,5,17,false,17,22,5,41.8568,-87.63387
129,5,17,false,2,3,1,41.85752,-87.66158
202,5,17,false,1,3,2,41.85752,-87.64621
13135,5,17,false,24,25,1,41.85753,-87.66157
338,5,17,false,11,5,-6,41.85758,-87.61956
13102,5,17,false,35,32,-3,41.85762,-87.61942
13150,5,17,false,42,31,-11,41.85783,-87.62455
273,5,17,false,7,13,6,41.85783,-87.62455
13099,5,17,false,14,16,2,41.85784,-87.64627
205,5,17,false,2,4,2,41.8579,-87.6687
TA1307000159,5,17,false,14,16,2,41.8579,-87.6687
170,5,17,false,2,1,-1,41.85793,-87.64083
TA1307000044,5,17,false,13,18,5,41.85794,-87.64083
14,5,17,false,1,5,4,41.85808,-87.65109
13163,5,17,false,32,19,-13,41.85808,-87.65108
13164,5,17,false,14,40,26,41.85818,-87.65648
15,5,17,false,6,6,0,41.85819,-87.65648
SL-012,5,17,false,35,27,-8,41.86038,-87.62581
72,5,17,false,8,7,-1,41.86039,-87.62581
13304,5,17,false,10,7,-3,41.86126,-87.65659
437,5,17,false,1,2,1,41.86192,-87.69348
KA1504000109,5,17,false,2,2,0,41.86192,-87.69347
137,5,17,false,3,8,5,41.86238,-87.65108
TA1306000002,5,17,false,5,11,6,41.86238,-87.65108
TA1307000124,5,17,false,85,51,-34,41.86411,-87.62372
168,5,17,false,13,16,3,41.86415,-87.62372
282,5,17,false,6,4,-2,41.86487,-87.64708
TA1309000001,5,17,false,36,31,-5,41.86488,-87.64708
13165,5,17,false,8,5,-3,41.86505,-87.65697
13354,5,17,false,3,7,4,41.86524,-87.66651
13029,5,17,false,69,29,-40,41.86531,-87.6179
97,5,17,false,11,10,-1,41.86531,-87.6179
341,5,17,false,18,7,-11,41.86608,-87.60733
13431,5,17,false,118,114,-4,41.8661,-87.60728
15682,5,17,false,1,4,3,41.86651,-87.70649
KA1504000101,5,17,false,7,10,3,41.86651,-87.68466
434,5,17,false,1,2,1,41.86651,-87.68465
WL-008,5,17,false,38,38,0,41.86712,-87.64108
57,5,17,false,9,8,-1,41.86712,-87.64107
TA1305000002,5,17,false,107,97,-10,41.86721,-87.62597
59,5,17,false,23,27,4,41.86721,-87.62597
15544,5,17,false,129,109,-20,41.86723,-87.61536
3,5,17,false,16,6,-10,41.86723,-87.61536
TA1305000017,5,17,false,8,10,2,41.86734,-87.64863
55,5,17,false,9,1,-8,41.86735,-87.64863
626,5,17,false,5,7,2,41.86749,-87.63219
KA1706005007,5,17,false,28,31,3,41.86749,-87.63219
SL-005,5,17,false,244,191,-53,41.8679,-87.62304
255,5,17,false,28,22,-6,41.86791,-87.62304
644,5,17,false,13,15,2,41.86859,-87.68625
19,5,17,false,3,1,-2,41.86892,-87.65913
13139,5,17,false,19,24,5,41.86893,-87.65913
13285,5,17,false,24,1,-23,41.86928,-87.67372
22,5,17,false,3,8,5,41.86947,-87.65548
13160,5,17,false,19,26,7,41.86947,-87.65548
382,5,17,false,1,2,1,41.8699,-87.68725
414,5,17,false,5,3,-2,41.87023,-87.63947
15550,5,17,false,24,30,6,41.87024,-87.63947
TA1309000010,5,17,false,80,53,-27,41.87074,-87.62574
SL-009,5,17,false,35,36,1,41.87081,-87.63121
TA1309000064,5,17,false,17,9,-8,41.87127,-87.67369
15542,5,17,false,6,4,-2,41.87146,-87.64095
TA1307000130,5,17,false,16,18,2,41.87178,-87.65103
241,5,17,false,2,3,1,41.8718,-87.65102
TA1307000121,5,17,false,30,21,-9,41.87184,-87.64664
41,5,17,false,16,19,3,41.87209,-87.62957
SL-008,5,17,false,140,116,-24,41.87209,-87.62956
13332,5,17,false,26,16,-10,41.87219,-87.6615
394,5,17,false,7,5,-2,41.87226,-87.63484
175,5,17,false,13,12,-1,41.87255,-87.63359
SL-011,5,17,false,84,74,-10,41.87256,-87.63356
623,5,17,false,152,134,-18,41.87272,-87.62399
KA1504000104,5,17,false,14,9,-5,41.87296,-87.66912
383,5,17,false,9,2,-7,41.87297,-87.66912
320,5,17,false,7,12,5,41.87327,-87.66402
5,5,17,false,7,5,-2,41.87403,-87.6277
SL-007,5,17,false,63,46,-17,41.87404,-87.6277
169,5,17,false,2,1,-1,41.87424,-87.63959
13326,5,17,false,11,6,-5,41.87425,-87.63958
321,5,17,false,13,10,-3,41.87427,-87.63257
TA1306000025,5,17,false,16,14,-2,41.87464,-87.65703
15668,5,17,false,8,8,0,41.87471,-87.68642
13028,5,17,false,29,11,-18,41.87475,-87.64981
109,5,17,false,3,6,3,41.87475,-87.64981
13081,5,17,false,10,5,-5,41.87501,-87.67326
122,5,17,false,2,2,0,41.87501,-87.67325
89,5,17,false,3,3,0,41.87501,-87.6331
SL-010,5,17,false,24,23,-1,41.87501,-87.63309
16907,5,17,false,3,3,0,41.87568,-87.71549
15541,5,17,false,116,88,-28,41.8758,-87.62086
543,5,17,false,2,1,-1,41.87581,-87.75531
13037,5,17,false,13,11,-2,41.87588,-87.64078
50,5,17,false,3,3,0,41.87592,-87.6307
TA1305000009,5,17,false,16,20,4,41.87593,-87.63068
45,5,17,false,14,1,-13,41.87623,-87.62444
TA1305000010,5,17,false,50,48,-2,41.87623,-87.62444
624,5,17,false,30,28,-2,41.87626,-87.62923
2,5,17,false,18,14,-4,41.87649,-87.62051
33,5,17,false,8,1,-7,41.87715,-87.62786
TA1305000035,5,17,false,13,25,12,41.87716,-87.62787
13138,5,17,false,22,26,4,41.87723,-87.63941
75,5,17,false,2,2,0,41.87724,-87.63937
631,5,17,false,5,5,0,41.87761,-87.6739
15539,5,17,false,36,38,2,41.87763,-87.64405
13158,5,17,false,65,54,-11,41.87764,-87.64957
134,5,17,false,9,4,-5,41.87764,-87.64954
13157,5,17,false,47,33,-14,41.87773,-87.6548
21,5,17,false,2,16,14,41.87773,-87.6548
TA1305000025,5,17,false,61,56,-5,41.87773,-87.63528
36,5,17,false,9,5,-4,41.87776,-87.63525
284,5,17,false,18,9,-9,41.87784,-87.62408
TA1309000002,5,17,false,72,68,-4,41.87784,-87.62408
545,5,17,false,1,2,1,41.87792,-87.73583
13206,5,17,false,15,15,0,41.87794,-87.66201
146,5,17,false,1,2,1,41.87794,-87.66201
283,5,17,false,17,1,-16,41.87809,-87.63183
TA1309000004,5,17,false,47,25,-22,41.87811,-87.63184
107,5,17,false,16,7,-9,41.87822,-87.644
638,5,17,false,45,56,11,41.87827,-87.64078
37,5,17,false,5,5,0,41.87921,-87.62975
TA1305000005,5,17,false,22,38,16,41.87924,-87.62975
286,5,17,false,9,1,-8,41.8793,-87.6355
13011,5,17,false,83,45,-38,41.87931,-87.63993
TA1309000008,5,17,false,27,29,2,41.87933,-87.6355
192,5,17,false,8,7,-1,41.87935,-87.63997
KA1503000034,5,17,false,20,27,7,41.87938,-87.63197
39,5,17,false,8,7,-1,41.87948,-87.62571
KA1503000015,5,17,false,45,69,24,41.87948,-87.6257
15667,5,17,false,7,3,-4,41.8798,-87.68609
381,5,17,false,1,1,0,41.87981,-87.68607
16916,5,17,false,3,1,-2,41.88012,-87.76323
TA1309000007,5,17,false,75,22,-53,41.88022,-87.63526
16918,5,17,false,3,1,-2,41.88028,-87.77447
WL-011,5,17,false,34,36,2,41.88034,-87.64273
73,5,17,false,10,15,5,41.8804,-87.64273
13156,5,17,false,83,58,-25,41.88042,-87.65554
537,5,17,false,2,2,0,41.8807,-87.74102
13300,5,17,false,382,389,7,41.88097,-87.61675
76,5,17,false,36,52,16,41.88098,-87.61675
13008,5,17,false,396,391,-5,41.88105,-87.62408
90,5,17,false,46,32,-14,41.88107,-87.62409
49,5,17,false,11,13,2,41.88116,-87.62963
TA1305000006,5,17,false,50,50,0,41.88122,-87.6296
13134,5,17,false,21,16,-5,41.88138,-87.67493
13056,5,17,false,33,18,-15,41.88168,-87.63951
191,5,17,false,2,5,3,41.88169,-87.63951
198,5,17,false,12,17,5,41.88187,-87.6488
TA1307000120,5,17,false,152,152,0,41.88188,-87.64879
13341,5,17,false,65,56,-9,41.88208,-87.63985
174,5,17,false,7,2,-5,41.88208,-87.63984
197,5,17,false,6,3,-3,41.88208,-87.62513
13036,5,17,false,49,62,13,41.8821,-87.62513
77,5,17,false,5,13,8,41.88214,-87.64108
TA1305000032,5,17,false,104,67,-37,41.88218,-87.64109
98,5,17,false,5,4,-1,41.88266,-87.63251
13006,5,17,false,32,39,7,41.88268,-87.63252
13353,5,17,false,39,49,10,41.88283,-87.6612
346,5,17,false,3,5,2,41.88284,-87.6612
654,5,17,false,21,25,4,41.88307,-87.65698
233,5,17,false,7,14,7,41.88309,-87.6511
13409,5,17,false,40,67,27,41.8831,-87.6511
KA1503000072,5,17,false,24,22,-2,41.88317,-87.63693
91,5,17,false,10,5,-5,41.88336,-87.64122
WL-012,5,17,false,86,87,1,41.88337,-87.6412
112,5,17,false,11,18,7,41.88362,-87.6486
13053,5,17,false,136,165,29,41.88365,-87.64863
43,5,17,false,18,13,-5,41.88396,-87.62455
13001,5,17,false,126,118,-8,41.88397,-87.62459
88,5,17,false,1,3,2,41.88407,-87.65691
13155,5,17,false,29,32,3,41.88407,-87.65689
621,5,17,false,2,5,3,41.88412,-87.65427
18062,5,17,false,49,64,15,41.88412,-87.65427
81,5,17,false,31,17,-14,41.88417,-87.6296
TA1306000010,5,17,false,89,76,-13,41.88419,-87.62961
15666,5,17,false,7,2,-5,41.88446,-87.6963
KA1504000106,5,17,false,2,3,1,41.88459,-87.70631
TA1305000030,5,17,false,51,42,-9,41.88459,-87.63178
96,5,17,false,7,9,2,41.8846,-87.64455
15535,5,17,false,63,70,7,41.8846,-87.64455
51,5,17,false,13,6,-7,41.88462,-87.63176
TA1305000029,5,17,false,99,118,19,41.88466,-87.62787
195,5,17,false,38,10,-28,41.88466,-87.61952
13263,5,17,false,114,78,-36,41.88467,-87.61952
44,5,17,false,9,10,1,41.88468,-87.62782
TA1306000015,5,17,false,100,143,43,41.88549,-87.65232
518,5,17,false,2,2,0,41.8855,-87.71686
71,5,17,false,14,15,1,41.8855,-87.65233
66,5,17,false,10,11,1,41.88557,-87.64186
13021,5,17,false,62,58,-4,41.88559,-87.64184
TA1307000111,5,17,false,36,34,-2,41.88582,-87.63548
164,5,17,false,19,6,-13,41.88583,-87.63547
13073,5,17,false,27,39,12,41.88592,-87.66717
119,5,17,false,3,4,1,41.88593,-87.66717
656,5,17,false,2,4,2,41.88595,-87.67701
KA17018054,5,17,false,6,15,9,41.88595,-87.67701
38,5,17,false,12,7,-5,41.88599,-87.63089
KA1503000012,5,17,false,97,135,38,41.88599,-87.63089
52,5,17,false,24,26,2,41.886,-87.62421
TA1305000011,5,17,false,124,164,40,41.886,-87.62418
7,5,17,false,11,5,-6,41.88627,-87.61751
15534,5,17,false,77,72,-5,41.88627,-87.61749
217,5,17,false,2,3,1,41.8866,-87.65821
13197,5,17,false,24,41,17,41.8866,-87.65816
264,5,17,false,4,11,7,41.8867,-87.62224
TA1308000029,5,17,false,43,52,9,41.88673,-87.62225
194,5,17,false,16,17,1,41.88688,-87.62606
TA1307000131,5,17,false,84,137,53,41.88688,-87.62606
KA1503000064,5,17,false,203,189,-14,41.88697,-87.61281
6,5,17,false,14,28,14,41.88697,-87.61281
16905,5,17,false,2,5,3,41.88767,-87.76547
530,5,17,false,2,1,-1,41.88783,-87.75558
16906,5,17,false,7,4,-3,41.88792,-87.77445
100,5,17,false,9,14,5,41.88814,-87.63657
TA1305000022,5,17,false,52,38,-14,41.88817,-87.63656
56,5,17,false,23,17,-6,41.88866,-87.64442
TA1306000003,5,17,false,98,127,29,41.88867,-87.64442
KA1503000043,5,17,false,123,104,-19,41.88918,-87.63851
133,5,17,false,21,11,-10,41.88918,-87.63851
13050,5,17,false,98,152,54,41.88919,-87.62775
47,5,17,false,25,22,-3,41.88921,-87.62775
15664,5,17,false,6,12,6,41.8895,-87.68821
285,5,17,false,1,2,1,41.88989,-87.67149
13432,5,17,false,25,36,11,41.88989,-87.67149
TA1307000151,5,17,false,113,101,-12,41.88993,-87.63427
212,5,17,false,13,24,11,41.88995,-87.63427
636,5,17,false,39,43,4,41.88997,-87.63662
125,5,17,false,3,3,0,41.89018,-87.62621
KA1503000044,5,17,false,54,52,-2,41.89018,-87.6262
KA1504000113,5,17,false,1,1,0,41.89049,-87.70262
196,5,17,false,12,13,1,41.89053,-87.62205
13427,5,17,false,103,87,-16,41.89054,-87.62205
26,5,17,false,26,11,-15,41.89057,-87.61798
13430,5,17,false,154,177,23,41.89077,-87.63169
181,5,17,false,20,19,-1,41.89077,-87.63168
TA1306000013,5,17,false,176,150,-26,41.89083,-87.61852
RN-,5,17,false,111,111,0,41.89102,-87.63546
672,5,17,false,20,9,-11,41.89102,-87.63545
277,5,17,false,8,5,-3,41.89108,-87.66665
13434,5,17,false,44,58,14,41.89108,-87.66663
TA1308000006,5,17,false,45,41,-4,41.89128,-87.67686
199,5,17,false,19,24,5,41.89143,-87.62676
TA1307000117,5,17,false,183,209,26,41.89144,-87.62675
13033,5,17,false,99,131,32,41.8916,-87.64835
214,5,17,false,6,1,-5,41.89161,-87.67688
84,5,17,false,7,5,-2,41.89161,-87.64833
186,5,17,false,7,6,-1,41.8918,-87.65879
13194,5,17,false,39,54,15,41.8918,-87.65878
TA1305000003,5,17,false,128,153,25,41.89187,-87.62061
24,5,17,false,20,24,4,41.8919,-87.62063
643,5,17,false,8,8,0,41.89203,-87.68939
35,5,17,false,29,40,11,41.89227,-87.61206
13022,5,17,false,786,844,58,41.89227,-87.61205
99,5,17,false,11,14,3,41.89255,-87.61449
TA1306000029,5,17,false,140,124,-16,41.89256,-87.61449
13265,5,17,false,101,70,-31,41.89383,-87.64172
74,5,17,false,6,18,12,41.89384,-87.64173
13045,5,17,false,160,129,-31,41.89403,-87.62931
110,5,17,false,15,18,3,41.89406,-87.6293
13016,5,17,false,86,72,-14,41.89431,-87.62277
211,5,17,false,12,7,-5,41.89439,-87.62267
KA1503000041,5,17,false,66,60,-6,41.89452,-87.61798
142,5,17,false,12,11,-1,41.89453,-87.61806
92,5,17,false,9,6,-3,41.89455,-87.65346
13196,5,17,false,70,46,-24,41.89455,-87.65345
TA1307000062,5,17,false,50,37,-13,41.89466,-87.63839
111,5,17,false,5,5,0,41.89466,-87.63837
TA1306000012,5,17,false,171,141,-30,41.89475,-87.63438
53,5,17,false,21,17,-4,41.89476,-87.63439
627,5,17,false,5,10,5,41.8948,-87.63231
KP1705001026,5,17,false,83,105,22,41.89483,-87.6323
16921,5,17,false,4,5,1,41.89488,-87.77459
KA1504000114,5,17,false,8,8,0,41.89547,-87.70614
18058,5,17,false,26,25,-1,41.8955,-87.68201
659,5,17,false,2,4,2,41.8955,-87.68201
637,5,17,false,59,59,0,41.89563,-87.67209
128,5,17,false,6,5,-1,41.89571,-87.67716
13132,5,17,false,66,66,0,41.89573,-87.67718
161,5,17,false,22,16,-6,41.89574,-87.62599
15530,5,17,false,110,120,10,41.89575,-87.62596
18003,5,17,false,23,36,13,41.89575,-87.62011
635,5,17,false,5,4,-1,41.89576,-87.62012
13247,5,17,false,33,63,30,41.89597,-87.66775
350,5,17,false,6,13,7,41.89597,-87.66774
TA1305000020,5,17,false,67,47,-20,41.89636,-87.65406
54,5,17,false,6,4,-2,41.89637,-87.65407
13289,5,17,false,41,61,20,41.89638,-87.661
86,5,17,false,4,9,5,41.89639,-87.661
337,5,17,false,17,16,-1,41.89659,-87.63096
13303,5,17,false,74,73,-1,41.89672,-87.63088
13017,5,17,false,54,47,-7,41.89676,-87.6357
31,5,17,false,17,15,-2,41.89677,-87.63572
13338,5,17,false,37,44,7,41.89697,-87.62173
173,5,17,false,3,6,3,41.89704,-87.62173
TA1307000061,5,17,false,94,56,-38,41.89745,-87.62873
106,5,17,false,6,3,-3,41.89746,-87.62874
25,5,17,false,22,12,-10,41.89751,-87.62354
13034,5,17,false,68,65,-3,41.89754,-87.62352
48,5,17,false,10,3,-7,41.89772,-87.64302
TA1306000009,5,17,false,39,38,-1,41.89772,-87.64299
620,5,17,false,104,60,-44,41.89817,-87.63754
374,5,17,false,5,5,0,41.89842,-87.68659
KA1504000103,5,17,false,49,51,2,41.89842,-87.68659
145,5,17,false,9,12,3,41.89856,-87.62211
15529,5,17,false,75,69,-6,41.89858,-87.62206
140,5,17,false,13,19,6,41.89895,-87.6299
TA1307000128,5,17,false,147,118,-29,41.89896,-87.6299
657,5,17,false,33,17,-16,41.89918,-87.6722
KA1504000117,5,17,false,15,6,-9,41.89936,-87.64848
365,5,17,false,3,1,-2,41.89936,-87.64848
30,5,17,false,5,4,-1,41.89964,-87.66789
13248,5,17,false,25,31,6,41.89964,-87.66788
46,5,17,false,10,13,3,41.89994,-87.63444
TA1306000011,5,17,false,49,30,-19,41.89994,-87.63443
KA1504000116,5,17,false,26,18,-8,41.90023,-87.64299
364,5,17,false,3,5,2,41.90023,-87.64299
17660,5,17,false,23,24,1,41.90036,-87.69671
622,5,17,false,1,5,4,41.90037,-87.69671
13290,5,17,false,49,38,-11,41.90069,-87.66259
29,5,17,false,5,8,3,41.90069,-87.66259
13042,5,17,false,312,381,69,41.90097,-87.62377
85,5,17,false,28,36,8,41.90098,-87.62375
183,5,17,false,1,3,2,41.90133,-87.67744
TA1307000070,5,17,false,40,36,-4,41.90133,-87.67742
KA1504000133,5,17,false,120,89,-31,41.90234,-87.62773
172,5,17,false,15,16,1,41.90236,-87.62774
15654,5,17,false,12,9,-3,41.90271,-87.70923
305,5,17,false,2,1,-1,41.9028,-87.69005
13241,5,17,false,30,30,0,41.9029,-87.68731
176,5,17,false,34,22,-12,41.90291,-87.63141
TA1306000006,5,17,false,18,19,1,41.90292,-87.63772
23,5,17,false,1,5,4,41.90292,-87.63772
TA1307000039,5,17,false,214,215,1,41.90294,-87.63137
658,5,17,false,19,23,4,41.903,-87.6838
13256,5,17,false,24,23,-1,41.90302,-87.69749
216,5,17,false,1,2,1,41.90302,-87.69749
17,5,17,false,7,13,6,41.90313,-87.67391
TA1305000034,5,17,false,60,100,40,41.90313,-87.67391
182,5,17,false,34,27,-7,41.90317,-87.63442
KA1504000135,5,17,false,220,223,3,41.90319,-87.63439
13136,5,17,false,62,79,17,41.90326,-87.67845
130,5,17,false,6,8,2,41.90327,-87.67846
210,5,17,false,14,16,2,41.90342,-87.66781
13061,5,17,false,146,131,-15,41.90342,-87.66779
KA1504000079,5,17,false,76,46,-30,41.9035,-87.64334
359,5,17,false,9,6,-3,41.90458,-87.6497
138,5,17,false,5,2,-3,41.9046,-87.64057
TA1307000115,5,17,false,31,35,4,41.9046,-87.64056
291,5,17,false,28,21,-7,41.90672,-87.63494
TA1308000049,5,17,false,154,169,15,41.90672,-87.6349
KA1504000134,5,17,false,83,64,-19,41.90687,-87.6262
180,5,17,false,19,12,-7,41.90687,-87.62618
13224,5,17,false,65,56,-9,41.90706,-87.66725
333,5,17,false,6,11,5,41.90706,-87.66725
18069,5,17,false,17,3,-14,41.90722,-87.65563
TA1307000143,5,17,false,37,34,-3,41.90762,-87.63854
236,5,17,false,5,6,1,41.90762,-87.63853
61,5,17,false,6,12,6,41.90764,-87.67254
13221,5,17,false,90,102,12,41.90765,-87.67254
13245,5,17,false,18,14,-4,41.90777,-87.68586
301,5,17,false,16,17,1,41.90796,-87.63203
TA1309000024,5,17,false,111,129,18,41.908,-87.63152
69,5,17,false,14,16,2,41.90939,-87.6777
TA1305000041,5,17,false,90,140,50,41.9094,-87.67769
15652,5,17,false,10,9,-1,41.90965,-87.71664
331,5,17,false,103,134,31,41.90965,-87.64812
15653,5,17,false,11,13,2,41.90979,-87.7053
509,5,17,false,1,3,2,41.9098,-87.70531
TA1305000037,5,17,false,69,64,-5,41.91018,-87.67003
27,5,17,false,7,7,0,41.91019,-87.6435
TA1306000008,5,17,false,33,42,9,41.9102,-87.6435
16,5,17,false,7,10,3,41.91035,-87.67008
213,5,17,false,5,4,-1,41.91037,-87.68237
TA1308000005,5,17,false,41,37,-4,41.91042,-87.68238
13258,5,17,false,29,29,0,41.91043,-87.69718
160,5,17,false,4,2,-2,41.91054,-87.68957
13257,5,17,false,43,30,-13,41.91054,-87.68956
13154,5,17,false,64,57,-7,41.91054,-87.65312
20,5,17,false,8,9,1,41.91055,-87.65313
13058,5,17,false,79,59,-20,41.91059,-87.64942
60,5,17,false,9,14,5,41.91059,-87.64942
118,5,17,false,13,10,-3,41.91138,-87.63868
TA1307000038,5,17,false,91,95,4,41.91138,-87.63868
268,5,17,false,22,27,5,41.91172,-87.62681
LF-005,5,17,false,304,350,46,41.91172,-87.62681
126,5,17,false,8,6,-2,41.91196,-87.63197
13128,5,17,false,67,66,-1,41.91197,-87.63197
289,5,17,false,36,33,-3,41.91209,-87.63472
TA1308000050,5,17,false,277,280,3,41.91211,-87.6347
158,5,17,false,10,12,2,41.91262,-87.6814
13243,5,17,false,68,71,3,41.91262,-87.6814
TA1309000032,5,17,false,21,20,-1,41.91293,-87.66417
TA1306000032,5,17,false,80,65,-15,41.9137,-87.65285
93,5,17,false,9,7,-2,41.91371,-87.65285
TA1307000166,5,17,false,77,60,-17,41.91386,-87.64877
224,5,17,false,7,13,6,41.91386,-87.64877
511,5,17,false,3,5,2,41.914,-87.70515
15655,5,17,false,26,27,1,41.91401,-87.70514
18017,5,17,false,12,18,6,41.91416,-87.71676
628,5,17,false,9,2,-7,41.9146,-87.66796
18067,5,17,false,46,44,-2,41.9146,-87.66796
TA1306000007,5,17,false,25,22,-3,41.91469,-87.64333
28,5,17,false,5,4,-1,41.91469,-87.64333
13068,5,17,false,58,48,-10,41.91554,-87.68703
116,5,17,false,6,1,-5,41.91555,-87.68703
13179,5,17,false,192,190,-2,41.9157,-87.63461
141,5,17,false,12,25,13,41.91571,-87.63461
219,5,17,false,6,3,-3,41.91598,-87.67733
13133,5,17,false,83,88,5,41.91598,-87.67733
58,5,17,false,14,8,-6,41.91602,-87.66894
TA1305000039,5,17,false,69,80,11,41.9163,-87.66749
506,5,17,false,1,2,1,41.91711,-87.71023
15650,5,17,false,14,29,15,41.91711,-87.71023
15651,5,17,false,59,41,-18,41.91752,-87.70181
507,5,17,false,4,9,5,41.91752,-87.70181
185,5,17,false,3,1,-2,41.91774,-87.69143
13266,5,17,false,34,26,-8,41.91774,-87.69142
TA1309000029,5,17,false,38,47,9,41.9178,-87.68245
TA1309000006,5,17,false,68,62,-6,41.91809,-87.64375
288,5,17,false,11,8,-3,41.91809,-87.64375
223,5,17,false,7,12,5,41.91821,-87.65698
TA1307000163,5,17,false,50,69,19,41.91821,-87.65696
94,5,17,false,21,24,3,41.91831,-87.6363
13146,5,17,false,201,186,-15,41.91831,-87.63629
13059,5,17,false,137,112,-25,41.91845,-87.65222
113,5,17,false,17,14,-3,41.91846,-87.65222
13259,5,17,false,22,32,10,41.91852,-87.69744
259,5,17,false,3,8,5,41.91853,-87.69745
310,5,17,false,3,4,1,41.91984,-87.68083
13192,5,17,false,101,93,-8,41.91995,-87.64884
225,5,17,false,7,7,0,41.91995,-87.64884
13288,5,17,false,58,26,-32,41.92008,-87.67788
13242,5,17,false,28,28,0,41.92021,-87.69266
222,5,17,false,5,3,-2,41.92023,-87.69265
307,5,17,false,8,6,-2,41.92077,-87.66373
TA1309000030,5,17,false,42,64,22,41.92077,-87.66372
290,5,17,false,2,8,6,41.92152,-87.70734
13292,5,17,false,28,11,-17,41.92152,-87.70733
TA1309000033,5,17,false,93,114,21,41.92158,-87.65381
13193,5,17,false,169,165,-4,41.92182,-87.64412
144,5,17,false,19,22,3,41.92182,-87.64411
13191,5,17,false,91,89,-2,41.92217,-87.63891
143,5,17,false,15,18,3,41.92217,-87.63891
327,5,17,false,9,12,3,41.92225,-87.65783
13084,5,17,false,64,72,8,41.92268,-87.69715
123,5,17,false,9,13,4,41.92268,-87.69714
LP-,5,17,false,82,67,-15,41.92396,-87.63584
673,5,17,false,7,8,1,41.92398,-87.63585
505,5,17,false,5,3,-2,41.92409,-87.67646
KA1504000140,5,17,false,18,24,6,41.92409,-87.67646
16010,5,17,false,1,3,2,41.92458,-87.72787
504,5,17,false,7,10,3,41.92464,-87.68931
15648,5,17,false,25,29,4,41.92464,-87.68931
503,5,17,false,2,3,1,41.92483,-87.71451
KA1504000090,5,17,false,10,23,13,41.92483,-87.7145
TA1307000001,5,17,false,83,81,-2,41.92535,-87.66581
188,5,17,false,8,7,-1,41.92536,-87.66581
TA1306000026,5,17,false,53,50,-3,41.92558,-87.65842
87,5,17,false,6,11,5,41.92559,-87.65843
67,5,17,false,9,10,1,41.9256,-87.65371
TA1306000016,5,17,false,70,75,5,41.9256,-87.65371
313,5,17,false,24,31,7,41.9257,-87.64246
TA1309000019,5,17,false,155,159,4,41.92586,-87.63897
TA1309000058,5,17,false,155,174,19,41.92591,-87.64927
127,5,17,false,23,27,4,41.92592,-87.64927
TA1308000001,5,17,false,264,246,-18,41.92627,-87.63086
177,5,17,false,19,30,11,41.92627,-87.63086
502,5,17,false,2,4,2,41.92667,-87.69772
15646,5,17,false,28,37,9,41.92668,-87.6977
13124,5,17,false,56,51,-5,41.92675,-87.63444
34,5,17,false,1,7,6,41.92675,-87.63444
302,5,17,false,11,17,6,41.92859,-87.65421
TA1309000023,5,17,false,98,111,13,41.9287,-87.65383
TA1307000113,5,17,false,91,95,4,41.92878,-87.66391
190,5,17,false,10,4,-6,41.92878,-87.6639
166,5,17,false,5,2,-3,41.92883,-87.66853
13296,5,17,false,48,51,3,41.92883,-87.66852
TA1309000059,5,17,false,51,41,-10,41.92889,-87.65898
343,5,17,false,1,7,6,41.92889,-87.65898
349,5,17,false,10,12,2,41.92915,-87.6491
TA1309000061,5,17,false,134,119,-15,41.92915,-87.64909
TA1308000031,5,17,false,48,35,-13,41.92946,-87.68417
258,5,17,false,5,10,5,41.92946,-87.68417
340,5,17,false,19,14,-5,41.92956,-87.64313
TA1305000014,5,17,false,155,172,17,41.92956,-87.64313
260,5,17,false,9,7,-2,41.92958,-87.70791
13085,5,17,false,76,62,-14,41.92958,-87.70789
499,5,17,false,4,3,-1,41.93056,-87.72381
15643,5,17,false,19,10,-9,41.93057,-87.7238
TA1307000142,5,17,false,164,128,-36,41.93125,-87.64432
220,5,17,false,18,20,2,41.93125,-87.64431
13276,5,17,false,148,113,-35,41.93132,-87.63874
324,5,17,false,20,15,-5,41.93173,-87.64179
15645,5,17,false,26,26,0,41.93191,-87.70121
501,5,17,false,3,3,0,41.93191,-87.70121
163,5,17,false,4,4,0,41.93191,-87.67784
13271,5,17,false,35,19,-16,41.93192,-87.67784
152,5,17,false,5,10,5,41.93221,-87.65864
TA1307000064,5,17,false,68,78,10,41.93222,-87.65864
TA1306000014,5,17,false,118,89,-29,41.93242,-87.65271
13,5,17,false,12,15,3,41.93242,-87.65271
TA1309000039,5,17,false,192,151,-41,41.93258,-87.63642
329,5,17,false,13,14,1,41.93258,-87.63642
13294,5,17,false,53,37,-16,41.9326,-87.66595
319,5,17,false,6,1,-5,41.93292,-87.67217
TA1309000036,5,17,false,71,70,-1,41.93313,-87.64776
332,5,17,false,9,13,4,41.93313,-87.64776
15644,5,17,false,9,5,-4,41.93534,-87.71687
TA1307000006,5,17,false,58,60,2,41.93571,-87.6636
153,5,17,false,9,8,-1,41.93575,-87.66364
162,5,17,false,5,7,2,41.93588,-87.67844
13268,5,17,false,32,34,2,41.93588,-87.67843
250,5,17,false,5,1,-4,41.93609,-87.66984
13269,5,17,false,39,17,-22,41.93609,-87.66983
115,5,17,false,20,29,9,41.93628,-87.65266
TA1307000052,5,17,false,105,129,24,41.93628,-87.65266
156,5,17,false,12,20,8,41.9365,-87.64756
TA1307000136,5,17,false,140,87,-53,41.9365,-87.64755
TA1307000041,5,17,false,143,109,-34,41.93669,-87.63683
157,5,17,false,15,16,1,41.9367,-87.63683
13137,5,17,false,174,137,-37,41.9376,-87.6441
300,5,17,false,18,32,14,41.93761,-87.6441
498,5,17,false,4,2,-2,41.93843,-87.69801
15642,5,17,false,24,36,12,41.93843,-87.69801
154,5,17,false,14,3,-11,41.93912,-87.66384
664,5,17,false,1,4,3,41.93934,-87.68327
KA17018068,5,17,false,23,22,-1,41.93935,-87.68327
TA1309000042,5,17,false,72,36,-36,41.93937,-87.66836
131,5,17,false,7,10,3,41.93937,-87.66835
496,5,17,false,1,1,0,41.9394,-87.72356
KA150400009X,5,17,false,13,11,-2,41.9394,-87.71159
15640,5,17,false,10,10,0,41.93941,-87.72357
13229,5,17,false,99,81,-18,41.93946,-87.66376
226,5,17,false,9,10,1,41.93972,-87.65886
TA1308000019,5,17,false,94,100,6,41.93973,-87.65886
13277,5,17,false,112,96,-16,41.9401,-87.64546
296,5,17,false,2,8,6,41.9401,-87.64546
TA1307000134,5,17,false,176,157,-19,41.94016,-87.65303
117,5,17,false,14,24,10,41.94016,-87.65302
13143,5,17,false,44,24,-20,41.94059,-87.67853
334,5,17,false,27,20,-7,41.94076,-87.63919
TA1309000049,5,17,false,143,120,-23,41.94077,-87.63919
308,5,17,false,4,5,1,41.94152,-87.68471
493,5,17,false,7,3,-4,41.94304,-87.68729
15634,5,17,false,13,29,16,41.94304,-87.68729
TA1307000138,5,17,false,50,66,16,41.94334,-87.67094
230,5,17,false,11,5,-6,41.94335,-87.67093
13144,5,17,false,38,42,4,41.9434,-87.67964
TA1309000025,5,17,false,133,109,-24,41.94368,-87.64894
299,5,17,false,11,14,3,41.94368,-87.64894
229,5,17,false,13,19,6,41.94372,-87.66401
13071,5,17,false,172,130,-42,41.94373,-87.66401
632,5,17,false,218,203,-15,41.94453,-87.6547
303,5,17,false,7,19,12,41.94522,-87.64702
490,5,17,false,1,4,3,41.94523,-87.70664
15631,5,17,false,16,21,5,41.94524,-87.70665
13278,5,17,false,118,111,-7,41.94553,-87.64644
TA1309000050,5,17,false,23,18,-5,41.94618,-87.67331
330,5,17,false,1,2,1,41.94618,-87.67331
KA1504000141,5,17,false,10,2,-8,41.94627,-87.73105
488,5,17,false,1,1,0,41.94627,-87.73105
492,5,17,false,2,1,-1,41.94662,-87.68337
491,5,17,false,2,1,-1,41.94664,-87.69463
15632,5,17,false,10,10,0,41.94664,-87.69463
KA1504000143,5,17,false,20,18,-2,41.94664,-87.68337
KA1504000142,5,17,false,6,2,-4,41.94735,-87.71759
489,5,17,false,1,2,1,41.94736,-87.7176
16994,5,17,false,2,2,0,41.94784,-87.74
227,5,17,false,12,8,-4,41.94813,-87.66397
13235,5,17,false,115,99,-16,41.94814,-87.66396
304,5,17,false,6,12,6,41.94878,-87.64922
13253,5,17,false,23,22,-1,41.9488,-87.67527
257,5,17,false,2,3,1,41.9488,-87.67527
13325,5,17,false,97,88,-9,41.94907,-87.64863
114,5,17,false,17,11,-6,41.94935,-87.65451
TA1307000126,5,17,false,162,146,-16,41.94936,-87.65451
232,5,17,false,12,6,-6,41.94943,-87.64645
TA1307000150,5,17,false,103,100,-3,41.94945,-87.64646
18016,5,17,false,10,4,-6,41.94993,-87.71395
347,5,17,false,2,3,1,41.95068,-87.6687
13319,5,17,false,25,27,2,41.95069,-87.6687
TA1307000127,5,17,false,128,104,-24,41.9508,-87.65918
165,5,17,false,15,14,-1,41.95081,-87.65918
487,5,17,false,1,5,4,41.95216,-87.69806
15628,5,17,false,6,12,6,41.95216,-87.69806
318,5,17,false,3,2,-1,41.95254,-87.6735
13323,5,17,false,73,51,-22,41.95282,-87.65
256,5,17,false,17,8,-9,41.95282,-87.65
15624,5,17,false,14,13,-1,41.95339,-87.73199
314,5,17,false,2,5,3,41.9535,-87.69199
KA1504000096,5,17,false,8,7,-1,41.95361,-87.70932
KA1504000139,5,17,false,8,7,-1,41.954,-87.71909
TA1309000043,5,17,false,51,27,-24,41.95417,-87.66434
240,5,17,false,9,3,-6,41.95424,-87.65441
13063,5,17,false,65,79,14,41.95424,-87.65441
486,5,17,false,5,3,-2,41.95431,-87.68607
KA1504000158,5,17,false,12,17,5,41.95432,-87.68607
254,5,17,false,11,17,6,41.95438,-87.64806
TA1308000022,5,17,false,76,68,-8,41.95438,-87.64805
16991,5,17,false,1,8,7,41.95448,-87.7496
244,5,17,false,3,2,-1,41.95466,-87.67391
TA1307000149,5,17,false,23,40,17,41.95467,-87.67392
298,5,17,false,2,3,1,41.95601,-87.68021
TA1309000026,5,17,false,22,32,10,41.95601,-87.6802
246,5,17,false,2,1,-1,41.95606,-87.66885
13249,5,17,false,20,21,1,41.95606,-87.66885
312,5,17,false,8,3,-5,41.95637,-87.6563
TA1308000047,5,17,false,23,12,-11,41.95709,-87.6642
292,5,17,false,1,2,1,41.95709,-87.6642
13379,5,17,false,58,40,-18,41.95786,-87.6495
TA1309000018,5,17,false,19,15,-4,41.95791,-87.67357
316,5,17,false,4,2,-2,41.95841,-87.69401
306,5,17,false,7,4,-3,41.9585,-87.655
TA1309000027,5,17,false,50,31,-19,41.9585,-87.65499
592,5,17,false,5,3,-2,41.96065,-87.74538
13389,5,17,false,36,42,6,41.961,-87.64958
245,5,17,false,8,8,0,41.96101,-87.64958
15621,5,17,false,4,11,7,41.96103,-87.70586
KA1706005015,5,17,false,2,2,0,41.96108,-87.73569
15622,5,17,false,17,10,-7,41.96108,-87.69544
481,5,17,false,2,2,0,41.96108,-87.69544
KA1504000164,5,17,false,2,2,0,41.96109,-87.72897
KA1504000097,5,17,false,7,6,-1,41.96116,-87.71658
238,5,17,false,7,4,-3,41.96141,-87.6762
TA1307000144,5,17,false,17,12,-5,41.96142,-87.6762
297,5,17,false,3,2,-1,41.9615,-87.67141
TA1309000021,5,17,false,17,6,-11,41.9615,-87.6714
482,5,17,false,1,1,0,41.96154,-87.69117
15623,5,17,false,6,8,2,41.96154,-87.69117
234,5,17,false,3,2,-1,41.96158,-87.6661
KA1503000022,5,17,false,31,24,-7,41.96158,-87.66609
231,5,17,false,10,14,4,41.96163,-87.65464
TA1307000107,5,17,false,60,71,11,41.96164,-87.65464
TA1307000156,5,17,false,23,26,3,41.96301,-87.68479
TA1309000012,5,17,false,25,9,-16,41.96325,-87.67928
249,5,17,false,13,8,-5,41.96398,-87.63818
TA1308000012,5,17,false,142,156,14,41.96398,-87.63818
293,5,17,false,9,2,-7,41.96521,-87.65822
13074,5,17,false,38,41,3,41.96521,-87.6582
639,5,17,false,50,64,14,41.96584,-87.64538
KA1504000093,5,17,false,5,4,-1,41.96587,-87.69365
TA1307000140,5,17,false,19,25,6,41.96643,-87.68865
239,5,17,false,4,6,2,41.9665,-87.68843
326,5,17,false,5,4,-1,41.96665,-87.67113
KA1504000126,5,17,false,8,7,-1,41.96668,-87.70807
TA1309000014,5,17,false,34,44,10,41.96709,-87.66744
TA1307000158,5,17,false,23,18,-5,41.9671,-87.67904
242,5,17,false,2,3,1,41.9671,-87.67904
TA1307000119,5,17,false,34,19,-15,41.96796,-87.65
251,5,17,false,1,4,3,41.96796,-87.65
15615,5,17,false,3,5,2,41.96835,-87.71183
323,5,17,false,2,1,-1,41.96869,-87.66034
TA1308000021,5,17,false,32,19,-13,41.96883,-87.65765
253,5,17,false,1,1,0,41.96883,-87.65765
475,5,17,false,1,2,1,41.96885,-87.69611
KA1504000080,5,17,false,19,9,-10,41.96887,-87.69609
TA1309000015,5,17,false,12,4,-8,41.96889,-87.68401
311,5,17,false,2,3,1,41.9689,-87.68402
344,5,17,false,4,9,5,41.9691,-87.67423
TA1309000066,5,17,false,54,63,9,41.9691,-87.67423
TA1309000041,5,17,false,19,17,-2,41.96951,-87.65471
KA1504000171,5,17,false,48,44,-4,41.97161,-87.65016
465,5,17,false,5,5,0,41.97161,-87.65016
325,5,17,false,5,6,1,41.9728,-87.67186
TA1309000035,5,17,false,61,78,17,41.97335,-87.66785
295,5,17,false,6,6,0,41.97378,-87.65972
13108,5,17,false,37,45,8,41.97379,-87.65971
KA1504000078,5,17,false,6,6,0,41.97491,-87.69258
472,5,17,false,3,2,-1,41.97492,-87.69262
KA1504000149,5,17,false,12,24,12,41.97562,-87.67945
KA1504000160,5,17,false,5,4,-1,41.97564,-87.70143
471,5,17,false,1,3,2,41.97564,-87.70143
KA1504000128,5,17,false,8,1,-7,41.97567,-87.70927
463,5,17,false,4,10,6,41.978,-87.66805
KA1504000146,5,17,false,52,61,9,41.978,-87.66805
13109,5,17,false,38,39,1,41.97835,-87.65976
294,5,17,false,4,9,5,41.97835,-87.65976
KA1504000147,5,17,false,9,8,-1,41.97976,-87.67754
462,5,17,false,1,2,1,41.97977,-87.67755
655,5,17,false,11,22,11,41.97987,-87.68194
KA1504000167,5,17,false,2,4,2,41.98206,-87.70895
KA1504000151,5,17,false,17,35,18,41.98359,-87.66916
15585,5,17,false,8,7,-1,41.98367,-87.69642
KA1504000152,5,17,false,83,88,5,41.98403,-87.65231
459,5,17,false,8,15,7,41.98403,-87.65231
15578,5,17,false,18,16,-2,41.98405,-87.66027
461,5,17,false,4,4,0,41.98405,-87.66027
15575,5,17,false,37,26,-11,41.98975,-87.66014
458,5,17,false,6,3,-3,41.98975,-87.66013
455,5,17,false,2,2,0,41.99024,-87.69338
KA1504000130,5,17,false,3,5,2,41.99024,-87.69338
457,5,17,false,5,3,-2,41.99052,-87.66982
KA1504000148,5,17,false,16,11,-5,41.99086,-87.66971
KA1504000129,5,17,false,6,8,2,41.99417,-87.68945
15571,5,17,false,21,39,18,41.99478,-87.66028
454,5,17,false,5,5,0,41.99478,-87.66027
KA1504000156,5,17,false,12,3,-9,41.99925,-87.67137
453,5,17,false,2,1,-1,41.99925,-87.67137
RP-009,5,17,false,28,23,-5,42.00107,-87.66122
451,5,17,false,2,5,3,42.00108,-87.66123
450,5,17,false,2,3,1,42.00179,-87.68883
RP-001,5,17,false,3,8,5,42.00179,-87.68883
RP-008,5,17,false,3,4,1,42.00446,-87.6724
RP-002,5,17,false,3,7,4,42.00456,-87.68065
660,5,17,false,16,20,4,42.00458,-87.66143
KA1504000175,5,17,false,14,13,-1,42.00797,-87.66549
447,5,17,false,3,5,2,42.00797,-87.66548
RP-005,5,17,false,5,9,4,42.0086,-87.69047
432,5,17,false,2,2,0,42.00907,-87.67423
KA1504000162,5,17,false,5,13,8,42.00907,-87.67422
KA1504000159,5,17,false,13,10,-3,42.01059,-87.66241
RP-006,5,17,false,8,2,-6,42.01213,-87.68292
RP-004,5,17,false,13,6,-7,42.01234,-87.68825
525,5,17,false,13,9,-4,42.01272,-87.66605
517,5,17,false,3,3,0,42.01597,-87.675
520,5,17,false,13,2,-11,42.01597,-87.66859
519,5,17,false,2,4,2,42.01696,-87.67773
527,5,17,false,8,7,-1,42.01892,-87.69004
515,5,17,false,6,7,1,42.01915,-87.67356
514,5,17,false,6,2,-4,42.01927,-87.68452
16806,5,17,false,4,3,-1,42.01953,-87.66955
522,5,17,false,1,1,0,42.01954,-87.66954
523,5,17,false,6,7,1,42.02089,-87.66505
662,5,17,false,4,3,-1,42.02354,-87.69961
598,5,17,false,4,6,2,42.02578,-87.68411
597,5,17,false,2,1,-1,42.03256,-87.67914
E002,5,17,false,16,9,-7,42.03256,-87.67912
E011,5,17,false,1,5,4,42.03473,-87.69912
599,5,17,false,7,4,-3,42.03972,-87.69942
625,5,17,false,1,1,0,42.04163,-87.6808
596,5,17,false,24,24,0,42.04822,-87.68348
600,5,17,false,5,3,-2,42.04831,-87.6983
603,5,17,false,6,8,2,42.05049,-87.67782
E008,5,17,false,13,22,9,42.05049,-87.67782
605,5,17,false,19,5,-14,42.05294,-87.67342
661,5,17,false,15,16,1,42.05704,-87.68657
604,5,17,false,21,13,-8,42.05824,-87.67744
E006,5,17,false,6,3,-3,42.06367,-87.69871
602,5,17,false,1,1,0,42.06431,-87.68614
E014,5,17,false,2,6,4,42.06483,-87.71531
20206,5,17,true,1,1,0,41.68459,-87.6708
20108,5,17,true,1,1,0,41.69921,-87.66888
20224,5,17,true,8,7,-1,41.71371,-87.53083
20118,5,17,true,1,1,0,41.72762,-87.63487
706,5,17,true,1,1,0,41.73649,-87.60126
399,5,17,true,1,1,0,41.76225,-87.5592
KA1503000002,5,17,true,9,7,-2,41.76641,-87.5657
653,5,17,true,2,2,0,41.78059,-87.58491
KA1503000054,5,17,true,3,1,-2,41.78061,-87.60582
15491,5,17,true,5,4,-1,41.78096,-87.57624
101,5,17,true,5,4,-1,41.78105,-87.57611
KA1503000033,5,17,true,3,4,1,41.78411,-87.61329
KA1503000014,5,17,true,81,90,9,41.7851,-87.60108
426,5,17,true,21,31,10,41.7851,-87.60108
KA1503000070,5,17,true,22,16,-6,41.78794,-87.58831
425,5,17,true,9,9,0,41.78795,-87.58831
328,5,17,true,15,4,-11,41.78872,-87.6013
TA1309000011,5,17,true,82,14,-68,41.78873,-87.60131
KA1503000071,5,17,true,127,52,-75,41.79148,-87.59988
423,5,17,true,27,5,-22,41.79148,-87.59988
KA1503000075,5,17,true,7,4,-3,41.79156,-87.60785
KA1503000074,5,17,true,15,15,0,41.79174,-87.58395
KA1503000011,5,17,true,2,1,-1,41.79296,-87.645
TA1309000063,5,17,true,29,69,40,41.79325,-87.5878
345,5,17,true,12,22,10,41.79326,-87.5878
KA1503000073,5,17,true,3,3,0,41.79345,-87.61585
420,5,17,true,24,17,-7,41.79429,-87.60145
KA1504000076,5,17,true,95,56,-39,41.7943,-87.60145
TA1307000160,5,17,true,1,3,2,41.79485,-87.61873
KA1503000013,5,17,true,1,5,4,41.79498,-87.63312
247,5,17,true,8,22,14,41.79522,-87.58077
TA1308000009,5,17,true,43,68,25,41.79522,-87.58075
TA1307000164,5,17,true,34,51,17,41.79527,-87.59647
248,5,17,true,8,4,-4,41.79528,-87.59647
646,5,17,true,1,2,1,41.79663,-87.62592
KA1503000052,5,17,true,31,36,5,41.79935,-87.60097
418,5,17,true,9,9,0,41.79936,-87.60097
419,5,17,true,6,11,5,41.79952,-87.58643
KA1503000059,5,17,true,21,46,25,41.79952,-87.58643
TA1309000037,5,17,true,67,91,24,41.79957,-87.59474
KA1503000010,5,17,true,1,1,0,41.8018,-87.64522
15470,5,17,true,2,2,0,41.80228,-87.61807
417,5,17,true,9,11,2,41.80242,-87.5869
KA1503000007,5,17,true,34,51,17,41.80242,-87.58689
121,5,17,true,6,13,7,41.80256,-87.59035
13398,5,17,true,19,32,13,41.80256,-87.59035
TA1309000067,5,17,true,8,10,2,41.80303,-87.60661
322,5,17,true,7,18,11,41.80321,-87.59849
594,5,17,true,1,1,0,41.80567,-87.68337
416,5,17,true,2,1,-1,41.80578,-87.59247
KA1503000069,5,17,true,7,11,4,41.80579,-87.59247
KA1503000051,5,17,true,6,6,0,41.80815,-87.64563
KA1504000091,5,17,true,2,2,0,41.80823,-87.6772
16937,5,17,true,2,1,-1,41.80887,-87.66453
412,5,17,true,2,1,-1,41.80932,-87.63346
TA1308000035,5,17,true,17,13,-4,41.80944,-87.59188
267,5,17,true,1,1,0,41.80944,-87.59188
252,5,17,true,4,3,-1,41.80982,-87.59936
TA1308000002,5,17,true,7,11,4,41.80983,-87.59937
TA1308000007,5,17,true,2,3,1,41.80984,-87.61628
336,5,17,true,3,2,-1,41.80985,-87.60675
TA1309000053,5,17,true,7,12,5,41.80985,-87.60675
549,5,17,true,2,1,-1,41.81401,-87.66662
413,5,17,true,1,2,1,41.81408,-87.59701
KA1503000065,5,17,true,6,7,1,41.81409,-87.59701
TA1308000023,5,17,true,1,3,2,41.81649,-87.60659
410,5,17,true,1,1,0,41.81666,-87.61942
KA1503000027,5,17,true,4,6,2,41.81666,-87.61942
408,5,17,true,2,1,-1,41.81914,-87.64328
13083,5,17,true,2,4,2,41.82167,-87.62153
265,5,17,true,2,5,3,41.82297,-87.6071
TA1308000038,5,17,true,10,8,-2,41.82298,-87.6071
546,5,17,true,2,1,-1,41.82319,-87.67661
547,5,17,true,1,1,0,41.82346,-87.66558
16933,5,17,true,2,1,-1,41.82362,-87.65093
179,5,17,true,3,2,-1,41.82458,-87.61678
13420,5,17,true,10,7,-3,41.82459,-87.61678
645,5,17,true,1,2,1,41.82671,-87.68316
18022,5,17,true,3,1,-2,41.82672,-87.68315
262,5,17,true,2,4,2,41.82707,-87.64573
TA1307000161,5,17,true,3,1,-2,41.82707,-87.64572
KA1503000068,5,17,true,1,4,3,41.82878,-87.68062
9,5,17,true,2,3,1,41.82878,-87.68061
278,5,17,true,1,5,4,41.83062,-87.64129
TA1308000045,5,17,true,10,18,8,41.83062,-87.64129
TA1308000043,5,17,true,8,7,-1,41.83066,-87.64715
279,5,17,true,2,3,1,41.83067,-87.64715
15446,5,17,true,10,12,2,41.83068,-87.65603
367,5,17,true,1,2,1,41.83069,-87.65604
405,5,17,true,2,2,0,41.83078,-87.6325
KA1503000005,5,17,true,6,11,5,41.83079,-87.6325
TA1307000129,5,17,true,45,8,-37,41.83104,-87.62683
KA1503000004,5,17,true,9,7,-2,41.83127,-87.6088
406,5,17,true,2,4,2,41.83127,-87.6088
13345,5,17,true,6,5,-1,41.83138,-87.61803
15445,5,17,true,18,19,1,41.83453,-87.63183
403,5,17,true,1,7,6,41.83453,-87.63183
13216,5,17,true,84,44,-40,41.83473,-87.62581
148,5,17,true,22,10,-12,41.83474,-87.62581
149,5,17,true,16,9,-7,41.83486,-87.61791
13217,5,17,true,26,48,22,41.83488,-87.61792
13215,5,17,true,21,31,10,41.83634,-87.6135
263,5,17,true,1,5,4,41.8364,-87.61348
280,5,17,true,2,4,2,41.83779,-87.65116
TA1308000046,5,17,true,17,31,14,41.83779,-87.65115
339,5,17,true,3,9,6,41.83817,-87.64523
TA1309000055,5,17,true,29,73,44,41.8382,-87.64514
KA1503000038,5,17,true,27,18,-9,41.83845,-87.6354
402,5,17,true,4,2,-2,41.83845,-87.6354
150,5,17,true,11,5,-6,41.83855,-87.60821
TA1307000048,5,17,true,39,46,7,41.83855,-87.60821
272,5,17,true,1,8,7,41.83882,-87.62186
TA1308000036,5,17,true,28,32,4,41.83883,-87.62186
368,5,17,true,2,1,-1,41.83915,-87.66562
15442,5,17,true,11,9,-2,41.83918,-87.66562
KA1504000168,5,17,true,3,2,-1,41.84152,-87.68514
366,5,17,true,1,4,3,41.84164,-87.65744
KA1503000040,5,17,true,13,16,3,41.84164,-87.65744
237,5,17,true,9,19,10,41.84204,-87.61697
TA1307000139,5,17,true,61,49,-12,41.84205,-87.61698
15443,5,17,true,4,6,2,41.84275,-87.63549
207,5,17,true,3,1,-2,41.84358,-87.64539
TA1307000153,5,17,true,12,29,17,41.84358,-87.64538
15691,5,17,true,4,1,-3,41.84449,-87.70203
147,5,17,true,9,6,-3,41.84569,-87.62251
TA1307000005,5,17,true,23,19,-4,41.84569,-87.6225
206,5,17,true,6,1,-5,41.84719,-87.64683
TA1308000013,5,17,true,9,4,-5,41.84719,-87.64681
348,5,17,true,1,1,0,41.8477,-87.69448
TA1309000003,5,17,true,5,3,-2,41.84847,-87.68512
15689,5,17,true,1,5,4,41.84912,-87.69515
TA1307000066,5,17,true,2,1,-1,41.8492,-87.67564
TA1308000014,5,17,true,9,6,-3,41.84953,-87.64059
209,5,17,true,3,6,3,41.84953,-87.64058
132,5,17,true,3,3,0,41.85008,-87.63215
TA1308000026,5,17,true,7,5,-2,41.85008,-87.63214
TA1305000004,5,17,true,8,6,-2,41.8514,-87.61884
62,5,17,true,3,1,-2,41.85141,-87.61884
42,5,17,true,8,3,-5,41.85261,-87.62653
TA1305000001,5,17,true,16,35,19,41.85262,-87.6265
13075,5,17,true,57,61,4,41.8531,-87.63192
120,5,17,true,14,18,4,41.8531,-87.63191
135,5,17,true,2,5,3,41.85367,-87.64652
13162,5,17,true,9,8,-1,41.85378,-87.64659
13096,5,17,true,6,13,7,41.8538,-87.69577
15685,5,17,true,7,2,-5,41.85399,-87.71511
13091,5,17,true,17,17,0,41.85409,-87.68585
203,5,17,true,2,2,0,41.85409,-87.68585
370,5,17,true,2,2,0,41.85415,-87.61917
15546,5,17,true,6,12,6,41.85416,-87.61916
351,5,17,true,4,1,-3,41.85441,-87.67678
13307,5,17,true,10,13,3,41.85489,-87.66359
208,5,17,true,1,6,5,41.85489,-87.66359
124,5,17,true,1,2,1,41.85492,-87.67609
13089,5,17,true,12,17,5,41.85497,-87.67567
13331,5,17,true,22,11,-11,41.85515,-87.65414
171,5,17,true,1,4,3,41.85516,-87.65414
15545,5,17,true,93,84,-9,41.85627,-87.61334
4,5,17,true,22,21,-1,41.85627,-87.61334
178,5,17,true,4,3,-1,41.85657,-87.62755
SL-013,5,17,true,29,22,-7,41.85659,-87.62755
SL-006,5,17,true,14,9,-5,41.8568,-87.63387
129,5,17,true,8,6,-2,41.85752,-87.66158
202,5,17,true,8,5,-3,41.85752,-87.64621
13135,5,17,true,29,41,12,41.85753,-87.66157
338,5,17,true,11,17,6,41.85758,-87.61956
13102,5,17,true,60,71,11,41.85762,-87.61942
273,5,17,true,20,21,1,41.85783,-87.62455
13150,5,17,true,69,72,3,41.85783,-87.62455
13099,5,17,true,13,23,10,41.85784,-87.64627
205,5,17,true,6,13,7,41.8579,-87.6687
TA1307000159,5,17,true,18,49,31,41.8579,-87.6687
170,5,17,true,6,4,-2,41.85793,-87.64083
TA1307000044,5,17,true,18,16,-2,41.85794,-87.64083
14,5,17,true,2,4,2,41.85808,-87.65109
13163,5,17,true,19,41,22,41.85808,-87.65108
13164,5,17,true,41,72,31,41.85818,-87.65648
15,5,17,true,5,11,6,41.85819,-87.65648
SL-012,5,17,true,48,74,26,41.86038,-87.62581
72,5,17,true,12,23,11,41.86039,-87.62581
274,5,17,true,1,1,0,41.86126,-87.6566
13304,5,17,true,25,20,-5,41.86126,-87.65659
437,5,17,true,2,2,0,41.86192,-87.69348
KA1504000109,5,17,true,14,2,-12,41.86192,-87.69347
TA1306000002,5,17,true,53,46,-7,41.86238,-87.65108
137,5,17,true,9,7,-2,41.86238,-87.65108
TA1307000124,5,17,true,86,144,58,41.86411,-87.62372
168,5,17,true,10,35,25,41.86415,-87.62372
282,5,17,true,13,9,-4,41.86487,-87.64708
TA1309000001,5,17,true,50,55,5,41.86488,-87.64708
13165,5,17,true,8,10,2,41.86505,-87.65697
13354,5,17,true,15,20,5,41.86524,-87.66651
275,5,17,true,9,22,13,41.86524,-87.66651
13029,5,17,true,17,6,-11,41.86531,-87.6179
341,5,17,true,23,20,-3,41.86608,-87.60733
13431,5,17,true,41,45,4,41.8661,-87.60728
15682,5,17,true,1,1,0,41.86651,-87.70649
KA1504000101,5,17,true,19,13,-6,41.86651,-87.68466
434,5,17,true,9,8,-1,41.86651,-87.68465
WL-008,5,17,true,46,64,18,41.86712,-87.64108
57,5,17,true,17,18,1,41.86712,-87.64107
59,5,17,true,25,51,26,41.86721,-87.62597
TA1305000002,5,17,true,141,189,48,41.86721,-87.62597
3,5,17,true,3,9,6,41.86723,-87.61536
15544,5,17,true,25,38,13,41.86723,-87.61536
TA1305000017,5,17,true,43,13,-30,41.86734,-87.64863
55,5,17,true,8,2,-6,41.86735,-87.64863
626,5,17,true,11,10,-1,41.86749,-87.63219
KA1706005007,5,17,true,36,35,-1,41.86749,-87.63219
SL-005,5,17,true,121,204,83,41.8679,-87.62304
255,5,17,true,26,32,6,41.86791,-87.62304
644,5,17,true,61,48,-13,41.86859,-87.68625
19,5,17,true,16,15,-1,41.86892,-87.65913
13139,5,17,true,58,57,-1,41.86893,-87.65913
13285,5,17,true,113,21,-92,41.86928,-87.67372
22,5,17,true,15,17,2,41.86947,-87.65548
13160,5,17,true,81,93,12,41.86947,-87.65548
382,5,17,true,3,3,0,41.8699,-87.68725
414,5,17,true,8,6,-2,41.87023,-87.63947
15550,5,17,true,26,47,21,41.87024,-87.63947
TA1309000010,5,17,true,81,105,24,41.87074,-87.62574
SL-009,5,17,true,50,41,-9,41.87081,-87.63121
342,5,17,true,31,4,-27,41.87127,-87.6737
TA1309000064,5,17,true,144,27,-117,41.87127,-87.67369
15542,5,17,true,9,13,4,41.87146,-87.64095
261,5,17,true,21,6,-15,41.87151,-87.6699
TA1307000130,5,17,true,85,56,-29,41.87178,-87.65103
241,5,17,true,21,26,5,41.8718,-87.65102
108,5,17,true,7,23,16,41.87183,-87.64664
TA1307000121,5,17,true,85,77,-8,41.87184,-87.64664
41,5,17,true,23,37,14,41.87209,-87.62957
SL-008,5,17,true,129,200,71,41.87209,-87.62956
13332,5,17,true,115,135,20,41.87219,-87.6615
394,5,17,true,5,11,6,41.87226,-87.63484
175,5,17,true,12,30,18,41.87255,-87.63359
SL-011,5,17,true,71,82,11,41.87256,-87.63356
623,5,17,true,66,69,3,41.87272,-87.62399
KA1504000104,5,17,true,90,19,-71,41.87296,-87.66912
383,5,17,true,32,2,-30,41.87297,-87.66912
320,5,17,true,25,28,3,41.87327,-87.66402
5,5,17,true,8,11,3,41.87403,-87.6277
SL-007,5,17,true,37,63,26,41.87404,-87.6277
169,5,17,true,2,4,2,41.87424,-87.63959
13326,5,17,true,28,10,-18,41.87425,-87.63958
321,5,17,true,15,20,5,41.87427,-87.63257
TA1306000025,5,17,true,48,31,-17,41.87464,-87.65703
32,5,17,true,4,4,0,41.87464,-87.65703
15668,5,17,true,21,12,-9,41.87471,-87.68642
13028,5,17,true,45,33,-12,41.87475,-87.64981
109,5,17,true,15,8,-7,41.87475,-87.64981
13081,5,17,true,44,7,-37,41.87501,-87.67326
122,5,17,true,6,3,-3,41.87501,-87.67325
89,5,17,true,6,9,3,41.87501,-87.6331
SL-010,5,17,true,70,60,-10,41.87501,-87.63309
15541,5,17,true,21,23,2,41.8758,-87.62086
68,5,17,true,7,3,-4,41.87587,-87.64077
13037,5,17,true,19,17,-2,41.87588,-87.64078
50,5,17,true,9,4,-5,41.87592,-87.6307
TA1305000009,5,17,true,43,33,-10,41.87593,-87.63068
317,5,17,true,25,7,-18,41.87603,-87.68195
TA1305000010,5,17,true,52,21,-31,41.87623,-87.62444
45,5,17,true,10,8,-2,41.87623,-87.62444
624,5,17,true,63,47,-16,41.87626,-87.62923
2,5,17,true,5,4,-1,41.87649,-87.62051
33,5,17,true,11,5,-6,41.87715,-87.62786
TA1305000035,5,17,true,53,21,-32,41.87716,-87.62787
13138,5,17,true,63,16,-47,41.87723,-87.63941
75,5,17,true,11,5,-6,41.87724,-87.63937
631,5,17,true,18,1,-17,41.87761,-87.6739
15539,5,17,true,101,93,-8,41.87763,-87.64405
13158,5,17,true,122,136,14,41.87764,-87.64957
134,5,17,true,17,28,11,41.87764,-87.64954
13157,5,17,true,84,85,1,41.87773,-87.6548
21,5,17,true,20,23,3,41.87773,-87.6548
TA1305000025,5,17,true,99,48,-51,41.87773,-87.63528
36,5,17,true,22,9,-13,41.87776,-87.63525
TA1309000002,5,17,true,41,23,-18,41.87784,-87.62408
284,5,17,true,18,3,-15,41.87784,-87.62408
13206,5,17,true,62,43,-19,41.87794,-87.66201
146,5,17,true,11,10,-1,41.87794,-87.66201
283,5,17,true,18,5,-13,41.87809,-87.63183
TA1309000004,5,17,true,94,25,-69,41.87811,-87.63184
107,5,17,true,34,27,-7,41.87822,-87.644
638,5,17,true,138,91,-47,41.87827,-87.64078
37,5,17,true,27,8,-19,41.87921,-87.62975
TA1305000005,5,17,true,111,30,-81,41.87924,-87.62975
286,5,17,true,10,2,-8,41.8793,-87.6355
13011,5,17,true,160,146,-14,41.87931,-87.63993
TA1309000008,5,17,true,64,20,-44,41.87933,-87.6355
192,5,17,true,27,29,2,41.87935,-87.63997
KA1503000034,5,17,true,37,6,-31,41.87938,-87.63197
40,5,17,true,6,1,-5,41.87944,-87.63197
39,5,17,true,14,2,-12,41.87948,-87.62571
KA1503000015,5,17,true,71,34,-37,41.87948,-87.6257
15667,5,17,true,15,24,9,41.8798,-87.68609
381,5,17,true,4,3,-1,41.87981,-87.68607
542,5,17,true,2,2,0,41.88013,-87.76322
287,5,17,true,32,5,-27,41.88017,-87.63527
TA1309000007,5,17,true,139,16,-123,41.88022,-87.63526
WL-011,5,17,true,88,67,-21,41.88034,-87.64273
73,5,17,true,13,25,12,41.8804,-87.64273
80,5,17,true,13,27,14,41.88042,-87.65556
13156,5,17,true,72,94,22,41.88042,-87.65554
13300,5,17,true,113,131,18,41.88097,-87.61675
76,5,17,true,29,27,-2,41.88098,-87.61675
13008,5,17,true,118,80,-38,41.88105,-87.62408
90,5,17,true,20,11,-9,41.88107,-87.62409
49,5,17,true,88,13,-75,41.88116,-87.62963
TA1305000006,5,17,true,199,50,-149,41.88122,-87.6296
13134,5,17,true,18,33,15,41.88138,-87.67493
215,5,17,true,3,1,-2,41.88139,-87.67492
13056,5,17,true,74,67,-7,41.88168,-87.63951
191,5,17,true,13,12,-1,41.88169,-87.63951
198,5,17,true,27,54,27,41.88187,-87.6488
TA1307000120,5,17,true,167,230,63,41.88188,-87.64879
13341,5,17,true,94,88,-6,41.88208,-87.63985
174,5,17,true,11,14,3,41.88208,-87.63984
197,5,17,true,14,7,-7,41.88208,-87.62513
13036,5,17,true,66,44,-22,41.8821,-87.62513
77,5,17,true,45,28,-17,41.88214,-87.64108
TA1305000032,5,17,true,176,169,-7,41.88218,-87.64109
98,5,17,true,24,3,-21,41.88266,-87.63251
13006,5,17,true,106,37,-69,41.88268,-87.63252
13353,5,17,true,62,83,21,41.88283,-87.6612
346,5,17,true,9,12,3,41.88284,-87.6612
654,5,17,true,42,57,15,41.88307,-87.65698
233,5,17,true,7,15,8,41.88309,-87.6511
13409,5,17,true,63,85,22,41.8831,-87.6511
18,5,17,true,21,4,-17,41.88317,-87.63735
KA1503000072,5,17,true,90,34,-56,41.88317,-87.63693
91,5,17,true,30,23,-7,41.88336,-87.64122
WL-012,5,17,true,238,181,-57,41.88337,-87.6412
112,5,17,true,15,29,14,41.88362,-87.6486
13053,5,17,true,132,166,34,41.88365,-87.64863
43,5,17,true,20,20,0,41.88396,-87.62455
13001,5,17,true,135,71,-64,41.88397,-87.62459
88,5,17,true,5,4,-1,41.88407,-87.65691
13155,5,17,true,36,31,-5,41.88407,-87.65689
621,5,17,true,11,10,-1,41.88412,-87.65427
18062,5,17,true,52,94,42,41.88412,-87.65427
81,5,17,true,65,33,-32,41.88417,-87.6296
TA1306000010,5,17,true,200,133,-67,41.88419,-87.62961
15666,5,17,true,2,5,3,41.88446,-87.6963
KA1504000106,5,17,true,7,2,-5,41.88459,-87.70631
TA1305000030,5,17,true,128,42,-86,41.88459,-87.63178
96,5,17,true,17,21,4,41.8846,-87.64455
15535,5,17,true,81,98,17,41.8846,-87.64455
51,5,17,true,32,8,-24,41.88462,-87.63176
TA1305000029,5,17,true,154,113,-41,41.88466,-87.62787
195,5,17,true,42,41,-1,41.88466,-87.61952
13263,5,17,true,127,164,37,41.88467,-87.61952
44,5,17,true,27,27,0,41.88468,-87.62782
TA1306000015,5,17,true,93,119,26,41.88549,-87.65232
518,5,17,true,4,1,-3,41.8855,-87.71686
71,5,17,true,21,28,7,41.8855,-87.65233
66,5,17,true,30,27,-3,41.88557,-87.64186
13021,5,17,true,133,127,-6,41.88559,-87.64184
TA1307000111,5,17,true,113,49,-64,41.88582,-87.63548
164,5,17,true,24,4,-20,41.88583,-87.63547
13073,5,17,true,38,42,4,41.88592,-87.66717
536,5,17,true,1,2,1,41.88593,-87.7354
119,5,17,true,4,7,3,41.88593,-87.66717
656,5,17,true,6,1,-5,41.88595,-87.67701
KA17018054,5,17,true,21,40,19,41.88595,-87.67701
KA1503000012,5,17,true,163,80,-83,41.88599,-87.63089
38,5,17,true,35,22,-13,41.88599,-87.63089
52,5,17,true,51,26,-25,41.886,-87.62421
TA1305000011,5,17,true,147,88,-59,41.886,-87.62418
7,5,17,true,15,17,2,41.88627,-87.61751
15534,5,17,true,75,109,34,41.88627,-87.61749
217,5,17,true,8,8,0,41.8866,-87.65821
13197,5,17,true,64,41,-23,41.8866,-87.65816
264,5,17,true,19,18,-1,41.8867,-87.62224
TA1308000029,5,17,true,72,59,-13,41.88673,-87.62225
TA1307000131,5,17,true,106,38,-68,41.88688,-87.62606
194,5,17,true,23,7,-16,41.88688,-87.62606
6,5,17,true,16,17,1,41.88697,-87.61281
KA1503000064,5,17,true,80,103,23,41.88697,-87.61281
377,5,17,true,3,3,0,41.88719,-87.71697
16905,5,17,true,2,1,-1,41.88767,-87.76547
100,5,17,true,41,14,-27,41.88814,-87.63657
TA1305000022,5,17,true,127,90,-37,41.88817,-87.63656
56,5,17,true,44,47,3,41.88866,-87.64442
TA1306000003,5,17,true,197,177,-20,41.88867,-87.64442
KA1503000043,5,17,true,248,235,-13,41.88918,-87.63851
133,5,17,true,48,50,2,41.88918,-87.63851
13050,5,17,true,152,132,-20,41.88919,-87.62775
47,5,17,true,28,26,-2,41.88921,-87.62775
15664,5,17,true,8,19,11,41.8895,-87.68821
376,5,17,true,7,5,-2,41.88951,-87.68818
13432,5,17,true,58,41,-17,41.88989,-87.67149
285,5,17,true,8,5,-3,41.88989,-87.67149
TA1307000151,5,17,true,185,170,-15,41.88993,-87.63427
212,5,17,true,47,33,-14,41.88995,-87.63427
636,5,17,true,95,78,-17,41.88997,-87.63662
125,5,17,true,15,14,-1,41.89018,-87.62621
KA1503000044,5,17,true,59,47,-12,41.89018,-87.6262
KA1504000113,5,17,true,2,2,0,41.89049,-87.70262
196,5,17,true,9,12,3,41.89053,-87.62205
13427,5,17,true,79,49,-30,41.89054,-87.62205
26,5,17,true,14,29,15,41.89057,-87.61798
13430,5,17,true,175,193,18,41.89077,-87.63169
181,5,17,true,33,39,6,41.89077,-87.63168
TA1306000013,5,17,true,139,157,18,41.89083,-87.61852
RN-,5,17,true,137,168,31,41.89102,-87.63546
672,5,17,true,26,46,20,41.89102,-87.63545
277,5,17,true,6,12,6,41.89108,-87.66665
13434,5,17,true,28,65,37,41.89108,-87.66663
TA1308000006,5,17,true,32,33,1,41.89128,-87.67686
199,5,17,true,49,49,0,41.89143,-87.62676
TA1307000117,5,17,true,190,189,-1,41.89144,-87.62675
13033,5,17,true,151,153,2,41.8916,-87.64835
214,5,17,true,7,8,1,41.89161,-87.67688
84,5,17,true,19,33,14,41.89161,-87.64833
186,5,17,true,14,13,-1,41.8918,-87.65879
13194,5,17,true,77,103,26,41.8918,-87.65878
TA1305000003,5,17,true,156,115,-41,41.89187,-87.62061
24,5,17,true,41,40,-1,41.8919,-87.62063
643,5,17,true,10,20,10,41.89203,-87.68939
35,5,17,true,12,21,9,41.89227,-87.61206
13022,5,17,true,183,172,-11,41.89227,-87.61205
99,5,17,true,26,17,-9,41.89255,-87.61449
TA1306000029,5,17,true,118,133,15,41.89256,-87.61449
13265,5,17,true,153,137,-16,41.89383,-87.64172
74,5,17,true,54,48,-6,41.89384,-87.64173
13045,5,17,true,237,202,-35,41.89403,-87.62931
110,5,17,true,47,46,-1,41.89406,-87.6293
13016,5,17,true,256,70,-186,41.89431,-87.62277
211,5,17,true,88,14,-74,41.89439,-87.62267
KA1503000041,5,17,true,163,110,-53,41.89452,-87.61798
142,5,17,true,40,18,-22,41.89453,-87.61806
92,5,17,true,14,17,3,41.89455,-87.65346
13196,5,17,true,80,69,-11,41.89455,-87.65345
TA1307000062,5,17,true,85,83,-2,41.89466,-87.63839
111,5,17,true,24,14,-10,41.89466,-87.63837
TA1306000012,5,17,true,257,236,-21,41.89475,-87.63438
53,5,17,true,55,57,2,41.89476,-87.63439
627,5,17,true,14,25,11,41.8948,-87.63231
KP1705001026,5,17,true,102,102,0,41.89483,-87.6323
16921,5,17,true,1,3,2,41.89488,-87.77459
16920,5,17,true,4,8,4,41.89495,-87.76491
KA1504000114,5,17,true,2,1,-1,41.89547,-87.70614
373,5,17,true,1,1,0,41.89548,-87.70614
659,5,17,true,6,9,3,41.8955,-87.68201
18058,5,17,true,24,40,16,41.8955,-87.68201
637,5,17,true,57,75,18,41.89563,-87.67209
128,5,17,true,14,19,5,41.89571,-87.67716
13132,5,17,true,71,97,26,41.89573,-87.67718
161,5,17,true,28,16,-12,41.89574,-87.62599
15530,5,17,true,115,100,-15,41.89575,-87.62596
18003,5,17,true,101,27,-74,41.89575,-87.62011
635,5,17,true,16,5,-11,41.89576,-87.62012
13247,5,17,true,59,82,23,41.89597,-87.66775
350,5,17,true,14,8,-6,41.89597,-87.66774
TA1305000020,5,17,true,89,90,1,41.89636,-87.65406
54,5,17,true,19,13,-6,41.89637,-87.65407
13289,5,17,true,60,86,26,41.89638,-87.661
86,5,17,true,21,25,4,41.89639,-87.661
337,5,17,true,26,16,-10,41.89659,-87.63096
13303,5,17,true,97,85,-12,41.89672,-87.63088
13017,5,17,true,110,96,-14,41.89676,-87.6357
31,5,17,true,27,17,-10,41.89677,-87.63572
13338,5,17,true,132,55,-77,41.89697,-87.62173
173,5,17,true,35,13,-22,41.89704,-87.62173
TA1307000061,5,17,true,77,69,-8,41.89745,-87.62873
106,5,17,true,20,13,-7,41.89746,-87.62874
25,5,17,true,21,13,-8,41.89751,-87.62354
13034,5,17,true,73,50,-23,41.89754,-87.62352
48,5,17,true,36,12,-24,41.89772,-87.64302
TA1306000009,5,17,true,137,57,-80,41.89772,-87.64299
620,5,17,true,82,68,-14,41.89817,-87.63754
KA1504000103,5,17,true,52,54,2,41.89842,-87.68659
374,5,17,true,7,18,11,41.89842,-87.68659
145,5,17,true,50,41,-9,41.89856,-87.62211
15529,5,17,true,146,99,-47,41.89858,-87.62206
140,5,17,true,27,40,13,41.89895,-87.6299
TA1307000128,5,17,true,174,182,8,41.89896,-87.6299
657,5,17,true,38,67,29,41.89918,-87.6722
KA1504000117,5,17,true,28,21,-7,41.89936,-87.64848
365,5,17,true,7,1,-6,41.89936,-87.64848
30,5,17,true,7,12,5,41.89964,-87.66789
13248,5,17,true,55,60,5,41.89964,-87.66788
46,5,17,true,9,10,1,41.89994,-87.63444
TA1306000011,5,17,true,63,55,-8,41.89994,-87.63443
364,5,17,true,12,6,-6,41.90023,-87.64299
KA1504000116,5,17,true,67,67,0,41.90023,-87.64299
17660,5,17,true,29,33,4,41.90036,-87.69671
622,5,17,true,6,7,1,41.90037,-87.69671
29,5,17,true,13,17,4,41.90069,-87.66259
13290,5,17,true,57,67,10,41.90069,-87.66259
13042,5,17,true,226,110,-116,41.90097,-87.62377
85,5,17,true,33,20,-13,41.90098,-87.62375
183,5,17,true,5,9,4,41.90133,-87.67744
TA1307000070,5,17,true,51,61,10,41.90133,-87.67742
KA1504000133,5,17,true,155,114,-41,41.90234,-87.62773
172,5,17,true,34,20,-14,41.90236,-87.62774
15654,5,17,true,13,3,-10,41.90271,-87.70923
510,5,17,true,3,3,0,41.90272,-87.70923
305,5,17,true,5,7,2,41.9028,-87.69005
13241,5,17,true,51,37,-14,41.9029,-87.68731
176,5,17,true,51,73,22,41.90291,-87.63141
TA1306000006,5,17,true,37,35,-2,41.90292,-87.63772
23,5,17,true,4,8,4,41.90292,-87.63772
TA1307000039,5,17,true,296,326,30,41.90294,-87.63137
658,5,17,true,60,26,-34,41.903,-87.6838
13256,5,17,true,32,20,-12,41.90302,-87.69749
216,5,17,true,8,6,-2,41.90302,-87.69749
17,5,17,true,26,33,7,41.90313,-87.67391
TA1305000034,5,17,true,69,87,18,41.90313,-87.67391
182,5,17,true,44,62,18,41.90317,-87.63442
KA1504000135,5,17,true,259,272,13,41.90319,-87.63439
13136,5,17,true,93,94,1,41.90326,-87.67845
130,5,17,true,16,23,7,41.90327,-87.67846
210,5,17,true,36,27,-9,41.90342,-87.66781
13061,5,17,true,167,179,12,41.90342,-87.66779
KA1504000079,5,17,true,69,99,30,41.9035,-87.64334
359,5,17,true,17,28,11,41.90458,-87.6497
138,5,17,true,17,16,-1,41.9046,-87.64057
TA1307000115,5,17,true,52,53,1,41.9046,-87.64056
291,5,17,true,27,38,11,41.90672,-87.63494
TA1308000049,5,17,true,154,212,58,41.90672,-87.6349
KA1504000134,5,17,true,92,109,17,41.90687,-87.6262
180,5,17,true,18,16,-2,41.90687,-87.62618
13224,5,17,true,85,69,-16,41.90706,-87.66725
333,5,17,true,7,22,15,41.90706,-87.66725
18069,5,17,true,31,3,-28,41.90722,-87.65563
666,5,17,true,2,1,-1,41.90723,-87.65564
TA1307000143,5,17,true,28,59,31,41.90762,-87.63854
236,5,17,true,3,4,1,41.90762,-87.63853
61,5,17,true,23,28,5,41.90764,-87.67254
13221,5,17,true,97,124,27,41.90765,-87.67254
159,5,17,true,2,3,1,41.90777,-87.68586
13245,5,17,true,22,24,2,41.90777,-87.68586
301,5,17,true,31,38,7,41.90796,-87.63203
TA1309000024,5,17,true,162,168,6,41.908,-87.63152
69,5,17,true,13,25,12,41.90939,-87.6777
TA1305000041,5,17,true,120,125,5,41.9094,-87.67769
508,5,17,true,6,3,-3,41.90964,-87.71664
15652,5,17,true,5,6,1,41.90965,-87.71664
331,5,17,true,157,178,21,41.90965,-87.64812
15653,5,17,true,18,15,-3,41.90979,-87.7053
509,5,17,true,8,8,0,41.9098,-87.70531
TA1305000037,5,17,true,62,72,10,41.91018,-87.67003
27,5,17,true,5,9,4,41.91019,-87.6435
TA1306000008,5,17,true,50,83,33,41.9102,-87.6435
16,5,17,true,12,17,5,41.91035,-87.67008
213,5,17,true,15,8,-7,41.91037,-87.68237
TA1308000005,5,17,true,43,54,11,41.91042,-87.68238
13258,5,17,true,29,19,-10,41.91043,-87.69718
276,5,17,true,6,9,3,41.91043,-87.69718
160,5,17,true,7,7,0,41.91054,-87.68957
13257,5,17,true,36,25,-11,41.91054,-87.68956
13154,5,17,true,128,118,-10,41.91054,-87.65312
20,5,17,true,31,20,-11,41.91055,-87.65313
13058,5,17,true,65,67,2,41.91059,-87.64942
60,5,17,true,19,21,2,41.91059,-87.64942
118,5,17,true,34,19,-15,41.91138,-87.63868
TA1307000038,5,17,true,84,118,34,41.91138,-87.63868
268,5,17,true,32,33,1,41.91172,-87.62681
LF-005,5,17,true,154,213,59,41.91172,-87.62681
126,5,17,true,11,11,0,41.91196,-87.63197
13128,5,17,true,46,50,4,41.91197,-87.63197
289,5,17,true,34,54,20,41.91209,-87.63472
TA1308000050,5,17,true,263,333,70,41.91211,-87.6347
13243,5,17,true,101,96,-5,41.91262,-87.6814
158,5,17,true,24,27,3,41.91262,-87.6814
315,5,17,true,2,5,3,41.91293,-87.66417
TA1309000032,5,17,true,13,41,28,41.91293,-87.66417
TA1306000032,5,17,true,109,102,-7,41.9137,-87.65285
93,5,17,true,34,37,3,41.91371,-87.65285
TA1307000166,5,17,true,87,89,2,41.91386,-87.64877
224,5,17,true,19,23,4,41.91386,-87.64877
511,5,17,true,5,6,1,41.914,-87.70515
15655,5,17,true,13,44,31,41.91401,-87.70514
641,5,17,true,3,3,0,41.91416,-87.71676
18017,5,17,true,9,16,7,41.91416,-87.71676
628,5,17,true,5,5,0,41.9146,-87.66796
18067,5,17,true,48,59,11,41.9146,-87.66796
28,5,17,true,10,17,7,41.91469,-87.64333
TA1306000007,5,17,true,36,58,22,41.91469,-87.64333
13068,5,17,true,61,75,14,41.91554,-87.68703
116,5,17,true,4,3,-1,41.91555,-87.68703
13179,5,17,true,169,244,75,41.9157,-87.63461
141,5,17,true,28,37,9,41.91571,-87.63461
219,5,17,true,15,11,-4,41.91598,-87.67733
13133,5,17,true,74,94,20,41.91598,-87.67733
58,5,17,true,11,27,16,41.91602,-87.66894
TA1305000039,5,17,true,73,108,35,41.9163,-87.66749
506,5,17,true,11,7,-4,41.91711,-87.71023
15650,5,17,true,20,25,5,41.91711,-87.71023
15651,5,17,true,43,36,-7,41.91752,-87.70181
507,5,17,true,7,7,0,41.91752,-87.70181
185,5,17,true,3,3,0,41.91774,-87.69143
13266,5,17,true,35,59,24,41.91774,-87.69142
TA1309000029,5,17,true,35,45,10,41.9178,-87.68245
309,5,17,true,9,5,-4,41.91789,-87.6865
TA1309000006,5,17,true,90,87,-3,41.91809,-87.64375
288,5,17,true,8,23,15,41.91809,-87.64375
223,5,17,true,7,13,6,41.91821,-87.65698
TA1307000163,5,17,true,90,83,-7,41.91821,-87.65696
94,5,17,true,37,42,5,41.91831,-87.6363
13146,5,17,true,184,244,60,41.91831,-87.63629
13059,5,17,true,140,161,21,41.91845,-87.65222
113,5,17,true,18,28,10,41.91846,-87.65222
13259,5,17,true,26,35,9,41.91852,-87.69744
259,5,17,true,8,8,0,41.91853,-87.69745
310,5,17,true,8,7,-1,41.91984,-87.68083
225,5,17,true,31,26,-5,41.91995,-87.64884
13192,5,17,true,98,130,32,41.91995,-87.64884
13288,5,17,true,35,52,17,41.92008,-87.67788
13242,5,17,true,39,42,3,41.92021,-87.69266
222,5,17,true,8,13,5,41.92023,-87.69265
307,5,17,true,10,15,5,41.92077,-87.66373
TA1309000030,5,17,true,61,66,5,41.92077,-87.66372
290,5,17,true,5,13,8,41.92152,-87.70734
13292,5,17,true,25,26,1,41.92152,-87.70733
TA1309000033,5,17,true,120,121,1,41.92158,-87.65381
13193,5,17,true,180,213,33,41.92182,-87.64412
144,5,17,true,30,50,20,41.92182,-87.64411
143,5,17,true,17,24,7,41.92217,-87.63891
13191,5,17,true,96,116,20,41.92217,-87.63891
327,5,17,true,24,32,8,41.92225,-87.65783
13084,5,17,true,41,76,35,41.92268,-87.69715
123,5,17,true,8,14,6,41.92268,-87.69714
LP-,5,17,true,45,60,15,41.92396,-87.63584
673,5,17,true,16,12,-4,41.92398,-87.63585
KA1504000140,5,17,true,26,23,-3,41.92409,-87.67646
505,5,17,true,2,7,5,41.92409,-87.67646
16010,5,17,true,1,15,14,41.92458,-87.72787
15648,5,17,true,19,23,4,41.92464,-87.68931
504,5,17,true,1,6,5,41.92464,-87.68931
503,5,17,true,2,6,4,41.92483,-87.71451
KA1504000090,5,17,true,12,15,3,41.92483,-87.7145
TA1307000001,5,17,true,101,90,-11,41.92535,-87.66581
188,5,17,true,15,20,5,41.92536,-87.66581
TA1306000026,5,17,true,115,83,-32,41.92558,-87.65842
87,5,17,true,15,31,16,41.92559,-87.65843
TA1306000016,5,17,true,162,113,-49,41.9256,-87.65371
67,5,17,true,24,14,-10,41.9256,-87.65371
313,5,17,true,35,29,-6,41.9257,-87.64246
TA1309000019,5,17,true,148,170,22,41.92586,-87.63897
TA1309000058,5,17,true,186,172,-14,41.92591,-87.64927
127,5,17,true,38,42,4,41.92592,-87.64927
TA1308000001,5,17,true,210,177,-33,41.92627,-87.63086
177,5,17,true,29,32,3,41.92627,-87.63086
502,5,17,true,3,8,5,41.92667,-87.69772
15646,5,17,true,16,35,19,41.92668,-87.6977
13124,5,17,true,29,27,-2,41.92675,-87.63444
34,5,17,true,3,4,1,41.92675,-87.63444
302,5,17,true,14,22,8,41.92859,-87.65421
TA1309000023,5,17,true,118,132,14,41.9287,-87.65383
TA1307000113,5,17,true,62,70,8,41.92878,-87.66391
190,5,17,true,9,19,10,41.92878,-87.6639
166,5,17,true,9,5,-4,41.92883,-87.66853
13296,5,17,true,57,38,-19,41.92883,-87.66852
343,5,17,true,9,13,4,41.92889,-87.65898
TA1309000059,5,17,true,46,71,25,41.92889,-87.65898
349,5,17,true,20,22,2,41.92915,-87.6491
TA1309000061,5,17,true,130,163,33,41.92915,-87.64909
258,5,17,true,4,9,5,41.92946,-87.68417
TA1308000031,5,17,true,27,46,19,41.92946,-87.68417
340,5,17,true,24,25,1,41.92956,-87.64313
TA1305000014,5,17,true,146,163,17,41.92956,-87.64313
260,5,17,true,15,21,6,41.92958,-87.70791
13085,5,17,true,46,90,44,41.92958,-87.70789
15643,5,17,true,23,10,-13,41.93057,-87.7238
TA1307000142,5,17,true,147,152,5,41.93125,-87.64432
220,5,17,true,28,28,0,41.93125,-87.64431
13276,5,17,true,92,134,42,41.93132,-87.63874
324,5,17,true,33,35,2,41.93173,-87.64179
15645,5,17,true,16,14,-2,41.93191,-87.70121
501,5,17,true,6,4,-2,41.93191,-87.70121
163,5,17,true,5,13,8,41.93191,-87.67784
13271,5,17,true,43,37,-6,41.93192,-87.67784
152,5,17,true,19,28,9,41.93221,-87.65864
TA1307000064,5,17,true,136,145,9,41.93222,-87.65864
TA1306000014,5,17,true,143,135,-8,41.93242,-87.65271
13,5,17,true,23,24,1,41.93242,-87.65271
329,5,17,true,20,35,15,41.93258,-87.63642
TA1309000039,5,17,true,140,194,54,41.93258,-87.63642
13294,5,17,true,63,52,-11,41.9326,-87.66595
319,5,17,true,9,9,0,41.93292,-87.67217
332,5,17,true,23,36,13,41.93313,-87.64776
TA1309000036,5,17,true,98,121,23,41.93313,-87.64776
15644,5,17,true,13,10,-3,41.93534,-87.71687
500,5,17,true,3,4,1,41.93534,-87.71686
TA1307000006,5,17,true,95,92,-3,41.93571,-87.6636
153,5,17,true,19,22,3,41.93575,-87.66364
162,5,17,true,9,3,-6,41.93588,-87.67844
13268,5,17,true,20,35,15,41.93588,-87.67843
250,5,17,true,20,11,-9,41.93609,-87.66984
13269,5,17,true,44,67,23,41.93609,-87.66983
TA1307000052,5,17,true,128,109,-19,41.93628,-87.65266
115,5,17,true,21,32,11,41.93628,-87.65266
156,5,17,true,38,49,11,41.9365,-87.64756
TA1307000136,5,17,true,166,165,-1,41.9365,-87.64755
TA1307000041,5,17,true,138,109,-29,41.93669,-87.63683
157,5,17,true,27,28,1,41.9367,-87.63683
13137,5,17,true,192,217,25,41.9376,-87.6441
300,5,17,true,43,42,-1,41.93761,-87.6441
15642,5,17,true,14,15,1,41.93843,-87.69801
498,5,17,true,2,9,7,41.93843,-87.69801
154,5,17,true,13,21,8,41.93912,-87.66384
664,5,17,true,7,11,4,41.93934,-87.68327
KA17018068,5,17,true,17,28,11,41.93935,-87.68327
TA1309000042,5,17,true,81,73,-8,41.93937,-87.66836
131,5,17,true,16,16,0,41.93937,-87.66835
KA150400009X,5,17,true,8,14,6,41.9394,-87.71159
15640,5,17,true,6,4,-2,41.93941,-87.72357
497,5,17,true,1,2,1,41.93941,-87.71159
13229,5,17,true,57,81,24,41.93946,-87.66376
226,5,17,true,15,18,3,41.93972,-87.65886
TA1308000019,5,17,true,92,89,-3,41.93973,-87.65886
296,5,17,true,32,27,-5,41.9401,-87.64546
13277,5,17,true,98,121,23,41.9401,-87.64546
TA1307000134,5,17,true,245,144,-101,41.94016,-87.65303
117,5,17,true,46,45,-1,41.94016,-87.65302
13143,5,17,true,27,27,0,41.94059,-87.67853
334,5,17,true,32,24,-8,41.94076,-87.63919
TA1309000049,5,17,true,121,129,8,41.94077,-87.63919
308,5,17,true,8,10,2,41.94152,-87.68471
493,5,17,true,3,3,0,41.94304,-87.68729
15634,5,17,true,17,19,2,41.94304,-87.68729
TA1307000138,5,17,true,80,96,16,41.94334,-87.67094
230,5,17,true,10,15,5,41.94335,-87.67093
13144,5,17,true,50,37,-13,41.9434,-87.67964
299,5,17,true,29,35,6,41.94368,-87.64894
TA1309000025,5,17,true,116,163,47,41.94368,-87.64894
229,5,17,true,18,34,16,41.94372,-87.66401
13071,5,17,true,131,128,-3,41.94373,-87.66401
632,5,17,true,130,188,58,41.94453,-87.6547
303,5,17,true,37,30,-7,41.94522,-87.64702
490,5,17,true,1,5,4,41.94523,-87.70664
15631,5,17,true,16,19,3,41.94524,-87.70665
13278,5,17,true,147,147,0,41.94553,-87.64644
330,5,17,true,7,1,-6,41.94618,-87.67331
TA1309000050,5,17,true,21,33,12,41.94618,-87.67331
488,5,17,true,3,3,0,41.94627,-87.73105
492,5,17,true,4,3,-1,41.94662,-87.68337
491,5,17,true,5,2,-3,41.94664,-87.69463
15632,5,17,true,2,4,2,41.94664,-87.69463
KA1504000143,5,17,true,21,14,-7,41.94664,-87.68337
KA1504000142,5,17,true,7,8,1,41.94735,-87.71759
16994,5,17,true,2,3,1,41.94784,-87.74
227,5,17,true,15,31,16,41.94813,-87.66397
13235,5,17,true,141,111,-30,41.94814,-87.66396
304,5,17,true,23,30,7,41.94878,-87.64922
13253,5,17,true,42,41,-1,41.9488,-87.67527
257,5,17,true,9,17,8,41.9488,-87.67527
13325,5,17,true,150,167,17,41.94907,-87.64863
114,5,17,true,17,25,8,41.94935,-87.65451
TA1307000126,5,17,true,127,121,-6,41.94936,-87.65451
232,5,17,true,26,32,6,41.94943,-87.64645
TA1307000150,5,17,true,147,173,26,41.94945,-87.64646
640,5,17,true,1,2,1,41.94993,-87.71396
18016,5,17,true,5,6,1,41.94993,-87.71395
347,5,17,true,4,3,-1,41.95068,-87.6687
13319,5,17,true,42,35,-7,41.95069,-87.6687
TA1307000127,5,17,true,93,88,-5,41.9508,-87.65918
165,5,17,true,12,18,6,41.95081,-87.65918
15628,5,17,true,10,13,3,41.95216,-87.69806
487,5,17,true,4,7,3,41.95216,-87.69806
318,5,17,true,12,12,0,41.95254,-87.6735
13323,5,17,true,95,90,-5,41.95282,-87.65
256,5,17,true,15,14,-1,41.95282,-87.65
15624,5,17,true,10,4,-6,41.95339,-87.73199
483,5,17,true,3,3,0,41.9534,-87.73199
314,5,17,true,3,2,-1,41.9535,-87.69199
485,5,17,true,3,2,-1,41.95361,-87.70933
KA1504000096,5,17,true,4,7,3,41.95361,-87.70932
590,5,17,true,1,1,0,41.95374,-87.74056
KA1504000139,5,17,true,3,4,1,41.954,-87.71909
484,5,17,true,3,4,1,41.954,-87.71907
TA1309000043,5,17,true,40,50,10,41.95417,-87.66434
13063,5,17,true,118,83,-35,41.95424,-87.65441
240,5,17,true,17,16,-1,41.95424,-87.65441
486,5,17,true,3,2,-1,41.95431,-87.68607
KA1504000158,5,17,true,11,12,1,41.95432,-87.68607
254,5,17,true,28,25,-3,41.95438,-87.64806
TA1308000022,5,17,true,118,99,-19,41.95438,-87.64805
16991,5,17,true,9,6,-3,41.95448,-87.7496
244,5,17,true,12,11,-1,41.95466,-87.67391
TA1307000149,5,17,true,61,65,4,41.95467,-87.67392
298,5,17,true,11,9,-2,41.95601,-87.68021
TA1309000026,5,17,true,32,48,16,41.95601,-87.6802
246,5,17,true,5,6,1,41.95606,-87.66885
13249,5,17,true,13,17,4,41.95606,-87.66885
312,5,17,true,16,24,8,41.95637,-87.6563
292,5,17,true,10,5,-5,41.95709,-87.6642
TA1308000047,5,17,true,24,20,-4,41.95709,-87.6642
13379,5,17,true,101,106,5,41.95786,-87.6495
TA1309000018,5,17,true,26,22,-4,41.95791,-87.67357
316,5,17,true,9,8,-1,41.95841,-87.69401
306,5,17,true,11,10,-1,41.9585,-87.655
TA1309000027,5,17,true,55,62,7,41.9585,-87.65499
592,5,17,true,8,3,-5,41.96065,-87.74538
13389,5,17,true,66,59,-7,41.961,-87.64958
245,5,17,true,15,16,1,41.96101,-87.64958
15621,5,17,true,14,19,5,41.96103,-87.70586
480,5,17,true,3,2,-1,41.96104,-87.70586
KA1706005015,5,17,true,1,3,2,41.96108,-87.73569
481,5,17,true,3,4,1,41.96108,-87.69544
15622,5,17,true,10,21,11,41.96108,-87.69544
KA1504000164,5,17,true,4,7,3,41.96109,-87.72897
KA1504000097,5,17,true,13,16,3,41.96116,-87.71658
238,5,17,true,12,20,8,41.96141,-87.6762
TA1307000144,5,17,true,45,52,7,41.96142,-87.6762
297,5,17,true,3,3,0,41.9615,-87.67141
TA1309000021,5,17,true,14,27,13,41.9615,-87.6714
482,5,17,true,2,9,7,41.96154,-87.69117
15623,5,17,true,16,26,10,41.96154,-87.69117
234,5,17,true,10,10,0,41.96158,-87.6661
KA1503000022,5,17,true,53,42,-11,41.96158,-87.66609
231,5,17,true,21,24,3,41.96163,-87.65464
TA1307000107,5,17,true,88,87,-1,41.96164,-87.65464
TA1307000156,5,17,true,30,38,8,41.96301,-87.68479
243,5,17,true,15,9,-6,41.96302,-87.68479
TA1309000012,5,17,true,28,32,4,41.96325,-87.67928
249,5,17,true,17,7,-10,41.96398,-87.63818
TA1308000012,5,17,true,85,106,21,41.96398,-87.63818
293,5,17,true,13,16,3,41.96521,-87.65822
13074,5,17,true,87,75,-12,41.96521,-87.6582
639,5,17,true,80,76,-4,41.96584,-87.64538
477,5,17,true,3,5,2,41.96587,-87.70083
KA1504000127,5,17,true,8,20,12,41.96587,-87.70083
KA1504000093,5,17,true,27,25,-2,41.96587,-87.69365
478,5,17,true,3,9,6,41.96587,-87.69364
TA1307000140,5,17,true,36,40,4,41.96643,-87.68865
239,5,17,true,3,10,7,41.9665,-87.68843
326,5,17,true,16,14,-2,41.96665,-87.67113
KA1504000126,5,17,true,4,7,3,41.96668,-87.70807
TA1309000014,5,17,true,47,62,15,41.96709,-87.66744
TA1307000158,5,17,true,50,25,-25,41.9671,-87.67904
242,5,17,true,14,3,-11,41.9671,-87.67904
251,5,17,true,13,5,-8,41.96796,-87.65
TA1307000119,5,17,true,38,31,-7,41.96796,-87.65
15615,5,17,true,17,5,-12,41.96835,-87.71183
474,5,17,true,2,3,1,41.96835,-87.71182
323,5,17,true,5,8,3,41.96869,-87.66034
253,5,17,true,2,8,6,41.96883,-87.65765
TA1308000021,5,17,true,43,55,12,41.96883,-87.65765
475,5,17,true,8,16,8,41.96885,-87.69611
KA1504000080,5,17,true,12,28,16,41.96887,-87.69609
TA1309000015,5,17,true,17,27,10,41.96889,-87.68401
TA1309000066,5,17,true,130,116,-14,41.9691,-87.67423
344,5,17,true,20,22,2,41.9691,-87.67423
TA1309000041,5,17,true,53,31,-22,41.96951,-87.65471
KA1504000171,5,17,true,59,39,-20,41.97161,-87.65016
465,5,17,true,22,11,-11,41.97161,-87.65016
325,5,17,true,7,23,16,41.9728,-87.67186
TA1309000035,5,17,true,89,125,36,41.97335,-87.66785
295,5,17,true,11,19,8,41.97378,-87.65972
13108,5,17,true,68,52,-16,41.97379,-87.65971
KA1504000078,5,17,true,14,30,16,41.97491,-87.69258
472,5,17,true,3,9,6,41.97492,-87.69262
464,5,17,true,9,7,-2,41.97562,-87.67945
KA1504000149,5,17,true,16,31,15,41.97562,-87.67945
471,5,17,true,4,2,-2,41.97564,-87.70143
KA1504000160,5,17,true,5,12,7,41.97564,-87.70143
470,5,17,true,1,1,0,41.97567,-87.70927
KA1504000128,5,17,true,4,8,4,41.97567,-87.70927
463,5,17,true,13,19,6,41.978,-87.66805
KA1504000146,5,17,true,59,72,13,41.978,-87.66805
13109,5,17,true,64,61,-3,41.97835,-87.65976
294,5,17,true,12,20,8,41.97835,-87.65976
KA1504000147,5,17,true,24,26,2,41.97976,-87.67754
462,5,17,true,6,5,-1,41.97977,-87.67755
655,5,17,true,21,19,-2,41.97987,-87.68194
KA1504000161,5,17,true,6,6,0,41.98038,-87.71612
KA1504000167,5,17,true,7,3,-4,41.98206,-87.70895
460,5,17,true,13,11,-2,41.98358,-87.66916
KA1504000151,5,17,true,46,82,36,41.98359,-87.66916
468,5,17,true,2,1,-1,41.98367,-87.69642
15585,5,17,true,2,7,5,41.98367,-87.69642
459,5,17,true,21,33,12,41.98403,-87.65231
KA1504000152,5,17,true,89,101,12,41.98403,-87.65231
15578,5,17,true,62,40,-22,41.98405,-87.66027
461,5,17,true,12,4,-8,41.98405,-87.66027
15575,5,17,true,49,65,16,41.98975,-87.66014
458,5,17,true,5,13,8,41.98975,-87.66013
455,5,17,true,1,1,0,41.99024,-87.69338
KA1504000130,5,17,true,3,3,0,41.99024,-87.69338
457,5,17,true,4,3,-1,41.99052,-87.66982
KA1504000148,5,17,true,18,28,10,41.99086,-87.66971
456,5,17,true,1,4,3,41.99117,-87.68359
KA1504000155,5,17,true,4,5,1,41.99118,-87.68359
452,5,17,true,2,2,0,41.99417,-87.68945
KA1504000129,5,17,true,4,6,2,41.99417,-87.68945
15571,5,17,true,66,34,-32,41.99478,-87.66028
454,5,17,true,15,12,-3,41.99478,-87.66027
KA1504000156,5,17,true,18,12,-6,41.99925,-87.67137
453,5,17,true,4,1,-3,41.99925,-87.67137
RP-009,5,17,true,45,27,-18,42.00107,-87.66122
451,5,17,true,2,6,4,42.00108,-87.66123
450,5,17,true,2,1,-1,42.00179,-87.68883
RP-001,5,17,true,5,8,3,42.00179,-87.68883
RP-008,5,17,true,9,17,8,42.00446,-87.6724
RP-002,5,17,true,2,7,5,42.00456,-87.68065
448,5,17,true,1,1,0,42.00456,-87.68064
660,5,17,true,19,21,2,42.00458,-87.66143
354,5,17,true,5,6,1,42.00587,-87.66802
KA1504000175,5,17,true,18,22,4,42.00797,-87.66549
447,5,17,true,5,7,2,42.00797,-87.66548
RP-005,5,17,true,25,21,-4,42.0086,-87.69047
467,5,17,true,4,6,2,42.0086,-87.69047
432,5,17,true,5,1,-4,42.00907,-87.67423
KA1504000162,5,17,true,23,10,-13,42.00907,-87.67422
KA1504000159,5,17,true,14,17,3,42.01059,-87.66241
466,5,17,true,1,1,0,42.01213,-87.68292
RP-006,5,17,true,4,6,2,42.01213,-87.68292
RP-004,5,17,true,5,3,-2,42.01234,-87.68825
RP-007,5,17,true,6,9,3,42.01256,-87.67431
525,5,17,true,13,24,11,42.01272,-87.66605
517,5,17,true,12,13,1,42.01597,-87.675
520,5,17,true,28,27,-1,42.01597,-87.66859
519,5,17,true,3,2,-1,42.01696,-87.67773
527,5,17,true,2,2,0,42.01892,-87.69004
515,5,17,true,13,18,5,42.01915,-87.67356
514,5,17,true,5,5,0,42.01927,-87.68452
16806,5,17,true,2,7,5,42.01953,-87.66955
523,5,17,true,12,21,9,42.02089,-87.66505
662,5,17,true,4,5,1,42.02354,-87.69961
598,5,17,true,6,9,3,42.02578,-87.68411
597,5,17,true,2,4,2,42.03256,-87.67914
E002,5,17,true,18,38,20,42.03256,-87.67912
E011,5,17,true,4,4,0,42.03473,-87.69912
599,5,17,true,22,18,-4,42.03972,-87.69942
625,5,17,true,3,5,2,42.04163,-87.6808
596,5,17,true,58,62,4,42.04822,-87.68348
600,5,17,true,13,31,18,42.04831,-87.6983
E008,5,17,true,14,13,-1,42.05049,-87.67782
603,5,17,true,1,3,2,42.05049,-87.67782
605,5,17,true,38,11,-27,42.05294,-87.67342
661,5,17,true,10,6,-4,42.05704,-87.68657
604,5,17,true,43,18,-25,42.05824,-87.67744
E006,5,17,true,5,2,-3,42.06367,-87.69871
601,5,17,true,6,5,-1,42.06368,-87.69871
E007,5,17,true,3,2,-1,42.06431,-87.68615
602,5,17,true,4,2,-2,42.06431,-87.68614
663,5,17,true,1,2,1,42.06483,-87.71531
E014,5,17,true,2,7,5,42.06483,-87.71531
20243,6,9,false,1,1,0,41.68701,-87.62111
20203,6,9,false,1,1,0,41.69131,-87.71286
20204,6,9,false,1,1,0,41.6924,-87.70096
20108,6,9,false,1,1,0,41.69921,-87.66888
20113,6,9,false,3,1,-2,41.70728,-87.60767
20224,6,9,false,2,1,-1,41.71371,-87.53083
20227,6,9,false,1,1,0,41.7179,-87.56461
20103,6,9,false,3,3,0,41.7281,-87.66757
20229,6,9,false,2,2,0,41.73734,-87.54849
585,6,9,false,1,1,0,41.74344,-87.60485
574,6,9,false,1,1,0,41.75095,-87.61379
580,6,9,false,1,1,0,41.75172,-87.55282
KA1503000028,6,9,false,1,1,0,41.75712,-87.57585
KA1503000049,6,9,false,1,1,0,41.75788,-87.54938
KA1503000019,6,9,false,1,1,0,41.75867,-87.5869
KA1503000020,6,9,false,1,1,0,41.76223,-87.55923
15599,6,9,false,2,1,-1,41.76551,-87.61693
652,6,9,false,1,2,1,41.766,-87.61173
KA1503000002,6,9,false,7,6,-1,41.76641,-87.5657
KA1503000018,6,9,false,3,5,2,41.76663,-87.57645
KA1503000047,6,9,false,2,3,1,41.76929,-87.62821
KA1503000023,6,9,false,11,2,-9,41.77346,-87.58534
KA1503000030,6,9,false,2,3,1,41.77352,-87.57722
KA1503000029,6,9,false,8,2,-6,41.77364,-87.56747
KA1503000021,6,9,false,2,3,1,41.77888,-87.58665
KA1503000053,6,9,false,3,1,-2,41.78009,-87.61595
KA1503000046,6,9,false,2,1,-1,41.78041,-87.59141
KA1503000054,6,9,false,2,2,0,41.78061,-87.60582
15491,6,9,false,4,7,3,41.78096,-87.57624
101,6,9,false,3,1,-2,41.78105,-87.57611
KA1503000033,6,9,false,4,3,-1,41.78411,-87.61329
426,6,9,false,12,4,-8,41.7851,-87.60108
KA1503000014,6,9,false,17,9,-8,41.7851,-87.60108
561,6,9,false,1,1,0,41.7857,-87.67409
KA1503000070,6,9,false,11,8,-3,41.78794,-87.58831
328,6,9,false,7,1,-6,41.78872,-87.6013
TA1309000011,6,9,false,4,5,1,41.78873,-87.60131
423,6,9,false,2,3,1,41.79148,-87.59988
KA1503000071,6,9,false,5,15,10,41.79148,-87.59988
KA1503000075,6,9,false,23,4,-19,41.79156,-87.60785
422,6,9,false,1,1,0,41.79156,-87.60785
424,6,9,false,2,2,0,41.79174,-87.58395
KA1503000074,6,9,false,11,21,10,41.79174,-87.58395
TA1309000063,6,9,false,15,5,-10,41.79325,-87.5878
345,6,9,false,1,5,4,41.79326,-87.5878
420,6,9,false,8,11,3,41.79429,-87.60145
KA1504000076,6,9,false,17,11,-6,41.7943,-87.60145
TA1307000160,6,9,false,5,2,-3,41.79485,-87.61873
KA1503000013,6,9,false,1,1,0,41.79498,-87.63312
247,6,9,false,5,6,1,41.79522,-87.58077
TA1308000009,6,9,false,39,30,-9,41.79522,-87.58075
TA1307000164,6,9,false,17,8,-9,41.79527,-87.59647
248,6,9,false,5,1,-4,41.79528,-87.59647
KA1503000052,6,9,false,22,3,-19,41.79935,-87.60097
418,6,9,false,3,2,-1,41.79936,-87.60097
KA1503000059,6,9,false,34,18,-16,41.79952,-87.58643
419,6,9,false,3,4,1,41.79952,-87.58643
TA1309000037,6,9,false,23,15,-8,41.79957,-87.59474
15470,6,9,false,10,3,-7,41.80228,-87.61807
415,6,9,false,1,2,1,41.80228,-87.61807
417,6,9,false,3,1,-2,41.80242,-87.5869
KA1503000007,6,9,false,22,15,-7,41.80242,-87.58689
13398,6,9,false,23,11,-12,41.80256,-87.59035
121,6,9,false,6,6,0,41.80256,-87.59035
TA1309000067,6,9,false,3,4,1,41.80303,-87.60661
322,6,9,false,3,2,-1,41.80321,-87.59849
KA1503000069,6,9,false,3,2,-1,41.80579,-87.59247
TA1308000035,6,9,false,7,3,-4,41.80944,-87.59188
TA1308000002,6,9,false,9,1,-8,41.80983,-87.59937
TA1308000007,6,9,false,12,5,-7,41.80984,-87.61628
KA1503000065,6,9,false,2,3,1,41.81409,-87.59701
KA1503000027,6,9,false,8,5,-3,41.81666,-87.61942
355,6,9,false,1,1,0,41.82217,-87.63032
TA1308000038,6,9,false,12,6,-6,41.82298,-87.6071
546,6,9,false,4,6,2,41.82319,-87.67661
13420,6,9,false,6,2,-4,41.82459,-87.61678
18022,6,9,false,1,2,1,41.82672,-87.68315
KA1503000066,6,9,false,4,1,-3,41.83011,-87.67031
TA1308000045,6,9,false,2,1,-1,41.83062,-87.64129
TA1308000043,6,9,false,7,5,-2,41.83066,-87.64715
KA1503000005,6,9,false,2,7,5,41.83079,-87.6325
TA1307000129,6,9,false,4,3,-1,41.83104,-87.62683
406,6,9,false,5,2,-3,41.83127,-87.6088
KA1503000004,6,9,false,12,13,1,41.83127,-87.6088
13345,6,9,false,5,11,6,41.83138,-87.61803
15445,6,9,false,2,1,-1,41.83453,-87.63183
13217,6,9,false,5,1,-4,41.83488,-87.61792
13215,6,9,false,10,1,-9,41.83634,-87.6135
263,6,9,false,1,1,0,41.8364,-87.61348
TA1308000046,6,9,false,3,7,4,41.83779,-87.65115
TA1309000055,6,9,false,12,11,-1,41.8382,-87.64514
KA1503000038,6,9,false,4,3,-1,41.83845,-87.6354
TA1307000048,6,9,false,39,31,-8,41.83855,-87.60821
150,6,9,false,7,10,3,41.83855,-87.60821
TA1308000036,6,9,false,10,4,-6,41.83883,-87.62186
KA1503000040,6,9,false,4,1,-3,41.84164,-87.65744
13213,6,9,false,5,2,-3,41.84171,-87.62694
237,6,9,false,2,5,3,41.84204,-87.61697
TA1307000139,6,9,false,6,6,0,41.84205,-87.61698
15443,6,9,false,4,1,-3,41.84275,-87.63549
15691,6,9,false,1,1,0,41.84449,-87.70203
TA1307000005,6,9,false,7,4,-3,41.84569,-87.6225
TA1308000013,6,9,false,1,1,0,41.84719,-87.64681
15687,6,9,false,2,1,-1,41.8481,-87.71508
TA1308000014,6,9,false,2,1,-1,41.84953,-87.64059
TA1308000026,6,9,false,3,5,2,41.85008,-87.63214
TA1305000004,6,9,false,44,12,-32,41.8514,-87.61884
62,6,9,false,2,1,-1,41.85141,-87.61884
42,6,9,false,1,1,0,41.85261,-87.62653
TA1305000001,6,9,false,21,4,-17,41.85262,-87.6265
13075,6,9,false,22,20,-2,41.8531,-87.63192
15685,6,9,false,4,2,-2,41.85399,-87.71511
13091,6,9,false,2,4,2,41.85409,-87.68585
15546,6,9,false,11,9,-2,41.85416,-87.61916
13307,6,9,false,8,5,-3,41.85489,-87.66359
208,6,9,false,1,1,0,41.85489,-87.66359
13089,6,9,false,3,2,-1,41.85497,-87.67567
4,6,9,false,8,4,-4,41.85627,-87.61334
15545,6,9,false,52,49,-3,41.85627,-87.61334
SL-013,6,9,false,4,3,-1,41.85659,-87.62755
SL-006,6,9,false,5,3,-2,41.8568,-87.63387
13135,6,9,false,7,12,5,41.85753,-87.66157
338,6,9,false,2,1,-1,41.85758,-87.61956
13102,6,9,false,32,20,-12,41.85762,-87.61942
13150,6,9,false,33,28,-5,41.85783,-87.62455
13099,6,9,false,11,3,-8,41.85784,-87.64627
TA1307000159,6,9,false,3,13,10,41.8579,-87.6687
13163,6,9,false,11,4,-7,41.85808,-87.65108
13164,6,9,false,7,5,-2,41.85818,-87.65648
15,6,9,false,3,1,-2,41.85819,-87.65648
SL-012,6,9,false,9,12,3,41.86038,-87.62581
72,6,9,false,1,1,0,41.86039,-87.62581
13304,6,9,false,8,3,-5,41.86126,-87.65659
TA1306000002,6,9,false,8,1,-7,41.86238,-87.65108
TA1307000124,6,9,false,55,42,-13,41.86411,-87.62372
168,6,9,false,5,1,-4,41.86415,-87.62372
282,6,9,false,1,1,0,41.86487,-87.64708
13165,6,9,false,1,1,0,41.86505,-87.65697
13354,6,9,false,3,3,0,41.86524,-87.66651
97,6,9,false,1,7,6,41.86531,-87.6179
13029,6,9,false,5,66,61,41.86531,-87.6179
13431,6,9,false,31,57,26,41.8661,-87.60728
15682,6,9,false,4,1,-3,41.86651,-87.70649
KA1504000101,6,9,false,1,1,0,41.86651,-87.68466
WL-008,6,9,false,21,16,-5,41.86712,-87.64108
57,6,9,false,4,2,-2,41.86712,-87.64107
TA1305000002,6,9,false,77,46,-31,41.86721,-87.62597
3,6,9,false,3,7,4,41.86723,-87.61536
15544,6,9,false,76,171,95,41.86723,-87.61536
TA1305000017,6,9,false,6,3,-3,41.86734,-87.64863
KA1706005007,6,9,false,18,16,-2,41.86749,-87.63219
626,6,9,false,3,2,-1,41.86749,-87.63219
SL-005,6,9,false,120,117,-3,41.8679,-87.62304
255,6,9,false,34,9,-25,41.86791,-87.62304
644,6,9,false,11,5,-6,41.86859,-87.68625
13139,6,9,false,6,2,-4,41.86893,-87.65913
13160,6,9,false,9,10,1,41.86947,-87.65548
22,6,9,false,1,6,5,41.86947,-87.65548
414,6,9,false,1,3,2,41.87023,-87.63947
15550,6,9,false,7,20,13,41.87024,-87.63947
TA1309000010,6,9,false,64,32,-32,41.87074,-87.62574
SL-009,6,9,false,26,13,-13,41.87081,-87.63121
342,6,9,false,5,1,-4,41.87127,-87.6737
TA1309000064,6,9,false,9,8,-1,41.87127,-87.67369
15542,6,9,false,1,1,0,41.87146,-87.64095
TA1307000130,6,9,false,5,2,-3,41.87178,-87.65103
TA1307000121,6,9,false,5,5,0,41.87184,-87.64664
41,6,9,false,2,1,-1,41.87209,-87.62957
SL-008,6,9,false,72,39,-33,41.87209,-87.62956
13332,6,9,false,17,4,-13,41.87219,-87.6615
394,6,9,false,6,1,-5,41.87226,-87.63484
175,6,9,false,13,4,-9,41.87255,-87.63359
SL-011,6,9,false,45,24,-21,41.87256,-87.63356
623,6,9,false,101,53,-48,41.87272,-87.62399
KA1504000104,6,9,false,3,4,1,41.87296,-87.66912
383,6,9,false,1,1,0,41.87297,-87.66912
320,6,9,false,1,1,0,41.87327,-87.66402
5,6,9,false,3,1,-2,41.87403,-87.6277
SL-007,6,9,false,26,19,-7,41.87404,-87.6277
13326,6,9,false,1,1,0,41.87425,-87.63958
321,6,9,false,5,4,-1,41.87427,-87.63257
TA1306000025,6,9,false,5,2,-3,41.87464,-87.65703
32,6,9,false,3,2,-1,41.87464,-87.65703
15668,6,9,false,7,3,-4,41.87471,-87.68642
13028,6,9,false,14,5,-9,41.87475,-87.64981
13081,6,9,false,4,1,-3,41.87501,-87.67326
122,6,9,false,3,2,-1,41.87501,-87.67325
89,6,9,false,1,2,1,41.87501,-87.6331
SL-010,6,9,false,8,4,-4,41.87501,-87.63309
15541,6,9,false,53,34,-19,41.8758,-87.62086
13037,6,9,false,9,3,-6,41.87588,-87.64078
TA1305000009,6,9,false,10,8,-2,41.87593,-87.63068
TA1305000010,6,9,false,29,14,-15,41.87623,-87.62444
45,6,9,false,2,2,0,41.87623,-87.62444
624,6,9,false,28,20,-8,41.87626,-87.62923
2,6,9,false,6,9,3,41.87649,-87.62051
33,6,9,false,5,1,-4,41.87715,-87.62786
TA1305000035,6,9,false,10,10,0,41.87716,-87.62787
13138,6,9,false,4,7,3,41.87723,-87.63941
631,6,9,false,3,1,-2,41.87761,-87.6739
15539,6,9,false,24,12,-12,41.87763,-87.64405
13158,6,9,false,23,19,-4,41.87764,-87.64957
134,6,9,false,11,2,-9,41.87764,-87.64954
13157,6,9,false,23,16,-7,41.87773,-87.6548
21,6,9,false,4,2,-2,41.87773,-87.6548
TA1305000025,6,9,false,29,18,-11,41.87773,-87.63528
36,6,9,false,4,2,-2,41.87776,-87.63525
TA1309000002,6,9,false,38,16,-22,41.87784,-87.62408
284,6,9,false,1,2,1,41.87784,-87.62408
545,6,9,false,1,1,0,41.87792,-87.73583
13206,6,9,false,14,8,-6,41.87794,-87.66201
146,6,9,false,1,1,0,41.87794,-87.66201
TA1309000004,6,9,false,8,7,-1,41.87811,-87.63184
107,6,9,false,3,2,-1,41.87822,-87.644
638,6,9,false,18,7,-11,41.87827,-87.64078
TA1305000005,6,9,false,13,10,-3,41.87924,-87.62975
13011,6,9,false,21,15,-6,41.87931,-87.63993
TA1309000008,6,9,false,23,31,8,41.87933,-87.6355
192,6,9,false,5,3,-2,41.87935,-87.63997
KA1503000034,6,9,false,17,5,-12,41.87938,-87.63197
39,6,9,false,1,1,0,41.87948,-87.62571
KA1503000015,6,9,false,24,12,-12,41.87948,-87.6257
15667,6,9,false,5,4,-1,41.8798,-87.68609
287,6,9,false,5,4,-1,41.88017,-87.63527
TA1309000007,6,9,false,13,12,-1,41.88022,-87.63526
WL-011,6,9,false,32,10,-22,41.88034,-87.64273
73,6,9,false,5,8,3,41.8804,-87.64273
13156,6,9,false,14,12,-2,41.88042,-87.65554
534,6,9,false,1,2,1,41.88085,-87.72793
13300,6,9,false,231,151,-80,41.88097,-87.61675
76,6,9,false,23,24,1,41.88098,-87.61675
13008,6,9,false,135,169,34,41.88105,-87.62408
90,6,9,false,19,14,-5,41.88107,-87.62409
TA1305000006,6,9,false,41,24,-17,41.88122,-87.6296
13134,6,9,false,5,6,1,41.88138,-87.67493
13056,6,9,false,11,3,-8,41.88168,-87.63951
198,6,9,false,9,2,-7,41.88187,-87.6488
TA1307000120,6,9,false,66,48,-18,41.88188,-87.64879
13341,6,9,false,13,11,-2,41.88208,-87.63985
197,6,9,false,3,5,2,41.88208,-87.62513
13036,6,9,false,34,39,5,41.8821,-87.62513
77,6,9,false,8,6,-2,41.88214,-87.64108
TA1305000032,6,9,false,61,23,-38,41.88218,-87.64109
98,6,9,false,3,4,1,41.88266,-87.63251
13006,6,9,false,20,14,-6,41.88268,-87.63252
13353,6,9,false,18,23,5,41.88283,-87.6612
346,6,9,false,1,7,6,41.88284,-87.6612
654,6,9,false,19,6,-13,41.88307,-87.65698
233,6,9,false,3,8,5,41.88309,-87.6511
13409,6,9,false,34,15,-19,41.8831,-87.6511
18,6,9,false,1,2,1,41.88317,-87.63735
KA1503000072,6,9,false,6,7,1,41.88317,-87.63693
91,6,9,false,8,2,-6,41.88336,-87.64122
WL-012,6,9,false,36,15,-21,41.88337,-87.6412
112,6,9,false,4,11,7,41.88362,-87.6486
13053,6,9,false,34,74,40,41.88365,-87.64863
43,6,9,false,2,6,4,41.88396,-87.62455
13001,6,9,false,86,84,-2,41.88397,-87.62459
88,6,9,false,2,2,0,41.88407,-87.65691
13155,6,9,false,18,10,-8,41.88407,-87.65689
621,6,9,false,3,5,2,41.88412,-87.65427
18062,6,9,false,26,29,3,41.88412,-87.65427
81,6,9,false,4,8,4,41.88417,-87.6296
TA1306000010,6,9,false,29,14,-15,41.88419,-87.62961
15666,6,9,false,3,1,-2,41.88446,-87.6963
KA1504000106,6,9,false,4,1,-3,41.88459,-87.70631
TA1305000030,6,9,false,23,19,-4,41.88459,-87.63178
15535,6,9,false,32,21,-11,41.8846,-87.64455
96,6,9,false,7,3,-4,41.8846,-87.64455
51,6,9,false,4,4,0,41.88462,-87.63176
TA1305000029,6,9,false,49,52,3,41.88466,-87.62787
195,6,9,false,16,7,-9,41.88466,-87.61952
13263,6,9,false,77,33,-44,41.88467,-87.61952
44,6,9,false,7,5,-2,41.88468,-87.62782
TA1306000015,6,9,false,21,40,19,41.88549,-87.65232
518,6,9,false,2,4,2,41.8855,-87.71686
71,6,9,false,8,5,-3,41.8855,-87.65233
66,6,9,false,8,6,-2,41.88557,-87.64186
13021,6,9,false,31,22,-9,41.88559,-87.64184
TA1307000111,6,9,false,27,17,-10,41.88582,-87.63548
164,6,9,false,8,2,-6,41.88583,-87.63547
13073,6,9,false,5,6,1,41.88592,-87.66717
KA17018054,6,9,false,3,5,2,41.88595,-87.67701
KA1503000012,6,9,false,41,23,-18,41.88599,-87.63089
38,6,9,false,6,8,2,41.88599,-87.63089
52,6,9,false,9,14,5,41.886,-87.62421
TA1305000011,6,9,false,61,73,12,41.886,-87.62418
7,6,9,false,8,3,-5,41.88627,-87.61751
15534,6,9,false,37,38,1,41.88627,-87.61749
13197,6,9,false,8,8,0,41.8866,-87.65816
264,6,9,false,6,4,-2,41.8867,-87.62224
TA1308000029,6,9,false,39,23,-16,41.88673,-87.62225
194,6,9,false,7,5,-2,41.88688,-87.62606
TA1307000131,6,9,false,42,50,8,41.88688,-87.62606
KA1503000064,6,9,false,113,73,-40,41.88697,-87.61281
6,6,9,false,14,8,-6,41.88697,-87.61281
16905,6,9,false,4,2,-2,41.88767,-87.76547
530,6,9,false,3,1,-2,41.88783,-87.75558
16906,6,9,false,2,1,-1,41.88792,-87.77445
100,6,9,false,6,5,-1,41.88814,-87.63657
TA1305000022,6,9,false,39,35,-4,41.88817,-87.63656
56,6,9,false,8,7,-1,41.88866,-87.64442
TA1306000003,6,9,false,47,39,-8,41.88867,-87.64442
KA1503000043,6,9,false,87,43,-44,41.88918,-87.63851
133,6,9,false,23,6,-17,41.88918,-87.63851
13050,6,9,false,66,41,-25,41.88919,-87.62775
47,6,9,false,18,5,-13,41.88921,-87.62775
13432,6,9,false,4,12,8,41.88989,-87.67149
TA1307000151,6,9,false,52,27,-25,41.88993,-87.63427
212,6,9,false,16,8,-8,41.88995,-87.63427
636,6,9,false,21,22,1,41.88997,-87.63662
125,6,9,false,1,1,0,41.89018,-87.62621
KA1503000044,6,9,false,10,9,-1,41.89018,-87.6262
KA1504000113,6,9,false,1,2,1,41.89049,-87.70262
196,6,9,false,4,6,2,41.89053,-87.62205
13427,6,9,false,29,31,2,41.89054,-87.62205
26,6,9,false,14,2,-12,41.89057,-87.61798
13430,6,9,false,77,52,-25,41.89077,-87.63169
181,6,9,false,5,6,1,41.89077,-87.63168
TA1306000013,6,9,false,105,58,-47,41.89083,-87.61852
RN-,6,9,false,38,24,-14,41.89102,-87.63546
672,6,9,false,7,11,4,41.89102,-87.63545
13434,6,9,false,7,6,-1,41.89108,-87.66663
TA1308000006,6,9,false,11,8,-3,41.89128,-87.67686
199,6,9,false,10,8,-2,41.89143,-87.62676
TA1307000117,6,9,false,71,57,-14,41.89144,-87.62675
13033,6,9,false,42,28,-14,41.8916,-87.64835
84,6,9,false,8,10,2,41.89161,-87.64833
186,6,9,false,7,3,-4,41.8918,-87.65879
13194,6,9,false,25,10,-15,41.8918,-87.65878
TA1305000003,6,9,false,73,51,-22,41.89187,-87.62061
24,6,9,false,13,15,2,41.8919,-87.62063
643,6,9,false,1,5,4,41.89203,-87.68939
35,6,9,false,31,10,-21,41.89227,-87.61206
13022,6,9,false,214,224,10,41.89227,-87.61205
99,6,9,false,9,2,-7,41.89255,-87.61449
TA1306000029,6,9,false,82,56,-26,41.89256,-87.61449
13265,6,9,false,39,28,-11,41.89383,-87.64172
74,6,9,false,11,5,-6,41.89384,-87.64173
13045,6,9,false,92,67,-25,41.89403,-87.62931
110,6,9,false,11,4,-7,41.89406,-87.6293
13016,6,9,false,115,58,-57,41.89431,-87.62277
211,6,9,false,10,12,2,41.89439,-87.62267
KA1503000041,6,9,false,59,26,-33,41.89452,-87.61798
142,6,9,false,15,6,-9,41.89453,-87.61806
92,6,9,false,4,2,-2,41.89455,-87.65346
13196,6,9,false,32,14,-18,41.89455,-87.65345
TA1307000062,6,9,false,30,17,-13,41.89466,-87.63839
111,6,9,false,5,1,-4,41.89466,-87.63837
642,6,9,false,1,1,0,41.89473,-87.75689
TA1306000012,6,9,false,78,62,-16,41.89475,-87.63438
53,6,9,false,14,10,-4,41.89476,-87.63439
627,6,9,false,10,8,-2,41.8948,-87.63231
KP1705001026,6,9,false,66,44,-22,41.89483,-87.6323
KA1504000114,6,9,false,1,1,0,41.89547,-87.70614
18058,6,9,false,12,6,-6,41.8955,-87.68201
659,6,9,false,5,1,-4,41.8955,-87.68201
637,6,9,false,20,11,-9,41.89563,-87.67209
128,6,9,false,5,3,-2,41.89571,-87.67716
13132,6,9,false,23,19,-4,41.89573,-87.67718
161,6,9,false,9,7,-2,41.89574,-87.62599
15530,6,9,false,50,32,-18,41.89575,-87.62596
18003,6,9,false,31,11,-20,41.89575,-87.62011
635,6,9,false,2,1,-1,41.89576,-87.62012
13247,6,9,false,19,12,-7,41.89597,-87.66775
TA1305000020,6,9,false,34,30,-4,41.89636,-87.65406
54,6,9,false,7,7,0,41.89637,-87.65407
13289,6,9,false,23,15,-8,41.89638,-87.661
86,6,9,false,1,1,0,41.89639,-87.661
337,6,9,false,8,4,-4,41.89659,-87.63096
13303,6,9,false,37,29,-8,41.89672,-87.63088
13017,6,9,false,22,25,3,41.89676,-87.6357
31,6,9,false,6,8,2,41.89677,-87.63572
13338,6,9,false,38,33,-5,41.89697,-87.62173
173,6,9,false,3,4,1,41.89704,-87.62173
TA1307000061,6,9,false,37,14,-23,41.89745,-87.62873
106,6,9,false,3,4,1,41.89746,-87.62874
25,6,9,false,2,1,-1,41.89751,-87.62354
13034,6,9,false,36,18,-18,41.89754,-87.62352
48,6,9,false,1,3,2,41.89772,-87.64302
TA1306000009,6,9,false,31,15,-16,41.89772,-87.64299
620,6,9,false,36,36,0,41.89817,-87.63754
KA1504000103,6,9,false,19,14,-5,41.89842,-87.68659
374,6,9,false,2,2,0,41.89842,-87.68659
145,6,9,false,7,2,-5,41.89856,-87.62211
15529,6,9,false,62,31,-31,41.89858,-87.62206
140,6,9,false,23,8,-15,41.89895,-87.6299
TA1307000128,6,9,false,65,57,-8,41.89896,-87.6299
657,6,9,false,16,12,-4,41.89918,-87.6722
KA1504000117,6,9,false,3,2,-1,41.89936,-87.64848
30,6,9,false,2,7,5,41.89964,-87.66789
13248,6,9,false,26,16,-10,41.89964,-87.66788
46,6,9,false,3,1,-2,41.89994,-87.63444
TA1306000011,6,9,false,21,13,-8,41.89994,-87.63443
KA1504000116,6,9,false,17,15,-2,41.90023,-87.64299
17660,6,9,false,22,9,-13,41.90036,-87.69671
13290,6,9,false,25,7,-18,41.90069,-87.66259
29,6,9,false,7,3,-4,41.90069,-87.66259
13042,6,9,false,178,135,-43,41.90097,-87.62377
85,6,9,false,20,11,-9,41.90098,-87.62375
183,6,9,false,2,1,-1,41.90133,-87.67744
TA1307000070,6,9,false,30,10,-20,41.90133,-87.67742
KA1504000133,6,9,false,77,44,-33,41.90234,-87.62773
172,6,9,false,10,8,-2,41.90236,-87.62774
15654,6,9,false,4,3,-1,41.90271,-87.70923
305,6,9,false,7,1,-6,41.9028,-87.69005
13241,6,9,false,11,3,-8,41.9029,-87.68731
176,6,9,false,22,21,-1,41.90291,-87.63141
TA1306000006,6,9,false,19,6,-13,41.90292,-87.63772
23,6,9,false,1,1,0,41.90292,-87.63772
TA1307000039,6,9,false,103,81,-22,41.90294,-87.63137
658,6,9,false,5,6,1,41.903,-87.6838
13256,6,9,false,13,8,-5,41.90302,-87.69749
216,6,9,false,1,2,1,41.90302,-87.69749
TA1305000034,6,9,false,42,24,-18,41.90313,-87.67391
182,6,9,false,14,16,2,41.90317,-87.63442
KA1504000135,6,9,false,92,52,-40,41.90319,-87.63439
13136,6,9,false,27,19,-8,41.90326,-87.67845
130,6,9,false,5,1,-4,41.90327,-87.67846
210,6,9,false,7,5,-2,41.90342,-87.66781
13061,6,9,false,72,64,-8,41.90342,-87.66779
KA1504000079,6,9,false,32,25,-7,41.9035,-87.64334
359,6,9,false,4,4,0,41.90458,-87.6497
138,6,9,false,1,2,1,41.9046,-87.64057
TA1307000115,6,9,false,18,11,-7,41.9046,-87.64056
291,6,9,false,15,6,-9,41.90672,-87.63494
TA1308000049,6,9,false,41,50,9,41.90672,-87.6349
KA1504000134,6,9,false,30,26,-4,41.90687,-87.6262
180,6,9,false,4,9,5,41.90687,-87.62618
13224,6,9,false,28,16,-12,41.90706,-87.66725
333,6,9,false,5,5,0,41.90706,-87.66725
18069,6,9,false,1,1,0,41.90722,-87.65563
TA1307000143,6,9,false,13,8,-5,41.90762,-87.63854
61,6,9,false,4,3,-1,41.90764,-87.67254
13221,6,9,false,41,27,-14,41.90765,-87.67254
13245,6,9,false,6,5,-1,41.90777,-87.68586
301,6,9,false,10,4,-6,41.90796,-87.63203
TA1309000024,6,9,false,42,24,-18,41.908,-87.63152
69,6,9,false,3,12,9,41.90939,-87.6777
TA1305000041,6,9,false,34,43,9,41.9094,-87.67769
15652,6,9,false,1,2,1,41.90965,-87.71664
331,6,9,false,38,39,1,41.90965,-87.64812
15653,6,9,false,6,5,-1,41.90979,-87.7053
TA1305000037,6,9,false,25,20,-5,41.91018,-87.67003
27,6,9,false,5,4,-1,41.91019,-87.6435
TA1306000008,6,9,false,22,24,2,41.9102,-87.6435
16,6,9,false,4,1,-3,41.91035,-87.67008
TA1308000005,6,9,false,26,10,-16,41.91042,-87.68238
13258,6,9,false,17,7,-10,41.91043,-87.69718
276,6,9,false,6,5,-1,41.91043,-87.69718
13257,6,9,false,34,12,-22,41.91054,-87.68956
13154,6,9,false,9,16,7,41.91054,-87.65312
20,6,9,false,2,6,4,41.91055,-87.65313
13058,6,9,false,33,32,-1,41.91059,-87.64942
60,6,9,false,2,4,2,41.91059,-87.64942
TA1307000038,6,9,false,25,22,-3,41.91138,-87.63868
118,6,9,false,5,4,-1,41.91138,-87.63868
268,6,9,false,17,27,10,41.91172,-87.62681
LF-005,6,9,false,124,169,45,41.91172,-87.62681
126,6,9,false,4,14,10,41.91196,-87.63197
13128,6,9,false,39,51,12,41.91197,-87.63197
289,6,9,false,11,15,4,41.91209,-87.63472
TA1308000050,6,9,false,96,134,38,41.91211,-87.6347
13243,6,9,false,33,14,-19,41.91262,-87.6814
158,6,9,false,2,8,6,41.91262,-87.6814
TA1309000032,6,9,false,4,7,3,41.91293,-87.66417
TA1306000032,6,9,false,26,16,-10,41.9137,-87.65285
93,6,9,false,2,5,3,41.91371,-87.65285
TA1307000166,6,9,false,31,25,-6,41.91386,-87.64877
224,6,9,false,8,6,-2,41.91386,-87.64877
511,6,9,false,3,1,-2,41.914,-87.70515
15655,6,9,false,11,2,-9,41.91401,-87.70514
18017,6,9,false,13,12,-1,41.91416,-87.71676
18067,6,9,false,14,8,-6,41.9146,-87.66796
628,6,9,false,1,4,3,41.9146,-87.66796
TA1306000007,6,9,false,13,5,-8,41.91469,-87.64333
13068,6,9,false,27,16,-11,41.91554,-87.68703
116,6,9,false,4,1,-3,41.91555,-87.68703
13179,6,9,false,163,248,85,41.9157,-87.63461
141,6,9,false,24,36,12,41.91571,-87.63461
13133,6,9,false,32,21,-11,41.91598,-87.67733
219,6,9,false,1,6,5,41.91598,-87.67733
58,6,9,false,1,3,2,41.91602,-87.66894
TA1305000039,6,9,false,12,8,-4,41.9163,-87.66749
15650,6,9,false,19,7,-12,41.91711,-87.71023
15651,6,9,false,15,5,-10,41.91752,-87.70181
507,6,9,false,3,1,-2,41.91752,-87.70181
185,6,9,false,1,2,1,41.91774,-87.69143
13266,6,9,false,8,4,-4,41.91774,-87.69142
TA1309000029,6,9,false,19,8,-11,41.9178,-87.68245
309,6,9,false,6,1,-5,41.91789,-87.6865
TA1309000006,6,9,false,35,16,-19,41.91809,-87.64375
288,6,9,false,3,1,-2,41.91809,-87.64375
223,6,9,false,4,5,1,41.91821,-87.65698
TA1307000163,6,9,false,23,25,2,41.91821,-87.65696
94,6,9,false,12,24,12,41.91831,-87.6363
13146,6,9,false,104,123,19,41.91831,-87.63629
13059,6,9,false,56,48,-8,41.91845,-87.65222
113,6,9,false,13,7,-6,41.91846,-87.65222
13259,6,9,false,14,16,2,41.91852,-87.69744
259,6,9,false,2,1,-1,41.91853,-87.69745
310,6,9,false,5,1,-4,41.91984,-87.68083
13192,6,9,false,46,33,-13,41.91995,-87.64884
225,6,9,false,5,1,-4,41.91995,-87.64884
13288,6,9,false,19,13,-6,41.92008,-87.67788
13242,6,9,false,7,2,-5,41.92021,-87.69266
307,6,9,false,2,3,1,41.92077,-87.66373
TA1309000030,6,9,false,12,19,7,41.92077,-87.66372
290,6,9,false,1,3,2,41.92152,-87.70734
13292,6,9,false,11,2,-9,41.92152,-87.70733
TA1309000033,6,9,false,47,28,-19,41.92158,-87.65381
13193,6,9,false,79,66,-13,41.92182,-87.64412
144,6,9,false,12,13,1,41.92182,-87.64411
13191,6,9,false,53,32,-21,41.92217,-87.63891
143,6,9,false,5,4,-1,41.92217,-87.63891
327,6,9,false,5,3,-2,41.92225,-87.65783
13084,6,9,false,12,15,3,41.92268,-87.69715
123,6,9,false,5,3,-2,41.92268,-87.69714
LP-,6,9,false,53,30,-23,41.92396,-87.63584
673,6,9,false,4,2,-2,41.92398,-87.63585
505,6,9,false,2,1,-1,41.92409,-87.67646
KA1504000140,6,9,false,7,11,4,41.92409,-87.67646
16010,6,9,false,5,3,-2,41.92458,-87.72787
15648,6,9,false,5,2,-3,41.92464,-87.68931
KA1504000090,6,9,false,3,6,3,41.92483,-87.7145
TA1307000001,6,9,false,34,22,-12,41.92535,-87.66581
188,6,9,false,4,3,-1,41.92536,-87.66581
TA1306000026,6,9,false,25,26,1,41.92558,-87.65842
TA1306000016,6,9,false,37,29,-8,41.9256,-87.65371
67,6,9,false,2,3,1,41.9256,-87.65371
313,6,9,false,25,12,-13,41.9257,-87.64246
TA1309000019,6,9,false,97,53,-44,41.92586,-87.63897
TA1309000058,6,9,false,79,71,-8,41.92591,-87.64927
127,6,9,false,11,7,-4,41.92592,-87.64927
177,6,9,false,16,34,18,41.92627,-87.63086
TA1308000001,6,9,false,79,109,30,41.92627,-87.63086
15646,6,9,false,10,1,-9,41.92668,-87.6977
13124,6,9,false,30,22,-8,41.92675,-87.63444
34,6,9,false,5,4,-1,41.92675,-87.63444
302,6,9,false,3,1,-2,41.92859,-87.65421
TA1309000023,6,9,false,26,28,2,41.9287,-87.65383
TA1307000113,6,9,false,23,20,-3,41.92878,-87.66391
190,6,9,false,6,4,-2,41.92878,-87.6639
166,6,9,false,5,1,-4,41.92883,-87.66853
13296,6,9,false,19,9,-10,41.92883,-87.66852
TA1309000059,6,9,false,19,9,-10,41.92889,-87.65898
343,6,9,false,3,1,-2,41.92889,-87.65898
349,6,9,false,7,1,-6,41.92915,-87.6491
TA1309000061,6,9,false,37,24,-13,41.92915,-87.64909
258,6,9,false,2,4,2,41.92946,-87.68417
TA1308000031,6,9,false,11,17,6,41.92946,-87.68417
TA1305000014,6,9,false,87,46,-41,41.92956,-87.64313
340,6,9,false,12,11,-1,41.92956,-87.64313
260,6,9,false,3,1,-2,41.92958,-87.70791
13085,6,9,false,15,16,1,41.92958,-87.70789
499,6,9,false,1,1,0,41.93056,-87.72381
15643,6,9,false,13,8,-5,41.93057,-87.7238
TA1307000142,6,9,false,69,40,-29,41.93125,-87.64432
220,6,9,false,9,9,0,41.93125,-87.64431
13276,6,9,false,102,37,-65,41.93132,-87.63874
324,6,9,false,11,4,-7,41.93173,-87.64179
15645,6,9,false,4,2,-2,41.93191,-87.70121
163,6,9,false,3,4,1,41.93191,-87.67784
13271,6,9,false,16,9,-7,41.93192,-87.67784
152,6,9,false,1,1,0,41.93221,-87.65864
TA1307000064,6,9,false,57,38,-19,41.93222,-87.65864
13,6,9,false,12,4,-8,41.93242,-87.65271
TA1306000014,6,9,false,40,36,-4,41.93242,-87.65271
TA1309000039,6,9,false,100,63,-37,41.93258,-87.63642
329,6,9,false,17,3,-14,41.93258,-87.63642
13294,6,9,false,28,8,-20,41.9326,-87.66595
319,6,9,false,5,3,-2,41.93292,-87.67217
TA1309000036,6,9,false,38,16,-22,41.93313,-87.64776
332,6,9,false,4,5,1,41.93313,-87.64776
15644,6,9,false,2,3,1,41.93534,-87.71687
TA1307000006,6,9,false,30,33,3,41.93571,-87.6636
153,6,9,false,2,6,4,41.93575,-87.66364
162,6,9,false,1,1,0,41.93588,-87.67844
13268,6,9,false,23,4,-19,41.93588,-87.67843
13269,6,9,false,13,11,-2,41.93609,-87.66983
115,6,9,false,11,6,-5,41.93628,-87.65266
TA1307000052,6,9,false,43,38,-5,41.93628,-87.65266
156,6,9,false,8,4,-4,41.9365,-87.64756
TA1307000136,6,9,false,69,38,-31,41.9365,-87.64755
TA1307000041,6,9,false,83,39,-44,41.93669,-87.63683
157,6,9,false,13,10,-3,41.9367,-87.63683
13137,6,9,false,93,75,-18,41.9376,-87.6441
300,6,9,false,7,10,3,41.93761,-87.6441
15642,6,9,false,10,1,-9,41.93843,-87.69801
154,6,9,false,4,1,-3,41.93912,-87.66384
KA17018068,6,9,false,14,6,-8,41.93935,-87.68327
TA1309000042,6,9,false,27,23,-4,41.93937,-87.66836
131,6,9,false,4,3,-1,41.93937,-87.66835
KA150400009X,6,9,false,1,1,0,41.9394,-87.71159
15640,6,9,false,3,8,5,41.93941,-87.72357
13229,6,9,false,26,18,-8,41.93946,-87.66376
226,6,9,false,8,5,-3,41.93972,-87.65886
TA1308000019,6,9,false,40,38,-2,41.93973,-87.65886
13277,6,9,false,57,39,-18,41.9401,-87.64546
TA1307000134,6,9,false,46,45,-1,41.94016,-87.65303
117,6,9,false,8,8,0,41.94016,-87.65302
13143,6,9,false,23,6,-17,41.94059,-87.67853
334,6,9,false,23,7,-16,41.94076,-87.63919
TA1309000049,6,9,false,108,57,-51,41.94077,-87.63919
308,6,9,false,3,4,1,41.94152,-87.68471
15634,6,9,false,14,3,-11,41.94304,-87.68729
493,6,9,false,1,1,0,41.94304,-87.68729
TA1307000138,6,9,false,26,16,-10,41.94334,-87.67094
13144,6,9,false,18,14,-4,41.9434,-87.67964
TA1309000025,6,9,false,29,27,-2,41.94368,-87.64894
299,6,9,false,7,7,0,41.94368,-87.64894
229,6,9,false,10,5,-5,41.94372,-87.66401
13071,6,9,false,46,44,-2,41.94373,-87.66401
632,6,9,false,41,57,16,41.94453,-87.6547
303,6,9,false,20,2,-18,41.94522,-87.64702
15631,6,9,false,3,6,3,41.94524,-87.70665
13278,6,9,false,64,34,-30,41.94553,-87.64644
TA1309000050,6,9,false,5,3,-2,41.94618,-87.67331
330,6,9,false,1,2,1,41.94618,-87.67331
15632,6,9,false,6,5,-1,41.94664,-87.69463
KA1504000143,6,9,false,4,1,-3,41.94664,-87.68337
KA1504000142,6,9,false,2,1,-1,41.94735,-87.71759
227,6,9,false,1,5,4,41.94813,-87.66397
13235,6,9,false,32,32,0,41.94814,-87.66396
304,6,9,false,9,3,-6,41.94878,-87.64922
13253,6,9,false,6,5,-1,41.9488,-87.67527
13325,6,9,false,32,30,-2,41.94907,-87.64863
114,6,9,false,11,5,-6,41.94935,-87.65451
TA1307000126,6,9,false,31,58,27,41.94936,-87.65451
232,6,9,false,7,6,-1,41.94943,-87.64645
TA1307000150,6,9,false,86,44,-42,41.94945,-87.64646
13319,6,9,false,21,28,7,41.95069,-87.6687
TA1307000127,6,9,false,43,63,20,41.9508,-87.65918
165,6,9,false,3,4,1,41.95081,-87.65918
15628,6,9,false,9,8,-1,41.95216,-87.69806
487,6,9,false,4,4,0,41.95216,-87.69806
318,6,9,false,1,2,1,41.95254,-87.6735
13323,6,9,false,43,25,-18,41.95282,-87.65
15624,6,9,false,3,8,5,41.95339,-87.73199
590,6,9,false,1,2,1,41.95374,-87.74056
KA1504000139,6,9,false,3,7,4,41.954,-87.71909
TA1309000043,6,9,false,18,14,-4,41.95417,-87.66434
13063,6,9,false,51,13,-38,41.95424,-87.65441
240,6,9,false,2,6,4,41.95424,-87.65441
KA1504000158,6,9,false,1,3,2,41.95432,-87.68607
254,6,9,false,16,4,-12,41.95438,-87.64806
TA1308000022,6,9,false,57,24,-33,41.95438,-87.64805
16991,6,9,false,4,3,-1,41.95448,-87.7496
TA1307000149,6,9,false,4,6,2,41.95467,-87.67392
TA1309000026,6,9,false,17,7,-10,41.95601,-87.6802
13249,6,9,false,12,6,-6,41.95606,-87.66885
312,6,9,false,7,4,-3,41.95637,-87.6563
TA1308000047,6,9,false,11,2,-9,41.95709,-87.6642
13379,6,9,false,45,12,-33,41.95786,-87.6495
TA1309000018,6,9,false,7,2,-5,41.95791,-87.67357
TA1309000027,6,9,false,37,20,-17,41.9585,-87.65499
13389,6,9,false,35,13,-22,41.961,-87.64958
245,6,9,false,1,4,3,41.96101,-87.64958
15621,6,9,false,6,2,-4,41.96103,-87.70586
KA1706005015,6,9,false,2,1,-1,41.96108,-87.73569
15622,6,9,false,10,11,1,41.96108,-87.69544
KA1504000097,6,9,false,7,1,-6,41.96116,-87.71658
TA1307000144,6,9,false,15,4,-11,41.96142,-87.6762
TA1309000021,6,9,false,6,7,1,41.9615,-87.6714
15623,6,9,false,8,3,-5,41.96154,-87.69117
KA1503000022,6,9,false,19,9,-10,41.96158,-87.66609
231,6,9,false,6,4,-2,41.96163,-87.65464
TA1307000107,6,9,false,30,28,-2,41.96164,-87.65464
TA1307000156,6,9,false,6,9,3,41.96301,-87.68479
TA1309000012,6,9,false,16,5,-11,41.96325,-87.67928
249,6,9,false,3,5,2,41.96398,-87.63818
TA1308000012,6,9,false,70,100,30,41.96398,-87.63818
293,6,9,false,1,2,1,41.96521,-87.65822
13074,6,9,false,16,16,0,41.96521,-87.6582
639,6,9,false,33,55,22,41.96584,-87.64538
KA1504000127,6,9,false,4,3,-1,41.96587,-87.70083
KA1504000093,6,9,false,3,1,-2,41.96587,-87.69365
478,6,9,false,2,1,-1,41.96587,-87.69364
TA1307000140,6,9,false,9,6,-3,41.96643,-87.68865
326,6,9,false,2,1,-1,41.96665,-87.67113
TA1309000014,6,9,false,20,30,10,41.96709,-87.66744
TA1307000158,6,9,false,14,5,-9,41.9671,-87.67904
TA1307000119,6,9,false,23,17,-6,41.96796,-87.65
251,6,9,false,1,1,0,41.96796,-87.65
323,6,9,false,9,2,-7,41.96869,-87.66034
TA1308000021,6,9,false,16,6,-10,41.96883,-87.65765
KA1504000080,6,9,false,5,2,-3,41.96887,-87.69609
TA1309000015,6,9,false,2,7,5,41.96889,-87.68401
311,6,9,false,1,1,0,41.9689,-87.68402
TA1309000066,6,9,false,26,10,-16,41.9691,-87.67423
TA1309000041,6,9,false,14,11,-3,41.96951,-87.65471
KA1504000171,6,9,false,34,20,-14,41.97161,-87.65016
465,6,9,false,3,1,-2,41.97161,-87.65016
325,6,9,false,1,2,1,41.9728,-87.67186
TA1309000035,6,9,false,30,25,-5,41.97335,-87.66785
13108,6,9,false,21,9,-12,41.97379,-87.65971
KA1504000078,6,9,false,15,3,-12,41.97491,-87.69258
KA1504000149,6,9,false,14,10,-4,41.97562,-87.67945
KA1504000128,6,9,false,3,2,-1,41.97567,-87.70927
463,6,9,false,1,2,1,41.978,-87.66805
KA1504000146,6,9,false,13,39,26,41.978,-87.66805
13109,6,9,false,18,10,-8,41.97835,-87.65976
294,6,9,false,2,1,-1,41.97835,-87.65976
KA1504000147,6,9,false,5,5,0,41.97976,-87.67754
655,6,9,false,7,1,-6,41.97987,-87.68194
KA1504000161,6,9,false,1,1,0,41.98038,-87.71612
KA1504000167,6,9,false,2,1,-1,41.98206,-87.70895
KA1504000151,6,9,false,13,18,5,41.98359,-87.66916
15585,6,9,false,1,3,2,41.98367,-87.69642
KA1504000152,6,9,false,45,31,-14,41.98403,-87.65231
459,6,9,false,6,7,1,41.98403,-87.65231
461,6,9,false,3,1,-2,41.98405,-87.66027
15578,6,9,false,12,12,0,41.98405,-87.66027
15575,6,9,false,11,9,-2,41.98975,-87.66014
458,6,9,false,4,2,-2,41.98975,-87.66013
KA1504000148,6,9,false,6,8,2,41.99086,-87.66971
KA1504000155,6,9,false,1,1,0,41.99118,-87.68359
15571,6,9,false,18,10,-8,41.99478,-87.66028
454,6,9,false,6,1,-5,41.99478,-87.66027
KA1504000156,6,9,false,4,4,0,41.99925,-87.67137
RP-009,6,9,false,7,9,2,42.00107,-87.66122
RP-001,6,9,false,5,2,-3,42.00179,-87.68883
RP-008,6,9,false,7,2,-5,42.00446,-87.6724
RP-002,6,9,false,3,1,-2,42.00456,-87.68065
660,6,9,false,22,4,-18,42.00458,-87.66143
354,6,9,false,2,3,1,42.00587,-87.66802
KA1504000175,6,9,false,9,3,-6,42.00797,-87.66549
KA1504000162,6,9,false,9,2,-7,42.00907,-87.67422
KA1504000159,6,9,false,8,5,-3,42.01059,-87.66241
525,6,9,false,2,1,-1,42.01272,-87.66605
517,6,9,false,2,5,3,42.01597,-87.675
520,6,9,false,6,5,-1,42.01597,-87.66859
519,6,9,false,3,1,-2,42.01696,-87.67773
527,6,9,false,2,1,-1,42.01892,-87.69004
515,6,9,false,5,4,-1,42.01915,-87.67356
514,6,9,false,2,1,-1,42.01927,-87.68452
523,6,9,false,9,5,-4,42.02089,-87.66505
662,6,9,false,3,2,-1,42.02354,-87.69961
598,6,9,false,2,5,3,42.02578,-87.68411
597,6,9,false,1,1,0,42.03256,-87.67914
E002,6,9,false,9,8,-1,42.03256,-87.67912
E011,6,9,false,1,1,0,42.03473,-87.69912
599,6,9,false,2,2,0,42.03972,-87.69942
596,6,9,false,27,16,-11,42.04822,-87.68348
E008,6,9,false,15,7,-8,42.05049,-87.67782
603,6,9,false,1,1,0,42.05049,-87.67782
605,6,9,false,7,3,-4,42.05294,-87.67342
661,6,9,false,5,2,-3,42.05704,-87.68657
604,6,9,false,12,7,-5,42.05824,-87.67744
E006,6,9,false,4,5,1,42.06367,-87.69871
E007,6,9,false,4,3,-1,42.06431,-87.68615
E014,6,9,false,3,5,2,42.06483,-87.71531
20232,6,9,true,2,3,1,41.68588,-87.57378
20118,6,9,true,2,1,-1,41.72762,-87.63487
20231,6,9,true,1,3,2,41.7368,-87.58282
20121,6,9,true,1,1,0,41.74152,-87.65842
573,6,9,true,1,2,1,41.75079,-87.62444
KA1503000020,6,9,true,2,2,0,41.76223,-87.55923
KA1503000002,6,9,true,6,6,0,41.76641,-87.5657
KA1503000029,6,9,true,8,8,0,41.77364,-87.56747
429,6,9,true,1,1,0,41.77373,-87.60564
KA1503000031,6,9,true,1,1,0,41.77373,-87.60564
KA1503000021,6,9,true,2,1,-1,41.77888,-87.58665
18025,6,9,true,1,1,0,41.77989,-87.6509
KA1503000025,6,9,true,1,1,0,41.78008,-87.62977
KA1503000046,6,9,true,1,1,0,41.78041,-87.59141
KA1503000054,6,9,true,2,1,-1,41.78061,-87.60582
15491,6,9,true,4,7,3,41.78096,-87.57624
KA1503000033,6,9,true,1,1,0,41.78411,-87.61329
KA1503000014,6,9,true,33,22,-11,41.7851,-87.60108
426,6,9,true,17,8,-9,41.7851,-87.60108
KA1503000070,6,9,true,16,28,12,41.78794,-87.58831
425,6,9,true,4,3,-1,41.78795,-87.58831
328,6,9,true,5,5,0,41.78872,-87.6013
TA1309000011,6,9,true,15,30,15,41.78873,-87.60131
423,6,9,true,2,5,3,41.79148,-87.59988
KA1503000071,6,9,true,12,33,21,41.79148,-87.59988
424,6,9,true,5,3,-2,41.79174,-87.58395
KA1503000074,6,9,true,15,20,5,41.79174,-87.58395
386,6,9,true,1,1,0,41.793,-87.64502
TA1309000063,6,9,true,31,24,-7,41.79325,-87.5878
345,6,9,true,3,1,-2,41.79326,-87.5878
KA1503000073,6,9,true,11,3,-8,41.79345,-87.61585
420,6,9,true,4,20,16,41.79429,-87.60145
KA1504000076,6,9,true,35,45,10,41.7943,-87.60145
247,6,9,true,18,10,-8,41.79522,-87.58077
TA1308000009,6,9,true,28,24,-4,41.79522,-87.58075
TA1307000164,6,9,true,16,21,5,41.79527,-87.59647
248,6,9,true,5,3,-2,41.79528,-87.59647
646,6,9,true,1,1,0,41.79663,-87.62592
KA1503000052,6,9,true,36,15,-21,41.79935,-87.60097
418,6,9,true,6,1,-5,41.79936,-87.60097
KA1503000059,6,9,true,28,12,-16,41.79952,-87.58643
419,6,9,true,5,3,-2,41.79952,-87.58643
TA1309000037,6,9,true,40,22,-18,41.79957,-87.59474
415,6,9,true,1,1,0,41.80228,-87.61807
417,6,9,true,6,6,0,41.80242,-87.5869
KA1503000007,6,9,true,25,16,-9,41.80242,-87.58689
121,6,9,true,7,1,-6,41.80256,-87.59035
13398,6,9,true,23,19,-4,41.80256,-87.59035
TA1309000067,6,9,true,5,2,-3,41.80303,-87.60661
322,6,9,true,7,4,-3,41.80321,-87.59849
KA1503000069,6,9,true,4,4,0,41.80579,-87.59247
KA1503000051,6,9,true,2,2,0,41.80815,-87.64563
TA1308000035,6,9,true,15,5,-10,41.80944,-87.59188
267,6,9,true,4,7,3,41.80944,-87.59188
TA1308000002,6,9,true,10,1,-9,41.80983,-87.59937
TA1309000053,6,9,true,6,5,-1,41.80985,-87.60675
549,6,9,true,2,5,3,41.81401,-87.66662
KA1503000065,6,9,true,4,2,-2,41.81409,-87.59701
271,6,9,true,4,1,-3,41.81648,-87.60659
TA1308000023,6,9,true,11,2,-9,41.81649,-87.60659
KA1503000027,6,9,true,1,3,2,41.81666,-87.61942
TA1308000038,6,9,true,7,5,-2,41.82298,-87.6071
179,6,9,true,1,3,2,41.82458,-87.61678
13420,6,9,true,4,1,-3,41.82459,-87.61678
TA1308000045,6,9,true,8,12,4,41.83062,-87.64129
TA1308000043,6,9,true,3,4,1,41.83066,-87.64715
405,6,9,true,1,2,1,41.83078,-87.6325
KA1503000005,6,9,true,2,1,-1,41.83079,-87.6325
TA1307000129,6,9,true,7,11,4,41.83104,-87.62683
406,6,9,true,2,4,2,41.83127,-87.6088
KA1503000004,6,9,true,4,9,5,41.83127,-87.6088
13345,6,9,true,11,4,-7,41.83138,-87.61803
15445,6,9,true,3,5,2,41.83453,-87.63183
13216,6,9,true,15,46,31,41.83473,-87.62581
148,6,9,true,4,6,2,41.83474,-87.62581
149,6,9,true,5,5,0,41.83486,-87.61791
13217,6,9,true,22,14,-8,41.83488,-87.61792
13215,6,9,true,13,8,-5,41.83634,-87.6135
280,6,9,true,1,1,0,41.83779,-87.65116
TA1308000046,6,9,true,14,9,-5,41.83779,-87.65115
339,6,9,true,2,4,2,41.83817,-87.64523
TA1309000055,6,9,true,14,12,-2,41.8382,-87.64514
KA1503000038,6,9,true,10,6,-4,41.83845,-87.6354
402,6,9,true,4,2,-2,41.83845,-87.6354
150,6,9,true,5,5,0,41.83855,-87.60821
TA1307000048,6,9,true,17,29,12,41.83855,-87.60821
TA1308000036,6,9,true,9,17,8,41.83883,-87.62186
15442,6,9,true,2,7,5,41.83918,-87.66562
366,6,9,true,2,1,-1,41.84164,-87.65744
KA1503000040,6,9,true,1,3,2,41.84164,-87.65744
237,6,9,true,7,3,-4,41.84204,-87.61697
TA1307000139,6,9,true,55,15,-40,41.84205,-87.61698
15443,6,9,true,3,3,0,41.84275,-87.63549
207,6,9,true,7,2,-5,41.84358,-87.64539
TA1307000153,6,9,true,8,3,-5,41.84358,-87.64538
147,6,9,true,3,3,0,41.84569,-87.62251
TA1307000005,6,9,true,12,7,-5,41.84569,-87.6225
206,6,9,true,1,7,6,41.84719,-87.64683
TA1308000013,6,9,true,4,8,4,41.84719,-87.64681
TA1309000003,6,9,true,2,4,2,41.84847,-87.68512
15689,6,9,true,5,3,-2,41.84912,-87.69515
TA1308000014,6,9,true,10,1,-9,41.84953,-87.64059
TA1308000026,6,9,true,1,2,1,41.85008,-87.63214
TA1305000004,6,9,true,5,5,0,41.8514,-87.61884
42,6,9,true,6,6,0,41.85261,-87.62653
TA1305000001,6,9,true,7,14,7,41.85262,-87.6265
13075,6,9,true,9,14,5,41.8531,-87.63192
120,6,9,true,2,2,0,41.8531,-87.63191
13162,6,9,true,3,8,5,41.85378,-87.64659
13096,6,9,true,4,4,0,41.8538,-87.69577
203,6,9,true,7,2,-5,41.85409,-87.68585
13091,6,9,true,12,10,-2,41.85409,-87.68585
15546,6,9,true,6,5,-1,41.85416,-87.61916
13307,6,9,true,5,10,5,41.85489,-87.66359
124,6,9,true,3,1,-2,41.85492,-87.67609
13089,6,9,true,14,13,-1,41.85497,-87.67567
13331,6,9,true,8,4,-4,41.85515,-87.65414
15545,6,9,true,77,75,-2,41.85627,-87.61334
4,6,9,true,9,9,0,41.85627,-87.61334
SL-013,6,9,true,13,12,-1,41.85659,-87.62755
SL-006,6,9,true,7,6,-1,41.8568,-87.63387
129,6,9,true,12,3,-9,41.85752,-87.66158
13135,6,9,true,27,13,-14,41.85753,-87.66157
338,6,9,true,11,3,-8,41.85758,-87.61956
13102,6,9,true,60,29,-31,41.85762,-87.61942
13150,6,9,true,54,47,-7,41.85783,-87.62455
273,6,9,true,10,9,-1,41.85783,-87.62455
13099,6,9,true,10,6,-4,41.85784,-87.64627
205,6,9,true,5,1,-4,41.8579,-87.6687
TA1307000159,6,9,true,18,23,5,41.8579,-87.6687
170,6,9,true,3,1,-2,41.85793,-87.64083
TA1307000044,6,9,true,21,6,-15,41.85794,-87.64083
13163,6,9,true,14,16,2,41.85808,-87.65108
13164,6,9,true,25,17,-8,41.85818,-87.65648
15,6,9,true,5,2,-3,41.85819,-87.65648
SL-012,6,9,true,37,35,-2,41.86038,-87.62581
72,6,9,true,9,8,-1,41.86039,-87.62581
274,6,9,true,1,4,3,41.86126,-87.6566
13304,6,9,true,13,11,-2,41.86126,-87.65659
437,6,9,true,1,1,0,41.86192,-87.69348
KA1504000109,6,9,true,5,2,-3,41.86192,-87.69347
TA1306000002,6,9,true,19,9,-10,41.86238,-87.65108
137,6,9,true,1,5,4,41.86238,-87.65108
TA1307000124,6,9,true,71,55,-16,41.86411,-87.62372
168,6,9,true,13,8,-5,41.86415,-87.62372
282,6,9,true,1,2,1,41.86487,-87.64708
TA1309000001,6,9,true,12,18,6,41.86488,-87.64708
13165,6,9,true,3,5,2,41.86505,-87.65697
275,6,9,true,2,1,-1,41.86524,-87.66651
13354,6,9,true,3,8,5,41.86524,-87.66651
97,6,9,true,2,1,-1,41.86531,-87.6179
13029,6,9,true,11,24,13,41.86531,-87.6179
341,6,9,true,6,5,-1,41.86608,-87.60733
13431,6,9,true,22,29,7,41.8661,-87.60728
435,6,9,true,1,1,0,41.8665,-87.70649
KA1504000101,6,9,true,3,2,-1,41.86651,-87.68466
434,6,9,true,1,1,0,41.86651,-87.68465
KA1504000102,6,9,true,1,1,0,41.86664,-87.69453
WL-008,6,9,true,14,30,16,41.86712,-87.64108
57,6,9,true,1,4,3,41.86712,-87.64107
TA1305000002,6,9,true,83,70,-13,41.86721,-87.62597
59,6,9,true,16,20,4,41.86721,-87.62597
3,6,9,true,3,5,2,41.86723,-87.61536
15544,6,9,true,33,59,26,41.86723,-87.61536
TA1305000017,6,9,true,6,9,3,41.86734,-87.64863
55,6,9,true,1,3,2,41.86735,-87.64863
626,6,9,true,4,4,0,41.86749,-87.63219
KA1706005007,6,9,true,24,30,6,41.86749,-87.63219
SL-005,6,9,true,98,84,-14,41.8679,-87.62304
255,6,9,true,10,7,-3,41.86791,-87.62304
644,6,9,true,20,7,-13,41.86859,-87.68625
19,6,9,true,4,3,-1,41.86892,-87.65913
13139,6,9,true,34,10,-24,41.86893,-87.65913
13285,6,9,true,7,15,8,41.86928,-87.67372
13160,6,9,true,34,14,-20,41.86947,-87.65548
22,6,9,true,5,4,-1,41.86947,-87.65548
382,6,9,true,4,3,-1,41.8699,-87.68725
15550,6,9,true,13,31,18,41.87024,-87.63947
TA1309000010,6,9,true,66,54,-12,41.87074,-87.62574
SL-009,6,9,true,23,11,-12,41.87081,-87.63121
342,6,9,true,1,10,9,41.87127,-87.6737
TA1309000064,6,9,true,12,19,7,41.87127,-87.67369
261,6,9,true,1,6,5,41.87151,-87.6699
TA1307000130,6,9,true,27,24,-3,41.87178,-87.65103
241,6,9,true,8,3,-5,41.8718,-87.65102
108,6,9,true,1,11,10,41.87183,-87.64664
TA1307000121,6,9,true,3,41,38,41.87184,-87.64664
41,6,9,true,20,3,-17,41.87209,-87.62957
SL-008,6,9,true,77,55,-22,41.87209,-87.62956
13332,6,9,true,64,22,-42,41.87219,-87.6615
394,6,9,true,5,3,-2,41.87226,-87.63484
175,6,9,true,13,2,-11,41.87255,-87.63359
SL-011,6,9,true,41,18,-23,41.87256,-87.63356
623,6,9,true,43,30,-13,41.87272,-87.62399
KA1504000104,6,9,true,12,29,17,41.87296,-87.66912
320,6,9,true,11,11,0,41.87327,-87.66402
5,6,9,true,3,6,3,41.87403,-87.6277
SL-007,6,9,true,24,19,-5,41.87404,-87.6277
169,6,9,true,1,1,0,41.87424,-87.63959
13326,6,9,true,5,6,1,41.87425,-87.63958
321,6,9,true,20,13,-7,41.87427,-87.63257
356,6,9,true,1,1,0,41.87464,-87.70168
32,6,9,true,2,1,-1,41.87464,-87.65703
TA1306000025,6,9,true,16,21,5,41.87464,-87.65703
15668,6,9,true,16,1,-15,41.87471,-87.68642
13028,6,9,true,28,15,-13,41.87475,-87.64981
13081,6,9,true,1,3,2,41.87501,-87.67326
122,6,9,true,3,1,-2,41.87501,-87.67325
89,6,9,true,6,3,-3,41.87501,-87.6331
SL-010,6,9,true,24,14,-10,41.87501,-87.63309
15541,6,9,true,12,19,7,41.8758,-87.62086
13037,6,9,true,17,9,-8,41.87588,-87.64078
50,6,9,true,3,3,0,41.87592,-87.6307
TA1305000009,6,9,true,14,10,-4,41.87593,-87.63068
317,6,9,true,2,3,1,41.87603,-87.68195
45,6,9,true,1,1,0,41.87623,-87.62444
TA1305000010,6,9,true,9,13,4,41.87623,-87.62444
624,6,9,true,10,13,3,41.87626,-87.62923
2,6,9,true,5,3,-2,41.87649,-87.62051
33,6,9,true,2,6,4,41.87715,-87.62786
TA1305000035,6,9,true,6,9,3,41.87716,-87.62787
13138,6,9,true,1,4,3,41.87723,-87.63941
75,6,9,true,2,2,0,41.87724,-87.63937
631,6,9,true,4,3,-1,41.87761,-87.6739
16913,6,9,true,1,1,0,41.87762,-87.7454
15539,6,9,true,54,40,-14,41.87763,-87.64405
13158,6,9,true,53,47,-6,41.87764,-87.64957
134,6,9,true,17,10,-7,41.87764,-87.64954
13157,6,9,true,44,33,-11,41.87773,-87.6548
21,6,9,true,8,7,-1,41.87773,-87.6548
TA1305000025,6,9,true,33,19,-14,41.87773,-87.63528
36,6,9,true,14,4,-10,41.87776,-87.63525
TA1309000002,6,9,true,13,13,0,41.87784,-87.62408
13206,6,9,true,30,21,-9,41.87794,-87.66201
146,6,9,true,4,5,1,41.87794,-87.66201
283,6,9,true,1,4,3,41.87809,-87.63183
TA1309000004,6,9,true,9,12,3,41.87811,-87.63184
107,6,9,true,14,13,-1,41.87822,-87.644
638,6,9,true,15,26,11,41.87827,-87.64078
37,6,9,true,1,4,3,41.87921,-87.62975
TA1305000005,6,9,true,6,8,2,41.87924,-87.62975
13011,6,9,true,12,19,7,41.87931,-87.63993
TA1309000008,6,9,true,8,12,4,41.87933,-87.6355
192,6,9,true,2,8,6,41.87935,-87.63997
KA1503000034,6,9,true,2,5,3,41.87938,-87.63197
39,6,9,true,10,2,-8,41.87948,-87.62571
KA1503000015,6,9,true,16,28,12,41.87948,-87.6257
15667,6,9,true,3,6,3,41.8798,-87.68609
TA1309000007,6,9,true,4,7,3,41.88022,-87.63526
WL-011,6,9,true,29,25,-4,41.88034,-87.64273
73,6,9,true,7,7,0,41.8804,-87.64273
80,6,9,true,6,8,2,41.88042,-87.65556
13156,6,9,true,31,34,3,41.88042,-87.65554
13300,6,9,true,73,89,16,41.88097,-87.61675
76,6,9,true,13,13,0,41.88098,-87.61675
13008,6,9,true,27,78,51,41.88105,-87.62408
90,6,9,true,5,12,7,41.88107,-87.62409
49,6,9,true,2,6,4,41.88116,-87.62963
TA1305000006,6,9,true,13,29,16,41.88122,-87.6296
13134,6,9,true,6,9,3,41.88138,-87.67493
13056,6,9,true,6,7,1,41.88168,-87.63951
198,6,9,true,15,9,-6,41.88187,-87.6488
TA1307000120,6,9,true,95,96,1,41.88188,-87.64879
13341,6,9,true,11,7,-4,41.88208,-87.63985
174,6,9,true,3,3,0,41.88208,-87.63984
197,6,9,true,6,5,-1,41.88208,-87.62513
13036,6,9,true,17,42,25,41.8821,-87.62513
77,6,9,true,12,18,6,41.88214,-87.64108
TA1305000032,6,9,true,65,68,3,41.88218,-87.64109
98,6,9,true,2,5,3,41.88266,-87.63251
13006,6,9,true,15,26,11,41.88268,-87.63252
13353,6,9,true,42,34,-8,41.88283,-87.6612
346,6,9,true,8,8,0,41.88284,-87.6612
654,6,9,true,42,23,-19,41.88307,-87.65698
233,6,9,true,7,2,-5,41.88309,-87.6511
13409,6,9,true,28,20,-8,41.8831,-87.6511
18,6,9,true,1,3,2,41.88317,-87.63735
KA1503000072,6,9,true,11,13,2,41.88317,-87.63693
WL-012,6,9,true,17,19,2,41.88337,-87.6412
112,6,9,true,6,12,6,41.88362,-87.6486
13053,6,9,true,31,68,37,41.88365,-87.64863
43,6,9,true,9,8,-1,41.88396,-87.62455
13001,6,9,true,39,63,24,41.88397,-87.62459
88,6,9,true,2,8,6,41.88407,-87.65691
13155,6,9,true,20,37,17,41.88407,-87.65689
18062,6,9,true,27,26,-1,41.88412,-87.65427
621,6,9,true,2,4,2,41.88412,-87.65427
81,6,9,true,11,15,4,41.88417,-87.6296
TA1306000010,6,9,true,24,31,7,41.88419,-87.62961
15666,6,9,true,1,2,1,41.88446,-87.6963
TA1305000030,6,9,true,17,32,15,41.88459,-87.63178
15535,6,9,true,59,45,-14,41.8846,-87.64455
96,6,9,true,9,4,-5,41.8846,-87.64455
51,6,9,true,2,10,8,41.88462,-87.63176
TA1305000029,6,9,true,39,48,9,41.88466,-87.62787
195,6,9,true,37,18,-19,41.88466,-87.61952
13263,6,9,true,71,31,-40,41.88467,-87.61952
44,6,9,true,14,11,-3,41.88468,-87.62782
TA1306000015,6,9,true,37,50,13,41.88549,-87.65232
71,6,9,true,7,6,-1,41.8855,-87.65233
66,6,9,true,8,4,-4,41.88557,-87.64186
13021,6,9,true,45,35,-10,41.88559,-87.64184
TA1307000111,6,9,true,39,31,-8,41.88582,-87.63548
164,6,9,true,6,6,0,41.88583,-87.63547
13073,6,9,true,6,11,5,41.88592,-87.66717
KA17018054,6,9,true,4,6,2,41.88595,-87.67701
KA1503000012,6,9,true,32,39,7,41.88599,-87.63089
38,6,9,true,5,15,10,41.88599,-87.63089
52,6,9,true,10,7,-3,41.886,-87.62421
TA1305000011,6,9,true,52,32,-20,41.886,-87.62418
7,6,9,true,10,6,-4,41.88627,-87.61751
15534,6,9,true,28,25,-3,41.88627,-87.61749
217,6,9,true,1,2,1,41.8866,-87.65821
13197,6,9,true,9,9,0,41.8866,-87.65816
264,6,9,true,10,3,-7,41.8867,-87.62224
TA1308000029,6,9,true,37,23,-14,41.88673,-87.62225
TA1307000131,6,9,true,20,24,4,41.88688,-87.62606
6,6,9,true,4,4,0,41.88697,-87.61281
KA1503000064,6,9,true,44,55,11,41.88697,-87.61281
16905,6,9,true,3,1,-2,41.88767,-87.76547
100,6,9,true,9,9,0,41.88814,-87.63657
TA1305000022,6,9,true,42,36,-6,41.88817,-87.63656
56,6,9,true,23,21,-2,41.88866,-87.64442
TA1306000003,6,9,true,100,79,-21,41.88867,-87.64442
133,6,9,true,24,32,8,41.88918,-87.63851
KA1503000043,6,9,true,116,180,64,41.88918,-87.63851
13050,6,9,true,37,44,7,41.88919,-87.62775
47,6,9,true,4,8,4,41.88921,-87.62775
15664,6,9,true,3,5,2,41.8895,-87.68821
376,6,9,true,2,2,0,41.88951,-87.68818
13432,6,9,true,15,12,-3,41.88989,-87.67149
285,6,9,true,1,1,0,41.88989,-87.67149
TA1307000151,6,9,true,52,61,9,41.88993,-87.63427
212,6,9,true,23,24,1,41.88995,-87.63427
636,6,9,true,45,36,-9,41.88997,-87.63662
125,6,9,true,6,5,-1,41.89018,-87.62621
KA1503000044,6,9,true,8,16,8,41.89018,-87.6262
196,6,9,true,7,17,10,41.89053,-87.62205
13427,6,9,true,25,39,14,41.89054,-87.62205
26,6,9,true,27,4,-23,41.89057,-87.61798
13430,6,9,true,43,47,4,41.89077,-87.63169
181,6,9,true,8,3,-5,41.89077,-87.63168
TA1306000013,6,9,true,67,67,0,41.89083,-87.61852
RN-,6,9,true,52,61,9,41.89102,-87.63546
672,6,9,true,17,15,-2,41.89102,-87.63545
13434,6,9,true,13,9,-4,41.89108,-87.66663
TA1308000006,6,9,true,17,15,-2,41.89128,-87.67686
199,6,9,true,11,24,13,41.89143,-87.62676
TA1307000117,6,9,true,54,68,14,41.89144,-87.62675
13033,6,9,true,61,46,-15,41.8916,-87.64835
214,6,9,true,5,4,-1,41.89161,-87.67688
84,6,9,true,17,16,-1,41.89161,-87.64833
186,6,9,true,7,4,-3,41.8918,-87.65879
13194,6,9,true,62,24,-38,41.8918,-87.65878
TA1305000003,6,9,true,60,48,-12,41.89187,-87.62061
24,6,9,true,15,12,-3,41.8919,-87.62063
643,6,9,true,8,8,0,41.89203,-87.68939
35,6,9,true,14,4,-10,41.89227,-87.61206
13022,6,9,true,100,93,-7,41.89227,-87.61205
99,6,9,true,15,9,-6,41.89255,-87.61449
TA1306000029,6,9,true,53,30,-23,41.89256,-87.61449
13265,6,9,true,80,29,-51,41.89383,-87.64172
74,6,9,true,13,8,-5,41.89384,-87.64173
13045,6,9,true,132,150,18,41.89403,-87.62931
110,6,9,true,32,19,-13,41.89406,-87.6293
13016,6,9,true,45,32,-13,41.89431,-87.62277
211,6,9,true,7,11,4,41.89439,-87.62267
KA1503000041,6,9,true,77,35,-42,41.89452,-87.61798
142,6,9,true,20,10,-10,41.89453,-87.61806
92,6,9,true,11,4,-7,41.89455,-87.65346
13196,6,9,true,45,19,-26,41.89455,-87.65345
TA1307000062,6,9,true,39,55,16,41.89466,-87.63839
111,6,9,true,6,15,9,41.89466,-87.63837
TA1306000012,6,9,true,87,90,3,41.89475,-87.63438
53,6,9,true,38,20,-18,41.89476,-87.63439
627,6,9,true,7,6,-1,41.8948,-87.63231
KP1705001026,6,9,true,44,40,-4,41.89483,-87.6323
16921,6,9,true,1,2,1,41.89488,-87.77459
659,6,9,true,3,6,3,41.8955,-87.68201
18058,6,9,true,14,21,7,41.8955,-87.68201
637,6,9,true,38,26,-12,41.89563,-87.67209
128,6,9,true,7,4,-3,41.89571,-87.67716
13132,6,9,true,40,25,-15,41.89573,-87.67718
161,6,9,true,14,17,3,41.89574,-87.62599
15530,6,9,true,54,55,1,41.89575,-87.62596
18003,6,9,true,15,24,9,41.89575,-87.62011
635,6,9,true,2,6,4,41.89576,-87.62012
13247,6,9,true,33,26,-7,41.89597,-87.66775
350,6,9,true,12,8,-4,41.89597,-87.66774
TA1305000020,6,9,true,37,39,2,41.89636,-87.65406
54,6,9,true,12,12,0,41.89637,-87.65407
13289,6,9,true,28,28,0,41.89638,-87.661
86,6,9,true,5,5,0,41.89639,-87.661
337,6,9,true,12,7,-5,41.89659,-87.63096
13303,6,9,true,45,30,-15,41.89672,-87.63088
13017,6,9,true,53,54,1,41.89676,-87.6357
31,6,9,true,14,13,-1,41.89677,-87.63572
13338,6,9,true,38,27,-11,41.89697,-87.62173
173,6,9,true,7,7,0,41.89704,-87.62173
TA1307000061,6,9,true,35,18,-17,41.89745,-87.62873
106,6,9,true,10,8,-2,41.89746,-87.62874
25,6,9,true,2,2,0,41.89751,-87.62354
13034,6,9,true,19,7,-12,41.89754,-87.62352
48,6,9,true,6,7,1,41.89772,-87.64302
TA1306000009,6,9,true,64,28,-36,41.89772,-87.64299
620,6,9,true,42,56,14,41.89817,-87.63754
KA1504000103,6,9,true,30,11,-19,41.89842,-87.68659
374,6,9,true,5,6,1,41.89842,-87.68659
145,6,9,true,17,10,-7,41.89856,-87.62211
15529,6,9,true,49,46,-3,41.89858,-87.62206
140,6,9,true,26,28,2,41.89895,-87.6299
TA1307000128,6,9,true,85,81,-4,41.89896,-87.6299
657,6,9,true,36,22,-14,41.89918,-87.6722
365,6,9,true,2,1,-1,41.89936,-87.64848
KA1504000117,6,9,true,6,7,1,41.89936,-87.64848
30,6,9,true,10,5,-5,41.89964,-87.66789
13248,6,9,true,42,26,-16,41.89964,-87.66788
46,6,9,true,5,5,0,41.89994,-87.63444
TA1306000011,6,9,true,31,26,-5,41.89994,-87.63443
KA1504000116,6,9,true,41,37,-4,41.90023,-87.64299
364,6,9,true,7,13,6,41.90023,-87.64299
17660,6,9,true,13,10,-3,41.90036,-87.69671
622,6,9,true,4,1,-3,41.90037,-87.69671
13290,6,9,true,46,23,-23,41.90069,-87.66259
29,6,9,true,4,4,0,41.90069,-87.66259
13042,6,9,true,71,115,44,41.90097,-87.62377
85,6,9,true,13,20,7,41.90098,-87.62375
183,6,9,true,12,2,-10,41.90133,-87.67744
TA1307000070,6,9,true,27,17,-10,41.90133,-87.67742
KA1504000133,6,9,true,52,73,21,41.90234,-87.62773
172,6,9,true,7,20,13,41.90236,-87.62774
15654,6,9,true,13,6,-7,41.90271,-87.70923
510,6,9,true,2,2,0,41.90272,-87.70923
305,6,9,true,3,1,-2,41.9028,-87.69005
13241,6,9,true,25,14,-11,41.9029,-87.68731
176,6,9,true,40,42,2,41.90291,-87.63141
TA1306000006,6,9,true,28,15,-13,41.90292,-87.63772
23,6,9,true,5,4,-1,41.90292,-87.63772
TA1307000039,6,9,true,171,123,-48,41.90294,-87.63137
658,6,9,true,18,11,-7,41.903,-87.6838
216,6,9,true,4,1,-3,41.90302,-87.69749
13256,6,9,true,14,13,-1,41.90302,-87.69749
TA1305000034,6,9,true,44,33,-11,41.90313,-87.67391
17,6,9,true,10,6,-4,41.90313,-87.67391
182,6,9,true,29,35,6,41.90317,-87.63442
KA1504000135,6,9,true,108,118,10,41.90319,-87.63439
13136,6,9,true,34,35,1,41.90326,-87.67845
130,6,9,true,5,6,1,41.90327,-87.67846
210,6,9,true,19,19,0,41.90342,-87.66781
13061,6,9,true,84,84,0,41.90342,-87.66779
KA1504000079,6,9,true,46,68,22,41.9035,-87.64334
359,6,9,true,6,13,7,41.90458,-87.6497
138,6,9,true,9,6,-3,41.9046,-87.64057
TA1307000115,6,9,true,35,25,-10,41.9046,-87.64056
291,6,9,true,14,13,-1,41.90672,-87.63494
TA1308000049,6,9,true,64,63,-1,41.90672,-87.6349
KA1504000134,6,9,true,38,25,-13,41.90687,-87.6262
180,6,9,true,15,8,-7,41.90687,-87.62618
13224,6,9,true,42,30,-12,41.90706,-87.66725
333,6,9,true,1,2,1,41.90706,-87.66725
TA1307000143,6,9,true,24,10,-14,41.90762,-87.63854
236,6,9,true,7,6,-1,41.90762,-87.63853
61,6,9,true,11,10,-1,41.90764,-87.67254
13221,6,9,true,51,43,-8,41.90765,-87.67254
13245,6,9,true,11,4,-7,41.90777,-87.68586
159,6,9,true,4,2,-2,41.90777,-87.68586
301,6,9,true,35,13,-22,41.90796,-87.63203
TA1309000024,6,9,true,66,57,-9,41.908,-87.63152
69,6,9,true,2,13,11,41.90939,-87.6777
TA1305000041,6,9,true,40,47,7,41.9094,-87.67769
15652,6,9,true,1,1,0,41.90965,-87.71664
331,6,9,true,55,97,42,41.90965,-87.64812
15653,6,9,true,11,9,-2,41.90979,-87.7053
509,6,9,true,4,1,-3,41.9098,-87.70531
TA1305000037,6,9,true,28,20,-8,41.91018,-87.67003
27,6,9,true,4,5,1,41.91019,-87.6435
TA1306000008,6,9,true,34,21,-13,41.9102,-87.6435
16,6,9,true,8,8,0,41.91035,-87.67008
TA1308000005,6,9,true,34,25,-9,41.91042,-87.68238
13258,6,9,true,18,6,-12,41.91043,-87.69718
276,6,9,true,2,2,0,41.91043,-87.69718
160,6,9,true,8,2,-6,41.91054,-87.68957
13257,6,9,true,37,13,-24,41.91054,-87.68956
13154,6,9,true,50,73,23,41.91054,-87.65312
20,6,9,true,8,20,12,41.91055,-87.65313
13058,6,9,true,31,32,1,41.91059,-87.64942
60,6,9,true,4,15,11,41.91059,-87.64942
TA1307000038,6,9,true,48,44,-4,41.91138,-87.63868
118,6,9,true,13,21,8,41.91138,-87.63868
268,6,9,true,10,23,13,41.91172,-87.62681
LF-005,6,9,true,105,146,41,41.91172,-87.62681
126,6,9,true,18,19,1,41.91196,-87.63197
13128,6,9,true,40,51,11,41.91197,-87.63197
289,6,9,true,37,26,-11,41.91209,-87.63472
TA1308000050,6,9,true,147,163,16,41.91211,-87.6347
13243,6,9,true,50,46,-4,41.91262,-87.6814
158,6,9,true,14,11,-3,41.91262,-87.6814
315,6,9,true,2,4,2,41.91293,-87.66417
TA1309000032,6,9,true,6,9,3,41.91293,-87.66417
TA1306000032,6,9,true,53,41,-12,41.9137,-87.65285
93,6,9,true,12,15,3,41.91371,-87.65285
TA1307000166,6,9,true,62,39,-23,41.91386,-87.64877
224,6,9,true,8,8,0,41.91386,-87.64877
511,6,9,true,4,2,-2,41.914,-87.70515
15655,6,9,true,18,9,-9,41.91401,-87.70514
18017,6,9,true,7,5,-2,41.91416,-87.71676
641,6,9,true,3,1,-2,41.91416,-87.71676
18067,6,9,true,26,20,-6,41.9146,-87.66796
628,6,9,true,5,1,-4,41.9146,-87.66796
TA1306000007,6,9,true,25,20,-5,41.91469,-87.64333
28,6,9,true,5,7,2,41.91469,-87.64333
13068,6,9,true,24,30,6,41.91554,-87.68703
116,6,9,true,6,3,-3,41.91555,-87.68703
13179,6,9,true,210,251,41,41.9157,-87.63461
141,6,9,true,36,54,18,41.91571,-87.63461
13133,6,9,true,29,18,-11,41.91598,-87.67733
219,6,9,true,7,7,0,41.91598,-87.67733
58,6,9,true,4,5,1,41.91602,-87.66894
TA1305000039,6,9,true,14,19,5,41.9163,-87.66749
506,6,9,true,3,3,0,41.91711,-87.71023
15650,6,9,true,15,19,4,41.91711,-87.71023
15651,6,9,true,15,7,-8,41.91752,-87.70181
507,6,9,true,6,1,-5,41.91752,-87.70181
185,6,9,true,4,1,-3,41.91774,-87.69143
13266,6,9,true,11,10,-1,41.91774,-87.69142
TA1309000029,6,9,true,15,19,4,41.9178,-87.68245
309,6,9,true,3,3,0,41.91789,-87.6865
288,6,9,true,14,4,-10,41.91809,-87.64375
TA1309000006,6,9,true,27,32,5,41.91809,-87.64375
223,6,9,true,9,19,10,41.91821,-87.65698
TA1307000163,6,9,true,46,50,4,41.91821,-87.65696
94,6,9,true,36,24,-12,41.91831,-87.6363
13146,6,9,true,150,117,-33,41.91831,-87.63629
13059,6,9,true,74,63,-11,41.91845,-87.65222
113,6,9,true,19,12,-7,41.91846,-87.65222
13259,6,9,true,27,11,-16,41.91852,-87.69744
259,6,9,true,5,6,1,41.91853,-87.69745
310,6,9,true,3,2,-1,41.91984,-87.68083
13192,6,9,true,64,54,-10,41.91995,-87.64884
225,6,9,true,17,11,-6,41.91995,-87.64884
13288,6,9,true,26,6,-20,41.92008,-87.67788
13242,6,9,true,5,18,13,41.92021,-87.69266
222,6,9,true,7,1,-6,41.92023,-87.69265
307,6,9,true,3,12,9,41.92077,-87.66373
TA1309000030,6,9,true,34,51,17,41.92077,-87.66372
290,6,9,true,5,2,-3,41.92152,-87.70734
13292,6,9,true,15,2,-13,41.92152,-87.70733
TA1309000033,6,9,true,46,72,26,41.92158,-87.65381
13193,6,9,true,101,96,-5,41.92182,-87.64412
144,6,9,true,22,20,-2,41.92182,-87.64411
13191,6,9,true,62,38,-24,41.92217,-87.63891
143,6,9,true,6,9,3,41.92217,-87.63891
327,6,9,true,14,14,0,41.92225,-87.65783
13084,6,9,true,21,23,2,41.92268,-87.69715
123,6,9,true,3,3,0,41.92268,-87.69714
LP-,6,9,true,43,21,-22,41.92396,-87.63584
673,6,9,true,6,10,4,41.92398,-87.63585
505,6,9,true,4,2,-2,41.92409,-87.67646
KA1504000140,6,9,true,5,12,7,41.92409,-87.67646
504,6,9,true,3,2,-1,41.92464,-87.68931
15648,6,9,true,9,11,2,41.92464,-87.68931
KA1504000090,6,9,true,6,9,3,41.92483,-87.7145
TA1307000001,6,9,true,68,37,-31,41.92535,-87.66581
188,6,9,true,12,19,7,41.92536,-87.66581
TA1306000026,6,9,true,49,50,1,41.92558,-87.65842
87,6,9,true,11,16,5,41.92559,-87.65843
67,6,9,true,12,7,-5,41.9256,-87.65371
TA1306000016,6,9,true,57,65,8,41.9256,-87.65371
313,6,9,true,12,25,13,41.9257,-87.64246
TA1309000019,6,9,true,94,68,-26,41.92586,-87.63897
TA1309000058,6,9,true,96,126,30,41.92591,-87.64927
127,6,9,true,38,26,-12,41.92592,-87.64927
177,6,9,true,26,27,1,41.92627,-87.63086
TA1308000001,6,9,true,98,108,10,41.92627,-87.63086
15646,6,9,true,25,8,-17,41.92668,-87.6977
13124,6,9,true,23,17,-6,41.92675,-87.63444
34,6,9,true,5,4,-1,41.92675,-87.63444
302,6,9,true,9,10,1,41.92859,-87.65421
TA1309000023,6,9,true,51,34,-17,41.9287,-87.65383
TA1307000113,6,9,true,25,20,-5,41.92878,-87.66391
190,6,9,true,3,4,1,41.92878,-87.6639
166,6,9,true,6,5,-1,41.92883,-87.66853
13296,6,9,true,26,14,-12,41.92883,-87.66852
TA1309000059,6,9,true,41,19,-22,41.92889,-87.65898
343,6,9,true,9,12,3,41.92889,-87.65898
349,6,9,true,10,9,-1,41.92915,-87.6491
TA1309000061,6,9,true,54,63,9,41.92915,-87.64909
258,6,9,true,2,1,-1,41.92946,-87.68417
TA1308000031,6,9,true,8,32,24,41.92946,-87.68417
TA1305000014,6,9,true,110,88,-22,41.92956,-87.64313
340,6,9,true,24,21,-3,41.92956,-87.64313
260,6,9,true,2,13,11,41.92958,-87.70791
13085,6,9,true,20,12,-8,41.92958,-87.70789
499,6,9,true,1,1,0,41.93056,-87.72381
15643,6,9,true,6,5,-1,41.93057,-87.7238
TA1307000142,6,9,true,97,77,-20,41.93125,-87.64432
220,6,9,true,23,30,7,41.93125,-87.64431
13276,6,9,true,85,45,-40,41.93132,-87.63874
324,6,9,true,17,4,-13,41.93173,-87.64179
15645,6,9,true,3,9,6,41.93191,-87.70121
163,6,9,true,2,2,0,41.93191,-87.67784
13271,6,9,true,13,27,14,41.93192,-87.67784
152,6,9,true,27,19,-8,41.93221,-87.65864
TA1307000064,6,9,true,70,49,-21,41.93222,-87.65864
13,6,9,true,16,23,7,41.93242,-87.65271
TA1306000014,6,9,true,70,88,18,41.93242,-87.65271
TA1309000039,6,9,true,121,65,-56,41.93258,-87.63642
329,6,9,true,27,14,-13,41.93258,-87.63642
13294,6,9,true,16,7,-9,41.9326,-87.66595
TA1309000036,6,9,true,46,49,3,41.93313,-87.64776
332,6,9,true,8,15,7,41.93313,-87.64776
15644,6,9,true,2,2,0,41.93534,-87.71687
TA1307000006,6,9,true,39,50,11,41.93571,-87.6636
153,6,9,true,10,20,10,41.93575,-87.66364
13268,6,9,true,45,28,-17,41.93588,-87.67843
250,6,9,true,2,6,4,41.93609,-87.66984
13269,6,9,true,22,29,7,41.93609,-87.66983
TA1307000052,6,9,true,67,44,-23,41.93628,-87.65266
115,6,9,true,14,12,-2,41.93628,-87.65266
156,6,9,true,13,9,-4,41.9365,-87.64756
TA1307000136,6,9,true,64,51,-13,41.9365,-87.64755
TA1307000041,6,9,true,103,77,-26,41.93669,-87.63683
157,6,9,true,26,18,-8,41.9367,-87.63683
13137,6,9,true,118,137,19,41.9376,-87.6441
300,6,9,true,30,30,0,41.93761,-87.6441
15642,6,9,true,5,3,-2,41.93843,-87.69801
498,6,9,true,1,2,1,41.93843,-87.69801
154,6,9,true,8,3,-5,41.93912,-87.66384
664,6,9,true,5,2,-3,41.93934,-87.68327
KA17018068,6,9,true,13,11,-2,41.93935,-87.68327
TA1309000042,6,9,true,37,47,10,41.93937,-87.66836
131,6,9,true,10,13,3,41.93937,-87.66835
KA150400009X,6,9,true,1,4,3,41.9394,-87.71159
15640,6,9,true,9,1,-8,41.93941,-87.72357
497,6,9,true,2,2,0,41.93941,-87.71159
13229,6,9,true,39,20,-19,41.93946,-87.66376
226,6,9,true,10,10,0,41.93972,-87.65886
TA1308000019,6,9,true,56,51,-5,41.93973,-87.65886
13277,6,9,true,83,72,-11,41.9401,-87.64546
296,6,9,true,12,17,5,41.9401,-87.64546
TA1307000134,6,9,true,99,48,-51,41.94016,-87.65303
117,6,9,true,19,10,-9,41.94016,-87.65302
13143,6,9,true,13,11,-2,41.94059,-87.67853
334,6,9,true,29,15,-14,41.94076,-87.63919
TA1309000049,6,9,true,95,77,-18,41.94077,-87.63919
308,6,9,true,1,6,5,41.94152,-87.68471
15634,6,9,true,8,11,3,41.94304,-87.68729
TA1307000138,6,9,true,52,52,0,41.94334,-87.67094
230,6,9,true,17,13,-4,41.94335,-87.67093
13144,6,9,true,4,13,9,41.9434,-87.67964
299,6,9,true,13,16,3,41.94368,-87.64894
TA1309000025,6,9,true,35,60,25,41.94368,-87.64894
229,6,9,true,18,7,-11,41.94372,-87.66401
13071,6,9,true,77,59,-18,41.94373,-87.66401
632,6,9,true,64,78,14,41.94453,-87.6547
303,6,9,true,31,12,-19,41.94522,-87.64702
490,6,9,true,1,5,4,41.94523,-87.70664
15631,6,9,true,6,9,3,41.94524,-87.70665
13278,6,9,true,84,35,-49,41.94553,-87.64644
TA1309000050,6,9,true,12,7,-5,41.94618,-87.67331
488,6,9,true,1,1,0,41.94627,-87.73105
492,6,9,true,1,2,1,41.94662,-87.68337
491,6,9,true,1,1,0,41.94664,-87.69463
15632,6,9,true,9,32,23,41.94664,-87.69463
KA1504000143,6,9,true,14,8,-6,41.94664,-87.68337
KA1504000142,6,9,true,1,2,1,41.94735,-87.71759
227,6,9,true,15,16,1,41.94813,-87.66397
13235,6,9,true,68,79,11,41.94814,-87.66396
304,6,9,true,14,24,10,41.94878,-87.64922
13253,6,9,true,26,18,-8,41.9488,-87.67527
257,6,9,true,5,6,1,41.9488,-87.67527
13325,6,9,true,79,101,22,41.94907,-87.64863
114,6,9,true,7,6,-1,41.94935,-87.65451
TA1307000126,6,9,true,40,45,5,41.94936,-87.65451
232,6,9,true,24,12,-12,41.94943,-87.64645
TA1307000150,6,9,true,95,82,-13,41.94945,-87.64646
18016,6,9,true,15,5,-10,41.94993,-87.71395
347,6,9,true,7,3,-4,41.95068,-87.6687
13319,6,9,true,24,23,-1,41.95069,-87.6687
TA1307000127,6,9,true,39,52,13,41.9508,-87.65918
165,6,9,true,9,15,6,41.95081,-87.65918
15628,6,9,true,11,15,4,41.95216,-87.69806
318,6,9,true,6,5,-1,41.95254,-87.6735
13323,6,9,true,64,41,-23,41.95282,-87.65
256,6,9,true,6,10,4,41.95282,-87.65
15624,6,9,true,4,3,-1,41.95339,-87.73199
314,6,9,true,1,1,0,41.9535,-87.69199
KA1504000096,6,9,true,2,1,-1,41.95361,-87.70932
590,6,9,true,1,2,1,41.95374,-87.74056
TA1309000043,6,9,true,35,45,10,41.95417,-87.66434
13063,6,9,true,59,43,-16,41.95424,-87.65441
240,6,9,true,17,21,4,41.95424,-87.65441
486,6,9,true,2,3,1,41.95431,-87.68607
KA1504000158,6,9,true,8,13,5,41.95432,-87.68607
254,6,9,true,12,11,-1,41.95438,-87.64806
TA1308000022,6,9,true,60,28,-32,41.95438,-87.64805
16991,6,9,true,2,2,0,41.95448,-87.7496
TA1307000149,6,9,true,22,15,-7,41.95467,-87.67392
298,6,9,true,8,7,-1,41.95601,-87.68021
TA1309000026,6,9,true,33,29,-4,41.95601,-87.6802
13249,6,9,true,7,6,-1,41.95606,-87.66885
246,6,9,true,2,3,1,41.95606,-87.66885
312,6,9,true,19,3,-16,41.95637,-87.6563
TA1308000047,6,9,true,7,6,-1,41.95709,-87.6642
292,6,9,true,1,1,0,41.95709,-87.6642
13379,6,9,true,88,36,-52,41.95786,-87.6495
TA1309000018,6,9,true,13,9,-4,41.95791,-87.67357
316,6,9,true,5,1,-4,41.95841,-87.69401
306,6,9,true,13,6,-7,41.9585,-87.655
TA1309000027,6,9,true,57,34,-23,41.9585,-87.65499
592,6,9,true,2,1,-1,41.96065,-87.74538
13389,6,9,true,67,45,-22,41.961,-87.64958
245,6,9,true,15,8,-7,41.96101,-87.64958
15621,6,9,true,6,2,-4,41.96103,-87.70586
480,6,9,true,4,2,-2,41.96104,-87.70586
KA1706005015,6,9,true,2,1,-1,41.96108,-87.73569
481,6,9,true,1,1,0,41.96108,-87.69544
15622,6,9,true,9,15,6,41.96108,-87.69544
KA1504000164,6,9,true,2,1,-1,41.96109,-87.72897
KA1504000097,6,9,true,4,2,-2,41.96116,-87.71658
238,6,9,true,1,6,5,41.96141,-87.6762
TA1307000144,6,9,true,8,28,20,41.96142,-87.6762
297,6,9,true,6,3,-3,41.9615,-87.67141
TA1309000021,6,9,true,13,31,18,41.9615,-87.6714
15623,6,9,true,13,11,-2,41.96154,-87.69117
482,6,9,true,4,3,-1,41.96154,-87.69117
234,6,9,true,2,3,1,41.96158,-87.6661
KA1503000022,6,9,true,19,15,-4,41.96158,-87.66609
231,6,9,true,15,8,-7,41.96163,-87.65464
TA1307000107,6,9,true,61,58,-3,41.96164,-87.65464
TA1307000156,6,9,true,19,27,8,41.96301,-87.68479
243,6,9,true,2,4,2,41.96302,-87.68479
TA1309000012,6,9,true,30,14,-16,41.96325,-87.67928
249,6,9,true,7,7,0,41.96398,-87.63818
TA1308000012,6,9,true,76,95,19,41.96398,-87.63818
293,6,9,true,12,3,-9,41.96521,-87.65822
13074,6,9,true,30,24,-6,41.96521,-87.6582
639,6,9,true,45,58,13,41.96584,-87.64538
KA1504000127,6,9,true,6,3,-3,41.96587,-87.70083
477,6,9,true,1,2,1,41.96587,-87.70083
KA1504000093,6,9,true,16,10,-6,41.96587,-87.69365
478,6,9,true,6,1,-5,41.96587,-87.69364
TA1307000140,6,9,true,34,28,-6,41.96643,-87.68865
239,6,9,true,10,4,-6,41.9665,-87.68843
326,6,9,true,8,5,-3,41.96665,-87.67113
KA1504000126,6,9,true,3,4,1,41.96668,-87.70807
TA1309000014,6,9,true,43,50,7,41.96709,-87.66744
TA1307000158,6,9,true,44,15,-29,41.9671,-87.67904
242,6,9,true,4,4,0,41.9671,-87.67904
TA1307000119,6,9,true,27,20,-7,41.96796,-87.65
251,6,9,true,6,3,-3,41.96796,-87.65
15615,6,9,true,2,4,2,41.96835,-87.71183
323,6,9,true,6,1,-5,41.96869,-87.66034
TA1308000021,6,9,true,23,23,0,41.96883,-87.65765
253,6,9,true,3,5,2,41.96883,-87.65765
475,6,9,true,3,3,0,41.96885,-87.69611
KA1504000080,6,9,true,11,9,-2,41.96887,-87.69609
TA1309000015,6,9,true,18,6,-12,41.96889,-87.68401
344,6,9,true,4,4,0,41.9691,-87.67423
TA1309000066,6,9,true,46,56,10,41.9691,-87.67423
TA1309000041,6,9,true,41,14,-27,41.96951,-87.65471
KA1504000171,6,9,true,61,35,-26,41.97161,-87.65016
465,6,9,true,7,8,1,41.97161,-87.65016
325,6,9,true,6,4,-2,41.9728,-87.67186
TA1309000035,6,9,true,49,37,-12,41.97335,-87.66785
295,6,9,true,8,2,-6,41.97378,-87.65972
13108,6,9,true,39,22,-17,41.97379,-87.65971
KA1504000078,6,9,true,14,3,-11,41.97491,-87.69258
472,6,9,true,1,1,0,41.97492,-87.69262
KA1504000149,6,9,true,16,15,-1,41.97562,-87.67945
471,6,9,true,2,2,0,41.97564,-87.70143
KA1504000160,6,9,true,6,7,1,41.97564,-87.70143
KA1504000128,6,9,true,3,5,2,41.97567,-87.70927
463,6,9,true,6,2,-4,41.978,-87.66805
KA1504000146,6,9,true,18,42,24,41.978,-87.66805
13109,6,9,true,39,17,-22,41.97835,-87.65976
294,6,9,true,6,3,-3,41.97835,-87.65976
KA1504000147,6,9,true,8,10,2,41.97976,-87.67754
655,6,9,true,3,3,0,41.97987,-87.68194
KA1504000167,6,9,true,5,1,-4,41.98206,-87.70895
494,6,9,true,3,1,-2,41.98234,-87.70892
460,6,9,true,4,8,4,41.98358,-87.66916
KA1504000151,6,9,true,20,32,12,41.98359,-87.66916
15585,6,9,true,5,2,-3,41.98367,-87.69642
KA1504000152,6,9,true,78,53,-25,41.98403,-87.65231
459,6,9,true,20,15,-5,41.98403,-87.65231
15578,6,9,true,22,17,-5,41.98405,-87.66027
461,6,9,true,8,5,-3,41.98405,-87.66027
15575,6,9,true,21,23,2,41.98975,-87.66014
458,6,9,true,3,2,-1,41.98975,-87.66013
457,6,9,true,7,3,-4,41.99052,-87.66982
KA1504000148,6,9,true,14,5,-9,41.99086,-87.66971
KA1504000155,6,9,true,6,3,-3,41.99118,-87.68359
KA1504000129,6,9,true,2,8,6,41.99417,-87.68945
15571,6,9,true,28,17,-11,41.99478,-87.66028
454,6,9,true,2,9,7,41.99478,-87.66027
453,6,9,true,1,2,1,41.99925,-87.67137
KA1504000156,6,9,true,5,7,2,41.99925,-87.67137
RP-009,6,9,true,11,21,10,42.00107,-87.66122
451,6,9,true,2,3,1,42.00108,-87.66123
RP-001,6,9,true,2,1,-1,42.00179,-87.68883
449,6,9,true,7,1,-6,42.00446,-87.67241
RP-008,6,9,true,10,4,-6,42.00446,-87.6724
RP-002,6,9,true,3,2,-1,42.00456,-87.68065
448,6,9,true,4,4,0,42.00456,-87.68064
660,6,9,true,16,5,-11,42.00458,-87.66143
354,6,9,true,4,2,-2,42.00587,-87.66802
KA1504000175,6,9,true,13,10,-3,42.00797,-87.66549
RP-005,6,9,true,4,1,-3,42.0086,-87.69047
467,6,9,true,2,1,-1,42.0086,-87.69047
432,6,9,true,3,4,1,42.00907,-87.67423
KA1504000162,6,9,true,2,1,-1,42.00907,-87.67422
KA1504000159,6,9,true,4,9,5,42.01059,-87.66241
RP-006,6,9,true,3,3,0,42.01213,-87.68292
RP-004,6,9,true,1,1,0,42.01234,-87.68825
525,6,9,true,14,3,-11,42.01272,-87.66605
517,6,9,true,3,10,7,42.01597,-87.675
520,6,9,true,14,24,10,42.01597,-87.66859
515,6,9,true,4,12,8,42.01915,-87.67356
16806,6,9,true,2,2,0,42.01953,-87.66955
523,6,9,true,38,11,-27,42.02089,-87.66505
597,6,9,true,2,3,1,42.03256,-87.67914
E002,6,9,true,21,10,-11,42.03256,-87.67912
625,6,9,true,3,2,-1,42.04163,-87.6808
596,6,9,true,12,32,20,42.04822,-87.68348
E008,6,9,true,3,3,0,42.05049,-87.67782
605,6,9,true,6,22,16,42.05294,-87.67342
604,6,9,true,3,11,8,42.05824,-87.67744
E006,6,9,true,4,2,-2,42.06367,-87.69871
601,6,9,true,1,1,0,42.06368,-87.69871
E007,6,9,true,1,5,4,42.06431,-87.68615
E014,6,9,true,7,3,-4,42.06483,-87.71531
20213,6,17,false,1,2,1,41.65915,-87.55078
20210,6,17,false,2,1,-1,41.67067,-87.62273
719,6,17,false,1,1,0,41.68102,-87.53794
20218,6,17,false,1,1,0,41.68103,-87.53798
20206,6,17,false,1,1,0,41.68459,-87.6708
20243,6,17,false,4,3,-1,41.68701,-87.62111
20127,6,17,false,1,1,0,41.69228,-87.64268
725,6,17,false,2,1,-1,41.70515,-87.64403
20125,6,17,false,2,1,-1,41.70517,-87.64242
20113,6,17,false,1,1,0,41.70728,-87.60767
20107,6,17,false,3,1,-2,41.7122,-87.66772
20226,6,17,false,4,1,-3,41.71336,-87.56586
20224,6,17,false,4,14,10,41.71371,-87.53083
20238,6,17,false,1,4,3,41.7187,-87.597
20104,6,17,false,3,2,-1,41.72171,-87.62283
20119,6,17,false,6,1,-5,41.72682,-87.6543
20118,6,17,false,2,3,1,41.72762,-87.63487
20103,6,17,false,2,1,-1,41.7281,-87.66757
20116,6,17,false,3,3,0,41.73652,-87.60126
20229,6,17,false,2,2,0,41.73734,-87.54849
20121,6,17,false,1,1,0,41.74152,-87.65842
587,6,17,false,3,1,-2,41.74332,-87.62284
585,6,17,false,2,2,0,41.74344,-87.60485
588,6,17,false,3,1,-2,41.74392,-87.57522
582,6,17,false,1,2,1,41.74453,-87.56508
TA1309000051,6,17,false,2,3,1,41.74462,-87.55121
583,6,17,false,4,2,-2,41.74656,-87.58599
573,6,17,false,3,2,-1,41.75079,-87.62444
574,6,17,false,1,2,1,41.75095,-87.61379
577,6,17,false,1,1,0,41.75117,-87.58534
579,6,17,false,1,2,1,41.75182,-87.56522
571,6,17,false,2,2,0,41.75836,-87.61415
KA1503000019,6,17,false,1,1,0,41.75867,-87.5869
KA1503000024,6,17,false,2,1,-1,41.75876,-87.56644
569,6,17,false,1,1,0,41.75918,-87.59576
KA1503000020,6,17,false,2,3,1,41.76223,-87.55923
399,6,17,false,1,2,1,41.76225,-87.5592
12,6,17,false,2,2,0,41.76641,-87.5657
KA1503000002,6,17,false,12,20,8,41.76641,-87.5657
KA1503000045,6,17,false,4,4,0,41.76649,-87.58647
11,6,17,false,1,1,0,41.76662,-87.57646
15597,6,17,false,3,2,-1,41.76906,-87.64461
KA1503000023,6,17,false,6,2,-4,41.77346,-87.58534
KA1503000030,6,17,false,4,4,0,41.77352,-87.57722
KA1503000029,6,17,false,7,8,1,41.77364,-87.56747
KA1503000021,6,17,false,9,7,-2,41.77888,-87.58665
KA1503000046,6,17,false,9,9,0,41.78041,-87.59141
653,6,17,false,10,3,-7,41.78059,-87.58491
KA1503000054,6,17,false,2,9,7,41.78061,-87.60582
15491,6,17,false,13,25,12,41.78096,-87.57624
101,6,17,false,1,6,5,41.78105,-87.57611
426,6,17,false,2,14,12,41.7851,-87.60108
KA1503000014,6,17,false,31,54,23,41.7851,-87.60108
561,6,17,false,2,2,0,41.7857,-87.67409
KA1503000070,6,17,false,15,10,-5,41.78794,-87.58831
328,6,17,false,4,2,-2,41.78872,-87.6013
TA1309000011,6,17,false,15,7,-8,41.78873,-87.60131
423,6,17,false,7,5,-2,41.79148,-87.59988
KA1503000071,6,17,false,26,25,-1,41.79148,-87.59988
KA1503000074,6,17,false,108,29,-79,41.79174,-87.58395
424,6,17,false,8,11,3,41.79174,-87.58395
TA1309000063,6,17,false,37,34,-3,41.79325,-87.5878
345,6,17,false,2,3,1,41.79326,-87.5878
KA1503000073,6,17,false,1,1,0,41.79345,-87.61585
385,6,17,false,1,1,0,41.79419,-87.64526
559,6,17,false,1,2,1,41.79423,-87.65509
420,6,17,false,2,5,3,41.79429,-87.60145
KA1504000076,6,17,false,14,20,6,41.7943,-87.60145
TA1307000160,6,17,false,14,6,-8,41.79485,-87.61873
KA1503000013,6,17,false,3,7,4,41.79498,-87.63312
247,6,17,false,11,21,10,41.79522,-87.58077
TA1308000009,6,17,false,135,126,-9,41.79522,-87.58075
TA1307000164,6,17,false,24,29,5,41.79527,-87.59647
248,6,17,false,5,14,9,41.79528,-87.59647
KA1503000052,6,17,false,20,36,16,41.79935,-87.60097
418,6,17,false,1,4,3,41.79936,-87.60097
419,6,17,false,2,8,6,41.79952,-87.58643
KA1503000059,6,17,false,35,47,12,41.79952,-87.58643
TA1309000037,6,17,false,42,74,32,41.79957,-87.59474
15470,6,17,false,10,10,0,41.80228,-87.61807
415,6,17,false,1,2,1,41.80228,-87.61807
417,6,17,false,6,20,14,41.80242,-87.5869
KA1503000007,6,17,false,36,46,10,41.80242,-87.58689
121,6,17,false,6,6,0,41.80256,-87.59035
13398,6,17,false,17,26,9,41.80256,-87.59035
16940,6,17,false,3,1,-2,41.80302,-87.66469
TA1309000067,6,17,false,1,5,4,41.80303,-87.60661
322,6,17,false,16,12,-4,41.80321,-87.59849
416,6,17,false,2,3,1,41.80578,-87.59247
KA1503000069,6,17,false,13,9,-4,41.80579,-87.59247
KA1504000091,6,17,false,2,1,-1,41.80823,-87.6772
16937,6,17,false,1,4,3,41.80887,-87.66453
552,6,17,false,4,1,-3,41.80887,-87.66452
267,6,17,false,5,5,0,41.80944,-87.59188
TA1308000035,6,17,false,18,20,2,41.80944,-87.59188
252,6,17,false,4,7,3,41.80982,-87.59936
TA1308000002,6,17,false,7,8,1,41.80983,-87.59937
TA1308000007,6,17,false,5,6,1,41.80984,-87.61628
TA1309000053,6,17,false,9,10,1,41.80985,-87.60675
352,6,17,false,2,3,1,41.8137,-87.63448
413,6,17,false,1,2,1,41.81408,-87.59701
KA1503000065,6,17,false,13,13,0,41.81409,-87.59701
271,6,17,false,1,6,5,41.81648,-87.60659
TA1308000023,6,17,false,5,10,5,41.81649,-87.60659
KA1503000027,6,17,false,6,10,4,41.81666,-87.61942
KA1503000032,6,17,false,1,1,0,41.81912,-87.64328
13083,6,17,false,3,1,-2,41.82167,-87.62153
355,6,17,false,1,1,0,41.82217,-87.63032
265,6,17,false,4,4,0,41.82297,-87.6071
TA1308000038,6,17,false,16,11,-5,41.82298,-87.6071
15449,6,17,false,1,2,1,41.82302,-87.62657
407,6,17,false,2,3,1,41.82303,-87.62658
546,6,17,false,5,6,1,41.82319,-87.67661
179,6,17,false,3,2,-1,41.82458,-87.61678
13420,6,17,false,2,4,2,41.82459,-87.61678
18022,6,17,false,4,1,-3,41.82672,-87.68315
KA1503000066,6,17,false,2,1,-1,41.83011,-87.67031
TA1308000045,6,17,false,6,7,1,41.83062,-87.64129
TA1308000043,6,17,false,5,7,2,41.83066,-87.64715
15446,6,17,false,8,8,0,41.83068,-87.65603
KA1503000005,6,17,false,6,11,5,41.83079,-87.6325
184,6,17,false,2,3,1,41.83104,-87.62684
TA1307000129,6,17,false,7,12,5,41.83104,-87.62683
KA1503000004,6,17,false,48,31,-17,41.83127,-87.6088
406,6,17,false,3,10,7,41.83127,-87.6088
13345,6,17,false,11,10,-1,41.83138,-87.61803
15445,6,17,false,5,12,7,41.83453,-87.63183
13216,6,17,false,19,20,1,41.83473,-87.62581
148,6,17,false,1,1,0,41.83474,-87.62581
149,6,17,false,7,1,-6,41.83486,-87.61791
13217,6,17,false,12,14,2,41.83488,-87.61792
13215,6,17,false,14,23,9,41.83634,-87.6135
263,6,17,false,2,2,0,41.8364,-87.61348
280,6,17,false,3,4,1,41.83779,-87.65116
TA1308000046,6,17,false,17,23,6,41.83779,-87.65115
TA1309000055,6,17,false,17,6,-11,41.8382,-87.64514
KA1503000038,6,17,false,2,8,6,41.83845,-87.6354
150,6,17,false,5,10,5,41.83855,-87.60821
TA1307000048,6,17,false,105,122,17,41.83855,-87.60821
272,6,17,false,5,3,-2,41.83882,-87.62186
TA1308000036,6,17,false,5,4,-1,41.83883,-87.62186
368,6,17,false,3,1,-2,41.83915,-87.66562
15442,6,17,false,1,4,3,41.83918,-87.66562
KA1503000040,6,17,false,4,10,6,41.84164,-87.65744
13213,6,17,false,5,3,-2,41.84171,-87.62694
237,6,17,false,4,4,0,41.84204,-87.61697
TA1307000139,6,17,false,22,13,-9,41.84205,-87.61698
15443,6,17,false,12,12,0,41.84275,-87.63549
207,6,17,false,1,2,1,41.84358,-87.64539
147,6,17,false,3,3,0,41.84569,-87.62251
TA1307000005,6,17,false,12,10,-2,41.84569,-87.6225
206,6,17,false,1,1,0,41.84719,-87.64683
TA1308000013,6,17,false,6,5,-1,41.84719,-87.64681
KA1504000086,6,17,false,1,3,2,41.8482,-87.70542
15689,6,17,false,2,8,6,41.84912,-87.69515
TA1307000066,6,17,false,1,5,4,41.8492,-87.67564
TA1308000014,6,17,false,2,6,4,41.84953,-87.64059
209,6,17,false,1,6,5,41.84953,-87.64058
TA1308000026,6,17,false,8,15,7,41.85008,-87.63214
TA1305000004,6,17,false,28,30,2,41.8514,-87.61884
62,6,17,false,2,1,-1,41.85141,-87.61884
42,6,17,false,1,2,1,41.85261,-87.62653
TA1305000001,6,17,false,27,45,18,41.85262,-87.6265
13075,6,17,false,92,101,9,41.8531,-87.63192
120,6,17,false,7,7,0,41.8531,-87.63191
13162,6,17,false,11,6,-5,41.85378,-87.64659
15685,6,17,false,2,3,1,41.85399,-87.71511
13091,6,17,false,4,2,-2,41.85409,-87.68585
203,6,17,false,1,2,1,41.85409,-87.68585
15546,6,17,false,32,27,-5,41.85416,-87.61916
351,6,17,false,1,2,1,41.85441,-87.67678
13307,6,17,false,14,8,-6,41.85489,-87.66359
208,6,17,false,5,2,-3,41.85489,-87.66359
124,6,17,false,1,4,3,41.85492,-87.67609
13089,6,17,false,18,23,5,41.85497,-87.67567
13331,6,17,false,16,14,-2,41.85515,-87.65414
15545,6,17,false,86,76,-10,41.85627,-87.61334
4,6,17,false,17,18,1,41.85627,-87.61334
SL-013,6,17,false,17,14,-3,41.85659,-87.62755
218,6,17,false,4,3,-1,41.85679,-87.63387
SL-006,6,17,false,31,33,2,41.8568,-87.63387
129,6,17,false,6,4,-2,41.85752,-87.66158
13135,6,17,false,13,22,9,41.85753,-87.66157
338,6,17,false,6,12,6,41.85758,-87.61956
13102,6,17,false,74,66,-8,41.85762,-87.61942
273,6,17,false,5,12,7,41.85783,-87.62455
13150,6,17,false,31,49,18,41.85783,-87.62455
13099,6,17,false,8,15,7,41.85784,-87.64627
TA1307000159,6,17,false,21,23,2,41.8579,-87.6687
205,6,17,false,4,7,3,41.8579,-87.6687
170,6,17,false,2,1,-1,41.85793,-87.64083
TA1307000044,6,17,false,4,17,13,41.85794,-87.64083
14,6,17,false,1,2,1,41.85808,-87.65109
13163,6,17,false,21,19,-2,41.85808,-87.65108
13164,6,17,false,31,55,24,41.85818,-87.65648
15,6,17,false,4,6,2,41.85819,-87.65648
SL-012,6,17,false,33,33,0,41.86038,-87.62581
72,6,17,false,5,5,0,41.86039,-87.62581
13304,6,17,false,5,14,9,41.86126,-87.65659
KA1504000109,6,17,false,4,16,12,41.86192,-87.69347
137,6,17,false,5,3,-2,41.86238,-87.65108
TA1306000002,6,17,false,10,11,1,41.86238,-87.65108
TA1307000124,6,17,false,54,78,24,41.86411,-87.62372
168,6,17,false,4,7,3,41.86415,-87.62372
TA1309000001,6,17,false,23,26,3,41.86488,-87.64708
13165,6,17,false,7,6,-1,41.86505,-87.65697
13354,6,17,false,12,14,2,41.86524,-87.66651
13029,6,17,false,91,58,-33,41.86531,-87.6179
97,6,17,false,23,12,-11,41.86531,-87.6179
341,6,17,false,37,37,0,41.86608,-87.60733
13431,6,17,false,252,162,-90,41.8661,-87.60728
KA1504000101,6,17,false,11,12,1,41.86651,-87.68466
KA1504000102,6,17,false,3,5,2,41.86664,-87.69453
WL-008,6,17,false,27,29,2,41.86712,-87.64108
57,6,17,false,5,8,3,41.86712,-87.64107
TA1305000002,6,17,false,102,73,-29,41.86721,-87.62597
59,6,17,false,17,27,10,41.86721,-87.62597
15544,6,17,false,212,168,-44,41.86723,-87.61536
3,6,17,false,72,49,-23,41.86723,-87.61536
TA1305000017,6,17,false,10,10,0,41.86734,-87.64863
55,6,17,false,1,4,3,41.86735,-87.64863
626,6,17,false,11,12,1,41.86749,-87.63219
KA1706005007,6,17,false,28,34,6,41.86749,-87.63219
SL-005,6,17,false,261,242,-19,41.8679,-87.62304
255,6,17,false,53,75,22,41.86791,-87.62304
644,6,17,false,5,9,4,41.86859,-87.68625
19,6,17,false,1,1,0,41.86892,-87.65913
13139,6,17,false,19,9,-10,41.86893,-87.65913
13285,6,17,false,11,6,-5,41.86928,-87.67372
22,6,17,false,5,6,1,41.86947,-87.65548
13160,6,17,false,26,29,3,41.86947,-87.65548
382,6,17,false,1,2,1,41.8699,-87.68725
414,6,17,false,6,7,1,41.87023,-87.63947
15550,6,17,false,30,34,4,41.87024,-87.63947
TA1309000010,6,17,false,95,133,38,41.87074,-87.62574
SL-009,6,17,false,27,24,-3,41.87081,-87.63121
342,6,17,false,3,4,1,41.87127,-87.6737
TA1309000064,6,17,false,5,1,-4,41.87127,-87.67369
15542,6,17,false,5,8,3,41.87146,-87.64095
103,6,17,false,4,6,2,41.87146,-87.64094
261,6,17,false,3,1,-2,41.87151,-87.6699
TA1307000130,6,17,false,18,16,-2,41.87178,-87.65103
241,6,17,false,2,2,0,41.8718,-87.65102
108,6,17,false,1,3,2,41.87183,-87.64664
TA1307000121,6,17,false,8,11,3,41.87184,-87.64664
41,6,17,false,17,24,7,41.87209,-87.62957
SL-008,6,17,false,92,102,10,41.87209,-87.62956
13332,6,17,false,21,25,4,41.87219,-87.6615
175,6,17,false,6,16,10,41.87255,-87.63359
SL-011,6,17,false,55,72,17,41.87256,-87.63356
623,6,17,false,160,181,21,41.87272,-87.62399
KA1504000104,6,17,false,6,5,-1,41.87296,-87.66912
16915,6,17,false,2,2,0,41.873,-87.7645
320,6,17,false,4,5,1,41.87327,-87.66402
KA1504000082,6,17,false,1,1,0,41.87361,-87.70488
5,6,17,false,11,6,-5,41.87403,-87.6277
SL-007,6,17,false,42,54,12,41.87404,-87.6277
169,6,17,false,1,3,2,41.87424,-87.63959
13326,6,17,false,14,13,-1,41.87425,-87.63958
321,6,17,false,9,15,6,41.87427,-87.63257
535,6,17,false,3,1,-2,41.87433,-87.72582
TA1306000025,6,17,false,15,20,5,41.87464,-87.65703
15668,6,17,false,7,9,2,41.87471,-87.68642
13028,6,17,false,19,16,-3,41.87475,-87.64981
89,6,17,false,4,2,-2,41.87501,-87.6331
SL-010,6,17,false,17,29,12,41.87501,-87.63309
16907,6,17,false,1,2,1,41.87568,-87.71549
15541,6,17,false,155,153,-2,41.8758,-87.62086
68,6,17,false,1,2,1,41.87587,-87.64077
13037,6,17,false,13,7,-6,41.87588,-87.64078
50,6,17,false,2,3,1,41.87592,-87.6307
TA1305000009,6,17,false,14,24,10,41.87593,-87.63068
317,6,17,false,1,1,0,41.87603,-87.68195
45,6,17,false,7,10,3,41.87623,-87.62444
TA1305000010,6,17,false,52,75,23,41.87623,-87.62444
624,6,17,false,33,33,0,41.87626,-87.62923
2,6,17,false,19,46,27,41.87649,-87.62051
33,6,17,false,7,6,-1,41.87715,-87.62786
TA1305000035,6,17,false,52,45,-7,41.87716,-87.62787
13138,6,17,false,6,13,7,41.87723,-87.63941
631,6,17,false,6,4,-2,41.87761,-87.6739
16913,6,17,false,1,2,1,41.87762,-87.7454
15539,6,17,false,45,55,10,41.87763,-87.64405
13158,6,17,false,65,59,-6,41.87764,-87.64957
134,6,17,false,7,7,0,41.87764,-87.64954
21,6,17,false,5,4,-1,41.87773,-87.6548
13157,6,17,false,40,45,5,41.87773,-87.6548
TA1305000025,6,17,false,87,61,-26,41.87773,-87.63528
36,6,17,false,20,14,-6,41.87776,-87.63525
284,6,17,false,9,17,8,41.87784,-87.62408
TA1309000002,6,17,false,136,160,24,41.87784,-87.62408
146,6,17,false,6,4,-2,41.87794,-87.66201
13206,6,17,false,24,35,11,41.87794,-87.66201
283,6,17,false,6,3,-3,41.87809,-87.63183
TA1309000004,6,17,false,30,15,-15,41.87811,-87.63184
107,6,17,false,3,10,7,41.87822,-87.644
638,6,17,false,32,37,5,41.87827,-87.64078
37,6,17,false,4,8,4,41.87921,-87.62975
TA1305000005,6,17,false,31,36,5,41.87924,-87.62975
286,6,17,false,2,2,0,41.8793,-87.6355
13011,6,17,false,52,42,-10,41.87931,-87.63993
TA1309000008,6,17,false,57,60,3,41.87933,-87.6355
192,6,17,false,8,8,0,41.87935,-87.63997
KA1503000034,6,17,false,22,26,4,41.87938,-87.63197
40,6,17,false,3,1,-2,41.87944,-87.63197
39,6,17,false,13,11,-2,41.87948,-87.62571
KA1503000015,6,17,false,49,60,11,41.87948,-87.6257
15667,6,17,false,5,10,5,41.8798,-87.68609
381,6,17,false,2,2,0,41.87981,-87.68607
16916,6,17,false,1,1,0,41.88012,-87.76323
287,6,17,false,13,5,-8,41.88017,-87.63527
540,6,17,false,1,1,0,41.88022,-87.75536
TA1309000007,6,17,false,34,31,-3,41.88022,-87.63526
WL-011,6,17,false,24,32,8,41.88034,-87.64273
73,6,17,false,2,4,2,41.8804,-87.64273
80,6,17,false,3,8,5,41.88042,-87.65556
13156,6,17,false,80,57,-23,41.88042,-87.65554
13300,6,17,false,724,691,-33,41.88097,-87.61675
76,6,17,false,82,95,13,41.88098,-87.61675
13008,6,17,false,449,517,68,41.88105,-87.62408
90,6,17,false,81,97,16,41.88107,-87.62409
49,6,17,false,11,13,2,41.88116,-87.62963
TA1305000006,6,17,false,69,84,15,41.88122,-87.6296
13134,6,17,false,20,39,19,41.88138,-87.67493
13056,6,17,false,30,34,4,41.88168,-87.63951
191,6,17,false,7,4,-3,41.88169,-87.63951
198,6,17,false,13,20,7,41.88187,-87.6488
TA1307000120,6,17,false,92,131,39,41.88188,-87.64879
13341,6,17,false,46,51,5,41.88208,-87.63985
174,6,17,false,7,2,-5,41.88208,-87.63984
197,6,17,false,17,11,-6,41.88208,-87.62513
13036,6,17,false,94,102,8,41.8821,-87.62513
77,6,17,false,10,9,-1,41.88214,-87.64108
TA1305000032,6,17,false,85,77,-8,41.88218,-87.64109
98,6,17,false,2,4,2,41.88266,-87.63251
13006,6,17,false,29,28,-1,41.88268,-87.63252
13353,6,17,false,34,42,8,41.88283,-87.6612
346,6,17,false,5,8,3,41.88284,-87.6612
654,6,17,false,26,24,-2,41.88307,-87.65698
233,6,17,false,4,17,13,41.88309,-87.6511
13409,6,17,false,42,78,36,41.8831,-87.6511
18,6,17,false,1,7,6,41.88317,-87.63735
KA1503000072,6,17,false,14,32,18,41.88317,-87.63693
91,6,17,false,11,7,-4,41.88336,-87.64122
WL-012,6,17,false,42,57,15,41.88337,-87.6412
112,6,17,false,10,22,12,41.88362,-87.6486
13053,6,17,false,147,166,19,41.88365,-87.64863
43,6,17,false,24,28,4,41.88396,-87.62455
13001,6,17,false,184,193,9,41.88397,-87.62459
88,6,17,false,2,11,9,41.88407,-87.65691
13155,6,17,false,24,31,7,41.88407,-87.65689
18062,6,17,false,46,39,-7,41.88412,-87.65427
621,6,17,false,11,16,5,41.88412,-87.65427
81,6,17,false,19,9,-10,41.88417,-87.6296
TA1306000010,6,17,false,68,59,-9,41.88419,-87.62961
15666,6,17,false,8,3,-5,41.88446,-87.6963
KA1504000106,6,17,false,2,1,-1,41.88459,-87.70631
TA1305000030,6,17,false,33,38,5,41.88459,-87.63178
96,6,17,false,8,6,-2,41.8846,-87.64455
15535,6,17,false,50,74,24,41.8846,-87.64455
51,6,17,false,8,11,3,41.88462,-87.63176
TA1305000029,6,17,false,143,145,2,41.88466,-87.62787
195,6,17,false,16,29,13,41.88466,-87.61952
13263,6,17,false,168,163,-5,41.88467,-87.61952
44,6,17,false,13,20,7,41.88468,-87.62782
TA1306000015,6,17,false,103,138,35,41.88549,-87.65232
518,6,17,false,9,7,-2,41.8855,-87.71686
71,6,17,false,13,16,3,41.8855,-87.65233
66,6,17,false,8,4,-4,41.88557,-87.64186
13021,6,17,false,50,91,41,41.88559,-87.64184
TA1307000111,6,17,false,57,94,37,41.88582,-87.63548
164,6,17,false,8,16,8,41.88583,-87.63547
13073,6,17,false,26,38,12,41.88592,-87.66717
119,6,17,false,1,5,4,41.88593,-87.66717
656,6,17,false,8,2,-6,41.88595,-87.67701
KA17018054,6,17,false,11,14,3,41.88595,-87.67701
38,6,17,false,12,2,-10,41.88599,-87.63089
KA1503000012,6,17,false,90,118,28,41.88599,-87.63089
52,6,17,false,37,47,10,41.886,-87.62421
TA1305000011,6,17,false,205,220,15,41.886,-87.62418
7,6,17,false,14,16,2,41.88627,-87.61751
15534,6,17,false,97,102,5,41.88627,-87.61749
217,6,17,false,2,2,0,41.8866,-87.65821
13197,6,17,false,16,9,-7,41.8866,-87.65816
264,6,17,false,4,4,0,41.8867,-87.62224
TA1308000029,6,17,false,75,121,46,41.88673,-87.62225
16903,6,17,false,1,1,0,41.88686,-87.74531
194,6,17,false,40,45,5,41.88688,-87.62606
TA1307000131,6,17,false,155,171,16,41.88688,-87.62606
6,6,17,false,26,29,3,41.88697,-87.61281
KA1503000064,6,17,false,252,271,19,41.88697,-87.61281
16905,6,17,false,2,1,-1,41.88767,-87.76547
530,6,17,false,1,1,0,41.88783,-87.75558
532,6,17,false,1,1,0,41.88792,-87.77446
100,6,17,false,6,3,-3,41.88814,-87.63657
TA1305000022,6,17,false,52,55,3,41.88817,-87.63656
56,6,17,false,12,25,13,41.88866,-87.64442
TA1306000003,6,17,false,106,108,2,41.88867,-87.64442
KA1503000043,6,17,false,107,98,-9,41.88918,-87.63851
133,6,17,false,8,14,6,41.88918,-87.63851
13050,6,17,false,134,153,19,41.88919,-87.62775
47,6,17,false,15,17,2,41.88921,-87.62775
15664,6,17,false,3,4,1,41.8895,-87.68821
13432,6,17,false,43,32,-11,41.88989,-87.67149
285,6,17,false,8,8,0,41.88989,-87.67149
TA1307000151,6,17,false,102,111,9,41.88993,-87.63427
212,6,17,false,15,23,8,41.88995,-87.63427
636,6,17,false,37,46,9,41.88997,-87.63662
125,6,17,false,9,15,6,41.89018,-87.62621
KA1503000044,6,17,false,52,61,9,41.89018,-87.6262
196,6,17,false,14,12,-2,41.89053,-87.62205
13427,6,17,false,93,88,-5,41.89054,-87.62205
26,6,17,false,11,32,21,41.89057,-87.61798
13430,6,17,false,160,220,60,41.89077,-87.63169
181,6,17,false,12,33,21,41.89077,-87.63168
TA1306000013,6,17,false,210,240,30,41.89083,-87.61852
RN-,6,17,false,75,94,19,41.89102,-87.63546
672,6,17,false,15,17,2,41.89102,-87.63545
277,6,17,false,7,6,-1,41.89108,-87.66665
13434,6,17,false,42,40,-2,41.89108,-87.66663
TA1308000006,6,17,false,40,19,-21,41.89128,-87.67686
199,6,17,false,37,38,1,41.89143,-87.62676
TA1307000117,6,17,false,209,247,38,41.89144,-87.62675
13033,6,17,false,93,106,13,41.8916,-87.64835
214,6,17,false,3,4,1,41.89161,-87.67688
84,6,17,false,11,26,15,41.89161,-87.64833
186,6,17,false,8,11,3,41.8918,-87.65879
13194,6,17,false,44,40,-4,41.8918,-87.65878
TA1305000003,6,17,false,187,209,22,41.89187,-87.62061
24,6,17,false,23,44,21,41.8919,-87.62063
643,6,17,false,13,15,2,41.89203,-87.68939
35,6,17,false,58,103,45,41.89227,-87.61206
13022,6,17,false,1284,1289,5,41.89227,-87.61205
99,6,17,false,12,24,12,41.89255,-87.61449
TA1306000029,6,17,false,206,217,11,41.89256,-87.61449
13265,6,17,false,72,72,0,41.89383,-87.64172
74,6,17,false,6,11,5,41.89384,-87.64173
13045,6,17,false,129,186,57,41.89403,-87.62931
110,6,17,false,19,18,-1,41.89406,-87.6293
13016,6,17,false,111,135,24,41.89431,-87.62277
211,6,17,false,10,26,16,41.89439,-87.62267
KA1503000041,6,17,false,81,86,5,41.89452,-87.61798
142,6,17,false,3,9,6,41.89453,-87.61806
92,6,17,false,6,9,3,41.89455,-87.65346
13196,6,17,false,69,72,3,41.89455,-87.65345
TA1307000062,6,17,false,35,54,19,41.89466,-87.63839
111,6,17,false,1,6,5,41.89466,-87.63837
TA1306000012,6,17,false,129,137,8,41.89475,-87.63438
53,6,17,false,22,22,0,41.89476,-87.63439
627,6,17,false,8,15,7,41.8948,-87.63231
KP1705001026,6,17,false,80,96,16,41.89483,-87.6323
16921,6,17,false,8,3,-5,41.89488,-87.77459
KA1504000114,6,17,false,3,7,4,41.89547,-87.70614
659,6,17,false,1,3,2,41.8955,-87.68201
18058,6,17,false,16,33,17,41.8955,-87.68201
637,6,17,false,32,32,0,41.89563,-87.67209
128,6,17,false,1,3,2,41.89571,-87.67716
13132,6,17,false,51,67,16,41.89573,-87.67718
161,6,17,false,15,22,7,41.89574,-87.62599
15530,6,17,false,131,132,1,41.89575,-87.62596
18003,6,17,false,41,36,-5,41.89575,-87.62011
635,6,17,false,2,6,4,41.89576,-87.62012
13247,6,17,false,59,47,-12,41.89597,-87.66775
350,6,17,false,2,9,7,41.89597,-87.66774
TA1305000020,6,17,false,67,46,-21,41.89636,-87.65406
54,6,17,false,4,11,7,41.89637,-87.65407
13289,6,17,false,40,59,19,41.89638,-87.661
86,6,17,false,11,2,-9,41.89639,-87.661
337,6,17,false,14,15,1,41.89659,-87.63096
13303,6,17,false,96,105,9,41.89672,-87.63088
13017,6,17,false,59,44,-15,41.89676,-87.6357
31,6,17,false,6,2,-4,41.89677,-87.63572
13338,6,17,false,96,78,-18,41.89697,-87.62173
173,6,17,false,19,16,-3,41.89704,-87.62173
TA1307000061,6,17,false,67,50,-17,41.89745,-87.62873
106,6,17,false,15,3,-12,41.89746,-87.62874
25,6,17,false,29,27,-2,41.89751,-87.62354
13034,6,17,false,175,185,10,41.89754,-87.62352
48,6,17,false,4,1,-3,41.89772,-87.64302
TA1306000009,6,17,false,38,44,6,41.89772,-87.64299
620,6,17,false,51,61,10,41.89817,-87.63754
374,6,17,false,4,5,1,41.89842,-87.68659
KA1504000103,6,17,false,28,30,2,41.89842,-87.68659
145,6,17,false,25,21,-4,41.89856,-87.62211
15529,6,17,false,102,117,15,41.89858,-87.62206
140,6,17,false,25,20,-5,41.89895,-87.6299
TA1307000128,6,17,false,106,120,14,41.89896,-87.6299
657,6,17,false,28,45,17,41.89918,-87.6722
KA1504000117,6,17,false,6,3,-3,41.89936,-87.64848
365,6,17,false,1,3,2,41.89936,-87.64848
30,6,17,false,3,1,-2,41.89964,-87.66789
13248,6,17,false,24,31,7,41.89964,-87.66788
46,6,17,false,2,8,6,41.89994,-87.63444
TA1306000011,6,17,false,47,31,-16,41.89994,-87.63443
364,6,17,false,2,5,3,41.90023,-87.64299
KA1504000116,6,17,false,27,33,6,41.90023,-87.64299
17660,6,17,false,22,30,8,41.90036,-87.69671
622,6,17,false,1,5,4,41.90037,-87.69671
29,6,17,false,3,3,0,41.90069,-87.66259
13290,6,17,false,41,61,20,41.90069,-87.66259
13042,6,17,false,514,549,35,41.90097,-87.62377
85,6,17,false,44,70,26,41.90098,-87.62375
183,6,17,false,7,9,2,41.90133,-87.67744
TA1307000070,6,17,false,43,57,14,41.90133,-87.67742
KA1504000133,6,17,false,133,144,11,41.90234,-87.62773
172,6,17,false,27,14,-13,41.90236,-87.62774
15654,6,17,false,5,9,4,41.90271,-87.70923
305,6,17,false,4,3,-1,41.9028,-87.69005
13241,6,17,false,29,17,-12,41.9029,-87.68731
176,6,17,false,33,27,-6,41.90291,-87.63141
23,6,17,false,3,3,0,41.90292,-87.63772
TA1306000006,6,17,false,28,32,4,41.90292,-87.63772
TA1307000039,6,17,false,209,218,9,41.90294,-87.63137
658,6,17,false,10,17,7,41.903,-87.6838
13256,6,17,false,26,16,-10,41.90302,-87.69749
216,6,17,false,1,1,0,41.90302,-87.69749
17,6,17,false,5,6,1,41.90313,-87.67391
TA1305000034,6,17,false,80,87,7,41.90313,-87.67391
182,6,17,false,22,19,-3,41.90317,-87.63442
KA1504000135,6,17,false,240,226,-14,41.90319,-87.63439
13136,6,17,false,63,74,11,41.90326,-87.67845
130,6,17,false,6,5,-1,41.90327,-87.67846
210,6,17,false,12,12,0,41.90342,-87.66781
13061,6,17,false,111,142,31,41.90342,-87.66779
KA1504000079,6,17,false,55,61,6,41.9035,-87.64334
398,6,17,false,3,1,-2,41.90386,-87.70941
359,6,17,false,9,5,-4,41.90458,-87.6497
138,6,17,false,3,6,3,41.9046,-87.64057
TA1307000115,6,17,false,25,37,12,41.9046,-87.64056
291,6,17,false,23,28,5,41.90672,-87.63494
TA1308000049,6,17,false,182,180,-2,41.90672,-87.6349
KA1504000134,6,17,false,91,81,-10,41.90687,-87.6262
180,6,17,false,2,23,21,41.90687,-87.62618
333,6,17,false,8,11,3,41.90706,-87.66725
13224,6,17,false,50,77,27,41.90706,-87.66725
TA1307000143,6,17,false,56,43,-13,41.90762,-87.63854
236,6,17,false,4,3,-1,41.90762,-87.63853
61,6,17,false,12,7,-5,41.90764,-87.67254
13221,6,17,false,99,121,22,41.90765,-87.67254
159,6,17,false,2,3,1,41.90777,-87.68586
13245,6,17,false,10,14,4,41.90777,-87.68586
301,6,17,false,10,19,9,41.90796,-87.63203
TA1309000024,6,17,false,137,101,-36,41.908,-87.63152
69,6,17,false,11,10,-1,41.90939,-87.6777
TA1305000041,6,17,false,158,186,28,41.9094,-87.67769
15652,6,17,false,5,7,2,41.90965,-87.71664
331,6,17,false,114,122,8,41.90965,-87.64812
15653,6,17,false,18,16,-2,41.90979,-87.7053
509,6,17,false,1,3,2,41.9098,-87.70531
TA1305000037,6,17,false,55,62,7,41.91018,-87.67003
27,6,17,false,5,4,-1,41.91019,-87.6435
TA1306000008,6,17,false,51,54,3,41.9102,-87.6435
16,6,17,false,7,12,5,41.91035,-87.67008
213,6,17,false,2,9,7,41.91037,-87.68237
TA1308000005,6,17,false,55,41,-14,41.91042,-87.68238
276,6,17,false,8,1,-7,41.91043,-87.69718
13258,6,17,false,19,23,4,41.91043,-87.69718
160,6,17,false,2,5,3,41.91054,-87.68957
13257,6,17,false,33,22,-11,41.91054,-87.68956
13154,6,17,false,86,75,-11,41.91054,-87.65312
20,6,17,false,6,9,3,41.91055,-87.65313
60,6,17,false,10,6,-4,41.91059,-87.64942
13058,6,17,false,57,56,-1,41.91059,-87.64942
TA1307000038,6,17,false,131,118,-13,41.91138,-87.63868
118,6,17,false,2,5,3,41.91138,-87.63868
LF-005,6,17,false,609,499,-110,41.91172,-87.62681
268,6,17,false,39,62,23,41.91172,-87.62681
126,6,17,false,11,11,0,41.91196,-87.63197
13128,6,17,false,125,116,-9,41.91197,-87.63197
289,6,17,false,27,28,1,41.91209,-87.63472
TA1308000050,6,17,false,335,285,-50,41.91211,-87.6347
158,6,17,false,13,16,3,41.91262,-87.6814
13243,6,17,false,81,97,16,41.91262,-87.6814
TA1309000032,6,17,false,9,21,12,41.91293,-87.66417
TA1306000032,6,17,false,65,88,23,41.9137,-87.65285
93,6,17,false,9,2,-7,41.91371,-87.65285
224,6,17,false,3,15,12,41.91386,-87.64877
TA1307000166,6,17,false,53,80,27,41.91386,-87.64877
511,6,17,false,5,5,0,41.914,-87.70515
15655,6,17,false,24,35,11,41.91401,-87.70514
641,6,17,false,3,1,-2,41.91416,-87.71676
18017,6,17,false,28,28,0,41.91416,-87.71676
18067,6,17,false,50,47,-3,41.9146,-87.66796
628,6,17,false,2,2,0,41.9146,-87.66796
28,6,17,false,2,1,-1,41.91469,-87.64333
TA1306000007,6,17,false,31,49,18,41.91469,-87.64333
13068,6,17,false,48,72,24,41.91554,-87.68703
116,6,17,false,7,10,3,41.91555,-87.68703
13179,6,17,false,276,247,-29,41.9157,-87.63461
141,6,17,false,36,20,-16,41.91571,-87.63461
219,6,17,false,15,9,-6,41.91598,-87.67733
13133,6,17,false,107,121,14,41.91598,-87.67733
58,6,17,false,5,5,0,41.91602,-87.66894
TA1305000039,6,17,false,50,63,13,41.9163,-87.66749
506,6,17,false,1,5,4,41.91711,-87.71023
15650,6,17,false,22,36,14,41.91711,-87.71023
15651,6,17,false,39,38,-1,41.91752,-87.70181
507,6,17,false,7,6,-1,41.91752,-87.70181
185,6,17,false,2,4,2,41.91774,-87.69143
13266,6,17,false,34,36,2,41.91774,-87.69142
TA1309000029,6,17,false,17,45,28,41.9178,-87.68245
309,6,17,false,1,5,4,41.91789,-87.6865
288,6,17,false,8,2,-6,41.91809,-87.64375
TA1309000006,6,17,false,64,72,8,41.91809,-87.64375
223,6,17,false,5,8,3,41.91821,-87.65698
TA1307000163,6,17,false,53,54,1,41.91821,-87.65696
94,6,17,false,15,22,7,41.91831,-87.6363
13146,6,17,false,311,230,-81,41.91831,-87.63629
13059,6,17,false,129,141,12,41.91845,-87.65222
113,6,17,false,14,14,0,41.91846,-87.65222
13259,6,17,false,33,37,4,41.91852,-87.69744
259,6,17,false,2,6,4,41.91853,-87.69745
310,6,17,false,4,8,4,41.91984,-87.68083
225,6,17,false,8,15,7,41.91995,-87.64884
13192,6,17,false,93,104,11,41.91995,-87.64884
13288,6,17,false,39,57,18,41.92008,-87.67788
13242,6,17,false,35,35,0,41.92021,-87.69266
222,6,17,false,4,2,-2,41.92023,-87.69265
307,6,17,false,3,2,-1,41.92077,-87.66373
TA1309000030,6,17,false,51,81,30,41.92077,-87.66372
290,6,17,false,6,9,3,41.92152,-87.70734
13292,6,17,false,17,34,17,41.92152,-87.70733
TA1309000033,6,17,false,98,100,2,41.92158,-87.65381
13193,6,17,false,166,205,39,41.92182,-87.64412
144,6,17,false,17,22,5,41.92182,-87.64411
13191,6,17,false,114,94,-20,41.92217,-87.63891
143,6,17,false,1,12,11,41.92217,-87.63891
327,6,17,false,24,15,-9,41.92225,-87.65783
13084,6,17,false,75,81,6,41.92268,-87.69715
123,6,17,false,10,5,-5,41.92268,-87.69714
LP-,6,17,false,163,107,-56,41.92396,-87.63584
673,6,17,false,17,11,-6,41.92398,-87.63585
KA1504000140,6,17,false,30,7,-23,41.92409,-87.67646
619,6,17,false,2,1,-1,41.92457,-87.7279
16010,6,17,false,5,10,5,41.92458,-87.72787
504,6,17,false,4,5,1,41.92464,-87.68931
15648,6,17,false,16,31,15,41.92464,-87.68931
503,6,17,false,1,4,3,41.92483,-87.71451
KA1504000090,6,17,false,27,36,9,41.92483,-87.7145
TA1307000001,6,17,false,49,103,54,41.92535,-87.66581
188,6,17,false,2,8,6,41.92536,-87.66581
TA1306000026,6,17,false,52,58,6,41.92558,-87.65842
87,6,17,false,5,7,2,41.92559,-87.65843
67,6,17,false,9,5,-4,41.9256,-87.65371
TA1306000016,6,17,false,84,85,1,41.9256,-87.65371
313,6,17,false,29,20,-9,41.9257,-87.64246
TA1309000019,6,17,false,185,187,2,41.92586,-87.63897
TA1309000058,6,17,false,135,168,33,41.92591,-87.64927
127,6,17,false,15,14,-1,41.92592,-87.64927
TA1308000001,6,17,false,460,457,-3,41.92627,-87.63086
177,6,17,false,54,65,11,41.92627,-87.63086
15646,6,17,false,19,36,17,41.92668,-87.6977
13124,6,17,false,102,78,-24,41.92675,-87.63444
34,6,17,false,17,6,-11,41.92675,-87.63444
302,6,17,false,24,14,-10,41.92859,-87.65421
TA1309000023,6,17,false,117,147,30,41.9287,-87.65383
TA1307000113,6,17,false,96,119,23,41.92878,-87.66391
190,6,17,false,9,7,-2,41.92878,-87.6639
166,6,17,false,4,6,2,41.92883,-87.66853
13296,6,17,false,45,59,14,41.92883,-87.66852
TA1309000059,6,17,false,65,65,0,41.92889,-87.65898
343,6,17,false,3,4,1,41.92889,-87.65898
349,6,17,false,6,18,12,41.92915,-87.6491
TA1309000061,6,17,false,113,134,21,41.92915,-87.64909
258,6,17,false,9,10,1,41.92946,-87.68417
TA1308000031,6,17,false,41,46,5,41.92946,-87.68417
340,6,17,false,14,21,7,41.92956,-87.64313
TA1305000014,6,17,false,136,156,20,41.92956,-87.64313
260,6,17,false,9,19,10,41.92958,-87.70791
13085,6,17,false,55,83,28,41.92958,-87.70789
499,6,17,false,1,2,1,41.93056,-87.72381
15643,6,17,false,10,14,4,41.93057,-87.7238
TA1307000142,6,17,false,148,128,-20,41.93125,-87.64432
220,6,17,false,10,12,2,41.93125,-87.64431
13276,6,17,false,157,132,-25,41.93132,-87.63874
324,6,17,false,22,17,-5,41.93173,-87.64179
15645,6,17,false,13,29,16,41.93191,-87.70121
163,6,17,false,6,3,-3,41.93191,-87.67784
13271,6,17,false,34,29,-5,41.93192,-87.67784
152,6,17,false,6,11,5,41.93221,-87.65864
TA1307000064,6,17,false,88,92,4,41.93222,-87.65864
TA1306000014,6,17,false,111,101,-10,41.93242,-87.65271
13,6,17,false,6,17,11,41.93242,-87.65271
TA1309000039,6,17,false,197,168,-29,41.93258,-87.63642
329,6,17,false,26,17,-9,41.93258,-87.63642
13294,6,17,false,37,69,32,41.9326,-87.66595
319,6,17,false,4,8,4,41.93292,-87.67217
332,6,17,false,12,16,4,41.93313,-87.64776
TA1309000036,6,17,false,61,68,7,41.93313,-87.64776
15644,6,17,false,8,11,3,41.93534,-87.71687
TA1307000006,6,17,false,98,91,-7,41.93571,-87.6636
153,6,17,false,1,14,13,41.93575,-87.66364
162,6,17,false,3,2,-1,41.93588,-87.67844
13268,6,17,false,32,45,13,41.93588,-87.67843
13269,6,17,false,30,22,-8,41.93609,-87.66983
TA1307000052,6,17,false,121,103,-18,41.93628,-87.65266
115,6,17,false,15,25,10,41.93628,-87.65266
156,6,17,false,18,14,-4,41.9365,-87.64756
TA1307000136,6,17,false,127,149,22,41.9365,-87.64755
TA1307000041,6,17,false,195,194,-1,41.93669,-87.63683
157,6,17,false,15,13,-2,41.9367,-87.63683
13137,6,17,false,166,152,-14,41.9376,-87.6441
300,6,17,false,14,16,2,41.93761,-87.6441
498,6,17,false,4,6,2,41.93843,-87.69801
15642,6,17,false,28,31,3,41.93843,-87.69801
154,6,17,false,7,10,3,41.93912,-87.66384
KA17018068,6,17,false,18,37,19,41.93935,-87.68327
TA1309000042,6,17,false,48,53,5,41.93937,-87.66836
131,6,17,false,16,10,-6,41.93937,-87.66835
496,6,17,false,1,1,0,41.9394,-87.72356
KA150400009X,6,17,false,4,11,7,41.9394,-87.71159
15640,6,17,false,5,12,7,41.93941,-87.72357
497,6,17,false,1,2,1,41.93941,-87.71159
13229,6,17,false,85,67,-18,41.93946,-87.66376
226,6,17,false,8,15,7,41.93972,-87.65886
TA1308000019,6,17,false,149,120,-29,41.93973,-87.65886
296,6,17,false,7,14,7,41.9401,-87.64546
13277,6,17,false,110,127,17,41.9401,-87.64546
TA1307000134,6,17,false,213,217,4,41.94016,-87.65303
117,6,17,false,18,31,13,41.94016,-87.65302
228,6,17,false,2,2,0,41.94058,-87.67854
13143,6,17,false,29,41,12,41.94059,-87.67853
334,6,17,false,16,33,17,41.94076,-87.63919
TA1309000049,6,17,false,187,249,62,41.94077,-87.63919
308,6,17,false,3,7,4,41.94152,-87.68471
15634,6,17,false,14,10,-4,41.94304,-87.68729
TA1307000138,6,17,false,65,63,-2,41.94334,-87.67094
230,6,17,false,3,3,0,41.94335,-87.67093
13144,6,17,false,40,45,5,41.9434,-87.67964
299,6,17,false,13,18,5,41.94368,-87.64894
TA1309000025,6,17,false,116,145,29,41.94368,-87.64894
229,6,17,false,24,15,-9,41.94372,-87.66401
13071,6,17,false,122,153,31,41.94373,-87.66401
632,6,17,false,253,252,-1,41.94453,-87.6547
303,6,17,false,13,9,-4,41.94522,-87.64702
15631,6,17,false,10,16,6,41.94524,-87.70665
13278,6,17,false,145,141,-4,41.94553,-87.64644
330,6,17,false,2,2,0,41.94618,-87.67331
TA1309000050,6,17,false,15,24,9,41.94618,-87.67331
KA1504000141,6,17,false,9,7,-2,41.94627,-87.73105
492,6,17,false,3,2,-1,41.94662,-87.68337
491,6,17,false,2,6,4,41.94664,-87.69463
15632,6,17,false,6,12,6,41.94664,-87.69463
KA1504000143,6,17,false,14,17,3,41.94664,-87.68337
KA1504000142,6,17,false,5,6,1,41.94735,-87.71759
16994,6,17,false,5,3,-2,41.94784,-87.74
227,6,17,false,19,15,-4,41.94813,-87.66397
13235,6,17,false,91,117,26,41.94814,-87.66396
304,6,17,false,9,6,-3,41.94878,-87.64922
13253,6,17,false,26,25,-1,41.9488,-87.67527
257,6,17,false,1,4,3,41.9488,-87.67527
13325,6,17,false,90,95,5,41.94907,-87.64863
114,6,17,false,17,18,1,41.94935,-87.65451
TA1307000126,6,17,false,154,180,26,41.94936,-87.65451
232,6,17,false,9,18,9,41.94943,-87.64645
TA1307000150,6,17,false,153,115,-38,41.94945,-87.64646
18016,6,17,false,9,6,-3,41.94993,-87.71395
347,6,17,false,2,6,4,41.95068,-87.6687
13319,6,17,false,32,45,13,41.95069,-87.6687
TA1307000127,6,17,false,133,135,2,41.9508,-87.65918
165,6,17,false,14,10,-4,41.95081,-87.65918
487,6,17,false,2,2,0,41.95216,-87.69806
15628,6,17,false,15,25,10,41.95216,-87.69806
318,6,17,false,7,14,7,41.95254,-87.6735
13323,6,17,false,62,71,9,41.95282,-87.65
256,6,17,false,4,16,12,41.95282,-87.65
15624,6,17,false,3,5,2,41.95339,-87.73199
483,6,17,false,5,1,-4,41.9534,-87.73199
314,6,17,false,3,2,-1,41.9535,-87.69199
485,6,17,false,3,5,2,41.95361,-87.70933
KA1504000096,6,17,false,1,6,5,41.95361,-87.70932
590,6,17,false,2,1,-1,41.95374,-87.74056
KA1504000139,6,17,false,5,13,8,41.954,-87.71909
484,6,17,false,2,1,-1,41.954,-87.71907
TA1309000043,6,17,false,43,37,-6,41.95417,-87.66434
240,6,17,false,5,10,5,41.95424,-87.65441
13063,6,17,false,55,69,14,41.95424,-87.65441
486,6,17,false,3,1,-2,41.95431,-87.68607
KA1504000158,6,17,false,19,22,3,41.95432,-87.68607
254,6,17,false,14,10,-4,41.95438,-87.64806
TA1308000022,6,17,false,83,102,19,41.95438,-87.64805
16991,6,17,false,1,2,1,41.95448,-87.7496
244,6,17,false,4,2,-2,41.95466,-87.67391
TA1307000149,6,17,false,36,38,2,41.95467,-87.67392
298,6,17,false,3,5,2,41.95601,-87.68021
TA1309000026,6,17,false,27,28,1,41.95601,-87.6802
13249,6,17,false,12,11,-1,41.95606,-87.66885
246,6,17,false,2,4,2,41.95606,-87.66885
312,6,17,false,13,11,-2,41.95637,-87.6563
TA1308000047,6,17,false,20,30,10,41.95709,-87.6642
13379,6,17,false,47,57,10,41.95786,-87.6495
TA1309000018,6,17,false,23,20,-3,41.95791,-87.67357
316,6,17,false,5,5,0,41.95841,-87.69401
306,6,17,false,6,5,-1,41.9585,-87.655
TA1309000027,6,17,false,32,35,3,41.9585,-87.65499
592,6,17,false,2,4,2,41.96065,-87.74538
13389,6,17,false,65,66,1,41.961,-87.64958
245,6,17,false,9,8,-1,41.96101,-87.64958
15621,6,17,false,9,7,-2,41.96103,-87.70586
KA1706005015,6,17,false,6,5,-1,41.96108,-87.73569
15622,6,17,false,10,9,-1,41.96108,-87.69544
495,6,17,false,2,2,0,41.96109,-87.72897
KA1504000164,6,17,false,3,6,3,41.96109,-87.72897
KA1504000097,6,17,false,1,9,8,41.96116,-87.71658
238,6,17,false,3,1,-2,41.96141,-87.6762
TA1307000144,6,17,false,8,14,6,41.96142,-87.6762
297,6,17,false,6,5,-1,41.9615,-87.67141
TA1309000021,6,17,false,14,25,11,41.9615,-87.6714
15623,6,17,false,4,7,3,41.96154,-87.69117
234,6,17,false,2,4,2,41.96158,-87.6661
KA1503000022,6,17,false,32,27,-5,41.96158,-87.66609
231,6,17,false,13,23,10,41.96163,-87.65464
TA1307000107,6,17,false,71,80,9,41.96164,-87.65464
TA1307000156,6,17,false,27,28,1,41.96301,-87.68479
243,6,17,false,3,6,3,41.96302,-87.68479
TA1309000012,6,17,false,7,10,3,41.96325,-87.67928
TA1308000012,6,17,false,298,185,-113,41.96398,-87.63818
249,6,17,false,20,10,-10,41.96398,-87.63818
293,6,17,false,5,2,-3,41.96521,-87.65822
13074,6,17,false,40,66,26,41.96521,-87.6582
639,6,17,false,110,88,-22,41.96584,-87.64538
KA1504000127,6,17,false,5,3,-2,41.96587,-87.70083
477,6,17,false,3,2,-1,41.96587,-87.70083
KA1504000093,6,17,false,7,10,3,41.96587,-87.69365
TA1307000140,6,17,false,21,31,10,41.96643,-87.68865
239,6,17,false,7,10,3,41.9665,-87.68843
326,6,17,false,7,5,-2,41.96665,-87.67113
KA1504000126,6,17,false,10,7,-3,41.96668,-87.70807
476,6,17,false,3,3,0,41.96668,-87.70807
TA1309000014,6,17,false,55,70,15,41.96709,-87.66744
TA1307000158,6,17,false,12,8,-4,41.9671,-87.67904
242,6,17,false,6,7,1,41.9671,-87.67904
TA1307000119,6,17,false,43,42,-1,41.96796,-87.65
15615,6,17,false,6,5,-1,41.96835,-87.71183
323,6,17,false,8,7,-1,41.96869,-87.66034
253,6,17,false,1,7,6,41.96883,-87.65765
TA1308000021,6,17,false,31,39,8,41.96883,-87.65765
475,6,17,false,2,6,4,41.96885,-87.69611
KA1504000080,6,17,false,13,17,4,41.96887,-87.69609
TA1309000015,6,17,false,11,13,2,41.96889,-87.68401
311,6,17,false,3,7,4,41.9689,-87.68402
TA1309000066,6,17,false,54,45,-9,41.9691,-87.67423
TA1309000041,6,17,false,30,36,6,41.96951,-87.65471
KA1504000171,6,17,false,61,60,-1,41.97161,-87.65016
465,6,17,false,6,10,4,41.97161,-87.65016
325,6,17,false,5,8,3,41.9728,-87.67186
TA1309000035,6,17,false,63,56,-7,41.97335,-87.66785
295,6,17,false,3,2,-1,41.97378,-87.65972
13108,6,17,false,37,39,2,41.97379,-87.65971
KA1504000078,6,17,false,7,17,10,41.97491,-87.69258
472,6,17,false,3,4,1,41.97492,-87.69262
464,6,17,false,4,4,0,41.97562,-87.67945
KA1504000149,6,17,false,14,32,18,41.97562,-87.67945
KA1504000160,6,17,false,8,6,-2,41.97564,-87.70143
471,6,17,false,4,6,2,41.97564,-87.70143
KA1504000128,6,17,false,3,7,4,41.97567,-87.70927
463,6,17,false,5,2,-3,41.978,-87.66805
KA1504000146,6,17,false,68,81,13,41.978,-87.66805
13109,6,17,false,39,27,-12,41.97835,-87.65976
294,6,17,false,9,12,3,41.97835,-87.65976
KA1504000147,6,17,false,8,31,23,41.97976,-87.67754
655,6,17,false,19,14,-5,41.97987,-87.68194
469,6,17,false,1,2,1,41.98038,-87.71612
KA1504000161,6,17,false,1,3,2,41.98038,-87.71612
KA1504000167,6,17,false,7,3,-4,41.98206,-87.70895
494,6,17,false,2,4,2,41.98234,-87.70892
460,6,17,false,1,4,3,41.98358,-87.66916
KA1504000151,6,17,false,25,51,26,41.98359,-87.66916
15585,6,17,false,9,2,-7,41.98367,-87.69642
468,6,17,false,2,2,0,41.98367,-87.69642
KA1504000152,6,17,false,173,102,-71,41.98403,-87.65231
459,6,17,false,12,12,0,41.98403,-87.65231
15578,6,17,false,58,28,-30,41.98405,-87.66027
461,6,17,false,4,2,-2,41.98405,-87.66027
353,6,17,false,4,3,-1,41.98656,-87.70761
15575,6,17,false,30,43,13,41.98975,-87.66014
458,6,17,false,8,8,0,41.98975,-87.66013
KA1504000130,6,17,false,7,5,-2,41.99024,-87.69338
457,6,17,false,1,1,0,41.99052,-87.66982
KA1504000148,6,17,false,10,15,5,41.99086,-87.66971
KA1504000155,6,17,false,6,6,0,41.99118,-87.68359
452,6,17,false,2,3,1,41.99417,-87.68945
KA1504000129,6,17,false,7,14,7,41.99417,-87.68945
15571,6,17,false,38,41,3,41.99478,-87.66028
454,6,17,false,4,4,0,41.99478,-87.66027
453,6,17,false,2,4,2,41.99925,-87.67137
KA1504000156,6,17,false,7,18,11,41.99925,-87.67137
RP-009,6,17,false,13,24,11,42.00107,-87.66122
451,6,17,false,4,2,-2,42.00108,-87.66123
RP-001,6,17,false,18,13,-5,42.00179,-87.68883
450,6,17,false,1,4,3,42.00179,-87.68883
449,6,17,false,3,1,-2,42.00446,-87.67241
RP-008,6,17,false,9,11,2,42.00446,-87.6724
RP-002,6,17,false,7,6,-1,42.00456,-87.68065
660,6,17,false,22,26,4,42.00458,-87.66143
KA1504000175,6,17,false,14,21,7,42.00797,-87.66549
447,6,17,false,1,7,6,42.00797,-87.66548
RP-005,6,17,false,1,3,2,42.0086,-87.69047
KA1504000162,6,17,false,2,4,2,42.00907,-87.67422
KA1504000159,6,17,false,11,12,1,42.01059,-87.66241
RP-004,6,17,false,2,6,4,42.01234,-87.68825
RP-007,6,17,false,3,5,2,42.01256,-87.67431
525,6,17,false,7,6,-1,42.01272,-87.66605
517,6,17,false,10,5,-5,42.01597,-87.675
520,6,17,false,17,10,-7,42.01597,-87.66859
527,6,17,false,3,2,-1,42.01892,-87.69004
515,6,17,false,10,15,5,42.01915,-87.67356
514,6,17,false,4,5,1,42.01927,-87.68452
16806,6,17,false,6,4,-2,42.01953,-87.66955
523,6,17,false,12,12,0,42.02089,-87.66505
662,6,17,false,1,9,8,42.02354,-87.69961
598,6,17,false,4,3,-1,42.02578,-87.68411
597,6,17,false,3,2,-1,42.03256,-87.67914
E002,6,17,false,17,23,6,42.03256,-87.67912
599,6,17,false,9,8,-1,42.03972,-87.69942
596,6,17,false,30,50,20,42.04822,-87.68348
600,6,17,false,8,4,-4,42.04831,-87.6983
E008,6,17,false,21,40,19,42.05049,-87.67782
605,6,17,false,7,19,12,42.05294,-87.67342
661,6,17,false,9,11,2,42.05704,-87.68657
604,6,17,false,29,32,3,42.05824,-87.67744
E006,6,17,false,5,10,5,42.06367,-87.69871
E007,6,17,false,8,9,1,42.06431,-87.68615
602,6,17,false,3,2,-1,42.06431,-87.68614
E014,6,17,false,2,4,2,42.06483,-87.71531
20232,6,17,true,1,1,0,41.68588,-87.57378
717,6,17,true,1,3,2,41.68588,-87.57376
20231,6,17,true,2,2,0,41.7368,-87.58282
685,6,17,true,1,1,0,41.73785,-87.64491
20101,6,17,true,1,1,0,41.73785,-87.64489
583,6,17,true,2,4,2,41.74656,-87.58599
KA1503000049,6,17,true,4,4,0,41.75788,-87.54938
270,6,17,true,1,1,0,41.75867,-87.58692
KA1503000019,6,17,true,1,1,0,41.75867,-87.5869
KA1503000020,6,17,true,1,1,0,41.76223,-87.55923
KA1503000002,6,17,true,8,12,4,41.76641,-87.5657
567,6,17,true,1,1,0,41.76895,-87.65293
KA1503000029,6,17,true,3,4,1,41.77364,-87.56747
KA1503000031,6,17,true,2,1,-1,41.77373,-87.60564
KA1503000046,6,17,true,1,1,0,41.78041,-87.59141
653,6,17,true,6,2,-4,41.78059,-87.58491
KA1503000054,6,17,true,2,1,-1,41.78061,-87.60582
15491,6,17,true,8,12,4,41.78096,-87.57624
101,6,17,true,2,3,1,41.78105,-87.57611
426,6,17,true,8,17,9,41.7851,-87.60108
KA1503000014,6,17,true,48,63,15,41.7851,-87.60108
KA1503000070,6,17,true,14,7,-7,41.78794,-87.58831
425,6,17,true,5,2,-3,41.78795,-87.58831
328,6,17,true,4,4,0,41.78872,-87.6013
TA1309000011,6,17,true,17,12,-5,41.78873,-87.60131
KA1503000071,6,17,true,30,21,-9,41.79148,-87.59988
423,6,17,true,12,7,-5,41.79148,-87.59988
KA1503000074,6,17,true,37,26,-11,41.79174,-87.58395
424,6,17,true,5,5,0,41.79174,-87.58395
TA1309000063,6,17,true,25,25,0,41.79325,-87.5878
345,6,17,true,2,3,1,41.79326,-87.5878
420,6,17,true,11,6,-5,41.79429,-87.60145
KA1504000076,6,17,true,37,30,-7,41.7943,-87.60145
204,6,17,true,1,2,1,41.79485,-87.61874
TA1307000160,6,17,true,2,4,2,41.79485,-87.61873
247,6,17,true,23,18,-5,41.79522,-87.58077
TA1308000009,6,17,true,67,73,6,41.79522,-87.58075
TA1307000164,6,17,true,26,18,-8,41.79527,-87.59647
248,6,17,true,2,6,4,41.79528,-87.59647
KA1503000052,6,17,true,20,26,6,41.79935,-87.60097
418,6,17,true,9,12,3,41.79936,-87.60097
419,6,17,true,10,10,0,41.79952,-87.58643
KA1503000059,6,17,true,24,29,5,41.79952,-87.58643
TA1309000037,6,17,true,55,75,20,41.79957,-87.59474
15470,6,17,true,5,4,-1,41.80228,-87.61807
417,6,17,true,7,9,2,41.80242,-87.5869
KA1503000007,6,17,true,19,45,26,41.80242,-87.58689
121,6,17,true,8,7,-1,41.80256,-87.59035
13398,6,17,true,18,22,4,41.80256,-87.59035
TA1309000067,6,17,true,3,8,5,41.80303,-87.60661
322,6,17,true,12,19,7,41.80321,-87.59849
416,6,17,true,1,1,0,41.80578,-87.59247
KA1503000069,6,17,true,3,6,3,41.80579,-87.59247
KA1503000051,6,17,true,8,19,11,41.80815,-87.64563
KA1504000091,6,17,true,1,1,0,41.80823,-87.6772
16937,6,17,true,18,5,-13,41.80887,-87.66453
KA1503000009,6,17,true,1,1,0,41.80932,-87.63346
TA1308000035,6,17,true,14,12,-2,41.80944,-87.59188
267,6,17,true,5,6,1,41.80944,-87.59188
252,6,17,true,1,3,2,41.80982,-87.59936
TA1308000002,6,17,true,5,6,1,41.80983,-87.59937
336,6,17,true,2,1,-1,41.80985,-87.60675
TA1309000053,6,17,true,3,6,3,41.80985,-87.60675
352,6,17,true,1,1,0,41.8137,-87.63448
549,6,17,true,2,4,2,41.81401,-87.66662
413,6,17,true,6,3,-3,41.81408,-87.59701
KA1503000065,6,17,true,11,6,-5,41.81409,-87.59701
271,6,17,true,1,2,1,41.81648,-87.60659
TA1308000023,6,17,true,4,5,1,41.81649,-87.60659
410,6,17,true,2,2,0,41.81666,-87.61942
KA1503000027,6,17,true,1,2,1,41.81666,-87.61942
KA1503000032,6,17,true,2,3,1,41.81912,-87.64328
408,6,17,true,3,3,0,41.81914,-87.64328
13083,6,17,true,4,1,-3,41.82167,-87.62153
TA1308000038,6,17,true,6,6,0,41.82298,-87.6071
407,6,17,true,1,1,0,41.82303,-87.62658
546,6,17,true,5,2,-3,41.82319,-87.67661
13420,6,17,true,4,5,1,41.82459,-87.61678
TA1307000161,6,17,true,1,5,4,41.82707,-87.64572
KA1503000066,6,17,true,2,3,1,41.83011,-87.67031
TA1308000045,6,17,true,5,14,9,41.83062,-87.64129
TA1308000043,6,17,true,2,12,10,41.83066,-87.64715
15446,6,17,true,12,5,-7,41.83068,-87.65603
KA1503000005,6,17,true,5,6,1,41.83079,-87.6325
TA1307000129,6,17,true,18,12,-6,41.83104,-87.62683
KA1503000004,6,17,true,12,12,0,41.83127,-87.6088
406,6,17,true,1,2,1,41.83127,-87.6088
13345,6,17,true,8,4,-4,41.83138,-87.61803
403,6,17,true,2,3,1,41.83453,-87.63183
15445,6,17,true,10,15,5,41.83453,-87.63183
13216,6,17,true,54,40,-14,41.83473,-87.62581
148,6,17,true,11,4,-7,41.83474,-87.62581
149,6,17,true,6,11,5,41.83486,-87.61791
13217,6,17,true,29,39,10,41.83488,-87.61792
13215,6,17,true,19,22,3,41.83634,-87.6135
263,6,17,true,2,8,6,41.8364,-87.61348
280,6,17,true,3,1,-2,41.83779,-87.65116
TA1308000046,6,17,true,22,20,-2,41.83779,-87.65115
339,6,17,true,7,7,0,41.83817,-87.64523
TA1309000055,6,17,true,31,37,6,41.8382,-87.64514
KA1503000038,6,17,true,19,14,-5,41.83845,-87.6354
402,6,17,true,5,8,3,41.83845,-87.6354
TA1307000048,6,17,true,79,55,-24,41.83855,-87.60821
150,6,17,true,11,15,4,41.83855,-87.60821
272,6,17,true,11,10,-1,41.83882,-87.62186
TA1308000036,6,17,true,14,24,10,41.83883,-87.62186
15442,6,17,true,5,6,1,41.83918,-87.66562
KA1503000040,6,17,true,6,6,0,41.84164,-87.65744
237,6,17,true,11,12,1,41.84204,-87.61697
TA1307000139,6,17,true,45,37,-8,41.84205,-87.61698
15443,6,17,true,6,5,-1,41.84275,-87.63549
207,6,17,true,1,2,1,41.84358,-87.64539
TA1307000153,6,17,true,14,13,-1,41.84358,-87.64538
15692,6,17,true,1,2,1,41.84404,-87.69531
15691,6,17,true,1,5,4,41.84449,-87.70203
147,6,17,true,6,7,1,41.84569,-87.62251
TA1307000005,6,17,true,22,21,-1,41.84569,-87.6225
206,6,17,true,5,2,-3,41.84719,-87.64683
TA1308000013,6,17,true,12,6,-6,41.84719,-87.64681
348,6,17,true,2,1,-1,41.8477,-87.69448
TA1309000003,6,17,true,1,7,6,41.84847,-87.68512
15689,6,17,true,4,5,1,41.84912,-87.69515
TA1307000066,6,17,true,1,2,1,41.8492,-87.67564
TA1308000014,6,17,true,7,3,-4,41.84953,-87.64059
209,6,17,true,2,5,3,41.84953,-87.64058
132,6,17,true,2,5,3,41.85008,-87.63215
TA1308000026,6,17,true,12,6,-6,41.85008,-87.63214
TA1305000004,6,17,true,8,8,0,41.8514,-87.61884
62,6,17,true,1,1,0,41.85141,-87.61884
42,6,17,true,2,5,3,41.85261,-87.62653
TA1305000001,6,17,true,21,21,0,41.85262,-87.6265
13075,6,17,true,47,53,6,41.8531,-87.63192
120,6,17,true,10,8,-2,41.8531,-87.63191
15686,6,17,true,1,1,0,41.85354,-87.70507
439,6,17,true,1,1,0,41.85355,-87.70505
135,6,17,true,1,2,1,41.85367,-87.64652
13162,6,17,true,6,14,8,41.85378,-87.64659
13096,6,17,true,4,5,1,41.8538,-87.69577
13091,6,17,true,8,9,1,41.85409,-87.68585
370,6,17,true,1,2,1,41.85415,-87.61917
15546,6,17,true,13,11,-2,41.85416,-87.61916
13307,6,17,true,19,8,-11,41.85489,-87.66359
208,6,17,true,4,4,0,41.85489,-87.66359
13089,6,17,true,15,18,3,41.85497,-87.67567
13331,6,17,true,5,10,5,41.85515,-87.65414
171,6,17,true,2,1,-1,41.85516,-87.65414
15545,6,17,true,112,106,-6,41.85627,-87.61334
4,6,17,true,29,25,-4,41.85627,-87.61334
SL-013,6,17,true,15,17,2,41.85659,-87.62755
218,6,17,true,1,2,1,41.85679,-87.63387
SL-006,6,17,true,22,8,-14,41.8568,-87.63387
129,6,17,true,7,8,1,41.85752,-87.66158
202,6,17,true,3,4,1,41.85752,-87.64621
13135,6,17,true,28,44,16,41.85753,-87.66157
338,6,17,true,5,9,4,41.85758,-87.61956
13102,6,17,true,46,65,19,41.85762,-87.61942
13150,6,17,true,53,51,-2,41.85783,-87.62455
273,6,17,true,8,20,12,41.85783,-87.62455
13099,6,17,true,15,20,5,41.85784,-87.64627
205,6,17,true,4,2,-2,41.8579,-87.6687
TA1307000159,6,17,true,13,16,3,41.8579,-87.6687
TA1307000044,6,17,true,8,13,5,41.85794,-87.64083
14,6,17,true,8,4,-4,41.85808,-87.65109
13163,6,17,true,10,13,3,41.85808,-87.65108
13164,6,17,true,30,41,11,41.85818,-87.65648
15,6,17,true,1,4,3,41.85819,-87.65648
SL-012,6,17,true,34,40,6,41.86038,-87.62581
72,6,17,true,10,10,0,41.86039,-87.62581
274,6,17,true,3,1,-2,41.86126,-87.6566
13304,6,17,true,5,14,9,41.86126,-87.65659
KA1504000109,6,17,true,5,4,-1,41.86192,-87.69347
137,6,17,true,3,1,-2,41.86238,-87.65108
TA1306000002,6,17,true,23,26,3,41.86238,-87.65108
TA1307000124,6,17,true,52,60,8,41.86411,-87.62372
168,6,17,true,9,21,12,41.86415,-87.62372
282,6,17,true,7,8,1,41.86487,-87.64708
TA1309000001,6,17,true,26,23,-3,41.86488,-87.64708
136,6,17,true,3,4,1,41.86504,-87.65698
13165,6,17,true,4,7,3,41.86505,-87.65697
275,6,17,true,4,10,6,41.86524,-87.66651
13354,6,17,true,23,40,17,41.86524,-87.66651
97,6,17,true,5,2,-3,41.86531,-87.6179
13029,6,17,true,7,12,5,41.86531,-87.6179
341,6,17,true,17,8,-9,41.86608,-87.60733
13431,6,17,true,83,71,-12,41.8661,-87.60728
KA1504000101,6,17,true,20,8,-12,41.86651,-87.68466
434,6,17,true,2,4,2,41.86651,-87.68465
KA1504000102,6,17,true,3,2,-1,41.86664,-87.69453
436,6,17,true,4,1,-3,41.86664,-87.69452
WL-008,6,17,true,52,54,2,41.86712,-87.64108
57,6,17,true,13,19,6,41.86712,-87.64107
59,6,17,true,39,33,-6,41.86721,-87.62597
TA1305000002,6,17,true,90,134,44,41.86721,-87.62597
3,6,17,true,13,7,-6,41.86723,-87.61536
15544,6,17,true,45,57,12,41.86723,-87.61536
TA1305000017,6,17,true,13,14,1,41.86734,-87.64863
KA1706005007,6,17,true,38,38,0,41.86749,-87.63219
626,6,17,true,5,7,2,41.86749,-87.63219
SL-005,6,17,true,98,106,8,41.8679,-87.62304
255,6,17,true,14,33,19,41.86791,-87.62304
644,6,17,true,27,38,11,41.86859,-87.68625
19,6,17,true,12,12,0,41.86892,-87.65913
13139,6,17,true,29,36,7,41.86893,-87.65913
13285,6,17,true,20,12,-8,41.86928,-87.67372
13160,6,17,true,54,38,-16,41.86947,-87.65548
22,6,17,true,8,11,3,41.86947,-87.65548
382,6,17,true,4,2,-2,41.8699,-87.68725
414,6,17,true,3,3,0,41.87023,-87.63947
15550,6,17,true,32,33,1,41.87024,-87.63947
TA1309000010,6,17,true,78,67,-11,41.87074,-87.62574
SL-009,6,17,true,21,28,7,41.87081,-87.63121
342,6,17,true,5,5,0,41.87127,-87.6737
TA1309000064,6,17,true,28,29,1,41.87127,-87.67369
15542,6,17,true,4,4,0,41.87146,-87.64095
261,6,17,true,5,4,-1,41.87151,-87.6699
TA1307000130,6,17,true,44,36,-8,41.87178,-87.65103
241,6,17,true,16,6,-10,41.8718,-87.65102
108,6,17,true,2,2,0,41.87183,-87.64664
TA1307000121,6,17,true,40,22,-18,41.87184,-87.64664
41,6,17,true,11,24,13,41.87209,-87.62957
SL-008,6,17,true,77,77,0,41.87209,-87.62956
13332,6,17,true,96,82,-14,41.87219,-87.6615
394,6,17,true,5,7,2,41.87226,-87.63484
175,6,17,true,3,8,5,41.87255,-87.63359
SL-011,6,17,true,43,44,1,41.87256,-87.63356
623,6,17,true,43,46,3,41.87272,-87.62399
KA1504000104,6,17,true,22,8,-14,41.87296,-87.66912
383,6,17,true,6,1,-5,41.87297,-87.66912
320,6,17,true,20,19,-1,41.87327,-87.66402
5,6,17,true,8,4,-4,41.87403,-87.6277
SL-007,6,17,true,19,30,11,41.87404,-87.6277
169,6,17,true,4,1,-3,41.87424,-87.63959
13326,6,17,true,10,8,-2,41.87425,-87.63958
321,6,17,true,8,20,12,41.87427,-87.63257
TA1306000025,6,17,true,35,21,-14,41.87464,-87.65703
32,6,17,true,12,5,-7,41.87464,-87.65703
15668,6,17,true,9,8,-1,41.87471,-87.68642
13028,6,17,true,16,15,-1,41.87475,-87.64981
109,6,17,true,4,6,2,41.87475,-87.64981
13081,6,17,true,2,3,1,41.87501,-87.67326
89,6,17,true,1,4,3,41.87501,-87.6331
SL-010,6,17,true,18,20,2,41.87501,-87.63309
16907,6,17,true,1,2,1,41.87568,-87.71549
15541,6,17,true,21,14,-7,41.8758,-87.62086
68,6,17,true,3,2,-1,41.87587,-87.64077
13037,6,17,true,6,9,3,41.87588,-87.64078
50,6,17,true,4,4,0,41.87592,-87.6307
TA1305000009,6,17,true,7,13,6,41.87593,-87.63068
317,6,17,true,3,2,-1,41.87603,-87.68195
TA1305000010,6,17,true,15,6,-9,41.87623,-87.62444
45,6,17,true,6,3,-3,41.87623,-87.62444
624,6,17,true,21,22,1,41.87626,-87.62923
2,6,17,true,4,2,-2,41.87649,-87.62051
33,6,17,true,7,2,-5,41.87715,-87.62786
TA1305000035,6,17,true,19,15,-4,41.87716,-87.62787
13138,6,17,true,11,3,-8,41.87723,-87.63941
631,6,17,true,6,4,-2,41.87761,-87.6739
15539,6,17,true,63,50,-13,41.87763,-87.64405
13158,6,17,true,52,64,12,41.87764,-87.64957
134,6,17,true,10,8,-2,41.87764,-87.64954
13157,6,17,true,58,58,0,41.87773,-87.6548
21,6,17,true,8,21,13,41.87773,-87.6548
TA1305000025,6,17,true,23,41,18,41.87773,-87.63528
36,6,17,true,6,21,15,41.87776,-87.63525
284,6,17,true,12,4,-8,41.87784,-87.62408
TA1309000002,6,17,true,26,36,10,41.87784,-87.62408
146,6,17,true,8,4,-4,41.87794,-87.66201
13206,6,17,true,23,31,8,41.87794,-87.66201
283,6,17,true,3,1,-2,41.87809,-87.63183
TA1309000004,6,17,true,10,3,-7,41.87811,-87.63184
107,6,17,true,16,14,-2,41.87822,-87.644
638,6,17,true,29,23,-6,41.87827,-87.64078
37,6,17,true,7,2,-5,41.87921,-87.62975
TA1305000005,6,17,true,15,9,-6,41.87924,-87.62975
286,6,17,true,1,1,0,41.8793,-87.6355
13011,6,17,true,34,41,7,41.87931,-87.63993
TA1309000008,6,17,true,2,1,-1,41.87933,-87.6355
192,6,17,true,2,3,1,41.87935,-87.63997
KA1503000034,6,17,true,8,2,-6,41.87938,-87.63197
40,6,17,true,1,1,0,41.87944,-87.63197
39,6,17,true,9,6,-3,41.87948,-87.62571
KA1503000015,6,17,true,17,16,-1,41.87948,-87.6257
15667,6,17,true,12,13,1,41.8798,-87.68609
381,6,17,true,4,3,-1,41.87981,-87.68607
287,6,17,true,3,3,0,41.88017,-87.63527
TA1309000007,6,17,true,16,5,-11,41.88022,-87.63526
WL-011,6,17,true,33,41,8,41.88034,-87.64273
73,6,17,true,3,8,5,41.8804,-87.64273
80,6,17,true,7,8,1,41.88042,-87.65556
13156,6,17,true,36,45,9,41.88042,-87.65554
13300,6,17,true,169,178,9,41.88097,-87.61675
76,6,17,true,36,30,-6,41.88098,-87.61675
13008,6,17,true,69,75,6,41.88105,-87.62408
90,6,17,true,20,22,2,41.88107,-87.62409
49,6,17,true,18,9,-9,41.88116,-87.62963
TA1305000006,6,17,true,35,39,4,41.88122,-87.6296
13134,6,17,true,8,10,2,41.88138,-87.67493
13056,6,17,true,7,11,4,41.88168,-87.63951
191,6,17,true,1,3,2,41.88169,-87.63951
198,6,17,true,17,28,11,41.88187,-87.6488
TA1307000120,6,17,true,118,133,15,41.88188,-87.64879
13341,6,17,true,28,18,-10,41.88208,-87.63985
174,6,17,true,7,5,-2,41.88208,-87.63984
197,6,17,true,11,8,-3,41.88208,-87.62513
13036,6,17,true,39,33,-6,41.8821,-87.62513
77,6,17,true,19,19,0,41.88214,-87.64108
TA1305000032,6,17,true,68,80,12,41.88218,-87.64109
98,6,17,true,4,3,-1,41.88266,-87.63251
13006,6,17,true,13,10,-3,41.88268,-87.63252
13353,6,17,true,37,33,-4,41.88283,-87.6612
346,6,17,true,10,14,4,41.88284,-87.6612
654,6,17,true,21,30,9,41.88307,-87.65698
233,6,17,true,7,8,1,41.88309,-87.6511
13409,6,17,true,37,37,0,41.8831,-87.6511
18,6,17,true,5,4,-1,41.88317,-87.63735
KA1503000072,6,17,true,5,13,8,41.88317,-87.63693
91,6,17,true,7,5,-2,41.88336,-87.64122
WL-012,6,17,true,21,33,12,41.88337,-87.6412
112,6,17,true,12,11,-1,41.88362,-87.6486
13053,6,17,true,115,109,-6,41.88365,-87.64863
43,6,17,true,12,8,-4,41.88396,-87.62455
13001,6,17,true,60,52,-8,41.88397,-87.62459
88,6,17,true,4,5,1,41.88407,-87.65691
13155,6,17,true,15,28,13,41.88407,-87.65689
621,6,17,true,5,6,1,41.88412,-87.65427
18062,6,17,true,27,31,4,41.88412,-87.65427
81,6,17,true,16,12,-4,41.88417,-87.6296
TA1306000010,6,17,true,46,46,0,41.88419,-87.62961
15666,6,17,true,6,5,-1,41.88446,-87.6963
KA1504000106,6,17,true,3,3,0,41.88459,-87.70631
TA1305000030,6,17,true,27,15,-12,41.88459,-87.63178
96,6,17,true,10,19,9,41.8846,-87.64455
15535,6,17,true,44,62,18,41.8846,-87.64455
51,6,17,true,6,5,-1,41.88462,-87.63176
TA1305000029,6,17,true,71,65,-6,41.88466,-87.62787
195,6,17,true,26,20,-6,41.88466,-87.61952
13263,6,17,true,92,67,-25,41.88467,-87.61952
44,6,17,true,26,16,-10,41.88468,-87.62782
528,6,17,true,2,1,-1,41.88537,-87.72661
TA1306000015,6,17,true,67,96,29,41.88549,-87.65232
518,6,17,true,1,1,0,41.8855,-87.71686
71,6,17,true,11,19,8,41.8855,-87.65233
66,6,17,true,6,15,9,41.88557,-87.64186
13021,6,17,true,37,55,18,41.88559,-87.64184
TA1307000111,6,17,true,40,33,-7,41.88582,-87.63548
164,6,17,true,4,9,5,41.88583,-87.63547
13073,6,17,true,26,17,-9,41.88592,-87.66717
119,6,17,true,6,6,0,41.88593,-87.66717
KA17018054,6,17,true,15,17,2,41.88595,-87.67701
38,6,17,true,16,11,-5,41.88599,-87.63089
KA1503000012,6,17,true,46,53,7,41.88599,-87.63089
52,6,17,true,14,18,4,41.886,-87.62421
TA1305000011,6,17,true,65,68,3,41.886,-87.62418
7,6,17,true,11,22,11,41.88627,-87.61751
15534,6,17,true,61,62,1,41.88627,-87.61749
217,6,17,true,5,2,-3,41.8866,-87.65821
13197,6,17,true,20,15,-5,41.8866,-87.65816
264,6,17,true,15,7,-8,41.8867,-87.62224
TA1308000029,6,17,true,34,28,-6,41.88673,-87.62225
TA1307000131,6,17,true,30,21,-9,41.88688,-87.62606
194,6,17,true,11,9,-2,41.88688,-87.62606
6,6,17,true,13,13,0,41.88697,-87.61281
KA1503000064,6,17,true,87,87,0,41.88697,-87.61281
377,6,17,true,1,2,1,41.88719,-87.71697
16906,6,17,true,1,6,5,41.88792,-87.77445
100,6,17,true,11,9,-2,41.88814,-87.63657
TA1305000022,6,17,true,55,50,-5,41.88817,-87.63656
56,6,17,true,25,41,16,41.88866,-87.64442
TA1306000003,6,17,true,112,131,19,41.88867,-87.64442
133,6,17,true,19,15,-4,41.88918,-87.63851
KA1503000043,6,17,true,105,102,-3,41.88918,-87.63851
13050,6,17,true,47,54,7,41.88919,-87.62775
47,6,17,true,13,12,-1,41.88921,-87.62775
15664,6,17,true,6,6,0,41.8895,-87.68821
376,6,17,true,2,2,0,41.88951,-87.68818
285,6,17,true,3,4,1,41.88989,-87.67149
13432,6,17,true,22,41,19,41.88989,-87.67149
TA1307000151,6,17,true,85,99,14,41.88993,-87.63427
212,6,17,true,17,16,-1,41.88995,-87.63427
636,6,17,true,62,56,-6,41.88997,-87.63662
378,6,17,true,1,1,0,41.89014,-87.71289
125,6,17,true,4,11,7,41.89018,-87.62621
KA1503000044,6,17,true,36,31,-5,41.89018,-87.6262
KA1504000113,6,17,true,4,4,0,41.89049,-87.70262
196,6,17,true,4,18,14,41.89053,-87.62205
13427,6,17,true,30,33,3,41.89054,-87.62205
26,6,17,true,11,24,13,41.89057,-87.61798
13430,6,17,true,87,100,13,41.89077,-87.63169
181,6,17,true,8,21,13,41.89077,-87.63168
TA1306000013,6,17,true,83,75,-8,41.89083,-87.61852
RN-,6,17,true,87,86,-1,41.89102,-87.63546
672,6,17,true,21,21,0,41.89102,-87.63545
277,6,17,true,2,6,4,41.89108,-87.66665
13434,6,17,true,27,31,4,41.89108,-87.66663
TA1308000006,6,17,true,19,23,4,41.89128,-87.67686
199,6,17,true,42,29,-13,41.89143,-87.62676
TA1307000117,6,17,true,147,137,-10,41.89144,-87.62675
13033,6,17,true,74,69,-5,41.8916,-87.64835
214,6,17,true,5,6,1,41.89161,-87.67688
84,6,17,true,24,17,-7,41.89161,-87.64833
186,6,17,true,7,11,4,41.8918,-87.65879
13194,6,17,true,40,51,11,41.8918,-87.65878
TA1305000003,6,17,true,88,77,-11,41.89187,-87.62061
24,6,17,true,29,16,-13,41.8919,-87.62063
643,6,17,true,11,14,3,41.89203,-87.68939
35,6,17,true,18,12,-6,41.89227,-87.61206
13022,6,17,true,181,171,-10,41.89227,-87.61205
99,6,17,true,15,9,-6,41.89255,-87.61449
TA1306000029,6,17,true,64,77,13,41.89256,-87.61449
13265,6,17,true,89,83,-6,41.89383,-87.64172
74,6,17,true,20,22,2,41.89384,-87.64173
13045,6,17,true,114,132,18,41.89403,-87.62931
110,6,17,true,22,43,21,41.89406,-87.6293
13016,6,17,true,74,60,-14,41.89431,-87.62277
211,6,17,true,11,9,-2,41.89439,-87.62267
KA1503000041,6,17,true,42,54,12,41.89452,-87.61798
142,6,17,true,11,17,6,41.89453,-87.61806
92,6,17,true,4,5,1,41.89455,-87.65346
13196,6,17,true,37,32,-5,41.89455,-87.65345
TA1307000062,6,17,true,34,41,7,41.89466,-87.63839
111,6,17,true,8,9,1,41.89466,-87.63837
TA1306000012,6,17,true,111,141,30,41.89475,-87.63438
53,6,17,true,31,24,-7,41.89476,-87.63439
627,6,17,true,13,10,-3,41.8948,-87.63231
KP1705001026,6,17,true,61,41,-20,41.89483,-87.6323
550,6,17,true,1,1,0,41.89495,-87.76491
16920,6,17,true,3,6,3,41.89495,-87.76491
KA1504000114,6,17,true,3,2,-1,41.89547,-87.70614
373,6,17,true,1,1,0,41.89548,-87.70614
18058,6,17,true,23,30,7,41.8955,-87.68201
659,6,17,true,5,18,13,41.8955,-87.68201
637,6,17,true,29,35,6,41.89563,-87.67209
128,6,17,true,8,16,8,41.89571,-87.67716
13132,6,17,true,41,69,28,41.89573,-87.67718
161,6,17,true,12,19,7,41.89574,-87.62599
15530,6,17,true,87,71,-16,41.89575,-87.62596
18003,6,17,true,37,23,-14,41.89575,-87.62011
635,6,17,true,17,4,-13,41.89576,-87.62012
13247,6,17,true,30,36,6,41.89597,-87.66775
350,6,17,true,6,7,1,41.89597,-87.66774
TA1305000020,6,17,true,40,39,-1,41.89636,-87.65406
54,6,17,true,10,3,-7,41.89637,-87.65407
13289,6,17,true,31,54,23,41.89638,-87.661
86,6,17,true,7,8,1,41.89639,-87.661
337,6,17,true,17,14,-3,41.89659,-87.63096
13303,6,17,true,71,59,-12,41.89672,-87.63088
13017,6,17,true,57,44,-13,41.89676,-87.6357
31,6,17,true,11,9,-2,41.89677,-87.63572
13338,6,17,true,50,42,-8,41.89697,-87.62173
173,6,17,true,12,14,2,41.89704,-87.62173
TA1307000061,6,17,true,45,40,-5,41.89745,-87.62873
106,6,17,true,16,8,-8,41.89746,-87.62874
25,6,17,true,11,6,-5,41.89751,-87.62354
13034,6,17,true,39,32,-7,41.89754,-87.62352
48,6,17,true,6,13,7,41.89772,-87.64302
TA1306000009,6,17,true,49,29,-20,41.89772,-87.64299
620,6,17,true,66,64,-2,41.89817,-87.63754
374,6,17,true,7,10,3,41.89842,-87.68659
KA1504000103,6,17,true,24,45,21,41.89842,-87.68659
145,6,17,true,19,15,-4,41.89856,-87.62211
15529,6,17,true,64,62,-2,41.89858,-87.62206
140,6,17,true,24,15,-9,41.89895,-87.6299
TA1307000128,6,17,true,93,103,10,41.89896,-87.6299
657,6,17,true,36,35,-1,41.89918,-87.6722
KA1504000117,6,17,true,11,9,-2,41.89936,-87.64848
365,6,17,true,2,1,-1,41.89936,-87.64848
30,6,17,true,7,5,-2,41.89964,-87.66789
13248,6,17,true,25,35,10,41.89964,-87.66788
46,6,17,true,3,6,3,41.89994,-87.63444
TA1306000011,6,17,true,40,49,9,41.89994,-87.63443
364,6,17,true,4,5,1,41.90023,-87.64299
KA1504000116,6,17,true,20,24,4,41.90023,-87.64299
17660,6,17,true,22,23,1,41.90036,-87.69671
622,6,17,true,1,8,7,41.90037,-87.69671
29,6,17,true,8,12,4,41.90069,-87.66259
13290,6,17,true,32,40,8,41.90069,-87.66259
13042,6,17,true,154,136,-18,41.90097,-87.62377
85,6,17,true,22,20,-2,41.90098,-87.62375
183,6,17,true,9,10,1,41.90133,-87.67744
TA1307000070,6,17,true,43,42,-1,41.90133,-87.67742
KA1504000133,6,17,true,74,81,7,41.90234,-87.62773
172,6,17,true,21,17,-4,41.90236,-87.62774
15654,6,17,true,7,7,0,41.90271,-87.70923
510,6,17,true,3,3,0,41.90272,-87.70923
305,6,17,true,4,9,5,41.9028,-87.69005
13241,6,17,true,26,15,-11,41.9029,-87.68731
176,6,17,true,47,54,7,41.90291,-87.63141
TA1306000006,6,17,true,17,14,-3,41.90292,-87.63772
23,6,17,true,1,5,4,41.90292,-87.63772
TA1307000039,6,17,true,181,168,-13,41.90294,-87.63137
658,6,17,true,28,18,-10,41.903,-87.6838
216,6,17,true,14,5,-9,41.90302,-87.69749
13256,6,17,true,24,25,1,41.90302,-87.69749
17,6,17,true,8,10,2,41.90313,-87.67391
TA1305000034,6,17,true,49,55,6,41.90313,-87.67391
182,6,17,true,36,49,13,41.90317,-87.63442
KA1504000135,6,17,true,176,180,4,41.90319,-87.63439
13136,6,17,true,64,72,8,41.90326,-87.67845
130,6,17,true,9,11,2,41.90327,-87.67846
210,6,17,true,16,21,5,41.90342,-87.66781
13061,6,17,true,106,105,-1,41.90342,-87.66779
KA1504000079,6,17,true,53,57,4,41.9035,-87.64334
359,6,17,true,15,12,-3,41.90458,-87.6497
138,6,17,true,15,14,-1,41.9046,-87.64057
TA1307000115,6,17,true,41,39,-2,41.9046,-87.64056
291,6,17,true,24,27,3,41.90672,-87.63494
TA1308000049,6,17,true,127,133,6,41.90672,-87.6349
KA1504000134,6,17,true,75,72,-3,41.90687,-87.6262
180,6,17,true,16,24,8,41.90687,-87.62618
13224,6,17,true,60,49,-11,41.90706,-87.66725
333,6,17,true,10,16,6,41.90706,-87.66725
TA1307000143,6,17,true,30,25,-5,41.90762,-87.63854
236,6,17,true,1,3,2,41.90762,-87.63853
61,6,17,true,19,16,-3,41.90764,-87.67254
13221,6,17,true,80,86,6,41.90765,-87.67254
13245,6,17,true,8,4,-4,41.90777,-87.68586
159,6,17,true,4,4,0,41.90777,-87.68586
301,6,17,true,21,30,9,41.90796,-87.63203
TA1309000024,6,17,true,111,101,-10,41.908,-87.63152
69,6,17,true,24,19,-5,41.90939,-87.6777
TA1305000041,6,17,true,91,98,7,41.9094,-87.67769
15652,6,17,true,1,1,0,41.90965,-87.71664
331,6,17,true,133,115,-18,41.90965,-87.64812
15653,6,17,true,15,13,-2,41.90979,-87.7053
TA1305000037,6,17,true,34,58,24,41.91018,-87.67003
27,6,17,true,8,9,1,41.91019,-87.6435
TA1306000008,6,17,true,42,45,3,41.9102,-87.6435
16,6,17,true,23,14,-9,41.91035,-87.67008
213,6,17,true,8,16,8,41.91037,-87.68237
TA1308000005,6,17,true,33,53,20,41.91042,-87.68238
276,6,17,true,8,2,-6,41.91043,-87.69718
13258,6,17,true,22,28,6,41.91043,-87.69718
160,6,17,true,5,14,9,41.91054,-87.68957
13257,6,17,true,17,26,9,41.91054,-87.68956
13154,6,17,true,88,76,-12,41.91054,-87.65312
20,6,17,true,17,18,1,41.91055,-87.65313
60,6,17,true,16,16,0,41.91059,-87.64942
13058,6,17,true,56,59,3,41.91059,-87.64942
TA1307000038,6,17,true,89,64,-25,41.91138,-87.63868
118,6,17,true,14,21,7,41.91138,-87.63868
LF-005,6,17,true,252,157,-95,41.91172,-87.62681
268,6,17,true,48,33,-15,41.91172,-87.62681
126,6,17,true,17,12,-5,41.91196,-87.63197
13128,6,17,true,65,43,-22,41.91197,-87.63197
289,6,17,true,24,30,6,41.91209,-87.63472
TA1308000050,6,17,true,200,210,10,41.91211,-87.6347
158,6,17,true,16,12,-4,41.91262,-87.6814
13243,6,17,true,55,67,12,41.91262,-87.6814
315,6,17,true,2,5,3,41.91293,-87.66417
TA1309000032,6,17,true,12,36,24,41.91293,-87.66417
TA1306000032,6,17,true,91,68,-23,41.9137,-87.65285
93,6,17,true,18,17,-1,41.91371,-87.65285
224,6,17,true,11,7,-4,41.91386,-87.64877
TA1307000166,6,17,true,59,69,10,41.91386,-87.64877
511,6,17,true,7,6,-1,41.914,-87.70515
15655,6,17,true,13,17,4,41.91401,-87.70514
641,6,17,true,5,4,-1,41.91416,-87.71676
18017,6,17,true,5,5,0,41.91416,-87.71676
628,6,17,true,8,4,-4,41.9146,-87.66796
18067,6,17,true,42,46,4,41.9146,-87.66796
28,6,17,true,6,9,3,41.91469,-87.64333
TA1306000007,6,17,true,35,39,4,41.91469,-87.64333
13068,6,17,true,54,37,-17,41.91554,-87.68703
116,6,17,true,6,13,7,41.91555,-87.68703
13179,6,17,true,140,129,-11,41.9157,-87.63461
141,6,17,true,31,21,-10,41.91571,-87.63461
219,6,17,true,10,19,9,41.91598,-87.67733
13133,6,17,true,64,83,19,41.91598,-87.67733
58,6,17,true,13,8,-5,41.91602,-87.66894
TA1305000039,6,17,true,38,40,2,41.9163,-87.66749
506,6,17,true,2,5,3,41.91711,-87.71023
15650,6,17,true,13,23,10,41.91711,-87.71023
507,6,17,true,5,8,3,41.91752,-87.70181
15651,6,17,true,23,34,11,41.91752,-87.70181
185,6,17,true,6,13,7,41.91774,-87.69143
13266,6,17,true,33,39,6,41.91774,-87.69142
TA1309000029,6,17,true,28,27,-1,41.9178,-87.68245
309,6,17,true,3,7,4,41.91789,-87.6865
288,6,17,true,11,10,-1,41.91809,-87.64375
TA1309000006,6,17,true,64,70,6,41.91809,-87.64375
223,6,17,true,7,18,11,41.91821,-87.65698
TA1307000163,6,17,true,72,55,-17,41.91821,-87.65696
94,6,17,true,32,30,-2,41.91831,-87.6363
13146,6,17,true,150,153,3,41.91831,-87.63629
13059,6,17,true,94,103,9,41.91845,-87.65222
113,6,17,true,18,21,3,41.91846,-87.65222
13259,6,17,true,21,46,25,41.91852,-87.69744
259,6,17,true,7,6,-1,41.91853,-87.69745
310,6,17,true,7,8,1,41.91984,-87.68083
13192,6,17,true,78,80,2,41.91995,-87.64884
225,6,17,true,16,27,11,41.91995,-87.64884
13288,6,17,true,26,33,7,41.92008,-87.67788
13242,6,17,true,31,34,3,41.92021,-87.69266
222,6,17,true,2,3,1,41.92023,-87.69265
307,6,17,true,6,8,2,41.92077,-87.66373
TA1309000030,6,17,true,43,40,-3,41.92077,-87.66372
290,6,17,true,4,7,3,41.92152,-87.70734
13292,6,17,true,19,25,6,41.92152,-87.70733
TA1309000033,6,17,true,81,104,23,41.92158,-87.65381
13193,6,17,true,136,138,2,41.92182,-87.64412
144,6,17,true,40,32,-8,41.92182,-87.64411
143,6,17,true,12,13,1,41.92217,-87.63891
13191,6,17,true,72,80,8,41.92217,-87.63891
327,6,17,true,15,21,6,41.92225,-87.65783
13084,6,17,true,48,59,11,41.92268,-87.69715
123,6,17,true,15,17,2,41.92268,-87.69714
LP-,6,17,true,78,43,-35,41.92396,-87.63584
673,6,17,true,11,3,-8,41.92398,-87.63585
505,6,17,true,1,1,0,41.92409,-87.67646
KA1504000140,6,17,true,14,15,1,41.92409,-87.67646
504,6,17,true,2,3,1,41.92464,-87.68931
15648,6,17,true,12,29,17,41.92464,-87.68931
503,6,17,true,1,1,0,41.92483,-87.71451
KA1504000090,6,17,true,9,10,1,41.92483,-87.7145
TA1307000001,6,17,true,82,78,-4,41.92535,-87.66581
188,6,17,true,10,12,2,41.92536,-87.66581
TA1306000026,6,17,true,44,66,22,41.92558,-87.65842
87,6,17,true,17,13,-4,41.92559,-87.65843
67,6,17,true,5,9,4,41.9256,-87.65371
TA1306000016,6,17,true,60,68,8,41.9256,-87.65371
313,6,17,true,23,36,13,41.9257,-87.64246
TA1309000019,6,17,true,120,101,-19,41.92586,-87.63897
TA1309000058,6,17,true,122,126,4,41.92591,-87.64927
127,6,17,true,13,18,5,41.92592,-87.64927
TA1308000001,6,17,true,230,209,-21,41.92627,-87.63086
177,6,17,true,42,27,-15,41.92627,-87.63086
502,6,17,true,5,5,0,41.92667,-87.69772
15646,6,17,true,12,30,18,41.92668,-87.6977
34,6,17,true,7,3,-4,41.92675,-87.63444
13124,6,17,true,30,27,-3,41.92675,-87.63444
302,6,17,true,17,20,3,41.92859,-87.65421
TA1309000023,6,17,true,106,106,0,41.9287,-87.65383
TA1307000113,6,17,true,69,59,-10,41.92878,-87.66391
190,6,17,true,13,11,-2,41.92878,-87.6639
166,6,17,true,9,7,-2,41.92883,-87.66853
13296,6,17,true,48,31,-17,41.92883,-87.66852
343,6,17,true,12,14,2,41.92889,-87.65898
TA1309000059,6,17,true,39,51,12,41.92889,-87.65898
349,6,17,true,16,16,0,41.92915,-87.6491
TA1309000061,6,17,true,121,108,-13,41.92915,-87.64909
TA1308000031,6,17,true,36,24,-12,41.92946,-87.68417
258,6,17,true,8,10,2,41.92946,-87.68417
TA1305000014,6,17,true,114,98,-16,41.92956,-87.64313
340,6,17,true,25,29,4,41.92956,-87.64313
260,6,17,true,13,10,-3,41.92958,-87.70791
13085,6,17,true,40,53,13,41.92958,-87.70789
499,6,17,true,2,1,-1,41.93056,-87.72381
15643,6,17,true,3,7,4,41.93057,-87.7238
TA1307000142,6,17,true,108,110,2,41.93125,-87.64432
220,6,17,true,22,34,12,41.93125,-87.64431
13276,6,17,true,79,49,-30,41.93132,-87.63874
324,6,17,true,10,22,12,41.93173,-87.64179
501,6,17,true,2,1,-1,41.93191,-87.70121
15645,6,17,true,7,10,3,41.93191,-87.70121
163,6,17,true,6,6,0,41.93191,-87.67784
13271,6,17,true,20,32,12,41.93192,-87.67784
152,6,17,true,12,15,3,41.93221,-87.65864
TA1307000064,6,17,true,87,86,-1,41.93222,-87.65864
TA1306000014,6,17,true,96,85,-11,41.93242,-87.65271
13,6,17,true,15,12,-3,41.93242,-87.65271
TA1309000039,6,17,true,110,86,-24,41.93258,-87.63642
329,6,17,true,13,10,-3,41.93258,-87.63642
13294,6,17,true,35,42,7,41.9326,-87.66595
319,6,17,true,8,5,-3,41.93292,-87.67217
TA1309000036,6,17,true,89,76,-13,41.93313,-87.64776
332,6,17,true,11,14,3,41.93313,-87.64776
15644,6,17,true,15,11,-4,41.93534,-87.71687
500,6,17,true,2,2,0,41.93534,-87.71686
TA1307000006,6,17,true,64,91,27,41.93571,-87.6636
153,6,17,true,11,23,12,41.93575,-87.66364
162,6,17,true,8,7,-1,41.93588,-87.67844
13268,6,17,true,31,27,-4,41.93588,-87.67843
250,6,17,true,7,9,2,41.93609,-87.66984
13269,6,17,true,30,26,-4,41.93609,-87.66983
TA1307000052,6,17,true,87,81,-6,41.93628,-87.65266
115,6,17,true,21,26,5,41.93628,-87.65266
156,6,17,true,29,32,3,41.9365,-87.64756
TA1307000136,6,17,true,97,109,12,41.9365,-87.64755
TA1307000041,6,17,true,129,100,-29,41.93669,-87.63683
157,6,17,true,26,25,-1,41.9367,-87.63683
13137,6,17,true,145,162,17,41.9376,-87.6441
300,6,17,true,37,33,-4,41.93761,-87.6441
498,6,17,true,4,3,-1,41.93843,-87.69801
15642,6,17,true,18,27,9,41.93843,-87.69801
154,6,17,true,5,10,5,41.93912,-87.66384
664,6,17,true,4,3,-1,41.93934,-87.68327
KA17018068,6,17,true,15,19,4,41.93935,-87.68327
TA1309000042,6,17,true,55,67,12,41.93937,-87.66836
131,6,17,true,9,15,6,41.93937,-87.66835
KA150400009X,6,17,true,9,10,1,41.9394,-87.71159
15640,6,17,true,7,3,-4,41.93941,-87.72357
497,6,17,true,2,2,0,41.93941,-87.71159
13229,6,17,true,55,47,-8,41.93946,-87.66376
226,6,17,true,7,24,17,41.93972,-87.65886
TA1308000019,6,17,true,61,78,17,41.93973,-87.65886
296,6,17,true,22,13,-9,41.9401,-87.64546
13277,6,17,true,76,92,16,41.9401,-87.64546
TA1307000134,6,17,true,142,140,-2,41.94016,-87.65303
117,6,17,true,22,29,7,41.94016,-87.65302
228,6,17,true,9,6,-3,41.94058,-87.67854
13143,6,17,true,35,27,-8,41.94059,-87.67853
334,6,17,true,11,15,4,41.94076,-87.63919
TA1309000049,6,17,true,115,112,-3,41.94077,-87.63919
308,6,17,true,8,2,-6,41.94152,-87.68471
493,6,17,true,5,1,-4,41.94304,-87.68729
15634,6,17,true,17,15,-2,41.94304,-87.68729
TA1307000138,6,17,true,44,59,15,41.94334,-87.67094
230,6,17,true,11,11,0,41.94335,-87.67093
13144,6,17,true,44,35,-9,41.9434,-87.67964
299,6,17,true,32,25,-7,41.94368,-87.64894
TA1309000025,6,17,true,93,87,-6,41.94368,-87.64894
229,6,17,true,25,22,-3,41.94372,-87.66401
13071,6,17,true,88,108,20,41.94373,-87.66401
632,6,17,true,140,169,29,41.94453,-87.6547
303,6,17,true,29,31,2,41.94522,-87.64702
490,6,17,true,3,3,0,41.94523,-87.70664
15631,6,17,true,12,11,-1,41.94524,-87.70665
13278,6,17,true,102,126,24,41.94553,-87.64644
330,6,17,true,4,6,2,41.94618,-87.67331
TA1309000050,6,17,true,11,22,11,41.94618,-87.67331
KA1504000141,6,17,true,1,2,1,41.94627,-87.73105
15632,6,17,true,6,5,-1,41.94664,-87.69463
KA1504000143,6,17,true,13,14,1,41.94664,-87.68337
KA1504000142,6,17,true,7,4,-3,41.94735,-87.71759
227,6,17,true,20,20,0,41.94813,-87.66397
13235,6,17,true,95,89,-6,41.94814,-87.66396
304,6,17,true,23,24,1,41.94878,-87.64922
13253,6,17,true,34,28,-6,41.9488,-87.67527
257,6,17,true,10,4,-6,41.9488,-87.67527
13325,6,17,true,122,121,-1,41.94907,-87.64863
114,6,17,true,6,18,12,41.94935,-87.65451
TA1307000126,6,17,true,87,101,14,41.94936,-87.65451
232,6,17,true,26,27,1,41.94943,-87.64645
TA1307000150,6,17,true,110,119,9,41.94945,-87.64646
18016,6,17,true,6,2,-4,41.94993,-87.71395
347,6,17,true,4,3,-1,41.95068,-87.6687
13319,6,17,true,36,27,-9,41.95069,-87.6687
TA1307000127,6,17,true,88,69,-19,41.9508,-87.65918
165,6,17,true,14,23,9,41.95081,-87.65918
15628,6,17,true,12,7,-5,41.95216,-87.69806
487,6,17,true,3,1,-2,41.95216,-87.69806
318,6,17,true,6,5,-1,41.95254,-87.6735
256,6,17,true,11,11,0,41.95282,-87.65
13323,6,17,true,54,74,20,41.95282,-87.65
15624,6,17,true,4,9,5,41.95339,-87.73199
314,6,17,true,8,7,-1,41.9535,-87.69199
KA1504000096,6,17,true,2,5,3,41.95361,-87.70932
KA1504000139,6,17,true,1,6,5,41.954,-87.71909
484,6,17,true,1,3,2,41.954,-87.71907
TA1309000043,6,17,true,40,32,-8,41.95417,-87.66434
13063,6,17,true,87,64,-23,41.95424,-87.65441
240,6,17,true,19,13,-6,41.95424,-87.65441
486,6,17,true,4,2,-2,41.95431,-87.68607
KA1504000158,6,17,true,13,8,-5,41.95432,-87.68607
254,6,17,true,13,20,7,41.95438,-87.64806
TA1308000022,6,17,true,77,84,7,41.95438,-87.64805
16991,6,17,true,1,2,1,41.95448,-87.7496
244,6,17,true,7,4,-3,41.95466,-87.67391
TA1307000149,6,17,true,33,35,2,41.95467,-87.67392
298,6,17,true,9,16,7,41.95601,-87.68021
TA1309000026,6,17,true,33,40,7,41.95601,-87.6802
246,6,17,true,2,6,4,41.95606,-87.66885
13249,6,17,true,14,19,5,41.95606,-87.66885
312,6,17,true,15,18,3,41.95637,-87.6563
TA1308000047,6,17,true,22,18,-4,41.95709,-87.6642
292,6,17,true,2,5,3,41.95709,-87.6642
13379,6,17,true,70,67,-3,41.95786,-87.6495
TA1309000018,6,17,true,15,24,9,41.95791,-87.67357
316,6,17,true,7,7,0,41.95841,-87.69401
306,6,17,true,18,12,-6,41.9585,-87.655
TA1309000027,6,17,true,70,52,-18,41.9585,-87.65499
13389,6,17,true,67,54,-13,41.961,-87.64958
245,6,17,true,6,14,8,41.96101,-87.64958
15621,6,17,true,9,22,13,41.96103,-87.70586
480,6,17,true,2,4,2,41.96104,-87.70586
KA1706005015,6,17,true,2,2,0,41.96108,-87.73569
15622,6,17,true,16,12,-4,41.96108,-87.69544
481,6,17,true,10,9,-1,41.96108,-87.69544
495,6,17,true,1,1,0,41.96109,-87.72897
KA1504000097,6,17,true,6,7,1,41.96116,-87.71658
238,6,17,true,5,8,3,41.96141,-87.6762
TA1307000144,6,17,true,21,21,0,41.96142,-87.6762
297,6,17,true,2,6,4,41.9615,-87.67141
TA1309000021,6,17,true,18,11,-7,41.9615,-87.6714
15623,6,17,true,13,15,2,41.96154,-87.69117
482,6,17,true,7,10,3,41.96154,-87.69117
234,6,17,true,3,5,2,41.96158,-87.6661
KA1503000022,6,17,true,30,30,0,41.96158,-87.66609
231,6,17,true,17,13,-4,41.96163,-87.65464
TA1307000107,6,17,true,85,80,-5,41.96164,-87.65464
TA1307000156,6,17,true,30,21,-9,41.96301,-87.68479
243,6,17,true,7,7,0,41.96302,-87.68479
TA1309000012,6,17,true,18,13,-5,41.96325,-87.67928
TA1308000012,6,17,true,140,112,-28,41.96398,-87.63818
249,6,17,true,21,14,-7,41.96398,-87.63818
293,6,17,true,9,11,2,41.96521,-87.65822
13074,6,17,true,55,59,4,41.96521,-87.6582
639,6,17,true,75,53,-22,41.96584,-87.64538
477,6,17,true,4,3,-1,41.96587,-87.70083
KA1504000127,6,17,true,12,11,-1,41.96587,-87.70083
KA1504000093,6,17,true,12,11,-1,41.96587,-87.69365
478,6,17,true,4,3,-1,41.96587,-87.69364
TA1307000140,6,17,true,41,39,-2,41.96643,-87.68865
239,6,17,true,10,11,1,41.9665,-87.68843
326,6,17,true,10,8,-2,41.96665,-87.67113
476,6,17,true,3,1,-2,41.96668,-87.70807
KA1504000126,6,17,true,6,8,2,41.96668,-87.70807
TA1309000014,6,17,true,43,63,20,41.96709,-87.66744
TA1307000158,6,17,true,24,24,0,41.9671,-87.67904
242,6,17,true,3,6,3,41.9671,-87.67904
251,6,17,true,5,1,-4,41.96796,-87.65
TA1307000119,6,17,true,34,30,-4,41.96796,-87.65
15615,6,17,true,2,2,0,41.96835,-87.71183
323,6,17,true,12,10,-2,41.96869,-87.66034
253,6,17,true,6,7,1,41.96883,-87.65765
TA1308000021,6,17,true,30,45,15,41.96883,-87.65765
475,6,17,true,3,6,3,41.96885,-87.69611
KA1504000080,6,17,true,16,17,1,41.96887,-87.69609
TA1309000015,6,17,true,14,23,9,41.96889,-87.68401
311,6,17,true,1,3,2,41.9689,-87.68402
TA1309000066,6,17,true,47,50,3,41.9691,-87.67423
344,6,17,true,10,18,8,41.9691,-87.67423
TA1309000041,6,17,true,22,40,18,41.96951,-87.65471
465,6,17,true,7,12,5,41.97161,-87.65016
KA1504000171,6,17,true,43,48,5,41.97161,-87.65016
325,6,17,true,12,13,1,41.9728,-87.67186
TA1309000035,6,17,true,81,74,-7,41.97335,-87.66785
295,6,17,true,12,12,0,41.97378,-87.65972
13108,6,17,true,58,76,18,41.97379,-87.65971
KA1504000078,6,17,true,8,11,3,41.97491,-87.69258
472,6,17,true,2,3,1,41.97492,-87.69262
464,6,17,true,8,4,-4,41.97562,-87.67945
KA1504000149,6,17,true,19,29,10,41.97562,-87.67945
KA1504000160,6,17,true,7,6,-1,41.97564,-87.70143
471,6,17,true,3,3,0,41.97564,-87.70143
KA1504000128,6,17,true,7,5,-2,41.97567,-87.70927
470,6,17,true,2,3,1,41.97567,-87.70927
463,6,17,true,15,12,-3,41.978,-87.66805
KA1504000146,6,17,true,52,60,8,41.978,-87.66805
13109,6,17,true,49,42,-7,41.97835,-87.65976
294,6,17,true,11,19,8,41.97835,-87.65976
KA1504000147,6,17,true,5,14,9,41.97976,-87.67754
655,6,17,true,22,3,-19,41.97987,-87.68194
KA1504000161,6,17,true,5,4,-1,41.98038,-87.71612
KA1504000167,6,17,true,5,6,1,41.98206,-87.70895
460,6,17,true,3,6,3,41.98358,-87.66916
KA1504000151,6,17,true,41,40,-1,41.98359,-87.66916
15585,6,17,true,1,2,1,41.98367,-87.69642
KA1504000152,6,17,true,99,86,-13,41.98403,-87.65231
459,6,17,true,13,20,7,41.98403,-87.65231
15578,6,17,true,56,38,-18,41.98405,-87.66027
461,6,17,true,6,7,1,41.98405,-87.66027
353,6,17,true,1,1,0,41.98656,-87.70761
15575,6,17,true,47,36,-11,41.98975,-87.66014
458,6,17,true,11,13,2,41.98975,-87.66013
455,6,17,true,1,1,0,41.99024,-87.69338
KA1504000130,6,17,true,6,6,0,41.99024,-87.69338
457,6,17,true,2,3,1,41.99052,-87.66982
KA1504000148,6,17,true,8,45,37,41.99086,-87.66971
456,6,17,true,3,6,3,41.99117,-87.68359
KA1504000155,6,17,true,5,4,-1,41.99118,-87.68359
KA1504000129,6,17,true,9,6,-3,41.99417,-87.68945
452,6,17,true,1,5,4,41.99417,-87.68945
15571,6,17,true,46,39,-7,41.99478,-87.66028
454,6,17,true,8,17,9,41.99478,-87.66027
KA1504000156,6,17,true,16,18,2,41.99925,-87.67137
453,6,17,true,1,5,4,41.99925,-87.67137
RP-009,6,17,true,18,35,17,42.00107,-87.66122
451,6,17,true,2,3,1,42.00108,-87.66123
RP-001,6,17,true,6,2,-4,42.00179,-87.68883
RP-008,6,17,true,8,10,2,42.00446,-87.6724
RP-002,6,17,true,2,8,6,42.00456,-87.68065
448,6,17,true,1,2,1,42.00456,-87.68064
660,6,17,true,21,28,7,42.00458,-87.66143
354,6,17,true,2,3,1,42.00587,-87.66802
KA1504000175,6,17,true,22,20,-2,42.00797,-87.66549
447,6,17,true,8,5,-3,42.00797,-87.66548
RP-005,6,17,true,10,9,-1,42.0086,-87.69047
KA1504000162,6,17,true,4,10,6,42.00907,-87.67422
KA1504000159,6,17,true,9,12,3,42.01059,-87.66241
RP-006,6,17,true,1,1,0,42.01213,-87.68292
RP-007,6,17,true,6,5,-1,42.01256,-87.67431
525,6,17,true,12,25,13,42.01272,-87.66605
517,6,17,true,10,1,-9,42.01597,-87.675
520,6,17,true,34,27,-7,42.01597,-87.66859
519,6,17,true,4,2,-2,42.01696,-87.67773
527,6,17,true,9,6,-3,42.01892,-87.69004
515,6,17,true,11,12,1,42.01915,-87.67356
514,6,17,true,4,8,4,42.01927,-87.68452
16806,6,17,true,5,5,0,42.01953,-87.66955
523,6,17,true,28,28,0,42.02089,-87.66505
662,6,17,true,1,1,0,42.02354,-87.69961
598,6,17,true,2,10,8,42.02578,-87.68411
597,6,17,true,5,8,3,42.03256,-87.67914
E002,6,17,true,18,26,8,42.03256,-87.67912
599,6,17,true,10,5,-5,42.03972,-87.69942
625,6,17,true,2,2,0,42.04163,-87.6808
596,6,17,true,34,22,-12,42.04822,-87.68348
E008,6,17,true,11,9,-2,42.05049,-87.67782
603,6,17,true,2,2,0,42.05049,-87.67782
605,6,17,true,13,3,-10,42.05294,-87.67342
661,6,17,true,6,6,0,42.05704,-87.68657
604,6,17,true,14,14,0,42.05824,-87.67744
E006,6,17,true,3,4,1,42.06367,-87.69871
601,6,17,true,1,3,2,42.06368,-87.69871
E007,6,17,true,1,1,0,42.06431,-87.68615
602,6,17,true,2,2,0,42.06431,-87.68614
E014,6,17,true,3,4,1,42.06483,-87.71531
663,6,17,true,2,5,3,42.06483,-87.71531
20214,7,9,false,4,4,0,41.65191,-87.53961
20217,7,9,false,1,1,0,41.66628,-87.55719
20224,7,9,false,5,2,-3,41.71371,-87.53083
20238,7,9,false,1,1,0,41.7187,-87.597
703,7,9,false,4,1,-3,41.71871,-87.59699
20119,7,9,false,1,1,0,41.72682,-87.6543
20239,7,9,false,1,1,0,41.73367,-87.5584
595,7,9,false,1,3,2,41.73663,-87.62264
573,7,9,false,2,1,-1,41.75079,-87.62444
16970,7,9,false,1,1,0,41.7518,-87.5785
579,7,9,false,1,2,1,41.75182,-87.56522
575,7,9,false,1,1,0,41.75318,-87.60502
KA1503000028,7,9,false,1,1,0,41.75712,-87.57585
KA1503000049,7,9,false,3,4,1,41.75788,-87.54938
571,7,9,false,2,1,-1,41.75836,-87.61415
570,7,9,false,1,1,0,41.75849,-87.60642
KA1503000024,7,9,false,3,1,-2,41.75876,-87.56644
KA1503000020,7,9,false,1,1,0,41.76223,-87.55923
KA1503000002,7,9,false,7,4,-3,41.76641,-87.5657
KA1503000045,7,9,false,1,4,3,41.76649,-87.58647
KA1503000023,7,9,false,1,2,1,41.77346,-87.58534
KA1503000030,7,9,false,3,3,0,41.77352,-87.57722
KA1503000029,7,9,false,8,6,-2,41.77364,-87.56747
KA1503000031,7,9,false,1,1,0,41.77373,-87.60564
KA1503000021,7,9,false,2,3,1,41.77888,-87.58665
KA1503000055,7,9,false,1,1,0,41.77939,-87.64463
649,7,9,false,1,1,0,41.77984,-87.63477
KA1503000046,7,9,false,4,12,8,41.78041,-87.59141
653,7,9,false,7,9,2,41.78059,-87.58491
KA1503000054,7,9,false,3,5,2,41.78061,-87.60582
15491,7,9,false,40,18,-22,41.78096,-87.57624
KA1503000033,7,9,false,1,3,2,41.78411,-87.61329
KA1503000014,7,9,false,27,8,-19,41.7851,-87.60108
426,7,9,false,13,3,-10,41.7851,-87.60108
KA1503000070,7,9,false,9,8,-1,41.78794,-87.58831
328,7,9,false,3,2,-1,41.78872,-87.6013
TA1309000011,7,9,false,3,10,7,41.78873,-87.60131
KA1503000071,7,9,false,5,11,6,41.79148,-87.59988
424,7,9,false,4,6,2,41.79174,-87.58395
KA1503000074,7,9,false,21,26,5,41.79174,-87.58395
TA1309000063,7,9,false,15,11,-4,41.79325,-87.5878
345,7,9,false,1,1,0,41.79326,-87.5878
420,7,9,false,1,11,10,41.79429,-87.60145
KA1504000076,7,9,false,9,15,6,41.7943,-87.60145
TA1307000160,7,9,false,3,4,1,41.79485,-87.61873
247,7,9,false,5,7,2,41.79522,-87.58077
TA1308000009,7,9,false,35,20,-15,41.79522,-87.58075
TA1307000164,7,9,false,11,9,-2,41.79527,-87.59647
248,7,9,false,2,2,0,41.79528,-87.59647
KA1503000052,7,9,false,20,4,-16,41.79935,-87.60097
KA1503000059,7,9,false,20,17,-3,41.79952,-87.58643
TA1309000037,7,9,false,26,9,-17,41.79957,-87.59474
15470,7,9,false,4,2,-2,41.80228,-87.61807
417,7,9,false,2,1,-1,41.80242,-87.5869
KA1503000007,7,9,false,19,10,-9,41.80242,-87.58689
13398,7,9,false,13,18,5,41.80256,-87.59035
TA1309000067,7,9,false,7,3,-4,41.80303,-87.60661
KA1503000069,7,9,false,2,4,2,41.80579,-87.59247
TA1308000035,7,9,false,15,5,-10,41.80944,-87.59188
267,7,9,false,3,1,-2,41.80944,-87.59188
TA1308000002,7,9,false,5,5,0,41.80983,-87.59937
TA1308000007,7,9,false,6,1,-5,41.80984,-87.61628
TA1309000053,7,9,false,3,1,-2,41.80985,-87.60675
KA1503000065,7,9,false,4,8,4,41.81409,-87.59701
KA1503000032,7,9,false,1,1,0,41.81912,-87.64328
265,7,9,false,1,2,1,41.82297,-87.6071
TA1308000038,7,9,false,7,5,-2,41.82298,-87.6071
13420,7,9,false,4,5,1,41.82459,-87.61678
KA1503000066,7,9,false,1,1,0,41.83011,-87.67031
TA1308000045,7,9,false,2,4,2,41.83062,-87.64129
TA1308000043,7,9,false,1,1,0,41.83066,-87.64715
15446,7,9,false,2,1,-1,41.83068,-87.65603
KA1503000005,7,9,false,1,3,2,41.83079,-87.6325
TA1307000129,7,9,false,1,2,1,41.83104,-87.62683
KA1503000004,7,9,false,14,8,-6,41.83127,-87.6088
13345,7,9,false,4,3,-1,41.83138,-87.61803
13216,7,9,false,3,6,3,41.83473,-87.62581
13217,7,9,false,2,5,3,41.83488,-87.61792
13215,7,9,false,14,5,-9,41.83634,-87.6135
263,7,9,false,1,1,0,41.8364,-87.61348
280,7,9,false,1,1,0,41.83779,-87.65116
TA1308000046,7,9,false,8,1,-7,41.83779,-87.65115
TA1309000055,7,9,false,6,3,-3,41.8382,-87.64514
KA1503000038,7,9,false,6,3,-3,41.83845,-87.6354
TA1307000048,7,9,false,44,31,-13,41.83855,-87.60821
368,7,9,false,1,1,0,41.83915,-87.66562
15442,7,9,false,1,4,3,41.83918,-87.66562
KA1503000040,7,9,false,1,2,1,41.84164,-87.65744
TA1307000139,7,9,false,13,4,-9,41.84205,-87.61698
KA1504000110,7,9,false,1,3,2,41.84454,-87.71596
147,7,9,false,1,1,0,41.84569,-87.62251
TA1307000005,7,9,false,12,6,-6,41.84569,-87.6225
TA1308000013,7,9,false,1,3,2,41.84719,-87.64681
TA1307000066,7,9,false,2,2,0,41.8492,-87.67564
TA1308000014,7,9,false,1,1,0,41.84953,-87.64059
TA1308000026,7,9,false,2,4,2,41.85008,-87.63214
TA1305000004,7,9,false,32,18,-14,41.8514,-87.61884
TA1305000001,7,9,false,9,10,1,41.85262,-87.6265
13075,7,9,false,11,16,5,41.8531,-87.63192
13162,7,9,false,7,4,-3,41.85378,-87.64659
15546,7,9,false,18,12,-6,41.85416,-87.61916
351,7,9,false,1,1,0,41.85441,-87.67678
13307,7,9,false,4,1,-3,41.85489,-87.66359
124,7,9,false,3,2,-1,41.85492,-87.67609
13331,7,9,false,5,1,-4,41.85515,-87.65414
4,7,9,false,4,2,-2,41.85627,-87.61334
15545,7,9,false,12,23,11,41.85627,-87.61334
SL-013,7,9,false,2,5,3,41.85659,-87.62755
13135,7,9,false,10,5,-5,41.85753,-87.66157
13102,7,9,false,39,23,-16,41.85762,-87.61942
273,7,9,false,4,2,-2,41.85783,-87.62455
13150,7,9,false,15,16,1,41.85783,-87.62455
13099,7,9,false,3,2,-1,41.85784,-87.64627
TA1307000159,7,9,false,7,3,-4,41.8579,-87.6687
TA1307000044,7,9,false,2,3,1,41.85794,-87.64083
13163,7,9,false,10,6,-4,41.85808,-87.65108
13164,7,9,false,19,5,-14,41.85818,-87.65648
SL-012,7,9,false,22,5,-17,41.86038,-87.62581
72,7,9,false,1,2,1,41.86039,-87.62581
13304,7,9,false,7,1,-6,41.86126,-87.65659
KA1504000109,7,9,false,2,1,-1,41.86192,-87.69347
TA1306000002,7,9,false,7,1,-6,41.86238,-87.65108
137,7,9,false,2,1,-1,41.86238,-87.65108
TA1307000124,7,9,false,38,21,-17,41.86411,-87.62372
168,7,9,false,6,8,2,41.86415,-87.62372
282,7,9,false,6,1,-5,41.86487,-87.64708
TA1309000001,7,9,false,4,4,0,41.86488,-87.64708
97,7,9,false,1,8,7,41.86531,-87.6179
13029,7,9,false,13,43,30,41.86531,-87.6179
13431,7,9,false,45,32,-13,41.8661,-87.60728
15682,7,9,false,1,1,0,41.86651,-87.70649
WL-008,7,9,false,8,10,2,41.86712,-87.64108
TA1305000002,7,9,false,50,38,-12,41.86721,-87.62597
59,7,9,false,6,1,-5,41.86721,-87.62597
3,7,9,false,5,7,2,41.86723,-87.61536
15544,7,9,false,34,168,134,41.86723,-87.61536
TA1305000017,7,9,false,1,1,0,41.86734,-87.64863
626,7,9,false,2,1,-1,41.86749,-87.63219
KA1706005007,7,9,false,6,15,9,41.86749,-87.63219
SL-005,7,9,false,115,86,-29,41.8679,-87.62304
255,7,9,false,16,5,-11,41.86791,-87.62304
644,7,9,false,11,2,-9,41.86859,-87.68625
13139,7,9,false,9,2,-7,41.86893,-87.65913
13285,7,9,false,1,2,1,41.86928,-87.67372
13160,7,9,false,10,9,-1,41.86947,-87.65548
414,7,9,false,2,2,0,41.87023,-87.63947
15550,7,9,false,4,8,4,41.87024,-87.63947
TA1309000010,7,9,false,45,27,-18,41.87074,-87.62574
SL-009,7,9,false,19,9,-10,41.87081,-87.63121
342,7,9,false,2,1,-1,41.87127,-87.6737
TA1309000064,7,9,false,13,4,-9,41.87127,-87.67369
15542,7,9,false,1,1,0,41.87146,-87.64095
TA1307000130,7,9,false,8,3,-5,41.87178,-87.65103
TA1307000121,7,9,false,2,5,3,41.87184,-87.64664
41,7,9,false,10,1,-9,41.87209,-87.62957
SL-008,7,9,false,50,20,-30,41.87209,-87.62956
13332,7,9,false,27,4,-23,41.87219,-87.6615
175,7,9,false,6,3,-3,41.87255,-87.63359
SL-011,7,9,false,39,21,-18,41.87256,-87.63356
623,7,9,false,125,67,-58,41.87272,-87.62399
KA1504000104,7,9,false,4,3,-1,41.87296,-87.66912
SL-007,7,9,false,29,10,-19,41.87404,-87.6277
169,7,9,false,2,1,-1,41.87424,-87.63959
TA1306000025,7,9,false,8,2,-6,41.87464,-87.65703
15668,7,9,false,3,1,-2,41.87471,-87.68642
13028,7,9,false,12,6,-6,41.87475,-87.64981
SL-010,7,9,false,17,6,-11,41.87501,-87.63309
15541,7,9,false,69,41,-28,41.8758,-87.62086
13037,7,9,false,3,3,0,41.87588,-87.64078
TA1305000009,7,9,false,9,9,0,41.87593,-87.63068
317,7,9,false,2,3,1,41.87603,-87.68195
TA1305000010,7,9,false,52,13,-39,41.87623,-87.62444
624,7,9,false,27,19,-8,41.87626,-87.62923
2,7,9,false,2,1,-1,41.87649,-87.62051
33,7,9,false,4,2,-2,41.87715,-87.62786
TA1305000035,7,9,false,10,3,-7,41.87716,-87.62787
13138,7,9,false,5,1,-4,41.87723,-87.63941
631,7,9,false,2,4,2,41.87761,-87.6739
16913,7,9,false,1,2,1,41.87762,-87.7454
15539,7,9,false,15,13,-2,41.87763,-87.64405
13158,7,9,false,31,9,-22,41.87764,-87.64957
21,7,9,false,4,2,-2,41.87773,-87.6548
13157,7,9,false,15,19,4,41.87773,-87.6548
TA1305000025,7,9,false,31,34,3,41.87773,-87.63528
36,7,9,false,6,2,-4,41.87776,-87.63525
TA1309000002,7,9,false,27,33,6,41.87784,-87.62408
13206,7,9,false,10,5,-5,41.87794,-87.66201
146,7,9,false,3,1,-2,41.87794,-87.66201
TA1309000004,7,9,false,16,3,-13,41.87811,-87.63184
107,7,9,false,2,3,1,41.87822,-87.644
638,7,9,false,21,15,-6,41.87827,-87.64078
TA1305000005,7,9,false,20,2,-18,41.87924,-87.62975
13011,7,9,false,31,8,-23,41.87931,-87.63993
TA1309000008,7,9,false,32,35,3,41.87933,-87.6355
192,7,9,false,1,2,1,41.87935,-87.63997
KA1503000034,7,9,false,30,11,-19,41.87938,-87.63197
KA1503000015,7,9,false,34,13,-21,41.87948,-87.6257
15667,7,9,false,9,2,-7,41.8798,-87.68609
287,7,9,false,2,7,5,41.88017,-87.63527
TA1309000007,7,9,false,13,17,4,41.88022,-87.63526
WL-011,7,9,false,18,16,-2,41.88034,-87.64273
80,7,9,false,3,2,-1,41.88042,-87.65556
13156,7,9,false,21,22,1,41.88042,-87.65554
13300,7,9,false,188,145,-43,41.88097,-87.61675
76,7,9,false,18,8,-10,41.88098,-87.61675
13008,7,9,false,141,126,-15,41.88105,-87.62408
90,7,9,false,17,13,-4,41.88107,-87.62409
49,7,9,false,4,2,-2,41.88116,-87.62963
TA1305000006,7,9,false,34,19,-15,41.88122,-87.6296
13134,7,9,false,3,5,2,41.88138,-87.67493
13056,7,9,false,16,3,-13,41.88168,-87.63951
198,7,9,false,3,3,0,41.88187,-87.6488
TA1307000120,7,9,false,52,46,-6,41.88188,-87.64879
13341,7,9,false,4,5,1,41.88208,-87.63985
197,7,9,false,7,2,-5,41.88208,-87.62513
13036,7,9,false,21,17,-4,41.8821,-87.62513
TA1305000032,7,9,false,46,20,-26,41.88218,-87.64109
98,7,9,false,3,1,-2,41.88266,-87.63251
13006,7,9,false,23,5,-18,41.88268,-87.63252
13353,7,9,false,13,18,5,41.88283,-87.6612
346,7,9,false,4,4,0,41.88284,-87.6612
654,7,9,false,14,11,-3,41.88307,-87.65698
13409,7,9,false,9,14,5,41.8831,-87.6511
18,7,9,false,6,3,-3,41.88317,-87.63735
KA1503000072,7,9,false,4,6,2,41.88317,-87.63693
91,7,9,false,1,1,0,41.88336,-87.64122
WL-012,7,9,false,21,13,-8,41.88337,-87.6412
13053,7,9,false,41,47,6,41.88365,-87.64863
43,7,9,false,13,9,-4,41.88396,-87.62455
13001,7,9,false,103,60,-43,41.88397,-87.62459
13155,7,9,false,9,3,-6,41.88407,-87.65689
621,7,9,false,1,1,0,41.88412,-87.65427
18062,7,9,false,12,28,16,41.88412,-87.65427
81,7,9,false,6,3,-3,41.88417,-87.6296
TA1306000010,7,9,false,20,9,-11,41.88419,-87.62961
TA1305000030,7,9,false,19,15,-4,41.88459,-87.63178
96,7,9,false,8,1,-7,41.8846,-87.64455
15535,7,9,false,15,10,-5,41.8846,-87.64455
TA1305000029,7,9,false,35,28,-7,41.88466,-87.62787
195,7,9,false,9,6,-3,41.88466,-87.61952
13263,7,9,false,74,35,-39,41.88467,-87.61952
44,7,9,false,7,2,-5,41.88468,-87.62782
TA1306000015,7,9,false,14,39,25,41.88549,-87.65232
518,7,9,false,1,1,0,41.8855,-87.71686
71,7,9,false,5,6,1,41.8855,-87.65233
13021,7,9,false,33,7,-26,41.88559,-87.64184
TA1307000111,7,9,false,25,12,-13,41.88582,-87.63548
13073,7,9,false,6,5,-1,41.88592,-87.66717
KA17018054,7,9,false,4,4,0,41.88595,-87.67701
38,7,9,false,6,3,-3,41.88599,-87.63089
KA1503000012,7,9,false,19,18,-1,41.88599,-87.63089
52,7,9,false,7,3,-4,41.886,-87.62421
TA1305000011,7,9,false,73,53,-20,41.886,-87.62418
7,7,9,false,3,2,-1,41.88627,-87.61751
15534,7,9,false,56,24,-32,41.88627,-87.61749
217,7,9,false,1,1,0,41.8866,-87.65821
13197,7,9,false,4,1,-3,41.8866,-87.65816
TA1308000029,7,9,false,45,32,-13,41.88673,-87.62225
16903,7,9,false,1,1,0,41.88686,-87.74531
TA1307000131,7,9,false,69,41,-28,41.88688,-87.62606
194,7,9,false,11,5,-6,41.88688,-87.62606
KA1503000064,7,9,false,78,56,-22,41.88697,-87.61281
6,7,9,false,7,1,-6,41.88697,-87.61281
530,7,9,false,1,2,1,41.88783,-87.75558
TA1305000022,7,9,false,37,15,-22,41.88817,-87.63656
56,7,9,false,6,1,-5,41.88866,-87.64442
TA1306000003,7,9,false,32,20,-12,41.88867,-87.64442
KA1503000043,7,9,false,54,34,-20,41.88918,-87.63851
133,7,9,false,4,3,-1,41.88918,-87.63851
13050,7,9,false,44,37,-7,41.88919,-87.62775
47,7,9,false,13,6,-7,41.88921,-87.62775
15664,7,9,false,1,1,0,41.8895,-87.68821
13432,7,9,false,4,3,-1,41.88989,-87.67149
TA1307000151,7,9,false,33,34,1,41.88993,-87.63427
212,7,9,false,5,3,-2,41.88995,-87.63427
636,7,9,false,20,14,-6,41.88997,-87.63662
KA1503000044,7,9,false,33,17,-16,41.89018,-87.6262
196,7,9,false,2,4,2,41.89053,-87.62205
13427,7,9,false,47,25,-22,41.89054,-87.62205
26,7,9,false,8,8,0,41.89057,-87.61798
13430,7,9,false,56,41,-15,41.89077,-87.63169
181,7,9,false,3,3,0,41.89077,-87.63168
TA1306000013,7,9,false,116,72,-44,41.89083,-87.61852
RN-,7,9,false,22,12,-10,41.89102,-87.63546
672,7,9,false,1,2,1,41.89102,-87.63545
13434,7,9,false,9,2,-7,41.89108,-87.66663
TA1308000006,7,9,false,6,8,2,41.89128,-87.67686
199,7,9,false,6,8,2,41.89143,-87.62676
TA1307000117,7,9,false,76,38,-38,41.89144,-87.62675
13033,7,9,false,37,32,-5,41.8916,-87.64835
84,7,9,false,6,1,-5,41.89161,-87.64833
186,7,9,false,3,2,-1,41.8918,-87.65879
13194,7,9,false,16,8,-8,41.8918,-87.65878
TA1305000003,7,9,false,80,59,-21,41.89187,-87.62061
24,7,9,false,12,3,-9,41.8919,-87.62063
643,7,9,false,10,8,-2,41.89203,-87.68939
35,7,9,false,13,9,-4,41.89227,-87.61206
13022,7,9,false,230,209,-21,41.89227,-87.61205
99,7,9,false,9,1,-8,41.89255,-87.61449
TA1306000029,7,9,false,89,60,-29,41.89256,-87.61449
13265,7,9,false,44,9,-35,41.89383,-87.64172
13045,7,9,false,82,46,-36,41.89403,-87.62931
110,7,9,false,12,9,-3,41.89406,-87.6293
13016,7,9,false,119,59,-60,41.89431,-87.62277
211,7,9,false,2,9,7,41.89439,-87.62267
KA1503000041,7,9,false,82,14,-68,41.89452,-87.61798
142,7,9,false,18,5,-13,41.89453,-87.61806
13196,7,9,false,16,11,-5,41.89455,-87.65345
TA1307000062,7,9,false,23,11,-12,41.89466,-87.63839
TA1306000012,7,9,false,65,53,-12,41.89475,-87.63438
53,7,9,false,15,4,-11,41.89476,-87.63439
627,7,9,false,2,4,2,41.8948,-87.63231
KP1705001026,7,9,false,33,20,-13,41.89483,-87.6323
18058,7,9,false,13,1,-12,41.8955,-87.68201
637,7,9,false,13,8,-5,41.89563,-87.67209
13132,7,9,false,20,13,-7,41.89573,-87.67718
161,7,9,false,4,4,0,41.89574,-87.62599
15530,7,9,false,65,23,-42,41.89575,-87.62596
18003,7,9,false,27,3,-24,41.89575,-87.62011
635,7,9,false,1,1,0,41.89576,-87.62012
13247,7,9,false,14,16,2,41.89597,-87.66775
350,7,9,false,6,2,-4,41.89597,-87.66774
TA1305000020,7,9,false,22,18,-4,41.89636,-87.65406
13289,7,9,false,14,8,-6,41.89638,-87.661
337,7,9,false,2,5,3,41.89659,-87.63096
13303,7,9,false,28,18,-10,41.89672,-87.63088
13017,7,9,false,34,14,-20,41.89676,-87.6357
31,7,9,false,2,3,1,41.89677,-87.63572
13338,7,9,false,28,26,-2,41.89697,-87.62173
173,7,9,false,2,2,0,41.89704,-87.62173
TA1307000061,7,9,false,32,16,-16,41.89745,-87.62873
106,7,9,false,1,2,1,41.89746,-87.62874
25,7,9,false,5,5,0,41.89751,-87.62354
13034,7,9,false,57,38,-19,41.89754,-87.62352
TA1306000009,7,9,false,22,11,-11,41.89772,-87.64299
620,7,9,false,36,17,-19,41.89817,-87.63754
KA1504000103,7,9,false,10,5,-5,41.89842,-87.68659
374,7,9,false,5,1,-4,41.89842,-87.68659
145,7,9,false,7,1,-6,41.89856,-87.62211
15529,7,9,false,74,28,-46,41.89858,-87.62206
140,7,9,false,4,10,6,41.89895,-87.6299
TA1307000128,7,9,false,42,49,7,41.89896,-87.6299
657,7,9,false,12,1,-11,41.89918,-87.6722
KA1504000117,7,9,false,1,7,6,41.89936,-87.64848
30,7,9,false,2,2,0,41.89964,-87.66789
13248,7,9,false,9,4,-5,41.89964,-87.66788
46,7,9,false,4,3,-1,41.89994,-87.63444
TA1306000011,7,9,false,13,13,0,41.89994,-87.63443
KA1504000116,7,9,false,16,15,-1,41.90023,-87.64299
364,7,9,false,1,1,0,41.90023,-87.64299
17660,7,9,false,24,6,-18,41.90036,-87.69671
13290,7,9,false,9,5,-4,41.90069,-87.66259
29,7,9,false,1,2,1,41.90069,-87.66259
13042,7,9,false,210,176,-34,41.90097,-87.62377
85,7,9,false,9,6,-3,41.90098,-87.62375
TA1307000070,7,9,false,8,6,-2,41.90133,-87.67742
KA1504000133,7,9,false,46,46,0,41.90234,-87.62773
172,7,9,false,3,5,2,41.90236,-87.62774
15654,7,9,false,8,4,-4,41.90271,-87.70923
13241,7,9,false,14,4,-10,41.9029,-87.68731
176,7,9,false,13,5,-8,41.90291,-87.63141
TA1306000006,7,9,false,12,5,-7,41.90292,-87.63772
TA1307000039,7,9,false,89,55,-34,41.90294,-87.63137
658,7,9,false,4,2,-2,41.903,-87.6838
13256,7,9,false,8,5,-3,41.90302,-87.69749
TA1305000034,7,9,false,18,15,-3,41.90313,-87.67391
17,7,9,false,3,1,-2,41.90313,-87.67391
182,7,9,false,8,8,0,41.90317,-87.63442
KA1504000135,7,9,false,48,51,3,41.90319,-87.63439
13136,7,9,false,17,22,5,41.90326,-87.67845
210,7,9,false,4,4,0,41.90342,-87.66781
13061,7,9,false,48,33,-15,41.90342,-87.66779
KA1504000079,7,9,false,15,20,5,41.9035,-87.64334
359,7,9,false,2,3,1,41.90458,-87.6497
138,7,9,false,1,3,2,41.9046,-87.64057
TA1307000115,7,9,false,16,5,-11,41.9046,-87.64056
291,7,9,false,7,4,-3,41.90672,-87.63494
TA1308000049,7,9,false,16,21,5,41.90672,-87.6349
KA1504000134,7,9,false,39,15,-24,41.90687,-87.6262
180,7,9,false,1,3,2,41.90687,-87.62618
13224,7,9,false,37,17,-20,41.90706,-87.66725
18069,7,9,false,1,3,2,41.90722,-87.65563
TA1307000143,7,9,false,11,5,-6,41.90762,-87.63854
61,7,9,false,1,1,0,41.90764,-87.67254
13221,7,9,false,26,16,-10,41.90765,-87.67254
13245,7,9,false,7,1,-6,41.90777,-87.68586
301,7,9,false,2,5,3,41.90796,-87.63203
TA1309000024,7,9,false,38,24,-14,41.908,-87.63152
69,7,9,false,3,7,4,41.90939,-87.6777
TA1305000041,7,9,false,35,47,12,41.9094,-87.67769
15652,7,9,false,4,1,-3,41.90965,-87.71664
331,7,9,false,13,25,12,41.90965,-87.64812
15653,7,9,false,9,8,-1,41.90979,-87.7053
TA1305000037,7,9,false,19,9,-10,41.91018,-87.67003
27,7,9,false,1,1,0,41.91019,-87.6435
TA1306000008,7,9,false,10,12,2,41.9102,-87.6435
TA1308000005,7,9,false,22,10,-12,41.91042,-87.68238
13258,7,9,false,16,3,-13,41.91043,-87.69718
160,7,9,false,2,1,-1,41.91054,-87.68957
13257,7,9,false,21,5,-16,41.91054,-87.68956
13154,7,9,false,9,11,2,41.91054,-87.65312
20,7,9,false,1,5,4,41.91055,-87.65313
60,7,9,false,7,3,-4,41.91059,-87.64942
13058,7,9,false,23,25,2,41.91059,-87.64942
TA1307000038,7,9,false,16,17,1,41.91138,-87.63868
LF-005,7,9,false,101,101,0,41.91172,-87.62681
268,7,9,false,10,18,8,41.91172,-87.62681
126,7,9,false,1,6,5,41.91196,-87.63197
13128,7,9,false,38,35,-3,41.91197,-87.63197
289,7,9,false,5,13,8,41.91209,-87.63472
TA1308000050,7,9,false,68,83,15,41.91211,-87.6347
13243,7,9,false,23,13,-10,41.91262,-87.6814
TA1309000032,7,9,false,3,3,0,41.91293,-87.66417
TA1306000032,7,9,false,23,17,-6,41.9137,-87.65285
93,7,9,false,2,2,0,41.91371,-87.65285
224,7,9,false,5,3,-2,41.91386,-87.64877
TA1307000166,7,9,false,17,23,6,41.91386,-87.64877
15655,7,9,false,9,10,1,41.91401,-87.70514
18017,7,9,false,11,7,-4,41.91416,-87.71676
18067,7,9,false,14,11,-3,41.9146,-87.66796
628,7,9,false,2,4,2,41.9146,-87.66796
28,7,9,false,2,1,-1,41.91469,-87.64333
TA1306000007,7,9,false,7,7,0,41.91469,-87.64333
13068,7,9,false,11,13,2,41.91554,-87.68703
13179,7,9,false,71,88,17,41.9157,-87.63461
141,7,9,false,12,19,7,41.91571,-87.63461
13133,7,9,false,24,18,-6,41.91598,-87.67733
219,7,9,false,6,4,-2,41.91598,-87.67733
58,7,9,false,2,1,-1,41.91602,-87.66894
TA1305000039,7,9,false,3,19,16,41.9163,-87.66749
15650,7,9,false,8,11,3,41.91711,-87.71023
15651,7,9,false,7,7,0,41.91752,-87.70181
13266,7,9,false,4,9,5,41.91774,-87.69142
TA1309000029,7,9,false,16,4,-12,41.9178,-87.68245
309,7,9,false,3,3,0,41.91789,-87.6865
TA1309000006,7,9,false,22,16,-6,41.91809,-87.64375
223,7,9,false,2,2,0,41.91821,-87.65698
TA1307000163,7,9,false,19,23,4,41.91821,-87.65696
94,7,9,false,9,8,-1,41.91831,-87.6363
13146,7,9,false,44,54,10,41.91831,-87.63629
13059,7,9,false,37,32,-5,41.91845,-87.65222
113,7,9,false,7,5,-2,41.91846,-87.65222
13259,7,9,false,15,4,-11,41.91852,-87.69744
310,7,9,false,3,2,-1,41.91984,-87.68083
13192,7,9,false,26,25,-1,41.91995,-87.64884
225,7,9,false,3,2,-1,41.91995,-87.64884
13288,7,9,false,13,11,-2,41.92008,-87.67788
13242,7,9,false,2,6,4,41.92021,-87.69266
222,7,9,false,1,3,2,41.92023,-87.69265
TA1309000030,7,9,false,18,13,-5,41.92077,-87.66372
13292,7,9,false,11,7,-4,41.92152,-87.70733
TA1309000033,7,9,false,27,21,-6,41.92158,-87.65381
13193,7,9,false,43,32,-11,41.92182,-87.64412
144,7,9,false,5,4,-1,41.92182,-87.64411
13191,7,9,false,40,26,-14,41.92217,-87.63891
143,7,9,false,4,2,-2,41.92217,-87.63891
327,7,9,false,1,5,4,41.92225,-87.65783
13084,7,9,false,18,18,0,41.92268,-87.69715
LP-,7,9,false,32,19,-13,41.92396,-87.63584
673,7,9,false,2,2,0,41.92398,-87.63585
KA1504000140,7,9,false,4,7,3,41.92409,-87.67646
16010,7,9,false,1,1,0,41.92458,-87.72787
15648,7,9,false,7,4,-3,41.92464,-87.68931
503,7,9,false,1,1,0,41.92483,-87.71451
KA1504000090,7,9,false,5,5,0,41.92483,-87.7145
TA1307000001,7,9,false,21,10,-11,41.92535,-87.66581
TA1306000026,7,9,false,14,5,-9,41.92558,-87.65842
87,7,9,false,1,1,0,41.92559,-87.65843
TA1306000016,7,9,false,8,11,3,41.9256,-87.65371
313,7,9,false,6,2,-4,41.9257,-87.64246
TA1309000019,7,9,false,72,52,-20,41.92586,-87.63897
TA1309000058,7,9,false,43,37,-6,41.92591,-87.64927
127,7,9,false,3,5,2,41.92592,-87.64927
177,7,9,false,7,4,-3,41.92627,-87.63086
TA1308000001,7,9,false,90,117,27,41.92627,-87.63086
15646,7,9,false,2,6,4,41.92668,-87.6977
13124,7,9,false,15,13,-2,41.92675,-87.63444
302,7,9,false,6,3,-3,41.92859,-87.65421
TA1309000023,7,9,false,30,29,-1,41.9287,-87.65383
TA1307000113,7,9,false,17,14,-3,41.92878,-87.66391
166,7,9,false,7,1,-6,41.92883,-87.66853
13296,7,9,false,19,3,-16,41.92883,-87.66852
TA1309000059,7,9,false,15,11,-4,41.92889,-87.65898
343,7,9,false,2,1,-1,41.92889,-87.65898
349,7,9,false,5,5,0,41.92915,-87.6491
TA1309000061,7,9,false,30,20,-10,41.92915,-87.64909
TA1308000031,7,9,false,2,6,4,41.92946,-87.68417
TA1305000014,7,9,false,59,41,-18,41.92956,-87.64313
340,7,9,false,7,5,-2,41.92956,-87.64313
260,7,9,false,1,8,7,41.92958,-87.70791
13085,7,9,false,28,30,2,41.92958,-87.70789
15643,7,9,false,4,3,-1,41.93057,-87.7238
TA1307000142,7,9,false,48,39,-9,41.93125,-87.64432
220,7,9,false,4,6,2,41.93125,-87.64431
13276,7,9,false,80,28,-52,41.93132,-87.63874
324,7,9,false,7,5,-2,41.93173,-87.64179
15645,7,9,false,2,3,1,41.93191,-87.70121
163,7,9,false,3,1,-2,41.93191,-87.67784
13271,7,9,false,7,8,1,41.93192,-87.67784
152,7,9,false,4,5,1,41.93221,-87.65864
TA1307000064,7,9,false,28,21,-7,41.93222,-87.65864
TA1306000014,7,9,false,35,25,-10,41.93242,-87.65271
13,7,9,false,5,4,-1,41.93242,-87.65271
TA1309000039,7,9,false,71,43,-28,41.93258,-87.63642
329,7,9,false,6,2,-4,41.93258,-87.63642
13294,7,9,false,18,6,-12,41.9326,-87.66595
TA1309000036,7,9,false,18,13,-5,41.93313,-87.64776
332,7,9,false,4,2,-2,41.93313,-87.64776
15644,7,9,false,4,3,-1,41.93534,-87.71687
TA1307000006,7,9,false,24,28,4,41.93571,-87.6636
153,7,9,false,2,2,0,41.93575,-87.66364
13268,7,9,false,6,3,-3,41.93588,-87.67843
13269,7,9,false,3,8,5,41.93609,-87.66983
TA1307000052,7,9,false,39,7,-32,41.93628,-87.65266
156,7,9,false,1,2,1,41.9365,-87.64756
TA1307000136,7,9,false,28,13,-15,41.9365,-87.64755
TA1307000041,7,9,false,56,37,-19,41.93669,-87.63683
157,7,9,false,3,7,4,41.9367,-87.63683
13137,7,9,false,59,47,-12,41.9376,-87.6441
300,7,9,false,5,2,-3,41.93761,-87.6441
15642,7,9,false,2,2,0,41.93843,-87.69801
154,7,9,false,3,1,-2,41.93912,-87.66384
KA17018068,7,9,false,5,4,-1,41.93935,-87.68327
TA1309000042,7,9,false,27,16,-11,41.93937,-87.66836
131,7,9,false,2,2,0,41.93937,-87.66835
KA150400009X,7,9,false,2,3,1,41.9394,-87.71159
15640,7,9,false,7,1,-6,41.93941,-87.72357
13229,7,9,false,17,6,-11,41.93946,-87.66376
226,7,9,false,5,5,0,41.93972,-87.65886
TA1308000019,7,9,false,36,11,-25,41.93973,-87.65886
13277,7,9,false,37,24,-13,41.9401,-87.64546
296,7,9,false,5,3,-2,41.9401,-87.64546
TA1307000134,7,9,false,29,34,5,41.94016,-87.65303
117,7,9,false,4,5,1,41.94016,-87.65302
13143,7,9,false,15,8,-7,41.94059,-87.67853
334,7,9,false,13,12,-1,41.94076,-87.63919
TA1309000049,7,9,false,93,48,-45,41.94077,-87.63919
15634,7,9,false,6,4,-2,41.94304,-87.68729
TA1307000138,7,9,false,13,10,-3,41.94334,-87.67094
13144,7,9,false,9,11,2,41.9434,-87.67964
TA1309000025,7,9,false,25,21,-4,41.94368,-87.64894
299,7,9,false,5,3,-2,41.94368,-87.64894
229,7,9,false,12,2,-10,41.94372,-87.66401
13071,7,9,false,28,31,3,41.94373,-87.66401
632,7,9,false,35,30,-5,41.94453,-87.6547
303,7,9,false,7,5,-2,41.94522,-87.64702
15631,7,9,false,4,3,-1,41.94524,-87.70665
13278,7,9,false,30,28,-2,41.94553,-87.64644
TA1309000050,7,9,false,5,1,-4,41.94618,-87.67331
15632,7,9,false,1,10,9,41.94664,-87.69463
KA1504000143,7,9,false,3,2,-1,41.94664,-87.68337
227,7,9,false,4,1,-3,41.94813,-87.66397
13235,7,9,false,26,19,-7,41.94814,-87.66396
304,7,9,false,4,2,-2,41.94878,-87.64922
13253,7,9,false,5,8,3,41.9488,-87.67527
591,7,9,false,1,1,0,41.94882,-87.74001
13325,7,9,false,30,26,-4,41.94907,-87.64863
114,7,9,false,3,4,1,41.94935,-87.65451
TA1307000126,7,9,false,35,42,7,41.94936,-87.65451
232,7,9,false,12,5,-7,41.94943,-87.64645
TA1307000150,7,9,false,47,32,-15,41.94945,-87.64646
18016,7,9,false,5,2,-3,41.94993,-87.71395
13319,7,9,false,14,14,0,41.95069,-87.6687
TA1307000127,7,9,false,33,28,-5,41.9508,-87.65918
165,7,9,false,1,2,1,41.95081,-87.65918
13323,7,9,false,35,15,-20,41.95282,-87.65
256,7,9,false,3,5,2,41.95282,-87.65
15624,7,9,false,2,4,2,41.95339,-87.73199
KA1504000096,7,9,false,3,1,-2,41.95361,-87.70932
KA1504000139,7,9,false,1,3,2,41.954,-87.71909
TA1309000043,7,9,false,14,11,-3,41.95417,-87.66434
13063,7,9,false,33,10,-23,41.95424,-87.65441
KA1504000158,7,9,false,3,4,1,41.95432,-87.68607
254,7,9,false,1,7,6,41.95438,-87.64806
TA1308000022,7,9,false,53,27,-26,41.95438,-87.64805
16991,7,9,false,2,1,-1,41.95448,-87.7496
TA1307000149,7,9,false,7,3,-4,41.95467,-87.67392
TA1309000026,7,9,false,13,7,-6,41.95601,-87.6802
13249,7,9,false,7,2,-5,41.95606,-87.66885
312,7,9,false,8,2,-6,41.95637,-87.6563
TA1308000047,7,9,false,9,4,-5,41.95709,-87.6642
13379,7,9,false,31,11,-20,41.95786,-87.6495
316,7,9,false,1,1,0,41.95841,-87.69401
306,7,9,false,2,1,-1,41.9585,-87.655
TA1309000027,7,9,false,14,5,-9,41.9585,-87.65499
13389,7,9,false,18,22,4,41.961,-87.64958
245,7,9,false,6,3,-3,41.96101,-87.64958
15622,7,9,false,3,5,2,41.96108,-87.69544
KA1504000097,7,9,false,2,1,-1,41.96116,-87.71658
TA1307000144,7,9,false,4,7,3,41.96142,-87.6762
297,7,9,false,1,1,0,41.9615,-87.67141
15623,7,9,false,4,2,-2,41.96154,-87.69117
KA1503000022,7,9,false,11,6,-5,41.96158,-87.66609
TA1307000107,7,9,false,36,21,-15,41.96164,-87.65464
TA1307000156,7,9,false,9,2,-7,41.96301,-87.68479
TA1309000012,7,9,false,13,6,-7,41.96325,-87.67928
TA1308000012,7,9,false,44,73,29,41.96398,-87.63818
293,7,9,false,7,1,-6,41.96521,-87.65822
13074,7,9,false,12,9,-3,41.96521,-87.6582
639,7,9,false,22,34,12,41.96584,-87.64538
KA1504000093,7,9,false,6,2,-4,41.96587,-87.69365
TA1307000140,7,9,false,8,7,-1,41.96643,-87.68865
326,7,9,false,7,4,-3,41.96665,-87.67113
KA1504000126,7,9,false,6,3,-3,41.96668,-87.70807
TA1309000014,7,9,false,17,6,-11,41.96709,-87.66744
TA1307000158,7,9,false,6,1,-5,41.9671,-87.67904
TA1307000119,7,9,false,12,6,-6,41.96796,-87.65
251,7,9,false,4,1,-3,41.96796,-87.65
15615,7,9,false,2,1,-1,41.96835,-87.71183
TA1308000021,7,9,false,22,20,-2,41.96883,-87.65765
KA1504000080,7,9,false,7,3,-4,41.96887,-87.69609
TA1309000015,7,9,false,4,2,-2,41.96889,-87.68401
344,7,9,false,1,3,2,41.9691,-87.67423
TA1309000066,7,9,false,7,18,11,41.9691,-87.67423
TA1309000041,7,9,false,10,4,-6,41.96951,-87.65471
KA1504000171,7,9,false,37,10,-27,41.97161,-87.65016
465,7,9,false,2,2,0,41.97161,-87.65016
325,7,9,false,1,2,1,41.9728,-87.67186
TA1309000035,7,9,false,7,11,4,41.97335,-87.66785
295,7,9,false,2,1,-1,41.97378,-87.65972
13108,7,9,false,20,11,-9,41.97379,-87.65971
KA1504000078,7,9,false,3,3,0,41.97491,-87.69258
KA1504000149,7,9,false,6,6,0,41.97562,-87.67945
470,7,9,false,3,1,-2,41.97567,-87.70927
KA1504000128,7,9,false,2,3,1,41.97567,-87.70927
463,7,9,false,2,3,1,41.978,-87.66805
KA1504000146,7,9,false,12,15,3,41.978,-87.66805
13109,7,9,false,16,9,-7,41.97835,-87.65976
KA1504000147,7,9,false,3,4,1,41.97976,-87.67754
655,7,9,false,4,1,-3,41.97987,-87.68194
KA1504000161,7,9,false,2,2,0,41.98038,-87.71612
KA1504000167,7,9,false,1,1,0,41.98206,-87.70895
494,7,9,false,1,1,0,41.98234,-87.70892
KA1504000151,7,9,false,12,15,3,41.98359,-87.66916
15585,7,9,false,1,1,0,41.98367,-87.69642
KA1504000152,7,9,false,46,32,-14,41.98403,-87.65231
459,7,9,false,5,3,-2,41.98403,-87.65231
15578,7,9,false,19,11,-8,41.98405,-87.66027
15575,7,9,false,7,11,4,41.98975,-87.66014
KA1504000130,7,9,false,3,1,-2,41.99024,-87.69338
KA1504000148,7,9,false,7,6,-1,41.99086,-87.66971
KA1504000155,7,9,false,1,2,1,41.99118,-87.68359
KA1504000129,7,9,false,2,2,0,41.99417,-87.68945
15571,7,9,false,20,13,-7,41.99478,-87.66028
454,7,9,false,2,1,-1,41.99478,-87.66027
KA1504000156,7,9,false,5,1,-4,41.99925,-87.67137
RP-009,7,9,false,8,1,-7,42.00107,-87.66122
RP-001,7,9,false,2,3,1,42.00179,-87.68883
RP-008,7,9,false,4,5,1,42.00446,-87.6724
RP-002,7,9,false,3,3,0,42.00456,-87.68065
660,7,9,false,7,1,-6,42.00458,-87.66143
KA1504000175,7,9,false,10,3,-7,42.00797,-87.66549
KA1504000159,7,9,false,15,8,-7,42.01059,-87.66241
525,7,9,false,13,4,-9,42.01272,-87.66605
517,7,9,false,1,1,0,42.01597,-87.675
520,7,9,false,9,5,-4,42.01597,-87.66859
527,7,9,false,4,1,-3,42.01892,-87.69004
515,7,9,false,2,3,1,42.01915,-87.67356
16806,7,9,false,3,1,-2,42.01953,-87.66955
523,7,9,false,5,2,-3,42.02089,-87.66505
598,7,9,false,2,2,0,42.02578,-87.68411
E002,7,9,false,10,9,-1,42.03256,-87.67912
E011,7,9,false,1,1,0,42.03473,-87.69912
599,7,9,false,5,2,-3,42.03972,-87.69942
596,7,9,false,18,11,-7,42.04822,-87.68348
E008,7,9,false,14,8,-6,42.05049,-87.67782
605,7,9,false,2,4,2,42.05294,-87.67342
661,7,9,false,4,2,-2,42.05704,-87.68657
604,7,9,false,5,8,3,42.05824,-87.67744
E006,7,9,false,1,4,3,42.06367,-87.69871
E014,7,9,false,1,3,2,42.06483,-87.71531
20232,7,9,true,1,1,0,41.68588,-87.57378
KA1503000019,7,9,true,2,1,-1,41.75867,-87.5869
KA1503000020,7,9,true,1,2,1,41.76223,-87.55923
KA1503000002,7,9,true,3,4,1,41.76641,-87.5657
391,7,9,true,1,1,0,41.76907,-87.64462
KA1503000029,7,9,true,9,5,-4,41.77364,-87.56747
KA1503000053,7,9,true,1,1,0,41.78009,-87.61595
KA1503000046,7,9,true,2,5,3,41.78041,-87.59141
653,7,9,true,8,8,0,41.78059,-87.58491
KA1503000054,7,9,true,3,3,0,41.78061,-87.60582
15491,7,9,true,6,8,2,41.78096,-87.57624
101,7,9,true,1,1,0,41.78105,-87.57611
KA1503000014,7,9,true,53,15,-38,41.7851,-87.60108
426,7,9,true,12,2,-10,41.7851,-87.60108
KA1503000070,7,9,true,23,24,1,41.78794,-87.58831
425,7,9,true,3,2,-1,41.78795,-87.58831
TA1309000011,7,9,true,11,8,-3,41.78873,-87.60131
423,7,9,true,3,7,4,41.79148,-87.59988
KA1503000071,7,9,true,12,30,18,41.79148,-87.59988
424,7,9,true,2,2,0,41.79174,-87.58395
KA1503000074,7,9,true,13,17,4,41.79174,-87.58395
TA1309000063,7,9,true,13,15,2,41.79325,-87.5878
345,7,9,true,3,3,0,41.79326,-87.5878
KA1503000073,7,9,true,1,1,0,41.79345,-87.61585
420,7,9,true,7,14,7,41.79429,-87.60145
KA1504000076,7,9,true,21,61,40,41.7943,-87.60145
TA1307000160,7,9,true,2,1,-1,41.79485,-87.61873
247,7,9,true,3,3,0,41.79522,-87.58077
TA1308000009,7,9,true,52,24,-28,41.79522,-87.58075
TA1307000164,7,9,true,17,23,6,41.79527,-87.59647
248,7,9,true,7,7,0,41.79528,-87.59647
646,7,9,true,1,1,0,41.79663,-87.62592
KA1503000052,7,9,true,17,9,-8,41.79935,-87.60097
418,7,9,true,6,5,-1,41.79936,-87.60097
KA1503000059,7,9,true,15,10,-5,41.79952,-87.58643
TA1309000037,7,9,true,30,14,-16,41.79957,-87.59474
KA1503000007,7,9,true,19,10,-9,41.80242,-87.58689
121,7,9,true,3,3,0,41.80256,-87.59035
13398,7,9,true,12,14,2,41.80256,-87.59035
TA1309000067,7,9,true,1,2,1,41.80303,-87.60661
322,7,9,true,4,3,-1,41.80321,-87.59849
KA1503000069,7,9,true,10,3,-7,41.80579,-87.59247
TA1308000035,7,9,true,14,9,-5,41.80944,-87.59188
267,7,9,true,4,2,-2,41.80944,-87.59188
TA1308000002,7,9,true,4,9,5,41.80983,-87.59937
TA1308000007,7,9,true,1,1,0,41.80984,-87.61628
TA1309000053,7,9,true,2,1,-1,41.80985,-87.60675
549,7,9,true,2,3,1,41.81401,-87.66662
KA1503000027,7,9,true,3,1,-2,41.81666,-87.61942
265,7,9,true,1,2,1,41.82297,-87.6071
TA1308000038,7,9,true,4,5,1,41.82298,-87.6071
13420,7,9,true,1,2,1,41.82459,-87.61678
TA1308000045,7,9,true,11,15,4,41.83062,-87.64129
TA1308000043,7,9,true,3,3,0,41.83066,-87.64715
15446,7,9,true,1,3,2,41.83068,-87.65603
KA1503000005,7,9,true,2,3,1,41.83079,-87.6325
TA1307000129,7,9,true,5,2,-3,41.83104,-87.62683
KA1503000004,7,9,true,8,8,0,41.83127,-87.6088
13345,7,9,true,14,5,-9,41.83138,-87.61803
15445,7,9,true,2,3,1,41.83453,-87.63183
13216,7,9,true,26,20,-6,41.83473,-87.62581
148,7,9,true,3,7,4,41.83474,-87.62581
13217,7,9,true,17,13,-4,41.83488,-87.61792
13215,7,9,true,15,7,-8,41.83634,-87.6135
TA1308000046,7,9,true,11,9,-2,41.83779,-87.65115
339,7,9,true,4,5,1,41.83817,-87.64523
TA1309000055,7,9,true,22,11,-11,41.8382,-87.64514
KA1503000038,7,9,true,17,3,-14,41.83845,-87.6354
150,7,9,true,6,7,1,41.83855,-87.60821
TA1307000048,7,9,true,24,25,1,41.83855,-87.60821
TA1308000036,7,9,true,8,6,-2,41.83883,-87.62186
15442,7,9,true,2,1,-1,41.83918,-87.66562
KA1503000040,7,9,true,2,5,3,41.84164,-87.65744
237,7,9,true,4,6,2,41.84204,-87.61697
TA1307000139,7,9,true,45,31,-14,41.84205,-87.61698
15443,7,9,true,9,5,-4,41.84275,-87.63549
207,7,9,true,2,1,-1,41.84358,-87.64539
TA1307000153,7,9,true,12,5,-7,41.84358,-87.64538
147,7,9,true,2,1,-1,41.84569,-87.62251
TA1307000005,7,9,true,6,8,2,41.84569,-87.6225
TA1308000013,7,9,true,1,7,6,41.84719,-87.64681
TA1309000003,7,9,true,5,6,1,41.84847,-87.68512
15689,7,9,true,4,4,0,41.84912,-87.69515
TA1308000014,7,9,true,12,3,-9,41.84953,-87.64059
TA1308000026,7,9,true,2,2,0,41.85008,-87.63214
42,7,9,true,2,2,0,41.85261,-87.62653
TA1305000001,7,9,true,5,5,0,41.85262,-87.6265
13075,7,9,true,4,16,12,41.8531,-87.63192
13162,7,9,true,4,10,6,41.85378,-87.64659
13096,7,9,true,1,1,0,41.8538,-87.69577
13091,7,9,true,16,5,-11,41.85409,-87.68585
203,7,9,true,8,2,-6,41.85409,-87.68585
370,7,9,true,1,1,0,41.85415,-87.61917
15546,7,9,true,5,6,1,41.85416,-87.61916
13307,7,9,true,10,5,-5,41.85489,-87.66359
13089,7,9,true,13,3,-10,41.85497,-87.67567
13331,7,9,true,3,1,-2,41.85515,-87.65414
4,7,9,true,8,8,0,41.85627,-87.61334
15545,7,9,true,68,74,6,41.85627,-87.61334
SL-013,7,9,true,3,11,8,41.85659,-87.62755
SL-006,7,9,true,2,4,2,41.8568,-87.63387
129,7,9,true,6,2,-4,41.85752,-87.66158
13135,7,9,true,15,7,-8,41.85753,-87.66157
338,7,9,true,1,1,0,41.85758,-87.61956
13102,7,9,true,43,30,-13,41.85762,-87.61942
273,7,9,true,5,12,7,41.85783,-87.62455
13150,7,9,true,26,39,13,41.85783,-87.62455
13099,7,9,true,2,3,1,41.85784,-87.64627
TA1307000159,7,9,true,25,7,-18,41.8579,-87.6687
205,7,9,true,2,2,0,41.8579,-87.6687
TA1307000044,7,9,true,13,9,-4,41.85794,-87.64083
14,7,9,true,4,1,-3,41.85808,-87.65109
13163,7,9,true,11,6,-5,41.85808,-87.65108
13164,7,9,true,25,2,-23,41.85818,-87.65648
15,7,9,true,4,3,-1,41.85819,-87.65648
SL-012,7,9,true,27,25,-2,41.86038,-87.62581
72,7,9,true,7,3,-4,41.86039,-87.62581
13304,7,9,true,2,9,7,41.86126,-87.65659
437,7,9,true,2,2,0,41.86192,-87.69348
KA1504000109,7,9,true,2,1,-1,41.86192,-87.69347
TA1306000002,7,9,true,14,12,-2,41.86238,-87.65108
137,7,9,true,7,7,0,41.86238,-87.65108
TA1307000124,7,9,true,41,38,-3,41.86411,-87.62372
168,7,9,true,7,1,-6,41.86415,-87.62372
282,7,9,true,5,2,-3,41.86487,-87.64708
TA1309000001,7,9,true,7,7,0,41.86488,-87.64708
13029,7,9,true,14,18,4,41.86531,-87.6179
341,7,9,true,4,1,-3,41.86608,-87.60733
13431,7,9,true,31,33,2,41.8661,-87.60728
KA1504000101,7,9,true,3,6,3,41.86651,-87.68466
WL-008,7,9,true,17,17,0,41.86712,-87.64108
57,7,9,true,1,2,1,41.86712,-87.64107
TA1305000002,7,9,true,68,72,4,41.86721,-87.62597
59,7,9,true,12,17,5,41.86721,-87.62597
3,7,9,true,5,3,-2,41.86723,-87.61536
15544,7,9,true,30,33,3,41.86723,-87.61536
TA1305000017,7,9,true,6,11,5,41.86734,-87.64863
KA1706005007,7,9,true,13,10,-3,41.86749,-87.63219
626,7,9,true,6,9,3,41.86749,-87.63219
SL-005,7,9,true,73,54,-19,41.8679,-87.62304
255,7,9,true,9,5,-4,41.86791,-87.62304
644,7,9,true,18,13,-5,41.86859,-87.68625
19,7,9,true,1,3,2,41.86892,-87.65913
13139,7,9,true,27,8,-19,41.86893,-87.65913
13285,7,9,true,2,14,12,41.86928,-87.67372
13160,7,9,true,24,7,-17,41.86947,-87.65548
22,7,9,true,8,3,-5,41.86947,-87.65548
414,7,9,true,2,4,2,41.87023,-87.63947
15550,7,9,true,7,14,7,41.87024,-87.63947
TA1309000010,7,9,true,56,36,-20,41.87074,-87.62574
SL-009,7,9,true,15,6,-9,41.87081,-87.63121
TA1309000064,7,9,true,6,21,15,41.87127,-87.67369
15542,7,9,true,1,3,2,41.87146,-87.64095
261,7,9,true,4,3,-1,41.87151,-87.6699
TA1307000130,7,9,true,31,17,-14,41.87178,-87.65103
241,7,9,true,7,5,-2,41.8718,-87.65102
108,7,9,true,2,11,9,41.87183,-87.64664
TA1307000121,7,9,true,2,41,39,41.87184,-87.64664
41,7,9,true,8,10,2,41.87209,-87.62957
SL-008,7,9,true,56,35,-21,41.87209,-87.62956
13332,7,9,true,37,16,-21,41.87219,-87.6615
394,7,9,true,2,6,4,41.87226,-87.63484
175,7,9,true,9,3,-6,41.87255,-87.63359
SL-011,7,9,true,41,19,-22,41.87256,-87.63356
623,7,9,true,24,35,11,41.87272,-87.62399
KA1504000104,7,9,true,11,18,7,41.87296,-87.66912
320,7,9,true,6,5,-1,41.87327,-87.66402
5,7,9,true,3,1,-2,41.87403,-87.6277
SL-007,7,9,true,18,7,-11,41.87404,-87.6277
321,7,9,true,6,6,0,41.87427,-87.63257
TA1306000025,7,9,true,18,11,-7,41.87464,-87.65703
32,7,9,true,2,1,-1,41.87464,-87.65703
15668,7,9,true,9,2,-7,41.87471,-87.68642
13028,7,9,true,20,10,-10,41.87475,-87.64981
109,7,9,true,7,2,-5,41.87475,-87.64981
13081,7,9,true,4,2,-2,41.87501,-87.67326
122,7,9,true,1,1,0,41.87501,-87.67325
SL-010,7,9,true,15,17,2,41.87501,-87.63309
15541,7,9,true,13,34,21,41.8758,-87.62086
13037,7,9,true,7,1,-6,41.87588,-87.64078
50,7,9,true,2,1,-1,41.87592,-87.6307
TA1305000009,7,9,true,8,6,-2,41.87593,-87.63068
317,7,9,true,5,6,1,41.87603,-87.68195
45,7,9,true,2,2,0,41.87623,-87.62444
TA1305000010,7,9,true,7,20,13,41.87623,-87.62444
624,7,9,true,13,9,-4,41.87626,-87.62923
2,7,9,true,4,4,0,41.87649,-87.62051
TA1305000035,7,9,true,1,3,2,41.87716,-87.62787
13138,7,9,true,5,3,-2,41.87723,-87.63941
15539,7,9,true,21,30,9,41.87763,-87.64405
13158,7,9,true,28,20,-8,41.87764,-87.64957
134,7,9,true,8,3,-5,41.87764,-87.64954
13157,7,9,true,20,17,-3,41.87773,-87.6548
21,7,9,true,6,3,-3,41.87773,-87.6548
TA1305000025,7,9,true,21,7,-14,41.87773,-87.63528
36,7,9,true,11,3,-8,41.87776,-87.63525
284,7,9,true,2,1,-1,41.87784,-87.62408
TA1309000002,7,9,true,10,11,1,41.87784,-87.62408
13206,7,9,true,11,11,0,41.87794,-87.66201
146,7,9,true,2,3,1,41.87794,-87.66201
TA1309000004,7,9,true,3,2,-1,41.87811,-87.63184
107,7,9,true,4,8,4,41.87822,-87.644
638,7,9,true,15,11,-4,41.87827,-87.64078
37,7,9,true,3,2,-1,41.87921,-87.62975
TA1305000005,7,9,true,2,7,5,41.87924,-87.62975
286,7,9,true,1,2,1,41.8793,-87.6355
13011,7,9,true,15,16,1,41.87931,-87.63993
TA1309000008,7,9,true,11,5,-6,41.87933,-87.6355
192,7,9,true,6,5,-1,41.87935,-87.63997
KA1503000034,7,9,true,1,4,3,41.87938,-87.63197
40,7,9,true,1,1,0,41.87944,-87.63197
39,7,9,true,3,3,0,41.87948,-87.62571
KA1503000015,7,9,true,15,21,6,41.87948,-87.6257
15667,7,9,true,4,1,-3,41.8798,-87.68609
TA1309000007,7,9,true,6,7,1,41.88022,-87.63526
WL-011,7,9,true,19,20,1,41.88034,-87.64273
73,7,9,true,5,5,0,41.8804,-87.64273
80,7,9,true,3,4,1,41.88042,-87.65556
13156,7,9,true,19,72,53,41.88042,-87.65554
13300,7,9,true,78,80,2,41.88097,-87.61675
76,7,9,true,12,12,0,41.88098,-87.61675
13008,7,9,true,28,44,16,41.88105,-87.62408
90,7,9,true,3,6,3,41.88107,-87.62409
49,7,9,true,2,2,0,41.88116,-87.62963
TA1305000006,7,9,true,18,21,3,41.88122,-87.6296
13134,7,9,true,6,5,-1,41.88138,-87.67493
215,7,9,true,1,1,0,41.88139,-87.67492
13056,7,9,true,5,4,-1,41.88168,-87.63951
198,7,9,true,10,10,0,41.88187,-87.6488
TA1307000120,7,9,true,45,63,18,41.88188,-87.64879
13341,7,9,true,7,20,13,41.88208,-87.63985
197,7,9,true,2,1,-1,41.88208,-87.62513
13036,7,9,true,11,12,1,41.8821,-87.62513
77,7,9,true,10,6,-4,41.88214,-87.64108
TA1305000032,7,9,true,54,50,-4,41.88218,-87.64109
98,7,9,true,3,2,-1,41.88266,-87.63251
13006,7,9,true,7,19,12,41.88268,-87.63252
13353,7,9,true,18,17,-1,41.88283,-87.6612
346,7,9,true,3,3,0,41.88284,-87.6612
654,7,9,true,17,13,-4,41.88307,-87.65698
233,7,9,true,3,3,0,41.88309,-87.6511
13409,7,9,true,10,10,0,41.8831,-87.6511
18,7,9,true,1,1,0,41.88317,-87.63735
KA1503000072,7,9,true,13,5,-8,41.88317,-87.63693
91,7,9,true,4,6,2,41.88336,-87.64122
WL-012,7,9,true,12,12,0,41.88337,-87.6412
112,7,9,true,6,5,-1,41.88362,-87.6486
13053,7,9,true,26,50,24,41.88365,-87.64863
43,7,9,true,4,3,-1,41.88396,-87.62455
13001,7,9,true,19,29,10,41.88397,-87.62459
13155,7,9,true,4,13,9,41.88407,-87.65689
18062,7,9,true,21,18,-3,41.88412,-87.65427
81,7,9,true,5,8,3,41.88417,-87.6296
TA1306000010,7,9,true,9,24,15,41.88419,-87.62961
15666,7,9,true,3,1,-2,41.88446,-87.6963
TA1305000030,7,9,true,13,12,-1,41.88459,-87.63178
15535,7,9,true,52,25,-27,41.8846,-87.64455
96,7,9,true,4,1,-3,41.8846,-87.64455
51,7,9,true,1,4,3,41.88462,-87.63176
TA1305000029,7,9,true,17,19,2,41.88466,-87.62787
195,7,9,true,13,8,-5,41.88466,-87.61952
13263,7,9,true,64,32,-32,41.88467,-87.61952
44,7,9,true,6,5,-1,41.88468,-87.62782
TA1306000015,7,9,true,23,40,17,41.88549,-87.65232
518,7,9,true,3,4,1,41.8855,-87.71686
71,7,9,true,1,4,3,41.8855,-87.65233
66,7,9,true,8,3,-5,41.88557,-87.64186
13021,7,9,true,23,22,-1,41.88559,-87.64184
TA1307000111,7,9,true,20,26,6,41.88582,-87.63548
164,7,9,true,3,5,2,41.88583,-87.63547
13073,7,9,true,6,6,0,41.88592,-87.66717
KA17018054,7,9,true,1,8,7,41.88595,-87.67701
38,7,9,true,11,4,-7,41.88599,-87.63089
KA1503000012,7,9,true,23,23,0,41.88599,-87.63089
52,7,9,true,11,3,-8,41.886,-87.62421
TA1305000011,7,9,true,28,34,6,41.886,-87.62418
7,7,9,true,7,4,-3,41.88627,-87.61751
15534,7,9,true,34,19,-15,41.88627,-87.61749
217,7,9,true,1,1,0,41.8866,-87.65821
13197,7,9,true,3,7,4,41.8866,-87.65816
264,7,9,true,2,3,1,41.8867,-87.62224
TA1308000029,7,9,true,26,14,-12,41.88673,-87.62225
194,7,9,true,1,2,1,41.88688,-87.62606
TA1307000131,7,9,true,12,13,1,41.88688,-87.62606
6,7,9,true,7,9,2,41.88697,-87.61281
KA1503000064,7,9,true,49,72,23,41.88697,-87.61281
100,7,9,true,4,3,-1,41.88814,-87.63657
TA1305000022,7,9,true,29,24,-5,41.88817,-87.63656
56,7,9,true,17,13,-4,41.88866,-87.64442
TA1306000003,7,9,true,44,50,6,41.88867,-87.64442
133,7,9,true,19,11,-8,41.88918,-87.63851
KA1503000043,7,9,true,65,89,24,41.88918,-87.63851
13050,7,9,true,20,39,19,41.88919,-87.62775
47,7,9,true,1,9,8,41.88921,-87.62775
15664,7,9,true,1,1,0,41.8895,-87.68821
13432,7,9,true,11,2,-9,41.88989,-87.67149
TA1307000151,7,9,true,54,62,8,41.88993,-87.63427
212,7,9,true,7,10,3,41.88995,-87.63427
636,7,9,true,31,27,-4,41.88997,-87.63662
KA1503000044,7,9,true,14,12,-2,41.89018,-87.6262
KA1504000113,7,9,true,1,1,0,41.89049,-87.70262
196,7,9,true,3,6,3,41.89053,-87.62205
13427,7,9,true,25,20,-5,41.89054,-87.62205
26,7,9,true,6,10,4,41.89057,-87.61798
13430,7,9,true,28,29,1,41.89077,-87.63169
181,7,9,true,4,4,0,41.89077,-87.63168
TA1306000013,7,9,true,57,46,-11,41.89083,-87.61852
RN-,7,9,true,39,28,-11,41.89102,-87.63546
672,7,9,true,9,8,-1,41.89102,-87.63545
277,7,9,true,2,1,-1,41.89108,-87.66665
13434,7,9,true,20,11,-9,41.89108,-87.66663
TA1308000006,7,9,true,12,4,-8,41.89128,-87.67686
199,7,9,true,4,8,4,41.89143,-87.62676
TA1307000117,7,9,true,41,33,-8,41.89144,-87.62675
13033,7,9,true,40,28,-12,41.8916,-87.64835
214,7,9,true,3,2,-1,41.89161,-87.67688
84,7,9,true,17,4,-13,41.89161,-87.64833
186,7,9,true,7,5,-2,41.8918,-87.65879
13194,7,9,true,40,10,-30,41.8918,-87.65878
TA1305000003,7,9,true,66,39,-27,41.89187,-87.62061
24,7,9,true,7,12,5,41.8919,-87.62063
643,7,9,true,9,12,3,41.89203,-87.68939
35,7,9,true,7,7,0,41.89227,-87.61206
13022,7,9,true,76,73,-3,41.89227,-87.61205
99,7,9,true,11,4,-7,41.89255,-87.61449
TA1306000029,7,9,true,59,32,-27,41.89256,-87.61449
13265,7,9,true,66,28,-38,41.89383,-87.64172
74,7,9,true,10,4,-6,41.89384,-87.64173
13045,7,9,true,96,91,-5,41.89403,-87.62931
110,7,9,true,13,8,-5,41.89406,-87.6293
13016,7,9,true,34,32,-2,41.89431,-87.62277
211,7,9,true,2,6,4,41.89439,-87.62267
KA1503000041,7,9,true,48,17,-31,41.89452,-87.61798
142,7,9,true,12,7,-5,41.89453,-87.61806
92,7,9,true,10,6,-4,41.89455,-87.65346
13196,7,9,true,30,8,-22,41.89455,-87.65345
TA1307000062,7,9,true,25,20,-5,41.89466,-87.63839
111,7,9,true,1,1,0,41.89466,-87.63837
TA1306000012,7,9,true,69,61,-8,41.89475,-87.63438
53,7,9,true,24,9,-15,41.89476,-87.63439
627,7,9,true,8,4,-4,41.8948,-87.63231
KP1705001026,7,9,true,33,32,-1,41.89483,-87.6323
659,7,9,true,2,5,3,41.8955,-87.68201
18058,7,9,true,7,16,9,41.8955,-87.68201
637,7,9,true,21,7,-14,41.89563,-87.67209
128,7,9,true,4,1,-3,41.89571,-87.67716
13132,7,9,true,30,33,3,41.89573,-87.67718
161,7,9,true,14,8,-6,41.89574,-87.62599
15530,7,9,true,25,34,9,41.89575,-87.62596
18003,7,9,true,14,14,0,41.89575,-87.62011
635,7,9,true,1,5,4,41.89576,-87.62012
13247,7,9,true,28,22,-6,41.89597,-87.66775
350,7,9,true,4,4,0,41.89597,-87.66774
TA1305000020,7,9,true,24,18,-6,41.89636,-87.65406
13289,7,9,true,31,22,-9,41.89638,-87.661
86,7,9,true,2,9,7,41.89639,-87.661
337,7,9,true,3,3,0,41.89659,-87.63096
13303,7,9,true,32,35,3,41.89672,-87.63088
13017,7,9,true,26,35,9,41.89676,-87.6357
31,7,9,true,6,7,1,41.89677,-87.63572
13338,7,9,true,34,36,2,41.89697,-87.62173
173,7,9,true,3,4,1,41.89704,-87.62173
TA1307000061,7,9,true,27,25,-2,41.89745,-87.62873
106,7,9,true,6,10,4,41.89746,-87.62874
25,7,9,true,2,3,1,41.89751,-87.62354
13034,7,9,true,25,17,-8,41.89754,-87.62352
48,7,9,true,6,10,4,41.89772,-87.64302
TA1306000009,7,9,true,28,40,12,41.89772,-87.64299
620,7,9,true,32,25,-7,41.89817,-87.63754
KA1504000103,7,9,true,27,5,-22,41.89842,-87.68659
374,7,9,true,5,5,0,41.89842,-87.68659
145,7,9,true,14,9,-5,41.89856,-87.62211
15529,7,9,true,52,29,-23,41.89858,-87.62206
140,7,9,true,19,14,-5,41.89895,-87.6299
TA1307000128,7,9,true,70,56,-14,41.89896,-87.6299
657,7,9,true,25,13,-12,41.89918,-87.6722
KA1504000117,7,9,true,6,5,-1,41.89936,-87.64848
30,7,9,true,8,2,-6,41.89964,-87.66789
13248,7,9,true,21,18,-3,41.89964,-87.66788
46,7,9,true,1,2,1,41.89994,-87.63444
TA1306000011,7,9,true,15,17,2,41.89994,-87.63443
KA1504000116,7,9,true,30,25,-5,41.90023,-87.64299
17660,7,9,true,16,10,-6,41.90036,-87.69671
622,7,9,true,4,2,-2,41.90037,-87.69671
13290,7,9,true,32,9,-23,41.90069,-87.66259
29,7,9,true,7,3,-4,41.90069,-87.66259
13042,7,9,true,63,72,9,41.90097,-87.62377
85,7,9,true,5,10,5,41.90098,-87.62375
183,7,9,true,12,3,-9,41.90133,-87.67744
TA1307000070,7,9,true,19,8,-11,41.90133,-87.67742
KA1504000133,7,9,true,52,49,-3,41.90234,-87.62773
172,7,9,true,4,12,8,41.90236,-87.62774
305,7,9,true,4,2,-2,41.9028,-87.69005
13241,7,9,true,18,12,-6,41.9029,-87.68731
176,7,9,true,25,28,3,41.90291,-87.63141
TA1306000006,7,9,true,20,11,-9,41.90292,-87.63772
23,7,9,true,1,2,1,41.90292,-87.63772
TA1307000039,7,9,true,107,101,-6,41.90294,-87.63137
658,7,9,true,15,4,-11,41.903,-87.6838
216,7,9,true,5,4,-1,41.90302,-87.69749
13256,7,9,true,3,5,2,41.90302,-87.69749
TA1305000034,7,9,true,32,23,-9,41.90313,-87.67391
17,7,9,true,6,7,1,41.90313,-87.67391
182,7,9,true,11,17,6,41.90317,-87.63442
KA1504000135,7,9,true,76,84,8,41.90319,-87.63439
13136,7,9,true,22,37,15,41.90326,-87.67845
130,7,9,true,3,6,3,41.90327,-87.67846
210,7,9,true,11,14,3,41.90342,-87.66781
13061,7,9,true,54,33,-21,41.90342,-87.66779
KA1504000079,7,9,true,41,48,7,41.9035,-87.64334
359,7,9,true,5,11,6,41.90458,-87.6497
138,7,9,true,7,1,-6,41.9046,-87.64057
TA1307000115,7,9,true,22,14,-8,41.9046,-87.64056
291,7,9,true,9,12,3,41.90672,-87.63494
TA1308000049,7,9,true,42,39,-3,41.90672,-87.6349
KA1504000134,7,9,true,36,19,-17,41.90687,-87.6262
180,7,9,true,16,4,-12,41.90687,-87.62618
13224,7,9,true,29,22,-7,41.90706,-87.66725
333,7,9,true,4,3,-1,41.90706,-87.66725
18069,7,9,true,2,1,-1,41.90722,-87.65563
TA1307000143,7,9,true,16,6,-10,41.90762,-87.63854
236,7,9,true,1,2,1,41.90762,-87.63853
61,7,9,true,10,5,-5,41.90764,-87.67254
13221,7,9,true,33,33,0,41.90765,-87.67254
13245,7,9,true,2,2,0,41.90777,-87.68586
301,7,9,true,26,9,-17,41.90796,-87.63203
TA1309000024,7,9,true,67,53,-14,41.908,-87.63152
69,7,9,true,8,9,1,41.90939,-87.6777
TA1305000041,7,9,true,45,60,15,41.9094,-87.67769
331,7,9,true,40,79,39,41.90965,-87.64812
15653,7,9,true,9,5,-4,41.90979,-87.7053
509,7,9,true,2,2,0,41.9098,-87.70531
TA1305000037,7,9,true,23,18,-5,41.91018,-87.67003
27,7,9,true,1,1,0,41.91019,-87.6435
TA1306000008,7,9,true,13,15,2,41.9102,-87.6435
16,7,9,true,5,2,-3,41.91035,-87.67008
213,7,9,true,2,2,0,41.91037,-87.68237
TA1308000005,7,9,true,14,13,-1,41.91042,-87.68238
13258,7,9,true,12,7,-5,41.91043,-87.69718
160,7,9,true,8,1,-7,41.91054,-87.68957
13257,7,9,true,30,8,-22,41.91054,-87.68956
13154,7,9,true,19,43,24,41.91054,-87.65312
20,7,9,true,9,10,1,41.91055,-87.65313
60,7,9,true,6,7,1,41.91059,-87.64942
13058,7,9,true,15,19,4,41.91059,-87.64942
TA1307000038,7,9,true,55,23,-32,41.91138,-87.63868
118,7,9,true,15,3,-12,41.91138,-87.63868
268,7,9,true,11,21,10,41.91172,-87.62681
LF-005,7,9,true,80,106,26,41.91172,-87.62681
126,7,9,true,6,13,7,41.91196,-87.63197
13128,7,9,true,22,44,22,41.91197,-87.63197
289,7,9,true,10,20,10,41.91209,-87.63472
TA1308000050,7,9,true,99,113,14,41.91211,-87.6347
13243,7,9,true,48,30,-18,41.91262,-87.6814
158,7,9,true,8,2,-6,41.91262,-87.6814
TA1309000032,7,9,true,2,2,0,41.91293,-87.66417
315,7,9,true,4,5,1,41.91293,-87.66417
TA1306000032,7,9,true,34,27,-7,41.9137,-87.65285
93,7,9,true,2,6,4,41.91371,-87.65285
TA1307000166,7,9,true,37,17,-20,41.91386,-87.64877
224,7,9,true,5,10,5,41.91386,-87.64877
511,7,9,true,1,1,0,41.914,-87.70515
15655,7,9,true,16,8,-8,41.91401,-87.70514
18017,7,9,true,5,2,-3,41.91416,-87.71676
641,7,9,true,1,1,0,41.91416,-87.71676
18067,7,9,true,23,17,-6,41.9146,-87.66796
628,7,9,true,3,2,-1,41.9146,-87.66796
TA1306000007,7,9,true,26,15,-11,41.91469,-87.64333
28,7,9,true,5,3,-2,41.91469,-87.64333
13068,7,9,true,18,16,-2,41.91554,-87.68703
116,7,9,true,4,7,3,41.91555,-87.68703
13179,7,9,true,80,104,24,41.9157,-87.63461
141,7,9,true,9,17,8,41.91571,-87.63461
219,7,9,true,8,5,-3,41.91598,-87.67733
13133,7,9,true,17,17,0,41.91598,-87.67733
58,7,9,true,1,2,1,41.91602,-87.66894
TA1305000039,7,9,true,7,14,7,41.9163,-87.66749
15650,7,9,true,8,9,1,41.91711,-87.71023
15651,7,9,true,10,6,-4,41.91752,-87.70181
507,7,9,true,3,2,-1,41.91752,-87.70181
13266,7,9,true,10,8,-2,41.91774,-87.69142
TA1309000029,7,9,true,14,7,-7,41.9178,-87.68245
TA1309000006,7,9,true,24,15,-9,41.91809,-87.64375
288,7,9,true,1,3,2,41.91809,-87.64375
223,7,9,true,6,12,6,41.91821,-87.65698
TA1307000163,7,9,true,44,22,-22,41.91821,-87.65696
94,7,9,true,15,15,0,41.91831,-87.6363
13146,7,9,true,93,63,-30,41.91831,-87.63629
13059,7,9,true,53,42,-11,41.91845,-87.65222
113,7,9,true,13,8,-5,41.91846,-87.65222
13259,7,9,true,12,5,-7,41.91852,-87.69744
225,7,9,true,4,6,2,41.91995,-87.64884
13192,7,9,true,35,54,19,41.91995,-87.64884
13288,7,9,true,13,17,4,41.92008,-87.67788
13242,7,9,true,10,7,-3,41.92021,-87.69266
307,7,9,true,3,9,6,41.92077,-87.66373
TA1309000030,7,9,true,20,48,28,41.92077,-87.66372
290,7,9,true,2,3,1,41.92152,-87.70734
13292,7,9,true,14,5,-9,41.92152,-87.70733
TA1309000033,7,9,true,42,45,3,41.92158,-87.65381
13193,7,9,true,56,62,6,41.92182,-87.64412
144,7,9,true,13,13,0,41.92182,-87.64411
143,7,9,true,16,5,-11,41.92217,-87.63891
13191,7,9,true,53,74,21,41.92217,-87.63891
327,7,9,true,9,6,-3,41.92225,-87.65783
13084,7,9,true,15,12,-3,41.92268,-87.69715
123,7,9,true,10,3,-7,41.92268,-87.69714
LP-,7,9,true,29,21,-8,41.92396,-87.63584
673,7,9,true,9,2,-7,41.92398,-87.63585
KA1504000140,7,9,true,7,2,-5,41.92409,-87.67646
15648,7,9,true,12,3,-9,41.92464,-87.68931
504,7,9,true,3,1,-2,41.92464,-87.68931
KA1504000090,7,9,true,13,5,-8,41.92483,-87.7145
TA1307000001,7,9,true,42,27,-15,41.92535,-87.66581
188,7,9,true,5,12,7,41.92536,-87.66581
TA1306000026,7,9,true,20,35,15,41.92558,-87.65842
87,7,9,true,3,3,0,41.92559,-87.65843
TA1306000016,7,9,true,30,23,-7,41.9256,-87.65371
67,7,9,true,7,6,-1,41.9256,-87.65371
313,7,9,true,9,10,1,41.9257,-87.64246
TA1309000019,7,9,true,83,55,-28,41.92586,-87.63897
TA1309000058,7,9,true,57,73,16,41.92591,-87.64927
127,7,9,true,3,12,9,41.92592,-87.64927
177,7,9,true,23,21,-2,41.92627,-87.63086
TA1308000001,7,9,true,108,112,4,41.92627,-87.63086
15646,7,9,true,9,6,-3,41.92668,-87.6977
34,7,9,true,1,6,5,41.92675,-87.63444
13124,7,9,true,8,23,15,41.92675,-87.63444
302,7,9,true,7,7,0,41.92859,-87.65421
TA1309000023,7,9,true,36,35,-1,41.9287,-87.65383
TA1307000113,7,9,true,32,15,-17,41.92878,-87.66391
166,7,9,true,1,2,1,41.92883,-87.66853
13296,7,9,true,17,13,-4,41.92883,-87.66852
TA1309000059,7,9,true,33,17,-16,41.92889,-87.65898
343,7,9,true,5,4,-1,41.92889,-87.65898
349,7,9,true,8,11,3,41.92915,-87.6491
TA1309000061,7,9,true,47,47,0,41.92915,-87.64909
TA1308000031,7,9,true,2,11,9,41.92946,-87.68417
340,7,9,true,24,8,-16,41.92956,-87.64313
TA1305000014,7,9,true,68,57,-11,41.92956,-87.64313
260,7,9,true,2,7,5,41.92958,-87.70791
13085,7,9,true,10,43,33,41.92958,-87.70789
499,7,9,true,1,1,0,41.93056,-87.72381
15643,7,9,true,5,3,-2,41.93057,-87.7238
TA1307000142,7,9,true,52,61,9,41.93125,-87.64432
220,7,9,true,8,12,4,41.93125,-87.64431
13276,7,9,true,69,42,-27,41.93132,-87.63874
324,7,9,true,14,10,-4,41.93173,-87.64179
15645,7,9,true,6,1,-5,41.93191,-87.70121
163,7,9,true,4,4,0,41.93191,-87.67784
13271,7,9,true,7,24,17,41.93192,-87.67784
152,7,9,true,14,10,-4,41.93221,-87.65864
TA1307000064,7,9,true,45,41,-4,41.93222,-87.65864
13,7,9,true,15,9,-6,41.93242,-87.65271
TA1306000014,7,9,true,48,48,0,41.93242,-87.65271
TA1309000039,7,9,true,74,56,-18,41.93258,-87.63642
329,7,9,true,7,4,-3,41.93258,-87.63642
13294,7,9,true,14,17,3,41.9326,-87.66595
TA1309000036,7,9,true,55,33,-22,41.93313,-87.64776
332,7,9,true,12,7,-5,41.93313,-87.64776
15644,7,9,true,5,3,-2,41.93534,-87.71687
TA1307000006,7,9,true,37,31,-6,41.93571,-87.6636
153,7,9,true,6,3,-3,41.93575,-87.66364
162,7,9,true,5,9,4,41.93588,-87.67844
13268,7,9,true,13,6,-7,41.93588,-87.67843
250,7,9,true,10,1,-9,41.93609,-87.66984
13269,7,9,true,16,6,-10,41.93609,-87.66983
TA1307000052,7,9,true,37,25,-12,41.93628,-87.65266
115,7,9,true,2,6,4,41.93628,-87.65266
156,7,9,true,8,5,-3,41.9365,-87.64756
TA1307000136,7,9,true,49,38,-11,41.9365,-87.64755
TA1307000041,7,9,true,104,53,-51,41.93669,-87.63683
157,7,9,true,14,9,-5,41.9367,-87.63683
13137,7,9,true,85,74,-11,41.9376,-87.6441
300,7,9,true,18,10,-8,41.93761,-87.6441
15642,7,9,true,5,4,-1,41.93843,-87.69801
498,7,9,true,2,2,0,41.93843,-87.69801
154,7,9,true,4,8,4,41.93912,-87.66384
KA17018068,7,9,true,3,6,3,41.93935,-87.68327
TA1309000042,7,9,true,25,27,2,41.93937,-87.66836
131,7,9,true,3,3,0,41.93937,-87.66835
496,7,9,true,2,1,-1,41.9394,-87.72356
KA150400009X,7,9,true,2,2,0,41.9394,-87.71159
497,7,9,true,1,1,0,41.93941,-87.71159
13229,7,9,true,24,30,6,41.93946,-87.66376
226,7,9,true,9,7,-2,41.93972,-87.65886
TA1308000019,7,9,true,48,48,0,41.93973,-87.65886
296,7,9,true,8,12,4,41.9401,-87.64546
13277,7,9,true,36,42,6,41.9401,-87.64546
TA1307000134,7,9,true,64,44,-20,41.94016,-87.65303
117,7,9,true,5,8,3,41.94016,-87.65302
228,7,9,true,1,2,1,41.94058,-87.67854
13143,7,9,true,4,7,3,41.94059,-87.67853
334,7,9,true,15,7,-8,41.94076,-87.63919
TA1309000049,7,9,true,72,59,-13,41.94077,-87.63919
308,7,9,true,1,2,1,41.94152,-87.68471
493,7,9,true,3,3,0,41.94304,-87.68729
15634,7,9,true,2,22,20,41.94304,-87.68729
TA1307000138,7,9,true,25,28,3,41.94334,-87.67094
230,7,9,true,7,6,-1,41.94335,-87.67093
13144,7,9,true,6,12,6,41.9434,-87.67964
TA1309000025,7,9,true,44,40,-4,41.94368,-87.64894
299,7,9,true,4,8,4,41.94368,-87.64894
229,7,9,true,15,6,-9,41.94372,-87.66401
13071,7,9,true,54,36,-18,41.94373,-87.66401
632,7,9,true,34,44,10,41.94453,-87.6547
303,7,9,true,10,11,1,41.94522,-87.64702
15631,7,9,true,3,9,6,41.94524,-87.70665
13278,7,9,true,85,38,-47,41.94553,-87.64644
TA1309000050,7,9,true,10,5,-5,41.94618,-87.67331
330,7,9,true,1,2,1,41.94618,-87.67331
492,7,9,true,2,2,0,41.94662,-87.68337
15632,7,9,true,3,13,10,41.94664,-87.69463
KA1504000143,7,9,true,9,14,5,41.94664,-87.68337
227,7,9,true,6,8,2,41.94813,-87.66397
13235,7,9,true,48,47,-1,41.94814,-87.66396
304,7,9,true,15,15,0,41.94878,-87.64922
257,7,9,true,2,3,1,41.9488,-87.67527
13253,7,9,true,14,18,4,41.9488,-87.67527
13325,7,9,true,48,69,21,41.94907,-87.64863
114,7,9,true,5,3,-2,41.94935,-87.65451
TA1307000126,7,9,true,46,39,-7,41.94936,-87.65451
232,7,9,true,14,11,-3,41.94943,-87.64645
TA1307000150,7,9,true,87,64,-23,41.94945,-87.64646
18016,7,9,true,12,1,-11,41.94993,-87.71395
347,7,9,true,9,1,-8,41.95068,-87.6687
13319,7,9,true,22,15,-7,41.95069,-87.6687
TA1307000127,7,9,true,29,31,2,41.9508,-87.65918
165,7,9,true,7,4,-3,41.95081,-87.65918
15628,7,9,true,12,4,-8,41.95216,-87.69806
318,7,9,true,1,3,2,41.95254,-87.6735
256,7,9,true,5,4,-1,41.95282,-87.65
13323,7,9,true,38,40,2,41.95282,-87.65
15624,7,9,true,7,5,-2,41.95339,-87.73199
KA1504000096,7,9,true,4,1,-3,41.95361,-87.70932
590,7,9,true,3,2,-1,41.95374,-87.74056
KA1504000139,7,9,true,2,4,2,41.954,-87.71909
TA1309000043,7,9,true,22,15,-7,41.95417,-87.66434
240,7,9,true,5,4,-1,41.95424,-87.65441
13063,7,9,true,33,34,1,41.95424,-87.65441
486,7,9,true,2,2,0,41.95431,-87.68607
KA1504000158,7,9,true,1,6,5,41.95432,-87.68607
254,7,9,true,8,7,-1,41.95438,-87.64806
TA1308000022,7,9,true,45,30,-15,41.95438,-87.64805
589,7,9,true,1,1,0,41.95447,-87.7496
16991,7,9,true,4,1,-3,41.95448,-87.7496
TA1307000149,7,9,true,14,11,-3,41.95467,-87.67392
TA1309000026,7,9,true,19,14,-5,41.95601,-87.6802
246,7,9,true,6,1,-5,41.95606,-87.66885
13249,7,9,true,11,7,-4,41.95606,-87.66885
312,7,9,true,12,3,-9,41.95637,-87.6563
TA1308000047,7,9,true,9,4,-5,41.95709,-87.6642
292,7,9,true,3,1,-2,41.95709,-87.6642
13379,7,9,true,38,29,-9,41.95786,-87.6495
TA1309000018,7,9,true,9,7,-2,41.95791,-87.67357
306,7,9,true,5,5,0,41.9585,-87.655
TA1309000027,7,9,true,49,17,-32,41.9585,-87.65499
13389,7,9,true,68,31,-37,41.961,-87.64958
245,7,9,true,16,7,-9,41.96101,-87.64958
15621,7,9,true,12,5,-7,41.96103,-87.70586
480,7,9,true,2,3,1,41.96104,-87.70586
15622,7,9,true,6,8,2,41.96108,-87.69544
481,7,9,true,1,3,2,41.96108,-87.69544
KA1504000164,7,9,true,1,1,0,41.96109,-87.72897
KA1504000097,7,9,true,5,4,-1,41.96116,-87.71658
238,7,9,true,2,3,1,41.96141,-87.6762
TA1307000144,7,9,true,14,18,4,41.96142,-87.6762
297,7,9,true,2,6,4,41.9615,-87.67141
TA1309000021,7,9,true,14,23,9,41.9615,-87.6714
15623,7,9,true,23,10,-13,41.96154,-87.69117
482,7,9,true,3,2,-1,41.96154,-87.69117
234,7,9,true,1,2,1,41.96158,-87.6661
KA1503000022,7,9,true,23,12,-11,41.96158,-87.66609
231,7,9,true,7,5,-2,41.96163,-87.65464
TA1307000107,7,9,true,41,58,17,41.96164,-87.65464
TA1307000156,7,9,true,15,5,-10,41.96301,-87.68479
243,7,9,true,2,3,1,41.96302,-87.68479
TA1309000012,7,9,true,12,9,-3,41.96325,-87.67928
249,7,9,true,3,2,-1,41.96398,-87.63818
TA1308000012,7,9,true,48,74,26,41.96398,-87.63818
293,7,9,true,3,5,2,41.96521,-87.65822
13074,7,9,true,16,18,2,41.96521,-87.6582
639,7,9,true,44,44,0,41.96584,-87.64538
477,7,9,true,2,1,-1,41.96587,-87.70083
KA1504000127,7,9,true,3,6,3,41.96587,-87.70083
KA1504000093,7,9,true,37,6,-31,41.96587,-87.69365
478,7,9,true,4,3,-1,41.96587,-87.69364
TA1307000140,7,9,true,12,19,7,41.96643,-87.68865
239,7,9,true,1,3,2,41.9665,-87.68843
326,7,9,true,6,6,0,41.96665,-87.67113
KA1504000126,7,9,true,2,1,-1,41.96668,-87.70807
TA1309000014,7,9,true,37,25,-12,41.96709,-87.66744
TA1307000158,7,9,true,38,23,-15,41.9671,-87.67904
242,7,9,true,3,7,4,41.9671,-87.67904
TA1307000119,7,9,true,18,18,0,41.96796,-87.65
251,7,9,true,1,3,2,41.96796,-87.65
15615,7,9,true,3,5,2,41.96835,-87.71183
323,7,9,true,3,5,2,41.96869,-87.66034
TA1308000021,7,9,true,28,15,-13,41.96883,-87.65765
253,7,9,true,1,1,0,41.96883,-87.65765
475,7,9,true,3,2,-1,41.96885,-87.69611
KA1504000080,7,9,true,4,6,2,41.96887,-87.69609
TA1309000015,7,9,true,17,5,-12,41.96889,-87.68401
TA1309000066,7,9,true,38,31,-7,41.9691,-87.67423
344,7,9,true,5,4,-1,41.9691,-87.67423
TA1309000041,7,9,true,20,29,9,41.96951,-87.65471
KA1504000171,7,9,true,29,15,-14,41.97161,-87.65016
465,7,9,true,3,2,-1,41.97161,-87.65016
325,7,9,true,5,6,1,41.9728,-87.67186
TA1309000035,7,9,true,25,20,-5,41.97335,-87.66785
295,7,9,true,10,7,-3,41.97378,-87.65972
13108,7,9,true,22,17,-5,41.97379,-87.65971
KA1504000078,7,9,true,9,7,-2,41.97491,-87.69258
KA1504000149,7,9,true,15,11,-4,41.97562,-87.67945
464,7,9,true,1,3,2,41.97562,-87.67945
471,7,9,true,1,1,0,41.97564,-87.70143
KA1504000160,7,9,true,6,10,4,41.97564,-87.70143
KA1504000128,7,9,true,1,4,3,41.97567,-87.70927
463,7,9,true,6,5,-1,41.978,-87.66805
KA1504000146,7,9,true,16,38,22,41.978,-87.66805
13109,7,9,true,44,18,-26,41.97835,-87.65976
294,7,9,true,6,1,-5,41.97835,-87.65976
KA1504000147,7,9,true,5,4,-1,41.97976,-87.67754
655,7,9,true,2,2,0,41.97987,-87.68194
KA1504000167,7,9,true,2,4,2,41.98206,-87.70895
494,7,9,true,1,1,0,41.98234,-87.70892
460,7,9,true,2,4,2,41.98358,-87.66916
KA1504000151,7,9,true,31,30,-1,41.98359,-87.66916
15585,7,9,true,5,2,-3,41.98367,-87.69642
KA1504000152,7,9,true,80,68,-12,41.98403,-87.65231
459,7,9,true,15,10,-5,41.98403,-87.65231
15578,7,9,true,20,18,-2,41.98405,-87.66027
15575,7,9,true,21,23,2,41.98975,-87.66014
458,7,9,true,1,3,2,41.98975,-87.66013
KA1504000130,7,9,true,2,1,-1,41.99024,-87.69338
KA1504000148,7,9,true,8,8,0,41.99086,-87.66971
KA1504000155,7,9,true,1,3,2,41.99118,-87.68359
KA1504000129,7,9,true,3,8,5,41.99417,-87.68945
452,7,9,true,1,10,9,41.99417,-87.68945
15571,7,9,true,25,17,-8,41.99478,-87.66028
454,7,9,true,13,3,-10,41.99478,-87.66027
KA1504000156,7,9,true,12,7,-5,41.99925,-87.67137
453,7,9,true,4,1,-3,41.99925,-87.67137
RP-009,7,9,true,12,12,0,42.00107,-87.66122
RP-001,7,9,true,2,1,-1,42.00179,-87.68883
RP-008,7,9,true,15,5,-10,42.00446,-87.6724
RP-002,7,9,true,5,1,-4,42.00456,-87.68065
660,7,9,true,18,11,-7,42.00458,-87.66143
KA1504000175,7,9,true,17,11,-6,42.00797,-87.66549
447,7,9,true,3,1,-2,42.00797,-87.66548
RP-005,7,9,true,4,1,-3,42.0086,-87.69047
KA1504000162,7,9,true,2,4,2,42.00907,-87.67422
KA1504000159,7,9,true,14,7,-7,42.01059,-87.66241
RP-006,7,9,true,1,2,1,42.01213,-87.68292
RP-007,7,9,true,3,2,-1,42.01256,-87.67431
525,7,9,true,17,2,-15,42.01272,-87.66605
517,7,9,true,3,1,-2,42.01597,-87.675
520,7,9,true,11,25,14,42.01597,-87.66859
519,7,9,true,1,1,0,42.01696,-87.67773
527,7,9,true,3,1,-2,42.01892,-87.69004
515,7,9,true,6,12,6,42.01915,-87.67356
514,7,9,true,1,3,2,42.01927,-87.68452
16806,7,9,true,2,1,-1,42.01953,-87.66955
523,7,9,true,17,4,-13,42.02089,-87.66505
598,7,9,true,3,3,0,42.02578,-87.68411
597,7,9,true,3,2,-1,42.03256,-87.67914
E002,7,9,true,10,11,1,42.03256,-87.67912
599,7,9,true,1,8,7,42.03972,-87.69942
625,7,9,true,10,6,-4,42.04163,-87.6808
596,7,9,true,13,9,-4,42.04822,-87.68348
600,7,9,true,1,1,0,42.04831,-87.6983
E008,7,9,true,4,4,0,42.05049,-87.67782
605,7,9,true,1,5,4,42.05294,-87.67342
604,7,9,true,6,13,7,42.05824,-87.67744
E006,7,9,true,8,10,2,42.06367,-87.69871
601,7,9,true,1,2,1,42.06368,-87.69871
E007,7,9,true,5,3,-2,42.06431,-87.68615
602,7,9,true,1,1,0,42.06431,-87.68614
663,7,9,true,6,1,-5,42.06483,-87.71531
E014,7,9,true,9,4,-5,42.06483,-87.71531
20215,7,17,false,3,1,-2,41.64856,-87.54618
20214,7,17,false,2,3,1,41.65191,-87.53961
20211,7,17,false,5,2,-3,41.65807,-87.61076
722,7,17,false,1,1,0,41.65915,-87.55078
20213,7,17,false,4,11,7,41.65915,-87.55078
20206,7,17,false,5,3,-2,41.68459,-87.6708
20232,7,17,false,4,9,5,41.68588,-87.57378
20243,7,17,false,1,2,1,41.68701,-87.62111
709,7,17,false,1,1,0,41.68703,-87.62115
20129,7,17,false,5,2,-3,41.68756,-87.65542
20205,7,17,false,4,3,-1,41.69121,-87.6813
20204,7,17,false,1,1,0,41.6924,-87.70096
20108,7,17,false,3,1,-2,41.69921,-87.66888
20109,7,17,false,1,1,0,41.70018,-87.6123
20124,7,17,false,3,1,-2,41.70495,-87.657
20112,7,17,false,1,2,1,41.70717,-87.61842
20202,7,17,false,1,1,0,41.71,-87.72
20107,7,17,false,1,1,0,41.7122,-87.66772
20224,7,17,false,12,9,-3,41.71371,-87.53083
20227,7,17,false,1,1,0,41.7179,-87.56461
20238,7,17,false,1,1,0,41.7187,-87.597
20106,7,17,false,1,1,0,41.71897,-87.60833
20119,7,17,false,1,6,5,41.72682,-87.6543
20110,7,17,false,2,2,0,41.72933,-87.61076
20239,7,17,false,1,2,1,41.73367,-87.5584
20116,7,17,false,1,1,0,41.73652,-87.60126
595,7,17,false,4,1,-3,41.73663,-87.62264
20230,7,17,false,1,1,0,41.73716,-87.57272
20229,7,17,false,3,3,0,41.73734,-87.54849
20121,7,17,false,7,4,-3,41.74152,-87.65842
583,7,17,false,1,3,2,41.74656,-87.58599
573,7,17,false,2,1,-1,41.75079,-87.62444
576,7,17,false,1,3,2,41.75129,-87.59752
580,7,17,false,2,3,1,41.75172,-87.55282
579,7,17,false,4,3,-1,41.75182,-87.56522
20233,7,17,false,4,1,-3,41.75251,-87.64378
KA1503000028,7,17,false,5,4,-1,41.75712,-87.57585
KA1503000049,7,17,false,3,1,-2,41.75788,-87.54938
16953,7,17,false,3,3,0,41.75796,-87.6312
571,7,17,false,1,2,1,41.75836,-87.61415
270,7,17,false,1,2,1,41.75867,-87.58692
KA1503000024,7,17,false,2,3,1,41.75876,-87.56644
20244,7,17,false,2,2,0,41.76163,-87.64411
KA1503000020,7,17,false,5,5,0,41.76223,-87.55923
15599,7,17,false,2,1,-1,41.76551,-87.61693
KA1503000003,7,17,false,1,1,0,41.76572,-87.60498
12,7,17,false,5,2,-3,41.76641,-87.5657
KA1503000002,7,17,false,16,15,-1,41.76641,-87.5657
KA1503000045,7,17,false,3,2,-1,41.76649,-87.58647
KA1503000018,7,17,false,3,2,-1,41.76663,-87.57645
650,7,17,false,2,1,-1,41.7689,-87.63586
KA1503000047,7,17,false,2,1,-1,41.76929,-87.62821
KA1503000023,7,17,false,3,1,-2,41.77346,-87.58534
KA1503000030,7,17,false,10,9,-1,41.77352,-87.57722
KA1503000029,7,17,false,1,7,6,41.77364,-87.56747
KA1503000031,7,17,false,3,6,3,41.77373,-87.60564
KA1503000021,7,17,false,2,2,0,41.77888,-87.58665
KA1503000055,7,17,false,3,1,-2,41.77939,-87.64463
430,7,17,false,1,1,0,41.7801,-87.61595
KA1503000046,7,17,false,5,2,-3,41.78041,-87.59141
653,7,17,false,4,7,3,41.78059,-87.58491
KA1503000054,7,17,false,8,11,3,41.78061,-87.60582
15491,7,17,false,30,20,-10,41.78096,-87.57624
101,7,17,false,2,7,5,41.78105,-87.57611
KA1503000033,7,17,false,3,3,0,41.78411,-87.61329
KA1503000014,7,17,false,36,32,-4,41.7851,-87.60108
426,7,17,false,10,10,0,41.7851,-87.60108
KA1503000070,7,17,false,26,25,-1,41.78794,-87.58831
328,7,17,false,4,2,-2,41.78872,-87.6013
TA1309000011,7,17,false,5,12,7,41.78873,-87.60131
423,7,17,false,8,2,-6,41.79148,-87.59988
KA1503000071,7,17,false,27,24,-3,41.79148,-87.59988
KA1503000075,7,17,false,3,2,-1,41.79156,-87.60785
KA1503000074,7,17,false,99,55,-44,41.79174,-87.58395
424,7,17,false,6,6,0,41.79174,-87.58395
TA1309000063,7,17,false,32,29,-3,41.79325,-87.5878
345,7,17,false,3,7,4,41.79326,-87.5878
559,7,17,false,2,1,-1,41.79423,-87.65509
420,7,17,false,3,5,2,41.79429,-87.60145
KA1504000076,7,17,false,31,20,-11,41.7943,-87.60145
TA1307000160,7,17,false,3,6,3,41.79485,-87.61873
KA1503000013,7,17,false,2,2,0,41.79498,-87.63312
247,7,17,false,7,12,5,41.79522,-87.58077
TA1308000009,7,17,false,144,130,-14,41.79522,-87.58075
TA1307000164,7,17,false,26,29,3,41.79527,-87.59647
646,7,17,false,3,2,-1,41.79663,-87.62592
KA1503000052,7,17,false,28,34,6,41.79935,-87.60097
418,7,17,false,1,6,5,41.79936,-87.60097
419,7,17,false,2,8,6,41.79952,-87.58643
KA1503000059,7,17,false,48,56,8,41.79952,-87.58643
TA1309000037,7,17,false,34,57,23,41.79957,-87.59474
15470,7,17,false,8,9,1,41.80228,-87.61807
417,7,17,false,5,17,12,41.80242,-87.5869
KA1503000007,7,17,false,45,53,8,41.80242,-87.58689
121,7,17,false,8,13,5,41.80256,-87.59035
13398,7,17,false,30,44,14,41.80256,-87.59035
TA1309000067,7,17,false,2,12,10,41.80303,-87.60661
322,7,17,false,12,9,-3,41.80321,-87.59849
594,7,17,false,2,3,1,41.80567,-87.68337
KA1503000069,7,17,false,3,10,7,41.80579,-87.59247
16937,7,17,false,1,2,1,41.80887,-87.66453
TA1308000035,7,17,false,21,29,8,41.80944,-87.59188
252,7,17,false,1,1,0,41.80982,-87.59936
TA1308000002,7,17,false,7,15,8,41.80983,-87.59937
TA1308000007,7,17,false,3,11,8,41.80984,-87.61628
TA1309000053,7,17,false,7,6,-1,41.80985,-87.60675
336,7,17,false,1,1,0,41.80985,-87.60675
352,7,17,false,1,8,7,41.8137,-87.63448
413,7,17,false,1,2,1,41.81408,-87.59701
KA1503000065,7,17,false,20,18,-2,41.81409,-87.59701
271,7,17,false,1,1,0,41.81648,-87.60659
TA1308000023,7,17,false,6,7,1,41.81649,-87.60659
KA1503000027,7,17,false,3,5,2,41.81666,-87.61942
13083,7,17,false,4,4,0,41.82167,-87.62153
355,7,17,false,2,3,1,41.82217,-87.63032
TA1308000038,7,17,false,16,32,16,41.82298,-87.6071
15449,7,17,false,4,1,-3,41.82302,-87.62657
546,7,17,false,9,5,-4,41.82319,-87.67661
16932,7,17,false,1,2,1,41.82346,-87.66558
179,7,17,false,1,1,0,41.82458,-87.61678
13420,7,17,false,9,7,-2,41.82459,-87.61678
18022,7,17,false,8,6,-2,41.82672,-87.68315
KA1503000068,7,17,false,4,4,0,41.82878,-87.68062
KA1503000066,7,17,false,2,11,9,41.83011,-87.67031
369,7,17,false,3,1,-2,41.83012,-87.67031
TA1308000045,7,17,false,7,7,0,41.83062,-87.64129
TA1308000043,7,17,false,8,5,-3,41.83066,-87.64715
15446,7,17,false,8,2,-6,41.83068,-87.65603
KA1503000005,7,17,false,14,4,-10,41.83079,-87.6325
TA1307000129,7,17,false,17,4,-13,41.83104,-87.62683
KA1503000004,7,17,false,52,47,-5,41.83127,-87.6088
13345,7,17,false,15,10,-5,41.83138,-87.61803
15445,7,17,false,9,8,-1,41.83453,-87.63183
13216,7,17,false,26,8,-18,41.83473,-87.62581
149,7,17,false,3,4,1,41.83486,-87.61791
13217,7,17,false,10,8,-2,41.83488,-87.61792
13215,7,17,false,31,22,-9,41.83634,-87.6135
263,7,17,false,1,5,4,41.8364,-87.61348
280,7,17,false,2,1,-1,41.83779,-87.65116
TA1308000046,7,17,false,16,13,-3,41.83779,-87.65115
339,7,17,false,3,1,-2,41.83817,-87.64523
TA1309000055,7,17,false,10,13,3,41.8382,-87.64514
KA1503000038,7,17,false,9,5,-4,41.83845,-87.6354
TA1307000048,7,17,false,172,167,-5,41.83855,-87.60821
150,7,17,false,9,12,3,41.83855,-87.60821
TA1308000036,7,17,false,8,15,7,41.83883,-87.62186
15442,7,17,false,7,4,-3,41.83918,-87.66562
366,7,17,false,1,1,0,41.84164,-87.65744
KA1503000040,7,17,false,5,5,0,41.84164,-87.65744
13213,7,17,false,4,2,-2,41.84171,-87.62694
TA1307000139,7,17,false,26,17,-9,41.84205,-87.61698
15443,7,17,false,6,20,14,41.84275,-87.63549
207,7,17,false,1,1,0,41.84358,-87.64539
TA1307000153,7,17,false,5,4,-1,41.84358,-87.64538
15691,7,17,false,6,4,-2,41.84449,-87.70203
444,7,17,false,1,1,0,41.8445,-87.70202
KA1504000110,7,17,false,5,2,-3,41.84454,-87.71596
TA1307000005,7,17,false,9,13,4,41.84569,-87.6225
TA1308000013,7,17,false,9,7,-2,41.84719,-87.64681
KA1504000086,7,17,false,3,3,0,41.8482,-87.70542
TA1309000003,7,17,false,1,1,0,41.84847,-87.68512
15689,7,17,false,1,2,1,41.84912,-87.69515
TA1307000066,7,17,false,5,4,-1,41.8492,-87.67564
TA1308000014,7,17,false,5,7,2,41.84953,-87.64059
132,7,17,false,6,1,-5,41.85008,-87.63215
TA1308000026,7,17,false,19,11,-8,41.85008,-87.63214
TA1305000004,7,17,false,38,30,-8,41.8514,-87.61884
TA1305000001,7,17,false,26,35,9,41.85262,-87.6265
13075,7,17,false,105,129,24,41.8531,-87.63192
120,7,17,false,14,7,-7,41.8531,-87.63191
13162,7,17,false,11,8,-3,41.85378,-87.64659
13096,7,17,false,7,15,8,41.8538,-87.69577
15685,7,17,false,2,3,1,41.85399,-87.71511
203,7,17,false,2,1,-1,41.85409,-87.68585
13091,7,17,false,3,3,0,41.85409,-87.68585
15546,7,17,false,21,39,18,41.85416,-87.61916
13307,7,17,false,16,18,2,41.85489,-87.66359
124,7,17,false,2,2,0,41.85492,-87.67609
13089,7,17,false,9,18,9,41.85497,-87.67567
13331,7,17,false,4,14,10,41.85515,-87.65414
15545,7,17,false,139,122,-17,41.85627,-87.61334
4,7,17,false,4,11,7,41.85627,-87.61334
SL-013,7,17,false,23,29,6,41.85659,-87.62755
218,7,17,false,1,4,3,41.85679,-87.63387
SL-006,7,17,false,13,27,14,41.8568,-87.63387
129,7,17,false,2,1,-1,41.85752,-87.66158
13135,7,17,false,23,20,-3,41.85753,-87.66157
338,7,17,false,1,3,2,41.85758,-87.61956
13102,7,17,false,48,61,13,41.85762,-87.61942
273,7,17,false,2,4,2,41.85783,-87.62455
13150,7,17,false,35,53,18,41.85783,-87.62455
13099,7,17,false,12,13,1,41.85784,-87.64627
205,7,17,false,3,4,1,41.8579,-87.6687
TA1307000159,7,17,false,16,21,5,41.8579,-87.6687
TA1307000044,7,17,false,10,8,-2,41.85794,-87.64083
14,7,17,false,1,1,0,41.85808,-87.65109
13163,7,17,false,24,27,3,41.85808,-87.65108
13164,7,17,false,24,32,8,41.85818,-87.65648
SL-012,7,17,false,43,42,-1,41.86038,-87.62581
13304,7,17,false,10,10,0,41.86126,-87.65659
KA1504000109,7,17,false,2,2,0,41.86192,-87.69347
TA1306000002,7,17,false,14,8,-6,41.86238,-87.65108
137,7,17,false,2,1,-1,41.86238,-87.65108
TA1307000124,7,17,false,70,74,4,41.86411,-87.62372
168,7,17,false,3,13,10,41.86415,-87.62372
282,7,17,false,3,8,5,41.86487,-87.64708
TA1309000001,7,17,false,13,28,15,41.86488,-87.64708
136,7,17,false,2,1,-1,41.86504,-87.65698
13165,7,17,false,6,5,-1,41.86505,-87.65697
13354,7,17,false,11,8,-3,41.86524,-87.66651
275,7,17,false,3,2,-1,41.86524,-87.66651
13029,7,17,false,118,86,-32,41.86531,-87.6179
97,7,17,false,15,6,-9,41.86531,-87.6179
341,7,17,false,13,21,8,41.86608,-87.60733
13431,7,17,false,246,197,-49,41.8661,-87.60728
15682,7,17,false,6,2,-4,41.86651,-87.70649
KA1504000101,7,17,false,2,10,8,41.86651,-87.68466
434,7,17,false,1,1,0,41.86651,-87.68465
KA1504000102,7,17,false,5,1,-4,41.86664,-87.69453
436,7,17,false,1,1,0,41.86664,-87.69452
WL-008,7,17,false,57,27,-30,41.86712,-87.64108
57,7,17,false,3,6,3,41.86712,-87.64107
TA1305000002,7,17,false,136,133,-3,41.86721,-87.62597
59,7,17,false,10,13,3,41.86721,-87.62597
15544,7,17,false,281,233,-48,41.86723,-87.61536
3,7,17,false,24,11,-13,41.86723,-87.61536
TA1305000017,7,17,false,3,15,12,41.86734,-87.64863
626,7,17,false,8,8,0,41.86749,-87.63219
KA1706005007,7,17,false,31,32,1,41.86749,-87.63219
SL-005,7,17,false,275,288,13,41.8679,-87.62304
255,7,17,false,21,38,17,41.86791,-87.62304
644,7,17,false,8,9,1,41.86859,-87.68625
19,7,17,false,1,2,1,41.86892,-87.65913
13139,7,17,false,18,22,4,41.86893,-87.65913
13285,7,17,false,1,2,1,41.86928,-87.67372
22,7,17,false,4,1,-3,41.86947,-87.65548
13160,7,17,false,18,38,20,41.86947,-87.65548
414,7,17,false,5,5,0,41.87023,-87.63947
15550,7,17,false,35,29,-6,41.87024,-87.63947
TA1309000010,7,17,false,95,103,8,41.87074,-87.62574
SL-009,7,17,false,34,37,3,41.87081,-87.63121
TA1309000064,7,17,false,8,11,3,41.87127,-87.67369
15542,7,17,false,11,8,-3,41.87146,-87.64095
TA1307000130,7,17,false,18,14,-4,41.87178,-87.65103
241,7,17,false,2,2,0,41.8718,-87.65102
TA1307000121,7,17,false,25,11,-14,41.87184,-87.64664
41,7,17,false,3,15,12,41.87209,-87.62957
SL-008,7,17,false,92,119,27,41.87209,-87.62956
13332,7,17,false,23,34,11,41.87219,-87.6615
394,7,17,false,4,3,-1,41.87226,-87.63484
175,7,17,false,11,10,-1,41.87255,-87.63359
SL-011,7,17,false,73,89,16,41.87256,-87.63356
623,7,17,false,183,220,37,41.87272,-87.62399
KA1504000104,7,17,false,8,4,-4,41.87296,-87.66912
16915,7,17,false,3,1,-2,41.873,-87.7645
320,7,17,false,3,10,7,41.87327,-87.66402
KA1504000082,7,17,false,1,1,0,41.87361,-87.70488
5,7,17,false,1,3,2,41.87403,-87.6277
SL-007,7,17,false,57,73,16,41.87404,-87.6277
169,7,17,false,1,1,0,41.87424,-87.63959
13326,7,17,false,9,9,0,41.87425,-87.63958
321,7,17,false,8,16,8,41.87427,-87.63257
535,7,17,false,1,2,1,41.87433,-87.72582
356,7,17,false,1,2,1,41.87464,-87.70168
TA1306000025,7,17,false,17,10,-7,41.87464,-87.65703
32,7,17,false,1,1,0,41.87464,-87.65703
15668,7,17,false,15,10,-5,41.87471,-87.68642
109,7,17,false,3,3,0,41.87475,-87.64981
13028,7,17,false,13,20,7,41.87475,-87.64981
13081,7,17,false,3,5,2,41.87501,-87.67326
122,7,17,false,2,2,0,41.87501,-87.67325
89,7,17,false,5,8,3,41.87501,-87.6331
SL-010,7,17,false,18,29,11,41.87501,-87.63309
15541,7,17,false,229,215,-14,41.8758,-87.62086
543,7,17,false,3,2,-1,41.87581,-87.75531
68,7,17,false,2,3,1,41.87587,-87.64077
13037,7,17,false,4,8,4,41.87588,-87.64078
TA1305000009,7,17,false,18,11,-7,41.87593,-87.63068
317,7,17,false,2,1,-1,41.87603,-87.68195
TA1305000010,7,17,false,64,82,18,41.87623,-87.62444
624,7,17,false,47,60,13,41.87626,-87.62923
2,7,17,false,29,29,0,41.87649,-87.62051
33,7,17,false,6,6,0,41.87715,-87.62786
TA1305000035,7,17,false,44,44,0,41.87716,-87.62787
13138,7,17,false,20,15,-5,41.87723,-87.63941
75,7,17,false,1,2,1,41.87724,-87.63937
631,7,17,false,4,4,0,41.87761,-87.6739
15539,7,17,false,29,43,14,41.87763,-87.64405
13158,7,17,false,48,53,5,41.87764,-87.64957
134,7,17,false,3,5,2,41.87764,-87.64954
21,7,17,false,6,3,-3,41.87773,-87.6548
13157,7,17,false,44,56,12,41.87773,-87.6548
TA1305000025,7,17,false,89,87,-2,41.87773,-87.63528
36,7,17,false,5,9,4,41.87776,-87.63525
TA1309000002,7,17,false,140,134,-6,41.87784,-87.62408
284,7,17,false,7,13,6,41.87784,-87.62408
13206,7,17,false,25,40,15,41.87794,-87.66201
283,7,17,false,3,1,-2,41.87809,-87.63183
TA1309000004,7,17,false,36,28,-8,41.87811,-87.63184
107,7,17,false,5,7,2,41.87822,-87.644
638,7,17,false,35,37,2,41.87827,-87.64078
37,7,17,false,3,1,-2,41.87921,-87.62975
TA1305000005,7,17,false,29,23,-6,41.87924,-87.62975
286,7,17,false,4,9,5,41.8793,-87.6355
13011,7,17,false,30,33,3,41.87931,-87.63993
TA1309000008,7,17,false,22,26,4,41.87933,-87.6355
192,7,17,false,3,2,-1,41.87935,-87.63997
KA1503000034,7,17,false,30,15,-15,41.87938,-87.63197
40,7,17,false,2,1,-1,41.87944,-87.63197
39,7,17,false,3,3,0,41.87948,-87.62571
KA1503000015,7,17,false,52,56,4,41.87948,-87.6257
15667,7,17,false,4,9,5,41.8798,-87.68609
16916,7,17,false,1,1,0,41.88012,-87.76323
540,7,17,false,3,3,0,41.88022,-87.75536
TA1309000007,7,17,false,22,27,5,41.88022,-87.63526
16918,7,17,false,3,1,-2,41.88028,-87.77447
WL-011,7,17,false,33,30,-3,41.88034,-87.64273
73,7,17,false,5,3,-2,41.8804,-87.64273
13156,7,17,false,60,50,-10,41.88042,-87.65554
534,7,17,false,3,4,1,41.88085,-87.72793
13300,7,17,false,670,695,25,41.88097,-87.61675
76,7,17,false,50,69,19,41.88098,-87.61675
13008,7,17,false,457,536,79,41.88105,-87.62408
90,7,17,false,51,60,9,41.88107,-87.62409
49,7,17,false,1,6,5,41.88116,-87.62963
TA1305000006,7,17,false,67,55,-12,41.88122,-87.6296
13134,7,17,false,9,6,-3,41.88138,-87.67493
13056,7,17,false,14,17,3,41.88168,-87.63951
191,7,17,false,2,6,4,41.88169,-87.63951
198,7,17,false,5,11,6,41.88187,-87.6488
TA1307000120,7,17,false,108,142,34,41.88188,-87.64879
13341,7,17,false,30,30,0,41.88208,-87.63985
174,7,17,false,9,6,-3,41.88208,-87.63984
197,7,17,false,9,11,2,41.88208,-87.62513
13036,7,17,false,62,53,-9,41.8821,-87.62513
77,7,17,false,10,6,-4,41.88214,-87.64108
TA1305000032,7,17,false,58,84,26,41.88218,-87.64109
98,7,17,false,7,7,0,41.88266,-87.63251
13006,7,17,false,32,38,6,41.88268,-87.63252
13353,7,17,false,28,31,3,41.88283,-87.6612
346,7,17,false,1,3,2,41.88284,-87.6612
654,7,17,false,30,13,-17,41.88307,-87.65698
233,7,17,false,1,5,4,41.88309,-87.6511
13409,7,17,false,48,52,4,41.8831,-87.6511
18,7,17,false,11,6,-5,41.88317,-87.63735
KA1503000072,7,17,false,21,33,12,41.88317,-87.63693
91,7,17,false,4,5,1,41.88336,-87.64122
WL-012,7,17,false,23,21,-2,41.88337,-87.6412
112,7,17,false,6,16,10,41.88362,-87.6486
13053,7,17,false,139,205,66,41.88365,-87.64863
43,7,17,false,14,17,3,41.88396,-87.62455
13001,7,17,false,146,195,49,41.88397,-87.62459
13155,7,17,false,14,32,18,41.88407,-87.65689
621,7,17,false,1,5,4,41.88412,-87.65427
18062,7,17,false,24,42,18,41.88412,-87.65427
81,7,17,false,8,3,-5,41.88417,-87.6296
TA1306000010,7,17,false,76,59,-17,41.88419,-87.62961
15666,7,17,false,4,3,-1,41.88446,-87.6963
KA1504000106,7,17,false,3,2,-1,41.88459,-87.70631
TA1305000030,7,17,false,50,50,0,41.88459,-87.63178
96,7,17,false,4,3,-1,41.8846,-87.64455
15535,7,17,false,52,58,6,41.8846,-87.64455
51,7,17,false,1,7,6,41.88462,-87.63176
TA1305000029,7,17,false,163,174,11,41.88466,-87.62787
195,7,17,false,24,12,-12,41.88466,-87.61952
13263,7,17,false,132,147,15,41.88467,-87.61952
44,7,17,false,14,17,3,41.88468,-87.62782
528,7,17,false,1,1,0,41.88537,-87.72661
TA1306000015,7,17,false,88,138,50,41.88549,-87.65232
518,7,17,false,7,6,-1,41.8855,-87.71686
71,7,17,false,6,5,-1,41.8855,-87.65233
66,7,17,false,1,6,5,41.88557,-87.64186
13021,7,17,false,63,55,-8,41.88559,-87.64184
TA1307000111,7,17,false,56,71,15,41.88582,-87.63548
164,7,17,false,7,8,1,41.88583,-87.63547
13073,7,17,false,27,45,18,41.88592,-87.66717
119,7,17,false,3,2,-1,41.88593,-87.66717
KA17018054,7,17,false,13,10,-3,41.88595,-87.67701
38,7,17,false,9,9,0,41.88599,-87.63089
KA1503000012,7,17,false,61,76,15,41.88599,-87.63089
52,7,17,false,35,37,2,41.886,-87.62421
TA1305000011,7,17,false,169,209,40,41.886,-87.62418
7,7,17,false,4,5,1,41.88627,-87.61751
15534,7,17,false,96,131,35,41.88627,-87.61749
13197,7,17,false,9,16,7,41.8866,-87.65816
264,7,17,false,8,10,2,41.8867,-87.62224
TA1308000029,7,17,false,61,62,1,41.88673,-87.62225
TA1307000131,7,17,false,155,144,-11,41.88688,-87.62606
194,7,17,false,4,10,6,41.88688,-87.62606
KA1503000064,7,17,false,225,227,2,41.88697,-87.61281
6,7,17,false,7,25,18,41.88697,-87.61281
100,7,17,false,3,3,0,41.88814,-87.63657
TA1305000022,7,17,false,62,89,27,41.88817,-87.63656
56,7,17,false,7,8,1,41.88866,-87.64442
TA1306000003,7,17,false,98,107,9,41.88867,-87.64442
133,7,17,false,5,7,2,41.88918,-87.63851
KA1503000043,7,17,false,78,84,6,41.88918,-87.63851
13050,7,17,false,104,144,40,41.88919,-87.62775
47,7,17,false,15,24,9,41.88921,-87.62775
15664,7,17,false,2,6,4,41.8895,-87.68821
13432,7,17,false,15,14,-1,41.88989,-87.67149
TA1307000151,7,17,false,85,88,3,41.88993,-87.63427
212,7,17,false,9,8,-1,41.88995,-87.63427
636,7,17,false,36,39,3,41.88997,-87.63662
125,7,17,false,10,7,-3,41.89018,-87.62621
KA1503000044,7,17,false,37,59,22,41.89018,-87.6262
196,7,17,false,4,17,13,41.89053,-87.62205
13427,7,17,false,87,91,4,41.89054,-87.62205
26,7,17,false,19,24,5,41.89057,-87.61798
13430,7,17,false,117,136,19,41.89077,-87.63169
181,7,17,false,11,11,0,41.89077,-87.63168
TA1306000013,7,17,false,215,214,-1,41.89083,-87.61852
RN-,7,17,false,71,72,1,41.89102,-87.63546
672,7,17,false,9,12,3,41.89102,-87.63545
277,7,17,false,1,2,1,41.89108,-87.66665
13434,7,17,false,40,35,-5,41.89108,-87.66663
TA1308000006,7,17,false,23,28,5,41.89128,-87.67686
199,7,17,false,20,26,6,41.89143,-87.62676
TA1307000117,7,17,false,235,283,48,41.89144,-87.62675
13033,7,17,false,62,90,28,41.8916,-87.64835
214,7,17,false,3,4,1,41.89161,-87.67688
84,7,17,false,9,3,-6,41.89161,-87.64833
186,7,17,false,2,2,0,41.8918,-87.65879
13194,7,17,false,41,63,22,41.8918,-87.65878
TA1305000003,7,17,false,208,257,49,41.89187,-87.62061
24,7,17,false,23,17,-6,41.8919,-87.62063
643,7,17,false,6,8,2,41.89203,-87.68939
35,7,17,false,36,57,21,41.89227,-87.61206
13022,7,17,false,1246,1313,67,41.89227,-87.61205
99,7,17,false,11,9,-2,41.89255,-87.61449
TA1306000029,7,17,false,168,187,19,41.89256,-87.61449
13265,7,17,false,55,84,29,41.89383,-87.64172
74,7,17,false,2,7,5,41.89384,-87.64173
13045,7,17,false,119,164,45,41.89403,-87.62931
110,7,17,false,23,33,10,41.89406,-87.6293
13016,7,17,false,102,144,42,41.89431,-87.62277
211,7,17,false,15,14,-1,41.89439,-87.62267
KA1503000041,7,17,false,77,95,18,41.89452,-87.61798
142,7,17,false,11,11,0,41.89453,-87.61806
92,7,17,false,3,6,3,41.89455,-87.65346
13196,7,17,false,36,39,3,41.89455,-87.65345
TA1307000062,7,17,false,26,49,23,41.89466,-87.63839
111,7,17,false,2,5,3,41.89466,-87.63837
642,7,17,false,2,4,2,41.89473,-87.75689
TA1306000012,7,17,false,142,155,13,41.89475,-87.63438
53,7,17,false,11,14,3,41.89476,-87.63439
627,7,17,false,4,14,10,41.8948,-87.63231
KP1705001026,7,17,false,67,77,10,41.89483,-87.6323
16921,7,17,false,3,1,-2,41.89488,-87.77459
16920,7,17,false,1,2,1,41.89495,-87.76491
KA1504000114,7,17,false,6,8,2,41.89547,-87.70614
18058,7,17,false,22,19,-3,41.8955,-87.68201
659,7,17,false,3,3,0,41.8955,-87.68201
637,7,17,false,23,42,19,41.89563,-87.67209
13132,7,17,false,45,62,17,41.89573,-87.67718
161,7,17,false,8,18,10,41.89574,-87.62599
15530,7,17,false,129,143,14,41.89575,-87.62596
18003,7,17,false,28,43,15,41.89575,-87.62011
13247,7,17,false,40,33,-7,41.89597,-87.66775
350,7,17,false,5,3,-2,41.89597,-87.66774
TA1305000020,7,17,false,42,52,10,41.89636,-87.65406
54,7,17,false,4,4,0,41.89637,-87.65407
13289,7,17,false,39,35,-4,41.89638,-87.661
86,7,17,false,8,4,-4,41.89639,-87.661
337,7,17,false,4,12,8,41.89659,-87.63096
13303,7,17,false,70,84,14,41.89672,-87.63088
13017,7,17,false,37,39,2,41.89676,-87.6357
31,7,17,false,3,5,2,41.89677,-87.63572
13338,7,17,false,80,79,-1,41.89697,-87.62173
173,7,17,false,2,5,3,41.89704,-87.62173
TA1307000061,7,17,false,47,58,11,41.89745,-87.62873
106,7,17,false,8,3,-5,41.89746,-87.62874
25,7,17,false,19,17,-2,41.89751,-87.62354
13034,7,17,false,144,113,-31,41.89754,-87.62352
TA1306000009,7,17,false,31,34,3,41.89772,-87.64299
620,7,17,false,34,44,10,41.89817,-87.63754
KA1504000103,7,17,false,24,48,24,41.89842,-87.68659
145,7,17,false,12,14,2,41.89856,-87.62211
15529,7,17,false,110,100,-10,41.89858,-87.62206
140,7,17,false,17,7,-10,41.89895,-87.6299
TA1307000128,7,17,false,123,126,3,41.89896,-87.6299
657,7,17,false,11,24,13,41.89918,-87.6722
KA1504000117,7,17,false,9,8,-1,41.89936,-87.64848
30,7,17,false,3,4,1,41.89964,-87.66789
13248,7,17,false,30,27,-3,41.89964,-87.66788
46,7,17,false,3,7,4,41.89994,-87.63444
TA1306000011,7,17,false,40,45,5,41.89994,-87.63443
KA1504000116,7,17,false,26,21,-5,41.90023,-87.64299
17660,7,17,false,9,29,20,41.90036,-87.69671
29,7,17,false,5,6,1,41.90069,-87.66259
13290,7,17,false,35,52,17,41.90069,-87.66259
13042,7,17,false,574,587,13,41.90097,-87.62377
85,7,17,false,32,26,-6,41.90098,-87.62375
183,7,17,false,2,2,0,41.90133,-87.67744
TA1307000070,7,17,false,37,39,2,41.90133,-87.67742
KA1504000133,7,17,false,107,124,17,41.90234,-87.62773
172,7,17,false,7,15,8,41.90236,-87.62774
15654,7,17,false,13,10,-3,41.90271,-87.70923
305,7,17,false,3,2,-1,41.9028,-87.69005
13241,7,17,false,23,33,10,41.9029,-87.68731
176,7,17,false,20,27,7,41.90291,-87.63141
TA1306000006,7,17,false,18,12,-6,41.90292,-87.63772
TA1307000039,7,17,false,174,156,-18,41.90294,-87.63137
658,7,17,false,19,21,2,41.903,-87.6838
216,7,17,false,3,1,-2,41.90302,-87.69749
13256,7,17,false,27,39,12,41.90302,-87.69749
17,7,17,false,5,5,0,41.90313,-87.67391
TA1305000034,7,17,false,51,63,12,41.90313,-87.67391
182,7,17,false,12,24,12,41.90317,-87.63442
KA1504000135,7,17,false,181,166,-15,41.90319,-87.63439
13136,7,17,false,65,55,-10,41.90326,-87.67845
130,7,17,false,4,2,-2,41.90327,-87.67846
210,7,17,false,10,10,0,41.90342,-87.66781
13061,7,17,false,105,114,9,41.90342,-87.66779
KA1504000079,7,17,false,57,53,-4,41.9035,-87.64334
398,7,17,false,3,2,-1,41.90386,-87.70941
359,7,17,false,10,3,-7,41.90458,-87.6497
138,7,17,false,4,1,-3,41.9046,-87.64057
TA1307000115,7,17,false,27,25,-2,41.9046,-87.64056
291,7,17,false,16,14,-2,41.90672,-87.63494
TA1308000049,7,17,false,158,157,-1,41.90672,-87.6349
KA1504000134,7,17,false,101,99,-2,41.90687,-87.6262
180,7,17,false,5,8,3,41.90687,-87.62618
333,7,17,false,2,10,8,41.90706,-87.66725
13224,7,17,false,54,70,16,41.90706,-87.66725
18069,7,17,false,5,3,-2,41.90722,-87.65563
TA1307000143,7,17,false,42,25,-17,41.90762,-87.63854
61,7,17,false,8,4,-4,41.90764,-87.67254
13221,7,17,false,92,105,13,41.90765,-87.67254
13245,7,17,false,9,5,-4,41.90777,-87.68586
301,7,17,false,8,6,-2,41.90796,-87.63203
TA1309000024,7,17,false,93,109,16,41.908,-87.63152
69,7,17,false,14,7,-7,41.90939,-87.6777
TA1305000041,7,17,false,126,141,15,41.9094,-87.67769
15652,7,17,false,4,7,3,41.90965,-87.71664
331,7,17,false,99,81,-18,41.90965,-87.64812
15653,7,17,false,15,16,1,41.90979,-87.7053
509,7,17,false,3,4,1,41.9098,-87.70531
TA1305000037,7,17,false,38,57,19,41.91018,-87.67003
27,7,17,false,6,6,0,41.91019,-87.6435
TA1306000008,7,17,false,29,42,13,41.9102,-87.6435
16,7,17,false,5,7,2,41.91035,-87.67008
213,7,17,false,3,2,-1,41.91037,-87.68237
TA1308000005,7,17,false,32,46,14,41.91042,-87.68238
276,7,17,false,5,6,1,41.91043,-87.69718
13258,7,17,false,27,31,4,41.91043,-87.69718
13257,7,17,false,23,37,14,41.91054,-87.68956
13154,7,17,false,52,60,8,41.91054,-87.65312
20,7,17,false,2,7,5,41.91055,-87.65313
13058,7,17,false,64,56,-8,41.91059,-87.64942
60,7,17,false,7,4,-3,41.91059,-87.64942
TA1307000038,7,17,false,105,62,-43,41.91138,-87.63868
118,7,17,false,5,3,-2,41.91138,-87.63868
LF-005,7,17,false,586,505,-81,41.91172,-87.62681
268,7,17,false,13,43,30,41.91172,-87.62681
126,7,17,false,10,9,-1,41.91196,-87.63197
13128,7,17,false,115,80,-35,41.91197,-87.63197
289,7,17,false,18,21,3,41.91209,-87.63472
TA1308000050,7,17,false,238,217,-21,41.91211,-87.6347
158,7,17,false,4,4,0,41.91262,-87.6814
13243,7,17,false,49,72,23,41.91262,-87.6814
TA1309000032,7,17,false,10,3,-7,41.91293,-87.66417
315,7,17,false,3,2,-1,41.91293,-87.66417
TA1306000032,7,17,false,49,58,9,41.9137,-87.65285
93,7,17,false,5,3,-2,41.91371,-87.65285
224,7,17,false,7,7,0,41.91386,-87.64877
TA1307000166,7,17,false,51,62,11,41.91386,-87.64877
511,7,17,false,4,1,-3,41.914,-87.70515
15655,7,17,false,25,30,5,41.91401,-87.70514
641,7,17,false,3,5,2,41.91416,-87.71676
18017,7,17,false,17,36,19,41.91416,-87.71676
18067,7,17,false,44,43,-1,41.9146,-87.66796
628,7,17,false,4,8,4,41.9146,-87.66796
28,7,17,false,1,1,0,41.91469,-87.64333
TA1306000007,7,17,false,16,26,10,41.91469,-87.64333
13068,7,17,false,29,36,7,41.91554,-87.68703
116,7,17,false,3,2,-1,41.91555,-87.68703
13179,7,17,false,199,179,-20,41.9157,-87.63461
141,7,17,false,14,21,7,41.91571,-87.63461
219,7,17,false,5,2,-3,41.91598,-87.67733
13133,7,17,false,49,95,46,41.91598,-87.67733
58,7,17,false,2,4,2,41.91602,-87.66894
TA1305000039,7,17,false,29,37,8,41.9163,-87.66749
506,7,17,false,2,2,0,41.91711,-87.71023
15650,7,17,false,21,29,8,41.91711,-87.71023
15651,7,17,false,38,32,-6,41.91752,-87.70181
507,7,17,false,5,1,-4,41.91752,-87.70181
185,7,17,false,3,1,-2,41.91774,-87.69143
13266,7,17,false,15,23,8,41.91774,-87.69142
TA1309000029,7,17,false,12,38,26,41.9178,-87.68245
309,7,17,false,8,2,-6,41.91789,-87.6865
TA1309000006,7,17,false,50,47,-3,41.91809,-87.64375
223,7,17,false,4,3,-1,41.91821,-87.65698
TA1307000163,7,17,false,37,55,18,41.91821,-87.65696
94,7,17,false,32,16,-16,41.91831,-87.6363
13146,7,17,false,242,194,-48,41.91831,-87.63629
13059,7,17,false,135,110,-25,41.91845,-87.65222
113,7,17,false,7,14,7,41.91846,-87.65222
13259,7,17,false,29,29,0,41.91852,-87.69744
259,7,17,false,2,3,1,41.91853,-87.69745
310,7,17,false,2,6,4,41.91984,-87.68083
225,7,17,false,11,3,-8,41.91995,-87.64884
13192,7,17,false,66,70,4,41.91995,-87.64884
13288,7,17,false,24,36,12,41.92008,-87.67788
13242,7,17,false,31,17,-14,41.92021,-87.69266
307,7,17,false,3,6,3,41.92077,-87.66373
TA1309000030,7,17,false,53,69,16,41.92077,-87.66372
13292,7,17,false,24,22,-2,41.92152,-87.70733
TA1309000033,7,17,false,104,119,15,41.92158,-87.65381
13193,7,17,false,190,183,-7,41.92182,-87.64412
144,7,17,false,11,26,15,41.92182,-87.64411
13191,7,17,false,114,108,-6,41.92217,-87.63891
143,7,17,false,11,5,-6,41.92217,-87.63891
327,7,17,false,6,6,0,41.92225,-87.65783
13084,7,17,false,50,46,-4,41.92268,-87.69715
123,7,17,false,3,10,7,41.92268,-87.69714
LP-,7,17,false,168,95,-73,41.92396,-87.63584
673,7,17,false,12,15,3,41.92398,-87.63585
KA1504000140,7,17,false,7,24,17,41.92409,-87.67646
16010,7,17,false,5,13,8,41.92458,-87.72787
15648,7,17,false,16,20,4,41.92464,-87.68931
504,7,17,false,3,9,6,41.92464,-87.68931
KA1504000090,7,17,false,8,26,18,41.92483,-87.7145
TA1307000001,7,17,false,49,67,18,41.92535,-87.66581
TA1306000026,7,17,false,41,63,22,41.92558,-87.65842
87,7,17,false,3,2,-1,41.92559,-87.65843
TA1306000016,7,17,false,82,57,-25,41.9256,-87.65371
67,7,17,false,2,6,4,41.9256,-87.65371
313,7,17,false,12,14,2,41.9257,-87.64246
TA1309000019,7,17,false,197,190,-7,41.92586,-87.63897
TA1309000058,7,17,false,100,108,8,41.92591,-87.64927
127,7,17,false,8,6,-2,41.92592,-87.64927
TA1308000001,7,17,false,453,415,-38,41.92627,-87.63086
177,7,17,false,29,28,-1,41.92627,-87.63086
15646,7,17,false,23,20,-3,41.92668,-87.6977
13124,7,17,false,98,75,-23,41.92675,-87.63444
34,7,17,false,5,12,7,41.92675,-87.63444
302,7,17,false,5,6,1,41.92859,-87.65421
TA1309000023,7,17,false,71,87,16,41.9287,-87.65383
TA1307000113,7,17,false,69,74,5,41.92878,-87.66391
190,7,17,false,5,3,-2,41.92878,-87.6639
166,7,17,false,3,4,1,41.92883,-87.66853
13296,7,17,false,30,49,19,41.92883,-87.66852
TA1309000059,7,17,false,45,38,-7,41.92889,-87.65898
343,7,17,false,9,3,-6,41.92889,-87.65898
349,7,17,false,10,8,-2,41.92915,-87.6491
TA1309000061,7,17,false,87,96,9,41.92915,-87.64909
258,7,17,false,6,5,-1,41.92946,-87.68417
TA1308000031,7,17,false,19,35,16,41.92946,-87.68417
340,7,17,false,14,10,-4,41.92956,-87.64313
TA1305000014,7,17,false,147,146,-1,41.92956,-87.64313
260,7,17,false,6,8,2,41.92958,-87.70791
13085,7,17,false,53,60,7,41.92958,-87.70789
15643,7,17,false,15,12,-3,41.93057,-87.7238
TA1307000142,7,17,false,102,115,13,41.93125,-87.64432
220,7,17,false,13,17,4,41.93125,-87.64431
13276,7,17,false,159,150,-9,41.93132,-87.63874
324,7,17,false,6,19,13,41.93173,-87.64179
15645,7,17,false,11,18,7,41.93191,-87.70121
163,7,17,false,1,4,3,41.93191,-87.67784
13271,7,17,false,18,25,7,41.93192,-87.67784
152,7,17,false,4,3,-1,41.93221,-87.65864
TA1307000064,7,17,false,56,66,10,41.93222,-87.65864
13,7,17,false,4,13,9,41.93242,-87.65271
TA1306000014,7,17,false,71,84,13,41.93242,-87.65271
329,7,17,false,7,17,10,41.93258,-87.63642
TA1309000039,7,17,false,168,180,12,41.93258,-87.63642
13294,7,17,false,40,49,9,41.9326,-87.66595
319,7,17,false,4,2,-2,41.93292,-87.67217
332,7,17,false,1,5,4,41.93313,-87.64776
TA1309000036,7,17,false,68,85,17,41.93313,-87.64776
15644,7,17,false,16,8,-8,41.93534,-87.71687
TA1307000006,7,17,false,60,62,2,41.93571,-87.6636
153,7,17,false,4,5,1,41.93575,-87.66364
162,7,17,false,3,1,-2,41.93588,-87.67844
13268,7,17,false,33,43,10,41.93588,-87.67843
250,7,17,false,2,4,2,41.93609,-87.66984
13269,7,17,false,28,35,7,41.93609,-87.66983
115,7,17,false,6,13,7,41.93628,-87.65266
TA1307000052,7,17,false,69,95,26,41.93628,-87.65266
156,7,17,false,9,6,-3,41.9365,-87.64756
TA1307000136,7,17,false,93,100,7,41.9365,-87.64755
TA1307000041,7,17,false,229,199,-30,41.93669,-87.63683
157,7,17,false,5,15,10,41.9367,-87.63683
13137,7,17,false,154,199,45,41.9376,-87.6441
300,7,17,false,21,24,3,41.93761,-87.6441
15642,7,17,false,17,21,4,41.93843,-87.69801
154,7,17,false,7,8,1,41.93912,-87.66384
KA17018068,7,17,false,21,28,7,41.93935,-87.68327
TA1309000042,7,17,false,43,46,3,41.93937,-87.66836
131,7,17,false,1,2,1,41.93937,-87.66835
496,7,17,false,2,1,-1,41.9394,-87.72356
KA150400009X,7,17,false,12,9,-3,41.9394,-87.71159
15640,7,17,false,9,10,1,41.93941,-87.72357
13229,7,17,false,56,81,25,41.93946,-87.66376
226,7,17,false,5,3,-2,41.93972,-87.65886
TA1308000019,7,17,false,78,107,29,41.93973,-87.65886
296,7,17,false,11,7,-4,41.9401,-87.64546
13277,7,17,false,89,104,15,41.9401,-87.64546
TA1307000134,7,17,false,147,153,6,41.94016,-87.65303
117,7,17,false,18,24,6,41.94016,-87.65302
13143,7,17,false,22,25,3,41.94059,-87.67853
334,7,17,false,11,25,14,41.94076,-87.63919
TA1309000049,7,17,false,198,176,-22,41.94077,-87.63919
308,7,17,false,2,1,-1,41.94152,-87.68471
15634,7,17,false,18,12,-6,41.94304,-87.68729
TA1307000138,7,17,false,58,64,6,41.94334,-87.67094
230,7,17,false,1,2,1,41.94335,-87.67093
13144,7,17,false,17,41,24,41.9434,-87.67964
299,7,17,false,9,5,-4,41.94368,-87.64894
TA1309000025,7,17,false,124,145,21,41.94368,-87.64894
229,7,17,false,6,12,6,41.94372,-87.66401
13071,7,17,false,98,118,20,41.94373,-87.66401
632,7,17,false,162,159,-3,41.94453,-87.6547
303,7,17,false,6,14,8,41.94522,-87.64702
15631,7,17,false,6,18,12,41.94524,-87.70665
13278,7,17,false,79,156,77,41.94553,-87.64644
TA1309000050,7,17,false,25,15,-10,41.94618,-87.67331
330,7,17,false,2,1,-1,41.94618,-87.67331
KA1504000141,7,17,false,3,2,-1,41.94627,-87.73105
488,7,17,false,1,1,0,41.94627,-87.73105
15632,7,17,false,19,17,-2,41.94664,-87.69463
KA1504000143,7,17,false,13,11,-2,41.94664,-87.68337
KA1504000142,7,17,false,2,7,5,41.94735,-87.71759
16994,7,17,false,1,2,1,41.94784,-87.74
227,7,17,false,9,6,-3,41.94813,-87.66397
13235,7,17,false,104,129,25,41.94814,-87.66396
304,7,17,false,12,6,-6,41.94878,-87.64922
257,7,17,false,1,1,0,41.9488,-87.67527
13253,7,17,false,21,25,4,41.9488,-87.67527
13325,7,17,false,83,92,9,41.94907,-87.64863
114,7,17,false,7,8,1,41.94935,-87.65451
TA1307000126,7,17,false,127,213,86,41.94936,-87.65451
232,7,17,false,5,14,9,41.94943,-87.64645
TA1307000150,7,17,false,130,142,12,41.94945,-87.64646
18016,7,17,false,5,6,1,41.94993,-87.71395
347,7,17,false,3,2,-1,41.95068,-87.6687
13319,7,17,false,25,30,5,41.95069,-87.6687
TA1307000127,7,17,false,89,100,11,41.9508,-87.65918
165,7,17,false,4,11,7,41.95081,-87.65918
15628,7,17,false,8,13,5,41.95216,-87.69806
318,7,17,false,4,1,-3,41.95254,-87.6735
256,7,17,false,10,5,-5,41.95282,-87.65
13323,7,17,false,42,46,4,41.95282,-87.65
15624,7,17,false,6,9,3,41.95339,-87.73199
483,7,17,false,2,2,0,41.9534,-87.73199
314,7,17,false,1,1,0,41.9535,-87.69199
485,7,17,false,1,1,0,41.95361,-87.70933
KA1504000096,7,17,false,11,7,-4,41.95361,-87.70932
590,7,17,false,4,4,0,41.95374,-87.74056
KA1504000139,7,17,false,6,4,-2,41.954,-87.71909
TA1309000043,7,17,false,35,37,2,41.95417,-87.66434
240,7,17,false,4,6,2,41.95424,-87.65441
13063,7,17,false,45,69,24,41.95424,-87.65441
KA1504000158,7,17,false,9,7,-2,41.95432,-87.68607
254,7,17,false,14,15,1,41.95438,-87.64806
TA1308000022,7,17,false,87,118,31,41.95438,-87.64805
589,7,17,false,2,1,-1,41.95447,-87.7496
16991,7,17,false,1,3,2,41.95448,-87.7496
244,7,17,false,3,2,-1,41.95466,-87.67391
TA1307000149,7,17,false,25,12,-13,41.95467,-87.67392
298,7,17,false,1,1,0,41.95601,-87.68021
TA1309000026,7,17,false,20,27,7,41.95601,-87.6802
13249,7,17,false,17,13,-4,41.95606,-87.66885
246,7,17,false,1,1,0,41.95606,-87.66885
312,7,17,false,10,13,3,41.95637,-87.6563
TA1308000047,7,17,false,21,19,-2,41.95709,-87.6642
292,7,17,false,1,3,2,41.95709,-87.6642
13379,7,17,false,50,56,6,41.95786,-87.6495
TA1309000018,7,17,false,10,9,-1,41.95791,-87.67357
316,7,17,false,3,1,-2,41.95841,-87.69401
306,7,17,false,1,3,2,41.9585,-87.655
TA1309000027,7,17,false,27,42,15,41.9585,-87.65499
592,7,17,false,1,4,3,41.96065,-87.74538
13389,7,17,false,64,91,27,41.961,-87.64958
245,7,17,false,8,11,3,41.96101,-87.64958
15621,7,17,false,10,9,-1,41.96103,-87.70586
480,7,17,false,1,2,1,41.96104,-87.70586
KA1706005015,7,17,false,2,4,2,41.96108,-87.73569
15622,7,17,false,15,16,1,41.96108,-87.69544
KA1504000164,7,17,false,3,3,0,41.96109,-87.72897
479,7,17,false,1,1,0,41.96116,-87.71658
KA1504000097,7,17,false,5,10,5,41.96116,-87.71658
TA1307000144,7,17,false,11,27,16,41.96142,-87.6762
297,7,17,false,2,6,4,41.9615,-87.67141
TA1309000021,7,17,false,18,7,-11,41.9615,-87.6714
15623,7,17,false,5,13,8,41.96154,-87.69117
KA1503000022,7,17,false,22,19,-3,41.96158,-87.66609
231,7,17,false,4,13,9,41.96163,-87.65464
TA1307000107,7,17,false,55,88,33,41.96164,-87.65464
TA1307000156,7,17,false,12,38,26,41.96301,-87.68479
243,7,17,false,3,2,-1,41.96302,-87.68479
TA1309000012,7,17,false,7,10,3,41.96325,-87.67928
TA1308000012,7,17,false,342,246,-96,41.96398,-87.63818
249,7,17,false,17,23,6,41.96398,-87.63818
293,7,17,false,4,6,2,41.96521,-87.65822
13074,7,17,false,35,41,6,41.96521,-87.6582
639,7,17,false,129,117,-12,41.96584,-87.64538
477,7,17,false,1,1,0,41.96587,-87.70083
KA1504000127,7,17,false,1,3,2,41.96587,-87.70083
KA1504000093,7,17,false,7,12,5,41.96587,-87.69365
TA1307000140,7,17,false,29,28,-1,41.96643,-87.68865
326,7,17,false,8,6,-2,41.96665,-87.67113
KA1504000126,7,17,false,9,8,-1,41.96668,-87.70807
476,7,17,false,5,5,0,41.96668,-87.70807
TA1309000014,7,17,false,35,50,15,41.96709,-87.66744
242,7,17,false,1,4,3,41.9671,-87.67904
TA1307000158,7,17,false,20,25,5,41.9671,-87.67904
TA1307000119,7,17,false,48,43,-5,41.96796,-87.65
251,7,17,false,4,4,0,41.96796,-87.65
15615,7,17,false,5,3,-2,41.96835,-87.71183
323,7,17,false,4,9,5,41.96869,-87.66034
253,7,17,false,3,4,1,41.96883,-87.65765
TA1308000021,7,17,false,28,36,8,41.96883,-87.65765
KA1504000080,7,17,false,9,11,2,41.96887,-87.69609
TA1309000015,7,17,false,9,23,14,41.96889,-87.68401
344,7,17,false,3,2,-1,41.9691,-87.67423
TA1309000066,7,17,false,43,44,1,41.9691,-87.67423
TA1309000041,7,17,false,34,18,-16,41.96951,-87.65471
KA1504000171,7,17,false,99,82,-17,41.97161,-87.65016
465,7,17,false,3,13,10,41.97161,-87.65016
325,7,17,false,4,5,1,41.9728,-87.67186
TA1309000035,7,17,false,72,55,-17,41.97335,-87.66785
295,7,17,false,3,4,1,41.97378,-87.65972
13108,7,17,false,44,63,19,41.97379,-87.65971
KA1504000078,7,17,false,10,23,13,41.97491,-87.69258
KA1504000149,7,17,false,22,15,-7,41.97562,-87.67945
464,7,17,false,2,2,0,41.97562,-87.67945
KA1504000160,7,17,false,9,19,10,41.97564,-87.70143
470,7,17,false,5,1,-4,41.97567,-87.70927
KA1504000128,7,17,false,3,6,3,41.97567,-87.70927
463,7,17,false,9,2,-7,41.978,-87.66805
KA1504000146,7,17,false,58,60,2,41.978,-87.66805
294,7,17,false,4,5,1,41.97835,-87.65976
13109,7,17,false,44,46,2,41.97835,-87.65976
KA1504000147,7,17,false,11,7,-4,41.97976,-87.67754
655,7,17,false,21,9,-12,41.97987,-87.68194
KA1504000161,7,17,false,7,9,2,41.98038,-87.71612
KA1504000167,7,17,false,1,10,9,41.98206,-87.70895
494,7,17,false,2,4,2,41.98234,-87.70892
460,7,17,false,1,3,2,41.98358,-87.66916
KA1504000151,7,17,false,25,36,11,41.98359,-87.66916
468,7,17,false,4,2,-2,41.98367,-87.69642
15585,7,17,false,9,12,3,41.98367,-87.69642
KA1504000152,7,17,false,171,154,-17,41.98403,-87.65231
459,7,17,false,18,17,-1,41.98403,-87.65231
15578,7,17,false,54,29,-25,41.98405,-87.66027
461,7,17,false,2,2,0,41.98405,-87.66027
15575,7,17,false,34,48,14,41.98975,-87.66014
458,7,17,false,4,9,5,41.98975,-87.66013
KA1504000130,7,17,false,5,3,-2,41.99024,-87.69338
457,7,17,false,4,2,-2,41.99052,-87.66982
KA1504000148,7,17,false,9,17,8,41.99086,-87.66971
452,7,17,false,1,3,2,41.99417,-87.68945
KA1504000129,7,17,false,4,10,6,41.99417,-87.68945
15571,7,17,false,22,42,20,41.99478,-87.66028
454,7,17,false,5,11,6,41.99478,-87.66027
453,7,17,false,3,3,0,41.99925,-87.67137
KA1504000156,7,17,false,12,13,1,41.99925,-87.67137
RP-009,7,17,false,20,36,16,42.00107,-87.66122
451,7,17,false,3,5,2,42.00108,-87.66123
RP-001,7,17,false,21,13,-8,42.00179,-87.68883
449,7,17,false,4,3,-1,42.00446,-87.67241
RP-008,7,17,false,11,11,0,42.00446,-87.6724
RP-002,7,17,false,11,12,1,42.00456,-87.68065
660,7,17,false,11,11,0,42.00458,-87.66143
KA1504000175,7,17,false,10,20,10,42.00797,-87.66549
RP-005,7,17,false,1,4,3,42.0086,-87.69047
KA1504000162,7,17,false,5,4,-1,42.00907,-87.67422
KA1504000159,7,17,false,24,16,-8,42.01059,-87.66241
RP-006,7,17,false,3,6,3,42.01213,-87.68292
RP-004,7,17,false,1,2,1,42.01234,-87.68825
RP-007,7,17,false,1,2,1,42.01256,-87.67431
525,7,17,false,12,8,-4,42.01272,-87.66605
517,7,17,false,3,5,2,42.01597,-87.675
520,7,17,false,14,19,5,42.01597,-87.66859
519,7,17,false,1,1,0,42.01696,-87.67773
527,7,17,false,7,6,-1,42.01892,-87.69004
515,7,17,false,7,1,-6,42.01915,-87.67356
514,7,17,false,1,4,3,42.01927,-87.68452
16806,7,17,false,2,3,1,42.01953,-87.66955
523,7,17,false,10,11,1,42.02089,-87.66505
662,7,17,false,6,3,-3,42.02354,-87.69961
598,7,17,false,2,2,0,42.02578,-87.68411
597,7,17,false,3,6,3,42.03256,-87.67914
E002,7,17,false,18,22,4,42.03256,-87.67912
E011,7,17,false,5,2,-3,42.03473,-87.69912
599,7,17,false,11,12,1,42.03972,-87.69942
625,7,17,false,3,3,0,42.04163,-87.6808
596,7,17,false,36,28,-8,42.04822,-87.68348
600,7,17,false,6,7,1,42.04831,-87.6983
E008,7,17,false,37,45,8,42.05049,-87.67782
605,7,17,false,19,29,10,42.05294,-87.67342
661,7,17,false,7,9,2,42.05704,-87.68657
604,7,17,false,25,38,13,42.05824,-87.67744
E006,7,17,false,9,7,-2,42.06367,-87.69871
601,7,17,false,2,2,0,42.06368,-87.69871
E007,7,17,false,3,1,-2,42.06431,-87.68615
20218,7,17,true,1,1,0,41.68103,-87.53798
713,7,17,true,1,1,0,41.68496,-87.6453
20222,7,17,true,1,2,1,41.7046,-87.52832
20224,7,17,true,1,1,0,41.71371,-87.53083
20239,7,17,true,1,1,0,41.73367,-87.5584
586,7,17,true,1,1,0,41.74311,-87.61481
582,7,17,true,1,1,0,41.74453,-87.56508
TA1309000051,7,17,true,1,1,0,41.74462,-87.55121
KA1503000028,7,17,true,1,1,0,41.75712,-87.57585
569,7,17,true,1,1,0,41.75918,-87.59576
KA1503000020,7,17,true,4,1,-3,41.76223,-87.55923
KA1503000002,7,17,true,14,9,-5,41.76641,-87.5657
12,7,17,true,3,2,-1,41.76641,-87.5657
KA1503000018,7,17,true,2,2,0,41.76663,-87.57645
KA1503000029,7,17,true,3,5,2,41.77364,-87.56747
KA1503000031,7,17,true,1,3,2,41.77373,-87.60564
16948,7,17,true,1,2,1,41.77937,-87.6649
KA1503000053,7,17,true,1,1,0,41.78009,-87.61595
KA1503000046,7,17,true,1,2,1,41.78041,-87.59141
653,7,17,true,1,2,1,41.78059,-87.58491
15491,7,17,true,10,11,1,41.78096,-87.57624
101,7,17,true,2,1,-1,41.78105,-87.57611
426,7,17,true,11,12,1,41.7851,-87.60108
KA1503000014,7,17,true,52,85,33,41.7851,-87.60108
593,7,17,true,1,1,0,41.78756,-87.64488
KA1503000070,7,17,true,8,12,4,41.78794,-87.58831
425,7,17,true,1,4,3,41.78795,-87.58831
328,7,17,true,5,5,0,41.78872,-87.6013
TA1309000011,7,17,true,24,19,-5,41.78873,-87.60131
KA1503000071,7,17,true,43,39,-4,41.79148,-87.59988
423,7,17,true,9,7,-2,41.79148,-87.59988
424,7,17,true,6,4,-2,41.79174,-87.58395
KA1503000074,7,17,true,28,26,-2,41.79174,-87.58395
386,7,17,true,1,1,0,41.793,-87.64502
TA1309000063,7,17,true,27,35,8,41.79325,-87.5878
345,7,17,true,1,2,1,41.79326,-87.5878
KA1503000073,7,17,true,2,1,-1,41.79345,-87.61585
385,7,17,true,1,1,0,41.79419,-87.64526
420,7,17,true,11,6,-5,41.79429,-87.60145
KA1504000076,7,17,true,59,31,-28,41.7943,-87.60145
247,7,17,true,14,13,-1,41.79522,-87.58077
TA1308000009,7,17,true,76,77,1,41.79522,-87.58075
TA1307000164,7,17,true,30,33,3,41.79527,-87.59647
248,7,17,true,3,3,0,41.79528,-87.59647
KA1503000052,7,17,true,31,33,2,41.79935,-87.60097
418,7,17,true,3,7,4,41.79936,-87.60097
419,7,17,true,6,5,-1,41.79952,-87.58643
KA1503000059,7,17,true,18,42,24,41.79952,-87.58643
TA1309000037,7,17,true,78,66,-12,41.79957,-87.59474
15470,7,17,true,4,3,-1,41.80228,-87.61807
417,7,17,true,4,12,8,41.80242,-87.5869
KA1503000007,7,17,true,34,48,14,41.80242,-87.58689
121,7,17,true,4,2,-2,41.80256,-87.59035
13398,7,17,true,19,22,3,41.80256,-87.59035
TA1309000067,7,17,true,6,6,0,41.80303,-87.60661
322,7,17,true,14,12,-2,41.80321,-87.59849
416,7,17,true,2,2,0,41.80578,-87.59247
KA1503000069,7,17,true,8,11,3,41.80579,-87.59247
KA1503000051,7,17,true,2,1,-1,41.80815,-87.64563
KA1504000091,7,17,true,3,3,0,41.80823,-87.6772
552,7,17,true,2,2,0,41.80887,-87.66452
TA1308000035,7,17,true,16,14,-2,41.80944,-87.59188
252,7,17,true,2,1,-1,41.80982,-87.59936
TA1308000002,7,17,true,3,5,2,41.80983,-87.59937
TA1308000007,7,17,true,2,1,-1,41.80984,-87.61628
TA1309000053,7,17,true,7,7,0,41.80985,-87.60675
KA1503000065,7,17,true,10,14,4,41.81409,-87.59701
271,7,17,true,1,1,0,41.81648,-87.60659
410,7,17,true,3,1,-2,41.81666,-87.61942
KA1503000027,7,17,true,1,1,0,41.81666,-87.61942
KA1503000032,7,17,true,2,2,0,41.81912,-87.64328
408,7,17,true,1,1,0,41.81914,-87.64328
13083,7,17,true,2,2,0,41.82167,-87.62153
201,7,17,true,1,1,0,41.82168,-87.6215
TA1308000038,7,17,true,10,8,-2,41.82298,-87.6071
407,7,17,true,1,1,0,41.82303,-87.62658
547,7,17,true,1,1,0,41.82346,-87.66558
16933,7,17,true,2,2,0,41.82362,-87.65093
13420,7,17,true,8,6,-2,41.82459,-87.61678
18022,7,17,true,1,1,0,41.82672,-87.68315
TA1307000161,7,17,true,2,3,1,41.82707,-87.64572
KA1503000066,7,17,true,4,3,-1,41.83011,-87.67031
TA1308000045,7,17,true,15,10,-5,41.83062,-87.64129
278,7,17,true,2,2,0,41.83062,-87.64129
TA1308000043,7,17,true,12,7,-5,41.83066,-87.64715
15446,7,17,true,1,4,3,41.83068,-87.65603
KA1503000005,7,17,true,11,5,-6,41.83079,-87.6325
TA1307000129,7,17,true,6,6,0,41.83104,-87.62683
406,7,17,true,1,3,2,41.83127,-87.6088
KA1503000004,7,17,true,8,10,2,41.83127,-87.6088
13345,7,17,true,11,4,-7,41.83138,-87.61803
15445,7,17,true,32,15,-17,41.83453,-87.63183
13216,7,17,true,44,37,-7,41.83473,-87.62581
148,7,17,true,7,3,-4,41.83474,-87.62581
149,7,17,true,9,2,-7,41.83486,-87.61791
13217,7,17,true,26,38,12,41.83488,-87.61792
13215,7,17,true,20,13,-7,41.83634,-87.6135
263,7,17,true,3,5,2,41.8364,-87.61348
280,7,17,true,6,2,-4,41.83779,-87.65116
TA1308000046,7,17,true,13,25,12,41.83779,-87.65115
339,7,17,true,6,6,0,41.83817,-87.64523
TA1309000055,7,17,true,29,39,10,41.8382,-87.64514
KA1503000038,7,17,true,19,18,-1,41.83845,-87.6354
402,7,17,true,1,7,6,41.83845,-87.6354
TA1307000048,7,17,true,64,60,-4,41.83855,-87.60821
150,7,17,true,12,15,3,41.83855,-87.60821
272,7,17,true,3,5,2,41.83882,-87.62186
TA1308000036,7,17,true,22,15,-7,41.83883,-87.62186
368,7,17,true,2,1,-1,41.83915,-87.66562
15442,7,17,true,2,3,1,41.83918,-87.66562
KA1503000040,7,17,true,9,8,-1,41.84164,-87.65744
237,7,17,true,10,13,3,41.84204,-87.61697
TA1307000139,7,17,true,41,39,-2,41.84205,-87.61698
15443,7,17,true,12,11,-1,41.84275,-87.63549
207,7,17,true,5,3,-2,41.84358,-87.64539
TA1307000153,7,17,true,10,21,11,41.84358,-87.64538
147,7,17,true,2,5,3,41.84569,-87.62251
TA1307000005,7,17,true,14,18,4,41.84569,-87.6225
TA1308000013,7,17,true,3,5,2,41.84719,-87.64681
15689,7,17,true,4,5,1,41.84912,-87.69515
TA1308000014,7,17,true,5,6,1,41.84953,-87.64059
132,7,17,true,4,1,-3,41.85008,-87.63215
TA1308000026,7,17,true,5,11,6,41.85008,-87.63214
TA1305000004,7,17,true,4,5,1,41.8514,-87.61884
62,7,17,true,1,1,0,41.85141,-87.61884
42,7,17,true,5,2,-3,41.85261,-87.62653
TA1305000001,7,17,true,12,16,4,41.85262,-87.6265
13075,7,17,true,80,56,-24,41.8531,-87.63192
120,7,17,true,5,9,4,41.8531,-87.63191
135,7,17,true,1,2,1,41.85367,-87.64652
13162,7,17,true,7,6,-1,41.85378,-87.64659
13096,7,17,true,5,5,0,41.8538,-87.69577
13091,7,17,true,9,8,-1,41.85409,-87.68585
203,7,17,true,1,2,1,41.85409,-87.68585
15546,7,17,true,11,28,17,41.85416,-87.61916
351,7,17,true,3,2,-1,41.85441,-87.67678
13307,7,17,true,13,9,-4,41.85489,-87.66359
208,7,17,true,2,3,1,41.85489,-87.66359
13089,7,17,true,8,11,3,41.85497,-87.67567
13331,7,17,true,6,8,2,41.85515,-87.65414
171,7,17,true,3,2,-1,41.85516,-87.65414
15545,7,17,true,132,120,-12,41.85627,-87.61334
4,7,17,true,27,26,-1,41.85627,-87.61334
178,7,17,true,1,4,3,41.85657,-87.62755
SL-013,7,17,true,13,13,0,41.85659,-87.62755
218,7,17,true,3,1,-2,41.85679,-87.63387
SL-006,7,17,true,23,12,-11,41.8568,-87.63387
129,7,17,true,5,9,4,41.85752,-87.66158
202,7,17,true,1,5,4,41.85752,-87.64621
13135,7,17,true,19,22,3,41.85753,-87.66157
338,7,17,true,6,11,5,41.85758,-87.61956
13102,7,17,true,47,48,1,41.85762,-87.61942
273,7,17,true,12,10,-2,41.85783,-87.62455
13150,7,17,true,45,59,14,41.85783,-87.62455
13099,7,17,true,9,16,7,41.85784,-87.64627
205,7,17,true,3,2,-1,41.8579,-87.6687
TA1307000159,7,17,true,13,12,-1,41.8579,-87.6687
170,7,17,true,2,2,0,41.85793,-87.64083
TA1307000044,7,17,true,6,12,6,41.85794,-87.64083
14,7,17,true,2,4,2,41.85808,-87.65109
13163,7,17,true,20,14,-6,41.85808,-87.65108
13164,7,17,true,20,32,12,41.85818,-87.65648
15,7,17,true,2,2,0,41.85819,-87.65648
SL-012,7,17,true,27,38,11,41.86038,-87.62581
72,7,17,true,5,12,7,41.86039,-87.62581
13304,7,17,true,10,10,0,41.86126,-87.65659
KA1504000109,7,17,true,3,7,4,41.86192,-87.69347
137,7,17,true,1,3,2,41.86238,-87.65108
TA1306000002,7,17,true,15,18,3,41.86238,-87.65108
TA1307000124,7,17,true,44,72,28,41.86411,-87.62372
168,7,17,true,4,13,9,41.86415,-87.62372
282,7,17,true,5,5,0,41.86487,-87.64708
TA1309000001,7,17,true,17,23,6,41.86488,-87.64708
13165,7,17,true,1,2,1,41.86505,-87.65697
275,7,17,true,12,3,-9,41.86524,-87.66651
13354,7,17,true,28,41,13,41.86524,-87.66651
13029,7,17,true,16,25,9,41.86531,-87.6179
341,7,17,true,16,10,-6,41.86608,-87.60733
13431,7,17,true,90,75,-15,41.8661,-87.60728
KA1504000101,7,17,true,8,11,3,41.86651,-87.68466
434,7,17,true,1,4,3,41.86651,-87.68465
WL-008,7,17,true,37,39,2,41.86712,-87.64108
57,7,17,true,11,7,-4,41.86712,-87.64107
59,7,17,true,23,16,-7,41.86721,-87.62597
TA1305000002,7,17,true,91,113,22,41.86721,-87.62597
15544,7,17,true,53,48,-5,41.86723,-87.61536
3,7,17,true,3,3,0,41.86723,-87.61536
TA1305000017,7,17,true,11,13,2,41.86734,-87.64863
55,7,17,true,3,3,0,41.86735,-87.64863
626,7,17,true,6,3,-3,41.86749,-87.63219
KA1706005007,7,17,true,30,42,12,41.86749,-87.63219
SL-005,7,17,true,98,135,37,41.8679,-87.62304
255,7,17,true,14,30,16,41.86791,-87.62304
644,7,17,true,48,34,-14,41.86859,-87.68625
19,7,17,true,7,10,3,41.86892,-87.65913
13139,7,17,true,30,30,0,41.86893,-87.65913
13285,7,17,true,16,8,-8,41.86928,-87.67372
13160,7,17,true,40,34,-6,41.86947,-87.65548
22,7,17,true,9,6,-3,41.86947,-87.65548
382,7,17,true,2,2,0,41.8699,-87.68725
414,7,17,true,5,3,-2,41.87023,-87.63947
15550,7,17,true,31,19,-12,41.87024,-87.63947
TA1309000010,7,17,true,65,68,3,41.87074,-87.62574
SL-009,7,17,true,24,19,-5,41.87081,-87.63121
342,7,17,true,6,7,1,41.87127,-87.6737
TA1309000064,7,17,true,24,23,-1,41.87127,-87.67369
15542,7,17,true,5,3,-2,41.87146,-87.64095
261,7,17,true,5,4,-1,41.87151,-87.6699
TA1307000130,7,17,true,47,47,0,41.87178,-87.65103
241,7,17,true,9,10,1,41.8718,-87.65102
108,7,17,true,2,1,-1,41.87183,-87.64664
TA1307000121,7,17,true,33,21,-12,41.87184,-87.64664
41,7,17,true,13,18,5,41.87209,-87.62957
SL-008,7,17,true,92,86,-6,41.87209,-87.62956
13332,7,17,true,69,89,20,41.87219,-87.6615
394,7,17,true,5,3,-2,41.87226,-87.63484
175,7,17,true,7,10,3,41.87255,-87.63359
SL-011,7,17,true,39,65,26,41.87256,-87.63356
623,7,17,true,54,49,-5,41.87272,-87.62399
KA1504000104,7,17,true,26,12,-14,41.87296,-87.66912
383,7,17,true,4,4,0,41.87297,-87.66912
320,7,17,true,13,15,2,41.87327,-87.66402
5,7,17,true,6,2,-4,41.87403,-87.6277
SL-007,7,17,true,33,32,-1,41.87404,-87.6277
13326,7,17,true,8,7,-1,41.87425,-87.63958
321,7,17,true,19,18,-1,41.87427,-87.63257
TA1306000025,7,17,true,21,17,-4,41.87464,-87.65703
32,7,17,true,2,3,1,41.87464,-87.65703
15668,7,17,true,10,14,4,41.87471,-87.68642
13028,7,17,true,25,14,-11,41.87475,-87.64981
109,7,17,true,6,7,1,41.87475,-87.64981
13081,7,17,true,5,6,1,41.87501,-87.67326
122,7,17,true,1,7,6,41.87501,-87.67325
89,7,17,true,4,4,0,41.87501,-87.6331
SL-010,7,17,true,19,37,18,41.87501,-87.63309
15541,7,17,true,33,32,-1,41.8758,-87.62086
13037,7,17,true,13,14,1,41.87588,-87.64078
50,7,17,true,3,5,2,41.87592,-87.6307
TA1305000009,7,17,true,15,17,2,41.87593,-87.63068
317,7,17,true,5,3,-2,41.87603,-87.68195
TA1305000010,7,17,true,24,19,-5,41.87623,-87.62444
45,7,17,true,5,1,-4,41.87623,-87.62444
624,7,17,true,26,20,-6,41.87626,-87.62923
2,7,17,true,3,3,0,41.87649,-87.62051
33,7,17,true,2,2,0,41.87715,-87.62786
TA1305000035,7,17,true,19,11,-8,41.87716,-87.62787
13138,7,17,true,15,4,-11,41.87723,-87.63941
75,7,17,true,4,2,-2,41.87724,-87.63937
631,7,17,true,4,7,3,41.87761,-87.6739
15539,7,17,true,62,70,8,41.87763,-87.64405
13158,7,17,true,61,51,-10,41.87764,-87.64957
134,7,17,true,5,7,2,41.87764,-87.64954
13157,7,17,true,56,62,6,41.87773,-87.6548
21,7,17,true,15,21,6,41.87773,-87.6548
TA1305000025,7,17,true,45,53,8,41.87773,-87.63528
36,7,17,true,5,10,5,41.87776,-87.63525
284,7,17,true,7,4,-3,41.87784,-87.62408
TA1309000002,7,17,true,18,20,2,41.87784,-87.62408
146,7,17,true,6,2,-4,41.87794,-87.66201
13206,7,17,true,36,41,5,41.87794,-87.66201
TA1309000004,7,17,true,10,4,-6,41.87811,-87.63184
107,7,17,true,12,18,6,41.87822,-87.644
638,7,17,true,48,23,-25,41.87827,-87.64078
TA1305000005,7,17,true,20,11,-9,41.87924,-87.62975
13011,7,17,true,35,35,0,41.87931,-87.63993
TA1309000008,7,17,true,15,3,-12,41.87933,-87.6355
192,7,17,true,10,3,-7,41.87935,-87.63997
KA1503000034,7,17,true,13,2,-11,41.87938,-87.63197
39,7,17,true,1,1,0,41.87948,-87.62571
KA1503000015,7,17,true,21,17,-4,41.87948,-87.6257
15667,7,17,true,17,16,-1,41.8798,-87.68609
16916,7,17,true,2,2,0,41.88012,-87.76323
287,7,17,true,3,2,-1,41.88017,-87.63527
TA1309000007,7,17,true,10,4,-6,41.88022,-87.63526
16918,7,17,true,2,2,0,41.88028,-87.77447
WL-011,7,17,true,48,45,-3,41.88034,-87.64273
73,7,17,true,8,15,7,41.8804,-87.64273
80,7,17,true,4,4,0,41.88042,-87.65556
13156,7,17,true,40,40,0,41.88042,-87.65554
534,7,17,true,1,1,0,41.88085,-87.72793
13300,7,17,true,184,169,-15,41.88097,-87.61675
76,7,17,true,9,6,-3,41.88098,-87.61675
13008,7,17,true,98,70,-28,41.88105,-87.62408
90,7,17,true,9,17,8,41.88107,-87.62409
49,7,17,true,11,3,-8,41.88116,-87.62963
TA1305000006,7,17,true,51,43,-8,41.88122,-87.6296
13134,7,17,true,6,17,11,41.88138,-87.67493
215,7,17,true,1,2,1,41.88139,-87.67492
13056,7,17,true,12,7,-5,41.88168,-87.63951
198,7,17,true,28,27,-1,41.88187,-87.6488
TA1307000120,7,17,true,114,140,26,41.88188,-87.64879
13341,7,17,true,34,22,-12,41.88208,-87.63985
174,7,17,true,7,3,-4,41.88208,-87.63984
197,7,17,true,8,4,-4,41.88208,-87.62513
13036,7,17,true,42,36,-6,41.8821,-87.62513
77,7,17,true,17,28,11,41.88214,-87.64108
TA1305000032,7,17,true,77,80,3,41.88218,-87.64109
98,7,17,true,2,7,5,41.88266,-87.63251
13006,7,17,true,12,12,0,41.88268,-87.63252
13353,7,17,true,40,24,-16,41.88283,-87.6612
346,7,17,true,5,9,4,41.88284,-87.6612
654,7,17,true,23,20,-3,41.88307,-87.65698
233,7,17,true,7,7,0,41.88309,-87.6511
13409,7,17,true,29,30,1,41.8831,-87.6511
18,7,17,true,4,2,-2,41.88317,-87.63735
KA1503000072,7,17,true,13,13,0,41.88317,-87.63693
91,7,17,true,5,2,-3,41.88336,-87.64122
WL-012,7,17,true,28,16,-12,41.88337,-87.6412
112,7,17,true,10,19,9,41.88362,-87.6486
13053,7,17,true,92,97,5,41.88365,-87.64863
43,7,17,true,9,3,-6,41.88396,-87.62455
13001,7,17,true,74,50,-24,41.88397,-87.62459
13155,7,17,true,14,21,7,41.88407,-87.65689
621,7,17,true,5,6,1,41.88412,-87.65427
18062,7,17,true,32,41,9,41.88412,-87.65427
81,7,17,true,15,9,-6,41.88417,-87.6296
TA1306000010,7,17,true,64,84,20,41.88419,-87.62961
15666,7,17,true,1,2,1,41.88446,-87.6963
KA1504000106,7,17,true,3,1,-2,41.88459,-87.70631
TA1305000030,7,17,true,33,22,-11,41.88459,-87.63178
96,7,17,true,8,12,4,41.8846,-87.64455
15535,7,17,true,47,78,31,41.8846,-87.64455
51,7,17,true,3,2,-1,41.88462,-87.63176
TA1305000029,7,17,true,77,94,17,41.88466,-87.62787
195,7,17,true,22,25,3,41.88466,-87.61952
13263,7,17,true,103,87,-16,41.88467,-87.61952
44,7,17,true,16,15,-1,41.88468,-87.62782
528,7,17,true,2,2,0,41.88537,-87.72661
TA1306000015,7,17,true,52,88,36,41.88549,-87.65232
518,7,17,true,4,1,-3,41.8855,-87.71686
71,7,17,true,6,7,1,41.8855,-87.65233
66,7,17,true,7,11,4,41.88557,-87.64186
13021,7,17,true,41,55,14,41.88559,-87.64184
TA1307000111,7,17,true,30,26,-4,41.88582,-87.63548
164,7,17,true,10,8,-2,41.88583,-87.63547
13073,7,17,true,16,23,7,41.88592,-87.66717
119,7,17,true,3,1,-2,41.88593,-87.66717
KA17018054,7,17,true,19,10,-9,41.88595,-87.67701
KA1503000012,7,17,true,57,48,-9,41.88599,-87.63089
38,7,17,true,10,10,0,41.88599,-87.63089
52,7,17,true,8,15,7,41.886,-87.62421
TA1305000011,7,17,true,49,57,8,41.886,-87.62418
7,7,17,true,3,16,13,41.88627,-87.61751
15534,7,17,true,60,70,10,41.88627,-87.61749
217,7,17,true,1,4,3,41.8866,-87.65821
13197,7,17,true,7,15,8,41.8866,-87.65816
264,7,17,true,1,7,6,41.8867,-87.62224
TA1308000029,7,17,true,27,23,-4,41.88673,-87.62225
TA1307000131,7,17,true,50,34,-16,41.88688,-87.62606
194,7,17,true,5,4,-1,41.88688,-87.62606
6,7,17,true,8,2,-6,41.88697,-87.61281
KA1503000064,7,17,true,85,94,9,41.88697,-87.61281
16906,7,17,true,2,2,0,41.88792,-87.77445
100,7,17,true,6,10,4,41.88814,-87.63657
TA1305000022,7,17,true,43,35,-8,41.88817,-87.63656
56,7,17,true,28,38,10,41.88866,-87.64442
TA1306000003,7,17,true,121,145,24,41.88867,-87.64442
133,7,17,true,16,23,7,41.88918,-87.63851
KA1503000043,7,17,true,96,105,9,41.88918,-87.63851
13050,7,17,true,59,43,-16,41.88919,-87.62775
47,7,17,true,9,11,2,41.88921,-87.62775
15664,7,17,true,7,3,-4,41.8895,-87.68821
376,7,17,true,3,2,-1,41.88951,-87.68818
13432,7,17,true,32,25,-7,41.88989,-87.67149
285,7,17,true,1,3,2,41.88989,-87.67149
TA1307000151,7,17,true,70,73,3,41.88993,-87.63427
212,7,17,true,12,12,0,41.88995,-87.63427
636,7,17,true,56,46,-10,41.88997,-87.63662
125,7,17,true,3,11,8,41.89018,-87.62621
KA1503000044,7,17,true,19,20,1,41.89018,-87.6262
KA1504000113,7,17,true,3,6,3,41.89049,-87.70262
196,7,17,true,9,5,-4,41.89053,-87.62205
13427,7,17,true,39,38,-1,41.89054,-87.62205
26,7,17,true,19,13,-6,41.89057,-87.61798
13430,7,17,true,89,73,-16,41.89077,-87.63169
181,7,17,true,11,9,-2,41.89077,-87.63168
TA1306000013,7,17,true,82,95,13,41.89083,-87.61852
RN-,7,17,true,81,85,4,41.89102,-87.63546
672,7,17,true,10,11,1,41.89102,-87.63545
277,7,17,true,3,9,6,41.89108,-87.66665
13434,7,17,true,20,31,11,41.89108,-87.66663
TA1308000006,7,17,true,15,21,6,41.89128,-87.67686
199,7,17,true,37,37,0,41.89143,-87.62676
TA1307000117,7,17,true,163,115,-48,41.89144,-87.62675
13033,7,17,true,77,95,18,41.8916,-87.64835
214,7,17,true,2,3,1,41.89161,-87.67688
84,7,17,true,12,18,6,41.89161,-87.64833
186,7,17,true,7,11,4,41.8918,-87.65879
13194,7,17,true,47,58,11,41.8918,-87.65878
TA1305000003,7,17,true,120,95,-25,41.89187,-87.62061
24,7,17,true,20,15,-5,41.8919,-87.62063
643,7,17,true,21,15,-6,41.89203,-87.68939
35,7,17,true,22,14,-8,41.89227,-87.61206
13022,7,17,true,217,176,-41,41.89227,-87.61205
99,7,17,true,13,20,7,41.89255,-87.61449
TA1306000029,7,17,true,97,98,1,41.89256,-87.61449
13265,7,17,true,91,92,1,41.89383,-87.64172
74,7,17,true,13,20,7,41.89384,-87.64173
13045,7,17,true,133,155,22,41.89403,-87.62931
110,7,17,true,27,27,0,41.89406,-87.6293
13016,7,17,true,64,49,-15,41.89431,-87.62277
211,7,17,true,20,17,-3,41.89439,-87.62267
KA1503000041,7,17,true,53,65,12,41.89452,-87.61798
142,7,17,true,9,15,6,41.89453,-87.61806
92,7,17,true,7,5,-2,41.89455,-87.65346
13196,7,17,true,36,40,4,41.89455,-87.65345
TA1307000062,7,17,true,40,37,-3,41.89466,-87.63839
111,7,17,true,6,12,6,41.89466,-87.63837
TA1306000012,7,17,true,106,125,19,41.89475,-87.63438
53,7,17,true,6,24,18,41.89476,-87.63439
627,7,17,true,17,16,-1,41.8948,-87.63231
KP1705001026,7,17,true,43,66,23,41.89483,-87.6323
16921,7,17,true,1,2,1,41.89488,-87.77459
16920,7,17,true,4,3,-1,41.89495,-87.76491
550,7,17,true,1,1,0,41.89495,-87.76491
KA1504000114,7,17,true,3,3,0,41.89547,-87.70614
659,7,17,true,2,5,3,41.8955,-87.68201
18058,7,17,true,19,29,10,41.8955,-87.68201
637,7,17,true,18,32,14,41.89563,-87.67209
128,7,17,true,10,9,-1,41.89571,-87.67716
13132,7,17,true,54,64,10,41.89573,-87.67718
161,7,17,true,13,23,10,41.89574,-87.62599
15530,7,17,true,70,81,11,41.89575,-87.62596
18003,7,17,true,29,17,-12,41.89575,-87.62011
635,7,17,true,7,7,0,41.89576,-87.62012
13247,7,17,true,28,41,13,41.89597,-87.66775
350,7,17,true,8,10,2,41.89597,-87.66774
TA1305000020,7,17,true,64,48,-16,41.89636,-87.65406
54,7,17,true,5,4,-1,41.89637,-87.65407
13289,7,17,true,31,56,25,41.89638,-87.661
86,7,17,true,7,8,1,41.89639,-87.661
337,7,17,true,18,18,0,41.89659,-87.63096
13303,7,17,true,56,69,13,41.89672,-87.63088
13017,7,17,true,33,39,6,41.89676,-87.6357
31,7,17,true,4,7,3,41.89677,-87.63572
13338,7,17,true,55,55,0,41.89697,-87.62173
173,7,17,true,11,9,-2,41.89704,-87.62173
TA1307000061,7,17,true,37,52,15,41.89745,-87.62873
106,7,17,true,9,4,-5,41.89746,-87.62874
25,7,17,true,5,5,0,41.89751,-87.62354
13034,7,17,true,54,36,-18,41.89754,-87.62352
48,7,17,true,12,8,-4,41.89772,-87.64302
TA1306000009,7,17,true,41,34,-7,41.89772,-87.64299
620,7,17,true,38,51,13,41.89817,-87.63754
374,7,17,true,3,9,6,41.89842,-87.68659
KA1504000103,7,17,true,32,44,12,41.89842,-87.68659
145,7,17,true,9,14,5,41.89856,-87.62211
15529,7,17,true,74,75,1,41.89858,-87.62206
140,7,17,true,24,22,-2,41.89895,-87.6299
TA1307000128,7,17,true,114,100,-14,41.89896,-87.6299
657,7,17,true,33,20,-13,41.89918,-87.6722
KA1504000117,7,17,true,13,10,-3,41.89936,-87.64848
365,7,17,true,2,1,-1,41.89936,-87.64848
30,7,17,true,10,6,-4,41.89964,-87.66789
13248,7,17,true,30,41,11,41.89964,-87.66788
46,7,17,true,5,6,1,41.89994,-87.63444
TA1306000011,7,17,true,43,41,-2,41.89994,-87.63443
364,7,17,true,4,5,1,41.90023,-87.64299
KA1504000116,7,17,true,22,32,10,41.90023,-87.64299
17660,7,17,true,17,33,16,41.90036,-87.69671
622,7,17,true,1,6,5,41.90037,-87.69671
13290,7,17,true,41,32,-9,41.90069,-87.66259
29,7,17,true,4,7,3,41.90069,-87.66259
13042,7,17,true,199,136,-63,41.90097,-87.62377
85,7,17,true,11,14,3,41.90098,-87.62375
183,7,17,true,1,7,6,41.90133,-87.67744
TA1307000070,7,17,true,39,34,-5,41.90133,-87.67742
KA1504000133,7,17,true,94,76,-18,41.90234,-87.62773
172,7,17,true,12,9,-3,41.90236,-87.62774
15654,7,17,true,6,11,5,41.90271,-87.70923
305,7,17,true,2,4,2,41.9028,-87.69005
13241,7,17,true,16,26,10,41.9029,-87.68731
176,7,17,true,37,46,9,41.90291,-87.63141
23,7,17,true,6,1,-5,41.90292,-87.63772
TA1306000006,7,17,true,19,22,3,41.90292,-87.63772
TA1307000039,7,17,true,186,209,23,41.90294,-87.63137
658,7,17,true,20,21,1,41.903,-87.6838
13256,7,17,true,21,13,-8,41.90302,-87.69749
216,7,17,true,2,2,0,41.90302,-87.69749
17,7,17,true,10,11,1,41.90313,-87.67391
TA1305000034,7,17,true,50,63,13,41.90313,-87.67391
182,7,17,true,26,31,5,41.90317,-87.63442
KA1504000135,7,17,true,193,185,-8,41.90319,-87.63439
13136,7,17,true,76,71,-5,41.90326,-87.67845
130,7,17,true,3,5,2,41.90327,-87.67846
210,7,17,true,14,14,0,41.90342,-87.66781
13061,7,17,true,97,124,27,41.90342,-87.66779
KA1504000079,7,17,true,59,59,0,41.9035,-87.64334
359,7,17,true,17,11,-6,41.90458,-87.6497
138,7,17,true,5,4,-1,41.9046,-87.64057
TA1307000115,7,17,true,30,36,6,41.9046,-87.64056
291,7,17,true,14,14,0,41.90672,-87.63494
TA1308000049,7,17,true,111,108,-3,41.90672,-87.6349
KA1504000134,7,17,true,68,61,-7,41.90687,-87.6262
180,7,17,true,15,17,2,41.90687,-87.62618
13224,7,17,true,79,76,-3,41.90706,-87.66725
333,7,17,true,10,12,2,41.90706,-87.66725
18069,7,17,true,5,5,0,41.90722,-87.65563
TA1307000143,7,17,true,23,18,-5,41.90762,-87.63854
236,7,17,true,3,4,1,41.90762,-87.63853
61,7,17,true,12,11,-1,41.90764,-87.67254
13221,7,17,true,74,86,12,41.90765,-87.67254
13245,7,17,true,6,4,-2,41.90777,-87.68586
301,7,17,true,13,18,5,41.90796,-87.63203
TA1309000024,7,17,true,85,86,1,41.908,-87.63152
69,7,17,true,12,10,-2,41.90939,-87.6777
TA1305000041,7,17,true,85,76,-9,41.9094,-87.67769
15652,7,17,true,5,3,-2,41.90965,-87.71664
331,7,17,true,128,127,-1,41.90965,-87.64812
15653,7,17,true,12,11,-1,41.90979,-87.7053
509,7,17,true,2,2,0,41.9098,-87.70531
TA1305000037,7,17,true,35,47,12,41.91018,-87.67003
27,7,17,true,11,5,-6,41.91019,-87.6435
TA1306000008,7,17,true,34,38,4,41.9102,-87.6435
16,7,17,true,8,11,3,41.91035,-87.67008
TA1308000005,7,17,true,30,43,13,41.91042,-87.68238
276,7,17,true,5,5,0,41.91043,-87.69718
13258,7,17,true,10,22,12,41.91043,-87.69718
160,7,17,true,2,6,4,41.91054,-87.68957
13257,7,17,true,18,24,6,41.91054,-87.68956
13154,7,17,true,93,74,-19,41.91054,-87.65312
20,7,17,true,29,15,-14,41.91055,-87.65313
13058,7,17,true,60,60,0,41.91059,-87.64942
60,7,17,true,11,12,1,41.91059,-87.64942
TA1307000038,7,17,true,78,66,-12,41.91138,-87.63868
118,7,17,true,10,15,5,41.91138,-87.63868
LF-005,7,17,true,294,203,-91,41.91172,-87.62681
268,7,17,true,21,22,1,41.91172,-87.62681
126,7,17,true,9,13,4,41.91196,-87.63197
13128,7,17,true,65,64,-1,41.91197,-87.63197
289,7,17,true,24,33,9,41.91209,-87.63472
TA1308000050,7,17,true,174,180,6,41.91211,-87.6347
158,7,17,true,12,5,-7,41.91262,-87.6814
13243,7,17,true,75,72,-3,41.91262,-87.6814
TA1309000032,7,17,true,18,36,18,41.91293,-87.66417
TA1306000032,7,17,true,76,74,-2,41.9137,-87.65285
93,7,17,true,11,9,-2,41.91371,-87.65285
224,7,17,true,5,4,-1,41.91386,-87.64877
TA1307000166,7,17,true,45,50,5,41.91386,-87.64877
511,7,17,true,2,3,1,41.914,-87.70515
15655,7,17,true,18,33,15,41.91401,-87.70514
641,7,17,true,2,1,-1,41.91416,-87.71676
18017,7,17,true,11,11,0,41.91416,-87.71676
18067,7,17,true,34,27,-7,41.9146,-87.66796
628,7,17,true,8,6,-2,41.9146,-87.66796
28,7,17,true,2,6,4,41.91469,-87.64333
TA1306000007,7,17,true,22,29,7,41.91469,-87.64333
13068,7,17,true,48,46,-2,41.91554,-87.68703
116,7,17,true,10,7,-3,41.91555,-87.68703
13179,7,17,true,138,133,-5,41.9157,-87.63461
141,7,17,true,34,31,-3,41.91571,-87.63461
219,7,17,true,10,9,-1,41.91598,-87.67733
13133,7,17,true,45,59,14,41.91598,-87.67733
58,7,17,true,7,5,-2,41.91602,-87.66894
TA1305000039,7,17,true,32,32,0,41.9163,-87.66749
15650,7,17,true,9,15,6,41.91711,-87.71023
507,7,17,true,7,5,-2,41.91752,-87.70181
15651,7,17,true,21,23,2,41.91752,-87.70181
185,7,17,true,3,3,0,41.91774,-87.69143
13266,7,17,true,17,15,-2,41.91774,-87.69142
TA1309000029,7,17,true,28,26,-2,41.9178,-87.68245
309,7,17,true,2,6,4,41.91789,-87.6865
TA1309000006,7,17,true,50,39,-11,41.91809,-87.64375
288,7,17,true,8,5,-3,41.91809,-87.64375
223,7,17,true,5,5,0,41.91821,-87.65698
TA1307000163,7,17,true,37,44,7,41.91821,-87.65696
94,7,17,true,26,20,-6,41.91831,-87.6363
13146,7,17,true,143,149,6,41.91831,-87.63629
13059,7,17,true,77,102,25,41.91845,-87.65222
113,7,17,true,15,15,0,41.91846,-87.65222
13259,7,17,true,15,26,11,41.91852,-87.69744
259,7,17,true,3,7,4,41.91853,-87.69745
310,7,17,true,5,5,0,41.91984,-87.68083
225,7,17,true,14,13,-1,41.91995,-87.64884
13192,7,17,true,67,68,1,41.91995,-87.64884
13288,7,17,true,32,36,4,41.92008,-87.67788
13242,7,17,true,27,27,0,41.92021,-87.69266
222,7,17,true,2,1,-1,41.92023,-87.69265
307,7,17,true,10,5,-5,41.92077,-87.66373
TA1309000030,7,17,true,49,53,4,41.92077,-87.66372
290,7,17,true,3,4,1,41.92152,-87.70734
13292,7,17,true,15,12,-3,41.92152,-87.70733
TA1309000033,7,17,true,130,105,-25,41.92158,-87.65381
13193,7,17,true,140,154,14,41.92182,-87.64412
144,7,17,true,26,26,0,41.92182,-87.64411
143,7,17,true,17,14,-3,41.92217,-87.63891
13191,7,17,true,66,83,17,41.92217,-87.63891
327,7,17,true,13,10,-3,41.92225,-87.65783
13084,7,17,true,37,49,12,41.92268,-87.69715
123,7,17,true,11,10,-1,41.92268,-87.69714
LP-,7,17,true,59,56,-3,41.92396,-87.63584
673,7,17,true,16,12,-4,41.92398,-87.63585
505,7,17,true,1,4,3,41.92409,-87.67646
KA1504000140,7,17,true,11,19,8,41.92409,-87.67646
16010,7,17,true,4,6,2,41.92458,-87.72787
504,7,17,true,3,6,3,41.92464,-87.68931
15648,7,17,true,12,18,6,41.92464,-87.68931
KA1504000090,7,17,true,7,13,6,41.92483,-87.7145
TA1307000001,7,17,true,36,47,11,41.92535,-87.66581
188,7,17,true,6,7,1,41.92536,-87.66581
TA1306000026,7,17,true,61,61,0,41.92558,-87.65842
87,7,17,true,14,10,-4,41.92559,-87.65843
67,7,17,true,7,8,1,41.9256,-87.65371
TA1306000016,7,17,true,56,59,3,41.9256,-87.65371
313,7,17,true,18,14,-4,41.9257,-87.64246
TA1309000019,7,17,true,124,113,-11,41.92586,-87.63897
TA1309000058,7,17,true,86,86,0,41.92591,-87.64927
127,7,17,true,19,17,-2,41.92592,-87.64927
TA1308000001,7,17,true,259,241,-18,41.92627,-87.63086
177,7,17,true,41,31,-10,41.92627,-87.63086
502,7,17,true,5,1,-4,41.92667,-87.69772
15646,7,17,true,10,13,3,41.92668,-87.6977
13124,7,17,true,36,19,-17,41.92675,-87.63444
34,7,17,true,4,2,-2,41.92675,-87.63444
302,7,17,true,8,12,4,41.92859,-87.65421
TA1309000023,7,17,true,63,61,-2,41.9287,-87.65383
TA1307000113,7,17,true,54,64,10,41.92878,-87.66391
190,7,17,true,7,5,-2,41.92878,-87.6639
166,7,17,true,4,9,5,41.92883,-87.66853
13296,7,17,true,40,18,-22,41.92883,-87.66852
343,7,17,true,5,11,6,41.92889,-87.65898
TA1309000059,7,17,true,36,57,21,41.92889,-87.65898
349,7,17,true,11,19,8,41.92915,-87.6491
TA1309000061,7,17,true,113,113,0,41.92915,-87.64909
TA1308000031,7,17,true,22,22,0,41.92946,-87.68417
258,7,17,true,5,9,4,41.92946,-87.68417
TA1305000014,7,17,true,132,110,-22,41.92956,-87.64313
340,7,17,true,26,20,-6,41.92956,-87.64313
260,7,17,true,4,4,0,41.92958,-87.70791
13085,7,17,true,38,36,-2,41.92958,-87.70789
15643,7,17,true,8,11,3,41.93057,-87.7238
TA1307000142,7,17,true,109,120,11,41.93125,-87.64432
220,7,17,true,18,30,12,41.93125,-87.64431
13276,7,17,true,98,98,0,41.93132,-87.63874
324,7,17,true,16,17,1,41.93173,-87.64179
501,7,17,true,7,1,-6,41.93191,-87.70121
15645,7,17,true,7,15,8,41.93191,-87.70121
163,7,17,true,7,6,-1,41.93191,-87.67784
13271,7,17,true,20,24,4,41.93192,-87.67784
152,7,17,true,12,17,5,41.93221,-87.65864
TA1307000064,7,17,true,67,61,-6,41.93222,-87.65864
13,7,17,true,14,11,-3,41.93242,-87.65271
TA1306000014,7,17,true,78,76,-2,41.93242,-87.65271
TA1309000039,7,17,true,117,117,0,41.93258,-87.63642
329,7,17,true,8,13,5,41.93258,-87.63642
13294,7,17,true,31,37,6,41.9326,-87.66595
319,7,17,true,5,4,-1,41.93292,-87.67217
332,7,17,true,11,9,-2,41.93313,-87.64776
TA1309000036,7,17,true,75,105,30,41.93313,-87.64776
15644,7,17,true,2,5,3,41.93534,-87.71687
500,7,17,true,4,1,-3,41.93534,-87.71686
TA1307000006,7,17,true,77,80,3,41.93571,-87.6636
153,7,17,true,6,12,6,41.93575,-87.66364
162,7,17,true,3,2,-1,41.93588,-87.67844
13268,7,17,true,18,36,18,41.93588,-87.67843
250,7,17,true,5,4,-1,41.93609,-87.66984
13269,7,17,true,23,40,17,41.93609,-87.66983
115,7,17,true,9,15,6,41.93628,-87.65266
TA1307000052,7,17,true,72,86,14,41.93628,-87.65266
156,7,17,true,14,22,8,41.9365,-87.64756
TA1307000136,7,17,true,92,119,27,41.9365,-87.64755
TA1307000041,7,17,true,127,134,7,41.93669,-87.63683
157,7,17,true,19,23,4,41.9367,-87.63683
13137,7,17,true,138,151,13,41.9376,-87.6441
300,7,17,true,31,33,2,41.93761,-87.6441
15642,7,17,true,14,7,-7,41.93843,-87.69801
498,7,17,true,2,7,5,41.93843,-87.69801
154,7,17,true,6,14,8,41.93912,-87.66384
KA17018068,7,17,true,12,20,8,41.93935,-87.68327
TA1309000042,7,17,true,57,62,5,41.93937,-87.66836
131,7,17,true,8,9,1,41.93937,-87.66835
KA150400009X,7,17,true,7,9,2,41.9394,-87.71159
15640,7,17,true,4,4,0,41.93941,-87.72357
497,7,17,true,5,1,-4,41.93941,-87.71159
13229,7,17,true,49,59,10,41.93946,-87.66376
226,7,17,true,7,10,3,41.93972,-87.65886
TA1308000019,7,17,true,59,84,25,41.93973,-87.65886
13277,7,17,true,110,105,-5,41.9401,-87.64546
296,7,17,true,12,13,1,41.9401,-87.64546
TA1307000134,7,17,true,112,153,41,41.94016,-87.65303
117,7,17,true,11,15,4,41.94016,-87.65302
13143,7,17,true,16,29,13,41.94059,-87.67853
334,7,17,true,17,17,0,41.94076,-87.63919
TA1309000049,7,17,true,140,125,-15,41.94077,-87.63919
308,7,17,true,3,2,-1,41.94152,-87.68471
493,7,17,true,2,3,1,41.94304,-87.68729
15634,7,17,true,14,18,4,41.94304,-87.68729
TA1307000138,7,17,true,64,48,-16,41.94334,-87.67094
230,7,17,true,4,6,2,41.94335,-87.67093
13144,7,17,true,24,31,7,41.9434,-87.67964
299,7,17,true,29,22,-7,41.94368,-87.64894
TA1309000025,7,17,true,136,138,2,41.94368,-87.64894
229,7,17,true,14,15,1,41.94372,-87.66401
13071,7,17,true,92,108,16,41.94373,-87.66401
632,7,17,true,105,105,0,41.94453,-87.6547
303,7,17,true,20,17,-3,41.94522,-87.64702
490,7,17,true,2,2,0,41.94523,-87.70664
15631,7,17,true,7,7,0,41.94524,-87.70665
13278,7,17,true,94,126,32,41.94553,-87.64644
TA1309000050,7,17,true,13,9,-4,41.94618,-87.67331
330,7,17,true,4,3,-1,41.94618,-87.67331
15632,7,17,true,14,16,2,41.94664,-87.69463
KA1504000143,7,17,true,8,11,3,41.94664,-87.68337
KA1504000142,7,17,true,2,7,5,41.94735,-87.71759
489,7,17,true,2,1,-1,41.94736,-87.7176
227,7,17,true,22,12,-10,41.94813,-87.66397
13235,7,17,true,83,102,19,41.94814,-87.66396
304,7,17,true,24,21,-3,41.94878,-87.64922
13253,7,17,true,27,20,-7,41.9488,-87.67527
257,7,17,true,6,3,-3,41.9488,-87.67527
13325,7,17,true,110,118,8,41.94907,-87.64863
114,7,17,true,10,10,0,41.94935,-87.65451
TA1307000126,7,17,true,85,128,43,41.94936,-87.65451
232,7,17,true,28,17,-11,41.94943,-87.64645
TA1307000150,7,17,true,105,121,16,41.94945,-87.64646
18016,7,17,true,2,8,6,41.94993,-87.71395
347,7,17,true,5,3,-2,41.95068,-87.6687
13319,7,17,true,26,31,5,41.95069,-87.6687
TA1307000127,7,17,true,81,74,-7,41.9508,-87.65918
165,7,17,true,7,12,5,41.95081,-87.65918
15628,7,17,true,8,13,5,41.95216,-87.69806
318,7,17,true,2,3,1,41.95254,-87.6735
256,7,17,true,9,5,-4,41.95282,-87.65
13323,7,17,true,54,63,9,41.95282,-87.65
15624,7,17,true,2,2,0,41.95339,-87.73199
483,7,17,true,1,1,0,41.9534,-87.73199
314,7,17,true,5,7,2,41.9535,-87.69199
485,7,17,true,2,2,0,41.95361,-87.70933
KA1504000096,7,17,true,5,6,1,41.95361,-87.70932
KA1504000139,7,17,true,3,1,-2,41.954,-87.71909
484,7,17,true,2,2,0,41.954,-87.71907
TA1309000043,7,17,true,28,29,1,41.95417,-87.66434
240,7,17,true,10,11,1,41.95424,-87.65441
13063,7,17,true,53,57,4,41.95424,-87.65441
486,7,17,true,2,1,-1,41.95431,-87.68607
KA1504000158,7,17,true,10,10,0,41.95432,-87.68607
254,7,17,true,19,16,-3,41.95438,-87.64806
TA1308000022,7,17,true,88,89,1,41.95438,-87.64805
589,7,17,true,3,4,1,41.95447,-87.7496
16991,7,17,true,3,2,-1,41.95448,-87.7496
TA1307000149,7,17,true,36,25,-11,41.95467,-87.67392
298,7,17,true,1,8,7,41.95601,-87.68021
TA1309000026,7,17,true,36,28,-8,41.95601,-87.6802
13249,7,17,true,6,17,11,41.95606,-87.66885
312,7,17,true,10,10,0,41.95637,-87.6563
292,7,17,true,2,1,-1,41.95709,-87.6642
TA1308000047,7,17,true,20,23,3,41.95709,-87.6642
13379,7,17,true,72,65,-7,41.95786,-87.6495
TA1309000018,7,17,true,16,22,6,41.95791,-87.67357
306,7,17,true,11,15,4,41.9585,-87.655
TA1309000027,7,17,true,31,59,28,41.9585,-87.65499
592,7,17,true,8,3,-5,41.96065,-87.74538
13389,7,17,true,57,53,-4,41.961,-87.64958
245,7,17,true,9,9,0,41.96101,-87.64958
15621,7,17,true,10,10,0,41.96103,-87.70586
480,7,17,true,4,3,-1,41.96104,-87.70586
481,7,17,true,3,1,-2,41.96108,-87.69544
15622,7,17,true,12,11,-1,41.96108,-87.69544
KA1504000164,7,17,true,1,1,0,41.96109,-87.72897
479,7,17,true,3,1,-2,41.96116,-87.71658
KA1504000097,7,17,true,4,7,3,41.96116,-87.71658
238,7,17,true,6,1,-5,41.96141,-87.6762
TA1307000144,7,17,true,24,24,0,41.96142,-87.6762
TA1309000021,7,17,true,35,22,-13,41.9615,-87.6714
482,7,17,true,1,5,4,41.96154,-87.69117
15623,7,17,true,17,32,15,41.96154,-87.69117
234,7,17,true,4,4,0,41.96158,-87.6661
KA1503000022,7,17,true,33,29,-4,41.96158,-87.66609
231,7,17,true,9,10,1,41.96163,-87.65464
TA1307000107,7,17,true,75,91,16,41.96164,-87.65464
TA1307000156,7,17,true,41,26,-15,41.96301,-87.68479
243,7,17,true,5,5,0,41.96302,-87.68479
TA1309000012,7,17,true,15,24,9,41.96325,-87.67928
TA1308000012,7,17,true,181,127,-54,41.96398,-87.63818
249,7,17,true,18,7,-11,41.96398,-87.63818
293,7,17,true,6,12,6,41.96521,-87.65822
13074,7,17,true,51,53,2,41.96521,-87.6582
639,7,17,true,81,59,-22,41.96584,-87.64538
KA1504000127,7,17,true,6,12,6,41.96587,-87.70083
KA1504000093,7,17,true,7,14,7,41.96587,-87.69365
478,7,17,true,1,1,0,41.96587,-87.69364
TA1307000140,7,17,true,24,25,1,41.96643,-87.68865
239,7,17,true,4,6,2,41.9665,-87.68843
326,7,17,true,5,13,8,41.96665,-87.67113
KA1504000126,7,17,true,4,4,0,41.96668,-87.70807
TA1309000014,7,17,true,47,53,6,41.96709,-87.66744
TA1307000158,7,17,true,31,30,-1,41.9671,-87.67904
242,7,17,true,3,6,3,41.9671,-87.67904
251,7,17,true,10,7,-3,41.96796,-87.65
TA1307000119,7,17,true,36,39,3,41.96796,-87.65
15615,7,17,true,6,4,-2,41.96835,-87.71183
474,7,17,true,2,2,0,41.96835,-87.71182
323,7,17,true,8,2,-6,41.96869,-87.66034
253,7,17,true,7,7,0,41.96883,-87.65765
TA1308000021,7,17,true,24,49,25,41.96883,-87.65765
475,7,17,true,6,4,-2,41.96885,-87.69611
KA1504000080,7,17,true,17,17,0,41.96887,-87.69609
TA1309000015,7,17,true,7,19,12,41.96889,-87.68401
344,7,17,true,8,13,5,41.9691,-87.67423
TA1309000066,7,17,true,48,65,17,41.9691,-87.67423
TA1309000041,7,17,true,30,34,4,41.96951,-87.65471
465,7,17,true,13,7,-6,41.97161,-87.65016
KA1504000171,7,17,true,69,64,-5,41.97161,-87.65016
325,7,17,true,13,9,-4,41.9728,-87.67186
TA1309000035,7,17,true,69,75,6,41.97335,-87.66785
295,7,17,true,16,14,-2,41.97378,-87.65972
13108,7,17,true,46,60,14,41.97379,-87.65971
KA1504000078,7,17,true,9,18,9,41.97491,-87.69258
464,7,17,true,7,1,-6,41.97562,-87.67945
KA1504000149,7,17,true,23,29,6,41.97562,-87.67945
471,7,17,true,2,1,-1,41.97564,-87.70143
KA1504000160,7,17,true,11,11,0,41.97564,-87.70143
470,7,17,true,1,1,0,41.97567,-87.70927
KA1504000128,7,17,true,3,3,0,41.97567,-87.70927
463,7,17,true,6,5,-1,41.978,-87.66805
KA1504000146,7,17,true,62,65,3,41.978,-87.66805
294,7,17,true,3,9,6,41.97835,-87.65976
13109,7,17,true,50,57,7,41.97835,-87.65976
KA1504000147,7,17,true,8,11,3,41.97976,-87.67754
655,7,17,true,33,5,-28,41.97987,-87.68194
KA1504000161,7,17,true,1,1,0,41.98038,-87.71612
KA1504000167,7,17,true,3,6,3,41.98206,-87.70895
460,7,17,true,4,3,-1,41.98358,-87.66916
KA1504000151,7,17,true,30,35,5,41.98359,-87.66916
KA1504000152,7,17,true,172,137,-35,41.98403,-87.65231
459,7,17,true,15,14,-1,41.98403,-87.65231
15578,7,17,true,47,31,-16,41.98405,-87.66027
461,7,17,true,5,4,-1,41.98405,-87.66027
353,7,17,true,1,2,1,41.98656,-87.70761
15575,7,17,true,36,51,15,41.98975,-87.66014
458,7,17,true,6,11,5,41.98975,-87.66013
KA1504000130,7,17,true,3,5,2,41.99024,-87.69338
457,7,17,true,3,1,-2,41.99052,-87.66982
KA1504000148,7,17,true,5,12,7,41.99086,-87.66971
456,7,17,true,1,1,0,41.99117,-87.68359
KA1504000155,7,17,true,4,11,7,41.99118,-87.68359
452,7,17,true,1,1,0,41.99417,-87.68945
KA1504000129,7,17,true,8,9,1,41.99417,-87.68945
15571,7,17,true,36,42,6,41.99478,-87.66028
454,7,17,true,12,13,1,41.99478,-87.66027
KA1504000156,7,17,true,25,11,-14,41.99925,-87.67137
RP-009,7,17,true,18,30,12,42.00107,-87.66122
451,7,17,true,4,3,-1,42.00108,-87.66123
450,7,17,true,2,1,-1,42.00179,-87.68883
RP-001,7,17,true,5,4,-1,42.00179,-87.68883
RP-008,7,17,true,12,16,4,42.00446,-87.6724
RP-002,7,17,true,2,3,1,42.00456,-87.68065
660,7,17,true,21,18,-3,42.00458,-87.66143
354,7,17,true,1,4,3,42.00587,-87.66802
KA1504000175,7,17,true,16,16,0,42.00797,-87.66549
447,7,17,true,5,2,-3,42.00797,-87.66548
RP-005,7,17,true,8,6,-2,42.0086,-87.69047
467,7,17,true,2,3,1,42.0086,-87.69047
432,7,17,true,1,2,1,42.00907,-87.67423
KA1504000162,7,17,true,4,8,4,42.00907,-87.67422
KA1504000159,7,17,true,14,21,7,42.01059,-87.66241
RP-006,7,17,true,1,2,1,42.01213,-87.68292
RP-004,7,17,true,1,2,1,42.01234,-87.68825
RP-007,7,17,true,3,3,0,42.01256,-87.67431
525,7,17,true,11,15,4,42.01272,-87.66605
517,7,17,true,9,6,-3,42.01597,-87.675
520,7,17,true,24,27,3,42.01597,-87.66859
527,7,17,true,2,3,1,42.01892,-87.69004
515,7,17,true,16,14,-2,42.01915,-87.67356
514,7,17,true,1,5,4,42.01927,-87.68452
16806,7,17,true,2,3,1,42.01953,-87.66955
523,7,17,true,13,18,5,42.02089,-87.66505
662,7,17,true,2,2,0,42.02354,-87.69961
598,7,17,true,7,4,-3,42.02578,-87.68411
597,7,17,true,2,2,0,42.03256,-87.67914
E002,7,17,true,17,17,0,42.03256,-87.67912
E011,7,17,true,3,4,1,42.03473,-87.69912
599,7,17,true,13,6,-7,42.03972,-87.69942
596,7,17,true,38,24,-14,42.04822,-87.68348
600,7,17,true,4,4,0,42.04831,-87.6983
E008,7,17,true,16,9,-7,42.05049,-87.67782
603,7,17,true,1,1,0,42.05049,-87.67782
605,7,17,true,13,10,-3,42.05294,-87.67342
661,7,17,true,5,8,3,42.05704,-87.68657
604,7,17,true,18,22,4,42.05824,-87.67744
E006,7,17,true,3,13,10,42.06367,-87.69871
601,7,17,true,9,4,-5,42.06368,-87.69871
E007,7,17,true,4,6,2,42.06431,-87.68615
602,7,17,true,1,4,3,42.06431,-87.68614
E014,7,17,true,3,2,-1,42.06483,-87.71531