station_id,dayofweek,hour,is_member,starts,ends,diff,lat,lng
KA1503000014,1,0,false,7,4,-3,41.7851,-87.60108
TA1308000009,1,0,false,3,5,2,41.79522,-87.58075
TA1309000001,1,0,false,5,5,0,41.86488,-87.64708
TA1305000002,1,0,false,6,12,6,41.86721,-87.62597
KA1706005007,1,0,false,5,6,1,41.86749,-87.63219
SL-005,1,0,false,8,3,-5,41.8679,-87.62304
TA1309000010,1,0,false,4,5,1,41.87074,-87.62574
SL-011,1,0,false,4,7,3,41.87256,-87.63356
623,1,0,false,12,18,6,41.87272,-87.62399
SL-007,1,0,false,4,7,3,41.87404,-87.6277
15541,1,0,false,9,6,-3,41.8758,-87.62086
TA1305000010,1,0,false,12,7,-5,41.87623,-87.62444
TA1305000035,1,0,false,9,2,-7,41.87716,-87.62787
KA1503000015,1,0,false,2,12,10,41.87948,-87.6257
13300,1,0,false,15,9,-6,41.88097,-87.61675
13008,1,0,false,24,36,12,41.88105,-87.62408
TA1305000006,1,0,false,3,7,4,41.88122,-87.6296
13001,1,0,false,15,17,2,41.88397,-87.62459
TA1305000030,1,0,false,9,2,-7,41.88459,-87.63178
TA1305000029,1,0,false,10,6,-4,41.88466,-87.62787
13263,1,0,false,5,4,-1,41.88467,-87.61952
13021,1,0,false,1,5,4,41.88559,-87.64184
TA1307000111,1,0,false,5,2,-3,41.88582,-87.63548
TA1305000011,1,0,false,6,8,2,41.886,-87.62418
TA1308000029,1,0,false,3,10,7,41.88673,-87.62225
TA1307000131,1,0,false,5,10,5,41.88688,-87.62606
13050,1,0,false,7,10,3,41.88919,-87.62775
TA1306000013,1,0,false,10,2,-8,41.89083,-87.61852
TA1307000117,1,0,false,9,17,8,41.89144,-87.62675
TA1305000003,1,0,false,10,3,-7,41.89187,-87.62061
13022,1,0,false,1,6,5,41.89227,-87.61205
TA1306000029,1,0,false,3,6,3,41.89256,-87.61449
13045,1,0,false,4,7,3,41.89403,-87.62931
13016,1,0,false,2,8,6,41.89431,-87.62277
13034,1,0,false,2,5,3,41.89754,-87.62352
13042,1,0,false,5,8,3,41.90097,-87.62377
KA1504000133,1,0,false,6,3,-3,41.90234,-87.62773
TA1309000024,1,0,false,1,7,6,41.908,-87.63152
TA1305000041,1,0,false,5,15,10,41.9094,-87.67769
LP-,1,0,false,1,5,4,41.92396,-87.63584
TA1309000019,1,0,false,6,13,7,41.92586,-87.63897
TA1308000001,1,0,false,1,5,4,41.92627,-87.63086
13124,1,0,false,5,5,0,41.92675,-87.63444
TA1307000142,1,0,false,8,8,0,41.93125,-87.64432
TA1307000052,1,0,false,9,2,-7,41.93628,-87.65266
13278,1,0,false,5,1,-4,41.94553,-87.64644
13045,1,0,true,6,1,-5,41.89403,-87.62931
TA1307000039,1,0,true,1,6,5,41.90294,-87.63137
TA1308000049,1,0,true,4,5,1,41.90672,-87.6349
TA1309000024,1,0,true,2,5,3,41.908,-87.63152
TA1306000026,1,0,true,6,4,-2,41.92558,-87.65842
13325,1,0,true,5,4,-1,41.94907,-87.64863
TA1307000164,1,1,false,1,5,4,41.79527,-87.59647
TA1305000002,1,1,false,3,13,10,41.86721,-87.62597
SL-005,1,1,false,7,4,-3,41.8679,-87.62304
623,1,1,false,2,5,3,41.87272,-87.62399
SL-007,1,1,false,6,6,0,41.87404,-87.6277
15541,1,1,false,6,3,-3,41.8758,-87.62086
TA1305000010,1,1,false,7,14,7,41.87623,-87.62444
TA1309000002,1,1,false,4,5,1,41.87784,-87.62408
KA1503000015,1,1,false,13,13,0,41.87948,-87.6257
13300,1,1,false,3,11,8,41.88097,-87.61675
13008,1,1,false,13,6,-7,41.88105,-87.62408
TA1306000010,1,1,false,9,8,-1,41.88419,-87.62961
TA1305000011,1,1,false,6,3,-3,41.886,-87.62418
TA1308000029,1,1,false,5,4,-1,41.88673,-87.62225
TA1307000131,1,1,false,5,3,-2,41.88688,-87.62606
13050,1,1,false,7,9,2,41.88919,-87.62775
TA1307000117,1,1,false,9,14,5,41.89144,-87.62675
TA1305000003,1,1,false,1,8,7,41.89187,-87.62061
13022,1,1,false,10,8,-2,41.89227,-87.61205
TA1306000029,1,1,false,6,4,-2,41.89256,-87.61449
TA1307000039,1,1,false,5,2,-3,41.90294,-87.63137
13146,1,1,false,6,1,-5,41.91831,-87.63629
TA1307000134,1,1,false,4,5,1,41.94016,-87.65303
13278,1,1,false,6,3,-3,41.94553,-87.64644
13325,1,1,false,7,3,-4,41.94907,-87.64863
KA1503000012,1,1,true,1,6,5,41.88599,-87.63089
TA1309000010,1,2,false,6,2,-4,41.87074,-87.62574
SL-007,1,2,false,1,7,6,41.87404,-87.6277
15541,1,2,false,1,5,4,41.8758,-87.62086
13300,1,2,false,3,5,2,41.88097,-87.61675
13008,1,2,false,2,5,3,41.88105,-87.62408
TA1305000011,1,2,false,4,6,2,41.886,-87.62418
TA1308000029,1,2,false,1,8,7,41.88673,-87.62225
TA1307000131,1,2,false,6,11,5,41.88688,-87.62606
13050,1,2,false,5,4,-1,41.88919,-87.62775
TA1307000117,1,2,false,3,5,2,41.89144,-87.62675
TA1305000003,1,2,false,5,1,-4,41.89187,-87.62061
TA1307000039,1,2,false,2,6,4,41.90294,-87.63137
TA1307000038,1,2,false,5,2,-3,41.91138,-87.63868
TA1305000014,1,2,false,8,9,1,41.92956,-87.64313
TA1307000142,1,2,false,2,6,4,41.93125,-87.64432
13278,1,2,false,5,1,-4,41.94553,-87.64644
TA1307000126,1,2,false,6,1,-5,41.94936,-87.65451
623,1,3,false,5,2,-3,41.87272,-87.62399
15541,1,3,false,9,4,-5,41.8758,-87.62086
TA1305000010,1,3,false,1,7,6,41.87623,-87.62444
KA1503000015,1,3,false,3,6,3,41.87948,-87.6257
SL-007,1,4,false,4,5,1,41.87404,-87.6277
TA1305000003,1,4,false,2,7,5,41.89187,-87.62061
TA1309000027,1,4,false,5,1,-4,41.9585,-87.65499
13179,1,4,true,1,5,4,41.9157,-87.63461
13001,1,5,false,1,5,4,41.88397,-87.62459
13016,1,5,false,2,5,3,41.89431,-87.62277
KA1503000041,1,5,false,10,2,-8,41.89452,-87.61798
SL-008,1,5,true,6,6,0,41.87209,-87.62956
KA1504000104,1,5,true,1,7,6,41.87296,-87.66912
TA1309000004,1,5,true,2,7,5,41.87811,-87.63184
TA1306000010,1,5,true,1,6,5,41.88419,-87.62961
TA1307000111,1,5,true,3,5,2,41.88582,-87.63548
15534,1,5,true,6,1,-5,41.88627,-87.61749
TA1306000003,1,5,true,6,1,-5,41.88867,-87.64442
KA1503000043,1,5,true,3,10,7,41.88918,-87.63851
TA1306000013,1,5,true,7,2,-5,41.89083,-87.61852
TA1307000117,1,5,true,5,1,-4,41.89144,-87.62675
TA1305000003,1,5,true,2,6,4,41.89187,-87.62061
TA1306000029,1,5,true,9,1,-8,41.89256,-87.61449
13016,1,5,true,6,28,22,41.89431,-87.62277
18003,1,5,true,1,9,8,41.89575,-87.62011
13017,1,5,true,2,6,4,41.89676,-87.6357
620,1,5,true,5,3,-2,41.89817,-87.63754
TA1307000039,1,5,true,12,5,-7,41.90294,-87.63137
KA1504000135,1,5,true,7,3,-4,41.90319,-87.63439
TA1309000024,1,5,true,6,1,-5,41.908,-87.63152
331,1,5,true,1,6,5,41.90965,-87.64812
TA1308000050,1,5,true,11,3,-8,41.91211,-87.6347
13146,1,5,true,6,1,-5,41.91831,-87.63629
13193,1,5,true,2,5,3,41.92182,-87.64412
TA1305000014,1,5,true,5,1,-4,41.92956,-87.64313
TA1307000142,1,5,true,5,3,-2,41.93125,-87.64432
TA1307000150,1,5,true,5,3,-2,41.94945,-87.64646
SL-008,1,6,false,5,1,-4,41.87209,-87.62956
TA1307000120,1,6,false,5,1,-4,41.88188,-87.64879
13341,1,6,false,5,5,0,41.88208,-87.63985
TA1305000032,1,6,false,2,5,3,41.88218,-87.64109
TA1306000003,1,6,false,5,2,-3,41.88867,-87.64442
TA1307000151,1,6,false,4,5,1,41.88993,-87.63427
TA1305000003,1,6,false,6,2,-4,41.89187,-87.62061
13016,1,6,false,3,12,9,41.89431,-87.62277
KA1503000041,1,6,false,1,7,6,41.89452,-87.61798
TA1307000062,1,6,false,5,2,-3,41.89466,-87.63839
13017,1,6,false,2,5,3,41.89676,-87.6357
13042,1,6,false,3,5,2,41.90097,-87.62377
TA1307000039,1,6,false,9,2,-7,41.90294,-87.63137
KA1504000135,1,6,false,8,3,-5,41.90319,-87.63439
KA1504000134,1,6,false,7,1,-6,41.90687,-87.6262
13179,1,6,false,7,1,-6,41.9157,-87.63461
13071,1,6,false,4,6,2,41.94373,-87.66401
13150,1,6,true,11,2,-9,41.85783,-87.62455
TA1307000124,1,6,true,14,3,-11,41.86411,-87.62372
TA1305000002,1,6,true,6,1,-5,41.86721,-87.62597
SL-005,1,6,true,9,8,-1,41.8679,-87.62304
TA1309000064,1,6,true,1,23,22,41.87127,-87.67369
SL-008,1,6,true,7,4,-3,41.87209,-87.62956
SL-011,1,6,true,8,1,-7,41.87256,-87.63356
623,1,6,true,13,3,-10,41.87272,-87.62399
KA1504000104,1,6,true,1,35,34,41.87296,-87.66912
TA1305000035,1,6,true,2,6,4,41.87716,-87.62787
13138,1,6,true,1,9,8,41.87723,-87.63941
13158,1,6,true,6,1,-5,41.87764,-87.64957
TA1309000004,1,6,true,11,26,15,41.87811,-87.63184
638,1,6,true,11,18,7,41.87827,-87.64078
13011,1,6,true,10,6,-4,41.87931,-87.63993
TA1309000008,1,6,true,5,11,6,41.87933,-87.6355
TA1309000007,1,6,true,1,31,30,41.88022,-87.63526
13156,1,6,true,7,1,-6,41.88042,-87.65554
13008,1,6,true,2,8,6,41.88105,-87.62408
TA1305000006,1,6,true,1,20,19,41.88122,-87.6296
13056,1,6,true,1,8,7,41.88168,-87.63951
TA1307000120,1,6,true,6,7,1,41.88188,-87.64879
13341,1,6,true,6,6,0,41.88208,-87.63985
TA1305000032,1,6,true,14,19,5,41.88218,-87.64109
13409,1,6,true,5,1,-4,41.8831,-87.6511
KA1503000072,1,6,true,6,16,10,41.88317,-87.63693
WL-012,1,6,true,25,17,-8,41.88337,-87.6412
13001,1,6,true,9,8,-1,41.88397,-87.62459
TA1306000010,1,6,true,1,7,6,41.88419,-87.62961
15535,1,6,true,5,1,-4,41.8846,-87.64455
13263,1,6,true,15,9,-6,41.88467,-87.61952
TA1306000015,1,6,true,1,11,10,41.88549,-87.65232
13021,1,6,true,14,6,-8,41.88559,-87.64184
TA1307000111,1,6,true,9,12,3,41.88582,-87.63548
TA1305000011,1,6,true,16,14,-2,41.886,-87.62418
TA1308000029,1,6,true,4,5,1,41.88673,-87.62225
TA1305000022,1,6,true,12,14,2,41.88817,-87.63656
TA1306000003,1,6,true,17,12,-5,41.88867,-87.64442
KA1503000043,1,6,true,21,22,1,41.88918,-87.63851
TA1307000151,1,6,true,5,4,-1,41.88993,-87.63427
636,1,6,true,8,1,-7,41.88997,-87.63662
KA1503000044,1,6,true,4,5,1,41.89018,-87.6262
13427,1,6,true,7,6,-1,41.89054,-87.62205
13430,1,6,true,3,5,2,41.89077,-87.63169
13033,1,6,true,5,1,-4,41.8916,-87.64835
TA1305000003,1,6,true,5,6,1,41.89187,-87.62061
13022,1,6,true,9,7,-2,41.89227,-87.61205
13265,1,6,true,17,2,-15,41.89383,-87.64172
13045,1,6,true,9,22,13,41.89403,-87.62931
13016,1,6,true,3,44,41,41.89431,-87.62277
KA1503000041,1,6,true,13,26,13,41.89452,-87.61798
13196,1,6,true,7,4,-3,41.89455,-87.65345
TA1307000062,1,6,true,7,6,-1,41.89466,-87.63839
TA1306000012,1,6,true,22,12,-10,41.89475,-87.63438
KP1705001026,1,6,true,9,1,-8,41.89483,-87.6323
15530,1,6,true,8,16,8,41.89575,-87.62596
18003,1,6,true,2,18,16,41.89575,-87.62011
13247,1,6,true,8,2,-6,41.89597,-87.66775
TA1305000020,1,6,true,10,1,-9,41.89636,-87.65406
13303,1,6,true,13,7,-6,41.89672,-87.63088
13017,1,6,true,13,8,-5,41.89676,-87.6357
13338,1,6,true,6,39,33,41.89697,-87.62173
TA1307000061,1,6,true,5,1,-4,41.89745,-87.62873
13034,1,6,true,3,7,4,41.89754,-87.62352
TA1306000009,1,6,true,4,9,5,41.89772,-87.64299
620,1,6,true,7,1,-6,41.89817,-87.63754
15529,1,6,true,7,14,7,41.89858,-87.62206
TA1307000128,1,6,true,11,1,-10,41.89896,-87.6299
KA1504000133,1,6,true,5,2,-3,41.90234,-87.62773
TA1307000039,1,6,true,16,18,2,41.90294,-87.63137
TA1305000034,1,6,true,5,1,-4,41.90313,-87.67391
KA1504000135,1,6,true,17,3,-14,41.90319,-87.63439
13061,1,6,true,8,2,-6,41.90342,-87.66779
TA1308000049,1,6,true,16,1,-15,41.90672,-87.6349
KA1504000134,1,6,true,6,1,-5,41.90687,-87.6262
TA1309000024,1,6,true,15,2,-13,41.908,-87.63152
331,1,6,true,6,6,0,41.90965,-87.64812
13154,1,6,true,1,5,4,41.91054,-87.65312
TA1308000050,1,6,true,11,10,-1,41.91211,-87.6347
TA1306000032,1,6,true,5,4,-1,41.9137,-87.65285
13179,1,6,true,6,3,-3,41.9157,-87.63461
13146,1,6,true,8,1,-7,41.91831,-87.63629
13193,1,6,true,10,2,-8,41.92182,-87.64412
13191,1,6,true,16,1,-15,41.92217,-87.63891
TA1306000016,1,6,true,1,16,15,41.9256,-87.65371
TA1309000019,1,6,true,7,1,-6,41.92586,-87.63897
TA1309000023,1,6,true,5,1,-4,41.9287,-87.65383
TA1309000061,1,6,true,12,2,-10,41.92915,-87.64909
TA1305000014,1,6,true,6,2,-4,41.92956,-87.64313
TA1307000142,1,6,true,8,3,-5,41.93125,-87.64432
13276,1,6,true,11,1,-10,41.93132,-87.63874
TA1306000014,1,6,true,5,10,5,41.93242,-87.65271
TA1307000006,1,6,true,5,2,-3,41.93571,-87.6636
TA1307000052,1,6,true,7,10,3,41.93628,-87.65266
TA1307000136,1,6,true,3,5,2,41.9365,-87.64755
13277,1,6,true,7,2,-5,41.9401,-87.64546
TA1307000134,1,6,true,4,5,1,41.94016,-87.65303
TA1307000138,1,6,true,1,7,6,41.94334,-87.67094
TA1309000025,1,6,true,6,4,-2,41.94368,-87.64894
13278,1,6,true,6,4,-2,41.94553,-87.64644
KA1504000143,1,6,true,5,1,-4,41.94664,-87.68337
13325,1,6,true,6,10,4,41.94907,-87.64863
TA1307000126,1,6,true,11,2,-9,41.94936,-87.65451
13319,1,6,true,5,4,-1,41.95069,-87.6687
13063,1,6,true,10,2,-8,41.95424,-87.65441
13379,1,6,true,6,2,-4,41.95786,-87.6495
TA1309000027,1,6,true,8,1,-7,41.9585,-87.65499
TA1307000107,1,6,true,6,1,-5,41.96164,-87.65464
TA1309000010,1,7,false,5,2,-3,41.87074,-87.62574
SL-008,1,7,false,8,1,-7,41.87209,-87.62956
SL-011,1,7,false,7,2,-5,41.87256,-87.63356
13011,1,7,false,4,9,5,41.87931,-87.63993
TA1309000007,1,7,false,1,13,12,41.88022,-87.63526
WL-011,1,7,false,2,5,3,41.88034,-87.64273
13008,1,7,false,2,6,4,41.88105,-87.62408
TA1305000006,1,7,false,2,9,7,41.88122,-87.6296
13341,1,7,false,3,6,3,41.88208,-87.63985
KA1503000072,1,7,false,2,7,5,41.88317,-87.63693
13021,1,7,false,5,3,-2,41.88559,-87.64184
TA1306000003,1,7,false,7,2,-5,41.88867,-87.64442
KA1503000043,1,7,false,8,5,-3,41.88918,-87.63851
13050,1,7,false,1,5,4,41.88919,-87.62775
TA1307000151,1,7,false,1,6,5,41.88993,-87.63427
TA1306000013,1,7,false,5,4,-1,41.89083,-87.61852
RN-,1,7,false,7,4,-3,41.89102,-87.63546
TA1307000117,1,7,false,3,6,3,41.89144,-87.62675
TA1305000003,1,7,false,8,2,-6,41.89187,-87.62061
13022,1,7,false,6,4,-2,41.89227,-87.61205
TA1306000029,1,7,false,6,4,-2,41.89256,-87.61449
13265,1,7,false,5,1,-4,41.89383,-87.64172
13045,1,7,false,9,6,-3,41.89403,-87.62931
13016,1,7,false,5,8,3,41.89431,-87.62277
KA1503000041,1,7,false,5,6,1,41.89452,-87.61798
15530,1,7,false,6,2,-4,41.89575,-87.62596
13303,1,7,false,5,2,-3,41.89672,-87.63088
13338,1,7,false,12,3,-9,41.89697,-87.62173
15529,1,7,false,6,1,-5,41.89858,-87.62206
TA1307000128,1,7,false,5,4,-1,41.89896,-87.6299
TA1306000011,1,7,false,6,1,-5,41.89994,-87.63443
13042,1,7,false,3,8,5,41.90097,-87.62377
KA1504000133,1,7,false,12,6,-6,41.90234,-87.62773
TA1307000039,1,7,false,10,4,-6,41.90294,-87.63137
KA1504000135,1,7,false,3,8,5,41.90319,-87.63439
13061,1,7,false,8,2,-6,41.90342,-87.66779
TA1305000041,1,7,false,2,5,3,41.9094,-87.67769
331,1,7,false,1,6,5,41.90965,-87.64812
13058,1,7,false,1,5,4,41.91059,-87.64942
LF-005,1,7,false,8,7,-1,41.91172,-87.62681
TA1308000050,1,7,false,6,6,0,41.91211,-87.6347
13179,1,7,false,1,5,4,41.9157,-87.63461
13133,1,7,false,5,1,-4,41.91598,-87.67733
TA1305000039,1,7,false,2,8,6,41.9163,-87.66749
13059,1,7,false,11,1,-10,41.91845,-87.65222
13191,1,7,false,2,6,4,41.92217,-87.63891
TA1307000113,1,7,false,5,1,-4,41.92878,-87.66391
13296,1,7,false,6,2,-4,41.92883,-87.66852
TA1309000061,1,7,false,5,2,-3,41.92915,-87.64909
TA1305000014,1,7,false,7,1,-6,41.92956,-87.64313
13235,1,7,false,5,1,-4,41.94814,-87.66396
TA1308000045,1,7,true,6,4,-2,41.83062,-87.64129
TA1309000055,1,7,true,5,1,-4,41.8382,-87.64514
TA1307000048,1,7,true,5,4,-1,41.83855,-87.60821
15545,1,7,true,7,10,3,41.85627,-87.61334
13102,1,7,true,9,2,-7,41.85762,-87.61942
13150,1,7,true,8,4,-4,41.85783,-87.62455
SL-012,1,7,true,9,3,-6,41.86038,-87.62581
13304,1,7,true,7,3,-4,41.86126,-87.65659
TA1306000002,1,7,true,6,1,-5,41.86238,-87.65108
TA1307000124,1,7,true,14,5,-9,41.86411,-87.62372
TA1305000002,1,7,true,11,2,-9,41.86721,-87.62597
15544,1,7,true,5,8,3,41.86723,-87.61536
SL-005,1,7,true,21,9,-12,41.8679,-87.62304
13160,1,7,true,5,7,2,41.86947,-87.65548
TA1309000010,1,7,true,12,3,-9,41.87074,-87.62574
SL-009,1,7,true,5,1,-4,41.87081,-87.63121
TA1309000064,1,7,true,3,28,25,41.87127,-87.67369
SL-008,1,7,true,12,2,-10,41.87209,-87.62956
13332,1,7,true,10,1,-9,41.87219,-87.6615
SL-011,1,7,true,16,5,-11,41.87256,-87.63356
623,1,7,true,10,8,-2,41.87272,-87.62399
KA1504000104,1,7,true,8,27,19,41.87296,-87.66912
SL-007,1,7,true,14,3,-11,41.87404,-87.6277
TA1306000025,1,7,true,5,1,-4,41.87464,-87.65703
SL-010,1,7,true,20,4,-16,41.87501,-87.63309
TA1305000035,1,7,true,2,19,17,41.87716,-87.62787
13138,1,7,true,11,17,6,41.87723,-87.63941
15539,1,7,true,12,5,-7,41.87763,-87.64405
13158,1,7,true,27,5,-22,41.87764,-87.64957
13157,1,7,true,8,4,-4,41.87773,-87.6548
TA1305000025,1,7,true,5,29,24,41.87773,-87.63528
TA1309000002,1,7,true,5,3,-2,41.87784,-87.62408
13206,1,7,true,6,1,-5,41.87794,-87.66201
TA1309000004,1,7,true,8,53,45,41.87811,-87.63184
638,1,7,true,24,20,-4,41.87827,-87.64078
TA1305000005,1,7,true,5,16,11,41.87924,-87.62975
13011,1,7,true,16,7,-9,41.87931,-87.63993
TA1309000008,1,7,true,5,24,19,41.87933,-87.6355
KA1503000015,1,7,true,4,21,17,41.87948,-87.6257
13156,1,7,true,11,6,-5,41.88042,-87.65554
TA1305000006,1,7,true,5,31,26,41.88122,-87.6296
13134,1,7,true,5,1,-4,41.88138,-87.67493
13056,1,7,true,17,25,8,41.88168,-87.63951
TA1307000120,1,7,true,20,9,-11,41.88188,-87.64879
13341,1,7,true,23,23,0,41.88208,-87.63985
TA1305000032,1,7,true,17,17,0,41.88218,-87.64109
13006,1,7,true,5,16,11,41.88268,-87.63252
13353,1,7,true,7,8,1,41.88283,-87.6612
654,1,7,true,5,1,-4,41.88307,-87.65698
13409,1,7,true,6,2,-4,41.8831,-87.6511
KA1503000072,1,7,true,4,24,20,41.88317,-87.63693
WL-012,1,7,true,37,20,-17,41.88337,-87.6412
13053,1,7,true,8,9,1,41.88365,-87.64863
13001,1,7,true,9,34,25,41.88397,-87.62459
13155,1,7,true,1,8,7,41.88407,-87.65689
18062,1,7,true,8,13,5,41.88412,-87.65427
TA1306000010,1,7,true,4,29,25,41.88419,-87.62961
TA1305000030,1,7,true,5,21,16,41.88459,-87.63178
15535,1,7,true,6,1,-5,41.8846,-87.64455
TA1305000029,1,7,true,5,5,0,41.88466,-87.62787
13263,1,7,true,22,9,-13,41.88467,-87.61952
TA1306000015,1,7,true,7,10,3,41.88549,-87.65232
13021,1,7,true,17,28,11,41.88559,-87.64184
TA1307000111,1,7,true,8,23,15,41.88582,-87.63548
13073,1,7,true,2,6,4,41.88592,-87.66717
KA1503000012,1,7,true,11,7,-4,41.88599,-87.63089
TA1305000011,1,7,true,5,37,32,41.886,-87.62418
15534,1,7,true,9,1,-8,41.88627,-87.61749
13197,1,7,true,3,12,9,41.8866,-87.65816
TA1308000029,1,7,true,7,4,-3,41.88673,-87.62225
TA1307000131,1,7,true,6,6,0,41.88688,-87.62606
TA1305000022,1,7,true,17,17,0,41.88817,-87.63656
TA1306000003,1,7,true,19,5,-14,41.88867,-87.64442
KA1503000043,1,7,true,32,42,10,41.88918,-87.63851
13050,1,7,true,13,16,3,41.88919,-87.62775
TA1307000151,1,7,true,17,30,13,41.88993,-87.63427
636,1,7,true,8,8,0,41.88997,-87.63662
KA1503000044,1,7,true,7,6,-1,41.89018,-87.6262
13427,1,7,true,12,14,2,41.89054,-87.62205
13430,1,7,true,3,10,7,41.89077,-87.63169
TA1306000013,1,7,true,8,7,-1,41.89083,-87.61852
RN-,1,7,true,17,2,-15,41.89102,-87.63546
TA1307000117,1,7,true,21,7,-14,41.89144,-87.62675
13033,1,7,true,10,9,-1,41.8916,-87.64835
13194,1,7,true,6,4,-2,41.8918,-87.65878
TA1305000003,1,7,true,15,11,-4,41.89187,-87.62061
13022,1,7,true,4,7,3,41.89227,-87.61205
TA1306000029,1,7,true,3,6,3,41.89256,-87.61449
13265,1,7,true,5,4,-1,41.89383,-87.64172
13045,1,7,true,37,22,-15,41.89403,-87.62931
13016,1,7,true,15,76,61,41.89431,-87.62277
KA1503000041,1,7,true,9,27,18,41.89452,-87.61798
13196,1,7,true,7,1,-6,41.89455,-87.65345
TA1307000062,1,7,true,17,15,-2,41.89466,-87.63839
TA1306000012,1,7,true,28,11,-17,41.89475,-87.63438
KP1705001026,1,7,true,13,4,-9,41.89483,-87.6323
13132,1,7,true,5,3,-2,41.89573,-87.67718
15530,1,7,true,8,22,14,41.89575,-87.62596
TA1305000020,1,7,true,2,6,4,41.89636,-87.65406
13289,1,7,true,14,1,-13,41.89638,-87.661
13303,1,7,true,13,3,-10,41.89672,-87.63088
13017,1,7,true,10,11,1,41.89676,-87.6357
13338,1,7,true,27,23,-4,41.89697,-87.62173
TA1307000061,1,7,true,14,4,-10,41.89745,-87.62873
TA1306000009,1,7,true,17,33,16,41.89772,-87.64299
15529,1,7,true,15,12,-3,41.89858,-87.62206
TA1307000128,1,7,true,11,7,-4,41.89896,-87.6299
13248,1,7,true,12,2,-10,41.89964,-87.66788
TA1306000011,1,7,true,23,3,-20,41.89994,-87.63443
KA1504000116,1,7,true,8,4,-4,41.90023,-87.64299
13290,1,7,true,7,2,-5,41.90069,-87.66259
13042,1,7,true,16,9,-7,41.90097,-87.62377
TA1307000070,1,7,true,8,2,-6,41.90133,-87.67742
KA1504000133,1,7,true,13,5,-8,41.90234,-87.62773
TA1307000039,1,7,true,42,24,-18,41.90294,-87.63137
KA1504000135,1,7,true,17,10,-7,41.90319,-87.63439
13061,1,7,true,6,8,2,41.90342,-87.66779
KA1504000079,1,7,true,11,3,-8,41.9035,-87.64334
TA1307000115,1,7,true,5,2,-3,41.9046,-87.64056
TA1307000143,1,7,true,10,3,-7,41.90762,-87.63854
13221,1,7,true,9,4,-5,41.90765,-87.67254
TA1309000024,1,7,true,16,3,-13,41.908,-87.63152
TA1305000041,1,7,true,2,7,5,41.9094,-87.67769
331,1,7,true,11,9,-2,41.90965,-87.64812
13258,1,7,true,5,1,-4,41.91043,-87.69718
13058,1,7,true,6,7,1,41.91059,-87.64942
TA1307000038,1,7,true,16,7,-9,41.91138,-87.63868
LF-005,1,7,true,10,4,-6,41.91172,-87.62681
13128,1,7,true,7,6,-1,41.91197,-87.63197
TA1308000050,1,7,true,27,19,-8,41.91211,-87.6347
13243,1,7,true,10,4,-6,41.91262,-87.6814
TA1306000032,1,7,true,10,1,-9,41.9137,-87.65285
18067,1,7,true,6,2,-4,41.9146,-87.66796
TA1306000007,1,7,true,6,2,-4,41.91469,-87.64333
13179,1,7,true,13,7,-6,41.9157,-87.63461
TA1305000039,1,7,true,5,4,-1,41.9163,-87.66749
TA1309000029,1,7,true,6,2,-4,41.9178,-87.68245
TA1309000006,1,7,true,4,5,1,41.91809,-87.64375
TA1307000163,1,7,true,10,8,-2,41.91821,-87.65696
13146,1,7,true,11,7,-4,41.91831,-87.63629
13059,1,7,true,8,7,-1,41.91845,-87.65222
13192,1,7,true,12,9,-3,41.91995,-87.64884
TA1309000033,1,7,true,6,6,0,41.92158,-87.65381
13193,1,7,true,10,6,-4,41.92182,-87.64412
13191,1,7,true,7,4,-3,41.92217,-87.63891
LP-,1,7,true,9,2,-7,41.92396,-87.63584
15648,1,7,true,6,1,-5,41.92464,-87.68931
TA1307000001,1,7,true,6,3,-3,41.92535,-87.66581
TA1306000026,1,7,true,6,2,-4,41.92558,-87.65842
TA1306000016,1,7,true,4,6,2,41.9256,-87.65371
TA1309000019,1,7,true,14,8,-6,41.92586,-87.63897
TA1309000058,1,7,true,10,4,-6,41.92591,-87.64927
TA1308000001,1,7,true,8,7,-1,41.92627,-87.63086
TA1309000059,1,7,true,7,1,-6,41.92889,-87.65898
TA1305000014,1,7,true,11,7,-4,41.92956,-87.64313
TA1307000142,1,7,true,10,4,-6,41.93125,-87.64432
13276,1,7,true,11,6,-5,41.93132,-87.63874
TA1307000064,1,7,true,2,6,4,41.93222,-87.65864
TA1306000014,1,7,true,14,5,-9,41.93242,-87.65271
TA1309000039,1,7,true,7,6,-1,41.93258,-87.63642
13294,1,7,true,12,1,-11,41.9326,-87.66595
TA1309000036,1,7,true,5,3,-2,41.93313,-87.64776
TA1307000006,1,7,true,13,2,-11,41.93571,-87.6636
TA1307000052,1,7,true,7,16,9,41.93628,-87.65266
TA1307000041,1,7,true,7,4,-3,41.93669,-87.63683
13137,1,7,true,17,8,-9,41.9376,-87.6441
KA17018068,1,7,true,5,2,-3,41.93935,-87.68327
TA1309000042,1,7,true,3,10,7,41.93937,-87.66836
13229,1,7,true,5,1,-4,41.93946,-87.66376
13277,1,7,true,5,5,0,41.9401,-87.64546
TA1307000134,1,7,true,5,6,1,41.94016,-87.65303
TA1309000049,1,7,true,6,4,-2,41.94077,-87.63919
TA1307000138,1,7,true,5,5,0,41.94334,-87.67094
TA1309000025,1,7,true,8,2,-6,41.94368,-87.64894
632,1,7,true,4,6,2,41.94453,-87.6547
13278,1,7,true,13,3,-10,41.94553,-87.64644
13325,1,7,true,11,4,-7,41.94907,-87.64863
TA1307000126,1,7,true,10,7,-3,41.94936,-87.65451
TA1307000150,1,7,true,7,4,-3,41.94945,-87.64646
13323,1,7,true,6,2,-4,41.95282,-87.65
13063,1,7,true,8,6,-2,41.95424,-87.65441
TA1308000022,1,7,true,5,2,-3,41.95438,-87.64805
TA1307000149,1,7,true,1,8,7,41.95467,-87.67392
13379,1,7,true,8,3,-5,41.95786,-87.6495
13389,1,7,true,5,6,1,41.961,-87.64958
TA1307000107,1,7,true,3,9,6,41.96164,-87.65464
TA1309000012,1,7,true,1,5,4,41.96325,-87.67928
TA1307000158,1,7,true,3,7,4,41.9671,-87.67904
TA1309000066,1,7,true,5,8,3,41.9691,-87.67423
KA1504000151,1,7,true,10,1,-9,41.98359,-87.66916
KA1504000152,1,7,true,5,3,-2,41.98403,-87.65231
15578,1,7,true,5,4,-1,41.98405,-87.66027
TA1305000002,1,8,false,4,8,4,41.86721,-87.62597
SL-008,1,8,false,9,3,-6,41.87209,-87.62956
SL-007,1,8,false,5,4,-1,41.87404,-87.6277
SL-010,1,8,false,1,5,4,41.87501,-87.63309
13158,1,8,false,2,7,5,41.87764,-87.64957
638,1,8,false,2,5,3,41.87827,-87.64078
13011,1,8,false,5,9,4,41.87931,-87.63993
TA1309000007,1,8,false,1,12,11,41.88022,-87.63526
13300,1,8,false,12,4,-8,41.88097,-87.61675
13008,1,8,false,4,8,4,41.88105,-87.62408
TA1305000006,1,8,false,4,10,6,41.88122,-87.6296
TA1307000120,1,8,false,4,5,1,41.88188,-87.64879
13341,1,8,false,7,5,-2,41.88208,-87.63985
TA1305000032,1,8,false,8,5,-3,41.88218,-87.64109
KA1503000072,1,8,false,4,8,4,41.88317,-87.63693
13001,1,8,false,5,6,1,41.88397,-87.62459
TA1305000030,1,8,false,5,9,4,41.88459,-87.63178
15535,1,8,false,5,7,2,41.8846,-87.64455
TA1305000029,1,8,false,5,7,2,41.88466,-87.62787
TA1306000015,1,8,false,2,10,8,41.88549,-87.65232
13021,1,8,false,6,5,-1,41.88559,-87.64184
TA1307000111,1,8,false,1,10,9,41.88582,-87.63548
KA1503000012,1,8,false,2,6,4,41.88599,-87.63089
TA1305000011,1,8,false,7,7,0,41.886,-87.62418
TA1308000029,1,8,false,8,2,-6,41.88673,-87.62225
TA1305000022,1,8,false,6,9,3,41.88817,-87.63656
TA1306000003,1,8,false,8,1,-7,41.88867,-87.64442
KA1503000043,1,8,false,8,3,-5,41.88918,-87.63851
13050,1,8,false,2,6,4,41.88919,-87.62775
TA1307000151,1,8,false,2,6,4,41.88993,-87.63427
KA1503000044,1,8,false,6,2,-4,41.89018,-87.6262
13430,1,8,false,6,1,-5,41.89077,-87.63169
TA1306000013,1,8,false,5,3,-2,41.89083,-87.61852
RN-,1,8,false,2,9,7,41.89102,-87.63546
TA1307000117,1,8,false,5,8,3,41.89144,-87.62675
TA1305000003,1,8,false,5,1,-4,41.89187,-87.62061
13265,1,8,false,5,1,-4,41.89383,-87.64172
13045,1,8,false,14,8,-6,41.89403,-87.62931
13016,1,8,false,8,10,2,41.89431,-87.62277
KA1503000041,1,8,false,5,5,0,41.89452,-87.61798
TA1306000012,1,8,false,10,8,-2,41.89475,-87.63438
TA1306000009,1,8,false,5,4,-1,41.89772,-87.64299
TA1307000128,1,8,false,4,10,6,41.89896,-87.6299
13042,1,8,false,10,10,0,41.90097,-87.62377
TA1307000039,1,8,false,5,4,-1,41.90294,-87.63137
KA1504000135,1,8,false,9,6,-3,41.90319,-87.63439
13061,1,8,false,5,3,-2,41.90342,-87.66779
TA1305000041,1,8,false,1,6,5,41.9094,-87.67769
331,1,8,false,5,3,-2,41.90965,-87.64812
LF-005,1,8,false,3,9,6,41.91172,-87.62681
13128,1,8,false,5,3,-2,41.91197,-87.63197
TA1308000050,1,8,false,7,10,3,41.91211,-87.6347
13179,1,8,false,7,2,-5,41.9157,-87.63461
TA1305000039,1,8,false,5,2,-3,41.9163,-87.66749
13146,1,8,false,3,5,2,41.91831,-87.63629
13192,1,8,false,1,5,4,41.91995,-87.64884
13292,1,8,false,6,1,-5,41.92152,-87.70733
13193,1,8,false,5,4,-1,41.92182,-87.64412
TA1306000016,1,8,false,2,9,7,41.9256,-87.65371
TA1309000019,1,8,false,5,4,-1,41.92586,-87.63897
TA1309000058,1,8,false,8,1,-7,41.92591,-87.64927
TA1307000113,1,8,false,5,1,-4,41.92878,-87.66391
TA1305000014,1,8,false,2,5,3,41.92956,-87.64313
TA1307000142,1,8,false,1,5,4,41.93125,-87.64432
13276,1,8,false,5,4,-1,41.93132,-87.63874
TA1307000064,1,8,false,6,2,-4,41.93222,-87.65864
TA1306000014,1,8,false,1,5,4,41.93242,-87.65271
TA1309000036,1,8,false,5,3,-2,41.93313,-87.64776
TA1308000019,1,8,false,5,5,0,41.93973,-87.65886
TA1307000134,1,8,false,6,3,-3,41.94016,-87.65303
TA1309000049,1,8,false,7,4,-3,41.94077,-87.63919
13325,1,8,false,6,7,1,41.94907,-87.64863
13323,1,8,false,4,6,2,41.95282,-87.65
TA1309000011,1,8,true,3,6,3,41.78873,-87.60131
KA1503000071,1,8,true,3,6,3,41.79148,-87.59988
KA1503000007,1,8,true,5,1,-4,41.80242,-87.58689
13216,1,8,true,3,7,4,41.83473,-87.62581
TA1307000005,1,8,true,5,6,1,41.84569,-87.6225
15545,1,8,true,5,5,0,41.85627,-87.61334
13135,1,8,true,8,3,-5,41.85753,-87.66157
13102,1,8,true,11,4,-7,41.85762,-87.61942
13150,1,8,true,9,2,-7,41.85783,-87.62455
13099,1,8,true,5,3,-2,41.85784,-87.64627
13163,1,8,true,5,1,-4,41.85808,-87.65108
13164,1,8,true,5,1,-4,41.85818,-87.65648
TA1307000124,1,8,true,10,4,-6,41.86411,-87.62372
TA1305000002,1,8,true,16,9,-7,41.86721,-87.62597
SL-005,1,8,true,17,5,-12,41.8679,-87.62304
644,1,8,true,5,1,-4,41.86859,-87.68625
13285,1,8,true,5,21,16,41.86928,-87.67372
TA1309000010,1,8,true,7,4,-3,41.87074,-87.62574
TA1309000064,1,8,true,1,9,8,41.87127,-87.67369
TA1307000130,1,8,true,9,3,-6,41.87178,-87.65103
TA1307000121,1,8,true,1,9,8,41.87184,-87.64664
SL-008,1,8,true,21,9,-12,41.87209,-87.62956
13332,1,8,true,16,5,-11,41.87219,-87.6615
SL-011,1,8,true,14,4,-10,41.87256,-87.63356
623,1,8,true,5,5,0,41.87272,-87.62399
KA1504000104,1,8,true,5,28,23,41.87296,-87.66912
SL-007,1,8,true,17,6,-11,41.87404,-87.6277
13326,1,8,true,1,6,5,41.87425,-87.63958
SL-010,1,8,true,8,1,-7,41.87501,-87.63309
624,1,8,true,2,6,4,41.87626,-87.62923
TA1305000035,1,8,true,7,8,1,41.87716,-87.62787
13138,1,8,true,8,14,6,41.87723,-87.63941
15539,1,8,true,2,6,4,41.87763,-87.64405
13158,1,8,true,12,6,-6,41.87764,-87.64957
13157,1,8,true,6,2,-4,41.87773,-87.6548
TA1305000025,1,8,true,13,51,38,41.87773,-87.63528
TA1309000002,1,8,true,6,5,-1,41.87784,-87.62408
13206,1,8,true,4,5,1,41.87794,-87.66201
TA1309000004,1,8,true,2,20,18,41.87811,-87.63184
638,1,8,true,18,26,8,41.87827,-87.64078
TA1305000005,1,8,true,1,22,21,41.87924,-87.62975
13011,1,8,true,22,16,-6,41.87931,-87.63993
KA1503000034,1,8,true,2,18,16,41.87938,-87.63197
KA1503000015,1,8,true,8,7,-1,41.87948,-87.6257
TA1309000007,1,8,true,3,47,44,41.88022,-87.63526
WL-011,1,8,true,9,3,-6,41.88034,-87.64273
13156,1,8,true,9,9,0,41.88042,-87.65554
13300,1,8,true,4,8,4,41.88097,-87.61675
13008,1,8,true,2,11,9,41.88105,-87.62408
TA1305000006,1,8,true,4,47,43,41.88122,-87.6296
13056,1,8,true,10,13,3,41.88168,-87.63951
TA1307000120,1,8,true,14,3,-11,41.88188,-87.64879
13341,1,8,true,10,25,15,41.88208,-87.63985
13036,1,8,true,6,15,9,41.8821,-87.62513
TA1305000032,1,8,true,40,29,-11,41.88218,-87.64109
13006,1,8,true,2,18,16,41.88268,-87.63252
13353,1,8,true,13,8,-5,41.88283,-87.6612
654,1,8,true,5,4,-1,41.88307,-87.65698
13409,1,8,true,8,6,-2,41.8831,-87.6511
KA1503000072,1,8,true,3,27,24,41.88317,-87.63693
WL-012,1,8,true,35,29,-6,41.88337,-87.6412
13053,1,8,true,7,5,-2,41.88365,-87.64863
13001,1,8,true,21,24,3,41.88397,-87.62459
13155,1,8,true,1,7,6,41.88407,-87.65689
18062,1,8,true,7,14,7,41.88412,-87.65427
TA1306000010,1,8,true,7,37,30,41.88419,-87.62961
TA1305000030,1,8,true,9,64,55,41.88459,-87.63178
15535,1,8,true,4,7,3,41.8846,-87.64455
TA1305000029,1,8,true,4,8,4,41.88466,-87.62787
13263,1,8,true,14,17,3,41.88467,-87.61952
TA1306000015,1,8,true,8,14,6,41.88549,-87.65232
13021,1,8,true,13,32,19,41.88559,-87.64184
TA1307000111,1,8,true,7,32,25,41.88582,-87.63548
KA1503000012,1,8,true,11,17,6,41.88599,-87.63089
TA1305000011,1,8,true,12,22,10,41.886,-87.62418
15534,1,8,true,14,5,-9,41.88627,-87.61749
13197,1,8,true,8,3,-5,41.8866,-87.65816
TA1308000029,1,8,true,10,7,-3,41.88673,-87.62225
TA1307000131,1,8,true,7,10,3,41.88688,-87.62606
TA1305000022,1,8,true,7,25,18,41.88817,-87.63656
TA1306000003,1,8,true,25,18,-7,41.88867,-87.64442
KA1503000043,1,8,true,34,38,4,41.88918,-87.63851
13050,1,8,true,12,40,28,41.88919,-87.62775
TA1307000151,1,8,true,19,32,13,41.88993,-87.63427
636,1,8,true,8,13,5,41.88997,-87.63662
KA1503000044,1,8,true,10,15,5,41.89018,-87.6262
13427,1,8,true,9,9,0,41.89054,-87.62205
13430,1,8,true,5,20,15,41.89077,-87.63169
TA1306000013,1,8,true,7,7,0,41.89083,-87.61852
RN-,1,8,true,4,6,2,41.89102,-87.63546
TA1307000117,1,8,true,10,13,3,41.89144,-87.62675
13033,1,8,true,13,13,0,41.8916,-87.64835
13194,1,8,true,3,6,3,41.8918,-87.65878
TA1305000003,1,8,true,15,14,-1,41.89187,-87.62061
13022,1,8,true,11,5,-6,41.89227,-87.61205
TA1306000029,1,8,true,5,11,6,41.89256,-87.61449
13265,1,8,true,15,12,-3,41.89383,-87.64172
13045,1,8,true,22,21,-1,41.89403,-87.62931
13016,1,8,true,14,38,24,41.89431,-87.62277
KA1503000041,1,8,true,20,20,0,41.89452,-87.61798
13196,1,8,true,10,7,-3,41.89455,-87.65345
TA1307000062,1,8,true,16,22,6,41.89466,-87.63839
TA1306000012,1,8,true,30,21,-9,41.89475,-87.63438
637,1,8,true,5,2,-3,41.89563,-87.67209
13132,1,8,true,5,2,-3,41.89573,-87.67718
15530,1,8,true,23,22,-1,41.89575,-87.62596
TA1305000020,1,8,true,4,5,1,41.89636,-87.65406
13303,1,8,true,7,5,-2,41.89672,-87.63088
13017,1,8,true,20,10,-10,41.89676,-87.6357
13338,1,8,true,6,20,14,41.89697,-87.62173
TA1307000061,1,8,true,15,6,-9,41.89745,-87.62873
TA1306000009,1,8,true,14,17,3,41.89772,-87.64299
620,1,8,true,10,4,-6,41.89817,-87.63754
15529,1,8,true,13,13,0,41.89858,-87.62206
TA1307000128,1,8,true,15,10,-5,41.89896,-87.6299
657,1,8,true,9,4,-5,41.89918,-87.6722
13248,1,8,true,8,3,-5,41.89964,-87.66788
TA1306000011,1,8,true,6,1,-5,41.89994,-87.63443
KA1504000116,1,8,true,5,3,-2,41.90023,-87.64299
13290,1,8,true,9,4,-5,41.90069,-87.66259
13042,1,8,true,21,18,-3,41.90097,-87.62377
TA1307000070,1,8,true,7,1,-6,41.90133,-87.67742
KA1504000133,1,8,true,5,6,1,41.90234,-87.62773
TA1306000006,1,8,true,5,2,-3,41.90292,-87.63772
TA1307000039,1,8,true,26,15,-11,41.90294,-87.63137
658,1,8,true,1,8,7,41.903,-87.6838
KA1504000135,1,8,true,6,10,4,41.90319,-87.63439
13136,1,8,true,11,7,-4,41.90326,-87.67845
13061,1,8,true,20,13,-7,41.90342,-87.66779
KA1504000079,1,8,true,6,5,-1,41.9035,-87.64334
TA1308000049,1,8,true,7,5,-2,41.90672,-87.6349
TA1309000024,1,8,true,10,8,-2,41.908,-87.63152
TA1305000041,1,8,true,9,6,-3,41.9094,-87.67769
331,1,8,true,7,5,-2,41.90965,-87.64812
TA1305000037,1,8,true,9,2,-7,41.91018,-87.67003
TA1308000005,1,8,true,7,1,-6,41.91042,-87.68238
13257,1,8,true,7,1,-6,41.91054,-87.68956
13154,1,8,true,9,5,-4,41.91054,-87.65312
13058,1,8,true,7,2,-5,41.91059,-87.64942
TA1307000038,1,8,true,15,6,-9,41.91138,-87.63868
LF-005,1,8,true,5,2,-3,41.91172,-87.62681
13128,1,8,true,4,7,3,41.91197,-87.63197
TA1308000050,1,8,true,11,13,2,41.91211,-87.6347
13243,1,8,true,8,3,-5,41.91262,-87.6814
TA1307000166,1,8,true,5,3,-2,41.91386,-87.64877
TA1306000007,1,8,true,6,1,-5,41.91469,-87.64333
13179,1,8,true,19,7,-12,41.9157,-87.63461
13133,1,8,true,10,1,-9,41.91598,-87.67733
TA1305000039,1,8,true,2,18,16,41.9163,-87.66749
TA1309000029,1,8,true,6,3,-3,41.9178,-87.68245
TA1309000006,1,8,true,5,3,-2,41.91809,-87.64375
TA1307000163,1,8,true,6,10,4,41.91821,-87.65696
13146,1,8,true,13,7,-6,41.91831,-87.63629
13059,1,8,true,9,7,-2,41.91845,-87.65222
13192,1,8,true,6,6,0,41.91995,-87.64884
TA1309000030,1,8,true,6,4,-2,41.92077,-87.66372
TA1309000033,1,8,true,7,3,-4,41.92158,-87.65381
13193,1,8,true,14,12,-2,41.92182,-87.64412
13191,1,8,true,10,4,-6,41.92217,-87.63891
TA1307000001,1,8,true,3,6,3,41.92535,-87.66581
TA1306000026,1,8,true,12,8,-4,41.92558,-87.65842
TA1306000016,1,8,true,15,12,-3,41.9256,-87.65371
TA1309000019,1,8,true,14,4,-10,41.92586,-87.63897
TA1309000058,1,8,true,13,17,4,41.92591,-87.64927
TA1308000001,1,8,true,5,2,-3,41.92627,-87.63086
15646,1,8,true,6,3,-3,41.92668,-87.6977
TA1309000023,1,8,true,5,5,0,41.9287,-87.65383
13296,1,8,true,5,4,-1,41.92883,-87.66852
TA1309000059,1,8,true,5,5,0,41.92889,-87.65898
TA1309000061,1,8,true,9,7,-2,41.92915,-87.64909
TA1305000014,1,8,true,11,11,0,41.92956,-87.64313
TA1307000142,1,8,true,9,5,-4,41.93125,-87.64432
13276,1,8,true,11,3,-8,41.93132,-87.63874
TA1307000064,1,8,true,12,7,-5,41.93222,-87.65864
TA1306000014,1,8,true,7,7,0,41.93242,-87.65271
TA1309000039,1,8,true,15,6,-9,41.93258,-87.63642
TA1309000036,1,8,true,9,8,-1,41.93313,-87.64776
TA1307000006,1,8,true,7,4,-3,41.93571,-87.6636
13269,1,8,true,6,4,-2,41.93609,-87.66983
TA1307000052,1,8,true,9,13,4,41.93628,-87.65266
TA1307000136,1,8,true,10,6,-4,41.9365,-87.64755
TA1307000041,1,8,true,15,5,-10,41.93669,-87.63683
13137,1,8,true,17,15,-2,41.9376,-87.6441
TA1309000042,1,8,true,8,4,-4,41.93937,-87.66836
13229,1,8,true,8,1,-7,41.93946,-87.66376
TA1308000019,1,8,true,10,4,-6,41.93973,-87.65886
13277,1,8,true,17,7,-10,41.9401,-87.64546
TA1307000134,1,8,true,9,15,6,41.94016,-87.65303
TA1309000049,1,8,true,10,9,-1,41.94077,-87.63919
TA1307000138,1,8,true,8,9,1,41.94334,-87.67094
13144,1,8,true,8,3,-5,41.9434,-87.67964
TA1309000025,1,8,true,6,5,-1,41.94368,-87.64894
13071,1,8,true,3,6,3,41.94373,-87.66401
632,1,8,true,11,5,-6,41.94453,-87.6547
13278,1,8,true,7,4,-3,41.94553,-87.64644
13235,1,8,true,11,13,2,41.94814,-87.66396
13253,1,8,true,5,3,-2,41.9488,-87.67527
13325,1,8,true,8,4,-4,41.94907,-87.64863
TA1307000126,1,8,true,4,8,4,41.94936,-87.65451
TA1307000150,1,8,true,8,8,0,41.94945,-87.64646
TA1307000127,1,8,true,3,6,3,41.9508,-87.65918
13323,1,8,true,5,9,4,41.95282,-87.65
TA1309000043,1,8,true,1,5,4,41.95417,-87.66434
13063,1,8,true,2,12,10,41.95424,-87.65441
TA1307000149,1,8,true,2,13,11,41.95467,-87.67392
13379,1,8,true,15,2,-13,41.95786,-87.6495
13389,1,8,true,5,7,2,41.961,-87.64958
TA1307000107,1,8,true,5,5,0,41.96164,-87.65464
13074,1,8,true,1,5,4,41.96521,-87.6582
TA1307000140,1,8,true,6,2,-4,41.96643,-87.68865
TA1309000014,1,8,true,4,7,3,41.96709,-87.66744
TA1307000158,1,8,true,6,5,-1,41.9671,-87.67904
TA1307000119,1,8,true,5,3,-2,41.96796,-87.65
TA1309000066,1,8,true,13,9,-4,41.9691,-87.67423
13108,1,8,true,7,2,-5,41.97379,-87.65971
KA1504000151,1,8,true,1,5,4,41.98359,-87.66916
15575,1,8,true,15,4,-11,41.98975,-87.66014
15571,1,8,true,6,1,-5,41.99478,-87.66028
TA1309000011,1,9,false,1,5,4,41.78873,-87.60131
TA1308000009,1,9,false,3,6,3,41.79522,-87.58075
TA1307000124,1,9,false,2,6,4,41.86411,-87.62372
WL-008,1,9,false,5,1,-4,41.86712,-87.64108
TA1305000002,1,9,false,6,6,0,41.86721,-87.62597
15544,1,9,false,2,13,11,41.86723,-87.61536
SL-005,1,9,false,5,7,2,41.8679,-87.62304
SL-007,1,9,false,6,4,-2,41.87404,-87.6277
15541,1,9,false,3,6,3,41.8758,-87.62086
TA1305000010,1,9,false,8,1,-7,41.87623,-87.62444
TA1305000025,1,9,false,1,10,9,41.87773,-87.63528
TA1309000002,1,9,false,5,3,-2,41.87784,-87.62408
TA1309000008,1,9,false,5,1,-4,41.87933,-87.6355
13300,1,9,false,19,4,-15,41.88097,-87.61675
13008,1,9,false,10,6,-4,41.88105,-87.62408
TA1307000120,1,9,false,4,6,2,41.88188,-87.64879
13341,1,9,false,3,5,2,41.88208,-87.63985
TA1305000032,1,9,false,6,4,-2,41.88218,-87.64109
WL-012,1,9,false,5,6,1,41.88337,-87.6412
13001,1,9,false,8,9,1,41.88397,-87.62459
TA1305000030,1,9,false,7,8,1,41.88459,-87.63178
TA1305000029,1,9,false,9,3,-6,41.88466,-87.62787
KA1503000012,1,9,false,3,5,2,41.88599,-87.63089
TA1305000011,1,9,false,9,5,-4,41.886,-87.62418
TA1308000029,1,9,false,7,3,-4,41.88673,-87.62225
KA1503000064,1,9,false,7,2,-5,41.88697,-87.61281
TA1305000022,1,9,false,3,8,5,41.88817,-87.63656
KA1503000043,1,9,false,7,6,-1,41.88918,-87.63851
13050,1,9,false,8,6,-2,41.88919,-87.62775
TA1307000151,1,9,false,4,7,3,41.88993,-87.63427
13427,1,9,false,5,3,-2,41.89054,-87.62205
TA1306000013,1,9,false,5,7,2,41.89083,-87.61852
RN-,1,9,false,8,1,-7,41.89102,-87.63546
TA1307000117,1,9,false,14,3,-11,41.89144,-87.62675
TA1305000003,1,9,false,2,7,5,41.89187,-87.62061
13022,1,9,false,14,14,0,41.89227,-87.61205
TA1306000029,1,9,false,5,4,-1,41.89256,-87.61449
13045,1,9,false,6,8,2,41.89403,-87.62931
13016,1,9,false,5,6,1,41.89431,-87.62277
KA1503000041,1,9,false,11,3,-8,41.89452,-87.61798
TA1307000062,1,9,false,6,2,-4,41.89466,-87.63839
TA1306000009,1,9,false,3,6,3,41.89772,-87.64299
13042,1,9,false,13,7,-6,41.90097,-87.62377
TA1307000039,1,9,false,9,5,-4,41.90294,-87.63137
TA1305000041,1,9,false,5,3,-2,41.9094,-87.67769
331,1,9,false,2,5,3,41.90965,-87.64812
TA1307000038,1,9,false,5,3,-2,41.91138,-87.63868
LF-005,1,9,false,2,5,3,41.91172,-87.62681
TA1308000050,1,9,false,5,8,3,41.91211,-87.6347
18067,1,9,false,6,2,-4,41.9146,-87.66796
13179,1,9,false,2,8,6,41.9157,-87.63461
13059,1,9,false,3,5,2,41.91845,-87.65222
13193,1,9,false,7,4,-3,41.92182,-87.64412
TA1309000019,1,9,false,5,1,-4,41.92586,-87.63897
TA1309000058,1,9,false,1,7,6,41.92591,-87.64927
TA1308000001,1,9,false,5,6,1,41.92627,-87.63086
13276,1,9,false,7,2,-5,41.93132,-87.63874
13137,1,9,false,2,6,4,41.9376,-87.6441
13235,1,9,false,3,7,4,41.94814,-87.66396
TA1308000012,1,9,false,5,1,-4,41.96398,-87.63818
KA1503000071,1,9,true,3,13,10,41.79148,-87.59988
TA1308000009,1,9,true,11,5,-6,41.79522,-87.58075
KA1503000007,1,9,true,7,1,-6,41.80242,-87.58689
13216,1,9,true,1,14,13,41.83473,-87.62581
13217,1,9,true,5,2,-3,41.83488,-87.61792
TA1307000139,1,9,true,6,2,-4,41.84205,-87.61698
13075,1,9,true,1,6,5,41.8531,-87.63192
13102,1,9,true,7,3,-4,41.85762,-87.61942
SL-012,1,9,true,5,4,-1,41.86038,-87.62581
TA1307000124,1,9,true,6,4,-2,41.86411,-87.62372
TA1305000002,1,9,true,13,14,1,41.86721,-87.62597
15544,1,9,true,3,8,5,41.86723,-87.61536
SL-005,1,9,true,8,3,-5,41.8679,-87.62304
13285,1,9,true,3,9,6,41.86928,-87.67372
TA1309000010,1,9,true,4,5,1,41.87074,-87.62574
15542,1,9,true,1,5,4,41.87146,-87.64095
TA1307000121,1,9,true,14,2,-12,41.87184,-87.64664
SL-008,1,9,true,5,2,-3,41.87209,-87.62956
13332,1,9,true,5,5,0,41.87219,-87.6615
623,1,9,true,6,3,-3,41.87272,-87.62399
KA1504000104,1,9,true,5,13,8,41.87296,-87.66912
13028,1,9,true,8,1,-7,41.87475,-87.64981
SL-010,1,9,true,6,3,-3,41.87501,-87.63309
TA1305000009,1,9,true,3,5,2,41.87593,-87.63068
13138,1,9,true,3,7,4,41.87723,-87.63941
13158,1,9,true,7,5,-2,41.87764,-87.64957
13157,1,9,true,5,4,-1,41.87773,-87.6548
TA1305000025,1,9,true,3,20,17,41.87773,-87.63528
638,1,9,true,5,11,6,41.87827,-87.64078
TA1305000005,1,9,true,4,9,5,41.87924,-87.62975
13011,1,9,true,2,6,4,41.87931,-87.63993
TA1309000008,1,9,true,5,4,-1,41.87933,-87.6355
KA1503000034,1,9,true,1,10,9,41.87938,-87.63197
KA1503000015,1,9,true,6,9,3,41.87948,-87.6257
TA1309000007,1,9,true,6,18,12,41.88022,-87.63526
WL-011,1,9,true,3,8,5,41.88034,-87.64273
13008,1,9,true,2,9,7,41.88105,-87.62408
TA1305000006,1,9,true,10,11,1,41.88122,-87.6296
13056,1,9,true,3,8,5,41.88168,-87.63951
TA1307000120,1,9,true,6,15,9,41.88188,-87.64879
13341,1,9,true,2,11,9,41.88208,-87.63985
13036,1,9,true,5,7,2,41.8821,-87.62513
TA1305000032,1,9,true,16,7,-9,41.88218,-87.64109
13006,1,9,true,6,6,0,41.88268,-87.63252
13409,1,9,true,3,5,2,41.8831,-87.6511
WL-012,1,9,true,9,13,4,41.88337,-87.6412
13053,1,9,true,5,6,1,41.88365,-87.64863
13001,1,9,true,8,13,5,41.88397,-87.62459
18062,1,9,true,2,7,5,41.88412,-87.65427
TA1306000010,1,9,true,11,14,3,41.88419,-87.62961
TA1305000030,1,9,true,7,31,24,41.88459,-87.63178
TA1305000029,1,9,true,7,9,2,41.88466,-87.62787
13263,1,9,true,8,6,-2,41.88467,-87.61952
13021,1,9,true,12,19,7,41.88559,-87.64184
TA1307000111,1,9,true,7,12,5,41.88582,-87.63548
KA1503000012,1,9,true,5,8,3,41.88599,-87.63089
TA1305000011,1,9,true,4,9,5,41.886,-87.62418
TA1308000029,1,9,true,4,8,4,41.88673,-87.62225
TA1307000131,1,9,true,1,8,7,41.88688,-87.62606
KA1503000064,1,9,true,5,6,1,41.88697,-87.61281
TA1305000022,1,9,true,15,14,-1,41.88817,-87.63656
TA1306000003,1,9,true,5,6,1,41.88867,-87.64442
KA1503000043,1,9,true,18,6,-12,41.88918,-87.63851
13050,1,9,true,4,5,1,41.88919,-87.62775
TA1307000151,1,9,true,10,12,2,41.88993,-87.63427
636,1,9,true,8,3,-5,41.88997,-87.63662
KA1503000044,1,9,true,5,4,-1,41.89018,-87.6262
13427,1,9,true,4,11,7,41.89054,-87.62205
13430,1,9,true,5,6,1,41.89077,-87.63169
TA1306000013,1,9,true,5,5,0,41.89083,-87.61852
RN-,1,9,true,1,6,5,41.89102,-87.63546
13434,1,9,true,1,7,6,41.89108,-87.66663
TA1307000117,1,9,true,5,10,5,41.89144,-87.62675
13033,1,9,true,5,5,0,41.8916,-87.64835
13194,1,9,true,7,3,-4,41.8918,-87.65878
TA1305000003,1,9,true,5,6,1,41.89187,-87.62061
13022,1,9,true,8,5,-3,41.89227,-87.61205
TA1306000029,1,9,true,6,3,-3,41.89256,-87.61449
13265,1,9,true,11,6,-5,41.89383,-87.64172
13045,1,9,true,7,12,5,41.89403,-87.62931
13016,1,9,true,10,20,10,41.89431,-87.62277
KA1503000041,1,9,true,10,12,2,41.89452,-87.61798
TA1307000062,1,9,true,6,12,6,41.89466,-87.63839
TA1306000012,1,9,true,10,10,0,41.89475,-87.63438
637,1,9,true,5,2,-3,41.89563,-87.67209
15530,1,9,true,3,7,4,41.89575,-87.62596
18003,1,9,true,4,7,3,41.89575,-87.62011
TA1305000020,1,9,true,5,4,-1,41.89636,-87.65406
13017,1,9,true,7,2,-5,41.89676,-87.6357
13338,1,9,true,8,7,-1,41.89697,-87.62173
TA1307000061,1,9,true,5,4,-1,41.89745,-87.62873
13034,1,9,true,2,6,4,41.89754,-87.62352
TA1306000009,1,9,true,4,11,7,41.89772,-87.64299
15529,1,9,true,5,16,11,41.89858,-87.62206
TA1307000128,1,9,true,6,6,0,41.89896,-87.6299
13042,1,9,true,7,16,9,41.90097,-87.62377
KA1504000133,1,9,true,5,3,-2,41.90234,-87.62773
TA1307000039,1,9,true,11,19,8,41.90294,-87.63137
KA1504000135,1,9,true,5,6,1,41.90319,-87.63439
13061,1,9,true,6,7,1,41.90342,-87.66779
KA1504000079,1,9,true,5,1,-4,41.9035,-87.64334
TA1308000049,1,9,true,5,5,0,41.90672,-87.6349
13224,1,9,true,7,4,-3,41.90706,-87.66725
TA1309000024,1,9,true,7,4,-3,41.908,-87.63152
331,1,9,true,8,5,-3,41.90965,-87.64812
TA1305000037,1,9,true,8,1,-7,41.91018,-87.67003
13154,1,9,true,5,6,1,41.91054,-87.65312
TA1307000038,1,9,true,4,7,3,41.91138,-87.63868
LF-005,1,9,true,6,5,-1,41.91172,-87.62681
TA1308000050,1,9,true,7,4,-3,41.91211,-87.6347
18067,1,9,true,7,3,-4,41.9146,-87.66796
13068,1,9,true,1,10,9,41.91554,-87.68703
13179,1,9,true,7,6,-1,41.9157,-87.63461
13133,1,9,true,6,1,-5,41.91598,-87.67733
13146,1,9,true,6,4,-2,41.91831,-87.63629
TA1309000030,1,9,true,5,1,-4,41.92077,-87.66372
13193,1,9,true,9,2,-7,41.92182,-87.64412
TA1307000001,1,9,true,8,4,-4,41.92535,-87.66581
TA1306000026,1,9,true,7,5,-2,41.92558,-87.65842
TA1306000016,1,9,true,7,4,-3,41.9256,-87.65371
TA1309000019,1,9,true,7,1,-6,41.92586,-87.63897
TA1309000058,1,9,true,9,4,-5,41.92591,-87.64927
TA1308000001,1,9,true,5,4,-1,41.92627,-87.63086
TA1309000061,1,9,true,5,5,0,41.92915,-87.64909
TA1305000014,1,9,true,8,8,0,41.92956,-87.64313
TA1307000142,1,9,true,4,7,3,41.93125,-87.64432
TA1307000064,1,9,true,3,6,3,41.93222,-87.65864
TA1309000039,1,9,true,5,5,0,41.93258,-87.63642
TA1307000006,1,9,true,5,5,0,41.93571,-87.6636
TA1307000052,1,9,true,6,2,-4,41.93628,-87.65266
TA1307000041,1,9,true,9,6,-3,41.93669,-87.63683
13137,1,9,true,10,5,-5,41.9376,-87.6441
TA1309000042,1,9,true,5,4,-1,41.93937,-87.66836
13277,1,9,true,6,2,-4,41.9401,-87.64546
TA1309000049,1,9,true,6,3,-3,41.94077,-87.63919
TA1309000025,1,9,true,5,7,2,41.94368,-87.64894
13071,1,9,true,3,5,2,41.94373,-87.66401
13278,1,9,true,7,3,-4,41.94553,-87.64644
13235,1,9,true,6,7,1,41.94814,-87.66396
13325,1,9,true,9,6,-3,41.94907,-87.64863
TA1307000126,1,9,true,5,6,1,41.94936,-87.65451
TA1307000127,1,9,true,5,3,-2,41.9508,-87.65918
13323,1,9,true,9,4,-5,41.95282,-87.65
13063,1,9,true,1,10,9,41.95424,-87.65441
TA1308000022,1,9,true,3,5,2,41.95438,-87.64805
TA1307000149,1,9,true,3,5,2,41.95467,-87.67392
13389,1,9,true,5,3,-2,41.961,-87.64958
TA1307000158,1,9,true,3,5,2,41.9671,-87.67904
KA1504000152,1,9,true,4,5,1,41.98403,-87.65231
TA1307000048,1,10,false,2,6,4,41.83855,-87.60821
13075,1,10,false,5,2,-3,41.8531,-87.63192
13029,1,10,false,1,7,6,41.86531,-87.6179
15544,1,10,false,9,29,20,41.86723,-87.61536
SL-005,1,10,false,12,7,-5,41.8679,-87.62304
TA1309000010,1,10,false,6,7,1,41.87074,-87.62574
15541,1,10,false,14,11,-3,41.8758,-87.62086
624,1,10,false,5,1,-4,41.87626,-87.62923
TA1305000025,1,10,false,6,2,-4,41.87773,-87.63528
TA1309000002,1,10,false,3,5,2,41.87784,-87.62408
13300,1,10,false,37,28,-9,41.88097,-87.61675
13008,1,10,false,12,9,-3,41.88105,-87.62408
13341,1,10,false,10,2,-8,41.88208,-87.63985
TA1305000032,1,10,false,8,1,-7,41.88218,-87.64109
13001,1,10,false,11,7,-4,41.88397,-87.62459
TA1306000010,1,10,false,5,8,3,41.88419,-87.62961
TA1305000030,1,10,false,9,2,-7,41.88459,-87.63178
TA1305000011,1,10,false,12,10,-2,41.886,-87.62418
15534,1,10,false,5,2,-3,41.88627,-87.61749
TA1307000131,1,10,false,16,5,-11,41.88688,-87.62606
KA1503000064,1,10,false,7,6,-1,41.88697,-87.61281
KA1503000043,1,10,false,5,1,-4,41.88918,-87.63851
KA1503000044,1,10,false,1,5,4,41.89018,-87.6262
13430,1,10,false,9,5,-4,41.89077,-87.63169
TA1306000013,1,10,false,5,4,-1,41.89083,-87.61852
RN-,1,10,false,5,5,0,41.89102,-87.63546
TA1307000117,1,10,false,11,8,-3,41.89144,-87.62675
13033,1,10,false,2,5,3,41.8916,-87.64835
13022,1,10,false,30,23,-7,41.89227,-87.61205
TA1306000029,1,10,false,4,10,6,41.89256,-87.61449
13045,1,10,false,8,3,-5,41.89403,-87.62931
13016,1,10,false,16,7,-9,41.89431,-87.62277
TA1306000012,1,10,false,1,5,4,41.89475,-87.63438
15530,1,10,false,6,6,0,41.89575,-87.62596
13338,1,10,false,5,3,-2,41.89697,-87.62173
13034,1,10,false,4,6,2,41.89754,-87.62352
15529,1,10,false,17,3,-14,41.89858,-87.62206
13042,1,10,false,13,5,-8,41.90097,-87.62377
KA1504000133,1,10,false,1,5,4,41.90234,-87.62773
TA1307000039,1,10,false,3,5,2,41.90294,-87.63137
KA1504000135,1,10,false,5,4,-1,41.90319,-87.63439
13061,1,10,false,3,6,3,41.90342,-87.66779
TA1308000049,1,10,false,6,3,-3,41.90672,-87.6349
TA1307000038,1,10,false,11,3,-8,41.91138,-87.63868
LF-005,1,10,false,13,13,0,41.91172,-87.62681
TA1308000050,1,10,false,4,11,7,41.91211,-87.6347
13179,1,10,false,12,4,-8,41.9157,-87.63461
13059,1,10,false,5,1,-4,41.91845,-87.65222
13084,1,10,false,5,5,0,41.92268,-87.69715
TA1308000001,1,10,false,7,4,-3,41.92627,-87.63086
13276,1,10,false,10,2,-8,41.93132,-87.63874
TA1307000064,1,10,false,11,5,-6,41.93222,-87.65864
13277,1,10,false,1,5,4,41.9401,-87.64546
TA1307000134,1,10,false,4,8,4,41.94016,-87.65303
TA1309000049,1,10,false,10,1,-9,41.94077,-87.63919
632,1,10,false,5,4,-1,41.94453,-87.6547
13235,1,10,false,5,2,-3,41.94814,-87.66396
TA1307000126,1,10,false,2,5,3,41.94936,-87.65451
TA1308000022,1,10,false,5,3,-2,41.95438,-87.64805
13379,1,10,false,5,2,-3,41.95786,-87.6495
13389,1,10,false,5,1,-4,41.961,-87.64958
TA1308000012,1,10,false,3,6,3,41.96398,-87.63818
KA1503000071,1,10,true,4,6,2,41.79148,-87.59988
KA1504000076,1,10,true,4,6,2,41.7943,-87.60145
TA1307000129,1,10,true,5,1,-4,41.83104,-87.62683
13216,1,10,true,2,10,8,41.83473,-87.62581
TA1309000055,1,10,true,5,1,-4,41.8382,-87.64514
TA1308000036,1,10,true,2,5,3,41.83883,-87.62186
TA1307000139,1,10,true,6,3,-3,41.84205,-87.61698
15545,1,10,true,6,7,1,41.85627,-87.61334
13135,1,10,true,3,5,2,41.85753,-87.66157
SL-012,1,10,true,5,3,-2,41.86038,-87.62581
TA1307000124,1,10,true,3,5,2,41.86411,-87.62372
TA1305000002,1,10,true,8,5,-3,41.86721,-87.62597
SL-005,1,10,true,7,3,-4,41.8679,-87.62304
13285,1,10,true,3,7,4,41.86928,-87.67372
TA1307000130,1,10,true,5,7,2,41.87178,-87.65103
13332,1,10,true,17,5,-12,41.87219,-87.6615
SL-011,1,10,true,2,5,3,41.87256,-87.63356
13158,1,10,true,5,3,-2,41.87764,-87.64957
TA1305000025,1,10,true,5,11,6,41.87773,-87.63528
KA1503000015,1,10,true,1,6,5,41.87948,-87.6257
13300,1,10,true,4,5,1,41.88097,-87.61675
13008,1,10,true,2,8,6,41.88105,-87.62408
TA1305000006,1,10,true,3,8,5,41.88122,-87.6296
TA1307000120,1,10,true,4,7,3,41.88188,-87.64879
13341,1,10,true,2,5,3,41.88208,-87.63985
TA1305000032,1,10,true,7,7,0,41.88218,-87.64109
13053,1,10,true,3,9,6,41.88365,-87.64863
13001,1,10,true,1,9,8,41.88397,-87.62459
TA1306000010,1,10,true,4,11,7,41.88419,-87.62961
TA1305000030,1,10,true,8,11,3,41.88459,-87.63178
15535,1,10,true,5,5,0,41.8846,-87.64455
TA1305000029,1,10,true,1,7,6,41.88466,-87.62787
13263,1,10,true,7,6,-1,41.88467,-87.61952
13021,1,10,true,7,7,0,41.88559,-87.64184
TA1307000111,1,10,true,9,4,-5,41.88582,-87.63548
KA1503000012,1,10,true,9,8,-1,41.88599,-87.63089
TA1305000011,1,10,true,9,11,2,41.886,-87.62418
15534,1,10,true,2,5,3,41.88627,-87.61749
TA1307000131,1,10,true,2,5,3,41.88688,-87.62606
KA1503000064,1,10,true,3,6,3,41.88697,-87.61281
TA1305000022,1,10,true,3,6,3,41.88817,-87.63656
TA1306000003,1,10,true,7,8,1,41.88867,-87.64442
KA1503000043,1,10,true,13,10,-3,41.88918,-87.63851
13050,1,10,true,4,5,1,41.88919,-87.62775
TA1307000151,1,10,true,9,4,-5,41.88993,-87.63427
KA1503000044,1,10,true,5,6,1,41.89018,-87.6262
TA1306000013,1,10,true,3,5,2,41.89083,-87.61852
RN-,1,10,true,5,4,-1,41.89102,-87.63546
TA1307000117,1,10,true,3,6,3,41.89144,-87.62675
13033,1,10,true,3,5,2,41.8916,-87.64835
13194,1,10,true,1,5,4,41.8918,-87.65878
TA1305000003,1,10,true,4,5,1,41.89187,-87.62061
TA1306000029,1,10,true,5,4,-1,41.89256,-87.61449
13265,1,10,true,11,5,-6,41.89383,-87.64172
13045,1,10,true,13,8,-5,41.89403,-87.62931
13016,1,10,true,8,10,2,41.89431,-87.62277
KA1503000041,1,10,true,2,11,9,41.89452,-87.61798
TA1307000062,1,10,true,3,5,2,41.89466,-87.63839
TA1306000012,1,10,true,8,8,0,41.89475,-87.63438
15530,1,10,true,5,8,3,41.89575,-87.62596
13303,1,10,true,3,7,4,41.89672,-87.63088
13338,1,10,true,8,11,3,41.89697,-87.62173
TA1307000061,1,10,true,4,8,4,41.89745,-87.62873
TA1306000009,1,10,true,7,11,4,41.89772,-87.64299
15529,1,10,true,5,8,3,41.89858,-87.62206
13042,1,10,true,6,9,3,41.90097,-87.62377
KA1504000133,1,10,true,6,9,3,41.90234,-87.62773
TA1307000039,1,10,true,14,8,-6,41.90294,-87.63137
KA1504000135,1,10,true,7,9,2,41.90319,-87.63439
13061,1,10,true,6,3,-3,41.90342,-87.66779
TA1308000049,1,10,true,5,2,-3,41.90672,-87.6349
TA1309000024,1,10,true,9,7,-2,41.908,-87.63152
TA1305000041,1,10,true,3,5,2,41.9094,-87.67769
331,1,10,true,3,5,2,41.90965,-87.64812
TA1307000038,1,10,true,7,5,-2,41.91138,-87.63868
LF-005,1,10,true,6,1,-5,41.91172,-87.62681
TA1308000050,1,10,true,16,11,-5,41.91211,-87.6347
TA1307000166,1,10,true,1,6,5,41.91386,-87.64877
18017,1,10,true,5,5,0,41.91416,-87.71676
18067,1,10,true,4,5,1,41.9146,-87.66796
TA1307000163,1,10,true,6,8,2,41.91821,-87.65696
13059,1,10,true,6,3,-3,41.91845,-87.65222
13192,1,10,true,7,8,1,41.91995,-87.64884
13193,1,10,true,5,3,-2,41.92182,-87.64412
TA1307000001,1,10,true,7,4,-3,41.92535,-87.66581
TA1306000016,1,10,true,5,3,-2,41.9256,-87.65371
TA1308000001,1,10,true,10,8,-2,41.92627,-87.63086
TA1309000023,1,10,true,4,8,4,41.9287,-87.65383
TA1309000061,1,10,true,1,8,7,41.92915,-87.64909
TA1307000064,1,10,true,5,4,-1,41.93222,-87.65864
TA1309000039,1,10,true,6,2,-4,41.93258,-87.63642
TA1307000052,1,10,true,5,1,-4,41.93628,-87.65266
TA1307000136,1,10,true,6,3,-3,41.9365,-87.64755
TA1307000041,1,10,true,6,2,-4,41.93669,-87.63683
13137,1,10,true,7,6,-1,41.9376,-87.6441
TA1309000042,1,10,true,4,5,1,41.93937,-87.66836
TA1307000134,1,10,true,4,6,2,41.94016,-87.65303
TA1307000138,1,10,true,8,5,-3,41.94334,-87.67094
TA1309000025,1,10,true,1,5,4,41.94368,-87.64894
13071,1,10,true,5,5,0,41.94373,-87.66401
13235,1,10,true,4,5,1,41.94814,-87.66396
13325,1,10,true,2,6,4,41.94907,-87.64863
TA1307000150,1,10,true,3,5,2,41.94945,-87.64646
13323,1,10,true,10,6,-4,41.95282,-87.65
13063,1,10,true,1,10,9,41.95424,-87.65441
TA1308000022,1,10,true,5,3,-2,41.95438,-87.64805
13379,1,10,true,6,4,-2,41.95786,-87.6495
13389,1,10,true,8,3,-5,41.961,-87.64958
TA1307000107,1,10,true,8,5,-3,41.96164,-87.65464
13074,1,10,true,5,4,-1,41.96521,-87.6582
13109,1,10,true,5,3,-2,41.97835,-87.65976
15578,1,10,true,7,4,-3,41.98405,-87.66027
E002,1,10,true,1,7,6,42.03256,-87.67912
TA1309000011,1,11,false,6,2,-4,41.78873,-87.60131
KA1503000071,1,11,false,11,6,-5,41.79148,-87.59988
TA1308000009,1,11,false,8,6,-2,41.79522,-87.58075
TA1307000164,1,11,false,5,1,-4,41.79527,-87.59647
KA1503000059,1,11,false,3,8,5,41.79952,-87.58643
TA1309000037,1,11,false,6,1,-5,41.79957,-87.59474
TA1307000048,1,11,false,12,5,-7,41.83855,-87.60821
13075,1,11,false,3,18,15,41.8531,-87.63192
15545,1,11,false,2,5,3,41.85627,-87.61334
SL-006,1,11,false,7,2,-5,41.8568,-87.63387
13102,1,11,false,6,3,-3,41.85762,-87.61942
TA1307000124,1,11,false,5,7,2,41.86411,-87.62372
13029,1,11,false,1,8,7,41.86531,-87.6179
13431,1,11,false,7,6,-1,41.8661,-87.60728
WL-008,1,11,false,1,5,4,41.86712,-87.64108
15544,1,11,false,29,36,7,41.86723,-87.61536
SL-005,1,11,false,14,1,-13,41.8679,-87.62304
TA1309000010,1,11,false,6,4,-2,41.87074,-87.62574
623,1,11,false,5,5,0,41.87272,-87.62399
15541,1,11,false,26,5,-21,41.8758,-87.62086
TA1305000010,1,11,false,7,5,-2,41.87623,-87.62444
624,1,11,false,7,3,-4,41.87626,-87.62923
TA1305000025,1,11,false,14,14,0,41.87773,-87.63528
TA1309000002,1,11,false,11,3,-8,41.87784,-87.62408
TA1309000004,1,11,false,9,2,-7,41.87811,-87.63184
TA1305000005,1,11,false,7,3,-4,41.87924,-87.62975
TA1309000008,1,11,false,16,9,-7,41.87933,-87.6355
KA1503000034,1,11,false,4,5,1,41.87938,-87.63197
TA1309000007,1,11,false,1,5,4,41.88022,-87.63526
WL-011,1,11,false,9,6,-3,41.88034,-87.64273
13300,1,11,false,33,21,-12,41.88097,-87.61675
13008,1,11,false,23,50,27,41.88105,-87.62408
TA1305000006,1,11,false,21,8,-13,41.88122,-87.6296
TA1307000120,1,11,false,8,5,-3,41.88188,-87.64879
13036,1,11,false,5,7,2,41.8821,-87.62513
TA1305000032,1,11,false,5,6,1,41.88218,-87.64109
WL-012,1,11,false,2,6,4,41.88337,-87.6412
13001,1,11,false,14,6,-8,41.88397,-87.62459
TA1306000010,1,11,false,5,4,-1,41.88419,-87.62961
TA1305000029,1,11,false,12,2,-10,41.88466,-87.62787
TA1307000111,1,11,false,7,2,-5,41.88582,-87.63548
TA1305000011,1,11,false,16,10,-6,41.886,-87.62418
TA1308000029,1,11,false,12,5,-7,41.88673,-87.62225
TA1307000131,1,11,false,9,1,-8,41.88688,-87.62606
KA1503000064,1,11,false,13,5,-8,41.88697,-87.61281
TA1305000022,1,11,false,5,4,-1,41.88817,-87.63656
KA1503000044,1,11,false,10,9,-1,41.89018,-87.6262
13427,1,11,false,8,3,-5,41.89054,-87.62205
13430,1,11,false,8,7,-1,41.89077,-87.63169
TA1306000013,1,11,false,5,10,5,41.89083,-87.61852
TA1307000117,1,11,false,14,14,0,41.89144,-87.62675
TA1305000003,1,11,false,6,8,2,41.89187,-87.62061
13022,1,11,false,55,72,17,41.89227,-87.61205
TA1306000029,1,11,false,15,14,-1,41.89256,-87.61449
13016,1,11,false,19,16,-3,41.89431,-87.62277
KA1503000041,1,11,false,7,1,-6,41.89452,-87.61798
TA1307000062,1,11,false,7,3,-4,41.89466,-87.63839
TA1306000012,1,11,false,5,9,4,41.89475,-87.63438
637,1,11,false,1,5,4,41.89563,-87.67209
15530,1,11,false,8,4,-4,41.89575,-87.62596
13338,1,11,false,5,6,1,41.89697,-87.62173
13034,1,11,false,6,10,4,41.89754,-87.62352
15529,1,11,false,10,5,-5,41.89858,-87.62206
13042,1,11,false,27,13,-14,41.90097,-87.62377
KA1504000133,1,11,false,3,8,5,41.90234,-87.62773
TA1307000039,1,11,false,2,5,3,41.90294,-87.63137
KA1504000135,1,11,false,2,7,5,41.90319,-87.63439
13061,1,11,false,4,8,4,41.90342,-87.66779
LF-005,1,11,false,11,22,11,41.91172,-87.62681
TA1308000050,1,11,false,5,8,3,41.91211,-87.6347
13146,1,11,false,1,15,14,41.91831,-87.63629
13059,1,11,false,2,7,5,41.91845,-87.65222
13193,1,11,false,3,6,3,41.92182,-87.64412
LP-,1,11,false,7,6,-1,41.92396,-87.63584
TA1306000016,1,11,false,7,1,-6,41.9256,-87.65371
TA1308000001,1,11,false,9,16,7,41.92627,-87.63086
TA1307000142,1,11,false,6,2,-4,41.93125,-87.64432
13276,1,11,false,3,5,2,41.93132,-87.63874
TA1309000039,1,11,false,8,8,0,41.93258,-87.63642
TA1307000041,1,11,false,6,5,-1,41.93669,-87.63683
13137,1,11,false,4,7,3,41.9376,-87.6441
TA1307000134,1,11,false,4,6,2,41.94016,-87.65303
TA1309000049,1,11,false,6,2,-4,41.94077,-87.63919
TA1309000025,1,11,false,8,4,-4,41.94368,-87.64894
13071,1,11,false,1,5,4,41.94373,-87.66401
13278,1,11,false,5,7,2,41.94553,-87.64644
13235,1,11,false,1,5,4,41.94814,-87.66396
TA1307000150,1,11,false,5,4,-1,41.94945,-87.64646
13323,1,11,false,6,2,-4,41.95282,-87.65
13063,1,11,false,5,2,-3,41.95424,-87.65441
TA1308000022,1,11,false,10,2,-8,41.95438,-87.64805
13379,1,11,false,7,3,-4,41.95786,-87.6495
13389,1,11,false,5,2,-3,41.961,-87.64958
TA1308000012,1,11,false,12,4,-8,41.96398,-87.63818
TA1307000140,1,11,false,5,1,-4,41.96643,-87.68865
KA1504000149,1,11,false,7,1,-6,41.97562,-87.67945
KA1504000152,1,11,false,5,2,-3,41.98403,-87.65231
TA1309000011,1,11,true,3,6,3,41.78873,-87.60131
KA1503000071,1,11,true,5,9,4,41.79148,-87.59988
13216,1,11,true,3,5,2,41.83473,-87.62581
13215,1,11,true,4,6,2,41.83634,-87.6135
TA1307000048,1,11,true,8,2,-6,41.83855,-87.60821
TA1307000139,1,11,true,5,3,-2,41.84205,-87.61698
15545,1,11,true,8,7,-1,41.85627,-87.61334
13102,1,11,true,5,2,-3,41.85762,-87.61942
TA1307000124,1,11,true,4,7,3,41.86411,-87.62372
TA1305000002,1,11,true,8,6,-2,41.86721,-87.62597
13160,1,11,true,6,4,-2,41.86947,-87.65548
TA1309000010,1,11,true,5,3,-2,41.87074,-87.62574
TA1309000064,1,11,true,6,2,-4,41.87127,-87.67369
TA1307000130,1,11,true,3,7,4,41.87178,-87.65103
TA1307000121,1,11,true,4,8,4,41.87184,-87.64664
SL-008,1,11,true,2,5,3,41.87209,-87.62956
13332,1,11,true,8,7,-1,41.87219,-87.6615
KA1504000104,1,11,true,5,3,-2,41.87296,-87.66912
13028,1,11,true,6,3,-3,41.87475,-87.64981
TA1305000035,1,11,true,8,1,-7,41.87716,-87.62787
13158,1,11,true,6,4,-2,41.87764,-87.64957
13157,1,11,true,8,7,-1,41.87773,-87.6548
13206,1,11,true,5,1,-4,41.87794,-87.66201
TA1309000004,1,11,true,7,7,0,41.87811,-87.63184
TA1305000005,1,11,true,5,5,0,41.87924,-87.62975
TA1309000008,1,11,true,6,1,-5,41.87933,-87.6355
KA1503000015,1,11,true,6,4,-2,41.87948,-87.6257
TA1309000007,1,11,true,12,8,-4,41.88022,-87.63526
13156,1,11,true,3,6,3,41.88042,-87.65554
13008,1,11,true,6,5,-1,41.88105,-87.62408
TA1305000006,1,11,true,4,6,2,41.88122,-87.6296
TA1307000120,1,11,true,9,15,6,41.88188,-87.64879
TA1305000032,1,11,true,5,7,2,41.88218,-87.64109
13006,1,11,true,8,3,-5,41.88268,-87.63252
KA1503000072,1,11,true,8,3,-5,41.88317,-87.63693
WL-012,1,11,true,2,5,3,41.88337,-87.6412
13053,1,11,true,1,5,4,41.88365,-87.64863
13001,1,11,true,9,6,-3,41.88397,-87.62459
TA1306000010,1,11,true,7,8,1,41.88419,-87.62961
TA1305000030,1,11,true,19,7,-12,41.88459,-87.63178
TA1305000029,1,11,true,8,8,0,41.88466,-87.62787
13263,1,11,true,4,6,2,41.88467,-87.61952
13021,1,11,true,7,6,-1,41.88559,-87.64184
TA1307000111,1,11,true,10,9,-1,41.88582,-87.63548
KA1503000012,1,11,true,8,14,6,41.88599,-87.63089
TA1305000011,1,11,true,7,7,0,41.886,-87.62418
TA1307000131,1,11,true,5,3,-2,41.88688,-87.62606
KA1503000064,1,11,true,4,8,4,41.88697,-87.61281
TA1305000022,1,11,true,4,7,3,41.88817,-87.63656
TA1306000003,1,11,true,11,8,-3,41.88867,-87.64442
KA1503000043,1,11,true,10,23,13,41.88918,-87.63851
13050,1,11,true,5,5,0,41.88919,-87.62775
TA1307000151,1,11,true,8,9,1,41.88993,-87.63427
13430,1,11,true,5,6,1,41.89077,-87.63169
RN-,1,11,true,5,4,-1,41.89102,-87.63546
TA1307000117,1,11,true,6,8,2,41.89144,-87.62675
13033,1,11,true,12,3,-9,41.8916,-87.64835
13194,1,11,true,9,4,-5,41.8918,-87.65878
TA1305000003,1,11,true,7,7,0,41.89187,-87.62061
13022,1,11,true,7,6,-1,41.89227,-87.61205
TA1306000029,1,11,true,6,3,-3,41.89256,-87.61449
13265,1,11,true,10,7,-3,41.89383,-87.64172
13045,1,11,true,8,7,-1,41.89403,-87.62931
13016,1,11,true,7,10,3,41.89431,-87.62277
KA1503000041,1,11,true,8,8,0,41.89452,-87.61798
13196,1,11,true,7,4,-3,41.89455,-87.65345
TA1307000062,1,11,true,7,6,-1,41.89466,-87.63839
TA1306000012,1,11,true,14,7,-7,41.89475,-87.63438
KP1705001026,1,11,true,1,5,4,41.89483,-87.6323
15530,1,11,true,6,6,0,41.89575,-87.62596
18003,1,11,true,2,5,3,41.89575,-87.62011
13303,1,11,true,1,5,4,41.89672,-87.63088
13338,1,11,true,7,8,1,41.89697,-87.62173
TA1306000009,1,11,true,5,10,5,41.89772,-87.64299
KA1504000103,1,11,true,8,1,-7,41.89842,-87.68659
15529,1,11,true,6,11,5,41.89858,-87.62206
TA1307000128,1,11,true,6,12,6,41.89896,-87.6299
TA1306000011,1,11,true,5,4,-1,41.89994,-87.63443
13290,1,11,true,5,1,-4,41.90069,-87.66259
13042,1,11,true,7,9,2,41.90097,-87.62377
KA1504000133,1,11,true,6,4,-2,41.90234,-87.62773
TA1307000039,1,11,true,12,9,-3,41.90294,-87.63137
TA1305000034,1,11,true,5,5,0,41.90313,-87.67391
KA1504000135,1,11,true,8,5,-3,41.90319,-87.63439
13061,1,11,true,9,11,2,41.90342,-87.66779
KA1504000079,1,11,true,2,8,6,41.9035,-87.64334
TA1308000049,1,11,true,8,7,-1,41.90672,-87.6349
TA1309000024,1,11,true,5,5,0,41.908,-87.63152
TA1305000041,1,11,true,5,6,1,41.9094,-87.67769
331,1,11,true,9,7,-2,41.90965,-87.64812
TA1305000037,1,11,true,2,6,4,41.91018,-87.67003
13154,1,11,true,10,10,0,41.91054,-87.65312
13058,1,11,true,3,6,3,41.91059,-87.64942
TA1307000038,1,11,true,6,6,0,41.91138,-87.63868
LF-005,1,11,true,7,6,-1,41.91172,-87.62681
TA1308000050,1,11,true,10,5,-5,41.91211,-87.6347
13243,1,11,true,2,5,3,41.91262,-87.6814
TA1306000032,1,11,true,6,2,-4,41.9137,-87.65285
13146,1,11,true,7,7,0,41.91831,-87.63629
13059,1,11,true,10,7,-3,41.91845,-87.65222
13192,1,11,true,9,5,-4,41.91995,-87.64884
13288,1,11,true,5,1,-4,41.92008,-87.67788
TA1309000033,1,11,true,2,5,3,41.92158,-87.65381
13193,1,11,true,8,5,-3,41.92182,-87.64412
13191,1,11,true,3,7,4,41.92217,-87.63891
TA1306000016,1,11,true,4,6,2,41.9256,-87.65371
TA1309000019,1,11,true,7,6,-1,41.92586,-87.63897
TA1309000058,1,11,true,3,5,2,41.92591,-87.64927
TA1308000001,1,11,true,4,5,1,41.92627,-87.63086
TA1309000023,1,11,true,3,8,5,41.9287,-87.65383
TA1307000113,1,11,true,2,5,3,41.92878,-87.66391
TA1309000061,1,11,true,4,7,3,41.92915,-87.64909
TA1307000142,1,11,true,5,3,-2,41.93125,-87.64432
13276,1,11,true,6,3,-3,41.93132,-87.63874
TA1307000064,1,11,true,3,6,3,41.93222,-87.65864
TA1306000014,1,11,true,5,6,1,41.93242,-87.65271
TA1309000039,1,11,true,3,6,3,41.93258,-87.63642
TA1309000036,1,11,true,6,6,0,41.93313,-87.64776
TA1307000052,1,11,true,6,4,-2,41.93628,-87.65266
TA1307000136,1,11,true,8,4,-4,41.9365,-87.64755
TA1307000041,1,11,true,3,5,2,41.93669,-87.63683
13137,1,11,true,7,11,4,41.9376,-87.6441
TA1308000019,1,11,true,5,1,-4,41.93973,-87.65886
TA1307000134,1,11,true,5,8,3,41.94016,-87.65303
TA1309000049,1,11,true,8,4,-4,41.94077,-87.63919
TA1307000138,1,11,true,3,6,3,41.94334,-87.67094
TA1309000025,1,11,true,4,6,2,41.94368,-87.64894
13071,1,11,true,5,12,7,41.94373,-87.66401
13278,1,11,true,6,5,-1,41.94553,-87.64644
13235,1,11,true,11,5,-6,41.94814,-87.66396
13253,1,11,true,3,5,2,41.9488,-87.67527
13325,1,11,true,10,10,0,41.94907,-87.64863
TA1307000126,1,11,true,7,5,-2,41.94936,-87.65451
TA1307000150,1,11,true,10,7,-3,41.94945,-87.64646
TA1307000127,1,11,true,5,4,-1,41.9508,-87.65918
TA1309000043,1,11,true,5,6,1,41.95417,-87.66434
13063,1,11,true,13,10,-3,41.95424,-87.65441
TA1308000022,1,11,true,6,5,-1,41.95438,-87.64805
13379,1,11,true,9,4,-5,41.95786,-87.6495
TA1309000027,1,11,true,5,3,-2,41.9585,-87.65499
13389,1,11,true,5,5,0,41.961,-87.64958
KA1503000022,1,11,true,6,2,-4,41.96158,-87.66609
TA1307000140,1,11,true,6,2,-4,41.96643,-87.68865
TA1309000066,1,11,true,1,6,5,41.9691,-87.67423
KA1504000146,1,11,true,6,5,-1,41.978,-87.66805
13109,1,11,true,3,8,5,41.97835,-87.65976
KA1504000152,1,11,true,5,2,-3,41.98403,-87.65231
15578,1,11,true,3,5,2,41.98405,-87.66027
15571,1,11,true,5,4,-1,41.99478,-87.66028
TA1309000011,1,12,false,1,9,8,41.78873,-87.60131
KA1503000071,1,12,false,7,9,2,41.79148,-87.59988
TA1308000009,1,12,false,5,1,-4,41.79522,-87.58075
KA1503000059,1,12,false,6,1,-5,41.79952,-87.58643
TA1307000048,1,12,false,6,6,0,41.83855,-87.60821
13075,1,12,false,2,6,4,41.8531,-87.63192
15545,1,12,false,6,6,0,41.85627,-87.61334
TA1307000124,1,12,false,8,4,-4,41.86411,-87.62372
13029,1,12,false,9,14,5,41.86531,-87.6179
13431,1,12,false,5,5,0,41.8661,-87.60728
WL-008,1,12,false,4,5,1,41.86712,-87.64108
TA1305000002,1,12,false,10,6,-4,41.86721,-87.62597
15544,1,12,false,42,45,3,41.86723,-87.61536
SL-005,1,12,false,10,14,4,41.8679,-87.62304
13160,1,12,false,5,1,-4,41.86947,-87.65548
TA1309000010,1,12,false,1,10,9,41.87074,-87.62574
SL-009,1,12,false,3,5,2,41.87081,-87.63121
SL-008,1,12,false,9,3,-6,41.87209,-87.62956
623,1,12,false,4,10,6,41.87272,-87.62399
SL-007,1,12,false,2,5,3,41.87404,-87.6277
13028,1,12,false,1,5,4,41.87475,-87.64981
15541,1,12,false,24,16,-8,41.8758,-87.62086
TA1305000010,1,12,false,6,1,-5,41.87623,-87.62444
624,1,12,false,6,3,-3,41.87626,-87.62923
13158,1,12,false,1,5,4,41.87764,-87.64957
13157,1,12,false,5,3,-2,41.87773,-87.6548
TA1305000025,1,12,false,17,7,-10,41.87773,-87.63528
TA1309000002,1,12,false,13,17,4,41.87784,-87.62408
TA1309000004,1,12,false,13,1,-12,41.87811,-87.63184
TA1309000008,1,12,false,19,8,-11,41.87933,-87.6355
TA1309000007,1,12,false,6,5,-1,41.88022,-87.63526
13156,1,12,false,3,7,4,41.88042,-87.65554
13300,1,12,false,49,30,-19,41.88097,-87.61675
13008,1,12,false,52,53,1,41.88105,-87.62408
TA1305000006,1,12,false,11,5,-6,41.88122,-87.6296
TA1307000120,1,12,false,5,3,-2,41.88188,-87.64879
13036,1,12,false,10,6,-4,41.8821,-87.62513
13006,1,12,false,4,6,2,41.88268,-87.63252
WL-012,1,12,false,4,6,2,41.88337,-87.6412
13053,1,12,false,3,7,4,41.88365,-87.64863
13001,1,12,false,27,34,7,41.88397,-87.62459
TA1305000030,1,12,false,6,5,-1,41.88459,-87.63178
TA1305000029,1,12,false,8,7,-1,41.88466,-87.62787
13263,1,12,false,10,7,-3,41.88467,-87.61952
TA1306000015,1,12,false,5,1,-4,41.88549,-87.65232
TA1307000111,1,12,false,3,8,5,41.88582,-87.63548
KA1503000012,1,12,false,5,3,-2,41.88599,-87.63089
TA1305000011,1,12,false,25,12,-13,41.886,-87.62418
15534,1,12,false,4,8,4,41.88627,-87.61749
TA1307000131,1,12,false,4,11,7,41.88688,-87.62606
KA1503000064,1,12,false,11,14,3,41.88697,-87.61281
TA1306000003,1,12,false,5,4,-1,41.88867,-87.64442
KA1503000043,1,12,false,6,6,0,41.88918,-87.63851
13050,1,12,false,8,6,-2,41.88919,-87.62775
TA1307000151,1,12,false,6,4,-2,41.88993,-87.63427
13430,1,12,false,8,9,1,41.89077,-87.63169
TA1306000013,1,12,false,11,9,-2,41.89083,-87.61852
TA1307000117,1,12,false,8,23,15,41.89144,-87.62675
TA1305000003,1,12,false,8,7,-1,41.89187,-87.62061
13022,1,12,false,58,95,37,41.89227,-87.61205
TA1306000029,1,12,false,21,8,-13,41.89256,-87.61449
13265,1,12,false,10,10,0,41.89383,-87.64172
13045,1,12,false,7,15,8,41.89403,-87.62931
13016,1,12,false,18,10,-8,41.89431,-87.62277
TA1307000062,1,12,false,4,5,1,41.89466,-87.63839
TA1306000012,1,12,false,16,9,-7,41.89475,-87.63438
15530,1,12,false,21,9,-12,41.89575,-87.62596
13247,1,12,false,8,1,-7,41.89597,-87.66775
13338,1,12,false,7,5,-2,41.89697,-87.62173
TA1307000061,1,12,false,6,5,-1,41.89745,-87.62873
13034,1,12,false,15,11,-4,41.89754,-87.62352
13042,1,12,false,29,18,-11,41.90097,-87.62377
KA1504000133,1,12,false,9,16,7,41.90234,-87.62773
TA1307000039,1,12,false,11,8,-3,41.90294,-87.63137
KA1504000135,1,12,false,5,6,1,41.90319,-87.63439
KA1504000079,1,12,false,5,3,-2,41.9035,-87.64334
TA1305000041,1,12,false,8,7,-1,41.9094,-87.67769
331,1,12,false,1,6,5,41.90965,-87.64812
TA1307000038,1,12,false,6,5,-1,41.91138,-87.63868
LF-005,1,12,false,15,21,6,41.91172,-87.62681
13128,1,12,false,6,7,1,41.91197,-87.63197
TA1308000050,1,12,false,5,11,6,41.91211,-87.6347
TA1307000166,1,12,false,1,5,4,41.91386,-87.64877
18067,1,12,false,3,6,3,41.9146,-87.66796
13179,1,12,false,4,7,3,41.9157,-87.63461
13146,1,12,false,8,10,2,41.91831,-87.63629
13059,1,12,false,7,8,1,41.91845,-87.65222
13192,1,12,false,5,1,-4,41.91995,-87.64884
TA1309000030,1,12,false,6,4,-2,41.92077,-87.66372
13193,1,12,false,7,6,-1,41.92182,-87.64412
13191,1,12,false,5,4,-1,41.92217,-87.63891
LP-,1,12,false,5,4,-1,41.92396,-87.63584
TA1307000001,1,12,false,5,5,0,41.92535,-87.66581
TA1309000019,1,12,false,5,6,1,41.92586,-87.63897
TA1309000058,1,12,false,7,2,-5,41.92591,-87.64927
TA1308000001,1,12,false,20,16,-4,41.92627,-87.63086
TA1309000023,1,12,false,7,2,-5,41.9287,-87.65383
TA1305000014,1,12,false,11,6,-5,41.92956,-87.64313
TA1307000064,1,12,false,3,7,4,41.93222,-87.65864
TA1306000014,1,12,false,5,3,-2,41.93242,-87.65271
TA1309000039,1,12,false,13,11,-2,41.93258,-87.63642
TA1309000036,1,12,false,1,5,4,41.93313,-87.64776
TA1307000136,1,12,false,5,2,-3,41.9365,-87.64755
TA1307000041,1,12,false,2,5,3,41.93669,-87.63683
13137,1,12,false,7,6,-1,41.9376,-87.6441
13277,1,12,false,8,3,-5,41.9401,-87.64546
TA1309000049,1,12,false,5,10,5,41.94077,-87.63919
TA1309000025,1,12,false,3,5,2,41.94368,-87.64894
13278,1,12,false,7,4,-3,41.94553,-87.64644
13235,1,12,false,4,10,6,41.94814,-87.66396
13325,1,12,false,6,6,0,41.94907,-87.64863
TA1307000126,1,12,false,6,11,5,41.94936,-87.65451
TA1307000150,1,12,false,9,2,-7,41.94945,-87.64646
TA1307000127,1,12,false,7,8,1,41.9508,-87.65918
13323,1,12,false,6,8,2,41.95282,-87.65
13063,1,12,false,5,3,-2,41.95424,-87.65441
13379,1,12,false,2,5,3,41.95786,-87.6495
13389,1,12,false,9,3,-6,41.961,-87.64958
TA1307000107,1,12,false,5,1,-4,41.96164,-87.65464
TA1308000012,1,12,false,6,7,1,41.96398,-87.63818
639,1,12,false,11,2,-9,41.96584,-87.64538
TA1309000041,1,12,false,5,1,-4,41.96951,-87.65471
13109,1,12,false,4,5,1,41.97835,-87.65976
KA1504000152,1,12,false,7,6,-1,41.98403,-87.65231
15578,1,12,false,6,1,-5,41.98405,-87.66027
15575,1,12,false,6,3,-3,41.98975,-87.66014
E008,1,12,false,7,4,-3,42.05049,-87.67782
KA1503000014,1,12,true,7,6,-1,41.7851,-87.60108
TA1309000011,1,12,true,5,5,0,41.78873,-87.60131
KA1503000071,1,12,true,6,7,1,41.79148,-87.59988
TA1309000037,1,12,true,3,7,4,41.79957,-87.59474
TA1307000129,1,12,true,7,2,-5,41.83104,-87.62683
13216,1,12,true,10,8,-2,41.83473,-87.62581
13215,1,12,true,5,3,-2,41.83634,-87.6135
TA1309000055,1,12,true,9,10,1,41.8382,-87.64514
TA1308000036,1,12,true,5,2,-3,41.83883,-87.62186
TA1307000139,1,12,true,7,3,-4,41.84205,-87.61698
15545,1,12,true,9,9,0,41.85627,-87.61334
TA1307000159,1,12,true,2,5,3,41.8579,-87.6687
SL-012,1,12,true,6,3,-3,41.86038,-87.62581
TA1307000124,1,12,true,10,7,-3,41.86411,-87.62372
TA1305000002,1,12,true,11,13,2,41.86721,-87.62597
KA1706005007,1,12,true,2,6,4,41.86749,-87.63219
SL-005,1,12,true,6,9,3,41.8679,-87.62304
644,1,12,true,3,5,2,41.86859,-87.68625
13139,1,12,true,6,5,-1,41.86893,-87.65913
13285,1,12,true,10,3,-7,41.86928,-87.67372
13160,1,12,true,2,5,3,41.86947,-87.65548
TA1309000010,1,12,true,11,3,-8,41.87074,-87.62574
TA1309000064,1,12,true,8,7,-1,41.87127,-87.67369
TA1307000130,1,12,true,8,5,-3,41.87178,-87.65103
TA1307000121,1,12,true,4,6,2,41.87184,-87.64664
SL-008,1,12,true,4,12,8,41.87209,-87.62956
13332,1,12,true,14,18,4,41.87219,-87.6615
KA1504000104,1,12,true,3,5,2,41.87296,-87.66912
TA1305000035,1,12,true,3,6,3,41.87716,-87.62787
13138,1,12,true,13,4,-9,41.87723,-87.63941
13158,1,12,true,10,10,0,41.87764,-87.64957
13157,1,12,true,5,7,2,41.87773,-87.6548
TA1305000025,1,12,true,8,7,-1,41.87773,-87.63528
TA1309000004,1,12,true,6,5,-1,41.87811,-87.63184
638,1,12,true,5,5,0,41.87827,-87.64078
TA1305000005,1,12,true,8,7,-1,41.87924,-87.62975
13011,1,12,true,4,14,10,41.87931,-87.63993
TA1309000008,1,12,true,1,6,5,41.87933,-87.6355
KA1503000034,1,12,true,6,2,-4,41.87938,-87.63197
KA1503000015,1,12,true,1,6,5,41.87948,-87.6257
TA1309000007,1,12,true,10,7,-3,41.88022,-87.63526
WL-011,1,12,true,1,7,6,41.88034,-87.64273
13300,1,12,true,9,8,-1,41.88097,-87.61675
13008,1,12,true,7,9,2,41.88105,-87.62408
TA1305000006,1,12,true,9,6,-3,41.88122,-87.6296
TA1307000120,1,12,true,11,11,0,41.88188,-87.64879
13036,1,12,true,4,13,9,41.8821,-87.62513
TA1305000032,1,12,true,9,2,-7,41.88218,-87.64109
13006,1,12,true,13,7,-6,41.88268,-87.63252
654,1,12,true,1,8,7,41.88307,-87.65698
13409,1,12,true,5,10,5,41.8831,-87.6511
WL-012,1,12,true,9,12,3,41.88337,-87.6412
13053,1,12,true,7,2,-5,41.88365,-87.64863
13001,1,12,true,13,11,-2,41.88397,-87.62459
TA1306000010,1,12,true,10,8,-2,41.88419,-87.62961
TA1305000030,1,12,true,11,11,0,41.88459,-87.63178
15535,1,12,true,6,7,1,41.8846,-87.64455
TA1305000029,1,12,true,9,4,-5,41.88466,-87.62787
13263,1,12,true,5,7,2,41.88467,-87.61952
13021,1,12,true,16,3,-13,41.88559,-87.64184
TA1307000111,1,12,true,3,10,7,41.88582,-87.63548
KA1503000012,1,12,true,8,10,2,41.88599,-87.63089
TA1305000011,1,12,true,7,4,-3,41.886,-87.62418
15534,1,12,true,6,3,-3,41.88627,-87.61749
TA1307000131,1,12,true,4,7,3,41.88688,-87.62606
TA1305000022,1,12,true,7,4,-3,41.88817,-87.63656
TA1306000003,1,12,true,13,10,-3,41.88867,-87.64442
KA1503000043,1,12,true,12,25,13,41.88918,-87.63851
TA1307000151,1,12,true,12,14,2,41.88993,-87.63427
636,1,12,true,5,3,-2,41.88997,-87.63662
13427,1,12,true,3,5,2,41.89054,-87.62205
13430,1,12,true,5,11,6,41.89077,-87.63169
TA1306000013,1,12,true,4,6,2,41.89083,-87.61852
RN-,1,12,true,5,7,2,41.89102,-87.63546
TA1307000117,1,12,true,8,9,1,41.89144,-87.62675
13033,1,12,true,6,10,4,41.8916,-87.64835
13194,1,12,true,10,6,-4,41.8918,-87.65878
TA1305000003,1,12,true,9,9,0,41.89187,-87.62061
13022,1,12,true,12,9,-3,41.89227,-87.61205
TA1306000029,1,12,true,10,9,-1,41.89256,-87.61449
13265,1,12,true,14,14,0,41.89383,-87.64172
13045,1,12,true,15,13,-2,41.89403,-87.62931
13016,1,12,true,16,12,-4,41.89431,-87.62277
KA1503000041,1,12,true,11,7,-4,41.89452,-87.61798
TA1307000062,1,12,true,14,7,-7,41.89466,-87.63839
TA1306000012,1,12,true,12,10,-2,41.89475,-87.63438
13132,1,12,true,10,5,-5,41.89573,-87.67718
15530,1,12,true,7,7,0,41.89575,-87.62596
18003,1,12,true,10,4,-6,41.89575,-87.62011
13247,1,12,true,7,6,-1,41.89597,-87.66775
13303,1,12,true,5,2,-3,41.89672,-87.63088
13017,1,12,true,5,5,0,41.89676,-87.6357
13338,1,12,true,10,4,-6,41.89697,-87.62173
TA1307000061,1,12,true,7,7,0,41.89745,-87.62873
13034,1,12,true,6,4,-2,41.89754,-87.62352
TA1306000009,1,12,true,8,8,0,41.89772,-87.64299
15529,1,12,true,13,5,-8,41.89858,-87.62206
TA1307000128,1,12,true,8,5,-3,41.89896,-87.6299
13248,1,12,true,7,6,-1,41.89964,-87.66788
13290,1,12,true,5,4,-1,41.90069,-87.66259
13042,1,12,true,6,15,9,41.90097,-87.62377
KA1504000133,1,12,true,9,8,-1,41.90234,-87.62773
TA1307000039,1,12,true,16,14,-2,41.90294,-87.63137
TA1305000034,1,12,true,1,7,6,41.90313,-87.67391
KA1504000135,1,12,true,6,10,4,41.90319,-87.63439
13136,1,12,true,5,4,-1,41.90326,-87.67845
13061,1,12,true,8,4,-4,41.90342,-87.66779
KA1504000079,1,12,true,7,2,-5,41.9035,-87.64334
TA1308000049,1,12,true,7,10,3,41.90672,-87.6349
KA1504000134,1,12,true,7,4,-3,41.90687,-87.6262
13224,1,12,true,4,7,3,41.90706,-87.66725
13221,1,12,true,2,5,3,41.90765,-87.67254
TA1309000024,1,12,true,7,5,-2,41.908,-87.63152
TA1305000041,1,12,true,2,7,5,41.9094,-87.67769
331,1,12,true,8,4,-4,41.90965,-87.64812
TA1305000037,1,12,true,8,3,-5,41.91018,-87.67003
13154,1,12,true,5,7,2,41.91054,-87.65312
13058,1,12,true,7,7,0,41.91059,-87.64942
LF-005,1,12,true,12,6,-6,41.91172,-87.62681
13128,1,12,true,6,4,-2,41.91197,-87.63197
TA1308000050,1,12,true,11,14,3,41.91211,-87.6347
13243,1,12,true,8,10,2,41.91262,-87.6814
TA1306000032,1,12,true,6,9,3,41.9137,-87.65285
TA1307000166,1,12,true,5,6,1,41.91386,-87.64877
13179,1,12,true,8,5,-3,41.9157,-87.63461
TA1305000039,1,12,true,2,5,3,41.9163,-87.66749
13146,1,12,true,10,8,-2,41.91831,-87.63629
13059,1,12,true,3,13,10,41.91845,-87.65222
13192,1,12,true,5,7,2,41.91995,-87.64884
TA1309000033,1,12,true,13,7,-6,41.92158,-87.65381
13193,1,12,true,8,14,6,41.92182,-87.64412
LP-,1,12,true,8,6,-2,41.92396,-87.63584
TA1307000001,1,12,true,3,5,2,41.92535,-87.66581
TA1306000016,1,12,true,5,6,1,41.9256,-87.65371
TA1309000019,1,12,true,10,5,-5,41.92586,-87.63897
TA1309000058,1,12,true,8,7,-1,41.92591,-87.64927
TA1308000001,1,12,true,9,11,2,41.92627,-87.63086
TA1309000061,1,12,true,6,6,0,41.92915,-87.64909
TA1305000014,1,12,true,9,12,3,41.92956,-87.64313
TA1307000142,1,12,true,12,9,-3,41.93125,-87.64432
13276,1,12,true,10,9,-1,41.93132,-87.63874
TA1306000014,1,12,true,6,2,-4,41.93242,-87.65271
TA1309000039,1,12,true,3,5,2,41.93258,-87.63642
TA1309000036,1,12,true,4,5,1,41.93313,-87.64776
TA1307000006,1,12,true,5,2,-3,41.93571,-87.6636
13268,1,12,true,5,1,-4,41.93588,-87.67843
TA1307000052,1,12,true,8,8,0,41.93628,-87.65266
TA1307000136,1,12,true,11,7,-4,41.9365,-87.64755
TA1307000041,1,12,true,8,6,-2,41.93669,-87.63683
13137,1,12,true,17,11,-6,41.9376,-87.6441
TA1309000042,1,12,true,5,4,-1,41.93937,-87.66836
TA1307000134,1,12,true,6,12,6,41.94016,-87.65303
TA1309000049,1,12,true,3,9,6,41.94077,-87.63919
TA1307000138,1,12,true,3,13,10,41.94334,-87.67094
13144,1,12,true,5,4,-1,41.9434,-87.67964
TA1309000025,1,12,true,6,3,-3,41.94368,-87.64894
13071,1,12,true,11,11,0,41.94373,-87.66401
13278,1,12,true,6,6,0,41.94553,-87.64644
13235,1,12,true,11,8,-3,41.94814,-87.66396
13253,1,12,true,3,5,2,41.9488,-87.67527
13325,1,12,true,22,16,-6,41.94907,-87.64863
TA1307000126,1,12,true,11,5,-6,41.94936,-87.65451
TA1307000150,1,12,true,9,9,0,41.94945,-87.64646
TA1307000127,1,12,true,8,5,-3,41.9508,-87.65918
13323,1,12,true,6,7,1,41.95282,-87.65
13063,1,12,true,1,5,4,41.95424,-87.65441
TA1309000026,1,12,true,4,5,1,41.95601,-87.6802
13379,1,12,true,6,8,2,41.95786,-87.6495
TA1309000027,1,12,true,7,6,-1,41.9585,-87.65499
TA1307000107,1,12,true,6,3,-3,41.96164,-87.65464
KA1504000146,1,12,true,5,5,0,41.978,-87.66805
13109,1,12,true,5,4,-1,41.97835,-87.65976
KA1504000152,1,12,true,9,7,-2,41.98403,-87.65231
15575,1,12,true,1,5,4,41.98975,-87.66014
15571,1,12,true,4,6,2,41.99478,-87.66028
604,1,12,true,2,6,4,42.05824,-87.67744
TA1309000011,1,13,false,5,2,-3,41.78873,-87.60131
KA1503000059,1,13,false,3,8,5,41.79952,-87.58643
TA1307000048,1,13,false,5,1,-4,41.83855,-87.60821
15546,1,13,false,5,1,-4,41.85416,-87.61916
15545,1,13,false,14,11,-3,41.85627,-87.61334
13029,1,13,false,6,16,10,41.86531,-87.6179
13431,1,13,false,16,13,-3,41.8661,-87.60728
TA1305000002,1,13,false,10,9,-1,41.86721,-87.62597
15544,1,13,false,72,48,-24,41.86723,-87.61536
KA1706005007,1,13,false,2,6,4,41.86749,-87.63219
SL-005,1,13,false,15,6,-9,41.8679,-87.62304
13160,1,13,false,5,2,-3,41.86947,-87.65548
15550,1,13,false,6,2,-4,41.87024,-87.63947
TA1309000010,1,13,false,16,9,-7,41.87074,-87.62574
TA1307000121,1,13,false,6,1,-5,41.87184,-87.64664
SL-008,1,13,false,6,3,-3,41.87209,-87.62956
SL-011,1,13,false,4,7,3,41.87256,-87.63356
623,1,13,false,12,15,3,41.87272,-87.62399
15541,1,13,false,20,16,-4,41.8758,-87.62086
624,1,13,false,6,2,-4,41.87626,-87.62923
13158,1,13,false,5,5,0,41.87764,-87.64957
TA1305000025,1,13,false,21,4,-17,41.87773,-87.63528
TA1309000002,1,13,false,22,11,-11,41.87784,-87.62408
TA1309000004,1,13,false,6,3,-3,41.87811,-87.63184
TA1305000005,1,13,false,8,4,-4,41.87924,-87.62975
TA1309000008,1,13,false,4,5,1,41.87933,-87.6355
KA1503000015,1,13,false,13,5,-8,41.87948,-87.6257
13156,1,13,false,4,8,4,41.88042,-87.65554
13300,1,13,false,47,50,3,41.88097,-87.61675
13008,1,13,false,69,63,-6,41.88105,-87.62408
TA1305000006,1,13,false,4,5,1,41.88122,-87.6296
13134,1,13,false,5,1,-4,41.88138,-87.67493
TA1307000120,1,13,false,13,10,-3,41.88188,-87.64879
13036,1,13,false,5,7,2,41.8821,-87.62513
TA1305000032,1,13,false,2,5,3,41.88218,-87.64109
13006,1,13,false,1,6,5,41.88268,-87.63252
KA1503000072,1,13,false,4,6,2,41.88317,-87.63693
WL-012,1,13,false,9,9,0,41.88337,-87.6412
13053,1,13,false,6,13,7,41.88365,-87.64863
13001,1,13,false,34,23,-11,41.88397,-87.62459
TA1306000010,1,13,false,8,13,5,41.88419,-87.62961
TA1305000030,1,13,false,11,6,-5,41.88459,-87.63178
15535,1,13,false,5,2,-3,41.8846,-87.64455
TA1305000029,1,13,false,12,8,-4,41.88466,-87.62787
13263,1,13,false,6,5,-1,41.88467,-87.61952
TA1305000011,1,13,false,12,20,8,41.886,-87.62418
15534,1,13,false,8,6,-2,41.88627,-87.61749
TA1308000029,1,13,false,9,3,-6,41.88673,-87.62225
TA1307000131,1,13,false,8,24,16,41.88688,-87.62606
KA1503000064,1,13,false,23,23,0,41.88697,-87.61281
TA1306000003,1,13,false,8,2,-6,41.88867,-87.64442
13050,1,13,false,9,10,1,41.88919,-87.62775
TA1307000151,1,13,false,5,4,-1,41.88993,-87.63427
KA1503000044,1,13,false,8,4,-4,41.89018,-87.6262
13427,1,13,false,7,7,0,41.89054,-87.62205
13430,1,13,false,10,8,-2,41.89077,-87.63169
TA1306000013,1,13,false,9,7,-2,41.89083,-87.61852
TA1307000117,1,13,false,14,17,3,41.89144,-87.62675
TA1305000003,1,13,false,4,10,6,41.89187,-87.62061
13022,1,13,false,101,88,-13,41.89227,-87.61205
TA1306000029,1,13,false,8,9,1,41.89256,-87.61449
13045,1,13,false,14,18,4,41.89403,-87.62931
13016,1,13,false,9,12,3,41.89431,-87.62277
KA1503000041,1,13,false,12,4,-8,41.89452,-87.61798
TA1307000062,1,13,false,5,5,0,41.89466,-87.63839
TA1306000012,1,13,false,5,3,-2,41.89475,-87.63438
13132,1,13,false,3,6,3,41.89573,-87.67718
15530,1,13,false,1,8,7,41.89575,-87.62596
TA1305000020,1,13,false,5,2,-3,41.89636,-87.65406
13017,1,13,false,3,5,2,41.89676,-87.6357
13338,1,13,false,10,2,-8,41.89697,-87.62173
TA1307000061,1,13,false,5,1,-4,41.89745,-87.62873
13034,1,13,false,9,8,-1,41.89754,-87.62352
15529,1,13,false,8,10,2,41.89858,-87.62206
TA1307000128,1,13,false,6,12,6,41.89896,-87.6299
13042,1,13,false,23,32,9,41.90097,-87.62377
KA1504000133,1,13,false,14,18,4,41.90234,-87.62773
TA1307000039,1,13,false,7,10,3,41.90294,-87.63137
KA1504000135,1,13,false,5,7,2,41.90319,-87.63439
13136,1,13,false,5,2,-3,41.90326,-87.67845
KA1504000079,1,13,false,1,5,4,41.9035,-87.64334
TA1308000049,1,13,false,4,5,1,41.90672,-87.6349
13221,1,13,false,5,3,-2,41.90765,-87.67254
TA1309000024,1,13,false,2,7,5,41.908,-87.63152
TA1305000041,1,13,false,2,12,10,41.9094,-87.67769
331,1,13,false,2,6,4,41.90965,-87.64812
13058,1,13,false,3,5,2,41.91059,-87.64942
LF-005,1,13,false,17,38,21,41.91172,-87.62681
13128,1,13,false,6,1,-5,41.91197,-87.63197
TA1308000050,1,13,false,8,5,-3,41.91211,-87.6347
13243,1,13,false,6,4,-2,41.91262,-87.6814
TA1307000166,1,13,false,5,2,-3,41.91386,-87.64877
15655,1,13,false,6,1,-5,41.91401,-87.70514
13179,1,13,false,5,13,8,41.9157,-87.63461
13146,1,13,false,5,10,5,41.91831,-87.63629
13059,1,13,false,8,6,-2,41.91845,-87.65222
13192,1,13,false,7,2,-5,41.91995,-87.64884
13193,1,13,false,6,1,-5,41.92182,-87.64412
13084,1,13,false,1,5,4,41.92268,-87.69715
LP-,1,13,false,7,16,9,41.92396,-87.63584
TA1307000001,1,13,false,3,5,2,41.92535,-87.66581
TA1306000016,1,13,false,6,2,-4,41.9256,-87.65371
TA1309000019,1,13,false,6,7,1,41.92586,-87.63897
TA1309000058,1,13,false,3,5,2,41.92591,-87.64927
TA1308000001,1,13,false,15,17,2,41.92627,-87.63086
13124,1,13,false,12,4,-8,41.92675,-87.63444
13085,1,13,false,7,2,-5,41.92958,-87.70789
TA1307000142,1,13,false,4,9,5,41.93125,-87.64432
13276,1,13,false,9,6,-3,41.93132,-87.63874
TA1307000064,1,13,false,8,1,-7,41.93222,-87.65864
TA1306000014,1,13,false,7,5,-2,41.93242,-87.65271
TA1309000039,1,13,false,11,4,-7,41.93258,-87.63642
TA1309000036,1,13,false,5,3,-2,41.93313,-87.64776
TA1307000136,1,13,false,5,2,-3,41.9365,-87.64755
TA1307000041,1,13,false,12,6,-6,41.93669,-87.63683
13137,1,13,false,5,12,7,41.9376,-87.6441
13277,1,13,false,4,5,1,41.9401,-87.64546
TA1307000134,1,13,false,11,5,-6,41.94016,-87.65303
TA1309000049,1,13,false,12,8,-4,41.94077,-87.63919
TA1309000025,1,13,false,7,8,1,41.94368,-87.64894
13071,1,13,false,3,6,3,41.94373,-87.66401
632,1,13,false,9,1,-8,41.94453,-87.6547
13278,1,13,false,5,4,-1,41.94553,-87.64644
13235,1,13,false,7,3,-4,41.94814,-87.66396
13325,1,13,false,5,1,-4,41.94907,-87.64863
TA1307000126,1,13,false,5,5,0,41.94936,-87.65451
13323,1,13,false,6,5,-1,41.95282,-87.65
TA1309000043,1,13,false,2,6,4,41.95417,-87.66434
13063,1,13,false,7,10,3,41.95424,-87.65441
13379,1,13,false,6,3,-3,41.95786,-87.6495
TA1308000012,1,13,false,14,13,-1,41.96398,-87.63818
KA1504000152,1,13,false,6,7,1,41.98403,-87.65231
15578,1,13,false,5,1,-4,41.98405,-87.66027
RP-009,1,13,false,5,4,-1,42.00107,-87.66122
TA1309000011,1,13,true,3,6,3,41.78873,-87.60131
KA1503000071,1,13,true,8,3,-5,41.79148,-87.59988
TA1307000129,1,13,true,2,5,3,41.83104,-87.62683
13345,1,13,true,5,5,0,41.83138,-87.61803
13216,1,13,true,10,7,-3,41.83473,-87.62581
TA1309000055,1,13,true,7,6,-1,41.8382,-87.64514
TA1307000048,1,13,true,5,4,-1,41.83855,-87.60821
TA1308000036,1,13,true,2,8,6,41.83883,-87.62186
TA1307000139,1,13,true,8,4,-4,41.84205,-87.61698
15545,1,13,true,5,3,-2,41.85627,-87.61334
13135,1,13,true,4,6,2,41.85753,-87.66157
13102,1,13,true,5,7,2,41.85762,-87.61942
13150,1,13,true,4,7,3,41.85783,-87.62455
TA1307000124,1,13,true,5,6,1,41.86411,-87.62372
13431,1,13,true,5,4,-1,41.8661,-87.60728
WL-008,1,13,true,6,2,-4,41.86712,-87.64108
TA1305000002,1,13,true,13,12,-1,41.86721,-87.62597
15544,1,13,true,11,6,-5,41.86723,-87.61536
KA1706005007,1,13,true,5,2,-3,41.86749,-87.63219
SL-005,1,13,true,10,6,-4,41.8679,-87.62304
13139,1,13,true,8,4,-4,41.86893,-87.65913
13160,1,13,true,1,5,4,41.86947,-87.65548
15550,1,13,true,4,6,2,41.87024,-87.63947
TA1309000010,1,13,true,5,12,7,41.87074,-87.62574
TA1309000064,1,13,true,11,9,-2,41.87127,-87.67369
TA1307000130,1,13,true,6,3,-3,41.87178,-87.65103
TA1307000121,1,13,true,7,6,-1,41.87184,-87.64664
SL-008,1,13,true,8,6,-2,41.87209,-87.62956
13332,1,13,true,11,10,-1,41.87219,-87.6615
13028,1,13,true,3,8,5,41.87475,-87.64981
TA1305000035,1,13,true,6,7,1,41.87716,-87.62787
15539,1,13,true,4,6,2,41.87763,-87.64405
13158,1,13,true,10,14,4,41.87764,-87.64957
13157,1,13,true,5,8,3,41.87773,-87.6548
TA1305000025,1,13,true,14,20,6,41.87773,-87.63528
13206,1,13,true,1,5,4,41.87794,-87.66201
TA1309000004,1,13,true,3,5,2,41.87811,-87.63184
638,1,13,true,9,8,-1,41.87827,-87.64078
TA1305000005,1,13,true,4,6,2,41.87924,-87.62975
13011,1,13,true,4,5,1,41.87931,-87.63993
TA1309000008,1,13,true,8,5,-3,41.87933,-87.6355
KA1503000015,1,13,true,4,6,2,41.87948,-87.6257
TA1309000007,1,13,true,3,6,3,41.88022,-87.63526
13156,1,13,true,5,3,-2,41.88042,-87.65554
13300,1,13,true,4,10,6,41.88097,-87.61675
13008,1,13,true,3,8,5,41.88105,-87.62408
TA1305000006,1,13,true,16,10,-6,41.88122,-87.6296
TA1307000120,1,13,true,12,9,-3,41.88188,-87.64879
13341,1,13,true,3,5,2,41.88208,-87.63985
13036,1,13,true,8,5,-3,41.8821,-87.62513
TA1305000032,1,13,true,7,9,2,41.88218,-87.64109
13006,1,13,true,12,7,-5,41.88268,-87.63252
13409,1,13,true,5,6,1,41.8831,-87.6511
13053,1,13,true,5,5,0,41.88365,-87.64863
13001,1,13,true,9,3,-6,41.88397,-87.62459
TA1306000010,1,13,true,11,9,-2,41.88419,-87.62961
TA1305000030,1,13,true,7,7,0,41.88459,-87.63178
TA1305000029,1,13,true,13,8,-5,41.88466,-87.62787
13263,1,13,true,6,13,7,41.88467,-87.61952
TA1306000015,1,13,true,4,5,1,41.88549,-87.65232
13021,1,13,true,6,6,0,41.88559,-87.64184
TA1307000111,1,13,true,6,14,8,41.88582,-87.63548
KA1503000012,1,13,true,7,11,4,41.88599,-87.63089
TA1305000011,1,13,true,16,5,-11,41.886,-87.62418
15534,1,13,true,2,6,4,41.88627,-87.61749
TA1307000131,1,13,true,9,5,-4,41.88688,-87.62606
KA1503000064,1,13,true,5,2,-3,41.88697,-87.61281
TA1305000022,1,13,true,12,10,-2,41.88817,-87.63656
TA1306000003,1,13,true,3,6,3,41.88867,-87.64442
KA1503000043,1,13,true,20,15,-5,41.88918,-87.63851
13050,1,13,true,5,10,5,41.88919,-87.62775
TA1307000151,1,13,true,12,9,-3,41.88993,-87.63427
636,1,13,true,4,5,1,41.88997,-87.63662
KA1503000044,1,13,true,2,9,7,41.89018,-87.6262
13427,1,13,true,5,3,-2,41.89054,-87.62205
13430,1,13,true,9,13,4,41.89077,-87.63169
TA1306000013,1,13,true,3,7,4,41.89083,-87.61852
RN-,1,13,true,7,6,-1,41.89102,-87.63546
TA1307000117,1,13,true,12,16,4,41.89144,-87.62675
13033,1,13,true,7,5,-2,41.8916,-87.64835
13194,1,13,true,6,5,-1,41.8918,-87.65878
TA1305000003,1,13,true,7,13,6,41.89187,-87.62061
13022,1,13,true,13,9,-4,41.89227,-87.61205
TA1306000029,1,13,true,4,7,3,41.89256,-87.61449
13265,1,13,true,6,9,3,41.89383,-87.64172
13045,1,13,true,18,11,-7,41.89403,-87.62931
13016,1,13,true,8,8,0,41.89431,-87.62277
KA1503000041,1,13,true,8,4,-4,41.89452,-87.61798
13196,1,13,true,2,5,3,41.89455,-87.65345
TA1307000062,1,13,true,11,8,-3,41.89466,-87.63839
TA1306000012,1,13,true,5,8,3,41.89475,-87.63438
KP1705001026,1,13,true,5,5,0,41.89483,-87.6323
637,1,13,true,6,3,-3,41.89563,-87.67209
13132,1,13,true,3,6,3,41.89573,-87.67718
15530,1,13,true,8,10,2,41.89575,-87.62596
18003,1,13,true,4,6,2,41.89575,-87.62011
13247,1,13,true,6,7,1,41.89597,-87.66775
13303,1,13,true,4,6,2,41.89672,-87.63088
13338,1,13,true,9,6,-3,41.89697,-87.62173
13034,1,13,true,3,5,2,41.89754,-87.62352
15529,1,13,true,6,6,0,41.89858,-87.62206
TA1307000128,1,13,true,6,15,9,41.89896,-87.6299
13290,1,13,true,5,2,-3,41.90069,-87.66259
13042,1,13,true,8,9,1,41.90097,-87.62377
TA1307000070,1,13,true,2,10,8,41.90133,-87.67742
KA1504000133,1,13,true,11,10,-1,41.90234,-87.62773
TA1307000039,1,13,true,21,18,-3,41.90294,-87.63137
TA1305000034,1,13,true,7,4,-3,41.90313,-87.67391
KA1504000135,1,13,true,14,14,0,41.90319,-87.63439
13061,1,13,true,8,5,-3,41.90342,-87.66779
KA1504000079,1,13,true,6,7,1,41.9035,-87.64334
TA1307000115,1,13,true,5,11,6,41.9046,-87.64056
TA1308000049,1,13,true,10,7,-3,41.90672,-87.6349
KA1504000134,1,13,true,6,9,3,41.90687,-87.6262
13221,1,13,true,7,2,-5,41.90765,-87.67254
TA1309000024,1,13,true,10,5,-5,41.908,-87.63152
TA1305000041,1,13,true,5,5,0,41.9094,-87.67769
331,1,13,true,7,7,0,41.90965,-87.64812
TA1306000008,1,13,true,6,5,-1,41.9102,-87.6435
13154,1,13,true,5,8,3,41.91054,-87.65312
13058,1,13,true,6,3,-3,41.91059,-87.64942
LF-005,1,13,true,11,8,-3,41.91172,-87.62681
TA1308000050,1,13,true,14,15,1,41.91211,-87.6347
TA1307000166,1,13,true,5,3,-2,41.91386,-87.64877
13179,1,13,true,7,7,0,41.9157,-87.63461
TA1307000163,1,13,true,4,10,6,41.91821,-87.65696
13146,1,13,true,8,6,-2,41.91831,-87.63629
13059,1,13,true,7,8,1,41.91845,-87.65222
13192,1,13,true,5,3,-2,41.91995,-87.64884
TA1309000030,1,13,true,4,12,8,41.92077,-87.66372
TA1309000033,1,13,true,3,6,3,41.92158,-87.65381
13193,1,13,true,9,7,-2,41.92182,-87.64412
TA1307000001,1,13,true,5,6,1,41.92535,-87.66581
TA1306000026,1,13,true,8,10,2,41.92558,-87.65842
TA1306000016,1,13,true,6,3,-3,41.9256,-87.65371
TA1309000019,1,13,true,3,7,4,41.92586,-87.63897
TA1309000058,1,13,true,10,8,-2,41.92591,-87.64927
TA1308000001,1,13,true,11,6,-5,41.92627,-87.63086
13124,1,13,true,5,3,-2,41.92675,-87.63444
TA1309000023,1,13,true,8,4,-4,41.9287,-87.65383
TA1309000061,1,13,true,5,3,-2,41.92915,-87.64909
TA1305000014,1,13,true,7,5,-2,41.92956,-87.64313
TA1307000142,1,13,true,12,11,-1,41.93125,-87.64432
TA1309000039,1,13,true,7,6,-1,41.93258,-87.63642
TA1309000036,1,13,true,6,8,2,41.93313,-87.64776
TA1307000006,1,13,true,1,8,7,41.93571,-87.6636
13269,1,13,true,5,3,-2,41.93609,-87.66983
TA1307000052,1,13,true,6,12,6,41.93628,-87.65266
TA1307000136,1,13,true,7,10,3,41.9365,-87.64755
TA1307000041,1,13,true,7,5,-2,41.93669,-87.63683
13137,1,13,true,5,13,8,41.9376,-87.6441
TA1309000042,1,13,true,4,5,1,41.93937,-87.66836
13277,1,13,true,5,4,-1,41.9401,-87.64546
TA1307000134,1,13,true,6,6,0,41.94016,-87.65303
TA1309000049,1,13,true,7,3,-4,41.94077,-87.63919
TA1307000138,1,13,true,7,3,-4,41.94334,-87.67094
TA1309000025,1,13,true,3,7,4,41.94368,-87.64894
13071,1,13,true,11,8,-3,41.94373,-87.66401
632,1,13,true,5,4,-1,41.94453,-87.6547
13278,1,13,true,6,9,3,41.94553,-87.64644
13235,1,13,true,10,7,-3,41.94814,-87.66396
13253,1,13,true,5,5,0,41.9488,-87.67527
TA1307000126,1,13,true,5,3,-2,41.94936,-87.65451
TA1307000150,1,13,true,13,10,-3,41.94945,-87.64646
TA1307000127,1,13,true,5,11,6,41.9508,-87.65918
13323,1,13,true,5,5,0,41.95282,-87.65
TA1309000043,1,13,true,3,6,3,41.95417,-87.66434
13063,1,13,true,6,3,-3,41.95424,-87.65441
13379,1,13,true,6,16,10,41.95786,-87.6495
TA1307000107,1,13,true,3,10,7,41.96164,-87.65464
13074,1,13,true,11,6,-5,41.96521,-87.6582
TA1309000014,1,13,true,8,7,-1,41.96709,-87.66744
TA1307000158,1,13,true,7,8,1,41.9671,-87.67904
KA1504000149,1,13,true,6,1,-5,41.97562,-87.67945
13109,1,13,true,8,8,0,41.97835,-87.65976
KA1504000151,1,13,true,5,5,0,41.98359,-87.66916
KA1504000152,1,13,true,6,4,-2,41.98403,-87.65231
15571,1,13,true,5,3,-2,41.99478,-87.66028
660,1,13,true,2,5,3,42.00458,-87.66143
KA1504000076,1,14,false,6,2,-4,41.7943,-87.60145
TA1307000164,1,14,false,6,3,-3,41.79527,-87.59647
KA1503000059,1,14,false,7,4,-3,41.79952,-87.58643
TA1307000048,1,14,false,4,7,3,41.83855,-87.60821
TA1307000005,1,14,false,1,5,4,41.84569,-87.6225
TA1305000001,1,14,false,5,1,-4,41.85262,-87.6265
15545,1,14,false,1,6,5,41.85627,-87.61334
13102,1,14,false,4,7,3,41.85762,-87.61942
13029,1,14,false,10,5,-5,41.86531,-87.6179
13431,1,14,false,7,8,1,41.8661,-87.60728
TA1305000002,1,14,false,12,15,3,41.86721,-87.62597
15544,1,14,false,86,59,-27,41.86723,-87.61536
KA1706005007,1,14,false,3,6,3,41.86749,-87.63219
SL-005,1,14,false,6,18,12,41.8679,-87.62304
13160,1,14,false,5,4,-1,41.86947,-87.65548
15550,1,14,false,3,5,2,41.87024,-87.63947
TA1309000010,1,14,false,9,2,-7,41.87074,-87.62574
SL-009,1,14,false,1,5,4,41.87081,-87.63121
SL-011,1,14,false,7,6,-1,41.87256,-87.63356
623,1,14,false,13,13,0,41.87272,-87.62399
KA1504000104,1,14,false,5,2,-3,41.87296,-87.66912
15541,1,14,false,26,19,-7,41.8758,-87.62086
13037,1,14,false,5,1,-4,41.87588,-87.64078
624,1,14,false,4,9,5,41.87626,-87.62923
TA1305000035,1,14,false,9,4,-5,41.87716,-87.62787
TA1305000025,1,14,false,2,6,4,41.87773,-87.63528
TA1309000002,1,14,false,11,25,14,41.87784,-87.62408
TA1309000004,1,14,false,6,1,-5,41.87811,-87.63184
TA1305000005,1,14,false,9,2,-7,41.87924,-87.62975
TA1309000008,1,14,false,7,5,-2,41.87933,-87.6355
KA1503000034,1,14,false,12,2,-10,41.87938,-87.63197
KA1503000015,1,14,false,7,5,-2,41.87948,-87.6257
TA1309000007,1,14,false,11,13,2,41.88022,-87.63526
13156,1,14,false,16,1,-15,41.88042,-87.65554
13300,1,14,false,41,37,-4,41.88097,-87.61675
13008,1,14,false,42,42,0,41.88105,-87.62408
TA1305000006,1,14,false,10,6,-4,41.88122,-87.6296
TA1307000120,1,14,false,4,5,1,41.88188,-87.64879
13341,1,14,false,1,5,4,41.88208,-87.63985
13036,1,14,false,12,12,0,41.8821,-87.62513
TA1305000032,1,14,false,10,4,-6,41.88218,-87.64109
13006,1,14,false,5,2,-3,41.88268,-87.63252
13409,1,14,false,3,7,4,41.8831,-87.6511
WL-012,1,14,false,5,1,-4,41.88337,-87.6412
13053,1,14,false,7,5,-2,41.88365,-87.64863
13001,1,14,false,13,17,4,41.88397,-87.62459
TA1306000010,1,14,false,17,8,-9,41.88419,-87.62961
TA1305000030,1,14,false,8,5,-3,41.88459,-87.63178
TA1305000029,1,14,false,6,6,0,41.88466,-87.62787
13263,1,14,false,6,3,-3,41.88467,-87.61952
TA1306000015,1,14,false,3,6,3,41.88549,-87.65232
13021,1,14,false,6,5,-1,41.88559,-87.64184
TA1307000111,1,14,false,5,1,-4,41.88582,-87.63548
KA1503000012,1,14,false,5,7,2,41.88599,-87.63089
TA1305000011,1,14,false,26,23,-3,41.886,-87.62418
TA1307000131,1,14,false,16,20,4,41.88688,-87.62606
KA1503000064,1,14,false,24,19,-5,41.88697,-87.61281
TA1305000022,1,14,false,6,9,3,41.88817,-87.63656
TA1306000003,1,14,false,4,7,3,41.88867,-87.64442
KA1503000043,1,14,false,5,5,0,41.88918,-87.63851
13050,1,14,false,6,9,3,41.88919,-87.62775
TA1307000151,1,14,false,4,8,4,41.88993,-87.63427
KA1503000044,1,14,false,6,7,1,41.89018,-87.6262
13427,1,14,false,7,7,0,41.89054,-87.62205
13430,1,14,false,10,8,-2,41.89077,-87.63169
TA1306000013,1,14,false,6,4,-2,41.89083,-87.61852
RN-,1,14,false,6,6,0,41.89102,-87.63546
TA1307000117,1,14,false,4,24,20,41.89144,-87.62675
TA1305000003,1,14,false,14,14,0,41.89187,-87.62061
13022,1,14,false,101,100,-1,41.89227,-87.61205
TA1306000029,1,14,false,14,4,-10,41.89256,-87.61449
13265,1,14,false,5,3,-2,41.89383,-87.64172
13045,1,14,false,9,9,0,41.89403,-87.62931
13016,1,14,false,15,13,-2,41.89431,-87.62277
KA1503000041,1,14,false,1,5,4,41.89452,-87.61798
TA1306000012,1,14,false,6,5,-1,41.89475,-87.63438
KP1705001026,1,14,false,5,4,-1,41.89483,-87.6323
15530,1,14,false,7,14,7,41.89575,-87.62596
18003,1,14,false,6,3,-3,41.89575,-87.62011
13303,1,14,false,6,5,-1,41.89672,-87.63088
13338,1,14,false,6,6,0,41.89697,-87.62173
TA1307000061,1,14,false,5,7,2,41.89745,-87.62873
13034,1,14,false,12,11,-1,41.89754,-87.62352
15529,1,14,false,6,6,0,41.89858,-87.62206
TA1307000128,1,14,false,3,7,4,41.89896,-87.6299
13042,1,14,false,50,45,-5,41.90097,-87.62377
KA1504000133,1,14,false,4,7,3,41.90234,-87.62773
TA1307000039,1,14,false,6,3,-3,41.90294,-87.63137
KA1504000135,1,14,false,4,11,7,41.90319,-87.63439
13136,1,14,false,5,3,-2,41.90326,-87.67845
13061,1,14,false,2,7,5,41.90342,-87.66779
KA1504000079,1,14,false,4,5,1,41.9035,-87.64334
TA1308000049,1,14,false,2,10,8,41.90672,-87.6349
KA1504000134,1,14,false,3,6,3,41.90687,-87.6262
TA1309000024,1,14,false,5,5,0,41.908,-87.63152
TA1305000041,1,14,false,6,5,-1,41.9094,-87.67769
331,1,14,false,6,1,-5,41.90965,-87.64812
LF-005,1,14,false,38,29,-9,41.91172,-87.62681
13128,1,14,false,5,7,2,41.91197,-87.63197
TA1308000050,1,14,false,12,8,-4,41.91211,-87.6347
15655,1,14,false,4,5,1,41.91401,-87.70514
18067,1,14,false,4,7,3,41.9146,-87.66796
13068,1,14,false,4,5,1,41.91554,-87.68703
13179,1,14,false,13,10,-3,41.9157,-87.63461
13146,1,14,false,8,8,0,41.91831,-87.63629
13059,1,14,false,7,6,-1,41.91845,-87.65222
TA1309000033,1,14,false,4,8,4,41.92158,-87.65381
13193,1,14,false,7,7,0,41.92182,-87.64412
LP-,1,14,false,15,20,5,41.92396,-87.63584
TA1307000001,1,14,false,4,5,1,41.92535,-87.66581
TA1309000019,1,14,false,9,13,4,41.92586,-87.63897
TA1308000001,1,14,false,24,25,1,41.92627,-87.63086
13124,1,14,false,11,8,-3,41.92675,-87.63444
TA1309000023,1,14,false,4,8,4,41.9287,-87.65383
TA1305000014,1,14,false,5,6,1,41.92956,-87.64313
13085,1,14,false,1,8,7,41.92958,-87.70789
TA1307000142,1,14,false,4,11,7,41.93125,-87.64432
13276,1,14,false,9,9,0,41.93132,-87.63874
TA1307000064,1,14,false,6,6,0,41.93222,-87.65864
TA1309000039,1,14,false,5,4,-1,41.93258,-87.63642
TA1309000036,1,14,false,5,1,-4,41.93313,-87.64776
TA1307000006,1,14,false,7,1,-6,41.93571,-87.6636
TA1307000136,1,14,false,4,5,1,41.9365,-87.64755
TA1307000041,1,14,false,7,8,1,41.93669,-87.63683
13137,1,14,false,7,7,0,41.9376,-87.6441
TA1308000019,1,14,false,1,5,4,41.93973,-87.65886
13277,1,14,false,4,10,6,41.9401,-87.64546
TA1307000134,1,14,false,1,7,6,41.94016,-87.65303
TA1309000049,1,14,false,14,8,-6,41.94077,-87.63919
TA1309000025,1,14,false,5,7,2,41.94368,-87.64894
13278,1,14,false,7,4,-3,41.94553,-87.64644
13325,1,14,false,6,7,1,41.94907,-87.64863
TA1307000126,1,14,false,11,11,0,41.94936,-87.65451
TA1307000150,1,14,false,2,5,3,41.94945,-87.64646
13319,1,14,false,6,3,-3,41.95069,-87.6687
13063,1,14,false,7,4,-3,41.95424,-87.65441
TA1308000022,1,14,false,5,8,3,41.95438,-87.64805
TA1309000027,1,14,false,2,6,4,41.9585,-87.65499
TA1308000012,1,14,false,7,7,0,41.96398,-87.63818
KA1504000152,1,14,false,17,12,-5,41.98403,-87.65231
15571,1,14,false,3,5,2,41.99478,-87.66028
523,1,14,false,1,5,4,42.02089,-87.66505
596,1,14,false,1,5,4,42.04822,-87.68348
KA1503000071,1,14,true,12,6,-6,41.79148,-87.59988
TA1308000009,1,14,true,8,5,-3,41.79522,-87.58075
TA1307000164,1,14,true,1,6,5,41.79527,-87.59647
KA1503000059,1,14,true,6,3,-3,41.79952,-87.58643
13216,1,14,true,12,7,-5,41.83473,-87.62581
13215,1,14,true,6,3,-3,41.83634,-87.6135
TA1309000055,1,14,true,4,7,3,41.8382,-87.64514
TA1307000139,1,14,true,4,10,6,41.84205,-87.61698
15545,1,14,true,4,6,2,41.85627,-87.61334
13135,1,14,true,5,5,0,41.85753,-87.66157
13102,1,14,true,5,3,-2,41.85762,-87.61942
13150,1,14,true,4,6,2,41.85783,-87.62455
TA1307000044,1,14,true,5,7,2,41.85794,-87.64083
SL-012,1,14,true,4,9,5,41.86038,-87.62581
TA1306000002,1,14,true,1,6,5,41.86238,-87.65108
TA1307000124,1,14,true,7,5,-2,41.86411,-87.62372
13354,1,14,true,1,7,6,41.86524,-87.66651
WL-008,1,14,true,1,8,7,41.86712,-87.64108
TA1305000002,1,14,true,10,11,1,41.86721,-87.62597
15544,1,14,true,4,6,2,41.86723,-87.61536
SL-005,1,14,true,7,4,-3,41.8679,-87.62304
13160,1,14,true,8,6,-2,41.86947,-87.65548
TA1309000010,1,14,true,6,4,-2,41.87074,-87.62574
TA1309000064,1,14,true,15,5,-10,41.87127,-87.67369
TA1307000130,1,14,true,9,15,6,41.87178,-87.65103
TA1307000121,1,14,true,8,10,2,41.87184,-87.64664
SL-008,1,14,true,6,4,-2,41.87209,-87.62956
13332,1,14,true,14,13,-1,41.87219,-87.6615
623,1,14,true,6,4,-2,41.87272,-87.62399
KA1504000104,1,14,true,6,1,-5,41.87296,-87.66912
TA1306000025,1,14,true,5,7,2,41.87464,-87.65703
13028,1,14,true,3,5,2,41.87475,-87.64981
624,1,14,true,1,6,5,41.87626,-87.62923
15539,1,14,true,1,5,4,41.87763,-87.64405
13158,1,14,true,8,8,0,41.87764,-87.64957
13157,1,14,true,5,7,2,41.87773,-87.6548
TA1305000025,1,14,true,13,3,-10,41.87773,-87.63528
TA1309000002,1,14,true,1,5,4,41.87784,-87.62408
TA1309000004,1,14,true,21,6,-15,41.87811,-87.63184
638,1,14,true,7,5,-2,41.87827,-87.64078
TA1305000005,1,14,true,6,2,-4,41.87924,-87.62975
13011,1,14,true,4,10,6,41.87931,-87.63993
TA1309000008,1,14,true,12,3,-9,41.87933,-87.6355
KA1503000015,1,14,true,8,8,0,41.87948,-87.6257
TA1309000007,1,14,true,14,2,-12,41.88022,-87.63526
13156,1,14,true,4,14,10,41.88042,-87.65554
13300,1,14,true,5,7,2,41.88097,-87.61675
13008,1,14,true,11,10,-1,41.88105,-87.62408
TA1305000006,1,14,true,16,5,-11,41.88122,-87.6296
TA1307000120,1,14,true,10,17,7,41.88188,-87.64879
13341,1,14,true,4,11,7,41.88208,-87.63985
TA1305000032,1,14,true,9,11,2,41.88218,-87.64109
13006,1,14,true,7,7,0,41.88268,-87.63252
13353,1,14,true,1,5,4,41.88283,-87.6612
13409,1,14,true,6,2,-4,41.8831,-87.6511
KA1503000072,1,14,true,7,2,-5,41.88317,-87.63693
WL-012,1,14,true,5,13,8,41.88337,-87.6412
13053,1,14,true,3,6,3,41.88365,-87.64863
13001,1,14,true,6,3,-3,41.88397,-87.62459
18062,1,14,true,5,3,-2,41.88412,-87.65427
TA1306000010,1,14,true,10,8,-2,41.88419,-87.62961
TA1305000030,1,14,true,13,6,-7,41.88459,-87.63178
TA1305000029,1,14,true,9,4,-5,41.88466,-87.62787
13263,1,14,true,7,10,3,41.88467,-87.61952
TA1306000015,1,14,true,6,3,-3,41.88549,-87.65232
13021,1,14,true,3,6,3,41.88559,-87.64184
TA1307000111,1,14,true,12,5,-7,41.88582,-87.63548
KA1503000012,1,14,true,9,14,5,41.88599,-87.63089
TA1305000011,1,14,true,11,4,-7,41.886,-87.62418
TA1305000022,1,14,true,8,14,6,41.88817,-87.63656
TA1306000003,1,14,true,5,3,-2,41.88867,-87.64442
KA1503000043,1,14,true,15,14,-1,41.88918,-87.63851
13050,1,14,true,6,5,-1,41.88919,-87.62775
TA1307000151,1,14,true,6,8,2,41.88993,-87.63427
636,1,14,true,5,9,4,41.88997,-87.63662
13427,1,14,true,4,6,2,41.89054,-87.62205
13430,1,14,true,3,7,4,41.89077,-87.63169
TA1306000013,1,14,true,3,5,2,41.89083,-87.61852
RN-,1,14,true,5,7,2,41.89102,-87.63546
TA1307000117,1,14,true,20,14,-6,41.89144,-87.62675
13194,1,14,true,2,6,4,41.8918,-87.65878
TA1305000003,1,14,true,12,6,-6,41.89187,-87.62061
13022,1,14,true,8,7,-1,41.89227,-87.61205
TA1306000029,1,14,true,5,9,4,41.89256,-87.61449
13265,1,14,true,9,9,0,41.89383,-87.64172
13045,1,14,true,6,11,5,41.89403,-87.62931
13016,1,14,true,18,12,-6,41.89431,-87.62277
KA1503000041,1,14,true,7,8,1,41.89452,-87.61798
13196,1,14,true,5,1,-4,41.89455,-87.65345
TA1307000062,1,14,true,4,5,1,41.89466,-87.63839
TA1306000012,1,14,true,7,6,-1,41.89475,-87.63438
15530,1,14,true,11,7,-4,41.89575,-87.62596
18003,1,14,true,6,2,-4,41.89575,-87.62011
13303,1,14,true,3,5,2,41.89672,-87.63088
13017,1,14,true,5,11,6,41.89676,-87.6357
13338,1,14,true,9,3,-6,41.89697,-87.62173
TA1306000009,1,14,true,10,2,-8,41.89772,-87.64299
15529,1,14,true,2,7,5,41.89858,-87.62206
TA1307000128,1,14,true,11,14,3,41.89896,-87.6299
13290,1,14,true,5,5,0,41.90069,-87.66259
13042,1,14,true,9,9,0,41.90097,-87.62377
KA1504000133,1,14,true,11,9,-2,41.90234,-87.62773
TA1307000039,1,14,true,16,19,3,41.90294,-87.63137
KA1504000135,1,14,true,13,14,1,41.90319,-87.63439
13136,1,14,true,3,5,2,41.90326,-87.67845
13061,1,14,true,3,5,2,41.90342,-87.66779
TA1308000049,1,14,true,3,9,6,41.90672,-87.6349
KA1504000134,1,14,true,8,9,1,41.90687,-87.6262
TA1309000024,1,14,true,8,12,4,41.908,-87.63152
TA1305000041,1,14,true,10,4,-6,41.9094,-87.67769
331,1,14,true,10,8,-2,41.90965,-87.64812
13154,1,14,true,8,15,7,41.91054,-87.65312
13058,1,14,true,9,5,-4,41.91059,-87.64942
TA1307000038,1,14,true,6,8,2,41.91138,-87.63868
LF-005,1,14,true,7,6,-1,41.91172,-87.62681
13128,1,14,true,2,5,3,41.91197,-87.63197
TA1308000050,1,14,true,10,16,6,41.91211,-87.6347
13243,1,14,true,5,3,-2,41.91262,-87.6814
TA1306000032,1,14,true,3,6,3,41.9137,-87.65285
13179,1,14,true,6,12,6,41.9157,-87.63461
TA1307000163,1,14,true,4,6,2,41.91821,-87.65696
13146,1,14,true,13,6,-7,41.91831,-87.63629
13059,1,14,true,5,4,-1,41.91845,-87.65222
TA1309000030,1,14,true,5,5,0,41.92077,-87.66372
13193,1,14,true,6,15,9,41.92182,-87.64412
13084,1,14,true,4,5,1,41.92268,-87.69715
LP-,1,14,true,5,2,-3,41.92396,-87.63584
TA1306000026,1,14,true,5,9,4,41.92558,-87.65842
TA1309000058,1,14,true,5,6,1,41.92591,-87.64927
TA1308000001,1,14,true,5,7,2,41.92627,-87.63086
TA1307000113,1,14,true,9,5,-4,41.92878,-87.66391
TA1309000059,1,14,true,3,5,2,41.92889,-87.65898
TA1309000061,1,14,true,9,7,-2,41.92915,-87.64909
TA1305000014,1,14,true,6,7,1,41.92956,-87.64313
13085,1,14,true,5,7,2,41.92958,-87.70789
TA1307000142,1,14,true,8,8,0,41.93125,-87.64432
TA1306000014,1,14,true,6,1,-5,41.93242,-87.65271
TA1309000039,1,14,true,5,5,0,41.93258,-87.63642
13294,1,14,true,2,6,4,41.9326,-87.66595
TA1309000036,1,14,true,3,8,5,41.93313,-87.64776
TA1307000136,1,14,true,2,9,7,41.9365,-87.64755
TA1307000041,1,14,true,2,6,4,41.93669,-87.63683
13137,1,14,true,18,10,-8,41.9376,-87.6441
KA17018068,1,14,true,1,5,4,41.93935,-87.68327
TA1309000042,1,14,true,4,6,2,41.93937,-87.66836
13277,1,14,true,5,2,-3,41.9401,-87.64546
TA1307000138,1,14,true,8,10,2,41.94334,-87.67094
13144,1,14,true,6,3,-3,41.9434,-87.67964
TA1309000025,1,14,true,2,7,5,41.94368,-87.64894
13071,1,14,true,6,6,0,41.94373,-87.66401
632,1,14,true,5,7,2,41.94453,-87.6547
13278,1,14,true,5,4,-1,41.94553,-87.64644
13235,1,14,true,9,8,-1,41.94814,-87.66396
13325,1,14,true,7,11,4,41.94907,-87.64863
TA1307000126,1,14,true,6,6,0,41.94936,-87.65451
TA1307000150,1,14,true,10,9,-1,41.94945,-87.64646
TA1307000127,1,14,true,10,8,-2,41.9508,-87.65918
TA1309000043,1,14,true,5,3,-2,41.95417,-87.66434
13063,1,14,true,6,5,-1,41.95424,-87.65441
13379,1,14,true,5,10,5,41.95786,-87.6495
TA1307000107,1,14,true,6,8,2,41.96164,-87.65464
TA1307000156,1,14,true,7,1,-6,41.96301,-87.68479
TA1308000012,1,14,true,7,10,3,41.96398,-87.63818
13074,1,14,true,4,7,3,41.96521,-87.6582
639,1,14,true,5,4,-1,41.96584,-87.64538
TA1309000014,1,14,true,6,4,-2,41.96709,-87.66744
TA1307000158,1,14,true,8,3,-5,41.9671,-87.67904
TA1307000119,1,14,true,7,4,-3,41.96796,-87.65
TA1308000021,1,14,true,5,1,-4,41.96883,-87.65765
TA1309000066,1,14,true,2,7,5,41.9691,-87.67423
KA1504000146,1,14,true,5,8,3,41.978,-87.66805
13109,1,14,true,6,1,-5,41.97835,-87.65976
KA1504000151,1,14,true,1,5,4,41.98359,-87.66916
KA1504000152,1,14,true,13,11,-2,41.98403,-87.65231
520,1,14,true,2,5,3,42.01597,-87.66859
TA1308000009,1,15,false,3,6,3,41.79522,-87.58075
15470,1,15,false,5,1,-4,41.80228,-87.61807
KA1503000007,1,15,false,4,7,3,41.80242,-87.58689
TA1308000038,1,15,false,2,6,4,41.82298,-87.6071
KA1503000004,1,15,false,11,7,-4,41.83127,-87.6088
TA1307000048,1,15,false,4,6,2,41.83855,-87.60821
13075,1,15,false,5,3,-2,41.8531,-87.63192
TA1307000124,1,15,false,3,6,3,41.86411,-87.62372
13029,1,15,false,26,5,-21,41.86531,-87.6179
13431,1,15,false,4,6,2,41.8661,-87.60728
WL-008,1,15,false,5,2,-3,41.86712,-87.64108
TA1305000002,1,15,false,5,7,2,41.86721,-87.62597
15544,1,15,false,60,42,-18,41.86723,-87.61536
SL-005,1,15,false,11,16,5,41.8679,-87.62304
SL-009,1,15,false,6,2,-4,41.87081,-87.63121
SL-008,1,15,false,2,12,10,41.87209,-87.62956
623,1,15,false,11,10,-1,41.87272,-87.62399
15541,1,15,false,6,30,24,41.8758,-87.62086
624,1,15,false,7,2,-5,41.87626,-87.62923
15539,1,15,false,4,5,1,41.87763,-87.64405
TA1305000025,1,15,false,7,9,2,41.87773,-87.63528
TA1309000002,1,15,false,8,13,5,41.87784,-87.62408
TA1305000005,1,15,false,8,4,-4,41.87924,-87.62975
TA1309000008,1,15,false,11,6,-5,41.87933,-87.6355
TA1309000007,1,15,false,19,2,-17,41.88022,-87.63526
13300,1,15,false,54,41,-13,41.88097,-87.61675
13008,1,15,false,29,51,22,41.88105,-87.62408
TA1305000006,1,15,false,14,8,-6,41.88122,-87.6296
13056,1,15,false,10,2,-8,41.88168,-87.63951
TA1307000120,1,15,false,5,12,7,41.88188,-87.64879
13036,1,15,false,4,8,4,41.8821,-87.62513
TA1305000032,1,15,false,4,5,1,41.88218,-87.64109
13006,1,15,false,5,3,-2,41.88268,-87.63252
654,1,15,false,2,5,3,41.88307,-87.65698
13409,1,15,false,3,5,2,41.8831,-87.6511
WL-012,1,15,false,5,7,2,41.88337,-87.6412
13053,1,15,false,14,9,-5,41.88365,-87.64863
13001,1,15,false,16,22,6,41.88397,-87.62459
TA1306000010,1,15,false,7,3,-4,41.88419,-87.62961
TA1305000030,1,15,false,8,8,0,41.88459,-87.63178
TA1305000029,1,15,false,10,9,-1,41.88466,-87.62787
13263,1,15,false,10,12,2,41.88467,-87.61952
TA1306000015,1,15,false,8,2,-6,41.88549,-87.65232
13021,1,15,false,6,3,-3,41.88559,-87.64184
KA1503000012,1,15,false,2,8,6,41.88599,-87.63089
TA1305000011,1,15,false,16,21,5,41.886,-87.62418
15534,1,15,false,8,7,-1,41.88627,-87.61749
TA1308000029,1,15,false,1,12,11,41.88673,-87.62225
TA1307000131,1,15,false,21,10,-11,41.88688,-87.62606
KA1503000064,1,15,false,13,22,9,41.88697,-87.61281
TA1305000022,1,15,false,5,3,-2,41.88817,-87.63656
TA1306000003,1,15,false,3,5,2,41.88867,-87.64442
KA1503000043,1,15,false,9,7,-2,41.88918,-87.63851
13050,1,15,false,6,10,4,41.88919,-87.62775
TA1307000151,1,15,false,8,5,-3,41.88993,-87.63427
KA1503000044,1,15,false,1,6,5,41.89018,-87.6262
13427,1,15,false,7,12,5,41.89054,-87.62205
13430,1,15,false,8,13,5,41.89077,-87.63169
TA1306000013,1,15,false,17,15,-2,41.89083,-87.61852
TA1307000117,1,15,false,14,19,5,41.89144,-87.62675
13033,1,15,false,8,2,-6,41.8916,-87.64835
TA1305000003,1,15,false,8,14,6,41.89187,-87.62061
13022,1,15,false,83,101,18,41.89227,-87.61205
TA1306000029,1,15,false,10,15,5,41.89256,-87.61449
13265,1,15,false,6,6,0,41.89383,-87.64172
13045,1,15,false,9,12,3,41.89403,-87.62931
13016,1,15,false,12,11,-1,41.89431,-87.62277
KA1503000041,1,15,false,2,8,6,41.89452,-87.61798
TA1307000062,1,15,false,2,6,4,41.89466,-87.63839
TA1306000012,1,15,false,1,7,6,41.89475,-87.63438
KP1705001026,1,15,false,1,6,5,41.89483,-87.6323
15530,1,15,false,8,10,2,41.89575,-87.62596
13017,1,15,false,2,5,3,41.89676,-87.6357
TA1307000061,1,15,false,4,5,1,41.89745,-87.62873
13034,1,15,false,11,13,2,41.89754,-87.62352
TA1306000009,1,15,false,7,4,-3,41.89772,-87.64299
15529,1,15,false,6,1,-5,41.89858,-87.62206
TA1307000128,1,15,false,7,5,-2,41.89896,-87.6299
13042,1,15,false,25,41,16,41.90097,-87.62377
KA1504000133,1,15,false,5,5,0,41.90234,-87.62773
TA1307000039,1,15,false,7,11,4,41.90294,-87.63137
KA1504000135,1,15,false,17,14,-3,41.90319,-87.63439
KA1504000079,1,15,false,4,6,2,41.9035,-87.64334
TA1308000049,1,15,false,10,8,-2,41.90672,-87.6349
KA1504000134,1,15,false,2,6,4,41.90687,-87.6262
13221,1,15,false,6,6,0,41.90765,-87.67254
TA1309000024,1,15,false,3,6,3,41.908,-87.63152
TA1305000041,1,15,false,6,5,-1,41.9094,-87.67769
331,1,15,false,7,2,-5,41.90965,-87.64812
TA1305000037,1,15,false,5,1,-4,41.91018,-87.67003
TA1307000038,1,15,false,4,7,3,41.91138,-87.63868
LF-005,1,15,false,28,19,-9,41.91172,-87.62681
13128,1,15,false,3,6,3,41.91197,-87.63197
TA1308000050,1,15,false,11,7,-4,41.91211,-87.6347
13243,1,15,false,1,5,4,41.91262,-87.6814
13179,1,15,false,10,18,8,41.9157,-87.63461
TA1305000039,1,15,false,5,3,-2,41.9163,-87.66749
13146,1,15,false,10,8,-2,41.91831,-87.63629
13059,1,15,false,14,4,-10,41.91845,-87.65222
TA1309000030,1,15,false,10,2,-8,41.92077,-87.66372
13193,1,15,false,7,8,1,41.92182,-87.64412
13191,1,15,false,3,8,5,41.92217,-87.63891
13084,1,15,false,6,5,-1,41.92268,-87.69715
LP-,1,15,false,9,3,-6,41.92396,-87.63584
TA1306000026,1,15,false,3,7,4,41.92558,-87.65842
TA1306000016,1,15,false,5,4,-1,41.9256,-87.65371
TA1309000019,1,15,false,4,5,1,41.92586,-87.63897
TA1309000058,1,15,false,4,8,4,41.92591,-87.64927
TA1308000001,1,15,false,10,22,12,41.92627,-87.63086
TA1309000023,1,15,false,5,3,-2,41.9287,-87.65383
TA1307000113,1,15,false,1,6,5,41.92878,-87.66391
TA1305000014,1,15,false,7,9,2,41.92956,-87.64313
13085,1,15,false,5,7,2,41.92958,-87.70789
13276,1,15,false,8,15,7,41.93132,-87.63874
TA1306000014,1,15,false,3,5,2,41.93242,-87.65271
TA1309000039,1,15,false,11,13,2,41.93258,-87.63642
TA1309000036,1,15,false,3,6,3,41.93313,-87.64776
TA1307000052,1,15,false,3,6,3,41.93628,-87.65266
TA1307000136,1,15,false,5,3,-2,41.9365,-87.64755
TA1307000041,1,15,false,5,5,0,41.93669,-87.63683
13137,1,15,false,6,6,0,41.9376,-87.6441
TA1308000019,1,15,false,3,5,2,41.93973,-87.65886
13277,1,15,false,6,4,-2,41.9401,-87.64546
TA1307000134,1,15,false,4,5,1,41.94016,-87.65303
TA1309000025,1,15,false,5,4,-1,41.94368,-87.64894
632,1,15,false,5,11,6,41.94453,-87.6547
13325,1,15,false,8,7,-1,41.94907,-87.64863
TA1307000126,1,15,false,2,7,5,41.94936,-87.65451
TA1307000150,1,15,false,9,4,-5,41.94945,-87.64646
13319,1,15,false,1,6,5,41.95069,-87.6687
TA1307000127,1,15,false,4,9,5,41.9508,-87.65918
13063,1,15,false,2,5,3,41.95424,-87.65441
TA1308000022,1,15,false,5,6,1,41.95438,-87.64805
TA1307000107,1,15,false,7,3,-4,41.96164,-87.65464
TA1308000012,1,15,false,8,18,10,41.96398,-87.63818
TA1307000158,1,15,false,5,1,-4,41.9671,-87.67904
TA1309000041,1,15,false,5,2,-3,41.96951,-87.65471
KA1504000171,1,15,false,5,4,-1,41.97161,-87.65016
KA1504000152,1,15,false,6,5,-1,41.98403,-87.65231
15578,1,15,false,5,1,-4,41.98405,-87.66027
15575,1,15,false,2,5,3,41.98975,-87.66014
605,1,15,false,8,4,-4,42.05294,-87.67342
KA1503000070,1,15,true,1,5,4,41.78794,-87.58831
TA1309000011,1,15,true,7,2,-5,41.78873,-87.60131
TA1308000009,1,15,true,6,6,0,41.79522,-87.58075
13216,1,15,true,8,8,0,41.83473,-87.62581
13217,1,15,true,2,5,3,41.83488,-87.61792
13215,1,15,true,5,1,-4,41.83634,-87.6135
15442,1,15,true,5,2,-3,41.83918,-87.66562
TA1307000139,1,15,true,5,5,0,41.84205,-87.61698
TA1305000001,1,15,true,2,6,4,41.85262,-87.6265
15545,1,15,true,11,6,-5,41.85627,-87.61334
13102,1,15,true,4,7,3,41.85762,-87.61942
13164,1,15,true,5,1,-4,41.85818,-87.65648
SL-012,1,15,true,3,7,4,41.86038,-87.62581
TA1307000124,1,15,true,11,6,-5,41.86411,-87.62372
TA1309000001,1,15,true,5,2,-3,41.86488,-87.64708
13354,1,15,true,2,5,3,41.86524,-87.66651
13431,1,15,true,5,2,-3,41.8661,-87.60728
WL-008,1,15,true,4,7,3,41.86712,-87.64108
TA1305000002,1,15,true,7,6,-1,41.86721,-87.62597
15544,1,15,true,5,6,1,41.86723,-87.61536
KA1706005007,1,15,true,4,5,1,41.86749,-87.63219
SL-005,1,15,true,6,7,1,41.8679,-87.62304
644,1,15,true,1,5,4,41.86859,-87.68625
13285,1,15,true,9,8,-1,41.86928,-87.67372
13160,1,15,true,5,5,0,41.86947,-87.65548
TA1309000010,1,15,true,5,16,11,41.87074,-87.62574
TA1309000064,1,15,true,12,4,-8,41.87127,-87.67369
TA1307000121,1,15,true,7,7,0,41.87184,-87.64664
SL-008,1,15,true,4,10,6,41.87209,-87.62956
13332,1,15,true,7,8,1,41.87219,-87.6615
SL-011,1,15,true,4,11,7,41.87256,-87.63356
KA1504000104,1,15,true,30,2,-28,41.87296,-87.66912
TA1306000025,1,15,true,1,9,8,41.87464,-87.65703
13028,1,15,true,4,5,1,41.87475,-87.64981
SL-010,1,15,true,2,5,3,41.87501,-87.63309
624,1,15,true,5,3,-2,41.87626,-87.62923
TA1305000035,1,15,true,5,5,0,41.87716,-87.62787
13158,1,15,true,6,7,1,41.87764,-87.64957
13157,1,15,true,4,5,1,41.87773,-87.6548
TA1305000025,1,15,true,12,6,-6,41.87773,-87.63528
TA1309000004,1,15,true,22,7,-15,41.87811,-87.63184
638,1,15,true,18,21,3,41.87827,-87.64078
TA1305000005,1,15,true,9,1,-8,41.87924,-87.62975
13011,1,15,true,9,12,3,41.87931,-87.63993
TA1309000008,1,15,true,8,11,3,41.87933,-87.6355
KA1503000015,1,15,true,11,3,-8,41.87948,-87.6257
TA1309000007,1,15,true,25,8,-17,41.88022,-87.63526
13300,1,15,true,7,12,5,41.88097,-87.61675
13008,1,15,true,6,7,1,41.88105,-87.62408
TA1305000006,1,15,true,12,5,-7,41.88122,-87.6296
13056,1,15,true,6,3,-3,41.88168,-87.63951
TA1307000120,1,15,true,12,12,0,41.88188,-87.64879
13341,1,15,true,2,11,9,41.88208,-87.63985
13036,1,15,true,6,3,-3,41.8821,-87.62513
TA1305000032,1,15,true,3,13,10,41.88218,-87.64109
13006,1,15,true,14,7,-7,41.88268,-87.63252
13409,1,15,true,9,6,-3,41.8831,-87.6511
WL-012,1,15,true,8,23,15,41.88337,-87.6412
13053,1,15,true,3,5,2,41.88365,-87.64863
13001,1,15,true,7,6,-1,41.88397,-87.62459
TA1306000010,1,15,true,12,3,-9,41.88419,-87.62961
TA1305000030,1,15,true,6,7,1,41.88459,-87.63178
15535,1,15,true,6,4,-2,41.8846,-87.64455
TA1305000029,1,15,true,7,4,-3,41.88466,-87.62787
13263,1,15,true,9,11,2,41.88467,-87.61952
13021,1,15,true,9,6,-3,41.88559,-87.64184
TA1307000111,1,15,true,14,4,-10,41.88582,-87.63548
KA1503000012,1,15,true,6,10,4,41.88599,-87.63089
TA1305000011,1,15,true,14,8,-6,41.886,-87.62418
15534,1,15,true,5,6,1,41.88627,-87.61749
KA1503000064,1,15,true,3,5,2,41.88697,-87.61281
TA1305000022,1,15,true,11,2,-9,41.88817,-87.63656
TA1306000003,1,15,true,3,8,5,41.88867,-87.64442
KA1503000043,1,15,true,15,6,-9,41.88918,-87.63851
13050,1,15,true,8,3,-5,41.88919,-87.62775
TA1307000151,1,15,true,6,12,6,41.88993,-87.63427
636,1,15,true,6,10,4,41.88997,-87.63662
KA1503000044,1,15,true,9,4,-5,41.89018,-87.6262
13427,1,15,true,3,7,4,41.89054,-87.62205
TA1306000013,1,15,true,3,7,4,41.89083,-87.61852
RN-,1,15,true,5,5,0,41.89102,-87.63546
13434,1,15,true,3,5,2,41.89108,-87.66663
TA1307000117,1,15,true,14,4,-10,41.89144,-87.62675
13033,1,15,true,3,14,11,41.8916,-87.64835
TA1305000003,1,15,true,8,15,7,41.89187,-87.62061
13022,1,15,true,14,10,-4,41.89227,-87.61205
TA1306000029,1,15,true,4,8,4,41.89256,-87.61449
13265,1,15,true,6,6,0,41.89383,-87.64172
13045,1,15,true,12,15,3,41.89403,-87.62931
13016,1,15,true,35,9,-26,41.89431,-87.62277
KA1503000041,1,15,true,10,4,-6,41.89452,-87.61798
TA1307000062,1,15,true,6,6,0,41.89466,-87.63839
TA1306000012,1,15,true,8,5,-3,41.89475,-87.63438
KP1705001026,1,15,true,7,8,1,41.89483,-87.6323
637,1,15,true,7,8,1,41.89563,-87.67209
13132,1,15,true,6,3,-3,41.89573,-87.67718
15530,1,15,true,14,4,-10,41.89575,-87.62596
18003,1,15,true,9,3,-6,41.89575,-87.62011
TA1305000020,1,15,true,6,8,2,41.89636,-87.65406
13289,1,15,true,3,6,3,41.89638,-87.661
13303,1,15,true,2,5,3,41.89672,-87.63088
13017,1,15,true,10,5,-5,41.89676,-87.6357
13338,1,15,true,17,6,-11,41.89697,-87.62173
TA1306000009,1,15,true,15,6,-9,41.89772,-87.64299
15529,1,15,true,3,6,3,41.89858,-87.62206
TA1307000128,1,15,true,9,15,6,41.89896,-87.6299
KA1504000116,1,15,true,2,10,8,41.90023,-87.64299
13042,1,15,true,18,7,-11,41.90097,-87.62377
KA1504000133,1,15,true,6,13,7,41.90234,-87.62773
TA1307000039,1,15,true,13,19,6,41.90294,-87.63137
TA1305000034,1,15,true,3,5,2,41.90313,-87.67391
KA1504000135,1,15,true,13,12,-1,41.90319,-87.63439
13136,1,15,true,3,6,3,41.90326,-87.67845
13061,1,15,true,10,6,-4,41.90342,-87.66779
KA1504000079,1,15,true,7,7,0,41.9035,-87.64334
TA1308000049,1,15,true,9,6,-3,41.90672,-87.6349
KA1504000134,1,15,true,2,13,11,41.90687,-87.6262
13224,1,15,true,5,14,9,41.90706,-87.66725
13221,1,15,true,2,9,7,41.90765,-87.67254
TA1309000024,1,15,true,8,15,7,41.908,-87.63152
TA1305000041,1,15,true,2,8,6,41.9094,-87.67769
331,1,15,true,11,9,-2,41.90965,-87.64812
TA1305000037,1,15,true,5,5,0,41.91018,-87.67003
13154,1,15,true,6,8,2,41.91054,-87.65312
13058,1,15,true,5,4,-1,41.91059,-87.64942
TA1307000038,1,15,true,1,6,5,41.91138,-87.63868
LF-005,1,15,true,5,6,1,41.91172,-87.62681
13128,1,15,true,7,5,-2,41.91197,-87.63197
TA1308000050,1,15,true,11,20,9,41.91211,-87.6347
13243,1,15,true,7,5,-2,41.91262,-87.6814
TA1307000166,1,15,true,6,2,-4,41.91386,-87.64877
18067,1,15,true,6,4,-2,41.9146,-87.66796
13179,1,15,true,8,6,-2,41.9157,-87.63461
13133,1,15,true,8,11,3,41.91598,-87.67733
TA1307000163,1,15,true,8,7,-1,41.91821,-87.65696
13146,1,15,true,7,9,2,41.91831,-87.63629
13059,1,15,true,4,9,5,41.91845,-87.65222
13192,1,15,true,4,6,2,41.91995,-87.64884
13193,1,15,true,6,10,4,41.92182,-87.64412
13191,1,15,true,2,9,7,41.92217,-87.63891
TA1307000001,1,15,true,7,10,3,41.92535,-87.66581
TA1306000026,1,15,true,8,7,-1,41.92558,-87.65842
TA1309000019,1,15,true,2,10,8,41.92586,-87.63897
TA1309000058,1,15,true,6,12,6,41.92591,-87.64927
TA1308000001,1,15,true,9,7,-2,41.92627,-87.63086
13124,1,15,true,7,5,-2,41.92675,-87.63444
TA1309000059,1,15,true,5,3,-2,41.92889,-87.65898
TA1305000014,1,15,true,9,12,3,41.92956,-87.64313
TA1307000142,1,15,true,16,17,1,41.93125,-87.64432
13271,1,15,true,3,5,2,41.93192,-87.67784
TA1306000014,1,15,true,2,8,6,41.93242,-87.65271
TA1309000039,1,15,true,6,6,0,41.93258,-87.63642
13294,1,15,true,4,6,2,41.9326,-87.66595
TA1309000036,1,15,true,9,2,-7,41.93313,-87.64776
TA1307000006,1,15,true,4,5,1,41.93571,-87.6636
13269,1,15,true,2,5,3,41.93609,-87.66983
TA1307000052,1,15,true,14,2,-12,41.93628,-87.65266
TA1307000136,1,15,true,7,7,0,41.9365,-87.64755
TA1307000041,1,15,true,7,6,-1,41.93669,-87.63683
13137,1,15,true,7,11,4,41.9376,-87.6441
TA1308000019,1,15,true,5,2,-3,41.93973,-87.65886
13277,1,15,true,5,5,0,41.9401,-87.64546
TA1307000134,1,15,true,11,5,-6,41.94016,-87.65303
TA1307000138,1,15,true,6,5,-1,41.94334,-87.67094
TA1309000025,1,15,true,6,8,2,41.94368,-87.64894
13071,1,15,true,11,7,-4,41.94373,-87.66401
632,1,15,true,2,10,8,41.94453,-87.6547
13278,1,15,true,8,6,-2,41.94553,-87.64644
13235,1,15,true,6,11,5,41.94814,-87.66396
13253,1,15,true,2,8,6,41.9488,-87.67527
13325,1,15,true,9,6,-3,41.94907,-87.64863
TA1307000150,1,15,true,7,10,3,41.94945,-87.64646
TA1307000127,1,15,true,7,3,-4,41.9508,-87.65918
13323,1,15,true,4,6,2,41.95282,-87.65
TA1309000043,1,15,true,6,7,1,41.95417,-87.66434
13063,1,15,true,10,6,-4,41.95424,-87.65441
13379,1,15,true,3,6,3,41.95786,-87.6495
TA1309000027,1,15,true,4,6,2,41.9585,-87.65499
TA1307000107,1,15,true,6,7,1,41.96164,-87.65464
TA1307000156,1,15,true,6,4,-2,41.96301,-87.68479
TA1308000012,1,15,true,8,9,1,41.96398,-87.63818
13074,1,15,true,9,5,-4,41.96521,-87.6582
TA1309000066,1,15,true,7,10,3,41.9691,-87.67423
KA1504000171,1,15,true,3,5,2,41.97161,-87.65016
TA1309000035,1,15,true,7,10,3,41.97335,-87.66785
13108,1,15,true,4,5,1,41.97379,-87.65971
KA1504000146,1,15,true,5,1,-4,41.978,-87.66805
KA1504000152,1,15,true,7,12,5,41.98403,-87.65231
RP-001,1,15,true,5,3,-2,42.00179,-87.68883
KA1503000002,1,16,false,5,3,-2,41.76641,-87.5657
TA1308000009,1,16,false,6,7,1,41.79522,-87.58075
TA1307000164,1,16,false,5,5,0,41.79527,-87.59647
KA1503000052,1,16,false,2,5,3,41.79935,-87.60097
KA1503000059,1,16,false,8,3,-5,41.79952,-87.58643
TA1309000037,1,16,false,4,6,2,41.79957,-87.59474
KA1503000007,1,16,false,7,2,-5,41.80242,-87.58689
KA1503000004,1,16,false,5,4,-1,41.83127,-87.6088
TA1305000004,1,16,false,1,5,4,41.8514,-87.61884
13075,1,16,false,5,8,3,41.8531,-87.63192
15545,1,16,false,5,6,1,41.85627,-87.61334
13102,1,16,false,5,3,-2,41.85762,-87.61942
SL-012,1,16,false,3,5,2,41.86038,-87.62581
13029,1,16,false,15,7,-8,41.86531,-87.6179
13431,1,16,false,15,3,-12,41.8661,-87.60728
TA1305000002,1,16,false,10,3,-7,41.86721,-87.62597
15544,1,16,false,15,7,-8,41.86723,-87.61536
SL-005,1,16,false,34,14,-20,41.8679,-87.62304
15550,1,16,false,8,3,-5,41.87024,-87.63947
TA1309000010,1,16,false,12,13,1,41.87074,-87.62574
SL-008,1,16,false,6,6,0,41.87209,-87.62956
623,1,16,false,1,11,10,41.87272,-87.62399
KA1504000104,1,16,false,6,1,-5,41.87296,-87.66912
SL-007,1,16,false,1,6,5,41.87404,-87.6277
13028,1,16,false,5,4,-1,41.87475,-87.64981
15541,1,16,false,26,12,-14,41.8758,-87.62086
TA1305000035,1,16,false,4,6,2,41.87716,-87.62787
13158,1,16,false,8,3,-5,41.87764,-87.64957
TA1305000025,1,16,false,20,4,-16,41.87773,-87.63528
TA1309000002,1,16,false,17,11,-6,41.87784,-87.62408
TA1309000004,1,16,false,13,2,-11,41.87811,-87.63184
638,1,16,false,7,2,-5,41.87827,-87.64078
13011,1,16,false,6,12,6,41.87931,-87.63993
TA1309000008,1,16,false,5,8,3,41.87933,-87.6355
KA1503000034,1,16,false,1,10,9,41.87938,-87.63197
KA1503000015,1,16,false,6,7,1,41.87948,-87.6257
TA1309000007,1,16,false,7,5,-2,41.88022,-87.63526
WL-011,1,16,false,7,2,-5,41.88034,-87.64273
13156,1,16,false,7,6,-1,41.88042,-87.65554
13300,1,16,false,37,21,-16,41.88097,-87.61675
13008,1,16,false,41,36,-5,41.88105,-87.62408
TA1305000006,1,16,false,21,9,-12,41.88122,-87.6296
13056,1,16,false,5,1,-4,41.88168,-87.63951
TA1307000120,1,16,false,11,15,4,41.88188,-87.64879
13341,1,16,false,9,16,7,41.88208,-87.63985
13036,1,16,false,8,19,11,41.8821,-87.62513
TA1305000032,1,16,false,14,9,-5,41.88218,-87.64109
13006,1,16,false,11,4,-7,41.88268,-87.63252
13353,1,16,false,1,6,5,41.88283,-87.6612
KA1503000072,1,16,false,14,4,-10,41.88317,-87.63693
WL-012,1,16,false,9,4,-5,41.88337,-87.6412
13053,1,16,false,5,9,4,41.88365,-87.64863
13001,1,16,false,23,16,-7,41.88397,-87.62459
TA1306000010,1,16,false,3,6,3,41.88419,-87.62961
TA1305000030,1,16,false,13,5,-8,41.88459,-87.63178
15535,1,16,false,12,8,-4,41.8846,-87.64455
TA1305000029,1,16,false,7,12,5,41.88466,-87.62787
13263,1,16,false,10,7,-3,41.88467,-87.61952
TA1306000015,1,16,false,11,5,-6,41.88549,-87.65232
13021,1,16,false,5,2,-3,41.88559,-87.64184
TA1307000111,1,16,false,13,6,-7,41.88582,-87.63548
KA1503000012,1,16,false,5,3,-2,41.88599,-87.63089
TA1305000011,1,16,false,30,20,-10,41.886,-87.62418
15534,1,16,false,5,6,1,41.88627,-87.61749
TA1308000029,1,16,false,6,2,-4,41.88673,-87.62225
TA1307000131,1,16,false,8,23,15,41.88688,-87.62606
KA1503000064,1,16,false,18,23,5,41.88697,-87.61281
TA1305000022,1,16,false,12,5,-7,41.88817,-87.63656
TA1306000003,1,16,false,10,6,-4,41.88867,-87.64442
KA1503000043,1,16,false,9,3,-6,41.88918,-87.63851
13050,1,16,false,12,11,-1,41.88919,-87.62775
TA1307000151,1,16,false,5,8,3,41.88993,-87.63427
636,1,16,false,1,5,4,41.88997,-87.63662
KA1503000044,1,16,false,9,2,-7,41.89018,-87.6262
13427,1,16,false,2,17,15,41.89054,-87.62205
13430,1,16,false,10,6,-4,41.89077,-87.63169
TA1306000013,1,16,false,6,16,10,41.89083,-87.61852
RN-,1,16,false,4,8,4,41.89102,-87.63546
TA1307000117,1,16,false,17,19,2,41.89144,-87.62675
13033,1,16,false,8,5,-3,41.8916,-87.64835
TA1305000003,1,16,false,14,18,4,41.89187,-87.62061
13022,1,16,false,119,117,-2,41.89227,-87.61205
TA1306000029,1,16,false,19,11,-8,41.89256,-87.61449
13265,1,16,false,6,4,-2,41.89383,-87.64172
13045,1,16,false,9,5,-4,41.89403,-87.62931
13016,1,16,false,12,10,-2,41.89431,-87.62277
KA1503000041,1,16,false,7,11,4,41.89452,-87.61798
TA1307000062,1,16,false,5,3,-2,41.89466,-87.63839
TA1306000012,1,16,false,8,2,-6,41.89475,-87.63438
KP1705001026,1,16,false,5,7,2,41.89483,-87.6323
15530,1,16,false,6,8,2,41.89575,-87.62596
13247,1,16,false,2,5,3,41.89597,-87.66775
13303,1,16,false,5,5,0,41.89672,-87.63088
13338,1,16,false,2,8,6,41.89697,-87.62173
TA1307000061,1,16,false,7,12,5,41.89745,-87.62873
13034,1,16,false,9,7,-2,41.89754,-87.62352
15529,1,16,false,13,14,1,41.89858,-87.62206
TA1307000128,1,16,false,8,14,6,41.89896,-87.6299
17660,1,16,false,5,2,-3,41.90036,-87.69671
13290,1,16,false,1,6,5,41.90069,-87.66259
13042,1,16,false,16,32,16,41.90097,-87.62377
KA1504000133,1,16,false,9,5,-4,41.90234,-87.62773
TA1307000039,1,16,false,23,17,-6,41.90294,-87.63137
TA1305000034,1,16,false,2,8,6,41.90313,-87.67391
KA1504000135,1,16,false,10,11,1,41.90319,-87.63439
13061,1,16,false,4,7,3,41.90342,-87.66779
KA1504000079,1,16,false,6,4,-2,41.9035,-87.64334
TA1308000049,1,16,false,14,4,-10,41.90672,-87.6349
KA1504000134,1,16,false,9,3,-6,41.90687,-87.6262
13221,1,16,false,3,7,4,41.90765,-87.67254
TA1309000024,1,16,false,6,8,2,41.908,-87.63152
TA1305000041,1,16,false,8,4,-4,41.9094,-87.67769
331,1,16,false,3,7,4,41.90965,-87.64812
13154,1,16,false,1,7,6,41.91054,-87.65312
TA1307000038,1,16,false,5,4,-1,41.91138,-87.63868
LF-005,1,16,false,17,14,-3,41.91172,-87.62681
13128,1,16,false,3,6,3,41.91197,-87.63197
TA1308000050,1,16,false,9,14,5,41.91211,-87.6347
TA1306000032,1,16,false,5,6,1,41.9137,-87.65285
13068,1,16,false,5,4,-1,41.91554,-87.68703
13179,1,16,false,16,14,-2,41.9157,-87.63461
TA1305000039,1,16,false,3,5,2,41.9163,-87.66749
15651,1,16,false,5,3,-2,41.91752,-87.70181
TA1307000163,1,16,false,9,4,-5,41.91821,-87.65696
13146,1,16,false,9,8,-1,41.91831,-87.63629
13059,1,16,false,7,10,3,41.91845,-87.65222
13192,1,16,false,8,11,3,41.91995,-87.64884
13288,1,16,false,6,2,-4,41.92008,-87.67788
13193,1,16,false,9,14,5,41.92182,-87.64412
13191,1,16,false,9,6,-3,41.92217,-87.63891
LP-,1,16,false,9,7,-2,41.92396,-87.63584
TA1307000001,1,16,false,3,5,2,41.92535,-87.66581
TA1306000026,1,16,false,6,2,-4,41.92558,-87.65842
TA1309000019,1,16,false,10,8,-2,41.92586,-87.63897
TA1308000001,1,16,false,19,23,4,41.92627,-87.63086
13124,1,16,false,9,8,-1,41.92675,-87.63444
TA1309000061,1,16,false,7,5,-2,41.92915,-87.64909
TA1308000031,1,16,false,2,8,6,41.92946,-87.68417
TA1305000014,1,16,false,12,2,-10,41.92956,-87.64313
TA1307000142,1,16,false,6,3,-3,41.93125,-87.64432
13276,1,16,false,3,10,7,41.93132,-87.63874
TA1307000064,1,16,false,2,7,5,41.93222,-87.65864
TA1306000014,1,16,false,5,8,3,41.93242,-87.65271
TA1309000039,1,16,false,11,4,-7,41.93258,-87.63642
TA1309000036,1,16,false,5,5,0,41.93313,-87.64776
TA1307000136,1,16,false,6,6,0,41.9365,-87.64755
TA1307000041,1,16,false,12,6,-6,41.93669,-87.63683
13137,1,16,false,9,17,8,41.9376,-87.6441
13277,1,16,false,5,8,3,41.9401,-87.64546
TA1307000134,1,16,false,8,5,-3,41.94016,-87.65303
TA1309000049,1,16,false,7,7,0,41.94077,-87.63919
TA1309000025,1,16,false,9,6,-3,41.94368,-87.64894
13071,1,16,false,8,7,-1,41.94373,-87.66401
632,1,16,false,6,6,0,41.94453,-87.6547
13325,1,16,false,5,12,7,41.94907,-87.64863
TA1307000126,1,16,false,3,13,10,41.94936,-87.65451
TA1307000150,1,16,false,9,5,-4,41.94945,-87.64646
TA1307000127,1,16,false,10,14,4,41.9508,-87.65918
13323,1,16,false,6,3,-3,41.95282,-87.65
TA1308000022,1,16,false,3,7,4,41.95438,-87.64805
13379,1,16,false,6,4,-2,41.95786,-87.6495
TA1307000107,1,16,false,5,4,-1,41.96164,-87.65464
TA1307000156,1,16,false,5,1,-4,41.96301,-87.68479
TA1308000012,1,16,false,8,11,3,41.96398,-87.63818
639,1,16,false,4,5,1,41.96584,-87.64538
KA1504000171,1,16,false,6,2,-4,41.97161,-87.65016
KA1504000160,1,16,false,6,1,-5,41.97564,-87.70143
KA1504000152,1,16,false,4,6,2,41.98403,-87.65231
15575,1,16,false,7,1,-6,41.98975,-87.66014
15571,1,16,false,7,3,-4,41.99478,-87.66028
RP-009,1,16,false,3,6,3,42.00107,-87.66122
KA1504000175,1,16,false,7,2,-5,42.00797,-87.66549
596,1,16,false,6,2,-4,42.04822,-87.68348
KA1503000014,1,16,true,6,4,-2,41.7851,-87.60108
KA1503000070,1,16,true,2,5,3,41.78794,-87.58831
TA1309000011,1,16,true,10,2,-8,41.78873,-87.60131
KA1503000071,1,16,true,9,4,-5,41.79148,-87.59988
KA1503000059,1,16,true,1,6,5,41.79952,-87.58643
TA1309000037,1,16,true,7,7,0,41.79957,-87.59474
TA1308000045,1,16,true,5,2,-3,41.83062,-87.64129
TA1307000129,1,16,true,7,1,-6,41.83104,-87.62683
13216,1,16,true,12,8,-4,41.83473,-87.62581
13217,1,16,true,5,6,1,41.83488,-87.61792
TA1309000055,1,16,true,5,6,1,41.8382,-87.64514
TA1307000048,1,16,true,7,7,0,41.83855,-87.60821
TA1307000153,1,16,true,2,5,3,41.84358,-87.64538
15545,1,16,true,12,17,5,41.85627,-87.61334
13102,1,16,true,10,7,-3,41.85762,-87.61942
13150,1,16,true,9,9,0,41.85783,-87.62455
TA1307000044,1,16,true,6,2,-4,41.85794,-87.64083
13164,1,16,true,9,8,-1,41.85818,-87.65648
SL-012,1,16,true,4,9,5,41.86038,-87.62581
TA1306000002,1,16,true,4,15,11,41.86238,-87.65108
TA1307000124,1,16,true,6,8,2,41.86411,-87.62372
TA1309000001,1,16,true,1,5,4,41.86488,-87.64708
13029,1,16,true,5,2,-3,41.86531,-87.6179
13431,1,16,true,5,2,-3,41.8661,-87.60728
WL-008,1,16,true,4,5,1,41.86712,-87.64108
TA1305000002,1,16,true,12,16,4,41.86721,-87.62597
KA1706005007,1,16,true,2,5,3,41.86749,-87.63219
SL-005,1,16,true,12,20,8,41.8679,-87.62304
13139,1,16,true,5,6,1,41.86893,-87.65913
13285,1,16,true,22,5,-17,41.86928,-87.67372
13160,1,16,true,7,13,6,41.86947,-87.65548
15550,1,16,true,1,5,4,41.87024,-87.63947
TA1309000010,1,16,true,8,7,-1,41.87074,-87.62574
SL-009,1,16,true,7,5,-2,41.87081,-87.63121
TA1309000064,1,16,true,31,7,-24,41.87127,-87.67369
TA1307000130,1,16,true,12,5,-7,41.87178,-87.65103
TA1307000121,1,16,true,7,8,1,41.87184,-87.64664
SL-008,1,16,true,13,18,5,41.87209,-87.62956
13332,1,16,true,13,11,-2,41.87219,-87.6615
SL-011,1,16,true,9,17,8,41.87256,-87.63356
623,1,16,true,5,5,0,41.87272,-87.62399
KA1504000104,1,16,true,32,5,-27,41.87296,-87.66912
TA1306000025,1,16,true,9,6,-3,41.87464,-87.65703
15668,1,16,true,1,6,5,41.87471,-87.68642
13028,1,16,true,9,1,-8,41.87475,-87.64981
SL-010,1,16,true,1,9,8,41.87501,-87.63309
TA1305000009,1,16,true,5,11,6,41.87593,-87.63068
624,1,16,true,2,6,4,41.87626,-87.62923
13138,1,16,true,14,11,-3,41.87723,-87.63941
15539,1,16,true,7,3,-4,41.87763,-87.64405
13158,1,16,true,15,21,6,41.87764,-87.64957
13157,1,16,true,13,7,-6,41.87773,-87.6548
TA1305000025,1,16,true,20,6,-14,41.87773,-87.63528
13206,1,16,true,5,9,4,41.87794,-87.66201
TA1309000004,1,16,true,24,7,-17,41.87811,-87.63184
638,1,16,true,19,16,-3,41.87827,-87.64078
TA1305000005,1,16,true,16,6,-10,41.87924,-87.62975
13011,1,16,true,16,21,5,41.87931,-87.63993
TA1309000008,1,16,true,12,5,-7,41.87933,-87.6355
KA1503000034,1,16,true,10,1,-9,41.87938,-87.63197
KA1503000015,1,16,true,17,7,-10,41.87948,-87.6257
TA1309000007,1,16,true,44,17,-27,41.88022,-87.63526
WL-011,1,16,true,7,5,-2,41.88034,-87.64273
13156,1,16,true,5,10,5,41.88042,-87.65554
13300,1,16,true,10,13,3,41.88097,-87.61675
13008,1,16,true,14,15,1,41.88105,-87.62408
TA1305000006,1,16,true,30,7,-23,41.88122,-87.6296
13056,1,16,true,9,6,-3,41.88168,-87.63951
TA1307000120,1,16,true,9,14,5,41.88188,-87.64879
13341,1,16,true,26,14,-12,41.88208,-87.63985
13036,1,16,true,10,4,-6,41.8821,-87.62513
TA1305000032,1,16,true,28,29,1,41.88218,-87.64109
13006,1,16,true,18,5,-13,41.88268,-87.63252
13353,1,16,true,6,11,5,41.88283,-87.6612
13409,1,16,true,8,5,-3,41.8831,-87.6511
KA1503000072,1,16,true,17,4,-13,41.88317,-87.63693
WL-012,1,16,true,14,40,26,41.88337,-87.6412
13053,1,16,true,4,10,6,41.88365,-87.64863
13001,1,16,true,11,13,2,41.88397,-87.62459
18062,1,16,true,7,6,-1,41.88412,-87.65427
TA1306000010,1,16,true,26,8,-18,41.88419,-87.62961
TA1305000030,1,16,true,30,9,-21,41.88459,-87.63178
TA1305000029,1,16,true,7,11,4,41.88466,-87.62787
13263,1,16,true,15,11,-4,41.88467,-87.61952
TA1306000015,1,16,true,14,11,-3,41.88549,-87.65232
13021,1,16,true,20,18,-2,41.88559,-87.64184
TA1307000111,1,16,true,28,7,-21,41.88582,-87.63548
KA1503000012,1,16,true,10,6,-4,41.88599,-87.63089
TA1305000011,1,16,true,22,8,-14,41.886,-87.62418
15534,1,16,true,5,6,1,41.88627,-87.61749
13197,1,16,true,11,6,-5,41.8866,-87.65816
TA1308000029,1,16,true,4,8,4,41.88673,-87.62225
TA1307000131,1,16,true,17,4,-13,41.88688,-87.62606
TA1305000022,1,16,true,19,6,-13,41.88817,-87.63656
TA1306000003,1,16,true,11,25,14,41.88867,-87.64442
KA1503000043,1,16,true,22,35,13,41.88918,-87.63851
13050,1,16,true,19,10,-9,41.88919,-87.62775
TA1307000151,1,16,true,20,13,-7,41.88993,-87.63427
636,1,16,true,6,4,-2,41.88997,-87.63662
KA1503000044,1,16,true,9,6,-3,41.89018,-87.6262
13427,1,16,true,7,14,7,41.89054,-87.62205
13430,1,16,true,9,5,-4,41.89077,-87.63169
TA1306000013,1,16,true,9,6,-3,41.89083,-87.61852
RN-,1,16,true,11,7,-4,41.89102,-87.63546
TA1308000006,1,16,true,5,5,0,41.89128,-87.67686
TA1307000117,1,16,true,13,10,-3,41.89144,-87.62675
13033,1,16,true,13,16,3,41.8916,-87.64835
13194,1,16,true,8,4,-4,41.8918,-87.65878
TA1305000003,1,16,true,27,9,-18,41.89187,-87.62061
13022,1,16,true,14,9,-5,41.89227,-87.61205
TA1306000029,1,16,true,11,11,0,41.89256,-87.61449
13265,1,16,true,14,13,-1,41.89383,-87.64172
13045,1,16,true,18,16,-2,41.89403,-87.62931
13016,1,16,true,55,6,-49,41.89431,-87.62277
KA1503000041,1,16,true,34,6,-28,41.89452,-87.61798
TA1307000062,1,16,true,13,2,-11,41.89466,-87.63839
TA1306000012,1,16,true,11,16,5,41.89475,-87.63438
KP1705001026,1,16,true,12,5,-7,41.89483,-87.6323
637,1,16,true,2,6,4,41.89563,-87.67209
13132,1,16,true,5,6,1,41.89573,-87.67718
15530,1,16,true,15,6,-9,41.89575,-87.62596
18003,1,16,true,6,1,-5,41.89575,-87.62011
13247,1,16,true,3,9,6,41.89597,-87.66775
TA1305000020,1,16,true,3,7,4,41.89636,-87.65406
13289,1,16,true,6,10,4,41.89638,-87.661
13303,1,16,true,4,12,8,41.89672,-87.63088
13017,1,16,true,8,8,0,41.89676,-87.6357
13338,1,16,true,18,7,-11,41.89697,-87.62173
TA1307000061,1,16,true,7,6,-1,41.89745,-87.62873
13034,1,16,true,13,6,-7,41.89754,-87.62352
TA1306000009,1,16,true,18,5,-13,41.89772,-87.64299
620,1,16,true,6,3,-3,41.89817,-87.63754
KA1504000103,1,16,true,3,10,7,41.89842,-87.68659
15529,1,16,true,21,5,-16,41.89858,-87.62206
TA1307000128,1,16,true,13,14,1,41.89896,-87.6299
657,1,16,true,1,9,8,41.89918,-87.6722
KA1504000116,1,16,true,7,4,-3,41.90023,-87.64299
13042,1,16,true,26,14,-12,41.90097,-87.62377
KA1504000133,1,16,true,9,6,-3,41.90234,-87.62773
TA1307000039,1,16,true,20,27,7,41.90294,-87.63137
TA1305000034,1,16,true,5,7,2,41.90313,-87.67391
KA1504000135,1,16,true,14,24,10,41.90319,-87.63439
13061,1,16,true,15,16,1,41.90342,-87.66779
KA1504000079,1,16,true,6,6,0,41.9035,-87.64334
TA1307000115,1,16,true,5,7,2,41.9046,-87.64056
TA1308000049,1,16,true,2,11,9,41.90672,-87.6349
KA1504000134,1,16,true,5,10,5,41.90687,-87.6262
13224,1,16,true,7,7,0,41.90706,-87.66725
13221,1,16,true,5,9,4,41.90765,-87.67254
TA1309000024,1,16,true,11,17,6,41.908,-87.63152
TA1305000041,1,16,true,8,6,-2,41.9094,-87.67769
331,1,16,true,12,12,0,41.90965,-87.64812
TA1305000037,1,16,true,9,11,2,41.91018,-87.67003
TA1308000005,1,16,true,6,3,-3,41.91042,-87.68238
13154,1,16,true,11,10,-1,41.91054,-87.65312
13058,1,16,true,8,8,0,41.91059,-87.64942
TA1307000038,1,16,true,5,8,3,41.91138,-87.63868
LF-005,1,16,true,5,5,0,41.91172,-87.62681
13128,1,16,true,5,7,2,41.91197,-87.63197
TA1308000050,1,16,true,20,30,10,41.91211,-87.6347
13243,1,16,true,2,7,5,41.91262,-87.6814
TA1306000032,1,16,true,11,6,-5,41.9137,-87.65285
TA1307000166,1,16,true,1,6,5,41.91386,-87.64877
18067,1,16,true,5,2,-3,41.9146,-87.66796
13068,1,16,true,9,2,-7,41.91554,-87.68703
13179,1,16,true,13,14,1,41.9157,-87.63461
13133,1,16,true,9,14,5,41.91598,-87.67733
TA1305000039,1,16,true,1,5,4,41.9163,-87.66749
TA1309000006,1,16,true,5,3,-2,41.91809,-87.64375
TA1307000163,1,16,true,12,13,1,41.91821,-87.65696
13146,1,16,true,11,10,-1,41.91831,-87.63629
13059,1,16,true,8,5,-3,41.91845,-87.65222
13192,1,16,true,5,10,5,41.91995,-87.64884
TA1309000030,1,16,true,7,16,9,41.92077,-87.66372
TA1309000033,1,16,true,3,11,8,41.92158,-87.65381
13193,1,16,true,13,11,-2,41.92182,-87.64412
13191,1,16,true,9,6,-3,41.92217,-87.63891
LP-,1,16,true,3,6,3,41.92396,-87.63584
TA1307000001,1,16,true,11,3,-8,41.92535,-87.66581
TA1306000026,1,16,true,8,5,-3,41.92558,-87.65842
TA1306000016,1,16,true,5,2,-3,41.9256,-87.65371
TA1309000019,1,16,true,12,14,2,41.92586,-87.63897
TA1309000058,1,16,true,14,14,0,41.92591,-87.64927
TA1308000001,1,16,true,7,6,-1,41.92627,-87.63086
13124,1,16,true,2,6,4,41.92675,-87.63444
TA1309000023,1,16,true,3,5,2,41.9287,-87.65383
TA1307000113,1,16,true,5,2,-3,41.92878,-87.66391
13296,1,16,true,3,5,2,41.92883,-87.66852
TA1309000059,1,16,true,5,1,-4,41.92889,-87.65898
TA1309000061,1,16,true,5,10,5,41.92915,-87.64909
TA1305000014,1,16,true,11,13,2,41.92956,-87.64313
TA1307000142,1,16,true,18,14,-4,41.93125,-87.64432
13276,1,16,true,8,9,1,41.93132,-87.63874
13271,1,16,true,3,5,2,41.93192,-87.67784
TA1307000064,1,16,true,6,3,-3,41.93222,-87.65864
TA1306000014,1,16,true,8,12,4,41.93242,-87.65271
TA1309000039,1,16,true,9,17,8,41.93258,-87.63642
13294,1,16,true,2,7,5,41.9326,-87.66595
TA1309000036,1,16,true,2,5,3,41.93313,-87.64776
13269,1,16,true,3,8,5,41.93609,-87.66983
TA1307000052,1,16,true,13,10,-3,41.93628,-87.65266
TA1307000136,1,16,true,6,8,2,41.9365,-87.64755
TA1307000041,1,16,true,7,3,-4,41.93669,-87.63683
13137,1,16,true,18,14,-4,41.9376,-87.6441
TA1309000042,1,16,true,4,8,4,41.93937,-87.66836
13229,1,16,true,4,5,1,41.93946,-87.66376
TA1308000019,1,16,true,4,6,2,41.93973,-87.65886
13277,1,16,true,6,12,6,41.9401,-87.64546
TA1307000134,1,16,true,9,13,4,41.94016,-87.65303
TA1309000049,1,16,true,5,6,1,41.94077,-87.63919
TA1307000138,1,16,true,7,7,0,41.94334,-87.67094
TA1309000025,1,16,true,9,14,5,41.94368,-87.64894
13071,1,16,true,9,9,0,41.94373,-87.66401
632,1,16,true,8,12,4,41.94453,-87.6547
13278,1,16,true,8,7,-1,41.94553,-87.64644
13235,1,16,true,13,10,-3,41.94814,-87.66396
13253,1,16,true,6,4,-2,41.9488,-87.67527
13325,1,16,true,13,10,-3,41.94907,-87.64863
TA1307000126,1,16,true,3,14,11,41.94936,-87.65451
TA1307000150,1,16,true,9,14,5,41.94945,-87.64646
13319,1,16,true,3,6,3,41.95069,-87.6687
TA1307000127,1,16,true,7,9,2,41.9508,-87.65918
13063,1,16,true,7,6,-1,41.95424,-87.65441
TA1308000022,1,16,true,4,7,3,41.95438,-87.64805
TA1309000026,1,16,true,2,6,4,41.95601,-87.6802
13379,1,16,true,7,10,3,41.95786,-87.6495
TA1309000027,1,16,true,8,3,-5,41.9585,-87.65499
13389,1,16,true,5,4,-1,41.961,-87.64958
TA1307000107,1,16,true,12,9,-3,41.96164,-87.65464
TA1307000156,1,16,true,5,5,0,41.96301,-87.68479
TA1308000012,1,16,true,8,11,3,41.96398,-87.63818
13074,1,16,true,4,7,3,41.96521,-87.6582
TA1309000014,1,16,true,5,4,-1,41.96709,-87.66744
TA1307000158,1,16,true,9,4,-5,41.9671,-87.67904
KA1504000080,1,16,true,2,5,3,41.96887,-87.69609
TA1309000066,1,16,true,12,7,-5,41.9691,-87.67423
TA1309000041,1,16,true,6,3,-3,41.96951,-87.65471
KA1504000171,1,16,true,7,4,-3,41.97161,-87.65016
TA1309000035,1,16,true,4,6,2,41.97335,-87.66785
13108,1,16,true,6,10,4,41.97379,-87.65971
13109,1,16,true,7,1,-6,41.97835,-87.65976
KA1504000151,1,16,true,6,3,-3,41.98359,-87.66916
KA1504000152,1,16,true,10,12,2,41.98403,-87.65231
15575,1,16,true,7,4,-3,41.98975,-87.66014
596,1,16,true,2,6,4,42.04822,-87.68348
20121,1,17,false,5,2,-3,41.74152,-87.65842
KA1503000014,1,17,false,5,4,-1,41.7851,-87.60108
TA1309000063,1,17,false,6,4,-2,41.79325,-87.5878
TA1308000009,1,17,false,6,16,10,41.79522,-87.58075
TA1307000164,1,17,false,6,2,-4,41.79527,-87.59647
KA1503000052,1,17,false,7,1,-6,41.79935,-87.60097
KA1503000059,1,17,false,6,7,1,41.79952,-87.58643
TA1309000037,1,17,false,2,6,4,41.79957,-87.59474
KA1503000007,1,17,false,8,3,-5,41.80242,-87.58689
TA1308000026,1,17,false,6,2,-4,41.85008,-87.63214
13075,1,17,false,5,7,2,41.8531,-87.63192
15545,1,17,false,6,10,4,41.85627,-87.61334
13102,1,17,false,3,8,5,41.85762,-87.61942
13150,1,17,false,5,5,0,41.85783,-87.62455
SL-012,1,17,false,5,2,-3,41.86038,-87.62581
TA1307000124,1,17,false,7,7,0,41.86411,-87.62372
TA1309000001,1,17,false,6,6,0,41.86488,-87.64708
13029,1,17,false,6,1,-5,41.86531,-87.6179
13431,1,17,false,17,3,-14,41.8661,-87.60728
WL-008,1,17,false,8,4,-4,41.86712,-87.64108
TA1305000002,1,17,false,14,15,1,41.86721,-87.62597
15544,1,17,false,20,11,-9,41.86723,-87.61536
SL-005,1,17,false,36,29,-7,41.8679,-87.62304
13160,1,17,false,10,4,-6,41.86947,-87.65548
TA1309000010,1,17,false,13,6,-7,41.87074,-87.62574
TA1309000064,1,17,false,6,2,-4,41.87127,-87.67369
SL-008,1,17,false,10,17,7,41.87209,-87.62956
13332,1,17,false,5,1,-4,41.87219,-87.6615
SL-011,1,17,false,8,5,-3,41.87256,-87.63356
623,1,17,false,25,10,-15,41.87272,-87.62399
KA1504000104,1,17,false,6,1,-5,41.87296,-87.66912
SL-007,1,17,false,6,5,-1,41.87404,-87.6277
SL-010,1,17,false,8,4,-4,41.87501,-87.63309
15541,1,17,false,37,15,-22,41.8758,-87.62086
TA1305000009,1,17,false,2,7,5,41.87593,-87.63068
TA1305000010,1,17,false,12,3,-9,41.87623,-87.62444
624,1,17,false,5,1,-4,41.87626,-87.62923
TA1305000035,1,17,false,10,6,-4,41.87716,-87.62787
13138,1,17,false,3,8,5,41.87723,-87.63941
15539,1,17,false,7,2,-5,41.87763,-87.64405
13158,1,17,false,12,5,-7,41.87764,-87.64957
13157,1,17,false,5,5,0,41.87773,-87.6548
TA1305000025,1,17,false,19,2,-17,41.87773,-87.63528
TA1309000002,1,17,false,12,9,-3,41.87784,-87.62408
TA1309000004,1,17,false,9,2,-7,41.87811,-87.63184
TA1305000005,1,17,false,7,10,3,41.87924,-87.62975
13011,1,17,false,15,14,-1,41.87931,-87.63993
TA1309000008,1,17,false,10,13,3,41.87933,-87.6355
KA1503000015,1,17,false,9,1,-8,41.87948,-87.6257
TA1309000007,1,17,false,17,6,-11,41.88022,-87.63526
WL-011,1,17,false,5,4,-1,41.88034,-87.64273
13156,1,17,false,3,5,2,41.88042,-87.65554
13300,1,17,false,54,43,-11,41.88097,-87.61675
13008,1,17,false,56,57,1,41.88105,-87.62408
TA1305000006,1,17,false,14,3,-11,41.88122,-87.6296
13056,1,17,false,5,4,-1,41.88168,-87.63951
TA1307000120,1,17,false,16,12,-4,41.88188,-87.64879
13341,1,17,false,14,6,-8,41.88208,-87.63985
13036,1,17,false,17,11,-6,41.8821,-87.62513
TA1305000032,1,17,false,25,9,-16,41.88218,-87.64109
13006,1,17,false,5,9,4,41.88268,-87.63252
13409,1,17,false,6,4,-2,41.8831,-87.6511
KA1503000072,1,17,false,13,4,-9,41.88317,-87.63693
WL-012,1,17,false,9,5,-4,41.88337,-87.6412
13053,1,17,false,9,13,4,41.88365,-87.64863
13001,1,17,false,14,15,1,41.88397,-87.62459
18062,1,17,false,9,4,-5,41.88412,-87.65427
TA1306000010,1,17,false,24,13,-11,41.88419,-87.62961
TA1305000030,1,17,false,17,6,-11,41.88459,-87.63178
15535,1,17,false,3,7,4,41.8846,-87.64455
TA1305000029,1,17,false,10,14,4,41.88466,-87.62787
13263,1,17,false,15,15,0,41.88467,-87.61952
TA1306000015,1,17,false,18,14,-4,41.88549,-87.65232
13021,1,17,false,11,8,-3,41.88559,-87.64184
TA1307000111,1,17,false,17,5,-12,41.88582,-87.63548
KA1503000012,1,17,false,12,12,0,41.88599,-87.63089
TA1305000011,1,17,false,22,31,9,41.886,-87.62418
15534,1,17,false,11,4,-7,41.88627,-87.61749
TA1308000029,1,17,false,8,6,-2,41.88673,-87.62225
TA1307000131,1,17,false,15,10,-5,41.88688,-87.62606
KA1503000064,1,17,false,24,25,1,41.88697,-87.61281
TA1305000022,1,17,false,21,8,-13,41.88817,-87.63656
TA1306000003,1,17,false,12,11,-1,41.88867,-87.64442
KA1503000043,1,17,false,13,25,12,41.88918,-87.63851
13050,1,17,false,9,19,10,41.88919,-87.62775
TA1307000151,1,17,false,19,15,-4,41.88993,-87.63427
636,1,17,false,5,5,0,41.88997,-87.63662
KA1503000044,1,17,false,3,5,2,41.89018,-87.6262
13427,1,17,false,19,6,-13,41.89054,-87.62205
13430,1,17,false,18,15,-3,41.89077,-87.63169
TA1306000013,1,17,false,31,34,3,41.89083,-87.61852
RN-,1,17,false,3,9,6,41.89102,-87.63546
TA1307000117,1,17,false,26,27,1,41.89144,-87.62675
13033,1,17,false,8,8,0,41.8916,-87.64835
13194,1,17,false,5,5,0,41.8918,-87.65878
TA1305000003,1,17,false,27,12,-15,41.89187,-87.62061
13022,1,17,false,78,104,26,41.89227,-87.61205
TA1306000029,1,17,false,8,17,9,41.89256,-87.61449
13265,1,17,false,15,13,-2,41.89383,-87.64172
13045,1,17,false,16,20,4,41.89403,-87.62931
13016,1,17,false,11,10,-1,41.89431,-87.62277
KA1503000041,1,17,false,8,12,4,41.89452,-87.61798
13196,1,17,false,5,5,0,41.89455,-87.65345
TA1307000062,1,17,false,10,6,-4,41.89466,-87.63839
TA1306000012,1,17,false,17,15,-2,41.89475,-87.63438
KP1705001026,1,17,false,10,11,1,41.89483,-87.6323
637,1,17,false,3,6,3,41.89563,-87.67209
13132,1,17,false,9,4,-5,41.89573,-87.67718
15530,1,17,false,13,8,-5,41.89575,-87.62596
18003,1,17,false,1,9,8,41.89575,-87.62011
13247,1,17,false,4,5,1,41.89597,-87.66775
TA1305000020,1,17,false,6,5,-1,41.89636,-87.65406
13289,1,17,false,7,5,-2,41.89638,-87.661
13303,1,17,false,12,5,-7,41.89672,-87.63088
13017,1,17,false,6,8,2,41.89676,-87.6357
13338,1,17,false,3,5,2,41.89697,-87.62173
13034,1,17,false,13,7,-6,41.89754,-87.62352
TA1306000009,1,17,false,13,6,-7,41.89772,-87.64299
KA1504000103,1,17,false,5,2,-3,41.89842,-87.68659
15529,1,17,false,5,10,5,41.89858,-87.62206
TA1307000128,1,17,false,17,13,-4,41.89896,-87.6299
13248,1,17,false,5,6,1,41.89964,-87.66788
TA1306000011,1,17,false,6,6,0,41.89994,-87.63443
13042,1,17,false,31,28,-3,41.90097,-87.62377
TA1307000070,1,17,false,7,1,-6,41.90133,-87.67742
KA1504000133,1,17,false,11,11,0,41.90234,-87.62773
TA1307000039,1,17,false,19,22,3,41.90294,-87.63137
TA1305000034,1,17,false,11,4,-7,41.90313,-87.67391
KA1504000135,1,17,false,23,18,-5,41.90319,-87.63439
13136,1,17,false,6,8,2,41.90326,-87.67845
13061,1,17,false,21,21,0,41.90342,-87.66779
KA1504000079,1,17,false,11,11,0,41.9035,-87.64334
TA1307000115,1,17,false,5,5,0,41.9046,-87.64056
TA1308000049,1,17,false,9,18,9,41.90672,-87.6349
KA1504000134,1,17,false,7,10,3,41.90687,-87.6262
13224,1,17,false,12,5,-7,41.90706,-87.66725
TA1307000143,1,17,false,3,6,3,41.90762,-87.63854
13221,1,17,false,16,10,-6,41.90765,-87.67254
13245,1,17,false,5,2,-3,41.90777,-87.68586
TA1309000024,1,17,false,8,9,1,41.908,-87.63152
TA1305000041,1,17,false,12,12,0,41.9094,-87.67769
331,1,17,false,12,19,7,41.90965,-87.64812
TA1305000037,1,17,false,4,6,2,41.91018,-87.67003
TA1306000008,1,17,false,5,5,0,41.9102,-87.6435
13154,1,17,false,9,10,1,41.91054,-87.65312
13058,1,17,false,9,15,6,41.91059,-87.64942
LF-005,1,17,false,28,55,27,41.91172,-87.62681
13128,1,17,false,2,8,6,41.91197,-87.63197
TA1308000050,1,17,false,35,32,-3,41.91211,-87.6347
13243,1,17,false,4,5,1,41.91262,-87.6814
TA1306000032,1,17,false,5,9,4,41.9137,-87.65285
TA1307000166,1,17,false,4,5,1,41.91386,-87.64877
18017,1,17,false,5,1,-4,41.91416,-87.71676
18067,1,17,false,3,5,2,41.9146,-87.66796
13068,1,17,false,8,5,-3,41.91554,-87.68703
13179,1,17,false,21,32,11,41.9157,-87.63461
13133,1,17,false,3,8,5,41.91598,-87.67733
TA1305000039,1,17,false,19,8,-11,41.9163,-87.66749
13266,1,17,false,7,4,-3,41.91774,-87.69142
TA1309000029,1,17,false,7,1,-6,41.9178,-87.68245
TA1307000163,1,17,false,8,10,2,41.91821,-87.65696
13146,1,17,false,18,10,-8,41.91831,-87.63629
13059,1,17,false,11,8,-3,41.91845,-87.65222
13192,1,17,false,9,10,1,41.91995,-87.64884
TA1309000033,1,17,false,4,7,3,41.92158,-87.65381
13193,1,17,false,14,22,8,41.92182,-87.64412
13191,1,17,false,7,6,-1,41.92217,-87.63891
13084,1,17,false,4,5,1,41.92268,-87.69715
LP-,1,17,false,7,12,5,41.92396,-87.63584
TA1307000001,1,17,false,6,3,-3,41.92535,-87.66581
TA1306000026,1,17,false,7,2,-5,41.92558,-87.65842
TA1306000016,1,17,false,9,5,-4,41.9256,-87.65371
TA1309000019,1,17,false,17,16,-1,41.92586,-87.63897
TA1309000058,1,17,false,17,17,0,41.92591,-87.64927
TA1308000001,1,17,false,26,20,-6,41.92627,-87.63086
13124,1,17,false,8,12,4,41.92675,-87.63444
TA1309000023,1,17,false,11,9,-2,41.9287,-87.65383
TA1307000113,1,17,false,4,6,2,41.92878,-87.66391
13296,1,17,false,6,5,-1,41.92883,-87.66852
TA1309000061,1,17,false,12,8,-4,41.92915,-87.64909
TA1305000014,1,17,false,8,21,13,41.92956,-87.64313
13085,1,17,false,4,5,1,41.92958,-87.70789
TA1307000142,1,17,false,13,11,-2,41.93125,-87.64432
13276,1,17,false,16,13,-3,41.93132,-87.63874
13271,1,17,false,5,2,-3,41.93192,-87.67784
TA1307000064,1,17,false,12,7,-5,41.93222,-87.65864
TA1306000014,1,17,false,5,11,6,41.93242,-87.65271
TA1309000039,1,17,false,20,11,-9,41.93258,-87.63642
TA1309000036,1,17,false,5,14,9,41.93313,-87.64776
TA1307000006,1,17,false,5,4,-1,41.93571,-87.6636
13269,1,17,false,5,4,-1,41.93609,-87.66983
TA1307000052,1,17,false,10,3,-7,41.93628,-87.65266
TA1307000136,1,17,false,7,13,6,41.9365,-87.64755
TA1307000041,1,17,false,8,9,1,41.93669,-87.63683
13137,1,17,false,17,14,-3,41.9376,-87.6441
TA1309000042,1,17,false,4,6,2,41.93937,-87.66836
13229,1,17,false,10,4,-6,41.93946,-87.66376
TA1308000019,1,17,false,9,6,-3,41.93973,-87.65886
13277,1,17,false,9,6,-3,41.9401,-87.64546
TA1307000134,1,17,false,14,11,-3,41.94016,-87.65303
13143,1,17,false,5,3,-2,41.94059,-87.67853
TA1309000049,1,17,false,14,11,-3,41.94077,-87.63919
TA1307000138,1,17,false,8,8,0,41.94334,-87.67094
TA1309000025,1,17,false,6,13,7,41.94368,-87.64894
13071,1,17,false,15,12,-3,41.94373,-87.66401
632,1,17,false,9,11,2,41.94453,-87.6547
13278,1,17,false,9,14,5,41.94553,-87.64644
13235,1,17,false,4,12,8,41.94814,-87.66396
13253,1,17,false,5,7,2,41.9488,-87.67527
13325,1,17,false,10,5,-5,41.94907,-87.64863
TA1307000126,1,17,false,9,38,29,41.94936,-87.65451
TA1307000150,1,17,false,9,13,4,41.94945,-87.64646
TA1307000127,1,17,false,6,8,2,41.9508,-87.65918
13323,1,17,false,6,7,1,41.95282,-87.65
TA1309000043,1,17,false,8,3,-5,41.95417,-87.66434
13063,1,17,false,2,10,8,41.95424,-87.65441
TA1308000022,1,17,false,8,8,0,41.95438,-87.64805
13379,1,17,false,8,5,-3,41.95786,-87.6495
TA1309000027,1,17,false,7,4,-3,41.9585,-87.65499
13389,1,17,false,7,7,0,41.961,-87.64958
TA1307000107,1,17,false,12,9,-3,41.96164,-87.65464
TA1308000012,1,17,false,10,16,6,41.96398,-87.63818
13074,1,17,false,9,4,-5,41.96521,-87.6582
639,1,17,false,7,7,0,41.96584,-87.64538
TA1309000014,1,17,false,5,5,0,41.96709,-87.66744
TA1307000158,1,17,false,7,1,-6,41.9671,-87.67904
TA1307000119,1,17,false,7,2,-5,41.96796,-87.65
TA1308000021,1,17,false,7,2,-5,41.96883,-87.65765
TA1309000066,1,17,false,11,7,-4,41.9691,-87.67423
KA1504000171,1,17,false,6,4,-2,41.97161,-87.65016
TA1309000035,1,17,false,5,7,2,41.97335,-87.66785
13108,1,17,false,7,2,-5,41.97379,-87.65971
KA1504000146,1,17,false,5,6,1,41.978,-87.66805
13109,1,17,false,6,2,-4,41.97835,-87.65976
KA1504000152,1,17,false,13,12,-1,41.98403,-87.65231
15578,1,17,false,4,6,2,41.98405,-87.66027
15575,1,17,false,4,8,4,41.98975,-87.66014
15571,1,17,false,4,7,3,41.99478,-87.66028
RP-009,1,17,false,7,1,-6,42.00107,-87.66122
660,1,17,false,5,2,-3,42.00458,-87.66143
596,1,17,false,1,7,6,42.04822,-87.68348
604,1,17,false,12,3,-9,42.05824,-87.67744
KA1503000014,1,17,true,5,4,-1,41.7851,-87.60108
KA1503000071,1,17,true,9,2,-7,41.79148,-87.59988
KA1504000076,1,17,true,6,5,-1,41.7943,-87.60145
TA1308000009,1,17,true,9,12,3,41.79522,-87.58075
TA1307000164,1,17,true,6,4,-2,41.79527,-87.59647
KA1503000059,1,17,true,2,5,3,41.79952,-87.58643
TA1309000037,1,17,true,7,9,2,41.79957,-87.59474
KA1503000007,1,17,true,3,7,4,41.80242,-87.58689
TA1307000129,1,17,true,5,1,-4,41.83104,-87.62683
13216,1,17,true,13,6,-7,41.83473,-87.62581
13217,1,17,true,5,9,4,41.83488,-87.61792
13215,1,17,true,2,5,3,41.83634,-87.6135
TA1308000046,1,17,true,1,9,8,41.83779,-87.65115
TA1309000055,1,17,true,5,5,0,41.8382,-87.64514
TA1308000036,1,17,true,3,5,2,41.83883,-87.62186
TA1307000139,1,17,true,14,8,-6,41.84205,-87.61698
TA1305000001,1,17,true,2,6,4,41.85262,-87.6265
13075,1,17,true,9,8,-1,41.8531,-87.63192
15545,1,17,true,11,9,-2,41.85627,-87.61334
SL-006,1,17,true,7,2,-5,41.8568,-87.63387
13135,1,17,true,2,8,6,41.85753,-87.66157
13102,1,17,true,7,13,6,41.85762,-87.61942
13150,1,17,true,3,16,13,41.85783,-87.62455
TA1307000159,1,17,true,2,5,3,41.8579,-87.6687
TA1307000044,1,17,true,1,9,8,41.85794,-87.64083
13164,1,17,true,4,11,7,41.85818,-87.65648
SL-012,1,17,true,10,14,4,41.86038,-87.62581
13304,1,17,true,3,8,5,41.86126,-87.65659
TA1307000124,1,17,true,11,16,5,41.86411,-87.62372
TA1309000001,1,17,true,10,6,-4,41.86488,-87.64708
WL-008,1,17,true,5,14,9,41.86712,-87.64108
TA1305000002,1,17,true,25,44,19,41.86721,-87.62597
TA1305000017,1,17,true,6,2,-4,41.86734,-87.64863
KA1706005007,1,17,true,4,7,3,41.86749,-87.63219
SL-005,1,17,true,22,22,0,41.8679,-87.62304
644,1,17,true,6,4,-2,41.86859,-87.68625
13139,1,17,true,10,7,-3,41.86893,-87.65913
13160,1,17,true,10,10,0,41.86947,-87.65548
15550,1,17,true,6,8,2,41.87024,-87.63947
TA1309000010,1,17,true,13,20,7,41.87074,-87.62574
SL-009,1,17,true,8,11,3,41.87081,-87.63121
TA1309000064,1,17,true,26,3,-23,41.87127,-87.67369
TA1307000130,1,17,true,12,10,-2,41.87178,-87.65103
TA1307000121,1,17,true,8,15,7,41.87184,-87.64664
SL-008,1,17,true,21,32,11,41.87209,-87.62956
13332,1,17,true,20,22,2,41.87219,-87.6615
SL-011,1,17,true,6,18,12,41.87256,-87.63356
623,1,17,true,10,9,-1,41.87272,-87.62399
KA1504000104,1,17,true,12,3,-9,41.87296,-87.66912
SL-007,1,17,true,8,9,1,41.87404,-87.6277
TA1306000025,1,17,true,8,9,1,41.87464,-87.65703
13028,1,17,true,8,4,-4,41.87475,-87.64981
13081,1,17,true,13,1,-12,41.87501,-87.67326
SL-010,1,17,true,11,11,0,41.87501,-87.63309
13037,1,17,true,6,2,-4,41.87588,-87.64078
TA1305000009,1,17,true,9,12,3,41.87593,-87.63068
TA1305000010,1,17,true,6,1,-5,41.87623,-87.62444
624,1,17,true,8,5,-3,41.87626,-87.62923
TA1305000035,1,17,true,22,5,-17,41.87716,-87.62787
13138,1,17,true,19,11,-8,41.87723,-87.63941
15539,1,17,true,15,14,-1,41.87763,-87.64405
13158,1,17,true,10,34,24,41.87764,-87.64957
13157,1,17,true,10,17,7,41.87773,-87.6548
TA1305000025,1,17,true,31,7,-24,41.87773,-87.63528
TA1309000002,1,17,true,13,4,-9,41.87784,-87.62408
13206,1,17,true,7,5,-2,41.87794,-87.66201
TA1309000004,1,17,true,34,4,-30,41.87811,-87.63184
638,1,17,true,29,21,-8,41.87827,-87.64078
TA1305000005,1,17,true,24,8,-16,41.87924,-87.62975
13011,1,17,true,21,16,-5,41.87931,-87.63993
TA1309000008,1,17,true,22,3,-19,41.87933,-87.6355
KA1503000015,1,17,true,15,7,-8,41.87948,-87.6257
15667,1,17,true,5,1,-4,41.8798,-87.68609
TA1309000007,1,17,true,36,3,-33,41.88022,-87.63526
WL-011,1,17,true,15,14,-1,41.88034,-87.64273
13156,1,17,true,8,13,5,41.88042,-87.65554
13300,1,17,true,12,27,15,41.88097,-87.61675
13008,1,17,true,17,12,-5,41.88105,-87.62408
TA1305000006,1,17,true,48,10,-38,41.88122,-87.6296
13056,1,17,true,16,11,-5,41.88168,-87.63951
TA1307000120,1,17,true,30,29,-1,41.88188,-87.64879
13341,1,17,true,36,21,-15,41.88208,-87.63985
13036,1,17,true,8,8,0,41.8821,-87.62513
TA1305000032,1,17,true,46,33,-13,41.88218,-87.64109
13006,1,17,true,13,6,-7,41.88268,-87.63252
13353,1,17,true,5,17,12,41.88283,-87.6612
654,1,17,true,6,6,0,41.88307,-87.65698
13409,1,17,true,9,8,-1,41.8831,-87.6511
KA1503000072,1,17,true,12,5,-7,41.88317,-87.63693
WL-012,1,17,true,40,29,-11,41.88337,-87.6412
13053,1,17,true,20,17,-3,41.88365,-87.64863
13001,1,17,true,33,15,-18,41.88397,-87.62459
13155,1,17,true,10,3,-7,41.88407,-87.65689
18062,1,17,true,16,14,-2,41.88412,-87.65427
TA1306000010,1,17,true,31,17,-14,41.88419,-87.62961
TA1305000030,1,17,true,44,5,-39,41.88459,-87.63178
15535,1,17,true,25,14,-11,41.8846,-87.64455
TA1305000029,1,17,true,19,12,-7,41.88466,-87.62787
13263,1,17,true,27,34,7,41.88467,-87.61952
TA1306000015,1,17,true,15,17,2,41.88549,-87.65232
13021,1,17,true,31,19,-12,41.88559,-87.64184
TA1307000111,1,17,true,39,8,-31,41.88582,-87.63548
KA1503000012,1,17,true,29,7,-22,41.88599,-87.63089
TA1305000011,1,17,true,28,9,-19,41.886,-87.62418
15534,1,17,true,14,24,10,41.88627,-87.61749
13197,1,17,true,8,3,-5,41.8866,-87.65816
TA1308000029,1,17,true,11,10,-1,41.88673,-87.62225
TA1307000131,1,17,true,17,10,-7,41.88688,-87.62606
KA1503000064,1,17,true,12,13,1,41.88697,-87.61281
TA1305000022,1,17,true,38,16,-22,41.88817,-87.63656
TA1306000003,1,17,true,36,35,-1,41.88867,-87.64442
KA1503000043,1,17,true,48,47,-1,41.88918,-87.63851
13050,1,17,true,34,12,-22,41.88919,-87.62775
13432,1,17,true,5,1,-4,41.88989,-87.67149
TA1307000151,1,17,true,40,31,-9,41.88993,-87.63427
636,1,17,true,19,19,0,41.88997,-87.63662
KA1503000044,1,17,true,20,11,-9,41.89018,-87.6262
13427,1,17,true,22,13,-9,41.89054,-87.62205
13430,1,17,true,26,5,-21,41.89077,-87.63169
TA1306000013,1,17,true,21,25,4,41.89083,-87.61852
RN-,1,17,true,20,18,-2,41.89102,-87.63546
13434,1,17,true,4,9,5,41.89108,-87.66663
TA1307000117,1,17,true,31,36,5,41.89144,-87.62675
13033,1,17,true,18,14,-4,41.8916,-87.64835
13194,1,17,true,11,10,-1,41.8918,-87.65878
TA1305000003,1,17,true,19,16,-3,41.89187,-87.62061
13022,1,17,true,20,29,9,41.89227,-87.61205
TA1306000029,1,17,true,20,19,-1,41.89256,-87.61449
13265,1,17,true,33,32,-1,41.89383,-87.64172
13045,1,17,true,28,33,5,41.89403,-87.62931
13016,1,17,true,58,15,-43,41.89431,-87.62277
KA1503000041,1,17,true,28,14,-14,41.89452,-87.61798
13196,1,17,true,16,15,-1,41.89455,-87.65345
TA1307000062,1,17,true,23,5,-18,41.89466,-87.63839
TA1306000012,1,17,true,37,32,-5,41.89475,-87.63438
KP1705001026,1,17,true,17,16,-1,41.89483,-87.6323
18058,1,17,true,7,7,0,41.8955,-87.68201
637,1,17,true,7,14,7,41.89563,-87.67209
13132,1,17,true,9,13,4,41.89573,-87.67718
15530,1,17,true,20,20,0,41.89575,-87.62596
18003,1,17,true,14,6,-8,41.89575,-87.62011
13247,1,17,true,10,17,7,41.89597,-87.66775
TA1305000020,1,17,true,3,12,9,41.89636,-87.65406
13289,1,17,true,10,16,6,41.89638,-87.661
13303,1,17,true,9,14,5,41.89672,-87.63088
13017,1,17,true,26,22,-4,41.89676,-87.6357
13338,1,17,true,13,9,-4,41.89697,-87.62173
TA1307000061,1,17,true,11,11,0,41.89745,-87.62873
13034,1,17,true,17,6,-11,41.89754,-87.62352
TA1306000009,1,17,true,40,10,-30,41.89772,-87.64299
620,1,17,true,17,21,4,41.89817,-87.63754
KA1504000103,1,17,true,5,6,1,41.89842,-87.68659
15529,1,17,true,32,13,-19,41.89858,-87.62206
TA1307000128,1,17,true,23,30,7,41.89896,-87.6299
657,1,17,true,4,6,2,41.89918,-87.6722
13248,1,17,true,4,22,18,41.89964,-87.66788
TA1306000011,1,17,true,12,12,0,41.89994,-87.63443
KA1504000116,1,17,true,10,11,1,41.90023,-87.64299
13290,1,17,true,16,11,-5,41.90069,-87.66259
13042,1,17,true,27,19,-8,41.90097,-87.62377
TA1307000070,1,17,true,5,16,11,41.90133,-87.67742
KA1504000133,1,17,true,10,16,6,41.90234,-87.62773
13241,1,17,true,7,6,-1,41.9029,-87.68731
TA1306000006,1,17,true,5,8,3,41.90292,-87.63772
TA1307000039,1,17,true,22,49,27,41.90294,-87.63137
658,1,17,true,10,3,-7,41.903,-87.6838
13256,1,17,true,5,2,-3,41.90302,-87.69749
TA1305000034,1,17,true,13,13,0,41.90313,-87.67391
KA1504000135,1,17,true,40,50,10,41.90319,-87.63439
13136,1,17,true,10,13,3,41.90326,-87.67845
13061,1,17,true,26,28,2,41.90342,-87.66779
KA1504000079,1,17,true,13,20,7,41.9035,-87.64334
TA1307000115,1,17,true,9,15,6,41.9046,-87.64056
TA1308000049,1,17,true,16,15,-1,41.90672,-87.6349
KA1504000134,1,17,true,7,11,4,41.90687,-87.6262
13224,1,17,true,11,6,-5,41.90706,-87.66725
TA1307000143,1,17,true,2,10,8,41.90762,-87.63854
13221,1,17,true,21,15,-6,41.90765,-87.67254
TA1309000024,1,17,true,14,20,6,41.908,-87.63152
TA1305000041,1,17,true,19,11,-8,41.9094,-87.67769
331,1,17,true,19,26,7,41.90965,-87.64812
TA1305000037,1,17,true,7,8,1,41.91018,-87.67003
TA1306000008,1,17,true,12,9,-3,41.9102,-87.6435
TA1308000005,1,17,true,4,8,4,41.91042,-87.68238
13257,1,17,true,4,5,1,41.91054,-87.68956
13154,1,17,true,20,23,3,41.91054,-87.65312
13058,1,17,true,12,14,2,41.91059,-87.64942
TA1307000038,1,17,true,20,9,-11,41.91138,-87.63868
LF-005,1,17,true,26,31,5,41.91172,-87.62681
13128,1,17,true,3,15,12,41.91197,-87.63197
TA1308000050,1,17,true,43,43,0,41.91211,-87.6347
13243,1,17,true,7,13,6,41.91262,-87.6814
TA1306000032,1,17,true,8,15,7,41.9137,-87.65285
TA1307000166,1,17,true,6,14,8,41.91386,-87.64877
15655,1,17,true,10,4,-6,41.91401,-87.70514
18067,1,17,true,7,11,4,41.9146,-87.66796
TA1306000007,1,17,true,3,7,4,41.91469,-87.64333
13068,1,17,true,7,11,4,41.91554,-87.68703
13179,1,17,true,16,29,13,41.9157,-87.63461
13133,1,17,true,3,14,11,41.91598,-87.67733
TA1305000039,1,17,true,5,4,-1,41.9163,-87.66749
15651,1,17,true,5,3,-2,41.91752,-87.70181
13266,1,17,true,6,8,2,41.91774,-87.69142
TA1309000029,1,17,true,4,5,1,41.9178,-87.68245
TA1309000006,1,17,true,9,10,1,41.91809,-87.64375
TA1307000163,1,17,true,19,14,-5,41.91821,-87.65696
13146,1,17,true,15,34,19,41.91831,-87.63629
13059,1,17,true,20,18,-2,41.91845,-87.65222
13259,1,17,true,3,5,2,41.91852,-87.69744
13192,1,17,true,10,17,7,41.91995,-87.64884
13288,1,17,true,10,13,3,41.92008,-87.67788
TA1309000030,1,17,true,6,14,8,41.92077,-87.66372
TA1309000033,1,17,true,20,27,7,41.92158,-87.65381
13193,1,17,true,22,21,-1,41.92182,-87.64412
13191,1,17,true,14,11,-3,41.92217,-87.63891
13084,1,17,true,5,3,-2,41.92268,-87.69715
LP-,1,17,true,8,8,0,41.92396,-87.63584
15648,1,17,true,2,5,3,41.92464,-87.68931
TA1307000001,1,17,true,18,12,-6,41.92535,-87.66581
TA1306000026,1,17,true,19,8,-11,41.92558,-87.65842
TA1306000016,1,17,true,16,8,-8,41.9256,-87.65371
TA1309000019,1,17,true,24,22,-2,41.92586,-87.63897
TA1309000058,1,17,true,30,19,-11,41.92591,-87.64927
TA1308000001,1,17,true,17,23,6,41.92627,-87.63086
TA1309000023,1,17,true,11,11,0,41.9287,-87.65383
TA1307000113,1,17,true,7,13,6,41.92878,-87.66391
13296,1,17,true,8,5,-3,41.92883,-87.66852
TA1309000061,1,17,true,27,23,-4,41.92915,-87.64909
TA1308000031,1,17,true,1,6,5,41.92946,-87.68417
TA1305000014,1,17,true,20,23,3,41.92956,-87.64313
TA1307000142,1,17,true,19,36,17,41.93125,-87.64432
13276,1,17,true,12,8,-4,41.93132,-87.63874
TA1307000064,1,17,true,21,15,-6,41.93222,-87.65864
TA1306000014,1,17,true,9,16,7,41.93242,-87.65271
TA1309000039,1,17,true,23,25,2,41.93258,-87.63642
13294,1,17,true,4,8,4,41.9326,-87.66595
TA1309000036,1,17,true,17,26,9,41.93313,-87.64776
TA1307000006,1,17,true,13,13,0,41.93571,-87.6636
13268,1,17,true,3,9,6,41.93588,-87.67843
13269,1,17,true,9,12,3,41.93609,-87.66983
TA1307000052,1,17,true,18,12,-6,41.93628,-87.65266
TA1307000136,1,17,true,21,25,4,41.9365,-87.64755
TA1307000041,1,17,true,22,25,3,41.93669,-87.63683
13137,1,17,true,33,29,-4,41.9376,-87.6441
TA1309000042,1,17,true,11,15,4,41.93937,-87.66836
13229,1,17,true,6,13,7,41.93946,-87.66376
TA1308000019,1,17,true,21,13,-8,41.93973,-87.65886
13277,1,17,true,11,19,8,41.9401,-87.64546
TA1307000134,1,17,true,30,25,-5,41.94016,-87.65303
TA1309000049,1,17,true,19,24,5,41.94077,-87.63919
TA1307000138,1,17,true,14,16,2,41.94334,-87.67094
TA1309000025,1,17,true,23,19,-4,41.94368,-87.64894
13071,1,17,true,17,15,-2,41.94373,-87.66401
632,1,17,true,14,17,3,41.94453,-87.6547
13278,1,17,true,17,22,5,41.94553,-87.64644
TA1309000050,1,17,true,2,6,4,41.94618,-87.67331
13235,1,17,true,22,16,-6,41.94814,-87.66396
13253,1,17,true,7,6,-1,41.9488,-87.67527
13325,1,17,true,23,39,16,41.94907,-87.64863
TA1307000126,1,17,true,5,20,15,41.94936,-87.65451
TA1307000150,1,17,true,25,21,-4,41.94945,-87.64646
13319,1,17,true,2,6,4,41.95069,-87.6687
TA1307000127,1,17,true,10,14,4,41.9508,-87.65918
13323,1,17,true,11,6,-5,41.95282,-87.65
TA1309000043,1,17,true,7,4,-3,41.95417,-87.66434
13063,1,17,true,10,3,-7,41.95424,-87.65441
TA1308000022,1,17,true,14,11,-3,41.95438,-87.64805
TA1307000149,1,17,true,16,7,-9,41.95467,-87.67392
TA1309000026,1,17,true,6,2,-4,41.95601,-87.6802
13379,1,17,true,14,18,4,41.95786,-87.6495
TA1309000018,1,17,true,5,1,-4,41.95791,-87.67357
TA1309000027,1,17,true,10,9,-1,41.9585,-87.65499
13389,1,17,true,7,6,-1,41.961,-87.64958
15622,1,17,true,4,7,3,41.96108,-87.69544
TA1307000144,1,17,true,5,5,0,41.96142,-87.6762
15623,1,17,true,2,6,4,41.96154,-87.69117
KA1503000022,1,17,true,8,4,-4,41.96158,-87.66609
TA1307000107,1,17,true,19,8,-11,41.96164,-87.65464
TA1307000156,1,17,true,2,8,6,41.96301,-87.68479
TA1308000012,1,17,true,10,21,11,41.96398,-87.63818
13074,1,17,true,7,7,0,41.96521,-87.6582
639,1,17,true,11,11,0,41.96584,-87.64538
TA1307000140,1,17,true,5,15,10,41.96643,-87.68865
TA1309000014,1,17,true,7,10,3,41.96709,-87.66744
TA1307000158,1,17,true,10,5,-5,41.9671,-87.67904
TA1308000021,1,17,true,7,3,-4,41.96883,-87.65765
KA1504000080,1,17,true,2,8,6,41.96887,-87.69609
TA1309000066,1,17,true,21,19,-2,41.9691,-87.67423
TA1309000041,1,17,true,7,4,-3,41.96951,-87.65471
KA1504000171,1,17,true,9,7,-2,41.97161,-87.65016
TA1309000035,1,17,true,12,6,-6,41.97335,-87.66785
13108,1,17,true,10,9,-1,41.97379,-87.65971
KA1504000078,1,17,true,2,8,6,41.97491,-87.69258
KA1504000146,1,17,true,7,9,2,41.978,-87.66805
13109,1,17,true,8,9,1,41.97835,-87.65976
KA1504000147,1,17,true,3,5,2,41.97976,-87.67754
KA1504000151,1,17,true,5,10,5,41.98359,-87.66916
KA1504000152,1,17,true,11,13,2,41.98403,-87.65231
15578,1,17,true,11,7,-4,41.98405,-87.66027
15575,1,17,true,5,7,2,41.98975,-87.66014
15571,1,17,true,8,6,-2,41.99478,-87.66028
E002,1,17,true,2,6,4,42.03256,-87.67912
596,1,17,true,6,8,2,42.04822,-87.68348
KA1503000021,1,18,false,1,5,4,41.77888,-87.58665
KA1503000014,1,18,false,8,2,-6,41.7851,-87.60108
TA1308000009,1,18,false,9,4,-5,41.79522,-87.58075
TA1307000164,1,18,false,2,6,4,41.79527,-87.59647
KA1503000059,1,18,false,4,5,1,41.79952,-87.58643
TA1309000037,1,18,false,6,9,3,41.79957,-87.59474
KA1503000004,1,18,false,6,7,1,41.83127,-87.6088
13215,1,18,false,5,2,-3,41.83634,-87.6135
TA1307000048,1,18,false,6,12,6,41.83855,-87.60821
13075,1,18,false,9,8,-1,41.8531,-87.63192
15546,1,18,false,3,5,2,41.85416,-87.61916
15545,1,18,false,2,6,4,41.85627,-87.61334
SL-006,1,18,false,5,11,6,41.8568,-87.63387
13102,1,18,false,3,5,2,41.85762,-87.61942
13150,1,18,false,5,7,2,41.85783,-87.62455
TA1307000124,1,18,false,9,6,-3,41.86411,-87.62372
13431,1,18,false,4,5,1,41.8661,-87.60728
TA1305000002,1,18,false,14,14,0,41.86721,-87.62597
15544,1,18,false,12,18,6,41.86723,-87.61536
TA1305000017,1,18,false,5,1,-4,41.86734,-87.64863
KA1706005007,1,18,false,7,4,-3,41.86749,-87.63219
SL-005,1,18,false,21,32,11,41.8679,-87.62304
13160,1,18,false,2,5,3,41.86947,-87.65548
15550,1,18,false,1,5,4,41.87024,-87.63947
TA1309000010,1,18,false,13,6,-7,41.87074,-87.62574
SL-009,1,18,false,6,4,-2,41.87081,-87.63121
TA1307000121,1,18,false,6,1,-5,41.87184,-87.64664
SL-008,1,18,false,17,9,-8,41.87209,-87.62956
SL-011,1,18,false,10,12,2,41.87256,-87.63356
623,1,18,false,20,13,-7,41.87272,-87.62399
SL-007,1,18,false,6,2,-4,41.87404,-87.6277
SL-010,1,18,false,6,8,2,41.87501,-87.63309
15541,1,18,false,11,22,11,41.8758,-87.62086
624,1,18,false,10,8,-2,41.87626,-87.62923
15539,1,18,false,8,5,-3,41.87763,-87.64405
13158,1,18,false,5,7,2,41.87764,-87.64957
TA1305000025,1,18,false,6,6,0,41.87773,-87.63528
TA1309000002,1,18,false,10,13,3,41.87784,-87.62408
638,1,18,false,6,3,-3,41.87827,-87.64078
13011,1,18,false,5,5,0,41.87931,-87.63993
KA1503000034,1,18,false,5,1,-4,41.87938,-87.63197
TA1309000007,1,18,false,3,5,2,41.88022,-87.63526
WL-011,1,18,false,1,7,6,41.88034,-87.64273
13156,1,18,false,6,5,-1,41.88042,-87.65554
13300,1,18,false,41,38,-3,41.88097,-87.61675
13008,1,18,false,52,46,-6,41.88105,-87.62408
TA1305000006,1,18,false,2,7,5,41.88122,-87.6296
TA1307000120,1,18,false,8,15,7,41.88188,-87.64879
13341,1,18,false,9,1,-8,41.88208,-87.63985
13036,1,18,false,17,4,-13,41.8821,-87.62513
TA1305000032,1,18,false,6,7,1,41.88218,-87.64109
13006,1,18,false,3,7,4,41.88268,-87.63252
13409,1,18,false,5,11,6,41.8831,-87.6511
WL-012,1,18,false,9,3,-6,41.88337,-87.6412
13053,1,18,false,4,18,14,41.88365,-87.64863
13001,1,18,false,22,21,-1,41.88397,-87.62459
18062,1,18,false,5,2,-3,41.88412,-87.65427
TA1306000010,1,18,false,10,2,-8,41.88419,-87.62961
TA1305000030,1,18,false,8,2,-6,41.88459,-87.63178
15535,1,18,false,11,10,-1,41.8846,-87.64455
TA1305000029,1,18,false,23,13,-10,41.88466,-87.62787
13263,1,18,false,23,11,-12,41.88467,-87.61952
TA1306000015,1,18,false,2,18,16,41.88549,-87.65232
13021,1,18,false,5,9,4,41.88559,-87.64184
TA1307000111,1,18,false,6,1,-5,41.88582,-87.63548
KA1503000012,1,18,false,10,8,-2,41.88599,-87.63089
TA1305000011,1,18,false,10,15,5,41.886,-87.62418
15534,1,18,false,12,8,-4,41.88627,-87.61749
TA1308000029,1,18,false,9,8,-1,41.88673,-87.62225
TA1307000131,1,18,false,5,10,5,41.88688,-87.62606
KA1503000064,1,18,false,19,19,0,41.88697,-87.61281
TA1305000022,1,18,false,16,6,-10,41.88817,-87.63656
TA1306000003,1,18,false,16,12,-4,41.88867,-87.64442
KA1503000043,1,18,false,16,8,-8,41.88918,-87.63851
13050,1,18,false,7,4,-3,41.88919,-87.62775
TA1307000151,1,18,false,20,8,-12,41.88993,-87.63427
636,1,18,false,7,5,-2,41.88997,-87.63662
KA1503000044,1,18,false,5,7,2,41.89018,-87.6262
13427,1,18,false,11,8,-3,41.89054,-87.62205
13430,1,18,false,6,10,4,41.89077,-87.63169
TA1306000013,1,18,false,21,17,-4,41.89083,-87.61852
RN-,1,18,false,8,10,2,41.89102,-87.63546
TA1307000117,1,18,false,35,30,-5,41.89144,-87.62675
13033,1,18,false,9,9,0,41.8916,-87.64835
13194,1,18,false,2,5,3,41.8918,-87.65878
TA1305000003,1,18,false,16,15,-1,41.89187,-87.62061
13022,1,18,false,137,116,-21,41.89227,-87.61205
TA1306000029,1,18,false,18,14,-4,41.89256,-87.61449
13265,1,18,false,12,8,-4,41.89383,-87.64172
13045,1,18,false,24,11,-13,41.89403,-87.62931
13016,1,18,false,20,19,-1,41.89431,-87.62277
KA1503000041,1,18,false,14,4,-10,41.89452,-87.61798
13196,1,18,false,7,10,3,41.89455,-87.65345
TA1307000062,1,18,false,11,3,-8,41.89466,-87.63839
TA1306000012,1,18,false,13,15,2,41.89475,-87.63438
KP1705001026,1,18,false,8,10,2,41.89483,-87.6323
13132,1,18,false,6,3,-3,41.89573,-87.67718
15530,1,18,false,16,11,-5,41.89575,-87.62596
13247,1,18,false,5,8,3,41.89597,-87.66775
TA1305000020,1,18,false,3,9,6,41.89636,-87.65406
13289,1,18,false,14,10,-4,41.89638,-87.661
13303,1,18,false,12,8,-4,41.89672,-87.63088
13017,1,18,false,10,7,-3,41.89676,-87.6357
13338,1,18,false,3,6,3,41.89697,-87.62173
13034,1,18,false,9,14,5,41.89754,-87.62352
TA1306000009,1,18,false,8,5,-3,41.89772,-87.64299
620,1,18,false,8,3,-5,41.89817,-87.63754
15529,1,18,false,6,9,3,41.89858,-87.62206
TA1307000128,1,18,false,27,16,-11,41.89896,-87.6299
657,1,18,false,9,4,-5,41.89918,-87.6722
13248,1,18,false,8,8,0,41.89964,-87.66788
TA1306000011,1,18,false,8,4,-4,41.89994,-87.63443
KA1504000116,1,18,false,5,3,-2,41.90023,-87.64299
17660,1,18,false,6,3,-3,41.90036,-87.69671
13042,1,18,false,35,26,-9,41.90097,-87.62377
KA1504000133,1,18,false,16,15,-1,41.90234,-87.62773
TA1307000039,1,18,false,32,21,-11,41.90294,-87.63137
13256,1,18,false,3,5,2,41.90302,-87.69749
TA1305000034,1,18,false,8,6,-2,41.90313,-87.67391
KA1504000135,1,18,false,25,19,-6,41.90319,-87.63439
13061,1,18,false,15,17,2,41.90342,-87.66779
KA1504000079,1,18,false,8,5,-3,41.9035,-87.64334
TA1307000115,1,18,false,9,10,1,41.9046,-87.64056
TA1308000049,1,18,false,23,19,-4,41.90672,-87.6349
KA1504000134,1,18,false,8,10,2,41.90687,-87.6262
13224,1,18,false,8,5,-3,41.90706,-87.66725
13221,1,18,false,10,10,0,41.90765,-87.67254
TA1309000024,1,18,false,14,19,5,41.908,-87.63152
TA1305000041,1,18,false,11,11,0,41.9094,-87.67769
331,1,18,false,20,16,-4,41.90965,-87.64812
15653,1,18,false,6,5,-1,41.90979,-87.7053
TA1305000037,1,18,false,9,2,-7,41.91018,-87.67003
TA1306000008,1,18,false,5,10,5,41.9102,-87.6435
13257,1,18,false,8,7,-1,41.91054,-87.68956
13154,1,18,false,6,5,-1,41.91054,-87.65312
13058,1,18,false,14,15,1,41.91059,-87.64942
TA1307000038,1,18,false,7,12,5,41.91138,-87.63868
LF-005,1,18,false,13,132,119,41.91172,-87.62681
13128,1,18,false,7,20,13,41.91197,-87.63197
TA1308000050,1,18,false,23,28,5,41.91211,-87.6347
13243,1,18,false,12,7,-5,41.91262,-87.6814
TA1306000032,1,18,false,19,14,-5,41.9137,-87.65285
TA1307000166,1,18,false,9,7,-2,41.91386,-87.64877
15655,1,18,false,5,3,-2,41.91401,-87.70514
18017,1,18,false,5,5,0,41.91416,-87.71676
18067,1,18,false,7,4,-3,41.9146,-87.66796
13068,1,18,false,14,6,-8,41.91554,-87.68703
13179,1,18,false,27,42,15,41.9157,-87.63461
13133,1,18,false,9,6,-3,41.91598,-87.67733
TA1305000039,1,18,false,5,2,-3,41.9163,-87.66749
TA1309000029,1,18,false,4,6,2,41.9178,-87.68245
TA1309000006,1,18,false,4,9,5,41.91809,-87.64375
TA1307000163,1,18,false,8,4,-4,41.91821,-87.65696
13146,1,18,false,18,22,4,41.91831,-87.63629
13059,1,18,false,12,25,13,41.91845,-87.65222
13192,1,18,false,17,11,-6,41.91995,-87.64884
13242,1,18,false,3,7,4,41.92021,-87.69266
TA1309000030,1,18,false,8,11,3,41.92077,-87.66372
TA1309000033,1,18,false,6,7,1,41.92158,-87.65381
13193,1,18,false,25,22,-3,41.92182,-87.64412
13191,1,18,false,7,7,0,41.92217,-87.63891
LP-,1,18,false,8,9,1,41.92396,-87.63584
TA1307000001,1,18,false,9,10,1,41.92535,-87.66581
TA1306000026,1,18,false,5,8,3,41.92558,-87.65842
TA1306000016,1,18,false,6,5,-1,41.9256,-87.65371
TA1309000019,1,18,false,21,7,-14,41.92586,-87.63897
TA1309000058,1,18,false,14,17,3,41.92591,-87.64927
TA1308000001,1,18,false,25,38,13,41.92627,-87.63086
13124,1,18,false,5,6,1,41.92675,-87.63444
TA1309000023,1,18,false,14,18,4,41.9287,-87.65383
TA1307000113,1,18,false,14,10,-4,41.92878,-87.66391
13296,1,18,false,6,7,1,41.92883,-87.66852
TA1309000059,1,18,false,7,10,3,41.92889,-87.65898
TA1309000061,1,18,false,9,13,4,41.92915,-87.64909
TA1308000031,1,18,false,3,7,4,41.92946,-87.68417
TA1305000014,1,18,false,18,10,-8,41.92956,-87.64313
13085,1,18,false,6,6,0,41.92958,-87.70789
15643,1,18,false,5,1,-4,41.93057,-87.7238
TA1307000142,1,18,false,21,22,1,41.93125,-87.64432
13276,1,18,false,9,12,3,41.93132,-87.63874
13271,1,18,false,4,6,2,41.93192,-87.67784
TA1307000064,1,18,false,8,10,2,41.93222,-87.65864
TA1306000014,1,18,false,17,8,-9,41.93242,-87.65271
TA1309000039,1,18,false,18,13,-5,41.93258,-87.63642
13294,1,18,false,5,2,-3,41.9326,-87.66595
TA1309000036,1,18,false,11,7,-4,41.93313,-87.64776
13268,1,18,false,5,4,-1,41.93588,-87.67843
13269,1,18,false,1,6,5,41.93609,-87.66983
TA1307000052,1,18,false,19,11,-8,41.93628,-87.65266
TA1307000136,1,18,false,16,5,-11,41.9365,-87.64755
TA1307000041,1,18,false,17,21,4,41.93669,-87.63683
13137,1,18,false,20,14,-6,41.9376,-87.6441
TA1309000042,1,18,false,12,3,-9,41.93937,-87.66836
15640,1,18,false,1,6,5,41.93941,-87.72357
13229,1,18,false,6,4,-2,41.93946,-87.66376
TA1308000019,1,18,false,7,6,-1,41.93973,-87.65886
13277,1,18,false,16,9,-7,41.9401,-87.64546
TA1307000134,1,18,false,29,19,-10,41.94016,-87.65303
TA1309000049,1,18,false,18,22,4,41.94077,-87.63919
TA1307000138,1,18,false,5,6,1,41.94334,-87.67094
TA1309000025,1,18,false,8,5,-3,41.94368,-87.64894
13071,1,18,false,4,18,14,41.94373,-87.66401
632,1,18,false,14,13,-1,41.94453,-87.6547
13278,1,18,false,11,14,3,41.94553,-87.64644
13235,1,18,false,4,16,12,41.94814,-87.66396
13325,1,18,false,14,12,-2,41.94907,-87.64863
TA1307000126,1,18,false,9,85,76,41.94936,-87.65451
TA1307000150,1,18,false,12,9,-3,41.94945,-87.64646
13319,1,18,false,3,5,2,41.95069,-87.6687
TA1307000127,1,18,false,11,9,-2,41.9508,-87.65918
13323,1,18,false,6,11,5,41.95282,-87.65
13063,1,18,false,6,11,5,41.95424,-87.65441
TA1308000022,1,18,false,9,12,3,41.95438,-87.64805
TA1307000149,1,18,false,3,6,3,41.95467,-87.67392
TA1309000026,1,18,false,6,4,-2,41.95601,-87.6802
13249,1,18,false,2,5,3,41.95606,-87.66885
13379,1,18,false,16,8,-8,41.95786,-87.6495
13389,1,18,false,12,8,-4,41.961,-87.64958
TA1307000107,1,18,false,11,10,-1,41.96164,-87.65464
TA1308000012,1,18,false,17,19,2,41.96398,-87.63818
13074,1,18,false,6,2,-4,41.96521,-87.6582
639,1,18,false,6,6,0,41.96584,-87.64538
TA1309000014,1,18,false,9,5,-4,41.96709,-87.66744
TA1307000119,1,18,false,7,6,-1,41.96796,-87.65
TA1308000021,1,18,false,7,4,-3,41.96883,-87.65765
TA1309000066,1,18,false,9,4,-5,41.9691,-87.67423
TA1309000041,1,18,false,7,5,-2,41.96951,-87.65471
KA1504000171,1,18,false,10,4,-6,41.97161,-87.65016
TA1309000035,1,18,false,7,4,-3,41.97335,-87.66785
13108,1,18,false,5,6,1,41.97379,-87.65971
KA1504000146,1,18,false,8,6,-2,41.978,-87.66805
KA1504000152,1,18,false,11,13,2,41.98403,-87.65231
15578,1,18,false,5,2,-3,41.98405,-87.66027
15575,1,18,false,6,7,1,41.98975,-87.66014
RP-001,1,18,false,7,7,0,42.00179,-87.68883
660,1,18,false,3,5,2,42.00458,-87.66143
KA1504000162,1,18,false,7,1,-6,42.00907,-87.67422
525,1,18,false,1,10,9,42.01272,-87.66605
596,1,18,false,6,9,3,42.04822,-87.68348
E008,1,18,false,6,1,-5,42.05049,-87.67782
604,1,18,false,5,5,0,42.05824,-87.67744
KA1503000014,1,18,true,11,10,-1,41.7851,-87.60108
TA1309000011,1,18,true,9,1,-8,41.78873,-87.60131
TA1309000063,1,18,true,6,2,-4,41.79325,-87.5878
KA1504000076,1,18,true,5,3,-2,41.7943,-87.60145
TA1308000009,1,18,true,5,9,4,41.79522,-87.58075
TA1307000164,1,18,true,3,5,2,41.79527,-87.59647
TA1309000037,1,18,true,1,12,11,41.79957,-87.59474
KA1503000007,1,18,true,4,5,1,41.80242,-87.58689
TA1308000035,1,18,true,4,7,3,41.80944,-87.59188
TA1308000045,1,18,true,2,6,4,41.83062,-87.64129
13216,1,18,true,18,5,-13,41.83473,-87.62581
13217,1,18,true,4,9,5,41.83488,-87.61792
13215,1,18,true,5,4,-1,41.83634,-87.6135
TA1307000048,1,18,true,5,16,11,41.83855,-87.60821
TA1308000036,1,18,true,2,5,3,41.83883,-87.62186
TA1307000139,1,18,true,12,8,-4,41.84205,-87.61698
TA1307000153,1,18,true,1,5,4,41.84358,-87.64538
TA1307000005,1,18,true,1,5,4,41.84569,-87.6225
13075,1,18,true,6,6,0,41.8531,-87.63192
15546,1,18,true,7,7,0,41.85416,-87.61916
15545,1,18,true,23,18,-5,41.85627,-87.61334
13135,1,18,true,5,6,1,41.85753,-87.66157
13102,1,18,true,13,20,7,41.85762,-87.61942
13150,1,18,true,11,16,5,41.85783,-87.62455
13099,1,18,true,1,6,5,41.85784,-87.64627
13164,1,18,true,11,12,1,41.85818,-87.65648
SL-012,1,18,true,8,15,7,41.86038,-87.62581
TA1306000002,1,18,true,15,9,-6,41.86238,-87.65108
TA1307000124,1,18,true,7,17,10,41.86411,-87.62372
13431,1,18,true,8,5,-3,41.8661,-87.60728
WL-008,1,18,true,14,11,-3,41.86712,-87.64108
TA1305000002,1,18,true,25,22,-3,41.86721,-87.62597
15544,1,18,true,8,9,1,41.86723,-87.61536
TA1305000017,1,18,true,8,5,-3,41.86734,-87.64863
KA1706005007,1,18,true,8,7,-1,41.86749,-87.63219
SL-005,1,18,true,20,30,10,41.8679,-87.62304
644,1,18,true,5,5,0,41.86859,-87.68625
13139,1,18,true,8,12,4,41.86893,-87.65913
13285,1,18,true,8,4,-4,41.86928,-87.67372
13160,1,18,true,14,9,-5,41.86947,-87.65548
15550,1,18,true,5,8,3,41.87024,-87.63947
TA1309000010,1,18,true,13,13,0,41.87074,-87.62574
TA1307000130,1,18,true,14,14,0,41.87178,-87.65103
TA1307000121,1,18,true,11,14,3,41.87184,-87.64664
SL-008,1,18,true,17,22,5,41.87209,-87.62956
13332,1,18,true,14,10,-4,41.87219,-87.6615
SL-011,1,18,true,6,10,4,41.87256,-87.63356
623,1,18,true,13,9,-4,41.87272,-87.62399
KA1504000104,1,18,true,6,9,3,41.87296,-87.66912
SL-007,1,18,true,6,8,2,41.87404,-87.6277
13326,1,18,true,2,7,5,41.87425,-87.63958
TA1306000025,1,18,true,11,6,-5,41.87464,-87.65703
13028,1,18,true,8,9,1,41.87475,-87.64981
SL-010,1,18,true,6,8,2,41.87501,-87.63309
15541,1,18,true,6,6,0,41.8758,-87.62086
624,1,18,true,10,7,-3,41.87626,-87.62923
TA1305000035,1,18,true,6,5,-1,41.87716,-87.62787
13138,1,18,true,9,3,-6,41.87723,-87.63941
15539,1,18,true,11,12,1,41.87763,-87.64405
13158,1,18,true,17,20,3,41.87764,-87.64957
13157,1,18,true,9,15,6,41.87773,-87.6548
TA1305000025,1,18,true,14,8,-6,41.87773,-87.63528
TA1309000002,1,18,true,5,1,-4,41.87784,-87.62408
13206,1,18,true,6,3,-3,41.87794,-87.66201
TA1309000004,1,18,true,5,2,-3,41.87811,-87.63184
638,1,18,true,14,9,-5,41.87827,-87.64078
TA1305000005,1,18,true,13,2,-11,41.87924,-87.62975
13011,1,18,true,26,13,-13,41.87931,-87.63993
KA1503000034,1,18,true,7,1,-6,41.87938,-87.63197
KA1503000015,1,18,true,14,3,-11,41.87948,-87.6257
WL-011,1,18,true,9,5,-4,41.88034,-87.64273
13156,1,18,true,7,16,9,41.88042,-87.65554
13300,1,18,true,23,20,-3,41.88097,-87.61675
13008,1,18,true,30,13,-17,41.88105,-87.62408
TA1305000006,1,18,true,17,11,-6,41.88122,-87.6296
13056,1,18,true,13,7,-6,41.88168,-87.63951
TA1307000120,1,18,true,27,44,17,41.88188,-87.64879
13341,1,18,true,20,8,-12,41.88208,-87.63985
13036,1,18,true,12,2,-10,41.8821,-87.62513
TA1305000032,1,18,true,38,19,-19,41.88218,-87.64109
13006,1,18,true,10,3,-7,41.88268,-87.63252
13353,1,18,true,11,11,0,41.88283,-87.6612
13409,1,18,true,17,21,4,41.8831,-87.6511
WL-012,1,18,true,24,12,-12,41.88337,-87.6412
13053,1,18,true,21,13,-8,41.88365,-87.64863
13001,1,18,true,32,5,-27,41.88397,-87.62459
13155,1,18,true,5,2,-3,41.88407,-87.65689
18062,1,18,true,12,7,-5,41.88412,-87.65427
TA1306000010,1,18,true,37,17,-20,41.88419,-87.62961
TA1305000030,1,18,true,20,10,-10,41.88459,-87.63178
15535,1,18,true,18,24,6,41.8846,-87.64455
TA1305000029,1,18,true,22,19,-3,41.88466,-87.62787
13263,1,18,true,23,22,-1,41.88467,-87.61952
TA1306000015,1,18,true,13,14,1,41.88549,-87.65232
13021,1,18,true,28,10,-18,41.88559,-87.64184
TA1307000111,1,18,true,9,11,2,41.88582,-87.63548
KA1503000012,1,18,true,24,11,-13,41.88599,-87.63089
TA1305000011,1,18,true,15,18,3,41.886,-87.62418
15534,1,18,true,9,7,-2,41.88627,-87.61749
13197,1,18,true,8,11,3,41.8866,-87.65816
TA1308000029,1,18,true,9,6,-3,41.88673,-87.62225
TA1307000131,1,18,true,20,10,-10,41.88688,-87.62606
KA1503000064,1,18,true,13,16,3,41.88697,-87.61281
TA1305000022,1,18,true,32,9,-23,41.88817,-87.63656
TA1306000003,1,18,true,43,43,0,41.88867,-87.64442
KA1503000043,1,18,true,61,48,-13,41.88918,-87.63851
13050,1,18,true,26,11,-15,41.88919,-87.62775
TA1307000151,1,18,true,47,15,-32,41.88993,-87.63427
636,1,18,true,27,10,-17,41.88997,-87.63662
KA1503000044,1,18,true,12,11,-1,41.89018,-87.6262
13427,1,18,true,15,15,0,41.89054,-87.62205
13430,1,18,true,17,20,3,41.89077,-87.63169
TA1306000013,1,18,true,16,29,13,41.89083,-87.61852
RN-,1,18,true,24,13,-11,41.89102,-87.63546
13434,1,18,true,6,3,-3,41.89108,-87.66663
TA1307000117,1,18,true,28,34,6,41.89144,-87.62675
13033,1,18,true,18,19,1,41.8916,-87.64835
13194,1,18,true,7,15,8,41.8918,-87.65878
TA1305000003,1,18,true,25,33,8,41.89187,-87.62061
13022,1,18,true,29,37,8,41.89227,-87.61205
TA1306000029,1,18,true,17,24,7,41.89256,-87.61449
13265,1,18,true,18,21,3,41.89383,-87.64172
13045,1,18,true,39,39,0,41.89403,-87.62931
13016,1,18,true,47,17,-30,41.89431,-87.62277
KA1503000041,1,18,true,19,22,3,41.89452,-87.61798
13196,1,18,true,13,17,4,41.89455,-87.65345
TA1307000062,1,18,true,12,10,-2,41.89466,-87.63839
TA1306000012,1,18,true,28,26,-2,41.89475,-87.63438
KP1705001026,1,18,true,18,14,-4,41.89483,-87.6323
18058,1,18,true,4,9,5,41.8955,-87.68201
637,1,18,true,5,6,1,41.89563,-87.67209
13132,1,18,true,18,20,2,41.89573,-87.67718
15530,1,18,true,24,22,-2,41.89575,-87.62596
18003,1,18,true,14,10,-4,41.89575,-87.62011
13247,1,18,true,10,18,8,41.89597,-87.66775
TA1305000020,1,18,true,11,9,-2,41.89636,-87.65406
13289,1,18,true,9,14,5,41.89638,-87.661
13303,1,18,true,19,16,-3,41.89672,-87.63088
13017,1,18,true,27,14,-13,41.89676,-87.6357
13338,1,18,true,16,15,-1,41.89697,-87.62173
TA1307000061,1,18,true,13,13,0,41.89745,-87.62873
13034,1,18,true,10,5,-5,41.89754,-87.62352
TA1306000009,1,18,true,27,18,-9,41.89772,-87.64299
620,1,18,true,13,11,-2,41.89817,-87.63754
KA1504000103,1,18,true,5,11,6,41.89842,-87.68659
15529,1,18,true,16,14,-2,41.89858,-87.62206
TA1307000128,1,18,true,27,31,4,41.89896,-87.6299
13248,1,18,true,4,17,13,41.89964,-87.66788
TA1306000011,1,18,true,11,10,-1,41.89994,-87.63443
KA1504000116,1,18,true,5,13,8,41.90023,-87.64299
17660,1,18,true,3,7,4,41.90036,-87.69671
13290,1,18,true,9,8,-1,41.90069,-87.66259
13042,1,18,true,31,18,-13,41.90097,-87.62377
TA1307000070,1,18,true,8,11,3,41.90133,-87.67742
KA1504000133,1,18,true,11,15,4,41.90234,-87.62773
13241,1,18,true,6,3,-3,41.9029,-87.68731
TA1306000006,1,18,true,4,6,2,41.90292,-87.63772
TA1307000039,1,18,true,49,48,-1,41.90294,-87.63137
658,1,18,true,3,6,3,41.903,-87.6838
TA1305000034,1,18,true,10,14,4,41.90313,-87.67391
KA1504000135,1,18,true,37,54,17,41.90319,-87.63439
13136,1,18,true,15,11,-4,41.90326,-87.67845
13061,1,18,true,24,19,-5,41.90342,-87.66779
KA1504000079,1,18,true,22,19,-3,41.9035,-87.64334
TA1307000115,1,18,true,3,16,13,41.9046,-87.64056
TA1308000049,1,18,true,15,28,13,41.90672,-87.6349
KA1504000134,1,18,true,18,10,-8,41.90687,-87.6262
13224,1,18,true,11,13,2,41.90706,-87.66725
TA1307000143,1,18,true,2,8,6,41.90762,-87.63854
13221,1,18,true,18,17,-1,41.90765,-87.67254
13245,1,18,true,3,6,3,41.90777,-87.68586
TA1309000024,1,18,true,16,21,5,41.908,-87.63152
TA1305000041,1,18,true,14,18,4,41.9094,-87.67769
331,1,18,true,29,39,10,41.90965,-87.64812
TA1305000037,1,18,true,11,13,2,41.91018,-87.67003
TA1306000008,1,18,true,9,10,1,41.9102,-87.6435
TA1308000005,1,18,true,11,7,-4,41.91042,-87.68238
13258,1,18,true,5,5,0,41.91043,-87.69718
13154,1,18,true,18,21,3,41.91054,-87.65312
13058,1,18,true,15,19,4,41.91059,-87.64942
TA1307000038,1,18,true,17,15,-2,41.91138,-87.63868
LF-005,1,18,true,28,166,138,41.91172,-87.62681
13128,1,18,true,14,17,3,41.91197,-87.63197
TA1308000050,1,18,true,33,52,19,41.91211,-87.6347
13243,1,18,true,18,19,1,41.91262,-87.6814
TA1306000032,1,18,true,20,21,1,41.9137,-87.65285
TA1307000166,1,18,true,7,15,8,41.91386,-87.64877
18067,1,18,true,6,7,1,41.9146,-87.66796
TA1306000007,1,18,true,5,8,3,41.91469,-87.64333
13068,1,18,true,9,8,-1,41.91554,-87.68703
13179,1,18,true,22,32,10,41.9157,-87.63461
13133,1,18,true,11,16,5,41.91598,-87.67733
TA1305000039,1,18,true,6,4,-2,41.9163,-87.66749
13266,1,18,true,2,6,4,41.91774,-87.69142
TA1309000029,1,18,true,3,7,4,41.9178,-87.68245
TA1309000006,1,18,true,8,10,2,41.91809,-87.64375
TA1307000163,1,18,true,13,15,2,41.91821,-87.65696
13146,1,18,true,25,53,28,41.91831,-87.63629
13059,1,18,true,26,24,-2,41.91845,-87.65222
13192,1,18,true,12,20,8,41.91995,-87.64884
13288,1,18,true,7,7,0,41.92008,-87.67788
13242,1,18,true,3,6,3,41.92021,-87.69266
TA1309000030,1,18,true,27,11,-16,41.92077,-87.66372
13292,1,18,true,1,5,4,41.92152,-87.70733
TA1309000033,1,18,true,15,22,7,41.92158,-87.65381
13193,1,18,true,28,25,-3,41.92182,-87.64412
13191,1,18,true,9,16,7,41.92217,-87.63891
13084,1,18,true,3,11,8,41.92268,-87.69715
LP-,1,18,true,5,13,8,41.92396,-87.63584
KA1504000140,1,18,true,3,5,2,41.92409,-87.67646
TA1307000001,1,18,true,10,13,3,41.92535,-87.66581
TA1306000026,1,18,true,25,22,-3,41.92558,-87.65842
TA1306000016,1,18,true,7,10,3,41.9256,-87.65371
TA1309000019,1,18,true,23,24,1,41.92586,-87.63897
TA1309000058,1,18,true,41,46,5,41.92591,-87.64927
TA1308000001,1,18,true,30,34,4,41.92627,-87.63086
15646,1,18,true,3,5,2,41.92668,-87.6977
13124,1,18,true,7,10,3,41.92675,-87.63444
TA1309000023,1,18,true,22,12,-10,41.9287,-87.65383
TA1307000113,1,18,true,10,12,2,41.92878,-87.66391
13296,1,18,true,10,10,0,41.92883,-87.66852
TA1309000059,1,18,true,3,10,7,41.92889,-87.65898
TA1309000061,1,18,true,17,23,6,41.92915,-87.64909
TA1308000031,1,18,true,5,5,0,41.92946,-87.68417
TA1305000014,1,18,true,24,30,6,41.92956,-87.64313
13085,1,18,true,5,5,0,41.92958,-87.70789
TA1307000142,1,18,true,21,24,3,41.93125,-87.64432
13276,1,18,true,13,21,8,41.93132,-87.63874
15645,1,18,true,4,5,1,41.93191,-87.70121
13271,1,18,true,8,7,-1,41.93192,-87.67784
TA1307000064,1,18,true,22,19,-3,41.93222,-87.65864
TA1306000014,1,18,true,32,12,-20,41.93242,-87.65271
TA1309000039,1,18,true,19,32,13,41.93258,-87.63642
13294,1,18,true,6,7,1,41.9326,-87.66595
TA1309000036,1,18,true,29,26,-3,41.93313,-87.64776
TA1307000006,1,18,true,7,10,3,41.93571,-87.6636
13268,1,18,true,5,2,-3,41.93588,-87.67843
13269,1,18,true,4,8,4,41.93609,-87.66983
TA1307000052,1,18,true,12,21,9,41.93628,-87.65266
TA1307000136,1,18,true,18,26,8,41.9365,-87.64755
TA1307000041,1,18,true,32,34,2,41.93669,-87.63683
13137,1,18,true,34,30,-4,41.9376,-87.6441
TA1309000042,1,18,true,9,17,8,41.93937,-87.66836
13229,1,18,true,4,7,3,41.93946,-87.66376
TA1308000019,1,18,true,20,17,-3,41.93973,-87.65886
13277,1,18,true,20,14,-6,41.9401,-87.64546
TA1307000134,1,18,true,42,38,-4,41.94016,-87.65303
TA1309000049,1,18,true,29,38,9,41.94077,-87.63919
TA1307000138,1,18,true,14,11,-3,41.94334,-87.67094
TA1309000025,1,18,true,23,22,-1,41.94368,-87.64894
13071,1,18,true,16,27,11,41.94373,-87.66401
632,1,18,true,19,18,-1,41.94453,-87.6547
13278,1,18,true,24,21,-3,41.94553,-87.64644
TA1309000050,1,18,true,7,7,0,41.94618,-87.67331
15632,1,18,true,1,9,8,41.94664,-87.69463
13235,1,18,true,22,25,3,41.94814,-87.66396
13253,1,18,true,9,2,-7,41.9488,-87.67527
13325,1,18,true,25,28,3,41.94907,-87.64863
TA1307000126,1,18,true,12,35,23,41.94936,-87.65451
TA1307000150,1,18,true,23,35,12,41.94945,-87.64646
13319,1,18,true,8,4,-4,41.95069,-87.6687
TA1307000127,1,18,true,12,14,2,41.9508,-87.65918
13323,1,18,true,16,16,0,41.95282,-87.65
TA1309000043,1,18,true,9,14,5,41.95417,-87.66434
13063,1,18,true,13,6,-7,41.95424,-87.65441
TA1308000022,1,18,true,13,15,2,41.95438,-87.64805
TA1307000149,1,18,true,8,6,-2,41.95467,-87.67392
TA1309000026,1,18,true,8,14,6,41.95601,-87.6802
13249,1,18,true,5,5,0,41.95606,-87.66885
TA1308000047,1,18,true,4,7,3,41.95709,-87.6642
13379,1,18,true,11,14,3,41.95786,-87.6495
TA1309000018,1,18,true,2,5,3,41.95791,-87.67357
TA1309000027,1,18,true,10,8,-2,41.9585,-87.65499
13389,1,18,true,13,9,-4,41.961,-87.64958
TA1307000144,1,18,true,8,7,-1,41.96142,-87.6762
15623,1,18,true,7,1,-6,41.96154,-87.69117
KA1503000022,1,18,true,4,6,2,41.96158,-87.66609
TA1307000107,1,18,true,20,9,-11,41.96164,-87.65464
TA1307000156,1,18,true,6,9,3,41.96301,-87.68479
TA1308000012,1,18,true,10,30,20,41.96398,-87.63818
13074,1,18,true,7,7,0,41.96521,-87.6582
639,1,18,true,10,7,-3,41.96584,-87.64538
TA1309000014,1,18,true,2,7,5,41.96709,-87.66744
TA1307000158,1,18,true,4,6,2,41.9671,-87.67904
TA1307000119,1,18,true,9,2,-7,41.96796,-87.65
TA1308000021,1,18,true,4,7,3,41.96883,-87.65765
KA1504000080,1,18,true,3,5,2,41.96887,-87.69609
TA1309000066,1,18,true,29,7,-22,41.9691,-87.67423
TA1309000041,1,18,true,6,9,3,41.96951,-87.65471
KA1504000171,1,18,true,8,9,1,41.97161,-87.65016
TA1309000035,1,18,true,14,13,-1,41.97335,-87.66785
13108,1,18,true,8,9,1,41.97379,-87.65971
KA1504000149,1,18,true,2,8,6,41.97562,-87.67945
KA1504000146,1,18,true,10,15,5,41.978,-87.66805
13109,1,18,true,10,13,3,41.97835,-87.65976
KA1504000151,1,18,true,5,4,-1,41.98359,-87.66916
KA1504000152,1,18,true,16,19,3,41.98403,-87.65231
15578,1,18,true,5,11,6,41.98405,-87.66027
15575,1,18,true,9,8,-1,41.98975,-87.66014
15571,1,18,true,8,13,5,41.99478,-87.66028
RP-009,1,18,true,3,6,3,42.00107,-87.66122
660,1,18,true,2,5,3,42.00458,-87.66143
KA1504000162,1,18,true,7,2,-5,42.00907,-87.67422
523,1,18,true,3,9,6,42.02089,-87.66505
596,1,18,true,6,4,-2,42.04822,-87.68348
KA1503000014,1,19,false,6,2,-4,41.7851,-87.60108
KA1503000074,1,19,false,2,5,3,41.79174,-87.58395
TA1308000009,1,19,false,4,7,3,41.79522,-87.58075
TA1307000164,1,19,false,5,5,0,41.79527,-87.59647
KA1503000059,1,19,false,5,5,0,41.79952,-87.58643
TA1309000037,1,19,false,7,5,-2,41.79957,-87.59474
KA1503000007,1,19,false,1,5,4,41.80242,-87.58689
13398,1,19,false,7,3,-4,41.80256,-87.59035
TA1308000035,1,19,false,3,8,5,41.80944,-87.59188
KA1503000004,1,19,false,10,5,-5,41.83127,-87.6088
15445,1,19,false,3,9,6,41.83453,-87.63183
TA1307000048,1,19,false,9,10,1,41.83855,-87.60821
13213,1,19,false,8,8,0,41.84171,-87.62694
TA1308000026,1,19,false,5,3,-2,41.85008,-87.63214
13075,1,19,false,9,5,-4,41.8531,-87.63192
15546,1,19,false,5,1,-4,41.85416,-87.61916
15545,1,19,false,4,6,2,41.85627,-87.61334
SL-013,1,19,false,5,2,-3,41.85659,-87.62755
13150,1,19,false,7,4,-3,41.85783,-87.62455
TA1307000124,1,19,false,4,5,1,41.86411,-87.62372
WL-008,1,19,false,3,5,2,41.86712,-87.64108
TA1305000002,1,19,false,16,10,-6,41.86721,-87.62597
15544,1,19,false,9,13,4,41.86723,-87.61536
SL-005,1,19,false,16,29,13,41.8679,-87.62304
15550,1,19,false,5,4,-1,41.87024,-87.63947
TA1309000010,1,19,false,8,10,2,41.87074,-87.62574
SL-009,1,19,false,5,4,-1,41.87081,-87.63121
TA1307000121,1,19,false,5,6,1,41.87184,-87.64664
SL-008,1,19,false,12,14,2,41.87209,-87.62956
13332,1,19,false,6,11,5,41.87219,-87.6615
SL-011,1,19,false,9,5,-4,41.87256,-87.63356
623,1,19,false,14,15,1,41.87272,-87.62399
SL-007,1,19,false,2,5,3,41.87404,-87.6277
15541,1,19,false,23,16,-7,41.8758,-87.62086
TA1305000010,1,19,false,10,3,-7,41.87623,-87.62444
624,1,19,false,5,3,-2,41.87626,-87.62923
TA1305000035,1,19,false,5,3,-2,41.87716,-87.62787
13158,1,19,false,5,4,-1,41.87764,-87.64957
13157,1,19,false,5,7,2,41.87773,-87.6548
TA1305000025,1,19,false,10,13,3,41.87773,-87.63528
TA1309000002,1,19,false,12,11,-1,41.87784,-87.62408
TA1309000007,1,19,false,6,1,-5,41.88022,-87.63526
WL-011,1,19,false,6,7,1,41.88034,-87.64273
13156,1,19,false,2,7,5,41.88042,-87.65554
13300,1,19,false,23,27,4,41.88097,-87.61675
13008,1,19,false,34,28,-6,41.88105,-87.62408
TA1305000006,1,19,false,8,8,0,41.88122,-87.6296
TA1307000120,1,19,false,10,16,6,41.88188,-87.64879
13036,1,19,false,10,11,1,41.8821,-87.62513
TA1305000032,1,19,false,6,5,-1,41.88218,-87.64109
13353,1,19,false,4,7,3,41.88283,-87.6612
13409,1,19,false,6,4,-2,41.8831,-87.6511
13053,1,19,false,5,13,8,41.88365,-87.64863
13001,1,19,false,22,16,-6,41.88397,-87.62459
18062,1,19,false,1,5,4,41.88412,-87.65427
TA1306000010,1,19,false,12,9,-3,41.88419,-87.62961
15535,1,19,false,10,9,-1,41.8846,-87.64455
TA1305000029,1,19,false,6,21,15,41.88466,-87.62787
13263,1,19,false,20,16,-4,41.88467,-87.61952
TA1306000015,1,19,false,7,7,0,41.88549,-87.65232
13021,1,19,false,11,7,-4,41.88559,-87.64184
KA1503000012,1,19,false,7,9,2,41.88599,-87.63089
TA1305000011,1,19,false,12,17,5,41.886,-87.62418
15534,1,19,false,6,4,-2,41.88627,-87.61749
TA1308000029,1,19,false,3,5,2,41.88673,-87.62225
TA1307000131,1,19,false,14,14,0,41.88688,-87.62606
KA1503000064,1,19,false,29,20,-9,41.88697,-87.61281
TA1305000022,1,19,false,10,10,0,41.88817,-87.63656
TA1306000003,1,19,false,7,12,5,41.88867,-87.64442
KA1503000043,1,19,false,9,5,-4,41.88918,-87.63851
13050,1,19,false,10,11,1,41.88919,-87.62775
TA1307000151,1,19,false,10,6,-4,41.88993,-87.63427
13427,1,19,false,11,5,-6,41.89054,-87.62205
13430,1,19,false,18,17,-1,41.89077,-87.63169
TA1306000013,1,19,false,21,24,3,41.89083,-87.61852
RN-,1,19,false,11,11,0,41.89102,-87.63546
13434,1,19,false,5,2,-3,41.89108,-87.66663
TA1307000117,1,19,false,26,23,-3,41.89144,-87.62675
13033,1,19,false,2,15,13,41.8916,-87.64835
TA1305000003,1,19,false,10,14,4,41.89187,-87.62061
13022,1,19,false,103,83,-20,41.89227,-87.61205
TA1306000029,1,19,false,19,17,-2,41.89256,-87.61449
13265,1,19,false,4,5,1,41.89383,-87.64172
13045,1,19,false,12,12,0,41.89403,-87.62931
13016,1,19,false,14,12,-2,41.89431,-87.62277
KA1503000041,1,19,false,6,12,6,41.89452,-87.61798
13196,1,19,false,8,4,-4,41.89455,-87.65345
TA1306000012,1,19,false,12,23,11,41.89475,-87.63438
KP1705001026,1,19,false,7,6,-1,41.89483,-87.6323
13132,1,19,false,4,6,2,41.89573,-87.67718
15530,1,19,false,11,6,-5,41.89575,-87.62596
13247,1,19,false,2,7,5,41.89597,-87.66775
13289,1,19,false,8,2,-6,41.89638,-87.661
13303,1,19,false,9,7,-2,41.89672,-87.63088
13017,1,19,false,7,2,-5,41.89676,-87.6357
TA1307000061,1,19,false,9,7,-2,41.89745,-87.62873
13034,1,19,false,5,5,0,41.89754,-87.62352
620,1,19,false,5,4,-1,41.89817,-87.63754
15529,1,19,false,11,12,1,41.89858,-87.62206
TA1307000128,1,19,false,11,15,4,41.89896,-87.6299
13042,1,19,false,24,36,12,41.90097,-87.62377
TA1307000070,1,19,false,7,2,-5,41.90133,-87.67742
KA1504000133,1,19,false,19,9,-10,41.90234,-87.62773
TA1307000039,1,19,false,18,20,2,41.90294,-87.63137
TA1305000034,1,19,false,5,6,1,41.90313,-87.67391
KA1504000135,1,19,false,16,26,10,41.90319,-87.63439
13136,1,19,false,5,3,-2,41.90326,-87.67845
13061,1,19,false,19,13,-6,41.90342,-87.66779
KA1504000079,1,19,false,7,7,0,41.9035,-87.64334
TA1308000049,1,19,false,16,30,14,41.90672,-87.6349
KA1504000134,1,19,false,7,6,-1,41.90687,-87.6262
13224,1,19,false,4,9,5,41.90706,-87.66725
TA1307000143,1,19,false,1,5,4,41.90762,-87.63854
13221,1,19,false,9,7,-2,41.90765,-87.67254
TA1309000024,1,19,false,10,10,0,41.908,-87.63152
TA1305000041,1,19,false,10,11,1,41.9094,-87.67769
331,1,19,false,10,2,-8,41.90965,-87.64812
TA1305000037,1,19,false,3,13,10,41.91018,-87.67003
TA1306000008,1,19,false,5,6,1,41.9102,-87.6435
13154,1,19,false,12,7,-5,41.91054,-87.65312
13058,1,19,false,9,3,-6,41.91059,-87.64942
TA1307000038,1,19,false,10,13,3,41.91138,-87.63868
LF-005,1,19,false,62,95,33,41.91172,-87.62681
13128,1,19,false,8,8,0,41.91197,-87.63197
TA1308000050,1,19,false,21,22,1,41.91211,-87.6347
TA1306000032,1,19,false,8,8,0,41.9137,-87.65285
TA1307000166,1,19,false,7,7,0,41.91386,-87.64877
18017,1,19,false,10,8,-2,41.91416,-87.71676
18067,1,19,false,8,6,-2,41.9146,-87.66796
13179,1,19,false,28,28,0,41.9157,-87.63461
TA1307000163,1,19,false,4,5,1,41.91821,-87.65696
13146,1,19,false,17,23,6,41.91831,-87.63629
13059,1,19,false,12,12,0,41.91845,-87.65222
13192,1,19,false,7,21,14,41.91995,-87.64884
13288,1,19,false,3,5,2,41.92008,-87.67788
TA1309000030,1,19,false,8,11,3,41.92077,-87.66372
13292,1,19,false,5,1,-4,41.92152,-87.70733
TA1309000033,1,19,false,12,10,-2,41.92158,-87.65381
13193,1,19,false,14,17,3,41.92182,-87.64412
13191,1,19,false,6,6,0,41.92217,-87.63891
13084,1,19,false,7,4,-3,41.92268,-87.69715
LP-,1,19,false,7,8,1,41.92396,-87.63584
TA1307000001,1,19,false,2,6,4,41.92535,-87.66581
TA1306000026,1,19,false,3,5,2,41.92558,-87.65842
TA1306000016,1,19,false,6,3,-3,41.9256,-87.65371
TA1309000019,1,19,false,8,20,12,41.92586,-87.63897
TA1309000058,1,19,false,11,11,0,41.92591,-87.64927
TA1308000001,1,19,false,29,37,8,41.92627,-87.63086
13124,1,19,false,7,5,-2,41.92675,-87.63444
TA1309000023,1,19,false,7,9,2,41.9287,-87.65383
TA1307000113,1,19,false,6,8,2,41.92878,-87.66391
13296,1,19,false,3,12,9,41.92883,-87.66852
TA1309000061,1,19,false,3,17,14,41.92915,-87.64909
TA1305000014,1,19,false,13,15,2,41.92956,-87.64313
13085,1,19,false,4,6,2,41.92958,-87.70789
TA1307000142,1,19,false,16,7,-9,41.93125,-87.64432
13276,1,19,false,24,23,-1,41.93132,-87.63874
TA1307000064,1,19,false,7,6,-1,41.93222,-87.65864
TA1306000014,1,19,false,8,10,2,41.93242,-87.65271
TA1309000039,1,19,false,9,13,4,41.93258,-87.63642
TA1309000036,1,19,false,11,15,4,41.93313,-87.64776
TA1307000006,1,19,false,3,6,3,41.93571,-87.6636
13268,1,19,false,11,2,-9,41.93588,-87.67843
TA1307000052,1,19,false,7,16,9,41.93628,-87.65266
TA1307000136,1,19,false,9,3,-6,41.9365,-87.64755
TA1307000041,1,19,false,15,16,1,41.93669,-87.63683
13137,1,19,false,12,24,12,41.9376,-87.6441
TA1309000042,1,19,false,5,1,-4,41.93937,-87.66836
13229,1,19,false,6,7,1,41.93946,-87.66376
TA1308000019,1,19,false,5,7,2,41.93973,-87.65886
13277,1,19,false,4,10,6,41.9401,-87.64546
TA1307000134,1,19,false,12,22,10,41.94016,-87.65303
TA1309000049,1,19,false,8,6,-2,41.94077,-87.63919
TA1307000138,1,19,false,5,1,-4,41.94334,-87.67094
TA1309000025,1,19,false,6,12,6,41.94368,-87.64894
13071,1,19,false,9,5,-4,41.94373,-87.66401
632,1,19,false,7,7,0,41.94453,-87.6547
13278,1,19,false,16,9,-7,41.94553,-87.64644
13235,1,19,false,5,6,1,41.94814,-87.66396
13325,1,19,false,9,9,0,41.94907,-87.64863
TA1307000126,1,19,false,7,32,25,41.94936,-87.65451
TA1307000150,1,19,false,8,14,6,41.94945,-87.64646
13319,1,19,false,5,4,-1,41.95069,-87.6687
TA1307000127,1,19,false,7,10,3,41.9508,-87.65918
13323,1,19,false,11,9,-2,41.95282,-87.65
13063,1,19,false,13,8,-5,41.95424,-87.65441
TA1308000022,1,19,false,7,6,-1,41.95438,-87.64805
13379,1,19,false,8,14,6,41.95786,-87.6495
13389,1,19,false,3,6,3,41.961,-87.64958
TA1307000144,1,19,false,5,2,-3,41.96142,-87.6762
TA1307000107,1,19,false,4,5,1,41.96164,-87.65464
TA1308000012,1,19,false,27,21,-6,41.96398,-87.63818
13074,1,19,false,2,7,5,41.96521,-87.6582
639,1,19,false,6,5,-1,41.96584,-87.64538
TA1307000119,1,19,false,2,7,5,41.96796,-87.65
TA1309000066,1,19,false,7,2,-5,41.9691,-87.67423
TA1309000041,1,19,false,1,6,5,41.96951,-87.65471
TA1309000035,1,19,false,2,5,3,41.97335,-87.66785
KA1504000152,1,19,false,11,12,1,41.98403,-87.65231
15578,1,19,false,9,3,-6,41.98405,-87.66027
15575,1,19,false,2,8,6,41.98975,-87.66014
15571,1,19,false,6,6,0,41.99478,-87.66028
KA1504000175,1,19,false,5,2,-3,42.00797,-87.66549
E002,1,19,false,5,4,-1,42.03256,-87.67912
596,1,19,false,8,6,-2,42.04822,-87.68348
E008,1,19,false,3,7,4,42.05049,-87.67782
TA1309000063,1,19,true,2,5,3,41.79325,-87.5878
TA1308000009,1,19,true,5,5,0,41.79522,-87.58075
TA1307000164,1,19,true,6,4,-2,41.79527,-87.59647
TA1309000037,1,19,true,15,12,-3,41.79957,-87.59474
KA1503000007,1,19,true,3,8,5,41.80242,-87.58689
13217,1,19,true,2,8,6,41.83488,-87.61792
13215,1,19,true,4,7,3,41.83634,-87.6135
TA1309000055,1,19,true,8,6,-2,41.8382,-87.64514
KA1503000038,1,19,true,5,2,-3,41.83845,-87.6354
TA1307000048,1,19,true,18,13,-5,41.83855,-87.60821
TA1308000036,1,19,true,5,7,2,41.83883,-87.62186
TA1307000139,1,19,true,5,10,5,41.84205,-87.61698
TA1307000005,1,19,true,6,3,-3,41.84569,-87.6225
13075,1,19,true,8,5,-3,41.8531,-87.63192
13091,1,19,true,4,6,2,41.85409,-87.68585
13089,1,19,true,3,5,2,41.85497,-87.67567
15545,1,19,true,11,17,6,41.85627,-87.61334
SL-006,1,19,true,2,7,5,41.8568,-87.63387
13135,1,19,true,10,6,-4,41.85753,-87.66157
13102,1,19,true,4,5,1,41.85762,-87.61942
13150,1,19,true,4,8,4,41.85783,-87.62455
13099,1,19,true,1,6,5,41.85784,-87.64627
SL-012,1,19,true,6,12,6,41.86038,-87.62581
TA1306000002,1,19,true,3,5,2,41.86238,-87.65108
TA1307000124,1,19,true,10,5,-5,41.86411,-87.62372
TA1309000001,1,19,true,2,6,4,41.86488,-87.64708
13354,1,19,true,7,2,-5,41.86524,-87.66651
13431,1,19,true,5,5,0,41.8661,-87.60728
WL-008,1,19,true,8,6,-2,41.86712,-87.64108
TA1305000002,1,19,true,11,15,4,41.86721,-87.62597
15544,1,19,true,6,3,-3,41.86723,-87.61536
KA1706005007,1,19,true,9,4,-5,41.86749,-87.63219
SL-005,1,19,true,8,23,15,41.8679,-87.62304
13160,1,19,true,7,5,-2,41.86947,-87.65548
15550,1,19,true,7,6,-1,41.87024,-87.63947
TA1309000010,1,19,true,13,14,1,41.87074,-87.62574
TA1309000064,1,19,true,3,8,5,41.87127,-87.67369
TA1307000130,1,19,true,6,8,2,41.87178,-87.65103
TA1307000121,1,19,true,13,1,-12,41.87184,-87.64664
SL-008,1,19,true,20,11,-9,41.87209,-87.62956
13332,1,19,true,21,19,-2,41.87219,-87.6615
SL-011,1,19,true,5,5,0,41.87256,-87.63356
623,1,19,true,6,6,0,41.87272,-87.62399
KA1504000104,1,19,true,12,1,-11,41.87296,-87.66912
SL-007,1,19,true,6,5,-1,41.87404,-87.6277
13326,1,19,true,6,1,-5,41.87425,-87.63958
TA1306000025,1,19,true,7,7,0,41.87464,-87.65703
13028,1,19,true,10,14,4,41.87475,-87.64981
SL-010,1,19,true,2,7,5,41.87501,-87.63309
15541,1,19,true,7,6,-1,41.8758,-87.62086
15539,1,19,true,7,8,1,41.87763,-87.64405
13158,1,19,true,18,12,-6,41.87764,-87.64957
13157,1,19,true,11,9,-2,41.87773,-87.6548
TA1305000025,1,19,true,13,8,-5,41.87773,-87.63528
638,1,19,true,10,6,-4,41.87827,-87.64078
TA1309000007,1,19,true,17,3,-14,41.88022,-87.63526
WL-011,1,19,true,12,11,-1,41.88034,-87.64273
13156,1,19,true,7,12,5,41.88042,-87.65554
13300,1,19,true,16,14,-2,41.88097,-87.61675
13008,1,19,true,16,7,-9,41.88105,-87.62408
TA1305000006,1,19,true,6,3,-3,41.88122,-87.6296
TA1307000120,1,19,true,19,18,-1,41.88188,-87.64879
13341,1,19,true,8,5,-3,41.88208,-87.63985
13036,1,19,true,9,5,-4,41.8821,-87.62513
TA1305000032,1,19,true,16,19,3,41.88218,-87.64109
13006,1,19,true,4,5,1,41.88268,-87.63252
13353,1,19,true,10,7,-3,41.88283,-87.6612
13409,1,19,true,5,8,3,41.8831,-87.6511
WL-012,1,19,true,6,4,-2,41.88337,-87.6412
13053,1,19,true,20,7,-13,41.88365,-87.64863
13001,1,19,true,10,7,-3,41.88397,-87.62459
18062,1,19,true,10,10,0,41.88412,-87.65427
TA1306000010,1,19,true,19,11,-8,41.88419,-87.62961
15535,1,19,true,9,7,-2,41.8846,-87.64455
TA1305000029,1,19,true,19,6,-13,41.88466,-87.62787
13263,1,19,true,17,24,7,41.88467,-87.61952
TA1306000015,1,19,true,9,4,-5,41.88549,-87.65232
13021,1,19,true,10,14,4,41.88559,-87.64184
TA1307000111,1,19,true,6,6,0,41.88582,-87.63548
KA1503000012,1,19,true,12,6,-6,41.88599,-87.63089
TA1305000011,1,19,true,13,14,1,41.886,-87.62418
15534,1,19,true,8,9,1,41.88627,-87.61749
TA1308000029,1,19,true,7,2,-5,41.88673,-87.62225
TA1307000131,1,19,true,12,10,-2,41.88688,-87.62606
KA1503000064,1,19,true,8,12,4,41.88697,-87.61281
TA1305000022,1,19,true,18,18,0,41.88817,-87.63656
TA1306000003,1,19,true,21,24,3,41.88867,-87.64442
KA1503000043,1,19,true,53,28,-25,41.88918,-87.63851
13050,1,19,true,14,17,3,41.88919,-87.62775
TA1307000151,1,19,true,6,10,4,41.88993,-87.63427
636,1,19,true,11,12,1,41.88997,-87.63662
KA1503000044,1,19,true,6,2,-4,41.89018,-87.6262
13430,1,19,true,20,8,-12,41.89077,-87.63169
TA1306000013,1,19,true,11,19,8,41.89083,-87.61852
RN-,1,19,true,9,14,5,41.89102,-87.63546
13434,1,19,true,4,6,2,41.89108,-87.66663
TA1307000117,1,19,true,15,20,5,41.89144,-87.62675
13033,1,19,true,9,15,6,41.8916,-87.64835
13194,1,19,true,7,4,-3,41.8918,-87.65878
TA1305000003,1,19,true,12,13,1,41.89187,-87.62061
13022,1,19,true,19,20,1,41.89227,-87.61205
TA1306000029,1,19,true,10,20,10,41.89256,-87.61449
13265,1,19,true,17,17,0,41.89383,-87.64172
13045,1,19,true,25,28,3,41.89403,-87.62931
13016,1,19,true,23,12,-11,41.89431,-87.62277
KA1503000041,1,19,true,15,8,-7,41.89452,-87.61798
13196,1,19,true,5,7,2,41.89455,-87.65345
TA1307000062,1,19,true,8,16,8,41.89466,-87.63839
TA1306000012,1,19,true,35,37,2,41.89475,-87.63438
KP1705001026,1,19,true,11,7,-4,41.89483,-87.6323
13132,1,19,true,10,11,1,41.89573,-87.67718
15530,1,19,true,8,15,7,41.89575,-87.62596
13247,1,19,true,11,12,1,41.89597,-87.66775
TA1305000020,1,19,true,9,12,3,41.89636,-87.65406
13289,1,19,true,3,15,12,41.89638,-87.661
13303,1,19,true,15,12,-3,41.89672,-87.63088
13017,1,19,true,6,9,3,41.89676,-87.6357
13338,1,19,true,12,4,-8,41.89697,-87.62173
TA1307000061,1,19,true,9,4,-5,41.89745,-87.62873
13034,1,19,true,6,1,-5,41.89754,-87.62352
TA1306000009,1,19,true,7,6,-1,41.89772,-87.64299
620,1,19,true,9,12,3,41.89817,-87.63754
KA1504000103,1,19,true,4,7,3,41.89842,-87.68659
15529,1,19,true,14,9,-5,41.89858,-87.62206
TA1307000128,1,19,true,20,22,2,41.89896,-87.6299
13248,1,19,true,5,6,1,41.89964,-87.66788
TA1306000011,1,19,true,5,10,5,41.89994,-87.63443
KA1504000116,1,19,true,8,6,-2,41.90023,-87.64299
13290,1,19,true,3,10,7,41.90069,-87.66259
13042,1,19,true,28,15,-13,41.90097,-87.62377
KA1504000133,1,19,true,18,17,-1,41.90234,-87.62773
13241,1,19,true,2,6,4,41.9029,-87.68731
TA1306000006,1,19,true,6,7,1,41.90292,-87.63772
TA1307000039,1,19,true,43,49,6,41.90294,-87.63137
658,1,19,true,6,4,-2,41.903,-87.6838
TA1305000034,1,19,true,2,6,4,41.90313,-87.67391
KA1504000135,1,19,true,31,45,14,41.90319,-87.63439
13136,1,19,true,6,11,5,41.90326,-87.67845
13061,1,19,true,15,12,-3,41.90342,-87.66779
KA1504000079,1,19,true,9,16,7,41.9035,-87.64334
TA1307000115,1,19,true,6,4,-2,41.9046,-87.64056
TA1308000049,1,19,true,16,27,11,41.90672,-87.6349
KA1504000134,1,19,true,8,16,8,41.90687,-87.6262
13224,1,19,true,5,6,1,41.90706,-87.66725
TA1307000143,1,19,true,3,7,4,41.90762,-87.63854
13221,1,19,true,19,18,-1,41.90765,-87.67254
TA1309000024,1,19,true,14,18,4,41.908,-87.63152
TA1305000041,1,19,true,13,9,-4,41.9094,-87.67769
331,1,19,true,21,14,-7,41.90965,-87.64812
TA1305000037,1,19,true,8,12,4,41.91018,-87.67003
TA1306000008,1,19,true,10,16,6,41.9102,-87.6435
TA1308000005,1,19,true,3,7,4,41.91042,-87.68238
13154,1,19,true,17,7,-10,41.91054,-87.65312
13058,1,19,true,16,9,-7,41.91059,-87.64942
TA1307000038,1,19,true,12,20,8,41.91138,-87.63868
LF-005,1,19,true,71,94,23,41.91172,-87.62681
13128,1,19,true,7,17,10,41.91197,-87.63197
TA1308000050,1,19,true,26,42,16,41.91211,-87.6347
13243,1,19,true,7,12,5,41.91262,-87.6814
TA1306000032,1,19,true,17,14,-3,41.9137,-87.65285
TA1307000166,1,19,true,3,11,8,41.91386,-87.64877
TA1306000007,1,19,true,6,7,1,41.91469,-87.64333
13068,1,19,true,5,5,0,41.91554,-87.68703
13179,1,19,true,30,34,4,41.9157,-87.63461
13133,1,19,true,2,6,4,41.91598,-87.67733
TA1305000039,1,19,true,4,5,1,41.9163,-87.66749
13266,1,19,true,4,9,5,41.91774,-87.69142
TA1309000006,1,19,true,5,3,-2,41.91809,-87.64375
TA1307000163,1,19,true,9,6,-3,41.91821,-87.65696
13146,1,19,true,22,24,2,41.91831,-87.63629
13059,1,19,true,14,19,5,41.91845,-87.65222
13192,1,19,true,13,14,1,41.91995,-87.64884
13288,1,19,true,2,8,6,41.92008,-87.67788
TA1309000030,1,19,true,6,13,7,41.92077,-87.66372
TA1309000033,1,19,true,27,15,-12,41.92158,-87.65381
13193,1,19,true,13,26,13,41.92182,-87.64412
13191,1,19,true,6,11,5,41.92217,-87.63891
13084,1,19,true,3,14,11,41.92268,-87.69715
LP-,1,19,true,11,14,3,41.92396,-87.63584
TA1307000001,1,19,true,6,9,3,41.92535,-87.66581
TA1306000026,1,19,true,15,13,-2,41.92558,-87.65842
TA1306000016,1,19,true,6,8,2,41.9256,-87.65371
TA1309000019,1,19,true,20,29,9,41.92586,-87.63897
TA1309000058,1,19,true,22,18,-4,41.92591,-87.64927
TA1308000001,1,19,true,33,26,-7,41.92627,-87.63086
13124,1,19,true,1,6,5,41.92675,-87.63444
TA1309000023,1,19,true,15,12,-3,41.9287,-87.65383
TA1307000113,1,19,true,4,11,7,41.92878,-87.66391
13296,1,19,true,5,8,3,41.92883,-87.66852
TA1309000059,1,19,true,4,8,4,41.92889,-87.65898
TA1309000061,1,19,true,14,15,1,41.92915,-87.64909
TA1305000014,1,19,true,24,29,5,41.92956,-87.64313
TA1307000142,1,19,true,20,21,1,41.93125,-87.64432
13276,1,19,true,15,15,0,41.93132,-87.63874
13271,1,19,true,5,4,-1,41.93192,-87.67784
TA1307000064,1,19,true,9,9,0,41.93222,-87.65864
TA1306000014,1,19,true,15,23,8,41.93242,-87.65271
TA1309000039,1,19,true,18,17,-1,41.93258,-87.63642
13294,1,19,true,4,6,2,41.9326,-87.66595
TA1309000036,1,19,true,20,25,5,41.93313,-87.64776
TA1307000006,1,19,true,8,16,8,41.93571,-87.6636
13269,1,19,true,5,5,0,41.93609,-87.66983
TA1307000052,1,19,true,12,25,13,41.93628,-87.65266
TA1307000136,1,19,true,16,19,3,41.9365,-87.64755
TA1307000041,1,19,true,20,21,1,41.93669,-87.63683
13137,1,19,true,35,26,-9,41.9376,-87.6441
KA17018068,1,19,true,1,8,7,41.93935,-87.68327
TA1309000042,1,19,true,13,9,-4,41.93937,-87.66836
13229,1,19,true,2,12,10,41.93946,-87.66376
TA1308000019,1,19,true,11,9,-2,41.93973,-87.65886
13277,1,19,true,7,15,8,41.9401,-87.64546
TA1307000134,1,19,true,20,22,2,41.94016,-87.65303
TA1309000049,1,19,true,18,24,6,41.94077,-87.63919
TA1307000138,1,19,true,11,12,1,41.94334,-87.67094
13144,1,19,true,1,5,4,41.9434,-87.67964
TA1309000025,1,19,true,12,12,0,41.94368,-87.64894
13071,1,19,true,19,16,-3,41.94373,-87.66401
632,1,19,true,16,9,-7,41.94453,-87.6547
13278,1,19,true,16,25,9,41.94553,-87.64644
13235,1,19,true,17,12,-5,41.94814,-87.66396
13325,1,19,true,18,19,1,41.94907,-87.64863
TA1307000126,1,19,true,6,25,19,41.94936,-87.65451
TA1307000150,1,19,true,25,35,10,41.94945,-87.64646
13319,1,19,true,1,8,7,41.95069,-87.6687
TA1307000127,1,19,true,5,13,8,41.9508,-87.65918
13323,1,19,true,8,6,-2,41.95282,-87.65
13063,1,19,true,11,8,-3,41.95424,-87.65441
TA1308000022,1,19,true,10,12,2,41.95438,-87.64805
TA1307000149,1,19,true,4,11,7,41.95467,-87.67392
TA1309000026,1,19,true,4,5,1,41.95601,-87.6802
TA1308000047,1,19,true,1,6,5,41.95709,-87.6642
13379,1,19,true,10,14,4,41.95786,-87.6495
TA1309000027,1,19,true,5,10,5,41.9585,-87.65499
13389,1,19,true,5,9,4,41.961,-87.64958
15622,1,19,true,6,4,-2,41.96108,-87.69544
TA1307000144,1,19,true,6,3,-3,41.96142,-87.6762
15623,1,19,true,4,8,4,41.96154,-87.69117
TA1307000107,1,19,true,12,19,7,41.96164,-87.65464
TA1307000156,1,19,true,6,3,-3,41.96301,-87.68479
TA1308000012,1,19,true,28,14,-14,41.96398,-87.63818
13074,1,19,true,7,6,-1,41.96521,-87.6582
639,1,19,true,7,7,0,41.96584,-87.64538
TA1307000140,1,19,true,3,5,2,41.96643,-87.68865
TA1309000014,1,19,true,14,9,-5,41.96709,-87.66744
TA1307000158,1,19,true,3,9,6,41.9671,-87.67904
TA1309000066,1,19,true,15,2,-13,41.9691,-87.67423
TA1309000041,1,19,true,9,3,-6,41.96951,-87.65471
KA1504000171,1,19,true,6,9,3,41.97161,-87.65016
TA1309000035,1,19,true,6,12,6,41.97335,-87.66785
13108,1,19,true,6,4,-2,41.97379,-87.65971
KA1504000149,1,19,true,1,10,9,41.97562,-87.67945
KA1504000146,1,19,true,4,7,3,41.978,-87.66805
13109,1,19,true,5,7,2,41.97835,-87.65976
KA1504000152,1,19,true,13,15,2,41.98403,-87.65231
15578,1,19,true,5,9,4,41.98405,-87.66027
15575,1,19,true,5,10,5,41.98975,-87.66014
15571,1,19,true,9,7,-2,41.99478,-87.66028
RP-008,1,19,true,5,4,-1,42.00446,-87.6724
660,1,19,true,3,8,5,42.00458,-87.66143
KA1503000021,1,20,false,6,4,-2,41.77888,-87.58665
KA1503000014,1,20,false,5,7,2,41.7851,-87.60108
561,1,20,false,8,8,0,41.7857,-87.67409
TA1308000009,1,20,false,15,13,-2,41.79522,-87.58075
TA1307000164,1,20,false,3,7,4,41.79527,-87.59647
TA1309000037,1,20,false,10,6,-4,41.79957,-87.59474
KA1503000007,1,20,false,2,7,5,41.80242,-87.58689
TA1308000002,1,20,false,1,5,4,41.80983,-87.59937
KA1503000004,1,20,false,2,5,3,41.83127,-87.6088
13345,1,20,false,5,2,-3,41.83138,-87.61803
TA1307000048,1,20,false,11,8,-3,41.83855,-87.60821
13075,1,20,false,7,10,3,41.8531,-87.63192
15545,1,20,false,5,4,-1,41.85627,-87.61334
SL-013,1,20,false,5,5,0,41.85659,-87.62755
13102,1,20,false,3,5,2,41.85762,-87.61942
SL-012,1,20,false,6,5,-1,41.86038,-87.62581
TA1307000124,1,20,false,5,9,4,41.86411,-87.62372
13431,1,20,false,12,15,3,41.8661,-87.60728
TA1305000002,1,20,false,12,13,1,41.86721,-87.62597
15544,1,20,false,10,3,-7,41.86723,-87.61536
SL-005,1,20,false,21,26,5,41.8679,-87.62304
13160,1,20,false,4,5,1,41.86947,-87.65548
TA1309000010,1,20,false,6,14,8,41.87074,-87.62574
SL-008,1,20,false,9,8,-1,41.87209,-87.62956
SL-011,1,20,false,1,11,10,41.87256,-87.63356
623,1,20,false,20,11,-9,41.87272,-87.62399
SL-010,1,20,false,3,5,2,41.87501,-87.63309
15541,1,20,false,14,26,12,41.8758,-87.62086
13158,1,20,false,5,5,0,41.87764,-87.64957
TA1309000002,1,20,false,8,10,2,41.87784,-87.62408
TA1309000008,1,20,false,2,6,4,41.87933,-87.6355
KA1503000034,1,20,false,1,5,4,41.87938,-87.63197
13156,1,20,false,5,6,1,41.88042,-87.65554
13300,1,20,false,23,19,-4,41.88097,-87.61675
13008,1,20,false,24,38,14,41.88105,-87.62408
13036,1,20,false,5,9,4,41.8821,-87.62513
TA1305000032,1,20,false,5,5,0,41.88218,-87.64109
WL-012,1,20,false,4,5,1,41.88337,-87.6412
13053,1,20,false,14,15,1,41.88365,-87.64863
13001,1,20,false,15,14,-1,41.88397,-87.62459
TA1306000010,1,20,false,2,8,6,41.88419,-87.62961
15535,1,20,false,6,3,-3,41.8846,-87.64455
TA1305000029,1,20,false,4,14,10,41.88466,-87.62787
13263,1,20,false,13,12,-1,41.88467,-87.61952
KA1503000012,1,20,false,6,12,6,41.88599,-87.63089
TA1305000011,1,20,false,18,7,-11,41.886,-87.62418
15534,1,20,false,1,6,5,41.88627,-87.61749
TA1308000029,1,20,false,4,7,3,41.88673,-87.62225
TA1307000131,1,20,false,16,8,-8,41.88688,-87.62606
KA1503000064,1,20,false,13,9,-4,41.88697,-87.61281
TA1305000022,1,20,false,6,3,-3,41.88817,-87.63656
TA1306000003,1,20,false,8,6,-2,41.88867,-87.64442
KA1503000043,1,20,false,5,5,0,41.88918,-87.63851
13050,1,20,false,2,8,6,41.88919,-87.62775
13427,1,20,false,8,4,-4,41.89054,-87.62205
13430,1,20,false,7,26,19,41.89077,-87.63169
TA1306000013,1,20,false,11,16,5,41.89083,-87.61852
RN-,1,20,false,3,8,5,41.89102,-87.63546
TA1307000117,1,20,false,13,15,2,41.89144,-87.62675
TA1305000003,1,20,false,6,6,0,41.89187,-87.62061
13022,1,20,false,62,55,-7,41.89227,-87.61205
TA1306000029,1,20,false,14,8,-6,41.89256,-87.61449
13265,1,20,false,3,11,8,41.89383,-87.64172
13045,1,20,false,6,11,5,41.89403,-87.62931
13016,1,20,false,4,19,15,41.89431,-87.62277
KA1503000041,1,20,false,6,13,7,41.89452,-87.61798
TA1307000062,1,20,false,2,5,3,41.89466,-87.63839
TA1306000012,1,20,false,11,6,-5,41.89475,-87.63438
KP1705001026,1,20,false,5,3,-2,41.89483,-87.6323
13132,1,20,false,3,5,2,41.89573,-87.67718
15530,1,20,false,7,9,2,41.89575,-87.62596
TA1305000020,1,20,false,10,3,-7,41.89636,-87.65406
13289,1,20,false,5,8,3,41.89638,-87.661
13303,1,20,false,3,11,8,41.89672,-87.63088
13338,1,20,false,5,4,-1,41.89697,-87.62173
KA1504000103,1,20,false,1,5,4,41.89842,-87.68659
15529,1,20,false,5,8,3,41.89858,-87.62206
TA1307000128,1,20,false,6,5,-1,41.89896,-87.6299
TA1306000011,1,20,false,5,3,-2,41.89994,-87.63443
13042,1,20,false,16,27,11,41.90097,-87.62377
KA1504000133,1,20,false,6,13,7,41.90234,-87.62773
TA1307000039,1,20,false,12,27,15,41.90294,-87.63137
KA1504000135,1,20,false,6,10,4,41.90319,-87.63439
13136,1,20,false,5,4,-1,41.90326,-87.67845
13061,1,20,false,6,9,3,41.90342,-87.66779
KA1504000079,1,20,false,8,6,-2,41.9035,-87.64334
TA1308000049,1,20,false,15,17,2,41.90672,-87.6349
KA1504000134,1,20,false,3,7,4,41.90687,-87.6262
13224,1,20,false,8,7,-1,41.90706,-87.66725
TA1307000143,1,20,false,2,5,3,41.90762,-87.63854
13221,1,20,false,10,17,7,41.90765,-87.67254
TA1309000024,1,20,false,8,7,-1,41.908,-87.63152
TA1305000041,1,20,false,5,14,9,41.9094,-87.67769
331,1,20,false,3,6,3,41.90965,-87.64812
TA1305000037,1,20,false,3,10,7,41.91018,-87.67003
TA1306000008,1,20,false,5,2,-3,41.9102,-87.6435
TA1308000005,1,20,false,3,10,7,41.91042,-87.68238
TA1307000038,1,20,false,5,9,4,41.91138,-87.63868
LF-005,1,20,false,80,21,-59,41.91172,-87.62681
13128,1,20,false,10,5,-5,41.91197,-87.63197
TA1308000050,1,20,false,20,18,-2,41.91211,-87.6347
13243,1,20,false,1,7,6,41.91262,-87.6814
18017,1,20,false,5,4,-1,41.91416,-87.71676
18067,1,20,false,1,5,4,41.9146,-87.66796
13179,1,20,false,20,16,-4,41.9157,-87.63461
13146,1,20,false,13,12,-1,41.91831,-87.63629
13059,1,20,false,6,7,1,41.91845,-87.65222
13192,1,20,false,5,2,-3,41.91995,-87.64884
TA1309000030,1,20,false,13,4,-9,41.92077,-87.66372
TA1309000033,1,20,false,7,5,-2,41.92158,-87.65381
13193,1,20,false,5,10,5,41.92182,-87.64412
13191,1,20,false,5,5,0,41.92217,-87.63891
LP-,1,20,false,2,6,4,41.92396,-87.63584
TA1307000001,1,20,false,7,1,-6,41.92535,-87.66581
TA1306000026,1,20,false,5,3,-2,41.92558,-87.65842
TA1309000019,1,20,false,10,12,2,41.92586,-87.63897
TA1309000058,1,20,false,11,14,3,41.92591,-87.64927
TA1308000001,1,20,false,20,12,-8,41.92627,-87.63086
13124,1,20,false,12,8,-4,41.92675,-87.63444
TA1309000023,1,20,false,5,9,4,41.9287,-87.65383
13296,1,20,false,3,7,4,41.92883,-87.66852
TA1309000061,1,20,false,3,7,4,41.92915,-87.64909
TA1308000031,1,20,false,5,1,-4,41.92946,-87.68417
TA1305000014,1,20,false,5,13,8,41.92956,-87.64313
13085,1,20,false,6,4,-2,41.92958,-87.70789
TA1307000142,1,20,false,5,15,10,41.93125,-87.64432
13276,1,20,false,7,14,7,41.93132,-87.63874
TA1306000014,1,20,false,4,8,4,41.93242,-87.65271
TA1309000039,1,20,false,17,8,-9,41.93258,-87.63642
TA1307000006,1,20,false,5,3,-2,41.93571,-87.6636
TA1307000052,1,20,false,3,7,4,41.93628,-87.65266
TA1307000136,1,20,false,5,6,1,41.9365,-87.64755
TA1307000041,1,20,false,9,7,-2,41.93669,-87.63683
13137,1,20,false,6,11,5,41.9376,-87.6441
TA1308000019,1,20,false,5,11,6,41.93973,-87.65886
13277,1,20,false,7,2,-5,41.9401,-87.64546
TA1307000134,1,20,false,9,10,1,41.94016,-87.65303
TA1309000049,1,20,false,5,10,5,41.94077,-87.63919
TA1307000138,1,20,false,5,8,3,41.94334,-87.67094
TA1309000025,1,20,false,9,3,-6,41.94368,-87.64894
632,1,20,false,11,10,-1,41.94453,-87.6547
13278,1,20,false,1,6,5,41.94553,-87.64644
13235,1,20,false,3,5,2,41.94814,-87.66396
13325,1,20,false,7,5,-2,41.94907,-87.64863
TA1307000126,1,20,false,16,12,-4,41.94936,-87.65451
TA1307000150,1,20,false,6,6,0,41.94945,-87.64646
13319,1,20,false,3,6,3,41.95069,-87.6687
TA1307000127,1,20,false,6,8,2,41.9508,-87.65918
13323,1,20,false,2,5,3,41.95282,-87.65
TA1308000022,1,20,false,7,7,0,41.95438,-87.64805
13379,1,20,false,6,5,-1,41.95786,-87.6495
TA1309000027,1,20,false,3,5,2,41.9585,-87.65499
13389,1,20,false,3,9,6,41.961,-87.64958
TA1307000107,1,20,false,6,11,5,41.96164,-87.65464
TA1308000012,1,20,false,24,23,-1,41.96398,-87.63818
639,1,20,false,9,2,-7,41.96584,-87.64538
TA1307000119,1,20,false,1,5,4,41.96796,-87.65
TA1308000021,1,20,false,1,6,5,41.96883,-87.65765
KA1504000146,1,20,false,1,5,4,41.978,-87.66805
KA1504000152,1,20,false,5,10,5,41.98403,-87.65231
15575,1,20,false,2,6,4,41.98975,-87.66014
15571,1,20,false,1,6,5,41.99478,-87.66028
E002,1,20,false,2,5,3,42.03256,-87.67912
E008,1,20,false,5,2,-3,42.05049,-87.67782
TA1308000009,1,20,true,7,4,-3,41.79522,-87.58075
KA1503000052,1,20,true,5,5,0,41.79935,-87.60097
TA1309000037,1,20,true,11,10,-1,41.79957,-87.59474
KA1503000007,1,20,true,2,9,7,41.80242,-87.58689
13216,1,20,true,1,6,5,41.83473,-87.62581
13217,1,20,true,8,8,0,41.83488,-87.61792
TA1309000055,1,20,true,6,5,-1,41.8382,-87.64514
KA1503000038,1,20,true,4,10,6,41.83845,-87.6354
TA1307000048,1,20,true,11,7,-4,41.83855,-87.60821
TA1307000139,1,20,true,6,12,6,41.84205,-87.61698
13075,1,20,true,6,3,-3,41.8531,-87.63192
15545,1,20,true,12,8,-4,41.85627,-87.61334
13102,1,20,true,4,7,3,41.85762,-87.61942
TA1307000124,1,20,true,1,10,9,41.86411,-87.62372
13431,1,20,true,6,5,-1,41.8661,-87.60728
WL-008,1,20,true,10,5,-5,41.86712,-87.64108
TA1305000002,1,20,true,8,12,4,41.86721,-87.62597
15544,1,20,true,3,6,3,41.86723,-87.61536
SL-005,1,20,true,6,23,17,41.8679,-87.62304
13139,1,20,true,3,7,4,41.86893,-87.65913
13160,1,20,true,2,5,3,41.86947,-87.65548
15550,1,20,true,9,1,-8,41.87024,-87.63947
TA1309000010,1,20,true,8,7,-1,41.87074,-87.62574
TA1309000064,1,20,true,3,5,2,41.87127,-87.67369
TA1307000130,1,20,true,10,16,6,41.87178,-87.65103
TA1307000121,1,20,true,13,2,-11,41.87184,-87.64664
SL-008,1,20,true,9,11,2,41.87209,-87.62956
13332,1,20,true,10,15,5,41.87219,-87.6615
SL-011,1,20,true,3,9,6,41.87256,-87.63356
15668,1,20,true,5,2,-3,41.87471,-87.68642
13028,1,20,true,2,8,6,41.87475,-87.64981
624,1,20,true,7,2,-5,41.87626,-87.62923
15539,1,20,true,6,7,1,41.87763,-87.64405
13158,1,20,true,4,13,9,41.87764,-87.64957
13157,1,20,true,5,6,1,41.87773,-87.6548
TA1305000025,1,20,true,4,5,1,41.87773,-87.63528
WL-011,1,20,true,7,8,1,41.88034,-87.64273
13156,1,20,true,5,3,-2,41.88042,-87.65554
13300,1,20,true,13,8,-5,41.88097,-87.61675
13008,1,20,true,12,2,-10,41.88105,-87.62408
TA1305000006,1,20,true,5,5,0,41.88122,-87.6296
TA1307000120,1,20,true,8,14,6,41.88188,-87.64879
13036,1,20,true,5,5,0,41.8821,-87.62513
TA1305000032,1,20,true,13,18,5,41.88218,-87.64109
13353,1,20,true,8,4,-4,41.88283,-87.6612
13409,1,20,true,3,7,4,41.8831,-87.6511
13053,1,20,true,15,8,-7,41.88365,-87.64863
18062,1,20,true,3,6,3,41.88412,-87.65427
TA1306000010,1,20,true,10,2,-8,41.88419,-87.62961
15535,1,20,true,4,6,2,41.8846,-87.64455
TA1305000029,1,20,true,9,3,-6,41.88466,-87.62787
13263,1,20,true,4,11,7,41.88467,-87.61952
TA1306000015,1,20,true,5,6,1,41.88549,-87.65232
13021,1,20,true,8,6,-2,41.88559,-87.64184
KA1503000012,1,20,true,11,5,-6,41.88599,-87.63089
TA1305000011,1,20,true,7,6,-1,41.886,-87.62418
TA1307000131,1,20,true,4,6,2,41.88688,-87.62606
KA1503000064,1,20,true,8,9,1,41.88697,-87.61281
TA1305000022,1,20,true,11,7,-4,41.88817,-87.63656
TA1306000003,1,20,true,18,15,-3,41.88867,-87.64442
KA1503000043,1,20,true,18,19,1,41.88918,-87.63851
13050,1,20,true,11,10,-1,41.88919,-87.62775
TA1307000151,1,20,true,3,7,4,41.88993,-87.63427
636,1,20,true,6,3,-3,41.88997,-87.63662
13427,1,20,true,8,6,-2,41.89054,-87.62205
13430,1,20,true,9,11,2,41.89077,-87.63169
TA1306000013,1,20,true,6,14,8,41.89083,-87.61852
RN-,1,20,true,10,13,3,41.89102,-87.63546
TA1307000117,1,20,true,14,19,5,41.89144,-87.62675
13033,1,20,true,4,12,8,41.8916,-87.64835
TA1305000003,1,20,true,11,9,-2,41.89187,-87.62061
13022,1,20,true,11,7,-4,41.89227,-87.61205
TA1306000029,1,20,true,8,11,3,41.89256,-87.61449
13265,1,20,true,6,12,6,41.89383,-87.64172
13045,1,20,true,14,18,4,41.89403,-87.62931
13016,1,20,true,10,3,-7,41.89431,-87.62277
KA1503000041,1,20,true,8,6,-2,41.89452,-87.61798
TA1307000062,1,20,true,2,7,5,41.89466,-87.63839
TA1306000012,1,20,true,19,17,-2,41.89475,-87.63438
KP1705001026,1,20,true,5,8,3,41.89483,-87.6323
15530,1,20,true,7,7,0,41.89575,-87.62596
TA1305000020,1,20,true,5,5,0,41.89636,-87.65406
13289,1,20,true,2,15,13,41.89638,-87.661
13303,1,20,true,3,5,2,41.89672,-87.63088
13017,1,20,true,5,4,-1,41.89676,-87.6357
13338,1,20,true,4,10,6,41.89697,-87.62173
TA1307000061,1,20,true,6,1,-5,41.89745,-87.62873
TA1306000009,1,20,true,8,1,-7,41.89772,-87.64299
620,1,20,true,7,12,5,41.89817,-87.63754
15529,1,20,true,8,7,-1,41.89858,-87.62206
TA1307000128,1,20,true,7,10,3,41.89896,-87.6299
657,1,20,true,4,5,1,41.89918,-87.6722
13248,1,20,true,3,9,6,41.89964,-87.66788
TA1306000011,1,20,true,2,5,3,41.89994,-87.63443
13290,1,20,true,6,7,1,41.90069,-87.66259
13042,1,20,true,12,5,-7,41.90097,-87.62377
KA1504000133,1,20,true,6,7,1,41.90234,-87.62773
TA1306000006,1,20,true,4,10,6,41.90292,-87.63772
TA1307000039,1,20,true,24,21,-3,41.90294,-87.63137
TA1305000034,1,20,true,5,6,1,41.90313,-87.67391
KA1504000135,1,20,true,18,23,5,41.90319,-87.63439
13061,1,20,true,6,19,13,41.90342,-87.66779
KA1504000079,1,20,true,4,7,3,41.9035,-87.64334
TA1307000115,1,20,true,1,6,5,41.9046,-87.64056
TA1308000049,1,20,true,8,18,10,41.90672,-87.6349
KA1504000134,1,20,true,3,8,5,41.90687,-87.6262
13224,1,20,true,2,5,3,41.90706,-87.66725
13221,1,20,true,13,11,-2,41.90765,-87.67254
TA1309000024,1,20,true,11,11,0,41.908,-87.63152
TA1305000041,1,20,true,13,4,-9,41.9094,-87.67769
331,1,20,true,26,13,-13,41.90965,-87.64812
TA1306000008,1,20,true,1,6,5,41.9102,-87.6435
TA1308000005,1,20,true,2,10,8,41.91042,-87.68238
13257,1,20,true,3,5,2,41.91054,-87.68956
13154,1,20,true,12,9,-3,41.91054,-87.65312
13058,1,20,true,7,3,-4,41.91059,-87.64942
TA1307000038,1,20,true,9,14,5,41.91138,-87.63868
LF-005,1,20,true,102,19,-83,41.91172,-87.62681
13128,1,20,true,13,7,-6,41.91197,-87.63197
TA1308000050,1,20,true,29,18,-11,41.91211,-87.6347
13243,1,20,true,7,6,-1,41.91262,-87.6814
18067,1,20,true,5,2,-3,41.9146,-87.66796
13068,1,20,true,3,5,2,41.91554,-87.68703
13179,1,20,true,19,19,0,41.9157,-87.63461
13133,1,20,true,1,5,4,41.91598,-87.67733
TA1307000163,1,20,true,4,5,1,41.91821,-87.65696
13146,1,20,true,18,23,5,41.91831,-87.63629
13059,1,20,true,9,5,-4,41.91845,-87.65222
13192,1,20,true,18,7,-11,41.91995,-87.64884
13288,1,20,true,4,5,1,41.92008,-87.67788
TA1309000030,1,20,true,12,8,-4,41.92077,-87.66372
TA1309000033,1,20,true,9,11,2,41.92158,-87.65381
13193,1,20,true,16,15,-1,41.92182,-87.64412
13191,1,20,true,6,9,3,41.92217,-87.63891
LP-,1,20,true,7,6,-1,41.92396,-87.63584
TA1307000001,1,20,true,3,12,9,41.92535,-87.66581
TA1306000026,1,20,true,5,4,-1,41.92558,-87.65842
TA1306000016,1,20,true,6,6,0,41.9256,-87.65371
TA1309000019,1,20,true,10,24,14,41.92586,-87.63897
TA1309000058,1,20,true,11,16,5,41.92591,-87.64927
TA1308000001,1,20,true,30,20,-10,41.92627,-87.63086
TA1309000023,1,20,true,3,8,5,41.9287,-87.65383
TA1307000113,1,20,true,7,4,-3,41.92878,-87.66391
TA1309000061,1,20,true,10,9,-1,41.92915,-87.64909
TA1305000014,1,20,true,11,21,10,41.92956,-87.64313
13085,1,20,true,4,7,3,41.92958,-87.70789
TA1307000142,1,20,true,17,22,5,41.93125,-87.64432
13276,1,20,true,8,14,6,41.93132,-87.63874
TA1307000064,1,20,true,5,17,12,41.93222,-87.65864
TA1306000014,1,20,true,9,10,1,41.93242,-87.65271
TA1309000039,1,20,true,11,15,4,41.93258,-87.63642
13294,1,20,true,3,7,4,41.9326,-87.66595
TA1309000036,1,20,true,12,10,-2,41.93313,-87.64776
TA1307000006,1,20,true,1,9,8,41.93571,-87.6636
TA1307000052,1,20,true,4,5,1,41.93628,-87.65266
TA1307000136,1,20,true,10,10,0,41.9365,-87.64755
TA1307000041,1,20,true,8,11,3,41.93669,-87.63683
13137,1,20,true,17,17,0,41.9376,-87.6441
TA1309000042,1,20,true,8,3,-5,41.93937,-87.66836
13229,1,20,true,10,7,-3,41.93946,-87.66376
TA1308000019,1,20,true,5,14,9,41.93973,-87.65886
13277,1,20,true,5,10,5,41.9401,-87.64546
TA1307000134,1,20,true,12,16,4,41.94016,-87.65303
TA1309000049,1,20,true,8,11,3,41.94077,-87.63919
TA1307000138,1,20,true,6,10,4,41.94334,-87.67094
TA1309000025,1,20,true,15,22,7,41.94368,-87.64894
13071,1,20,true,11,5,-6,41.94373,-87.66401
632,1,20,true,7,12,5,41.94453,-87.6547
13278,1,20,true,5,20,15,41.94553,-87.64644
15632,1,20,true,11,8,-3,41.94664,-87.69463
13235,1,20,true,7,5,-2,41.94814,-87.66396
13325,1,20,true,6,11,5,41.94907,-87.64863
TA1307000126,1,20,true,4,17,13,41.94936,-87.65451
TA1307000150,1,20,true,14,9,-5,41.94945,-87.64646
TA1307000127,1,20,true,9,13,4,41.9508,-87.65918
13323,1,20,true,6,13,7,41.95282,-87.65
TA1309000043,1,20,true,5,4,-1,41.95417,-87.66434
13063,1,20,true,7,6,-1,41.95424,-87.65441
TA1308000022,1,20,true,3,14,11,41.95438,-87.64805
TA1307000149,1,20,true,6,8,2,41.95467,-87.67392
TA1309000026,1,20,true,3,5,2,41.95601,-87.6802
13379,1,20,true,7,12,5,41.95786,-87.6495
TA1307000144,1,20,true,2,8,6,41.96142,-87.6762
15623,1,20,true,5,5,0,41.96154,-87.69117
TA1307000107,1,20,true,8,15,7,41.96164,-87.65464
TA1308000012,1,20,true,31,5,-26,41.96398,-87.63818
13074,1,20,true,6,8,2,41.96521,-87.6582
639,1,20,true,7,3,-4,41.96584,-87.64538
TA1309000014,1,20,true,4,5,1,41.96709,-87.66744
TA1307000119,1,20,true,1,5,4,41.96796,-87.65
TA1309000066,1,20,true,7,9,2,41.9691,-87.67423
KA1504000171,1,20,true,5,2,-3,41.97161,-87.65016
TA1309000035,1,20,true,5,5,0,41.97335,-87.66785
13108,1,20,true,5,5,0,41.97379,-87.65971
KA1504000146,1,20,true,7,3,-4,41.978,-87.66805
13109,1,20,true,3,6,3,41.97835,-87.65976
KA1504000152,1,20,true,6,15,9,41.98403,-87.65231
15575,1,20,true,3,9,6,41.98975,-87.66014
660,1,20,true,1,8,7,42.00458,-87.66143
KA1503000014,1,21,false,7,7,0,41.7851,-87.60108
TA1308000009,1,21,false,3,13,10,41.79522,-87.58075
TA1308000038,1,21,false,2,6,4,41.82298,-87.6071
TA1307000048,1,21,false,5,9,4,41.83855,-87.60821
TA1305000004,1,21,false,1,6,5,41.8514,-87.61884
13075,1,21,false,7,10,3,41.8531,-87.63192
13431,1,21,false,6,15,9,41.8661,-87.60728
TA1305000002,1,21,false,4,13,9,41.86721,-87.62597
SL-005,1,21,false,13,7,-6,41.8679,-87.62304
TA1309000010,1,21,false,10,14,4,41.87074,-87.62574
SL-009,1,21,false,8,3,-5,41.87081,-87.63121
SL-008,1,21,false,5,11,6,41.87209,-87.62956
SL-011,1,21,false,5,6,1,41.87256,-87.63356
623,1,21,false,14,18,4,41.87272,-87.62399
SL-007,1,21,false,2,13,11,41.87404,-87.6277
15541,1,21,false,30,24,-6,41.8758,-87.62086
TA1305000010,1,21,false,2,8,6,41.87623,-87.62444
TA1305000035,1,21,false,2,8,6,41.87716,-87.62787
13157,1,21,false,6,2,-4,41.87773,-87.6548
TA1305000025,1,21,false,6,5,-1,41.87773,-87.63528
TA1309000002,1,21,false,6,13,7,41.87784,-87.62408
13300,1,21,false,20,20,0,41.88097,-87.61675
13008,1,21,false,19,17,-2,41.88105,-87.62408
TA1305000006,1,21,false,2,6,4,41.88122,-87.6296
13036,1,21,false,3,7,4,41.8821,-87.62513
TA1305000032,1,21,false,4,7,3,41.88218,-87.64109
13353,1,21,false,10,1,-9,41.88283,-87.6612
WL-012,1,21,false,4,7,3,41.88337,-87.6412
13053,1,21,false,10,7,-3,41.88365,-87.64863
13001,1,21,false,5,8,3,41.88397,-87.62459
TA1305000030,1,21,false,1,7,6,41.88459,-87.63178
TA1305000029,1,21,false,5,8,3,41.88466,-87.62787
13263,1,21,false,6,4,-2,41.88467,-87.61952
TA1306000015,1,21,false,4,5,1,41.88549,-87.65232
TA1305000011,1,21,false,13,5,-8,41.886,-87.62418
15534,1,21,false,2,5,3,41.88627,-87.61749
TA1308000029,1,21,false,1,5,4,41.88673,-87.62225
TA1307000131,1,21,false,8,8,0,41.88688,-87.62606
TA1306000003,1,21,false,4,6,2,41.88867,-87.64442
KA1503000043,1,21,false,6,10,4,41.88918,-87.63851
13050,1,21,false,6,3,-3,41.88919,-87.62775
TA1307000151,1,21,false,8,8,0,41.88993,-87.63427
13427,1,21,false,7,2,-5,41.89054,-87.62205
13430,1,21,false,15,8,-7,41.89077,-87.63169
TA1306000013,1,21,false,12,17,5,41.89083,-87.61852
RN-,1,21,false,6,5,-1,41.89102,-87.63546
TA1307000117,1,21,false,23,20,-3,41.89144,-87.62675
TA1305000003,1,21,false,9,9,0,41.89187,-87.62061
13022,1,21,false,54,27,-27,41.89227,-87.61205
13265,1,21,false,3,7,4,41.89383,-87.64172
13045,1,21,false,8,5,-3,41.89403,-87.62931
KA1503000041,1,21,false,4,6,2,41.89452,-87.61798
TA1306000012,1,21,false,12,6,-6,41.89475,-87.63438
15530,1,21,false,11,9,-2,41.89575,-87.62596
TA1305000020,1,21,false,1,5,4,41.89636,-87.65406
TA1307000128,1,21,false,2,6,4,41.89896,-87.6299
13042,1,21,false,15,7,-8,41.90097,-87.62377
KA1504000133,1,21,false,12,6,-6,41.90234,-87.62773
TA1307000039,1,21,false,15,21,6,41.90294,-87.63137
TA1305000034,1,21,false,6,2,-4,41.90313,-87.67391
KA1504000135,1,21,false,12,13,1,41.90319,-87.63439
13061,1,21,false,3,6,3,41.90342,-87.66779
TA1308000049,1,21,false,19,13,-6,41.90672,-87.6349
KA1504000134,1,21,false,1,6,5,41.90687,-87.6262
13221,1,21,false,5,5,0,41.90765,-87.67254
TA1309000024,1,21,false,6,12,6,41.908,-87.63152
TA1305000041,1,21,false,8,4,-4,41.9094,-87.67769
331,1,21,false,9,3,-6,41.90965,-87.64812
TA1307000038,1,21,false,14,6,-8,41.91138,-87.63868
LF-005,1,21,false,14,8,-6,41.91172,-87.62681
13128,1,21,false,10,6,-4,41.91197,-87.63197
TA1308000050,1,21,false,19,11,-8,41.91211,-87.6347
TA1306000032,1,21,false,1,6,5,41.9137,-87.65285
TA1307000166,1,21,false,5,2,-3,41.91386,-87.64877
15655,1,21,false,7,1,-6,41.91401,-87.70514
13179,1,21,false,34,17,-17,41.9157,-87.63461
15651,1,21,false,1,5,4,41.91752,-87.70181
13266,1,21,false,5,4,-1,41.91774,-87.69142
TA1309000029,1,21,false,1,6,5,41.9178,-87.68245
TA1307000163,1,21,false,4,7,3,41.91821,-87.65696
13146,1,21,false,23,10,-13,41.91831,-87.63629
13059,1,21,false,5,12,7,41.91845,-87.65222
13192,1,21,false,6,6,0,41.91995,-87.64884
13292,1,21,false,2,5,3,41.92152,-87.70733
TA1309000033,1,21,false,7,3,-4,41.92158,-87.65381
13193,1,21,false,8,6,-2,41.92182,-87.64412
13191,1,21,false,5,5,0,41.92217,-87.63891
13084,1,21,false,7,6,-1,41.92268,-87.69715
LP-,1,21,false,2,5,3,41.92396,-87.63584
TA1306000026,1,21,false,4,7,3,41.92558,-87.65842
TA1306000016,1,21,false,9,3,-6,41.9256,-87.65371
TA1309000019,1,21,false,7,10,3,41.92586,-87.63897
TA1309000058,1,21,false,5,9,4,41.92591,-87.64927
TA1308000001,1,21,false,11,11,0,41.92627,-87.63086
13124,1,21,false,2,11,9,41.92675,-87.63444
TA1309000023,1,21,false,6,6,0,41.9287,-87.65383
TA1307000113,1,21,false,8,5,-3,41.92878,-87.66391
TA1309000061,1,21,false,9,1,-8,41.92915,-87.64909
TA1305000014,1,21,false,13,9,-4,41.92956,-87.64313
TA1307000142,1,21,false,2,11,9,41.93125,-87.64432
13276,1,21,false,3,11,8,41.93132,-87.63874
TA1307000064,1,21,false,8,9,1,41.93222,-87.65864
TA1306000014,1,21,false,5,11,6,41.93242,-87.65271
TA1309000039,1,21,false,5,3,-2,41.93258,-87.63642
13294,1,21,false,5,3,-2,41.9326,-87.66595
TA1309000036,1,21,false,2,5,3,41.93313,-87.64776
TA1307000006,1,21,false,4,7,3,41.93571,-87.6636
TA1307000052,1,21,false,10,2,-8,41.93628,-87.65266
TA1307000136,1,21,false,7,8,1,41.9365,-87.64755
TA1307000041,1,21,false,5,8,3,41.93669,-87.63683
13137,1,21,false,7,10,3,41.9376,-87.6441
TA1309000042,1,21,false,3,6,3,41.93937,-87.66836
TA1308000019,1,21,false,8,3,-5,41.93973,-87.65886
13277,1,21,false,10,11,1,41.9401,-87.64546
TA1307000134,1,21,false,5,4,-1,41.94016,-87.65303
TA1309000049,1,21,false,6,8,2,41.94077,-87.63919
TA1309000025,1,21,false,4,14,10,41.94368,-87.64894
13071,1,21,false,7,4,-3,41.94373,-87.66401
632,1,21,false,9,5,-4,41.94453,-87.6547
13278,1,21,false,6,10,4,41.94553,-87.64644
13235,1,21,false,6,4,-2,41.94814,-87.66396
TA1307000126,1,21,false,37,12,-25,41.94936,-87.65451
TA1307000150,1,21,false,5,13,8,41.94945,-87.64646
TA1307000127,1,21,false,7,2,-5,41.9508,-87.65918
13323,1,21,false,3,11,8,41.95282,-87.65
13063,1,21,false,4,9,5,41.95424,-87.65441
13389,1,21,false,1,12,11,41.961,-87.64958
TA1307000107,1,21,false,11,11,0,41.96164,-87.65464
TA1309000035,1,21,false,2,6,4,41.97335,-87.66785
13108,1,21,false,2,5,3,41.97379,-87.65971
KA1504000146,1,21,false,6,2,-4,41.978,-87.66805
15578,1,21,false,1,5,4,41.98405,-87.66027
KA1503000014,1,21,true,3,8,5,41.7851,-87.60108
TA1309000037,1,21,true,6,5,-1,41.79957,-87.59474
15445,1,21,true,2,5,3,41.83453,-87.63183
TA1309000055,1,21,true,1,6,5,41.8382,-87.64514
13307,1,21,true,1,5,4,41.85489,-87.66359
13102,1,21,true,3,5,2,41.85762,-87.61942
13431,1,21,true,5,2,-3,41.8661,-87.60728
TA1305000002,1,21,true,8,12,4,41.86721,-87.62597
SL-005,1,21,true,3,5,2,41.8679,-87.62304
13160,1,21,true,8,7,-1,41.86947,-87.65548
TA1309000010,1,21,true,7,9,2,41.87074,-87.62574
13332,1,21,true,7,14,7,41.87219,-87.6615
SL-011,1,21,true,6,2,-4,41.87256,-87.63356
623,1,21,true,2,7,5,41.87272,-87.62399
15539,1,21,true,5,10,5,41.87763,-87.64405
13158,1,21,true,7,4,-3,41.87764,-87.64957
WL-011,1,21,true,3,6,3,41.88034,-87.64273
13300,1,21,true,10,2,-8,41.88097,-87.61675
TA1305000032,1,21,true,5,10,5,41.88218,-87.64109
13409,1,21,true,4,7,3,41.8831,-87.6511
13053,1,21,true,10,11,1,41.88365,-87.64863
13001,1,21,true,7,3,-4,41.88397,-87.62459
TA1305000030,1,21,true,5,1,-4,41.88459,-87.63178
15535,1,21,true,7,14,7,41.8846,-87.64455
13263,1,21,true,2,5,3,41.88467,-87.61952
TA1307000111,1,21,true,5,1,-4,41.88582,-87.63548
KA1503000012,1,21,true,7,4,-3,41.88599,-87.63089
TA1305000011,1,21,true,4,8,4,41.886,-87.62418
TA1305000022,1,21,true,3,6,3,41.88817,-87.63656
TA1306000003,1,21,true,14,12,-2,41.88867,-87.64442
KA1503000043,1,21,true,15,10,-5,41.88918,-87.63851
13050,1,21,true,7,5,-2,41.88919,-87.62775
TA1307000151,1,21,true,8,3,-5,41.88993,-87.63427
KA1503000044,1,21,true,7,2,-5,41.89018,-87.6262
13427,1,21,true,2,7,5,41.89054,-87.62205
13430,1,21,true,12,4,-8,41.89077,-87.63169
TA1306000013,1,21,true,2,8,6,41.89083,-87.61852
RN-,1,21,true,9,2,-7,41.89102,-87.63546
TA1307000117,1,21,true,14,7,-7,41.89144,-87.62675
13033,1,21,true,4,7,3,41.8916,-87.64835
13194,1,21,true,5,4,-1,41.8918,-87.65878
TA1305000003,1,21,true,4,9,5,41.89187,-87.62061
13022,1,21,true,9,7,-2,41.89227,-87.61205
TA1306000029,1,21,true,5,4,-1,41.89256,-87.61449
13265,1,21,true,2,14,12,41.89383,-87.64172
13045,1,21,true,5,8,3,41.89403,-87.62931
KA1503000041,1,21,true,7,11,4,41.89452,-87.61798
13196,1,21,true,4,6,2,41.89455,-87.65345
TA1307000062,1,21,true,3,6,3,41.89466,-87.63839
TA1306000012,1,21,true,11,14,3,41.89475,-87.63438
KP1705001026,1,21,true,7,2,-5,41.89483,-87.6323
15530,1,21,true,5,8,3,41.89575,-87.62596
13289,1,21,true,4,7,3,41.89638,-87.661
13303,1,21,true,6,4,-2,41.89672,-87.63088
TA1307000061,1,21,true,5,9,4,41.89745,-87.62873
15529,1,21,true,1,11,10,41.89858,-87.62206
TA1307000128,1,21,true,4,7,3,41.89896,-87.6299
TA1306000011,1,21,true,1,5,4,41.89994,-87.63443
KA1504000116,1,21,true,2,7,5,41.90023,-87.64299
13290,1,21,true,2,7,5,41.90069,-87.66259
13042,1,21,true,4,7,3,41.90097,-87.62377
KA1504000133,1,21,true,2,6,4,41.90234,-87.62773
TA1307000039,1,21,true,22,14,-8,41.90294,-87.63137
KA1504000135,1,21,true,12,6,-6,41.90319,-87.63439
13061,1,21,true,7,9,2,41.90342,-87.66779
TA1308000049,1,21,true,19,6,-13,41.90672,-87.6349
KA1504000134,1,21,true,6,6,0,41.90687,-87.6262
13221,1,21,true,7,10,3,41.90765,-87.67254
TA1309000024,1,21,true,11,10,-1,41.908,-87.63152
TA1305000041,1,21,true,5,11,6,41.9094,-87.67769
331,1,21,true,9,6,-3,41.90965,-87.64812
TA1305000037,1,21,true,5,4,-1,41.91018,-87.67003
TA1306000008,1,21,true,1,8,7,41.9102,-87.6435
TA1308000005,1,21,true,4,5,1,41.91042,-87.68238
LF-005,1,21,true,12,14,2,41.91172,-87.62681
TA1308000050,1,21,true,28,11,-17,41.91211,-87.6347
13243,1,21,true,5,5,0,41.91262,-87.6814
TA1306000032,1,21,true,3,8,5,41.9137,-87.65285
TA1307000166,1,21,true,8,7,-1,41.91386,-87.64877
13179,1,21,true,20,6,-14,41.9157,-87.63461
TA1309000029,1,21,true,2,6,4,41.9178,-87.68245
TA1309000006,1,21,true,2,8,6,41.91809,-87.64375
TA1307000163,1,21,true,5,7,2,41.91821,-87.65696
13146,1,21,true,20,14,-6,41.91831,-87.63629
13059,1,21,true,2,6,4,41.91845,-87.65222
13192,1,21,true,2,5,3,41.91995,-87.64884
TA1309000030,1,21,true,7,3,-4,41.92077,-87.66372
TA1309000033,1,21,true,5,11,6,41.92158,-87.65381
13193,1,21,true,11,4,-7,41.92182,-87.64412
13191,1,21,true,4,9,5,41.92217,-87.63891
TA1306000026,1,21,true,4,7,3,41.92558,-87.65842
TA1309000019,1,21,true,8,10,2,41.92586,-87.63897
TA1309000058,1,21,true,10,15,5,41.92591,-87.64927
TA1308000001,1,21,true,6,4,-2,41.92627,-87.63086
TA1309000023,1,21,true,4,9,5,41.9287,-87.65383
TA1307000113,1,21,true,10,4,-6,41.92878,-87.66391
TA1309000061,1,21,true,6,6,0,41.92915,-87.64909
TA1305000014,1,21,true,7,12,5,41.92956,-87.64313
TA1307000142,1,21,true,7,6,-1,41.93125,-87.64432
13276,1,21,true,6,9,3,41.93132,-87.63874
TA1307000064,1,21,true,3,5,2,41.93222,-87.65864
TA1306000014,1,21,true,9,13,4,41.93242,-87.65271
TA1309000036,1,21,true,8,8,0,41.93313,-87.64776
TA1307000052,1,21,true,10,8,-2,41.93628,-87.65266
TA1307000136,1,21,true,4,11,7,41.9365,-87.64755
TA1307000041,1,21,true,5,9,4,41.93669,-87.63683
13137,1,21,true,19,16,-3,41.9376,-87.6441
TA1309000042,1,21,true,3,5,2,41.93937,-87.66836
TA1308000019,1,21,true,3,7,4,41.93973,-87.65886
TA1307000134,1,21,true,7,14,7,41.94016,-87.65303
TA1309000049,1,21,true,9,4,-5,41.94077,-87.63919
TA1309000025,1,21,true,8,9,1,41.94368,-87.64894
13071,1,21,true,12,4,-8,41.94373,-87.66401
632,1,21,true,6,10,4,41.94453,-87.6547
13278,1,21,true,11,14,3,41.94553,-87.64644
13235,1,21,true,8,8,0,41.94814,-87.66396
13325,1,21,true,4,6,2,41.94907,-87.64863
TA1307000126,1,21,true,12,6,-6,41.94936,-87.65451
TA1307000150,1,21,true,4,8,4,41.94945,-87.64646
13323,1,21,true,5,3,-2,41.95282,-87.65
13063,1,21,true,5,3,-2,41.95424,-87.65441
13379,1,21,true,3,5,2,41.95786,-87.6495
TA1309000027,1,21,true,2,8,6,41.9585,-87.65499
13389,1,21,true,2,11,9,41.961,-87.64958
TA1309000021,1,21,true,6,2,-4,41.9615,-87.6714
TA1307000107,1,21,true,8,9,1,41.96164,-87.65464
TA1309000066,1,21,true,7,3,-4,41.9691,-87.67423
TA1309000041,1,21,true,2,5,3,41.96951,-87.65471
KA1504000149,1,21,true,11,2,-9,41.97562,-87.67945
KA1503000065,1,22,false,1,6,5,41.81409,-87.59701
13215,1,22,false,7,3,-4,41.83634,-87.6135
TA1307000048,1,22,false,4,8,4,41.83855,-87.60821
SL-012,1,22,false,2,6,4,41.86038,-87.62581
13029,1,22,false,5,4,-1,41.86531,-87.6179
TA1305000002,1,22,false,7,7,0,41.86721,-87.62597
SL-005,1,22,false,4,20,16,41.8679,-87.62304
TA1309000010,1,22,false,14,9,-5,41.87074,-87.62574
13332,1,22,false,7,3,-4,41.87219,-87.6615
SL-011,1,22,false,1,6,5,41.87256,-87.63356
623,1,22,false,11,19,8,41.87272,-87.62399
15541,1,22,false,14,13,-1,41.8758,-87.62086
TA1305000010,1,22,false,6,10,4,41.87623,-87.62444
13011,1,22,false,13,3,-10,41.87931,-87.63993
KA1503000015,1,22,false,5,3,-2,41.87948,-87.6257
WL-011,1,22,false,6,4,-2,41.88034,-87.64273
13300,1,22,false,12,22,10,41.88097,-87.61675
13008,1,22,false,12,14,2,41.88105,-87.62408
TA1305000006,1,22,false,4,7,3,41.88122,-87.6296
13036,1,22,false,13,2,-11,41.8821,-87.62513
13409,1,22,false,5,1,-4,41.8831,-87.6511
13053,1,22,false,9,1,-8,41.88365,-87.64863
13001,1,22,false,8,5,-3,41.88397,-87.62459
TA1306000010,1,22,false,6,3,-3,41.88419,-87.62961
15535,1,22,false,3,8,5,41.8846,-87.64455
TA1305000029,1,22,false,4,8,4,41.88466,-87.62787
TA1306000015,1,22,false,6,3,-3,41.88549,-87.65232
KA1503000012,1,22,false,7,3,-4,41.88599,-87.63089
TA1305000011,1,22,false,10,12,2,41.886,-87.62418
TA1308000029,1,22,false,4,5,1,41.88673,-87.62225
TA1307000131,1,22,false,12,18,6,41.88688,-87.62606
TA1305000022,1,22,false,4,9,5,41.88817,-87.63656
TA1306000003,1,22,false,13,13,0,41.88867,-87.64442
KA1503000043,1,22,false,6,6,0,41.88918,-87.63851
13050,1,22,false,4,5,1,41.88919,-87.62775
TA1307000151,1,22,false,6,4,-2,41.88993,-87.63427
13427,1,22,false,2,6,4,41.89054,-87.62205
TA1306000013,1,22,false,23,10,-13,41.89083,-87.61852
TA1307000117,1,22,false,8,9,1,41.89144,-87.62675
13033,1,22,false,5,1,-4,41.8916,-87.64835
TA1305000003,1,22,false,13,11,-2,41.89187,-87.62061
13022,1,22,false,20,25,5,41.89227,-87.61205
TA1306000029,1,22,false,4,11,7,41.89256,-87.61449
13045,1,22,false,13,11,-2,41.89403,-87.62931
13016,1,22,false,5,5,0,41.89431,-87.62277
KA1503000041,1,22,false,6,3,-3,41.89452,-87.61798
TA1306000012,1,22,false,1,11,10,41.89475,-87.63438
KP1705001026,1,22,false,2,7,5,41.89483,-87.6323
13132,1,22,false,6,3,-3,41.89573,-87.67718
15530,1,22,false,12,8,-4,41.89575,-87.62596
13289,1,22,false,1,6,5,41.89638,-87.661
13303,1,22,false,4,9,5,41.89672,-87.63088
13017,1,22,false,2,5,3,41.89676,-87.6357
TA1307000061,1,22,false,6,6,0,41.89745,-87.62873
TA1306000011,1,22,false,1,7,6,41.89994,-87.63443
KA1504000116,1,22,false,1,5,4,41.90023,-87.64299
13042,1,22,false,5,12,7,41.90097,-87.62377
KA1504000133,1,22,false,6,6,0,41.90234,-87.62773
TA1305000034,1,22,false,4,5,1,41.90313,-87.67391
KA1504000135,1,22,false,8,3,-5,41.90319,-87.63439
13061,1,22,false,5,6,1,41.90342,-87.66779
TA1308000049,1,22,false,10,6,-4,41.90672,-87.6349
13221,1,22,false,2,9,7,41.90765,-87.67254
TA1309000024,1,22,false,7,1,-6,41.908,-87.63152
TA1305000041,1,22,false,4,5,1,41.9094,-87.67769
TA1306000008,1,22,false,8,3,-5,41.9102,-87.6435
13058,1,22,false,1,5,4,41.91059,-87.64942
TA1307000038,1,22,false,1,8,7,41.91138,-87.63868
LF-005,1,22,false,3,6,3,41.91172,-87.62681
13128,1,22,false,15,3,-12,41.91197,-87.63197
TA1308000050,1,22,false,15,9,-6,41.91211,-87.6347
13179,1,22,false,22,15,-7,41.9157,-87.63461
13133,1,22,false,5,1,-4,41.91598,-87.67733
13146,1,22,false,6,3,-3,41.91831,-87.63629
13059,1,22,false,5,9,4,41.91845,-87.65222
TA1309000030,1,22,false,3,6,3,41.92077,-87.66372
TA1309000033,1,22,false,8,3,-5,41.92158,-87.65381
13193,1,22,false,7,2,-5,41.92182,-87.64412
13084,1,22,false,5,2,-3,41.92268,-87.69715
TA1306000016,1,22,false,5,1,-4,41.9256,-87.65371
TA1309000019,1,22,false,5,7,2,41.92586,-87.63897
TA1309000023,1,22,false,8,3,-5,41.9287,-87.65383
TA1307000113,1,22,false,2,5,3,41.92878,-87.66391
13296,1,22,false,10,3,-7,41.92883,-87.66852
TA1309000061,1,22,false,8,7,-1,41.92915,-87.64909
TA1305000014,1,22,false,8,6,-2,41.92956,-87.64313
TA1307000142,1,22,false,8,8,0,41.93125,-87.64432
TA1307000064,1,22,false,1,10,9,41.93222,-87.65864
TA1309000036,1,22,false,6,4,-2,41.93313,-87.64776
13268,1,22,false,1,8,7,41.93588,-87.67843
TA1307000052,1,22,false,7,4,-3,41.93628,-87.65266
TA1307000136,1,22,false,7,2,-5,41.9365,-87.64755
13137,1,22,false,5,8,3,41.9376,-87.6441
TA1308000019,1,22,false,12,14,2,41.93973,-87.65886
13277,1,22,false,2,9,7,41.9401,-87.64546
TA1307000134,1,22,false,17,8,-9,41.94016,-87.65303
TA1309000049,1,22,false,4,7,3,41.94077,-87.63919
TA1307000138,1,22,false,7,3,-4,41.94334,-87.67094
13071,1,22,false,10,3,-7,41.94373,-87.66401
632,1,22,false,9,14,5,41.94453,-87.6547
13278,1,22,false,2,7,5,41.94553,-87.64644
13235,1,22,false,10,2,-8,41.94814,-87.66396
13325,1,22,false,5,6,1,41.94907,-87.64863
TA1307000126,1,22,false,8,3,-5,41.94936,-87.65451
TA1307000150,1,22,false,7,3,-4,41.94945,-87.64646
TA1307000127,1,22,false,14,5,-9,41.9508,-87.65918
13323,1,22,false,2,8,6,41.95282,-87.65
13063,1,22,false,3,6,3,41.95424,-87.65441
13389,1,22,false,2,5,3,41.961,-87.64958
TA1307000107,1,22,false,3,6,3,41.96164,-87.65464
TA1308000012,1,22,false,3,9,6,41.96398,-87.63818
TA1309000014,1,22,false,5,2,-3,41.96709,-87.66744
KA1503000014,1,22,true,1,5,4,41.7851,-87.60108
TA1309000037,1,22,true,3,5,2,41.79957,-87.59474
TA1305000002,1,22,true,7,3,-4,41.86721,-87.62597
13160,1,22,true,1,5,4,41.86947,-87.65548
SL-009,1,22,true,1,5,4,41.87081,-87.63121
13332,1,22,true,1,8,7,41.87219,-87.6615
13158,1,22,true,2,5,3,41.87764,-87.64957
TA1305000032,1,22,true,8,8,0,41.88218,-87.64109
13409,1,22,true,5,4,-1,41.8831,-87.6511
13053,1,22,true,7,2,-5,41.88365,-87.64863
13263,1,22,true,6,3,-3,41.88467,-87.61952
TA1305000022,1,22,true,3,5,2,41.88817,-87.63656
KA1503000043,1,22,true,6,6,0,41.88918,-87.63851
TA1307000151,1,22,true,5,1,-4,41.88993,-87.63427
TA1307000117,1,22,true,7,2,-5,41.89144,-87.62675
13033,1,22,true,6,4,-2,41.8916,-87.64835
TA1305000003,1,22,true,5,1,-4,41.89187,-87.62061
13265,1,22,true,3,6,3,41.89383,-87.64172
13045,1,22,true,3,5,2,41.89403,-87.62931
13196,1,22,true,6,4,-2,41.89455,-87.65345
TA1306000012,1,22,true,8,9,1,41.89475,-87.63438
KP1705001026,1,22,true,9,1,-8,41.89483,-87.6323
TA1306000009,1,22,true,2,5,3,41.89772,-87.64299
TA1307000128,1,22,true,5,1,-4,41.89896,-87.6299
KA1504000133,1,22,true,3,6,3,41.90234,-87.62773
TA1307000039,1,22,true,5,12,7,41.90294,-87.63137
TA1305000034,1,22,true,3,5,2,41.90313,-87.67391
KA1504000135,1,22,true,8,5,-3,41.90319,-87.63439
13061,1,22,true,6,11,5,41.90342,-87.66779
TA1308000049,1,22,true,8,6,-2,41.90672,-87.6349
331,1,22,true,2,5,3,41.90965,-87.64812
TA1307000038,1,22,true,5,3,-2,41.91138,-87.63868
LF-005,1,22,true,6,3,-3,41.91172,-87.62681
13128,1,22,true,7,4,-3,41.91197,-87.63197
TA1308000050,1,22,true,15,6,-9,41.91211,-87.6347
13179,1,22,true,14,3,-11,41.9157,-87.63461
TA1305000039,1,22,true,8,1,-7,41.9163,-87.66749
TA1307000163,1,22,true,7,2,-5,41.91821,-87.65696
13146,1,22,true,15,4,-11,41.91831,-87.63629
13059,1,22,true,2,8,6,41.91845,-87.65222
13192,1,22,true,2,9,7,41.91995,-87.64884
TA1309000033,1,22,true,5,5,0,41.92158,-87.65381
13191,1,22,true,1,5,4,41.92217,-87.63891
TA1306000026,1,22,true,2,19,17,41.92558,-87.65842
TA1309000019,1,22,true,4,8,4,41.92586,-87.63897
TA1309000023,1,22,true,7,2,-5,41.9287,-87.65383
TA1309000061,1,22,true,3,9,6,41.92915,-87.64909
TA1307000142,1,22,true,6,8,2,41.93125,-87.64432
13276,1,22,true,1,5,4,41.93132,-87.63874
TA1306000014,1,22,true,9,6,-3,41.93242,-87.65271
TA1309000036,1,22,true,1,7,6,41.93313,-87.64776
TA1307000052,1,22,true,9,8,-1,41.93628,-87.65266
TA1307000041,1,22,true,4,7,3,41.93669,-87.63683
13137,1,22,true,3,9,6,41.9376,-87.6441
13229,1,22,true,2,5,3,41.93946,-87.66376
TA1308000019,1,22,true,6,5,-1,41.93973,-87.65886
13277,1,22,true,1,6,5,41.9401,-87.64546
TA1307000134,1,22,true,12,4,-8,41.94016,-87.65303
TA1309000049,1,22,true,2,7,5,41.94077,-87.63919
TA1309000025,1,22,true,7,6,-1,41.94368,-87.64894
632,1,22,true,11,7,-4,41.94453,-87.6547
13278,1,22,true,2,5,3,41.94553,-87.64644
13235,1,22,true,6,7,1,41.94814,-87.66396
13253,1,22,true,1,5,4,41.9488,-87.67527
13325,1,22,true,11,4,-7,41.94907,-87.64863
TA1307000126,1,22,true,2,7,5,41.94936,-87.65451
TA1307000127,1,22,true,7,2,-5,41.9508,-87.65918
13063,1,22,true,7,3,-4,41.95424,-87.65441
TA1309000026,1,22,true,6,2,-4,41.95601,-87.6802
13379,1,22,true,4,6,2,41.95786,-87.6495
TA1309000027,1,22,true,2,5,3,41.9585,-87.65499
TA1307000107,1,22,true,4,14,10,41.96164,-87.65464
TA1307000158,1,22,true,4,6,2,41.9671,-87.67904
TA1308000009,1,23,false,7,6,-1,41.79522,-87.58075
TA1307000164,1,23,false,6,7,1,41.79527,-87.59647
KA1503000004,1,23,false,3,6,3,41.83127,-87.6088
TA1305000002,1,23,false,5,8,3,41.86721,-87.62597
SL-005,1,23,false,14,14,0,41.8679,-87.62304
TA1309000010,1,23,false,5,16,11,41.87074,-87.62574
623,1,23,false,23,14,-9,41.87272,-87.62399
TA1305000010,1,23,false,3,7,4,41.87623,-87.62444
TA1309000002,1,23,false,2,5,3,41.87784,-87.62408
KA1503000015,1,23,false,6,4,-2,41.87948,-87.6257
13008,1,23,false,3,13,10,41.88105,-87.62408
13036,1,23,false,3,7,4,41.8821,-87.62513
13001,1,23,false,2,5,3,41.88397,-87.62459
18062,1,23,false,5,2,-3,41.88412,-87.65427
15535,1,23,false,6,3,-3,41.8846,-87.64455
TA1305000029,1,23,false,7,2,-5,41.88466,-87.62787
13263,1,23,false,3,5,2,41.88467,-87.61952
TA1306000015,1,23,false,20,1,-19,41.88549,-87.65232
TA1305000011,1,23,false,2,9,7,41.886,-87.62418
TA1307000131,1,23,false,15,9,-6,41.88688,-87.62606
TA1305000022,1,23,false,5,1,-4,41.88817,-87.63656
TA1306000003,1,23,false,2,5,3,41.88867,-87.64442
13050,1,23,false,6,1,-5,41.88919,-87.62775
13430,1,23,false,12,5,-7,41.89077,-87.63169
TA1306000013,1,23,false,4,5,1,41.89083,-87.61852
RN-,1,23,false,3,6,3,41.89102,-87.63546
TA1307000117,1,23,false,15,10,-5,41.89144,-87.62675
TA1305000003,1,23,false,7,9,2,41.89187,-87.62061
13022,1,23,false,4,5,1,41.89227,-87.61205
13045,1,23,false,7,9,2,41.89403,-87.62931
KA1503000041,1,23,false,1,7,6,41.89452,-87.61798
13303,1,23,false,4,5,1,41.89672,-87.63088
13017,1,23,false,7,4,-3,41.89676,-87.6357
620,1,23,false,7,12,5,41.89817,-87.63754
TA1306000011,1,23,false,8,1,-7,41.89994,-87.63443
TA1308000049,1,23,false,6,4,-2,41.90672,-87.6349
TA1305000041,1,23,false,5,11,6,41.9094,-87.67769
LF-005,1,23,false,6,1,-5,41.91172,-87.62681
TA1308000050,1,23,false,1,5,4,41.91211,-87.6347
18067,1,23,false,5,7,2,41.9146,-87.66796
13179,1,23,false,11,9,-2,41.9157,-87.63461
TA1309000033,1,23,false,6,3,-3,41.92158,-87.65381
TA1306000016,1,23,false,1,6,5,41.9256,-87.65371
TA1307000142,1,23,false,1,9,8,41.93125,-87.64432
13276,1,23,false,2,5,3,41.93132,-87.63874
TA1306000014,1,23,false,5,2,-3,41.93242,-87.65271
13137,1,23,false,8,2,-6,41.9376,-87.6441
TA1309000025,1,23,false,6,2,-4,41.94368,-87.64894
632,1,23,false,1,6,5,41.94453,-87.6547
TA1307000107,1,23,false,6,3,-3,41.96164,-87.65464
KA1504000146,1,23,false,7,3,-4,41.978,-87.66805
TA1307000164,1,23,true,5,2,-3,41.79527,-87.59647
TA1305000022,1,23,true,5,3,-2,41.88817,-87.63656
TA1306000003,1,23,true,2,5,3,41.88867,-87.64442
KA1503000043,1,23,true,5,4,-1,41.88918,-87.63851
13045,1,23,true,5,3,-2,41.89403,-87.62931
TA1306000012,1,23,true,5,2,-3,41.89475,-87.63438
TA1307000039,1,23,true,3,8,5,41.90294,-87.63137
KA1504000135,1,23,true,4,5,1,41.90319,-87.63439
TA1309000024,1,23,true,3,6,3,41.908,-87.63152
TA1309000058,1,23,true,5,3,-2,41.92591,-87.64927
TA1309000023,1,23,true,3,5,2,41.9287,-87.65383
TA1305000014,1,23,true,7,2,-5,41.92956,-87.64313
TA1307000142,1,23,true,4,6,2,41.93125,-87.64432
TA1309000025,1,23,true,5,4,-1,41.94368,-87.64894
632,1,23,true,5,1,-4,41.94453,-87.6547
13278,1,23,true,3,5,2,41.94553,-87.64644
13325,1,23,true,3,5,2,41.94907,-87.64863
13323,1,23,true,5,6,1,41.95282,-87.65
TA1309000041,1,23,true,1,5,4,41.96951,-87.65471
TA1305000002,2,0,false,1,5,4,41.86721,-87.62597
SL-005,2,0,false,1,10,9,41.8679,-87.62304
TA1309000010,2,0,false,9,5,-4,41.87074,-87.62574
623,2,0,false,16,14,-2,41.87272,-87.62399
TA1305000010,2,0,false,2,14,12,41.87623,-87.62444
KA1503000015,2,0,false,8,3,-5,41.87948,-87.6257
WL-011,2,0,false,1,10,9,41.88034,-87.64273
13300,2,0,false,18,7,-11,41.88097,-87.61675
13008,2,0,false,10,7,-3,41.88105,-87.62408
13036,2,0,false,6,3,-3,41.8821,-87.62513
13263,2,0,false,6,6,0,41.88467,-87.61952
TA1305000011,2,0,false,9,3,-6,41.886,-87.62418
TA1307000131,2,0,false,5,1,-4,41.88688,-87.62606
TA1307000117,2,0,false,10,6,-4,41.89144,-87.62675
13022,2,0,false,3,6,3,41.89227,-87.61205
TA1307000128,2,0,false,1,5,4,41.89896,-87.6299
TA1308000050,2,0,false,5,5,0,41.91211,-87.6347
TA1309000033,2,0,false,5,2,-3,41.92158,-87.65381
13191,2,0,false,4,8,4,41.92217,-87.63891
TA1305000014,2,0,false,6,8,2,41.92956,-87.64313
TA1307000136,2,0,false,7,8,1,41.9365,-87.64755
TA1307000107,2,0,false,3,6,3,41.96164,-87.65464
TA1305000032,2,0,true,1,5,4,41.88218,-87.64109
TA1307000124,2,1,false,1,5,4,41.86411,-87.62372
TA1309000010,2,1,false,1,5,4,41.87074,-87.62574
623,2,1,false,8,29,21,41.87272,-87.62399
KA1503000034,2,1,false,1,5,4,41.87938,-87.63197
KA1503000015,2,1,false,7,8,1,41.87948,-87.6257
TA1307000117,2,1,false,1,10,9,41.89144,-87.62675
620,2,1,false,2,7,5,41.89817,-87.63754
13137,2,1,false,4,5,1,41.9376,-87.6441
13278,2,1,false,6,4,-2,41.94553,-87.64644
SL-005,2,2,false,5,5,0,41.8679,-87.62304
638,2,4,true,5,1,-4,41.87827,-87.64078
13276,2,5,false,6,1,-5,41.93132,-87.63874
SL-005,2,5,true,9,1,-8,41.8679,-87.62304
SL-008,2,5,true,7,5,-2,41.87209,-87.62956
SL-011,2,5,true,6,2,-4,41.87256,-87.63356
TA1309000004,2,5,true,2,6,4,41.87811,-87.63184
13011,2,5,true,5,3,-2,41.87931,-87.63993
13156,2,5,true,7,2,-5,41.88042,-87.65554
TA1307000120,2,5,true,8,7,-1,41.88188,-87.64879
13263,2,5,true,15,1,-14,41.88467,-87.61952
TA1307000111,2,5,true,2,11,9,41.88582,-87.63548
TA1305000022,2,5,true,6,5,-1,41.88817,-87.63656
KA1503000043,2,5,true,4,17,13,41.88918,-87.63851
13050,2,5,true,5,2,-3,41.88919,-87.62775
13430,2,5,true,6,1,-5,41.89077,-87.63169
TA1305000003,2,5,true,1,5,4,41.89187,-87.62061
13016,2,5,true,5,26,21,41.89431,-87.62277
KA1503000041,2,5,true,1,8,7,41.89452,-87.61798
TA1307000062,2,5,true,7,2,-5,41.89466,-87.63839
13132,2,5,true,5,1,-4,41.89573,-87.67718
15530,2,5,true,2,5,3,41.89575,-87.62596
13017,2,5,true,1,6,5,41.89676,-87.6357
13248,2,5,true,5,1,-4,41.89964,-87.66788
KA1504000133,2,5,true,7,1,-6,41.90234,-87.62773
TA1307000039,2,5,true,9,6,-3,41.90294,-87.63137
KA1504000079,2,5,true,3,5,2,41.9035,-87.64334
TA1308000049,2,5,true,6,1,-5,41.90672,-87.6349
TA1308000050,2,5,true,5,4,-1,41.91211,-87.6347
TA1309000019,2,5,true,6,1,-5,41.92586,-87.63897
TA1307000142,2,5,true,1,7,6,41.93125,-87.64432
TA1306000014,2,5,true,2,7,5,41.93242,-87.65271
TA1309000049,2,5,true,6,1,-5,41.94077,-87.63919
TA1307000150,2,5,true,7,4,-3,41.94945,-87.64646
13389,2,5,true,5,1,-4,41.961,-87.64958
15622,2,5,true,6,1,-5,41.96108,-87.69544
TA1309000035,2,5,true,5,1,-4,41.97335,-87.66785
TA1309000064,2,6,false,1,5,4,41.87127,-87.67369
TA1309000008,2,6,false,1,5,4,41.87933,-87.6355
TA1307000120,2,6,false,5,1,-4,41.88188,-87.64879
13341,2,6,false,1,6,5,41.88208,-87.63985
TA1305000032,2,6,false,3,5,2,41.88218,-87.64109
TA1305000030,2,6,false,1,6,5,41.88459,-87.63178
KA1503000043,2,6,false,4,6,2,41.88918,-87.63851
TA1307000117,2,6,false,5,2,-3,41.89144,-87.62675
13045,2,6,false,5,6,1,41.89403,-87.62931
13016,2,6,false,1,8,7,41.89431,-87.62277
TA1306000012,2,6,false,6,6,0,41.89475,-87.63438
15530,2,6,false,5,3,-2,41.89575,-87.62596
13042,2,6,false,2,8,6,41.90097,-87.62377
TA1307000039,2,6,false,14,2,-12,41.90294,-87.63137
KA1504000135,2,6,false,8,3,-5,41.90319,-87.63439
TA1308000050,2,6,false,6,2,-4,41.91211,-87.6347
13193,2,6,false,7,2,-5,41.92182,-87.64412
TA1307000048,2,6,true,6,2,-4,41.83855,-87.60821
SL-012,2,6,true,5,1,-4,41.86038,-87.62581
TA1307000124,2,6,true,13,3,-10,41.86411,-87.62372
13431,2,6,true,7,2,-5,41.8661,-87.60728
15544,2,6,true,3,6,3,41.86723,-87.61536
SL-005,2,6,true,10,4,-6,41.8679,-87.62304
13160,2,6,true,7,2,-5,41.86947,-87.65548
TA1309000010,2,6,true,10,1,-9,41.87074,-87.62574
SL-011,2,6,true,7,2,-5,41.87256,-87.63356
SL-007,2,6,true,5,1,-4,41.87404,-87.6277
SL-010,2,6,true,6,1,-5,41.87501,-87.63309
TA1305000009,2,6,true,2,6,4,41.87593,-87.63068
15539,2,6,true,2,6,4,41.87763,-87.64405
13158,2,6,true,11,4,-7,41.87764,-87.64957
TA1309000004,2,6,true,9,46,37,41.87811,-87.63184
638,2,6,true,12,12,0,41.87827,-87.64078
13011,2,6,true,14,10,-4,41.87931,-87.63993
TA1309000008,2,6,true,1,14,13,41.87933,-87.6355
TA1309000007,2,6,true,2,30,28,41.88022,-87.63526
WL-011,2,6,true,5,2,-3,41.88034,-87.64273
13156,2,6,true,7,3,-4,41.88042,-87.65554
13300,2,6,true,7,6,-1,41.88097,-87.61675
13056,2,6,true,1,7,6,41.88168,-87.63951
TA1307000120,2,6,true,10,6,-4,41.88188,-87.64879
13341,2,6,true,7,6,-1,41.88208,-87.63985
TA1305000032,2,6,true,22,25,3,41.88218,-87.64109
13353,2,6,true,10,4,-6,41.88283,-87.6612
KA1503000072,2,6,true,6,8,2,41.88317,-87.63693
WL-012,2,6,true,34,22,-12,41.88337,-87.6412
13001,2,6,true,9,12,3,41.88397,-87.62459
TA1306000010,2,6,true,2,10,8,41.88419,-87.62961
TA1305000030,2,6,true,1,6,5,41.88459,-87.63178
15535,2,6,true,14,2,-12,41.8846,-87.64455
13263,2,6,true,18,11,-7,41.88467,-87.61952
TA1306000015,2,6,true,2,9,7,41.88549,-87.65232
13021,2,6,true,6,6,0,41.88559,-87.64184
TA1307000111,2,6,true,7,14,7,41.88582,-87.63548
TA1305000011,2,6,true,8,23,15,41.886,-87.62418
15534,2,6,true,2,5,3,41.88627,-87.61749
TA1307000131,2,6,true,5,7,2,41.88688,-87.62606
TA1305000022,2,6,true,11,11,0,41.88817,-87.63656
TA1306000003,2,6,true,17,3,-14,41.88867,-87.64442
KA1503000043,2,6,true,30,36,6,41.88918,-87.63851
TA1307000151,2,6,true,4,7,3,41.88993,-87.63427
636,2,6,true,7,1,-6,41.88997,-87.63662
13427,2,6,true,14,5,-9,41.89054,-87.62205
13430,2,6,true,1,6,5,41.89077,-87.63169
TA1306000013,2,6,true,9,5,-4,41.89083,-87.61852
TA1307000117,2,6,true,4,10,6,41.89144,-87.62675
13033,2,6,true,6,1,-5,41.8916,-87.64835
13022,2,6,true,13,6,-7,41.89227,-87.61205
TA1306000029,2,6,true,6,5,-1,41.89256,-87.61449
13265,2,6,true,23,1,-22,41.89383,-87.64172
13045,2,6,true,12,25,13,41.89403,-87.62931
13016,2,6,true,6,45,39,41.89431,-87.62277
KA1503000041,2,6,true,13,20,7,41.89452,-87.61798
13196,2,6,true,7,2,-5,41.89455,-87.65345
TA1307000062,2,6,true,12,6,-6,41.89466,-87.63839
TA1306000012,2,6,true,13,13,0,41.89475,-87.63438
KP1705001026,2,6,true,6,3,-3,41.89483,-87.6323
637,2,6,true,7,2,-5,41.89563,-87.67209
15530,2,6,true,6,16,10,41.89575,-87.62596
18003,2,6,true,1,14,13,41.89575,-87.62011
13247,2,6,true,5,1,-4,41.89597,-87.66775
TA1305000020,2,6,true,10,1,-9,41.89636,-87.65406
13289,2,6,true,13,1,-12,41.89638,-87.661
13303,2,6,true,8,6,-2,41.89672,-87.63088
13017,2,6,true,4,8,4,41.89676,-87.6357
13338,2,6,true,3,36,33,41.89697,-87.62173
13034,2,6,true,5,12,7,41.89754,-87.62352
TA1306000009,2,6,true,9,3,-6,41.89772,-87.64299
620,2,6,true,13,1,-12,41.89817,-87.63754
15529,2,6,true,8,18,10,41.89858,-87.62206
13042,2,6,true,6,7,1,41.90097,-87.62377
TA1307000039,2,6,true,21,19,-2,41.90294,-87.63137
KA1504000135,2,6,true,18,4,-14,41.90319,-87.63439
13136,2,6,true,7,3,-4,41.90326,-87.67845
13061,2,6,true,7,4,-3,41.90342,-87.66779
TA1308000049,2,6,true,16,6,-10,41.90672,-87.6349
13224,2,6,true,7,1,-6,41.90706,-87.66725
13221,2,6,true,7,4,-3,41.90765,-87.67254
TA1309000024,2,6,true,14,1,-13,41.908,-87.63152
TA1305000037,2,6,true,7,2,-5,41.91018,-87.67003
LF-005,2,6,true,6,8,2,41.91172,-87.62681
13128,2,6,true,9,3,-6,41.91197,-87.63197
TA1308000050,2,6,true,6,6,0,41.91211,-87.6347
TA1307000166,2,6,true,6,1,-5,41.91386,-87.64877
TA1306000007,2,6,true,7,1,-6,41.91469,-87.64333
13179,2,6,true,6,7,1,41.9157,-87.63461
13133,2,6,true,9,2,-7,41.91598,-87.67733
TA1307000163,2,6,true,4,6,2,41.91821,-87.65696
13146,2,6,true,10,1,-9,41.91831,-87.63629
TA1309000033,2,6,true,6,5,-1,41.92158,-87.65381
13193,2,6,true,8,1,-7,41.92182,-87.64412
13191,2,6,true,17,1,-16,41.92217,-87.63891
TA1306000016,2,6,true,3,17,14,41.9256,-87.65371
TA1309000019,2,6,true,9,1,-8,41.92586,-87.63897
TA1309000058,2,6,true,9,3,-6,41.92591,-87.64927
TA1307000142,2,6,true,8,4,-4,41.93125,-87.64432
13276,2,6,true,12,3,-9,41.93132,-87.63874
TA1307000064,2,6,true,13,4,-9,41.93222,-87.65864
TA1306000014,2,6,true,7,14,7,41.93242,-87.65271
TA1309000039,2,6,true,14,7,-7,41.93258,-87.63642
TA1309000036,2,6,true,8,3,-5,41.93313,-87.64776
13268,2,6,true,5,4,-1,41.93588,-87.67843
TA1307000052,2,6,true,6,3,-3,41.93628,-87.65266
TA1307000136,2,6,true,6,5,-1,41.9365,-87.64755
TA1307000041,2,6,true,6,5,-1,41.93669,-87.63683
13137,2,6,true,4,10,6,41.9376,-87.6441
13277,2,6,true,11,3,-8,41.9401,-87.64546
TA1307000134,2,6,true,6,7,1,41.94016,-87.65303
TA1309000049,2,6,true,6,2,-4,41.94077,-87.63919
TA1309000025,2,6,true,5,3,-2,41.94368,-87.64894
13071,2,6,true,7,8,1,41.94373,-87.66401
13278,2,6,true,7,6,-1,41.94553,-87.64644
13325,2,6,true,6,7,1,41.94907,-87.64863
TA1307000126,2,6,true,5,3,-2,41.94936,-87.65451
TA1307000150,2,6,true,5,4,-1,41.94945,-87.64646
13319,2,6,true,5,2,-3,41.95069,-87.6687
13063,2,6,true,10,8,-2,41.95424,-87.65441
13379,2,6,true,5,2,-3,41.95786,-87.6495
13389,2,6,true,6,4,-2,41.961,-87.64958
15622,2,6,true,2,6,4,41.96108,-87.69544
TA1307000107,2,6,true,7,2,-5,41.96164,-87.65464
TA1308000012,2,6,true,6,4,-2,41.96398,-87.63818
639,2,6,true,2,7,5,41.96584,-87.64538
TA1309000066,2,6,true,1,12,11,41.9691,-87.67423
13307,2,7,false,2,5,3,41.85489,-87.66359
SL-005,2,7,false,9,2,-7,41.8679,-87.62304
SL-009,2,7,false,5,1,-4,41.87081,-87.63121
623,2,7,false,5,1,-4,41.87272,-87.62399
13056,2,7,false,5,1,-4,41.88168,-87.63951
13341,2,7,false,5,9,4,41.88208,-87.63985
WL-012,2,7,false,5,7,2,41.88337,-87.6412
TA1306000010,2,7,false,2,5,3,41.88419,-87.62961
TA1307000111,2,7,false,1,6,5,41.88582,-87.63548
TA1305000011,2,7,false,3,5,2,41.886,-87.62418
TA1308000029,2,7,false,6,4,-2,41.88673,-87.62225
TA1305000022,2,7,false,6,3,-3,41.88817,-87.63656
TA1306000003,2,7,false,6,1,-5,41.88867,-87.64442
KA1503000043,2,7,false,6,10,4,41.88918,-87.63851
13430,2,7,false,5,3,-2,41.89077,-87.63169
TA1307000117,2,7,false,4,9,5,41.89144,-87.62675
TA1305000003,2,7,false,6,3,-3,41.89187,-87.62061
13022,2,7,false,6,5,-1,41.89227,-87.61205
TA1306000029,2,7,false,5,3,-2,41.89256,-87.61449
13265,2,7,false,5,1,-4,41.89383,-87.64172
13045,2,7,false,9,7,-2,41.89403,-87.62931
13016,2,7,false,3,5,2,41.89431,-87.62277
TA1307000062,2,7,false,1,5,4,41.89466,-87.63839
TA1306000012,2,7,false,7,4,-3,41.89475,-87.63438
13247,2,7,false,7,1,-6,41.89597,-87.66775
13017,2,7,false,6,2,-4,41.89676,-87.6357
TA1306000009,2,7,false,7,8,1,41.89772,-87.64299
TA1307000128,2,7,false,6,1,-5,41.89896,-87.6299
TA1306000011,2,7,false,7,2,-5,41.89994,-87.63443
13042,2,7,false,8,7,-1,41.90097,-87.62377
KA1504000133,2,7,false,3,6,3,41.90234,-87.62773
TA1307000039,2,7,false,14,1,-13,41.90294,-87.63137
KA1504000135,2,7,false,11,7,-4,41.90319,-87.63439
TA1308000049,2,7,false,5,2,-3,41.90672,-87.6349
KA1504000134,2,7,false,7,2,-5,41.90687,-87.6262
TA1305000041,2,7,false,7,3,-4,41.9094,-87.67769
331,2,7,false,2,6,4,41.90965,-87.64812
TA1305000037,2,7,false,3,5,2,41.91018,-87.67003
TA1308000050,2,7,false,2,5,3,41.91211,-87.6347
TA1305000039,2,7,false,2,6,4,41.9163,-87.66749
13059,2,7,false,6,3,-3,41.91845,-87.65222
13192,2,7,false,6,3,-3,41.91995,-87.64884
TA1309000030,2,7,false,4,7,3,41.92077,-87.66372
13191,2,7,false,5,5,0,41.92217,-87.63891
TA1307000001,2,7,false,5,2,-3,41.92535,-87.66581
TA1306000016,2,7,false,1,5,4,41.9256,-87.65371
TA1309000019,2,7,false,6,1,-5,41.92586,-87.63897
TA1309000058,2,7,false,6,7,1,41.92591,-87.64927
TA1305000014,2,7,false,9,3,-6,41.92956,-87.64313
TA1307000142,2,7,false,5,4,-1,41.93125,-87.64432
13276,2,7,false,5,4,-1,41.93132,-87.63874
TA1306000014,2,7,false,1,6,5,41.93242,-87.65271
TA1307000136,2,7,false,6,2,-4,41.9365,-87.64755
13137,2,7,false,5,5,0,41.9376,-87.6441
TA1309000049,2,7,false,7,4,-3,41.94077,-87.63919
13235,2,7,false,5,2,-3,41.94814,-87.66396
KA1504000080,2,7,false,5,1,-4,41.96887,-87.69609
TA1308000009,2,7,true,5,3,-2,41.79522,-87.58075
TA1308000045,2,7,true,3,5,2,41.83062,-87.64129
15545,2,7,true,4,7,3,41.85627,-87.61334
13102,2,7,true,14,3,-11,41.85762,-87.61942
13150,2,7,true,7,5,-2,41.85783,-87.62455
TA1307000044,2,7,true,6,2,-4,41.85794,-87.64083
SL-012,2,7,true,12,6,-6,41.86038,-87.62581
13304,2,7,true,6,3,-3,41.86126,-87.65659
TA1306000002,2,7,true,5,2,-3,41.86238,-87.65108
TA1307000124,2,7,true,18,2,-16,41.86411,-87.62372
13431,2,7,true,8,7,-1,41.8661,-87.60728
TA1305000002,2,7,true,21,6,-15,41.86721,-87.62597
15544,2,7,true,7,14,7,41.86723,-87.61536
SL-005,2,7,true,18,7,-11,41.8679,-87.62304
TA1309000010,2,7,true,14,6,-8,41.87074,-87.62574
SL-009,2,7,true,5,1,-4,41.87081,-87.63121
TA1307000121,2,7,true,5,3,-2,41.87184,-87.64664
SL-008,2,7,true,13,3,-10,41.87209,-87.62956
13332,2,7,true,9,5,-4,41.87219,-87.6615
SL-011,2,7,true,24,3,-21,41.87256,-87.63356
623,2,7,true,5,12,7,41.87272,-87.62399
KA1504000104,2,7,true,7,29,22,41.87296,-87.66912
SL-007,2,7,true,24,2,-22,41.87404,-87.6277
TA1306000025,2,7,true,5,2,-3,41.87464,-87.65703
SL-010,2,7,true,12,3,-9,41.87501,-87.63309
13037,2,7,true,4,5,1,41.87588,-87.64078
TA1305000009,2,7,true,5,4,-1,41.87593,-87.63068
TA1305000010,2,7,true,3,5,2,41.87623,-87.62444
13138,2,7,true,10,12,2,41.87723,-87.63941
15539,2,7,true,8,6,-2,41.87763,-87.64405
13158,2,7,true,28,3,-25,41.87764,-87.64957
13157,2,7,true,15,5,-10,41.87773,-87.6548
TA1305000025,2,7,true,4,46,42,41.87773,-87.63528
13206,2,7,true,5,3,-2,41.87794,-87.66201
TA1309000004,2,7,true,11,49,38,41.87811,-87.63184
638,2,7,true,21,33,12,41.87827,-87.64078
TA1305000005,2,7,true,10,23,13,41.87924,-87.62975
13011,2,7,true,35,5,-30,41.87931,-87.63993
TA1309000008,2,7,true,6,24,18,41.87933,-87.6355
KA1503000034,2,7,true,2,15,13,41.87938,-87.63197
KA1503000015,2,7,true,1,17,16,41.87948,-87.6257
TA1309000007,2,7,true,4,51,47,41.88022,-87.63526
WL-011,2,7,true,3,8,5,41.88034,-87.64273
13156,2,7,true,9,11,2,41.88042,-87.65554
13300,2,7,true,6,5,-1,41.88097,-87.61675
13008,2,7,true,3,8,5,41.88105,-87.62408
TA1305000006,2,7,true,1,43,42,41.88122,-87.6296
13134,2,7,true,5,2,-3,41.88138,-87.67493
13056,2,7,true,14,21,7,41.88168,-87.63951
TA1307000120,2,7,true,19,15,-4,41.88188,-87.64879
13341,2,7,true,12,24,12,41.88208,-87.63985
13036,2,7,true,1,9,8,41.8821,-87.62513
TA1305000032,2,7,true,24,24,0,41.88218,-87.64109
13006,2,7,true,5,16,11,41.88268,-87.63252
13353,2,7,true,8,8,0,41.88283,-87.6612
654,2,7,true,5,4,-1,41.88307,-87.65698
13409,2,7,true,7,7,0,41.8831,-87.6511
KA1503000072,2,7,true,4,34,30,41.88317,-87.63693
WL-012,2,7,true,41,24,-17,41.88337,-87.6412
13053,2,7,true,4,5,1,41.88365,-87.64863
13001,2,7,true,14,22,8,41.88397,-87.62459
13155,2,7,true,8,11,3,41.88407,-87.65689
18062,2,7,true,8,12,4,41.88412,-87.65427
TA1306000010,2,7,true,2,30,28,41.88419,-87.62961
TA1305000030,2,7,true,1,25,24,41.88459,-87.63178
15535,2,7,true,6,4,-2,41.8846,-87.64455
TA1305000029,2,7,true,7,11,4,41.88466,-87.62787
13263,2,7,true,26,20,-6,41.88467,-87.61952
TA1306000015,2,7,true,13,21,8,41.88549,-87.65232
13021,2,7,true,14,24,10,41.88559,-87.64184
TA1307000111,2,7,true,6,46,40,41.88582,-87.63548
13073,2,7,true,2,5,3,41.88592,-87.66717
KA1503000012,2,7,true,10,8,-2,41.88599,-87.63089
TA1305000011,2,7,true,11,45,34,41.886,-87.62418
15534,2,7,true,9,4,-5,41.88627,-87.61749
13197,2,7,true,3,6,3,41.8866,-87.65816
TA1308000029,2,7,true,8,14,6,41.88673,-87.62225
TA1307000131,2,7,true,4,9,5,41.88688,-87.62606
TA1305000022,2,7,true,19,10,-9,41.88817,-87.63656
TA1306000003,2,7,true,22,18,-4,41.88867,-87.64442
KA1503000043,2,7,true,48,32,-16,41.88918,-87.63851
13050,2,7,true,10,17,7,41.88919,-87.62775
TA1307000151,2,7,true,15,45,30,41.88993,-87.63427
636,2,7,true,5,11,6,41.88997,-87.63662
KA1503000044,2,7,true,7,19,12,41.89018,-87.6262
13427,2,7,true,18,7,-11,41.89054,-87.62205
13430,2,7,true,1,11,10,41.89077,-87.63169
TA1306000013,2,7,true,9,5,-4,41.89083,-87.61852
RN-,2,7,true,14,8,-6,41.89102,-87.63546
13434,2,7,true,8,1,-7,41.89108,-87.66663
TA1307000117,2,7,true,15,14,-1,41.89144,-87.62675
13033,2,7,true,15,9,-6,41.8916,-87.64835
13194,2,7,true,5,6,1,41.8918,-87.65878
TA1305000003,2,7,true,5,6,1,41.89187,-87.62061
643,2,7,true,6,2,-4,41.89203,-87.68939
13022,2,7,true,8,7,-1,41.89227,-87.61205
TA1306000029,2,7,true,10,7,-3,41.89256,-87.61449
13265,2,7,true,16,3,-13,41.89383,-87.64172
13045,2,7,true,34,24,-10,41.89403,-87.62931
13016,2,7,true,16,84,68,41.89431,-87.62277
KA1503000041,2,7,true,14,30,16,41.89452,-87.61798
13196,2,7,true,15,7,-8,41.89455,-87.65345
TA1307000062,2,7,true,15,19,4,41.89466,-87.63839
TA1306000012,2,7,true,31,13,-18,41.89475,-87.63438
KP1705001026,2,7,true,16,9,-7,41.89483,-87.6323
18058,2,7,true,8,2,-6,41.8955,-87.68201
13132,2,7,true,9,5,-4,41.89573,-87.67718
15530,2,7,true,13,22,9,41.89575,-87.62596
18003,2,7,true,8,8,0,41.89575,-87.62011
13247,2,7,true,8,4,-4,41.89597,-87.66775
TA1305000020,2,7,true,6,9,3,41.89636,-87.65406
13303,2,7,true,7,4,-3,41.89672,-87.63088
13017,2,7,true,20,17,-3,41.89676,-87.6357
13338,2,7,true,27,22,-5,41.89697,-87.62173
TA1307000061,2,7,true,9,5,-4,41.89745,-87.62873
13034,2,7,true,5,10,5,41.89754,-87.62352
TA1306000009,2,7,true,19,37,18,41.89772,-87.64299
KA1504000103,2,7,true,13,4,-9,41.89842,-87.68659
15529,2,7,true,15,14,-1,41.89858,-87.62206
TA1307000128,2,7,true,26,12,-14,41.89896,-87.6299
KA1504000117,2,7,true,2,5,3,41.89936,-87.64848
13248,2,7,true,12,6,-6,41.89964,-87.66788
TA1306000011,2,7,true,11,4,-7,41.89994,-87.63443
KA1504000116,2,7,true,11,3,-8,41.90023,-87.64299
13290,2,7,true,7,4,-3,41.90069,-87.66259
13042,2,7,true,8,14,6,41.90097,-87.62377
TA1307000070,2,7,true,7,1,-6,41.90133,-87.67742
KA1504000133,2,7,true,15,8,-7,41.90234,-87.62773
13241,2,7,true,5,5,0,41.9029,-87.68731
TA1307000039,2,7,true,66,19,-47,41.90294,-87.63137
TA1305000034,2,7,true,8,2,-6,41.90313,-87.67391
KA1504000135,2,7,true,24,13,-11,41.90319,-87.63439
13061,2,7,true,18,13,-5,41.90342,-87.66779
KA1504000079,2,7,true,12,4,-8,41.9035,-87.64334
TA1307000115,2,7,true,9,3,-6,41.9046,-87.64056
TA1308000049,2,7,true,16,2,-14,41.90672,-87.6349
KA1504000134,2,7,true,15,2,-13,41.90687,-87.6262
13224,2,7,true,10,3,-7,41.90706,-87.66725
TA1307000143,2,7,true,19,1,-18,41.90762,-87.63854
13221,2,7,true,12,4,-8,41.90765,-87.67254
13245,2,7,true,6,3,-3,41.90777,-87.68586
TA1309000024,2,7,true,22,5,-17,41.908,-87.63152
TA1305000041,2,7,true,4,13,9,41.9094,-87.67769
331,2,7,true,8,6,-2,41.90965,-87.64812
TA1305000037,2,7,true,5,3,-2,41.91018,-87.67003
TA1306000008,2,7,true,8,4,-4,41.9102,-87.6435
13258,2,7,true,5,1,-4,41.91043,-87.69718
13154,2,7,true,5,11,6,41.91054,-87.65312
13058,2,7,true,4,9,5,41.91059,-87.64942
TA1307000038,2,7,true,12,2,-10,41.91138,-87.63868
13128,2,7,true,7,3,-4,41.91197,-87.63197
TA1308000050,2,7,true,25,24,-1,41.91211,-87.6347
13243,2,7,true,6,3,-3,41.91262,-87.6814
TA1307000166,2,7,true,7,7,0,41.91386,-87.64877
18067,2,7,true,10,2,-8,41.9146,-87.66796
TA1306000007,2,7,true,6,1,-5,41.91469,-87.64333
13179,2,7,true,23,3,-20,41.9157,-87.63461
13133,2,7,true,6,2,-4,41.91598,-87.67733
TA1305000039,2,7,true,5,7,2,41.9163,-87.66749
TA1309000006,2,7,true,5,3,-2,41.91809,-87.64375
TA1307000163,2,7,true,15,4,-11,41.91821,-87.65696
13146,2,7,true,9,5,-4,41.91831,-87.63629
13059,2,7,true,7,14,7,41.91845,-87.65222
13192,2,7,true,13,7,-6,41.91995,-87.64884
13288,2,7,true,5,2,-3,41.92008,-87.67788
13242,2,7,true,5,3,-2,41.92021,-87.69266
TA1309000033,2,7,true,7,3,-4,41.92158,-87.65381
13193,2,7,true,15,7,-8,41.92182,-87.64412
13191,2,7,true,10,5,-5,41.92217,-87.63891
LP-,2,7,true,9,5,-4,41.92396,-87.63584
TA1307000001,2,7,true,8,2,-6,41.92535,-87.66581
TA1306000016,2,7,true,6,11,5,41.9256,-87.65371
TA1309000019,2,7,true,25,7,-18,41.92586,-87.63897
TA1309000058,2,7,true,18,8,-10,41.92591,-87.64927
TA1308000001,2,7,true,16,9,-7,41.92627,-87.63086
15646,2,7,true,6,1,-5,41.92668,-87.6977
TA1309000023,2,7,true,7,5,-2,41.9287,-87.65383
TA1307000113,2,7,true,10,3,-7,41.92878,-87.66391
13296,2,7,true,6,3,-3,41.92883,-87.66852
TA1309000059,2,7,true,14,5,-9,41.92889,-87.65898
TA1309000061,2,7,true,8,4,-4,41.92915,-87.64909
TA1305000014,2,7,true,19,8,-11,41.92956,-87.64313
TA1307000142,2,7,true,12,12,0,41.93125,-87.64432
13276,2,7,true,20,10,-10,41.93132,-87.63874
TA1307000064,2,7,true,5,13,8,41.93222,-87.65864
TA1306000014,2,7,true,13,8,-5,41.93242,-87.65271
TA1309000039,2,7,true,19,11,-8,41.93258,-87.63642
13294,2,7,true,7,3,-4,41.9326,-87.66595
TA1309000036,2,7,true,4,5,1,41.93313,-87.64776
TA1307000006,2,7,true,19,12,-7,41.93571,-87.6636
13268,2,7,true,11,4,-7,41.93588,-87.67843
13269,2,7,true,10,4,-6,41.93609,-87.66983
TA1307000052,2,7,true,5,10,5,41.93628,-87.65266
TA1307000136,2,7,true,10,11,1,41.9365,-87.64755
TA1307000041,2,7,true,9,7,-2,41.93669,-87.63683
13137,2,7,true,29,13,-16,41.9376,-87.6441
TA1309000042,2,7,true,7,8,1,41.93937,-87.66836
13229,2,7,true,6,2,-4,41.93946,-87.66376
13277,2,7,true,5,5,0,41.9401,-87.64546
TA1307000134,2,7,true,6,18,12,41.94016,-87.65303
TA1309000049,2,7,true,10,5,-5,41.94077,-87.63919
TA1307000138,2,7,true,7,6,-1,41.94334,-87.67094
TA1309000025,2,7,true,6,3,-3,41.94368,-87.64894
13071,2,7,true,9,7,-2,41.94373,-87.66401
632,2,7,true,8,5,-3,41.94453,-87.6547
13278,2,7,true,14,4,-10,41.94553,-87.64644
13235,2,7,true,8,3,-5,41.94814,-87.66396
13325,2,7,true,16,1,-15,41.94907,-87.64863
TA1307000150,2,7,true,12,3,-9,41.94945,-87.64646
13319,2,7,true,5,3,-2,41.95069,-87.6687
13323,2,7,true,4,6,2,41.95282,-87.65
13063,2,7,true,8,13,5,41.95424,-87.65441
TA1308000022,2,7,true,9,5,-4,41.95438,-87.64805
TA1307000149,2,7,true,2,6,4,41.95467,-87.67392
TA1309000018,2,7,true,7,4,-3,41.95791,-87.67357
TA1309000027,2,7,true,10,3,-7,41.9585,-87.65499
13389,2,7,true,9,5,-4,41.961,-87.64958
TA1307000144,2,7,true,3,6,3,41.96142,-87.6762
KA1503000022,2,7,true,2,6,4,41.96158,-87.66609
TA1307000107,2,7,true,5,4,-1,41.96164,-87.65464
13074,2,7,true,1,6,5,41.96521,-87.6582
639,2,7,true,9,3,-6,41.96584,-87.64538
TA1307000140,2,7,true,7,4,-3,41.96643,-87.68865
TA1307000158,2,7,true,1,6,5,41.9671,-87.67904
TA1309000066,2,7,true,5,14,9,41.9691,-87.67423
TA1309000035,2,7,true,6,8,2,41.97335,-87.66785
13108,2,7,true,10,3,-7,41.97379,-87.65971
13109,2,7,true,3,5,2,41.97835,-87.65976
KA1504000175,2,7,true,5,2,-3,42.00797,-87.66549
KA1504000162,2,7,true,1,6,5,42.00907,-87.67422
TA1308000009,2,8,false,7,6,-1,41.79522,-87.58075
KA1503000059,2,8,false,6,2,-4,41.79952,-87.58643
TA1307000048,2,8,false,6,1,-5,41.83855,-87.60821
13102,2,8,false,5,1,-4,41.85762,-87.61942
TA1307000124,2,8,false,5,3,-2,41.86411,-87.62372
TA1305000002,2,8,false,5,1,-4,41.86721,-87.62597
15544,2,8,false,2,7,5,41.86723,-87.61536
SL-005,2,8,false,12,7,-5,41.8679,-87.62304
623,2,8,false,9,3,-6,41.87272,-87.62399
TA1305000025,2,8,false,2,11,9,41.87773,-87.63528
TA1309000004,2,8,false,1,6,5,41.87811,-87.63184
13011,2,8,false,12,16,4,41.87931,-87.63993
KA1503000034,2,8,false,1,5,4,41.87938,-87.63197
TA1309000007,2,8,false,2,10,8,41.88022,-87.63526
13008,2,8,false,6,4,-2,41.88105,-87.62408
13056,2,8,false,2,7,5,41.88168,-87.63951
TA1307000120,2,8,false,6,7,1,41.88188,-87.64879
13341,2,8,false,6,3,-3,41.88208,-87.63985
TA1305000032,2,8,false,4,5,1,41.88218,-87.64109
13409,2,8,false,7,4,-3,41.8831,-87.6511
KA1503000072,2,8,false,1,6,5,41.88317,-87.63693
WL-012,2,8,false,13,7,-6,41.88337,-87.6412
13001,2,8,false,9,4,-5,41.88397,-87.62459
18062,2,8,false,3,6,3,41.88412,-87.65427
TA1306000010,2,8,false,2,7,5,41.88419,-87.62961
TA1305000030,2,8,false,4,21,17,41.88459,-87.63178
13021,2,8,false,6,6,0,41.88559,-87.64184
TA1307000111,2,8,false,3,11,8,41.88582,-87.63548
KA1503000012,2,8,false,3,8,5,41.88599,-87.63089
TA1305000011,2,8,false,8,10,2,41.886,-87.62418
TA1308000029,2,8,false,5,2,-3,41.88673,-87.62225
TA1305000022,2,8,false,4,7,3,41.88817,-87.63656
KA1503000043,2,8,false,11,7,-4,41.88918,-87.63851
13050,2,8,false,2,9,7,41.88919,-87.62775
TA1307000151,2,8,false,6,18,12,41.88993,-87.63427
KA1503000044,2,8,false,6,5,-1,41.89018,-87.6262
13430,2,8,false,5,3,-2,41.89077,-87.63169
TA1306000013,2,8,false,11,7,-4,41.89083,-87.61852
TA1307000117,2,8,false,8,9,1,41.89144,-87.62675
13033,2,8,false,4,10,6,41.8916,-87.64835
TA1305000003,2,8,false,7,8,1,41.89187,-87.62061
13022,2,8,false,4,10,6,41.89227,-87.61205
TA1306000029,2,8,false,5,2,-3,41.89256,-87.61449
13265,2,8,false,12,8,-4,41.89383,-87.64172
13045,2,8,false,12,3,-9,41.89403,-87.62931
13016,2,8,false,6,5,-1,41.89431,-87.62277
KA1503000041,2,8,false,10,7,-3,41.89452,-87.61798
TA1307000062,2,8,false,6,7,1,41.89466,-87.63839
TA1306000012,2,8,false,11,12,1,41.89475,-87.63438
KP1705001026,2,8,false,5,1,-4,41.89483,-87.6323
15530,2,8,false,2,6,4,41.89575,-87.62596
18003,2,8,false,1,5,4,41.89575,-87.62011
13017,2,8,false,10,3,-7,41.89676,-87.6357
13338,2,8,false,5,5,0,41.89697,-87.62173
TA1307000061,2,8,false,6,5,-1,41.89745,-87.62873
TA1306000009,2,8,false,1,8,7,41.89772,-87.64299
TA1307000128,2,8,false,5,10,5,41.89896,-87.6299
13248,2,8,false,6,1,-5,41.89964,-87.66788
13042,2,8,false,17,4,-13,41.90097,-87.62377
TA1307000039,2,8,false,5,1,-4,41.90294,-87.63137
KA1504000135,2,8,false,8,2,-6,41.90319,-87.63439
13061,2,8,false,7,6,-1,41.90342,-87.66779
KA1504000134,2,8,false,7,5,-2,41.90687,-87.6262
331,2,8,false,3,8,5,41.90965,-87.64812
TA1306000008,2,8,false,5,1,-4,41.9102,-87.6435
13257,2,8,false,5,1,-4,41.91054,-87.68956
TA1307000038,2,8,false,6,3,-3,41.91138,-87.63868
LF-005,2,8,false,11,10,-1,41.91172,-87.62681
TA1308000050,2,8,false,6,10,4,41.91211,-87.6347
TA1305000039,2,8,false,5,5,0,41.9163,-87.66749
13059,2,8,false,4,5,1,41.91845,-87.65222
13192,2,8,false,1,5,4,41.91995,-87.64884
13193,2,8,false,3,5,2,41.92182,-87.64412
13191,2,8,false,2,5,3,41.92217,-87.63891
TA1309000019,2,8,false,7,4,-3,41.92586,-87.63897
TA1309000058,2,8,false,7,8,1,41.92591,-87.64927
TA1307000113,2,8,false,6,1,-5,41.92878,-87.66391
TA1309000059,2,8,false,5,3,-2,41.92889,-87.65898
TA1307000142,2,8,false,5,2,-3,41.93125,-87.64432
13276,2,8,false,2,5,3,41.93132,-87.63874
TA1307000064,2,8,false,5,1,-4,41.93222,-87.65864
TA1309000039,2,8,false,6,3,-3,41.93258,-87.63642
TA1307000006,2,8,false,2,6,4,41.93571,-87.6636
TA1307000052,2,8,false,5,1,-4,41.93628,-87.65266
TA1307000041,2,8,false,6,2,-4,41.93669,-87.63683
13229,2,8,false,3,6,3,41.93946,-87.66376
TA1307000134,2,8,false,5,1,-4,41.94016,-87.65303
13071,2,8,false,2,6,4,41.94373,-87.66401
13325,2,8,false,6,1,-5,41.94907,-87.64863
TA1307000150,2,8,false,5,2,-3,41.94945,-87.64646
13323,2,8,false,5,1,-4,41.95282,-87.65
13389,2,8,false,5,3,-2,41.961,-87.64958
TA1309000066,2,8,false,1,6,5,41.9691,-87.67423
KA1503000014,2,8,true,1,5,4,41.7851,-87.60108
TA1309000011,2,8,true,2,5,3,41.78873,-87.60131
TA1309000063,2,8,true,6,5,-1,41.79325,-87.5878
KA1504000076,2,8,true,5,6,1,41.7943,-87.60145
TA1308000009,2,8,true,8,2,-6,41.79522,-87.58075
KA1503000059,2,8,true,5,1,-4,41.79952,-87.58643
TA1309000037,2,8,true,10,6,-4,41.79957,-87.59474
13345,2,8,true,5,1,-4,41.83138,-87.61803
13216,2,8,true,2,6,4,41.83473,-87.62581
TA1307000005,2,8,true,4,8,4,41.84569,-87.6225
15689,2,8,true,5,2,-3,41.84912,-87.69515
15545,2,8,true,6,6,0,41.85627,-87.61334
13135,2,8,true,10,3,-7,41.85753,-87.66157
13102,2,8,true,5,1,-4,41.85762,-87.61942
13150,2,8,true,10,5,-5,41.85783,-87.62455
13163,2,8,true,6,2,-4,41.85808,-87.65108
TA1307000124,2,8,true,9,4,-5,41.86411,-87.62372
TA1309000001,2,8,true,3,5,2,41.86488,-87.64708
TA1305000002,2,8,true,20,6,-14,41.86721,-87.62597
15544,2,8,true,2,6,4,41.86723,-87.61536
TA1305000017,2,8,true,1,10,9,41.86734,-87.64863
SL-005,2,8,true,26,9,-17,41.8679,-87.62304
644,2,8,true,6,1,-5,41.86859,-87.68625
13285,2,8,true,1,17,16,41.86928,-87.67372
15550,2,8,true,5,5,0,41.87024,-87.63947
TA1309000010,2,8,true,13,2,-11,41.87074,-87.62574
SL-009,2,8,true,9,5,-4,41.87081,-87.63121
TA1307000130,2,8,true,8,3,-5,41.87178,-87.65103
TA1307000121,2,8,true,2,11,9,41.87184,-87.64664
SL-008,2,8,true,15,9,-6,41.87209,-87.62956
13332,2,8,true,19,2,-17,41.87219,-87.6615
SL-011,2,8,true,16,2,-14,41.87256,-87.63356
623,2,8,true,8,3,-5,41.87272,-87.62399
KA1504000104,2,8,true,5,31,26,41.87296,-87.66912
SL-007,2,8,true,9,3,-6,41.87404,-87.6277
TA1306000025,2,8,true,5,1,-4,41.87464,-87.65703
13081,2,8,true,1,5,4,41.87501,-87.67326
SL-010,2,8,true,12,6,-6,41.87501,-87.63309
13037,2,8,true,3,9,6,41.87588,-87.64078
TA1305000009,2,8,true,11,8,-3,41.87593,-87.63068
624,2,8,true,6,12,6,41.87626,-87.62923
TA1305000035,2,8,true,4,12,8,41.87716,-87.62787
13138,2,8,true,10,24,14,41.87723,-87.63941
15539,2,8,true,8,11,3,41.87763,-87.64405
13158,2,8,true,17,14,-3,41.87764,-87.64957
13157,2,8,true,8,4,-4,41.87773,-87.6548
TA1305000025,2,8,true,9,48,39,41.87773,-87.63528
13206,2,8,true,5,6,1,41.87794,-87.66201
TA1309000004,2,8,true,7,28,21,41.87811,-87.63184
638,2,8,true,15,31,16,41.87827,-87.64078
TA1305000005,2,8,true,5,42,37,41.87924,-87.62975
13011,2,8,true,26,26,0,41.87931,-87.63993
KA1503000015,2,8,true,8,13,5,41.87948,-87.6257
TA1309000007,2,8,true,5,61,56,41.88022,-87.63526
WL-011,2,8,true,10,5,-5,41.88034,-87.64273
13156,2,8,true,15,10,-5,41.88042,-87.65554
13008,2,8,true,3,21,18,41.88105,-87.62408
TA1305000006,2,8,true,1,26,25,41.88122,-87.6296
13056,2,8,true,10,11,1,41.88168,-87.63951
TA1307000120,2,8,true,28,10,-18,41.88188,-87.64879
13341,2,8,true,16,38,22,41.88208,-87.63985
13036,2,8,true,12,7,-5,41.8821,-87.62513
TA1305000032,2,8,true,37,32,-5,41.88218,-87.64109
13006,2,8,true,4,6,2,41.88268,-87.63252
13353,2,8,true,21,13,-8,41.88283,-87.6612
654,2,8,true,6,4,-2,41.88307,-87.65698
13409,2,8,true,16,16,0,41.8831,-87.6511
KA1503000072,2,8,true,7,21,14,41.88317,-87.63693
WL-012,2,8,true,56,49,-7,41.88337,-87.6412
13053,2,8,true,6,9,3,41.88365,-87.64863
13001,2,8,true,10,20,10,41.88397,-87.62459
18062,2,8,true,14,19,5,41.88412,-87.65427
TA1306000010,2,8,true,9,65,56,41.88419,-87.62961
TA1305000030,2,8,true,13,81,68,41.88459,-87.63178
15535,2,8,true,6,10,4,41.8846,-87.64455
TA1305000029,2,8,true,9,10,1,41.88466,-87.62787
13263,2,8,true,22,15,-7,41.88467,-87.61952
TA1306000015,2,8,true,12,20,8,41.88549,-87.65232
13021,2,8,true,17,29,12,41.88559,-87.64184
TA1307000111,2,8,true,7,15,8,41.88582,-87.63548
KA17018054,2,8,true,1,8,7,41.88595,-87.67701
KA1503000012,2,8,true,14,22,8,41.88599,-87.63089
TA1305000011,2,8,true,13,48,35,41.886,-87.62418
15534,2,8,true,15,5,-10,41.88627,-87.61749
13197,2,8,true,6,6,0,41.8866,-87.65816
TA1308000029,2,8,true,11,10,-1,41.88673,-87.62225
TA1307000131,2,8,true,3,14,11,41.88688,-87.62606
TA1305000022,2,8,true,3,38,35,41.88817,-87.63656
TA1306000003,2,8,true,26,15,-11,41.88867,-87.64442
KA1503000043,2,8,true,40,48,8,41.88918,-87.63851
13050,2,8,true,11,37,26,41.88919,-87.62775
TA1307000151,2,8,true,23,46,23,41.88993,-87.63427
636,2,8,true,11,19,8,41.88997,-87.63662
KA1503000044,2,8,true,12,20,8,41.89018,-87.6262
13427,2,8,true,9,11,2,41.89054,-87.62205
13430,2,8,true,7,16,9,41.89077,-87.63169
TA1306000013,2,8,true,12,7,-5,41.89083,-87.61852
RN-,2,8,true,9,14,5,41.89102,-87.63546
13434,2,8,true,6,4,-2,41.89108,-87.66663
TA1308000006,2,8,true,3,6,3,41.89128,-87.67686
TA1307000117,2,8,true,17,18,1,41.89144,-87.62675
13033,2,8,true,14,9,-5,41.8916,-87.64835
13194,2,8,true,6,10,4,41.8918,-87.65878
TA1305000003,2,8,true,13,20,7,41.89187,-87.62061
13022,2,8,true,11,14,3,41.89227,-87.61205
TA1306000029,2,8,true,7,8,1,41.89256,-87.61449
13265,2,8,true,18,13,-5,41.89383,-87.64172
13045,2,8,true,24,19,-5,41.89403,-87.62931
13016,2,8,true,15,48,33,41.89431,-87.62277
KA1503000041,2,8,true,8,23,15,41.89452,-87.61798
13196,2,8,true,13,5,-8,41.89455,-87.65345
TA1307000062,2,8,true,17,26,9,41.89466,-87.63839
TA1306000012,2,8,true,22,24,2,41.89475,-87.63438
KP1705001026,2,8,true,9,7,-2,41.89483,-87.6323
13132,2,8,true,9,4,-5,41.89573,-87.67718
15530,2,8,true,21,11,-10,41.89575,-87.62596
18003,2,8,true,8,17,9,41.89575,-87.62011
13247,2,8,true,11,4,-7,41.89597,-87.66775
TA1305000020,2,8,true,8,9,1,41.89636,-87.65406
13289,2,8,true,10,2,-8,41.89638,-87.661
13303,2,8,true,12,6,-6,41.89672,-87.63088
13017,2,8,true,19,18,-1,41.89676,-87.6357
13338,2,8,true,11,14,3,41.89697,-87.62173
TA1307000061,2,8,true,18,3,-15,41.89745,-87.62873
13034,2,8,true,1,10,9,41.89754,-87.62352
TA1306000009,2,8,true,17,44,27,41.89772,-87.64299
620,2,8,true,12,5,-7,41.89817,-87.63754
KA1504000103,2,8,true,5,4,-1,41.89842,-87.68659
15529,2,8,true,5,7,2,41.89858,-87.62206
TA1307000128,2,8,true,29,9,-20,41.89896,-87.6299
657,2,8,true,11,2,-9,41.89918,-87.6722
13248,2,8,true,15,4,-11,41.89964,-87.66788
TA1306000011,2,8,true,30,5,-25,41.89994,-87.63443
KA1504000116,2,8,true,6,1,-5,41.90023,-87.64299
13290,2,8,true,18,9,-9,41.90069,-87.66259
13042,2,8,true,12,13,1,41.90097,-87.62377
TA1307000070,2,8,true,9,4,-5,41.90133,-87.67742
KA1504000133,2,8,true,12,7,-5,41.90234,-87.62773
13241,2,8,true,3,5,2,41.9029,-87.68731
TA1307000039,2,8,true,20,7,-13,41.90294,-87.63137
658,2,8,true,2,8,6,41.903,-87.6838
TA1305000034,2,8,true,8,2,-6,41.90313,-87.67391
KA1504000135,2,8,true,15,15,0,41.90319,-87.63439
13136,2,8,true,11,7,-4,41.90326,-87.67845
13061,2,8,true,19,18,-1,41.90342,-87.66779
KA1504000079,2,8,true,13,1,-12,41.9035,-87.64334
TA1307000115,2,8,true,13,5,-8,41.9046,-87.64056
TA1308000049,2,8,true,16,8,-8,41.90672,-87.6349
KA1504000134,2,8,true,7,1,-6,41.90687,-87.6262
13221,2,8,true,5,3,-2,41.90765,-87.67254
TA1309000024,2,8,true,7,5,-2,41.908,-87.63152
TA1305000041,2,8,true,10,7,-3,41.9094,-87.67769
331,2,8,true,3,14,11,41.90965,-87.64812
TA1305000037,2,8,true,12,6,-6,41.91018,-87.67003
13154,2,8,true,15,15,0,41.91054,-87.65312
13058,2,8,true,14,5,-9,41.91059,-87.64942
TA1307000038,2,8,true,12,10,-2,41.91138,-87.63868
LF-005,2,8,true,15,8,-7,41.91172,-87.62681
13128,2,8,true,4,6,2,41.91197,-87.63197
TA1308000050,2,8,true,21,7,-14,41.91211,-87.6347
13243,2,8,true,10,2,-8,41.91262,-87.6814
TA1306000032,2,8,true,6,8,2,41.9137,-87.65285
TA1307000166,2,8,true,6,8,2,41.91386,-87.64877
18067,2,8,true,8,3,-5,41.9146,-87.66796
TA1306000007,2,8,true,7,6,-1,41.91469,-87.64333
13068,2,8,true,2,5,3,41.91554,-87.68703
13179,2,8,true,11,10,-1,41.9157,-87.63461
13133,2,8,true,9,4,-5,41.91598,-87.67733
TA1305000039,2,8,true,3,8,5,41.9163,-87.66749
13266,2,8,true,5,1,-4,41.91774,-87.69142
TA1309000006,2,8,true,11,3,-8,41.91809,-87.64375
TA1307000163,2,8,true,10,10,0,41.91821,-87.65696
13146,2,8,true,16,17,1,41.91831,-87.63629
13059,2,8,true,4,8,4,41.91845,-87.65222
13192,2,8,true,12,4,-8,41.91995,-87.64884
13288,2,8,true,5,1,-4,41.92008,-87.67788
TA1309000030,2,8,true,6,8,2,41.92077,-87.66372
TA1309000033,2,8,true,4,7,3,41.92158,-87.65381
13193,2,8,true,13,13,0,41.92182,-87.64412
13191,2,8,true,11,4,-7,41.92217,-87.63891
LP-,2,8,true,8,4,-4,41.92396,-87.63584
TA1306000026,2,8,true,9,13,4,41.92558,-87.65842
TA1306000016,2,8,true,7,13,6,41.9256,-87.65371
TA1309000019,2,8,true,19,3,-16,41.92586,-87.63897
TA1309000058,2,8,true,19,15,-4,41.92591,-87.64927
TA1308000001,2,8,true,9,5,-4,41.92627,-87.63086
TA1309000023,2,8,true,17,5,-12,41.9287,-87.65383
TA1307000113,2,8,true,5,4,-1,41.92878,-87.66391
13296,2,8,true,3,6,3,41.92883,-87.66852
TA1309000059,2,8,true,13,10,-3,41.92889,-87.65898
TA1309000061,2,8,true,14,13,-1,41.92915,-87.64909
TA1305000014,2,8,true,12,9,-3,41.92956,-87.64313
TA1307000142,2,8,true,22,9,-13,41.93125,-87.64432
13276,2,8,true,17,4,-13,41.93132,-87.63874
TA1307000064,2,8,true,13,7,-6,41.93222,-87.65864
TA1306000014,2,8,true,11,9,-2,41.93242,-87.65271
TA1309000039,2,8,true,19,6,-13,41.93258,-87.63642
13294,2,8,true,7,1,-6,41.9326,-87.66595
TA1309000036,2,8,true,13,9,-4,41.93313,-87.64776
TA1307000006,2,8,true,10,4,-6,41.93571,-87.6636
13268,2,8,true,7,2,-5,41.93588,-87.67843
13269,2,8,true,7,2,-5,41.93609,-87.66983
TA1307000052,2,8,true,5,19,14,41.93628,-87.65266
TA1307000136,2,8,true,14,8,-6,41.9365,-87.64755
TA1307000041,2,8,true,12,12,0,41.93669,-87.63683
13137,2,8,true,16,15,-1,41.9376,-87.6441
TA1309000042,2,8,true,8,4,-4,41.93937,-87.66836
13229,2,8,true,12,5,-7,41.93946,-87.66376
TA1308000019,2,8,true,8,3,-5,41.93973,-87.65886
13277,2,8,true,9,3,-6,41.9401,-87.64546
TA1307000134,2,8,true,10,11,1,41.94016,-87.65303
TA1309000049,2,8,true,13,12,-1,41.94077,-87.63919
TA1307000138,2,8,true,8,10,2,41.94334,-87.67094
TA1309000025,2,8,true,3,5,2,41.94368,-87.64894
13071,2,8,true,9,16,7,41.94373,-87.66401
632,2,8,true,8,6,-2,41.94453,-87.6547
13235,2,8,true,13,14,1,41.94814,-87.66396
13325,2,8,true,5,11,6,41.94907,-87.64863
TA1307000126,2,8,true,7,5,-2,41.94936,-87.65451
TA1307000150,2,8,true,11,4,-7,41.94945,-87.64646
TA1307000127,2,8,true,8,6,-2,41.9508,-87.65918
13323,2,8,true,12,5,-7,41.95282,-87.65
TA1309000043,2,8,true,3,5,2,41.95417,-87.66434
13063,2,8,true,5,7,2,41.95424,-87.65441
TA1308000022,2,8,true,6,5,-1,41.95438,-87.64805
13379,2,8,true,17,4,-13,41.95786,-87.6495
TA1309000027,2,8,true,10,3,-7,41.9585,-87.65499
13389,2,8,true,4,6,2,41.961,-87.64958
TA1307000144,2,8,true,5,1,-4,41.96142,-87.6762
KA1503000022,2,8,true,3,5,2,41.96158,-87.66609
TA1307000107,2,8,true,2,8,6,41.96164,-87.65464
TA1307000156,2,8,true,5,2,-3,41.96301,-87.68479
TA1307000140,2,8,true,8,9,1,41.96643,-87.68865
TA1309000014,2,8,true,6,6,0,41.96709,-87.66744
TA1307000158,2,8,true,9,3,-6,41.9671,-87.67904
TA1307000119,2,8,true,7,3,-4,41.96796,-87.65
TA1309000066,2,8,true,13,8,-5,41.9691,-87.67423
KA1504000171,2,8,true,9,7,-2,41.97161,-87.65016
TA1309000035,2,8,true,15,2,-13,41.97335,-87.66785
13109,2,8,true,2,6,4,41.97835,-87.65976
KA1504000151,2,8,true,5,3,-2,41.98359,-87.66916
KA1504000152,2,8,true,11,10,-1,41.98403,-87.65231
15575,2,8,true,7,3,-4,41.98975,-87.66014
15571,2,8,true,5,2,-3,41.99478,-87.66028
RP-009,2,8,true,7,1,-6,42.00107,-87.66122
E002,2,8,true,3,5,2,42.03256,-87.67912
TA1309000037,2,9,false,5,5,0,41.79957,-87.59474
TA1307000048,2,9,false,3,5,2,41.83855,-87.60821
13150,2,9,false,6,1,-5,41.85783,-87.62455
WL-008,2,9,false,8,1,-7,41.86712,-87.64108
TA1305000002,2,9,false,6,2,-4,41.86721,-87.62597
15544,2,9,false,3,12,9,41.86723,-87.61536
TA1309000010,2,9,false,6,3,-3,41.87074,-87.62574
623,2,9,false,10,1,-9,41.87272,-87.62399
SL-007,2,9,false,5,4,-1,41.87404,-87.6277
15541,2,9,false,6,4,-2,41.8758,-87.62086
13158,2,9,false,6,1,-5,41.87764,-87.64957
TA1309000004,2,9,false,6,3,-3,41.87811,-87.63184
TA1309000007,2,9,false,1,7,6,41.88022,-87.63526
13300,2,9,false,9,7,-2,41.88097,-87.61675
13008,2,9,false,5,9,4,41.88105,-87.62408
TA1307000120,2,9,false,6,4,-2,41.88188,-87.64879
13341,2,9,false,6,5,-1,41.88208,-87.63985
13036,2,9,false,5,3,-2,41.8821,-87.62513
13409,2,9,false,3,7,4,41.8831,-87.6511
WL-012,2,9,false,9,5,-4,41.88337,-87.6412
13001,2,9,false,9,2,-7,41.88397,-87.62459
TA1306000010,2,9,false,4,5,1,41.88419,-87.62961
TA1305000030,2,9,false,9,2,-7,41.88459,-87.63178
TA1305000029,2,9,false,3,5,2,41.88466,-87.62787
13021,2,9,false,3,6,3,41.88559,-87.64184
KA1503000012,2,9,false,2,7,5,41.88599,-87.63089
TA1305000011,2,9,false,10,7,-3,41.886,-87.62418
TA1305000022,2,9,false,8,2,-6,41.88817,-87.63656
TA1306000003,2,9,false,7,3,-4,41.88867,-87.64442
13050,2,9,false,3,7,4,41.88919,-87.62775
TA1307000151,2,9,false,5,9,4,41.88993,-87.63427
KA1503000044,2,9,false,5,6,1,41.89018,-87.6262
TA1306000013,2,9,false,4,10,6,41.89083,-87.61852
RN-,2,9,false,7,1,-6,41.89102,-87.63546
TA1307000117,2,9,false,8,6,-2,41.89144,-87.62675
TA1305000003,2,9,false,12,9,-3,41.89187,-87.62061
13022,2,9,false,19,15,-4,41.89227,-87.61205
TA1306000029,2,9,false,2,6,4,41.89256,-87.61449
13045,2,9,false,3,6,3,41.89403,-87.62931
13016,2,9,false,6,8,2,41.89431,-87.62277
KA1503000041,2,9,false,6,4,-2,41.89452,-87.61798
TA1307000062,2,9,false,5,1,-4,41.89466,-87.63839
TA1306000012,2,9,false,9,6,-3,41.89475,-87.63438
13132,2,9,false,6,1,-5,41.89573,-87.67718
18003,2,9,false,6,1,-5,41.89575,-87.62011
TA1306000009,2,9,false,2,6,4,41.89772,-87.64299
620,2,9,false,7,7,0,41.89817,-87.63754
15529,2,9,false,11,4,-7,41.89858,-87.62206
TA1306000011,2,9,false,5,2,-3,41.89994,-87.63443
13042,2,9,false,23,22,-1,41.90097,-87.62377
KA1504000133,2,9,false,2,5,3,41.90234,-87.62773
TA1307000039,2,9,false,4,13,9,41.90294,-87.63137
KA1504000135,2,9,false,3,7,4,41.90319,-87.63439
331,2,9,false,1,5,4,41.90965,-87.64812
TA1308000005,2,9,false,5,1,-4,41.91042,-87.68238
TA1307000038,2,9,false,6,1,-5,41.91138,-87.63868
LF-005,2,9,false,10,4,-6,41.91172,-87.62681
13128,2,9,false,6,2,-4,41.91197,-87.63197
TA1308000050,2,9,false,9,3,-6,41.91211,-87.6347
13146,2,9,false,3,5,2,41.91831,-87.63629
TA1309000019,2,9,false,2,5,3,41.92586,-87.63897
TA1309000058,2,9,false,3,5,2,41.92591,-87.64927
13276,2,9,false,5,3,-2,41.93132,-87.63874
13269,2,9,false,1,5,4,41.93609,-87.66983
13277,2,9,false,1,7,6,41.9401,-87.64546
TA1309000049,2,9,false,11,1,-10,41.94077,-87.63919
13278,2,9,false,2,6,4,41.94553,-87.64644
TA1308000022,2,9,false,6,2,-4,41.95438,-87.64805
KA1504000151,2,9,false,7,2,-5,41.98359,-87.66916
596,2,9,false,6,1,-5,42.04822,-87.68348
KA1503000070,2,9,true,2,5,3,41.78794,-87.58831
KA1504000076,2,9,true,4,6,2,41.7943,-87.60145
TA1308000009,2,9,true,8,3,-5,41.79522,-87.58075
KA1503000059,2,9,true,7,2,-5,41.79952,-87.58643
TA1309000037,2,9,true,7,4,-3,41.79957,-87.59474
TA1307000129,2,9,true,3,5,2,41.83104,-87.62683
13217,2,9,true,8,1,-7,41.83488,-87.61792
TA1309000055,2,9,true,3,5,2,41.8382,-87.64514
TA1308000036,2,9,true,6,1,-5,41.83883,-87.62186
TA1307000139,2,9,true,7,4,-3,41.84205,-87.61698
15545,2,9,true,8,10,2,41.85627,-87.61334
13135,2,9,true,7,4,-3,41.85753,-87.66157
13164,2,9,true,6,3,-3,41.85818,-87.65648
TA1307000124,2,9,true,7,3,-4,41.86411,-87.62372
TA1305000002,2,9,true,8,7,-1,41.86721,-87.62597
15544,2,9,true,1,6,5,41.86723,-87.61536
SL-005,2,9,true,14,1,-13,41.8679,-87.62304
13285,2,9,true,2,6,4,41.86928,-87.67372
13160,2,9,true,2,5,3,41.86947,-87.65548
15550,2,9,true,5,2,-3,41.87024,-87.63947
TA1309000010,2,9,true,9,7,-2,41.87074,-87.62574
TA1309000064,2,9,true,4,10,6,41.87127,-87.67369
TA1307000130,2,9,true,2,6,4,41.87178,-87.65103
TA1307000121,2,9,true,9,7,-2,41.87184,-87.64664
SL-008,2,9,true,8,5,-3,41.87209,-87.62956
13332,2,9,true,18,16,-2,41.87219,-87.6615
SL-011,2,9,true,4,8,4,41.87256,-87.63356
SL-007,2,9,true,1,6,5,41.87404,-87.6277
TA1306000025,2,9,true,5,2,-3,41.87464,-87.65703
13037,2,9,true,1,6,5,41.87588,-87.64078
TA1305000009,2,9,true,1,5,4,41.87593,-87.63068
TA1305000010,2,9,true,2,6,4,41.87623,-87.62444
624,2,9,true,2,14,12,41.87626,-87.62923
TA1305000035,2,9,true,4,15,11,41.87716,-87.62787
13138,2,9,true,6,13,7,41.87723,-87.63941
15539,2,9,true,3,5,2,41.87763,-87.64405
13158,2,9,true,7,8,1,41.87764,-87.64957
13157,2,9,true,5,3,-2,41.87773,-87.6548
TA1305000025,2,9,true,7,13,6,41.87773,-87.63528
TA1309000002,2,9,true,6,6,0,41.87784,-87.62408
TA1309000004,2,9,true,5,8,3,41.87811,-87.63184
638,2,9,true,9,13,4,41.87827,-87.64078
TA1305000005,2,9,true,6,7,1,41.87924,-87.62975
13011,2,9,true,1,20,19,41.87931,-87.63993
KA1503000015,2,9,true,3,14,11,41.87948,-87.6257
TA1309000007,2,9,true,4,21,17,41.88022,-87.63526
WL-011,2,9,true,5,7,2,41.88034,-87.64273
13156,2,9,true,6,6,0,41.88042,-87.65554
13008,2,9,true,3,11,8,41.88105,-87.62408
TA1305000006,2,9,true,3,8,5,41.88122,-87.6296
13056,2,9,true,9,6,-3,41.88168,-87.63951
TA1307000120,2,9,true,8,7,-1,41.88188,-87.64879
13341,2,9,true,2,8,6,41.88208,-87.63985
13036,2,9,true,2,13,11,41.8821,-87.62513
TA1305000032,2,9,true,6,10,4,41.88218,-87.64109
13006,2,9,true,3,6,3,41.88268,-87.63252
13409,2,9,true,9,12,3,41.8831,-87.6511
WL-012,2,9,true,13,15,2,41.88337,-87.6412
13053,2,9,true,11,10,-1,41.88365,-87.64863
13001,2,9,true,9,12,3,41.88397,-87.62459
13155,2,9,true,2,6,4,41.88407,-87.65689
18062,2,9,true,1,5,4,41.88412,-87.65427
TA1306000010,2,9,true,12,28,16,41.88419,-87.62961
TA1305000030,2,9,true,7,18,11,41.88459,-87.63178
TA1305000029,2,9,true,4,19,15,41.88466,-87.62787
13263,2,9,true,4,7,3,41.88467,-87.61952
TA1306000015,2,9,true,10,1,-9,41.88549,-87.65232
13021,2,9,true,16,24,8,41.88559,-87.64184
TA1307000111,2,9,true,7,6,-1,41.88582,-87.63548
KA1503000012,2,9,true,8,28,20,41.88599,-87.63089
TA1305000011,2,9,true,12,21,9,41.886,-87.62418
TA1308000029,2,9,true,4,9,5,41.88673,-87.62225
TA1307000131,2,9,true,3,12,9,41.88688,-87.62606
TA1305000022,2,9,true,8,16,8,41.88817,-87.63656
TA1306000003,2,9,true,12,3,-9,41.88867,-87.64442
KA1503000043,2,9,true,20,26,6,41.88918,-87.63851
13050,2,9,true,9,16,7,41.88919,-87.62775
TA1307000151,2,9,true,8,16,8,41.88993,-87.63427
636,2,9,true,3,5,2,41.88997,-87.63662
KA1503000044,2,9,true,2,7,5,41.89018,-87.6262
13430,2,9,true,6,11,5,41.89077,-87.63169
TA1306000013,2,9,true,5,5,0,41.89083,-87.61852
RN-,2,9,true,6,8,2,41.89102,-87.63546
13434,2,9,true,2,6,4,41.89108,-87.66663
TA1307000117,2,9,true,6,9,3,41.89144,-87.62675
13033,2,9,true,12,13,1,41.8916,-87.64835
13194,2,9,true,10,3,-7,41.8918,-87.65878
TA1305000003,2,9,true,7,8,1,41.89187,-87.62061
13022,2,9,true,7,5,-2,41.89227,-87.61205
TA1306000029,2,9,true,6,7,1,41.89256,-87.61449
13265,2,9,true,8,7,-1,41.89383,-87.64172
13045,2,9,true,10,18,8,41.89403,-87.62931
13016,2,9,true,8,21,13,41.89431,-87.62277
KA1503000041,2,9,true,13,14,1,41.89452,-87.61798
13196,2,9,true,1,5,4,41.89455,-87.65345
TA1307000062,2,9,true,18,15,-3,41.89466,-87.63839
TA1306000012,2,9,true,10,10,0,41.89475,-87.63438
KP1705001026,2,9,true,5,11,6,41.89483,-87.6323
637,2,9,true,6,1,-5,41.89563,-87.67209
15530,2,9,true,8,12,4,41.89575,-87.62596
18003,2,9,true,2,9,7,41.89575,-87.62011
TA1305000020,2,9,true,2,6,4,41.89636,-87.65406
13289,2,9,true,12,1,-11,41.89638,-87.661
13303,2,9,true,6,6,0,41.89672,-87.63088
13017,2,9,true,11,14,3,41.89676,-87.6357
13338,2,9,true,11,11,0,41.89697,-87.62173
TA1307000061,2,9,true,6,6,0,41.89745,-87.62873
TA1306000009,2,9,true,13,18,5,41.89772,-87.64299
620,2,9,true,2,8,6,41.89817,-87.63754
15529,2,9,true,10,17,7,41.89858,-87.62206
TA1307000128,2,9,true,5,4,-1,41.89896,-87.6299
657,2,9,true,6,5,-1,41.89918,-87.6722
13042,2,9,true,8,22,14,41.90097,-87.62377
KA1504000133,2,9,true,4,8,4,41.90234,-87.62773
13241,2,9,true,1,5,4,41.9029,-87.68731
TA1307000039,2,9,true,19,13,-6,41.90294,-87.63137
KA1504000135,2,9,true,8,10,2,41.90319,-87.63439
13136,2,9,true,7,1,-6,41.90326,-87.67845
13061,2,9,true,9,7,-2,41.90342,-87.66779
KA1504000079,2,9,true,5,6,1,41.9035,-87.64334
TA1308000049,2,9,true,9,2,-7,41.90672,-87.6349
KA1504000134,2,9,true,3,6,3,41.90687,-87.6262
13224,2,9,true,4,5,1,41.90706,-87.66725
TA1309000024,2,9,true,6,5,-1,41.908,-87.63152
TA1305000041,2,9,true,4,9,5,41.9094,-87.67769
331,2,9,true,12,3,-9,41.90965,-87.64812
13154,2,9,true,6,2,-4,41.91054,-87.65312
TA1307000038,2,9,true,7,4,-3,41.91138,-87.63868
LF-005,2,9,true,15,9,-6,41.91172,-87.62681
TA1308000050,2,9,true,3,6,3,41.91211,-87.6347
TA1306000007,2,9,true,5,2,-3,41.91469,-87.64333
13068,2,9,true,3,5,2,41.91554,-87.68703
13179,2,9,true,10,4,-6,41.9157,-87.63461
13133,2,9,true,5,1,-4,41.91598,-87.67733
TA1307000163,2,9,true,9,4,-5,41.91821,-87.65696
13059,2,9,true,7,7,0,41.91845,-87.65222
13288,2,9,true,5,1,-4,41.92008,-87.67788
13193,2,9,true,7,7,0,41.92182,-87.64412
13191,2,9,true,8,5,-3,41.92217,-87.63891
TA1307000001,2,9,true,5,1,-4,41.92535,-87.66581
TA1306000026,2,9,true,2,7,5,41.92558,-87.65842
TA1306000016,2,9,true,5,3,-2,41.9256,-87.65371
TA1309000019,2,9,true,8,5,-3,41.92586,-87.63897
TA1309000058,2,9,true,3,6,3,41.92591,-87.64927
TA1308000001,2,9,true,5,9,4,41.92627,-87.63086
TA1309000061,2,9,true,7,5,-2,41.92915,-87.64909
TA1305000014,2,9,true,4,5,1,41.92956,-87.64313
TA1307000142,2,9,true,6,5,-1,41.93125,-87.64432
13276,2,9,true,5,4,-1,41.93132,-87.63874
TA1307000064,2,9,true,4,6,2,41.93222,-87.65864
TA1309000039,2,9,true,7,13,6,41.93258,-87.63642
TA1309000036,2,9,true,6,2,-4,41.93313,-87.64776
TA1307000052,2,9,true,4,9,5,41.93628,-87.65266
TA1307000136,2,9,true,4,7,3,41.9365,-87.64755
TA1307000041,2,9,true,11,8,-3,41.93669,-87.63683
13137,2,9,true,11,5,-6,41.9376,-87.6441
TA1307000134,2,9,true,8,8,0,41.94016,-87.65303
TA1309000049,2,9,true,2,6,4,41.94077,-87.63919
TA1309000025,2,9,true,5,2,-3,41.94368,-87.64894
13071,2,9,true,3,5,2,41.94373,-87.66401
632,2,9,true,3,6,3,41.94453,-87.6547
13278,2,9,true,5,6,1,41.94553,-87.64644
13235,2,9,true,7,6,-1,41.94814,-87.66396
13325,2,9,true,2,8,6,41.94907,-87.64863
TA1307000126,2,9,true,1,6,5,41.94936,-87.65451
TA1307000150,2,9,true,10,5,-5,41.94945,-87.64646
13319,2,9,true,5,4,-1,41.95069,-87.6687
13323,2,9,true,9,3,-6,41.95282,-87.65
13063,2,9,true,5,5,0,41.95424,-87.65441
13379,2,9,true,7,2,-5,41.95786,-87.6495
TA1309000018,2,9,true,4,5,1,41.95791,-87.67357
TA1309000027,2,9,true,8,3,-5,41.9585,-87.65499
TA1307000140,2,9,true,7,2,-5,41.96643,-87.68865
KA1504000171,2,9,true,4,5,1,41.97161,-87.65016
13108,2,9,true,5,1,-4,41.97379,-87.65971
KA1504000152,2,9,true,6,9,3,41.98403,-87.65231
15571,2,9,true,7,1,-6,41.99478,-87.66028
596,2,9,true,2,6,4,42.04822,-87.68348
604,2,9,true,1,6,5,42.05824,-87.67744
KA1503000071,2,10,false,1,5,4,41.79148,-87.59988
KA1503000074,2,10,false,3,8,5,41.79174,-87.58395
KA1504000076,2,10,false,5,3,-2,41.7943,-87.60145
TA1308000009,2,10,false,6,1,-5,41.79522,-87.58075
15545,2,10,false,7,5,-2,41.85627,-87.61334
13164,2,10,false,6,5,-1,41.85818,-87.65648
13431,2,10,false,2,6,4,41.8661,-87.60728
15544,2,10,false,21,30,9,41.86723,-87.61536
SL-005,2,10,false,19,2,-17,41.8679,-87.62304
623,2,10,false,17,5,-12,41.87272,-87.62399
15541,2,10,false,13,1,-12,41.8758,-87.62086
TA1305000010,2,10,false,8,4,-4,41.87623,-87.62444
624,2,10,false,5,4,-1,41.87626,-87.62923
TA1305000025,2,10,false,4,6,2,41.87773,-87.63528
TA1309000002,2,10,false,4,7,3,41.87784,-87.62408
TA1305000005,2,10,false,11,3,-8,41.87924,-87.62975
TA1309000008,2,10,false,13,5,-8,41.87933,-87.6355
13300,2,10,false,17,18,1,41.88097,-87.61675
13008,2,10,false,8,18,10,41.88105,-87.62408
13036,2,10,false,6,3,-3,41.8821,-87.62513
13053,2,10,false,6,4,-2,41.88365,-87.64863
13001,2,10,false,10,14,4,41.88397,-87.62459
TA1306000010,2,10,false,8,9,1,41.88419,-87.62961
TA1305000030,2,10,false,3,5,2,41.88459,-87.63178
TA1305000029,2,10,false,8,5,-3,41.88466,-87.62787
13263,2,10,false,6,8,2,41.88467,-87.61952
TA1306000015,2,10,false,1,6,5,41.88549,-87.65232
KA1503000012,2,10,false,4,5,1,41.88599,-87.63089
TA1305000011,2,10,false,12,3,-9,41.886,-87.62418
TA1307000131,2,10,false,5,1,-4,41.88688,-87.62606
KA1503000064,2,10,false,4,7,3,41.88697,-87.61281
TA1306000003,2,10,false,4,6,2,41.88867,-87.64442
13427,2,10,false,7,3,-4,41.89054,-87.62205
13430,2,10,false,10,5,-5,41.89077,-87.63169
TA1306000013,2,10,false,19,8,-11,41.89083,-87.61852
RN-,2,10,false,2,6,4,41.89102,-87.63546
TA1307000117,2,10,false,6,3,-3,41.89144,-87.62675
13033,2,10,false,5,2,-3,41.8916,-87.64835
TA1305000003,2,10,false,10,7,-3,41.89187,-87.62061
13022,2,10,false,29,31,2,41.89227,-87.61205
TA1306000029,2,10,false,3,6,3,41.89256,-87.61449
13045,2,10,false,5,5,0,41.89403,-87.62931
13016,2,10,false,12,13,1,41.89431,-87.62277
KA1503000041,2,10,false,7,3,-4,41.89452,-87.61798
13017,2,10,false,5,2,-3,41.89676,-87.6357
15529,2,10,false,15,7,-8,41.89858,-87.62206
13042,2,10,false,21,21,0,41.90097,-87.62377
KA1504000133,2,10,false,7,4,-3,41.90234,-87.62773
KA1504000135,2,10,false,5,2,-3,41.90319,-87.63439
13061,2,10,false,5,7,2,41.90342,-87.66779
KA1504000134,2,10,false,4,6,2,41.90687,-87.6262
TA1309000024,2,10,false,5,4,-1,41.908,-87.63152
TA1307000038,2,10,false,5,1,-4,41.91138,-87.63868
LF-005,2,10,false,15,6,-9,41.91172,-87.62681
13146,2,10,false,5,6,1,41.91831,-87.63629
13059,2,10,false,4,5,1,41.91845,-87.65222
LP-,2,10,false,7,7,0,41.92396,-87.63584
TA1308000001,2,10,false,11,10,-1,41.92627,-87.63086
TA1307000006,2,10,false,3,5,2,41.93571,-87.6636
TA1307000136,2,10,false,1,6,5,41.9365,-87.64755
13137,2,10,false,4,5,1,41.9376,-87.6441
13278,2,10,false,6,4,-2,41.94553,-87.64644
13235,2,10,false,1,6,5,41.94814,-87.66396
13389,2,10,false,7,1,-6,41.961,-87.64958
TA1308000012,2,10,false,5,6,1,41.96398,-87.63818
KA1504000152,2,10,false,5,1,-4,41.98403,-87.65231
596,2,10,false,5,2,-3,42.04822,-87.68348
KA1503000014,2,10,true,5,3,-2,41.7851,-87.60108
TA1309000011,2,10,true,1,6,5,41.78873,-87.60131
KA1503000071,2,10,true,1,9,8,41.79148,-87.59988
KA1504000076,2,10,true,3,5,2,41.7943,-87.60145
KA1503000007,2,10,true,5,1,-4,41.80242,-87.58689
TA1308000045,2,10,true,5,1,-4,41.83062,-87.64129
TA1307000129,2,10,true,1,7,6,41.83104,-87.62683
13216,2,10,true,2,6,4,41.83473,-87.62581
15545,2,10,true,5,5,0,41.85627,-87.61334
13135,2,10,true,6,2,-4,41.85753,-87.66157
13102,2,10,true,5,3,-2,41.85762,-87.61942
13150,2,10,true,5,2,-3,41.85783,-87.62455
TA1307000124,2,10,true,4,7,3,41.86411,-87.62372
TA1309000001,2,10,true,2,5,3,41.86488,-87.64708
TA1305000002,2,10,true,9,4,-5,41.86721,-87.62597
SL-005,2,10,true,10,6,-4,41.8679,-87.62304
13285,2,10,true,7,6,-1,41.86928,-87.67372
TA1309000010,2,10,true,4,7,3,41.87074,-87.62574
TA1309000064,2,10,true,2,5,3,41.87127,-87.67369
TA1307000130,2,10,true,5,3,-2,41.87178,-87.65103
13332,2,10,true,10,12,2,41.87219,-87.6615
SL-011,2,10,true,4,7,3,41.87256,-87.63356
KA1504000104,2,10,true,8,3,-5,41.87296,-87.66912
TA1306000025,2,10,true,5,3,-2,41.87464,-87.65703
624,2,10,true,2,6,4,41.87626,-87.62923
15539,2,10,true,1,5,4,41.87763,-87.64405
13158,2,10,true,5,5,0,41.87764,-87.64957
TA1305000025,2,10,true,9,5,-4,41.87773,-87.63528
TA1309000004,2,10,true,3,5,2,41.87811,-87.63184
TA1305000005,2,10,true,2,8,6,41.87924,-87.62975
13011,2,10,true,5,1,-4,41.87931,-87.63993
KA1503000015,2,10,true,2,6,4,41.87948,-87.6257
TA1309000007,2,10,true,3,6,3,41.88022,-87.63526
WL-011,2,10,true,5,6,1,41.88034,-87.64273
13156,2,10,true,6,7,1,41.88042,-87.65554
13300,2,10,true,7,9,2,41.88097,-87.61675
13008,2,10,true,5,5,0,41.88105,-87.62408
TA1307000120,2,10,true,6,7,1,41.88188,-87.64879
13036,2,10,true,3,6,3,41.8821,-87.62513
13006,2,10,true,5,4,-1,41.88268,-87.63252
WL-012,2,10,true,8,6,-2,41.88337,-87.6412
13053,2,10,true,3,7,4,41.88365,-87.64863
13001,2,10,true,12,8,-4,41.88397,-87.62459
TA1306000010,2,10,true,5,3,-2,41.88419,-87.62961
TA1305000030,2,10,true,5,3,-2,41.88459,-87.63178
TA1305000029,2,10,true,8,11,3,41.88466,-87.62787
13263,2,10,true,6,10,4,41.88467,-87.61952
TA1306000015,2,10,true,6,5,-1,41.88549,-87.65232
13021,2,10,true,11,15,4,41.88559,-87.64184
TA1307000111,2,10,true,10,4,-6,41.88582,-87.63548
KA1503000012,2,10,true,5,9,4,41.88599,-87.63089
TA1305000011,2,10,true,13,5,-8,41.886,-87.62418
TA1308000029,2,10,true,1,5,4,41.88673,-87.62225
KA1503000064,2,10,true,4,5,1,41.88697,-87.61281
TA1305000022,2,10,true,8,14,6,41.88817,-87.63656
TA1306000003,2,10,true,12,7,-5,41.88867,-87.64442
KA1503000043,2,10,true,12,13,1,41.88918,-87.63851
13432,2,10,true,2,5,3,41.88989,-87.67149
TA1307000151,2,10,true,5,4,-1,41.88993,-87.63427
13430,2,10,true,5,6,1,41.89077,-87.63169
TA1306000013,2,10,true,4,7,3,41.89083,-87.61852
RN-,2,10,true,5,5,0,41.89102,-87.63546
TA1307000117,2,10,true,2,5,3,41.89144,-87.62675
13033,2,10,true,5,3,-2,41.8916,-87.64835
13194,2,10,true,1,5,4,41.8918,-87.65878
TA1305000003,2,10,true,14,11,-3,41.89187,-87.62061
13022,2,10,true,8,9,1,41.89227,-87.61205
TA1306000029,2,10,true,9,5,-4,41.89256,-87.61449
13265,2,10,true,6,4,-2,41.89383,-87.64172
13045,2,10,true,7,9,2,41.89403,-87.62931
13016,2,10,true,5,16,11,41.89431,-87.62277
KA1503000041,2,10,true,6,5,-1,41.89452,-87.61798
TA1306000012,2,10,true,14,10,-4,41.89475,-87.63438
KP1705001026,2,10,true,3,5,2,41.89483,-87.6323
15530,2,10,true,3,8,5,41.89575,-87.62596
18003,2,10,true,4,6,2,41.89575,-87.62011
13303,2,10,true,8,5,-3,41.89672,-87.63088
13017,2,10,true,11,10,-1,41.89676,-87.6357
13338,2,10,true,7,8,1,41.89697,-87.62173
TA1307000061,2,10,true,3,6,3,41.89745,-87.62873
TA1306000009,2,10,true,4,6,2,41.89772,-87.64299
15529,2,10,true,4,11,7,41.89858,-87.62206
TA1307000128,2,10,true,3,5,2,41.89896,-87.6299
13290,2,10,true,5,1,-4,41.90069,-87.66259
13042,2,10,true,5,18,13,41.90097,-87.62377
KA1504000133,2,10,true,7,3,-4,41.90234,-87.62773
TA1307000039,2,10,true,8,10,2,41.90294,-87.63137
KA1504000135,2,10,true,5,4,-1,41.90319,-87.63439
13061,2,10,true,11,11,0,41.90342,-87.66779
KA1504000134,2,10,true,8,6,-2,41.90687,-87.6262
13221,2,10,true,8,5,-3,41.90765,-87.67254
TA1309000024,2,10,true,12,9,-3,41.908,-87.63152
331,2,10,true,5,6,1,41.90965,-87.64812
LF-005,2,10,true,16,8,-8,41.91172,-87.62681
TA1308000050,2,10,true,6,10,4,41.91211,-87.6347
TA1306000032,2,10,true,7,3,-4,41.9137,-87.65285
13179,2,10,true,5,6,1,41.9157,-87.63461
TA1307000163,2,10,true,2,6,4,41.91821,-87.65696
13146,2,10,true,6,2,-4,41.91831,-87.63629
13059,2,10,true,6,3,-3,41.91845,-87.65222
13192,2,10,true,2,6,4,41.91995,-87.64884
13193,2,10,true,6,7,1,41.92182,-87.64412
13191,2,10,true,2,5,3,41.92217,-87.63891
13084,2,10,true,5,2,-3,41.92268,-87.69715
TA1307000001,2,10,true,6,5,-1,41.92535,-87.66581
TA1306000026,2,10,true,8,5,-3,41.92558,-87.65842
TA1306000016,2,10,true,5,4,-1,41.9256,-87.65371
TA1309000019,2,10,true,5,4,-1,41.92586,-87.63897
TA1309000058,2,10,true,5,7,2,41.92591,-87.64927
TA1308000001,2,10,true,18,13,-5,41.92627,-87.63086
TA1305000014,2,10,true,8,6,-2,41.92956,-87.64313
TA1307000142,2,10,true,8,2,-6,41.93125,-87.64432
13276,2,10,true,6,3,-3,41.93132,-87.63874
TA1309000039,2,10,true,6,7,1,41.93258,-87.63642
TA1309000036,2,10,true,9,2,-7,41.93313,-87.64776
13269,2,10,true,5,2,-3,41.93609,-87.66983
TA1307000136,2,10,true,5,2,-3,41.9365,-87.64755
TA1307000041,2,10,true,9,5,-4,41.93669,-87.63683
13137,2,10,true,7,4,-3,41.9376,-87.6441
TA1309000042,2,10,true,4,5,1,41.93937,-87.66836
TA1307000134,2,10,true,7,13,6,41.94016,-87.65303
TA1309000049,2,10,true,7,7,0,41.94077,-87.63919
TA1309000025,2,10,true,6,4,-2,41.94368,-87.64894
13071,2,10,true,3,6,3,41.94373,-87.66401
13278,2,10,true,8,4,-4,41.94553,-87.64644
13235,2,10,true,8,8,0,41.94814,-87.66396
13325,2,10,true,3,5,2,41.94907,-87.64863
TA1307000150,2,10,true,5,4,-1,41.94945,-87.64646
13323,2,10,true,3,6,3,41.95282,-87.65
13379,2,10,true,2,7,5,41.95786,-87.6495
TA1308000012,2,10,true,2,5,3,41.96398,-87.63818
639,2,10,true,3,5,2,41.96584,-87.64538
TA1307000140,2,10,true,2,5,3,41.96643,-87.68865
KA1504000146,2,10,true,1,5,4,41.978,-87.66805
13109,2,10,true,6,2,-4,41.97835,-87.65976
KA1504000152,2,10,true,7,8,1,41.98403,-87.65231
KA1503000071,2,11,false,8,7,-1,41.79148,-87.59988
KA1503000074,2,11,false,3,9,6,41.79174,-87.58395
TA1308000009,2,11,false,6,4,-2,41.79522,-87.58075
KA1503000059,2,11,false,2,5,3,41.79952,-87.58643
TA1307000048,2,11,false,3,8,5,41.83855,-87.60821
KA1503000040,2,11,false,5,2,-3,41.84164,-87.65744
13029,2,11,false,1,6,5,41.86531,-87.6179
13431,2,11,false,6,4,-2,41.8661,-87.60728
15544,2,11,false,28,35,7,41.86723,-87.61536
SL-005,2,11,false,11,4,-7,41.8679,-87.62304
TA1309000010,2,11,false,10,3,-7,41.87074,-87.62574
623,2,11,false,16,10,-6,41.87272,-87.62399
15541,2,11,false,15,19,4,41.8758,-87.62086
624,2,11,false,9,5,-4,41.87626,-87.62923
TA1305000025,2,11,false,7,4,-3,41.87773,-87.63528
TA1309000002,2,11,false,9,8,-1,41.87784,-87.62408
TA1305000005,2,11,false,8,5,-3,41.87924,-87.62975
TA1309000008,2,11,false,2,9,7,41.87933,-87.6355
KA1503000034,2,11,false,7,2,-5,41.87938,-87.63197
TA1309000007,2,11,false,7,6,-1,41.88022,-87.63526
13300,2,11,false,23,32,9,41.88097,-87.61675
13008,2,11,false,37,21,-16,41.88105,-87.62408
TA1305000006,2,11,false,18,4,-14,41.88122,-87.6296
TA1307000120,2,11,false,7,9,2,41.88188,-87.64879
13341,2,11,false,9,1,-8,41.88208,-87.63985
13036,2,11,false,6,5,-1,41.8821,-87.62513
WL-012,2,11,false,1,7,6,41.88337,-87.6412
13001,2,11,false,9,6,-3,41.88397,-87.62459
TA1306000010,2,11,false,7,5,-2,41.88419,-87.62961
TA1305000030,2,11,false,6,4,-2,41.88459,-87.63178
TA1305000029,2,11,false,5,5,0,41.88466,-87.62787
13263,2,11,false,7,3,-4,41.88467,-87.61952
TA1306000015,2,11,false,1,8,7,41.88549,-87.65232
13021,2,11,false,9,3,-6,41.88559,-87.64184
TA1307000111,2,11,false,5,3,-2,41.88582,-87.63548
13073,2,11,false,5,2,-3,41.88592,-87.66717
TA1305000011,2,11,false,21,13,-8,41.886,-87.62418
TA1307000131,2,11,false,8,3,-5,41.88688,-87.62606
KA1503000064,2,11,false,8,8,0,41.88697,-87.61281
TA1306000003,2,11,false,5,4,-1,41.88867,-87.64442
13050,2,11,false,3,5,2,41.88919,-87.62775
TA1307000151,2,11,false,2,5,3,41.88993,-87.63427
KA1503000044,2,11,false,1,5,4,41.89018,-87.6262
13427,2,11,false,9,2,-7,41.89054,-87.62205
TA1306000013,2,11,false,7,15,8,41.89083,-87.61852
RN-,2,11,false,6,1,-5,41.89102,-87.63546
13434,2,11,false,5,1,-4,41.89108,-87.66663
TA1307000117,2,11,false,9,7,-2,41.89144,-87.62675
13033,2,11,false,6,6,0,41.8916,-87.64835
TA1305000003,2,11,false,8,14,6,41.89187,-87.62061
13022,2,11,false,40,59,19,41.89227,-87.61205
KA1503000041,2,11,false,3,6,3,41.89452,-87.61798
KP1705001026,2,11,false,7,5,-2,41.89483,-87.6323
13132,2,11,false,1,5,4,41.89573,-87.67718
15530,2,11,false,8,5,-3,41.89575,-87.62596
13017,2,11,false,14,5,-9,41.89676,-87.6357
13034,2,11,false,5,7,2,41.89754,-87.62352
15529,2,11,false,8,10,2,41.89858,-87.62206
TA1307000128,2,11,false,5,9,4,41.89896,-87.6299
13248,2,11,false,3,5,2,41.89964,-87.66788
TA1306000011,2,11,false,5,2,-3,41.89994,-87.63443
13042,2,11,false,32,20,-12,41.90097,-87.62377
KA1504000133,2,11,false,7,18,11,41.90234,-87.62773
TA1305000034,2,11,false,6,4,-2,41.90313,-87.67391
KA1504000135,2,11,false,8,5,-3,41.90319,-87.63439
13061,2,11,false,9,4,-5,41.90342,-87.66779
TA1307000115,2,11,false,7,3,-4,41.9046,-87.64056
KA1504000134,2,11,false,6,2,-4,41.90687,-87.6262
13221,2,11,false,6,3,-3,41.90765,-87.67254
TA1309000024,2,11,false,3,6,3,41.908,-87.63152
331,2,11,false,3,6,3,41.90965,-87.64812
LF-005,2,11,false,16,16,0,41.91172,-87.62681
TA1306000032,2,11,false,1,5,4,41.9137,-87.65285
13179,2,11,false,5,6,1,41.9157,-87.63461
13146,2,11,false,4,6,2,41.91831,-87.63629
13059,2,11,false,6,2,-4,41.91845,-87.65222
13192,2,11,false,6,8,2,41.91995,-87.64884
13193,2,11,false,7,1,-6,41.92182,-87.64412
13084,2,11,false,6,4,-2,41.92268,-87.69715
LP-,2,11,false,6,7,1,41.92396,-87.63584
TA1309000019,2,11,false,5,4,-1,41.92586,-87.63897
TA1308000001,2,11,false,8,18,10,41.92627,-87.63086
TA1309000061,2,11,false,8,1,-7,41.92915,-87.64909
13085,2,11,false,7,3,-4,41.92958,-87.70789
TA1307000142,2,11,false,6,2,-4,41.93125,-87.64432
TA1307000064,2,11,false,5,2,-3,41.93222,-87.65864
TA1309000039,2,11,false,4,7,3,41.93258,-87.63642
TA1307000006,2,11,false,5,3,-2,41.93571,-87.6636
TA1307000052,2,11,false,5,4,-1,41.93628,-87.65266
TA1307000136,2,11,false,6,4,-2,41.9365,-87.64755
TA1307000041,2,11,false,8,8,0,41.93669,-87.63683
13137,2,11,false,6,3,-3,41.9376,-87.6441
TA1307000134,2,11,false,6,1,-5,41.94016,-87.65303
TA1309000049,2,11,false,5,3,-2,41.94077,-87.63919
TA1309000025,2,11,false,2,6,4,41.94368,-87.64894
13278,2,11,false,6,9,3,41.94553,-87.64644
13235,2,11,false,4,5,1,41.94814,-87.66396
TA1307000126,2,11,false,8,5,-3,41.94936,-87.65451
13379,2,11,false,5,3,-2,41.95786,-87.6495
639,2,11,false,4,8,4,41.96584,-87.64538
KA1504000152,2,11,false,11,6,-5,41.98403,-87.65231
15571,2,11,false,5,1,-4,41.99478,-87.66028
596,2,11,false,2,6,4,42.04822,-87.68348
605,2,11,false,2,5,3,42.05294,-87.67342
661,2,11,false,5,6,1,42.05704,-87.68657
TA1308000009,2,11,true,5,5,0,41.79522,-87.58075
13216,2,11,true,1,7,6,41.83473,-87.62581
TA1309000055,2,11,true,5,1,-4,41.8382,-87.64514
TA1307000139,2,11,true,8,4,-4,41.84205,-87.61698
15545,2,11,true,5,5,0,41.85627,-87.61334
13135,2,11,true,1,5,4,41.85753,-87.66157
TA1307000159,2,11,true,6,1,-5,41.8579,-87.6687
SL-012,2,11,true,9,5,-4,41.86038,-87.62581
TA1307000124,2,11,true,5,5,0,41.86411,-87.62372
WL-008,2,11,true,2,5,3,41.86712,-87.64108
TA1305000002,2,11,true,8,6,-2,41.86721,-87.62597
TA1309000010,2,11,true,1,5,4,41.87074,-87.62574
TA1309000064,2,11,true,7,7,0,41.87127,-87.67369
TA1307000130,2,11,true,5,7,2,41.87178,-87.65103
TA1307000121,2,11,true,5,7,2,41.87184,-87.64664
13332,2,11,true,9,12,3,41.87219,-87.6615
KA1504000104,2,11,true,8,3,-5,41.87296,-87.66912
13028,2,11,true,5,8,3,41.87475,-87.64981
TA1305000010,2,11,true,2,6,4,41.87623,-87.62444
TA1305000035,2,11,true,7,1,-6,41.87716,-87.62787
15539,2,11,true,5,1,-4,41.87763,-87.64405
13158,2,11,true,11,6,-5,41.87764,-87.64957
13157,2,11,true,6,8,2,41.87773,-87.6548
TA1305000025,2,11,true,8,7,-1,41.87773,-87.63528
TA1309000004,2,11,true,8,5,-3,41.87811,-87.63184
638,2,11,true,3,7,4,41.87827,-87.64078
TA1305000005,2,11,true,4,8,4,41.87924,-87.62975
KA1503000015,2,11,true,3,5,2,41.87948,-87.6257
TA1309000007,2,11,true,7,13,6,41.88022,-87.63526
WL-011,2,11,true,7,8,1,41.88034,-87.64273
13156,2,11,true,5,5,0,41.88042,-87.65554
13300,2,11,true,6,10,4,41.88097,-87.61675
13008,2,11,true,3,5,2,41.88105,-87.62408
TA1305000006,2,11,true,5,8,3,41.88122,-87.6296
TA1307000120,2,11,true,11,14,3,41.88188,-87.64879
13341,2,11,true,3,6,3,41.88208,-87.63985
13036,2,11,true,7,10,3,41.8821,-87.62513
TA1305000032,2,11,true,7,4,-3,41.88218,-87.64109
13006,2,11,true,10,9,-1,41.88268,-87.63252
KA1503000072,2,11,true,6,4,-2,41.88317,-87.63693
WL-012,2,11,true,5,4,-1,41.88337,-87.6412
13053,2,11,true,2,5,3,41.88365,-87.64863
13001,2,11,true,6,5,-1,41.88397,-87.62459
TA1306000010,2,11,true,6,8,2,41.88419,-87.62961
TA1305000030,2,11,true,5,8,3,41.88459,-87.63178
15535,2,11,true,2,11,9,41.8846,-87.64455
TA1305000029,2,11,true,4,8,4,41.88466,-87.62787
13263,2,11,true,14,7,-7,41.88467,-87.61952
TA1306000015,2,11,true,5,6,1,41.88549,-87.65232
13021,2,11,true,11,14,3,41.88559,-87.64184
TA1307000111,2,11,true,6,2,-4,41.88582,-87.63548
KA1503000012,2,11,true,7,7,0,41.88599,-87.63089
TA1305000011,2,11,true,13,7,-6,41.886,-87.62418
TA1305000022,2,11,true,7,6,-1,41.88817,-87.63656
TA1306000003,2,11,true,9,11,2,41.88867,-87.64442
KA1503000043,2,11,true,12,17,5,41.88918,-87.63851
13050,2,11,true,4,7,3,41.88919,-87.62775
TA1307000151,2,11,true,6,12,6,41.88993,-87.63427
KA1503000044,2,11,true,6,7,1,41.89018,-87.6262
13430,2,11,true,4,5,1,41.89077,-87.63169
TA1306000013,2,11,true,8,2,-6,41.89083,-87.61852
RN-,2,11,true,7,4,-3,41.89102,-87.63546
TA1307000117,2,11,true,7,6,-1,41.89144,-87.62675
13033,2,11,true,12,7,-5,41.8916,-87.64835
13194,2,11,true,5,6,1,41.8918,-87.65878
TA1305000003,2,11,true,4,8,4,41.89187,-87.62061
13022,2,11,true,9,9,0,41.89227,-87.61205
TA1306000029,2,11,true,2,6,4,41.89256,-87.61449
13265,2,11,true,8,6,-2,41.89383,-87.64172
13045,2,11,true,8,12,4,41.89403,-87.62931
13016,2,11,true,10,10,0,41.89431,-87.62277
KA1503000041,2,11,true,8,7,-1,41.89452,-87.61798
TA1307000062,2,11,true,9,1,-8,41.89466,-87.63839
KP1705001026,2,11,true,6,4,-2,41.89483,-87.6323
15530,2,11,true,5,2,-3,41.89575,-87.62596
18003,2,11,true,5,7,2,41.89575,-87.62011
13017,2,11,true,10,1,-9,41.89676,-87.6357
13338,2,11,true,5,5,0,41.89697,-87.62173
TA1307000061,2,11,true,5,7,2,41.89745,-87.62873
13034,2,11,true,2,5,3,41.89754,-87.62352
TA1306000009,2,11,true,7,10,3,41.89772,-87.64299
620,2,11,true,7,4,-3,41.89817,-87.63754
15529,2,11,true,8,9,1,41.89858,-87.62206
TA1307000128,2,11,true,11,12,1,41.89896,-87.6299
13042,2,11,true,9,11,2,41.90097,-87.62377
KA1504000133,2,11,true,5,10,5,41.90234,-87.62773
TA1307000039,2,11,true,9,6,-3,41.90294,-87.63137
TA1305000034,2,11,true,5,3,-2,41.90313,-87.67391
KA1504000135,2,11,true,4,7,3,41.90319,-87.63439
13061,2,11,true,6,11,5,41.90342,-87.66779
KA1504000079,2,11,true,9,5,-4,41.9035,-87.64334
KA1504000134,2,11,true,4,5,1,41.90687,-87.6262
13221,2,11,true,7,6,-1,41.90765,-87.67254
TA1309000024,2,11,true,9,5,-4,41.908,-87.63152
331,2,11,true,5,4,-1,41.90965,-87.64812
13154,2,11,true,7,10,3,41.91054,-87.65312
TA1307000038,2,11,true,9,3,-6,41.91138,-87.63868
LF-005,2,11,true,11,4,-7,41.91172,-87.62681
TA1308000050,2,11,true,10,9,-1,41.91211,-87.6347
13243,2,11,true,6,4,-2,41.91262,-87.6814
TA1306000032,2,11,true,8,6,-2,41.9137,-87.65285
TA1307000166,2,11,true,6,3,-3,41.91386,-87.64877
13068,2,11,true,5,2,-3,41.91554,-87.68703
13179,2,11,true,6,5,-1,41.9157,-87.63461
13133,2,11,true,8,4,-4,41.91598,-87.67733
TA1309000029,2,11,true,7,1,-6,41.9178,-87.68245
TA1307000163,2,11,true,1,6,5,41.91821,-87.65696
13146,2,11,true,3,6,3,41.91831,-87.63629
13059,2,11,true,6,4,-2,41.91845,-87.65222
13192,2,11,true,3,8,5,41.91995,-87.64884
13288,2,11,true,3,6,3,41.92008,-87.67788
TA1309000033,2,11,true,4,5,1,41.92158,-87.65381
13193,2,11,true,4,5,1,41.92182,-87.64412
13191,2,11,true,4,7,3,41.92217,-87.63891
TA1307000001,2,11,true,7,10,3,41.92535,-87.66581
TA1306000026,2,11,true,6,7,1,41.92558,-87.65842
TA1306000016,2,11,true,6,2,-4,41.9256,-87.65371
TA1309000019,2,11,true,8,9,1,41.92586,-87.63897
TA1309000058,2,11,true,12,4,-8,41.92591,-87.64927
TA1308000001,2,11,true,7,4,-3,41.92627,-87.63086
TA1309000061,2,11,true,6,7,1,41.92915,-87.64909
TA1305000014,2,11,true,6,6,0,41.92956,-87.64313
13085,2,11,true,5,1,-4,41.92958,-87.70789
TA1307000142,2,11,true,4,10,6,41.93125,-87.64432
13271,2,11,true,3,7,4,41.93192,-87.67784
TA1307000064,2,11,true,6,3,-3,41.93222,-87.65864
TA1306000014,2,11,true,2,6,4,41.93242,-87.65271
TA1309000039,2,11,true,7,4,-3,41.93258,-87.63642
TA1307000006,2,11,true,10,4,-6,41.93571,-87.6636
TA1307000052,2,11,true,9,5,-4,41.93628,-87.65266
TA1307000136,2,11,true,7,6,-1,41.9365,-87.64755
13137,2,11,true,10,8,-2,41.9376,-87.6441
TA1309000042,2,11,true,4,6,2,41.93937,-87.66836
13277,2,11,true,7,3,-4,41.9401,-87.64546
TA1307000134,2,11,true,6,5,-1,41.94016,-87.65303
TA1309000049,2,11,true,8,7,-1,41.94077,-87.63919
TA1309000025,2,11,true,1,6,5,41.94368,-87.64894
13278,2,11,true,7,3,-4,41.94553,-87.64644
13235,2,11,true,7,5,-2,41.94814,-87.66396
13325,2,11,true,11,10,-1,41.94907,-87.64863
TA1307000126,2,11,true,3,6,3,41.94936,-87.65451
TA1307000150,2,11,true,5,5,0,41.94945,-87.64646
13319,2,11,true,5,4,-1,41.95069,-87.6687
TA1307000127,2,11,true,8,4,-4,41.9508,-87.65918
13323,2,11,true,7,11,4,41.95282,-87.65
13063,2,11,true,5,7,2,41.95424,-87.65441
13379,2,11,true,9,8,-1,41.95786,-87.6495
TA1309000027,2,11,true,6,5,-1,41.9585,-87.65499
13389,2,11,true,6,5,-1,41.961,-87.64958
TA1307000107,2,11,true,8,6,-2,41.96164,-87.65464
TA1309000012,2,11,true,5,2,-3,41.96325,-87.67928
TA1308000012,2,11,true,4,5,1,41.96398,-87.63818
13074,2,11,true,4,5,1,41.96521,-87.6582
TA1307000140,2,11,true,8,8,0,41.96643,-87.68865
TA1309000066,2,11,true,5,3,-2,41.9691,-87.67423
KA1504000171,2,11,true,9,5,-4,41.97161,-87.65016
KA1504000146,2,11,true,2,5,3,41.978,-87.66805
KA1504000152,2,11,true,7,4,-3,41.98403,-87.65231
660,2,11,true,6,2,-4,42.00458,-87.66143
604,2,11,true,1,6,5,42.05824,-87.67744
15491,2,12,false,1,5,4,41.78096,-87.57624
KA1503000014,2,12,false,10,2,-8,41.7851,-87.60108
KA1503000074,2,12,false,7,8,1,41.79174,-87.58395
TA1309000037,2,12,false,4,11,7,41.79957,-87.59474
TA1307000048,2,12,false,7,1,-6,41.83855,-87.60821
TA1305000001,2,12,false,5,4,-1,41.85262,-87.6265
13075,2,12,false,5,5,0,41.8531,-87.63192
15545,2,12,false,7,5,-2,41.85627,-87.61334
13029,2,12,false,11,5,-6,41.86531,-87.6179
13431,2,12,false,14,1,-13,41.8661,-87.60728
TA1305000002,2,12,false,7,5,-2,41.86721,-87.62597
15544,2,12,false,43,61,18,41.86723,-87.61536
SL-005,2,12,false,11,9,-2,41.8679,-87.62304
SL-008,2,12,false,5,4,-1,41.87209,-87.62956
623,2,12,false,12,14,2,41.87272,-87.62399
SL-007,2,12,false,5,5,0,41.87404,-87.6277
15541,2,12,false,20,10,-10,41.8758,-87.62086
TA1305000025,2,12,false,17,14,-3,41.87773,-87.63528
TA1309000004,2,12,false,9,3,-6,41.87811,-87.63184
638,2,12,false,1,6,5,41.87827,-87.64078
TA1305000005,2,12,false,12,4,-8,41.87924,-87.62975
13011,2,12,false,2,6,4,41.87931,-87.63993
TA1309000008,2,12,false,11,5,-6,41.87933,-87.6355
KA1503000034,2,12,false,7,4,-3,41.87938,-87.63197
13300,2,12,false,67,26,-41,41.88097,-87.61675
13008,2,12,false,27,39,12,41.88105,-87.62408
TA1305000006,2,12,false,17,14,-3,41.88122,-87.6296
TA1307000120,2,12,false,7,5,-2,41.88188,-87.64879
WL-012,2,12,false,5,6,1,41.88337,-87.6412
13001,2,12,false,21,19,-2,41.88397,-87.62459
TA1305000029,2,12,false,10,9,-1,41.88466,-87.62787
13263,2,12,false,14,2,-12,41.88467,-87.61952
TA1306000015,2,12,false,5,7,2,41.88549,-87.65232
13021,2,12,false,5,6,1,41.88559,-87.64184
TA1305000011,2,12,false,25,15,-10,41.886,-87.62418
TA1307000131,2,12,false,7,10,3,41.88688,-87.62606
KA1503000064,2,12,false,25,9,-16,41.88697,-87.61281
TA1305000022,2,12,false,4,5,1,41.88817,-87.63656
TA1306000003,2,12,false,3,7,4,41.88867,-87.64442
KA1503000043,2,12,false,3,10,7,41.88918,-87.63851
13050,2,12,false,6,11,5,41.88919,-87.62775
TA1307000151,2,12,false,8,5,-3,41.88993,-87.63427
KA1503000044,2,12,false,7,5,-2,41.89018,-87.6262
13427,2,12,false,6,5,-1,41.89054,-87.62205
13430,2,12,false,12,9,-3,41.89077,-87.63169
TA1306000013,2,12,false,10,12,2,41.89083,-87.61852
RN-,2,12,false,10,6,-4,41.89102,-87.63546
TA1307000117,2,12,false,7,8,1,41.89144,-87.62675
TA1305000003,2,12,false,8,13,5,41.89187,-87.62061
13022,2,12,false,72,92,20,41.89227,-87.61205
TA1306000029,2,12,false,17,11,-6,41.89256,-87.61449
13045,2,12,false,8,5,-3,41.89403,-87.62931
13016,2,12,false,14,4,-10,41.89431,-87.62277
KA1503000041,2,12,false,5,4,-1,41.89452,-87.61798
TA1307000062,2,12,false,5,8,3,41.89466,-87.63839
TA1306000012,2,12,false,4,10,6,41.89475,-87.63438
13132,2,12,false,4,5,1,41.89573,-87.67718
15530,2,12,false,7,11,4,41.89575,-87.62596
18003,2,12,false,5,2,-3,41.89575,-87.62011
13303,2,12,false,3,12,9,41.89672,-87.63088
13017,2,12,false,7,3,-4,41.89676,-87.6357
13338,2,12,false,18,6,-12,41.89697,-87.62173
13034,2,12,false,13,9,-4,41.89754,-87.62352
620,2,12,false,5,7,2,41.89817,-87.63754
15529,2,12,false,8,10,2,41.89858,-87.62206
TA1307000128,2,12,false,9,13,4,41.89896,-87.6299
13290,2,12,false,3,7,4,41.90069,-87.66259
13042,2,12,false,38,30,-8,41.90097,-87.62377
KA1504000133,2,12,false,6,10,4,41.90234,-87.62773
TA1307000039,2,12,false,1,13,12,41.90294,-87.63137
KA1504000135,2,12,false,6,8,2,41.90319,-87.63439
13061,2,12,false,4,9,5,41.90342,-87.66779
KA1504000079,2,12,false,5,3,-2,41.9035,-87.64334
13221,2,12,false,5,3,-2,41.90765,-87.67254
TA1309000024,2,12,false,5,3,-2,41.908,-87.63152
TA1305000041,2,12,false,2,5,3,41.9094,-87.67769
331,2,12,false,5,9,4,41.90965,-87.64812
TA1305000037,2,12,false,2,7,5,41.91018,-87.67003
13058,2,12,false,5,2,-3,41.91059,-87.64942
LF-005,2,12,false,19,34,15,41.91172,-87.62681
TA1308000050,2,12,false,6,12,6,41.91211,-87.6347
13243,2,12,false,1,7,6,41.91262,-87.6814
18017,2,12,false,5,3,-2,41.91416,-87.71676
13179,2,12,false,8,13,5,41.9157,-87.63461
13133,2,12,false,8,1,-7,41.91598,-87.67733
15651,2,12,false,5,2,-3,41.91752,-87.70181
13146,2,12,false,6,28,22,41.91831,-87.63629
13192,2,12,false,9,7,-2,41.91995,-87.64884
TA1309000030,2,12,false,1,5,4,41.92077,-87.66372
13193,2,12,false,11,5,-6,41.92182,-87.64412
LP-,2,12,false,17,8,-9,41.92396,-87.63584
TA1307000001,2,12,false,2,5,3,41.92535,-87.66581
TA1309000019,2,12,false,11,12,1,41.92586,-87.63897
TA1309000058,2,12,false,4,6,2,41.92591,-87.64927
TA1308000001,2,12,false,17,17,0,41.92627,-87.63086
13124,2,12,false,9,5,-4,41.92675,-87.63444
TA1309000023,2,12,false,5,2,-3,41.9287,-87.65383
13296,2,12,false,2,5,3,41.92883,-87.66852
TA1305000014,2,12,false,6,6,0,41.92956,-87.64313
TA1307000142,2,12,false,8,8,0,41.93125,-87.64432
13276,2,12,false,6,5,-1,41.93132,-87.63874
13271,2,12,false,5,2,-3,41.93192,-87.67784
TA1309000039,2,12,false,7,7,0,41.93258,-87.63642
13269,2,12,false,4,5,1,41.93609,-87.66983
TA1307000136,2,12,false,3,6,3,41.9365,-87.64755
TA1307000041,2,12,false,13,15,2,41.93669,-87.63683
13137,2,12,false,10,3,-7,41.9376,-87.6441
13277,2,12,false,7,2,-5,41.9401,-87.64546
TA1307000134,2,12,false,1,5,4,41.94016,-87.65303
TA1309000049,2,12,false,10,4,-6,41.94077,-87.63919
TA1309000025,2,12,false,5,4,-1,41.94368,-87.64894
13071,2,12,false,5,5,0,41.94373,-87.66401
13235,2,12,false,2,7,5,41.94814,-87.66396
TA1307000126,2,12,false,6,4,-2,41.94936,-87.65451
TA1307000150,2,12,false,3,6,3,41.94945,-87.64646
13323,2,12,false,7,3,-4,41.95282,-87.65
13063,2,12,false,5,1,-4,41.95424,-87.65441
TA1309000026,2,12,false,2,5,3,41.95601,-87.6802
TA1309000027,2,12,false,6,3,-3,41.9585,-87.65499
TA1308000012,2,12,false,6,14,8,41.96398,-87.63818
639,2,12,false,9,3,-6,41.96584,-87.64538
KA1504000146,2,12,false,1,9,8,41.978,-87.66805
KA1504000152,2,12,false,9,6,-3,41.98403,-87.65231
596,2,12,false,5,5,0,42.04822,-87.68348
E008,2,12,false,2,5,3,42.05049,-87.67782
605,2,12,false,1,6,5,42.05294,-87.67342
KA1503000071,2,12,true,5,6,1,41.79148,-87.59988
TA1307000129,2,12,true,3,7,4,41.83104,-87.62683
13216,2,12,true,10,9,-1,41.83473,-87.62581
13217,2,12,true,5,3,-2,41.83488,-87.61792
TA1307000139,2,12,true,4,8,4,41.84205,-87.61698
15545,2,12,true,7,7,0,41.85627,-87.61334
13150,2,12,true,4,6,2,41.85783,-87.62455
TA1307000159,2,12,true,2,5,3,41.8579,-87.6687
SL-012,2,12,true,12,3,-9,41.86038,-87.62581
TA1306000002,2,12,true,5,4,-1,41.86238,-87.65108
TA1307000124,2,12,true,4,6,2,41.86411,-87.62372
TA1305000002,2,12,true,9,13,4,41.86721,-87.62597
15544,2,12,true,11,9,-2,41.86723,-87.61536
SL-005,2,12,true,9,11,2,41.8679,-87.62304
13139,2,12,true,6,5,-1,41.86893,-87.65913
TA1309000010,2,12,true,15,4,-11,41.87074,-87.62574
TA1309000064,2,12,true,17,4,-13,41.87127,-87.67369
TA1307000130,2,12,true,7,5,-2,41.87178,-87.65103
SL-008,2,12,true,7,14,7,41.87209,-87.62956
13332,2,12,true,4,11,7,41.87219,-87.6615
SL-011,2,12,true,6,5,-1,41.87256,-87.63356
623,2,12,true,6,3,-3,41.87272,-87.62399
KA1504000104,2,12,true,8,3,-5,41.87296,-87.66912
13028,2,12,true,7,4,-3,41.87475,-87.64981
SL-010,2,12,true,6,3,-3,41.87501,-87.63309
TA1305000010,2,12,true,5,5,0,41.87623,-87.62444
624,2,12,true,5,1,-4,41.87626,-87.62923
TA1305000035,2,12,true,7,9,2,41.87716,-87.62787
13138,2,12,true,4,10,6,41.87723,-87.63941
13158,2,12,true,9,12,3,41.87764,-87.64957
13157,2,12,true,6,9,3,41.87773,-87.6548
TA1305000025,2,12,true,10,10,0,41.87773,-87.63528
TA1309000002,2,12,true,3,5,2,41.87784,-87.62408
13206,2,12,true,6,2,-4,41.87794,-87.66201
638,2,12,true,6,8,2,41.87827,-87.64078
TA1305000005,2,12,true,6,5,-1,41.87924,-87.62975
13011,2,12,true,5,8,3,41.87931,-87.63993
TA1309000008,2,12,true,6,6,0,41.87933,-87.6355
KA1503000034,2,12,true,5,1,-4,41.87938,-87.63197
KA1503000015,2,12,true,7,4,-3,41.87948,-87.6257
TA1309000007,2,12,true,11,14,3,41.88022,-87.63526
WL-011,2,12,true,8,4,-4,41.88034,-87.64273
13300,2,12,true,13,8,-5,41.88097,-87.61675
13008,2,12,true,4,10,6,41.88105,-87.62408
TA1305000006,2,12,true,13,11,-2,41.88122,-87.6296
TA1307000120,2,12,true,10,10,0,41.88188,-87.64879
13341,2,12,true,6,5,-1,41.88208,-87.63985
13036,2,12,true,4,8,4,41.8821,-87.62513
TA1305000032,2,12,true,11,9,-2,41.88218,-87.64109
13006,2,12,true,7,5,-2,41.88268,-87.63252
KA1503000072,2,12,true,2,7,5,41.88317,-87.63693
WL-012,2,12,true,5,9,4,41.88337,-87.6412
13053,2,12,true,8,8,0,41.88365,-87.64863
13001,2,12,true,10,14,4,41.88397,-87.62459
TA1306000010,2,12,true,7,6,-1,41.88419,-87.62961
TA1305000030,2,12,true,12,8,-4,41.88459,-87.63178
15535,2,12,true,8,5,-3,41.8846,-87.64455
TA1305000029,2,12,true,7,13,6,41.88466,-87.62787
13263,2,12,true,8,12,4,41.88467,-87.61952
TA1306000015,2,12,true,5,9,4,41.88549,-87.65232
13021,2,12,true,8,7,-1,41.88559,-87.64184
TA1307000111,2,12,true,10,13,3,41.88582,-87.63548
KA1503000012,2,12,true,9,3,-6,41.88599,-87.63089
TA1305000011,2,12,true,10,10,0,41.886,-87.62418
15534,2,12,true,1,5,4,41.88627,-87.61749
TA1308000029,2,12,true,9,8,-1,41.88673,-87.62225
TA1305000022,2,12,true,6,16,10,41.88817,-87.63656
TA1306000003,2,12,true,12,7,-5,41.88867,-87.64442
KA1503000043,2,12,true,14,20,6,41.88918,-87.63851
13050,2,12,true,2,5,3,41.88919,-87.62775
TA1307000151,2,12,true,14,13,-1,41.88993,-87.63427
KA1503000044,2,12,true,4,6,2,41.89018,-87.6262
13430,2,12,true,5,8,3,41.89077,-87.63169
TA1306000013,2,12,true,3,5,2,41.89083,-87.61852
RN-,2,12,true,6,10,4,41.89102,-87.63546
TA1308000006,2,12,true,2,5,3,41.89128,-87.67686
TA1307000117,2,12,true,14,8,-6,41.89144,-87.62675
13033,2,12,true,13,17,4,41.8916,-87.64835
13194,2,12,true,10,5,-5,41.8918,-87.65878
TA1305000003,2,12,true,9,9,0,41.89187,-87.62061
13022,2,12,true,10,13,3,41.89227,-87.61205
TA1306000029,2,12,true,3,7,4,41.89256,-87.61449
13265,2,12,true,13,7,-6,41.89383,-87.64172
13045,2,12,true,11,16,5,41.89403,-87.62931
13016,2,12,true,13,19,6,41.89431,-87.62277
KA1503000041,2,12,true,6,7,1,41.89452,-87.61798
TA1307000062,2,12,true,9,7,-2,41.89466,-87.63839
TA1306000012,2,12,true,12,14,2,41.89475,-87.63438
KP1705001026,2,12,true,11,4,-7,41.89483,-87.6323
13132,2,12,true,6,7,1,41.89573,-87.67718
15530,2,12,true,9,8,-1,41.89575,-87.62596
18003,2,12,true,6,3,-3,41.89575,-87.62011
13247,2,12,true,6,4,-2,41.89597,-87.66775
13303,2,12,true,5,7,2,41.89672,-87.63088
13017,2,12,true,11,6,-5,41.89676,-87.6357
13338,2,12,true,5,6,1,41.89697,-87.62173
TA1307000061,2,12,true,3,7,4,41.89745,-87.62873
13034,2,12,true,1,7,6,41.89754,-87.62352
TA1306000009,2,12,true,8,7,-1,41.89772,-87.64299
KA1504000103,2,12,true,5,3,-2,41.89842,-87.68659
15529,2,12,true,11,8,-3,41.89858,-87.62206
TA1307000128,2,12,true,8,7,-1,41.89896,-87.6299
13248,2,12,true,8,4,-4,41.89964,-87.66788
13042,2,12,true,11,14,3,41.90097,-87.62377
KA1504000133,2,12,true,12,8,-4,41.90234,-87.62773
13241,2,12,true,6,2,-4,41.9029,-87.68731
TA1307000039,2,12,true,12,15,3,41.90294,-87.63137
KA1504000135,2,12,true,12,22,10,41.90319,-87.63439
13061,2,12,true,11,9,-2,41.90342,-87.66779
KA1504000079,2,12,true,5,4,-1,41.9035,-87.64334
KA1504000134,2,12,true,5,6,1,41.90687,-87.6262
13224,2,12,true,7,3,-4,41.90706,-87.66725
TA1309000024,2,12,true,8,5,-3,41.908,-87.63152
TA1305000041,2,12,true,5,3,-2,41.9094,-87.67769
331,2,12,true,12,7,-5,41.90965,-87.64812
TA1305000037,2,12,true,8,1,-7,41.91018,-87.67003
13154,2,12,true,9,13,4,41.91054,-87.65312
LF-005,2,12,true,9,7,-2,41.91172,-87.62681
13128,2,12,true,4,6,2,41.91197,-87.63197
TA1308000050,2,12,true,8,17,9,41.91211,-87.6347
13243,2,12,true,10,4,-6,41.91262,-87.6814
TA1306000032,2,12,true,6,8,2,41.9137,-87.65285
18067,2,12,true,5,4,-1,41.9146,-87.66796
13179,2,12,true,4,9,5,41.9157,-87.63461
TA1309000006,2,12,true,1,5,4,41.91809,-87.64375
13146,2,12,true,14,9,-5,41.91831,-87.63629
13059,2,12,true,5,6,1,41.91845,-87.65222
13192,2,12,true,16,12,-4,41.91995,-87.64884
TA1309000033,2,12,true,11,10,-1,41.92158,-87.65381
13193,2,12,true,8,12,4,41.92182,-87.64412
13084,2,12,true,5,6,1,41.92268,-87.69715
LP-,2,12,true,8,7,-1,41.92396,-87.63584
TA1307000001,2,12,true,6,3,-3,41.92535,-87.66581
TA1306000026,2,12,true,5,9,4,41.92558,-87.65842
TA1306000016,2,12,true,7,4,-3,41.9256,-87.65371
TA1309000019,2,12,true,8,6,-2,41.92586,-87.63897
TA1309000058,2,12,true,9,19,10,41.92591,-87.64927
TA1308000001,2,12,true,11,17,6,41.92627,-87.63086
13124,2,12,true,6,4,-2,41.92675,-87.63444
TA1307000113,2,12,true,1,6,5,41.92878,-87.66391
TA1309000061,2,12,true,12,12,0,41.92915,-87.64909
TA1305000014,2,12,true,4,10,6,41.92956,-87.64313
TA1307000142,2,12,true,8,7,-1,41.93125,-87.64432
13276,2,12,true,4,5,1,41.93132,-87.63874
TA1307000064,2,12,true,5,5,0,41.93222,-87.65864
TA1309000039,2,12,true,5,6,1,41.93258,-87.63642
TA1309000036,2,12,true,4,6,2,41.93313,-87.64776
13268,2,12,true,5,3,-2,41.93588,-87.67843
TA1307000052,2,12,true,3,6,3,41.93628,-87.65266
TA1307000136,2,12,true,6,10,4,41.9365,-87.64755
TA1307000041,2,12,true,9,6,-3,41.93669,-87.63683
13137,2,12,true,9,13,4,41.9376,-87.6441
TA1308000019,2,12,true,4,5,1,41.93973,-87.65886
13277,2,12,true,6,5,-1,41.9401,-87.64546
TA1307000134,2,12,true,10,11,1,41.94016,-87.65303
TA1309000049,2,12,true,5,5,0,41.94077,-87.63919
TA1307000138,2,12,true,2,5,3,41.94334,-87.67094
13144,2,12,true,5,6,1,41.9434,-87.67964
13071,2,12,true,10,14,4,41.94373,-87.66401
13278,2,12,true,9,6,-3,41.94553,-87.64644
15632,2,12,true,11,4,-7,41.94664,-87.69463
13235,2,12,true,11,8,-3,41.94814,-87.66396
13325,2,12,true,11,4,-7,41.94907,-87.64863
TA1307000126,2,12,true,5,5,0,41.94936,-87.65451
TA1307000150,2,12,true,7,6,-1,41.94945,-87.64646
13323,2,12,true,5,7,2,41.95282,-87.65
13063,2,12,true,6,3,-3,41.95424,-87.65441
TA1308000022,2,12,true,5,8,3,41.95438,-87.64805
13379,2,12,true,5,7,2,41.95786,-87.6495
TA1309000027,2,12,true,5,7,2,41.9585,-87.65499
TA1307000144,2,12,true,4,7,3,41.96142,-87.6762
KA1503000022,2,12,true,6,4,-2,41.96158,-87.66609
TA1307000107,2,12,true,6,8,2,41.96164,-87.65464
TA1307000156,2,12,true,3,5,2,41.96301,-87.68479
TA1308000012,2,12,true,6,6,0,41.96398,-87.63818
13074,2,12,true,1,8,7,41.96521,-87.6582
TA1307000140,2,12,true,12,4,-8,41.96643,-87.68865
TA1309000035,2,12,true,6,2,-4,41.97335,-87.66785
KA1504000146,2,12,true,5,2,-3,41.978,-87.66805
13109,2,12,true,6,3,-3,41.97835,-87.65976
KA1504000151,2,12,true,7,6,-1,41.98359,-87.66916
KA1504000152,2,12,true,7,5,-2,41.98403,-87.65231
15578,2,12,true,4,5,1,41.98405,-87.66027
520,2,12,true,3,5,2,42.01597,-87.66859
15491,2,13,false,5,3,-2,41.78096,-87.57624
KA1503000014,2,13,false,2,5,3,41.7851,-87.60108
TA1309000011,2,13,false,6,5,-1,41.78873,-87.60131
KA1503000071,2,13,false,5,2,-3,41.79148,-87.59988
KA1503000074,2,13,false,4,22,18,41.79174,-87.58395
TA1308000009,2,13,false,7,2,-5,41.79522,-87.58075
TA1309000037,2,13,false,5,9,4,41.79957,-87.59474
KA1503000007,2,13,false,6,6,0,41.80242,-87.58689
KA1503000004,2,13,false,6,4,-2,41.83127,-87.6088
TA1307000048,2,13,false,6,2,-4,41.83855,-87.60821
13089,2,13,false,5,1,-4,41.85497,-87.67567
15545,2,13,false,11,9,-2,41.85627,-87.61334
SL-006,2,13,false,4,7,3,41.8568,-87.63387
13102,2,13,false,5,1,-4,41.85762,-87.61942
13150,2,13,false,7,2,-5,41.85783,-87.62455
TA1307000124,2,13,false,5,8,3,41.86411,-87.62372
13029,2,13,false,12,6,-6,41.86531,-87.6179
TA1305000002,2,13,false,6,3,-3,41.86721,-87.62597
15544,2,13,false,83,53,-30,41.86723,-87.61536
KA1706005007,2,13,false,1,6,5,41.86749,-87.63219
SL-005,2,13,false,6,6,0,41.8679,-87.62304
TA1309000010,2,13,false,3,5,2,41.87074,-87.62574
SL-008,2,13,false,8,8,0,41.87209,-87.62956
SL-011,2,13,false,6,2,-4,41.87256,-87.63356
623,2,13,false,8,5,-3,41.87272,-87.62399
15541,2,13,false,12,20,8,41.8758,-87.62086
TA1305000010,2,13,false,7,1,-6,41.87623,-87.62444
13158,2,13,false,6,3,-3,41.87764,-87.64957
TA1309000002,2,13,false,5,1,-4,41.87784,-87.62408
TA1309000004,2,13,false,13,3,-10,41.87811,-87.63184
KA1503000034,2,13,false,7,5,-2,41.87938,-87.63197
13300,2,13,false,41,39,-2,41.88097,-87.61675
13008,2,13,false,43,36,-7,41.88105,-87.62408
TA1307000120,2,13,false,1,8,7,41.88188,-87.64879
TA1305000032,2,13,false,11,2,-9,41.88218,-87.64109
WL-012,2,13,false,2,7,5,41.88337,-87.6412
13001,2,13,false,32,20,-12,41.88397,-87.62459
TA1306000010,2,13,false,9,11,2,41.88419,-87.62961
TA1305000030,2,13,false,9,7,-2,41.88459,-87.63178
TA1305000029,2,13,false,9,3,-6,41.88466,-87.62787
13263,2,13,false,19,11,-8,41.88467,-87.61952
TA1306000015,2,13,false,10,6,-4,41.88549,-87.65232
KA1503000012,2,13,false,5,10,5,41.88599,-87.63089
TA1305000011,2,13,false,18,20,2,41.886,-87.62418
TA1307000131,2,13,false,4,7,3,41.88688,-87.62606
KA1503000064,2,13,false,26,15,-11,41.88697,-87.61281
TA1306000003,2,13,false,5,4,-1,41.88867,-87.64442
KA1503000043,2,13,false,9,7,-2,41.88918,-87.63851
13050,2,13,false,6,6,0,41.88919,-87.62775
TA1307000151,2,13,false,10,3,-7,41.88993,-87.63427
13427,2,13,false,3,7,4,41.89054,-87.62205
13430,2,13,false,18,18,0,41.89077,-87.63169
TA1306000013,2,13,false,15,10,-5,41.89083,-87.61852
RN-,2,13,false,3,6,3,41.89102,-87.63546
TA1307000117,2,13,false,14,19,5,41.89144,-87.62675
13033,2,13,false,7,2,-5,41.8916,-87.64835
TA1305000003,2,13,false,10,18,8,41.89187,-87.62061
13022,2,13,false,77,117,40,41.89227,-87.61205
TA1306000029,2,13,false,10,6,-4,41.89256,-87.61449
13045,2,13,false,15,3,-12,41.89403,-87.62931
13016,2,13,false,7,13,6,41.89431,-87.62277
13196,2,13,false,6,2,-4,41.89455,-87.65345
TA1307000062,2,13,false,6,1,-5,41.89466,-87.63839
TA1306000012,2,13,false,8,5,-3,41.89475,-87.63438
KP1705001026,2,13,false,4,9,5,41.89483,-87.6323
13132,2,13,false,6,4,-2,41.89573,-87.67718
15530,2,13,false,5,15,10,41.89575,-87.62596
13303,2,13,false,12,1,-11,41.89672,-87.63088
TA1307000061,2,13,false,9,2,-7,41.89745,-87.62873
13034,2,13,false,11,9,-2,41.89754,-87.62352
15529,2,13,false,5,10,5,41.89858,-87.62206
TA1307000128,2,13,false,3,5,2,41.89896,-87.6299
13042,2,13,false,37,43,6,41.90097,-87.62377
KA1504000133,2,13,false,12,11,-1,41.90234,-87.62773
TA1307000039,2,13,false,8,6,-2,41.90294,-87.63137
TA1305000034,2,13,false,1,6,5,41.90313,-87.67391
KA1504000135,2,13,false,13,9,-4,41.90319,-87.63439
13061,2,13,false,5,7,2,41.90342,-87.66779
KA1504000079,2,13,false,6,5,-1,41.9035,-87.64334
TA1308000049,2,13,false,1,5,4,41.90672,-87.6349
KA1504000134,2,13,false,3,5,2,41.90687,-87.6262
TA1305000041,2,13,false,4,6,2,41.9094,-87.67769
13154,2,13,false,11,6,-5,41.91054,-87.65312
13058,2,13,false,7,4,-3,41.91059,-87.64942
TA1307000038,2,13,false,8,2,-6,41.91138,-87.63868
LF-005,2,13,false,34,35,1,41.91172,-87.62681
TA1308000050,2,13,false,8,10,2,41.91211,-87.6347
TA1306000032,2,13,false,3,5,2,41.9137,-87.65285
13179,2,13,false,10,11,1,41.9157,-87.63461
13146,2,13,false,24,15,-9,41.91831,-87.63629
TA1309000030,2,13,false,2,7,5,41.92077,-87.66372
13193,2,13,false,3,6,3,41.92182,-87.64412
13191,2,13,false,2,9,7,41.92217,-87.63891
LP-,2,13,false,20,10,-10,41.92396,-87.63584
TA1306000016,2,13,false,5,1,-4,41.9256,-87.65371
TA1309000019,2,13,false,9,5,-4,41.92586,-87.63897
TA1309000058,2,13,false,5,2,-3,41.92591,-87.64927
TA1308000001,2,13,false,27,29,2,41.92627,-87.63086
13124,2,13,false,5,9,4,41.92675,-87.63444
TA1309000023,2,13,false,10,2,-8,41.9287,-87.65383
TA1309000059,2,13,false,2,5,3,41.92889,-87.65898
TA1309000061,2,13,false,6,2,-4,41.92915,-87.64909
TA1307000142,2,13,false,7,6,-1,41.93125,-87.64432
13276,2,13,false,6,5,-1,41.93132,-87.63874
TA1306000014,2,13,false,6,2,-4,41.93242,-87.65271
TA1309000039,2,13,false,17,13,-4,41.93258,-87.63642
TA1309000036,2,13,false,3,8,5,41.93313,-87.64776
TA1307000041,2,13,false,13,10,-3,41.93669,-87.63683
13137,2,13,false,8,5,-3,41.9376,-87.6441
13277,2,13,false,2,5,3,41.9401,-87.64546
TA1307000134,2,13,false,5,6,1,41.94016,-87.65303
TA1309000049,2,13,false,8,12,4,41.94077,-87.63919
TA1309000025,2,13,false,15,6,-9,41.94368,-87.64894
13278,2,13,false,5,5,0,41.94553,-87.64644
13235,2,13,false,7,5,-2,41.94814,-87.66396
13325,2,13,false,4,5,1,41.94907,-87.64863
TA1307000150,2,13,false,9,2,-7,41.94945,-87.64646
13323,2,13,false,1,5,4,41.95282,-87.65
13063,2,13,false,9,5,-4,41.95424,-87.65441
TA1308000022,2,13,false,7,3,-4,41.95438,-87.64805
13379,2,13,false,4,5,1,41.95786,-87.6495
TA1308000012,2,13,false,6,17,11,41.96398,-87.63818
639,2,13,false,2,9,7,41.96584,-87.64538
TA1309000014,2,13,false,1,6,5,41.96709,-87.66744
TA1307000119,2,13,false,1,5,4,41.96796,-87.65
TA1309000066,2,13,false,6,3,-3,41.9691,-87.67423
TA1309000035,2,13,false,7,6,-1,41.97335,-87.66785
KA1504000152,2,13,false,3,17,14,41.98403,-87.65231
E008,2,13,false,6,2,-4,42.05049,-87.67782
604,2,13,false,6,5,-1,42.05824,-87.67744
KA1503000014,2,13,true,4,5,1,41.7851,-87.60108
TA1309000011,2,13,true,7,7,0,41.78873,-87.60131
KA1503000071,2,13,true,5,7,2,41.79148,-87.59988
KA1503000059,2,13,true,6,2,-4,41.79952,-87.58643
TA1309000037,2,13,true,7,2,-5,41.79957,-87.59474
KA1503000007,2,13,true,3,6,3,41.80242,-87.58689
15445,2,13,true,4,5,1,41.83453,-87.63183
13216,2,13,true,6,10,4,41.83473,-87.62581
TA1309000055,2,13,true,2,6,4,41.8382,-87.64514
TA1307000139,2,13,true,8,3,-5,41.84205,-87.61698
TA1307000153,2,13,true,2,5,3,41.84358,-87.64538
15545,2,13,true,8,4,-4,41.85627,-87.61334
13150,2,13,true,2,6,4,41.85783,-87.62455
SL-012,2,13,true,5,4,-1,41.86038,-87.62581
13431,2,13,true,5,6,1,41.8661,-87.60728
WL-008,2,13,true,5,6,1,41.86712,-87.64108
TA1305000002,2,13,true,7,8,1,41.86721,-87.62597
15544,2,13,true,6,6,0,41.86723,-87.61536
SL-005,2,13,true,8,5,-3,41.8679,-87.62304
13139,2,13,true,6,4,-2,41.86893,-87.65913
13160,2,13,true,6,6,0,41.86947,-87.65548
TA1309000010,2,13,true,2,9,7,41.87074,-87.62574
TA1309000064,2,13,true,15,8,-7,41.87127,-87.67369
TA1307000130,2,13,true,4,6,2,41.87178,-87.65103
TA1307000121,2,13,true,4,5,1,41.87184,-87.64664
SL-008,2,13,true,7,6,-1,41.87209,-87.62956
13332,2,13,true,11,11,0,41.87219,-87.6615
KA1504000104,2,13,true,5,6,1,41.87296,-87.66912
13028,2,13,true,4,7,3,41.87475,-87.64981
TA1305000035,2,13,true,4,6,2,41.87716,-87.62787
13138,2,13,true,8,4,-4,41.87723,-87.63941
15539,2,13,true,6,3,-3,41.87763,-87.64405
13158,2,13,true,6,14,8,41.87764,-87.64957
13157,2,13,true,5,7,2,41.87773,-87.6548
TA1305000025,2,13,true,13,5,-8,41.87773,-87.63528
13206,2,13,true,5,6,1,41.87794,-87.66201
TA1305000005,2,13,true,7,6,-1,41.87924,-87.62975
13011,2,13,true,6,2,-4,41.87931,-87.63993
TA1309000008,2,13,true,10,2,-8,41.87933,-87.6355
KA1503000034,2,13,true,5,6,1,41.87938,-87.63197
KA1503000015,2,13,true,5,1,-4,41.87948,-87.6257
TA1309000007,2,13,true,8,7,-1,41.88022,-87.63526
WL-011,2,13,true,4,7,3,41.88034,-87.64273
13156,2,13,true,5,4,-1,41.88042,-87.65554
13300,2,13,true,8,5,-3,41.88097,-87.61675
TA1305000006,2,13,true,13,15,2,41.88122,-87.6296
TA1307000120,2,13,true,11,20,9,41.88188,-87.64879
13036,2,13,true,12,11,-1,41.8821,-87.62513
TA1305000032,2,13,true,4,5,1,41.88218,-87.64109
13006,2,13,true,11,14,3,41.88268,-87.63252
KA1503000072,2,13,true,7,3,-4,41.88317,-87.63693
WL-012,2,13,true,7,6,-1,41.88337,-87.6412
13053,2,13,true,5,10,5,41.88365,-87.64863
13001,2,13,true,6,7,1,41.88397,-87.62459
18062,2,13,true,5,5,0,41.88412,-87.65427
TA1306000010,2,13,true,9,17,8,41.88419,-87.62961
TA1305000030,2,13,true,19,12,-7,41.88459,-87.63178
TA1305000029,2,13,true,10,8,-2,41.88466,-87.62787
13263,2,13,true,11,9,-2,41.88467,-87.61952
TA1306000015,2,13,true,5,8,3,41.88549,-87.65232
13021,2,13,true,11,9,-2,41.88559,-87.64184
TA1307000111,2,13,true,5,9,4,41.88582,-87.63548
KA1503000012,2,13,true,8,11,3,41.88599,-87.63089
TA1305000011,2,13,true,14,5,-9,41.886,-87.62418
TA1308000029,2,13,true,3,5,2,41.88673,-87.62225
TA1305000022,2,13,true,7,12,5,41.88817,-87.63656
TA1306000003,2,13,true,12,8,-4,41.88867,-87.64442
KA1503000043,2,13,true,24,13,-11,41.88918,-87.63851
13050,2,13,true,11,8,-3,41.88919,-87.62775
TA1307000151,2,13,true,10,11,1,41.88993,-87.63427
KA1503000044,2,13,true,4,6,2,41.89018,-87.6262
13427,2,13,true,5,5,0,41.89054,-87.62205
13430,2,13,true,4,9,5,41.89077,-87.63169
TA1306000013,2,13,true,5,3,-2,41.89083,-87.61852
RN-,2,13,true,11,8,-3,41.89102,-87.63546
TA1307000117,2,13,true,7,11,4,41.89144,-87.62675
13033,2,13,true,8,9,1,41.8916,-87.64835
13194,2,13,true,6,7,1,41.8918,-87.65878
TA1305000003,2,13,true,15,5,-10,41.89187,-87.62061
13022,2,13,true,11,13,2,41.89227,-87.61205
13265,2,13,true,7,15,8,41.89383,-87.64172
13045,2,13,true,18,18,0,41.89403,-87.62931
13016,2,13,true,13,14,1,41.89431,-87.62277
KA1503000041,2,13,true,7,12,5,41.89452,-87.61798
13196,2,13,true,7,3,-4,41.89455,-87.65345
TA1307000062,2,13,true,7,6,-1,41.89466,-87.63839
TA1306000012,2,13,true,11,19,8,41.89475,-87.63438
KP1705001026,2,13,true,7,2,-5,41.89483,-87.6323
637,2,13,true,5,2,-3,41.89563,-87.67209
13132,2,13,true,2,6,4,41.89573,-87.67718
15530,2,13,true,7,5,-2,41.89575,-87.62596
18003,2,13,true,3,5,2,41.89575,-87.62011
13247,2,13,true,8,2,-6,41.89597,-87.66775
TA1305000020,2,13,true,5,2,-3,41.89636,-87.65406
13303,2,13,true,4,9,5,41.89672,-87.63088
13017,2,13,true,2,6,4,41.89676,-87.6357
13338,2,13,true,10,8,-2,41.89697,-87.62173
TA1307000061,2,13,true,6,2,-4,41.89745,-87.62873
TA1306000009,2,13,true,8,2,-6,41.89772,-87.64299
620,2,13,true,5,6,1,41.89817,-87.63754
15529,2,13,true,6,6,0,41.89858,-87.62206
TA1307000128,2,13,true,13,13,0,41.89896,-87.6299
13248,2,13,true,1,5,4,41.89964,-87.66788
13290,2,13,true,1,6,5,41.90069,-87.66259
13042,2,13,true,17,16,-1,41.90097,-87.62377
TA1307000070,2,13,true,6,3,-3,41.90133,-87.67742
KA1504000133,2,13,true,12,7,-5,41.90234,-87.62773
TA1306000006,2,13,true,6,3,-3,41.90292,-87.63772
TA1307000039,2,13,true,19,20,1,41.90294,-87.63137
TA1305000034,2,13,true,5,5,0,41.90313,-87.67391
KA1504000135,2,13,true,11,12,1,41.90319,-87.63439
13061,2,13,true,9,7,-2,41.90342,-87.66779
KA1504000079,2,13,true,2,5,3,41.9035,-87.64334
TA1308000049,2,13,true,10,8,-2,41.90672,-87.6349
KA1504000134,2,13,true,5,4,-1,41.90687,-87.6262
13221,2,13,true,8,12,4,41.90765,-87.67254
TA1309000024,2,13,true,10,7,-3,41.908,-87.63152
TA1305000041,2,13,true,5,5,0,41.9094,-87.67769
331,2,13,true,5,8,3,41.90965,-87.64812
TA1306000008,2,13,true,1,6,5,41.9102,-87.6435
13154,2,13,true,8,7,-1,41.91054,-87.65312
13058,2,13,true,6,6,0,41.91059,-87.64942
TA1307000038,2,13,true,6,8,2,41.91138,-87.63868
LF-005,2,13,true,17,14,-3,41.91172,-87.62681
TA1308000050,2,13,true,15,18,3,41.91211,-87.6347
13243,2,13,true,8,6,-2,41.91262,-87.6814
TA1306000032,2,13,true,2,8,6,41.9137,-87.65285
TA1307000166,2,13,true,3,5,2,41.91386,-87.64877
TA1306000007,2,13,true,6,3,-3,41.91469,-87.64333
13068,2,13,true,5,3,-2,41.91554,-87.68703
13179,2,13,true,9,6,-3,41.9157,-87.63461
TA1309000006,2,13,true,4,6,2,41.91809,-87.64375
13146,2,13,true,16,6,-10,41.91831,-87.63629
13192,2,13,true,11,6,-5,41.91995,-87.64884
TA1309000033,2,13,true,8,6,-2,41.92158,-87.65381
13193,2,13,true,18,7,-11,41.92182,-87.64412
13191,2,13,true,7,13,6,41.92217,-87.63891
TA1307000001,2,13,true,7,2,-5,41.92535,-87.66581
TA1306000026,2,13,true,7,2,-5,41.92558,-87.65842
TA1306000016,2,13,true,5,6,1,41.9256,-87.65371
TA1309000019,2,13,true,7,9,2,41.92586,-87.63897
TA1309000058,2,13,true,12,4,-8,41.92591,-87.64927
TA1308000001,2,13,true,13,19,6,41.92627,-87.63086
TA1309000023,2,13,true,7,3,-4,41.9287,-87.65383
TA1309000061,2,13,true,6,8,2,41.92915,-87.64909
TA1305000014,2,13,true,6,6,0,41.92956,-87.64313
13085,2,13,true,3,7,4,41.92958,-87.70789
TA1307000142,2,13,true,9,10,1,41.93125,-87.64432
13276,2,13,true,1,5,4,41.93132,-87.63874
TA1306000014,2,13,true,6,3,-3,41.93242,-87.65271
TA1309000039,2,13,true,11,10,-1,41.93258,-87.63642
13269,2,13,true,6,2,-4,41.93609,-87.66983
TA1307000052,2,13,true,6,2,-4,41.93628,-87.65266
TA1307000136,2,13,true,16,6,-10,41.9365,-87.64755
TA1307000041,2,13,true,4,10,6,41.93669,-87.63683
13137,2,13,true,7,10,3,41.9376,-87.6441
TA1308000019,2,13,true,6,3,-3,41.93973,-87.65886
13277,2,13,true,11,7,-4,41.9401,-87.64546
TA1307000134,2,13,true,3,10,7,41.94016,-87.65303
TA1309000049,2,13,true,3,10,7,41.94077,-87.63919
TA1307000138,2,13,true,6,5,-1,41.94334,-87.67094
TA1309000025,2,13,true,8,10,2,41.94368,-87.64894
13071,2,13,true,10,4,-6,41.94373,-87.66401
632,2,13,true,11,3,-8,41.94453,-87.6547
13278,2,13,true,5,13,8,41.94553,-87.64644
13235,2,13,true,6,9,3,41.94814,-87.66396
13325,2,13,true,9,7,-2,41.94907,-87.64863
TA1307000150,2,13,true,4,10,6,41.94945,-87.64646
TA1307000127,2,13,true,5,5,0,41.9508,-87.65918
13323,2,13,true,6,4,-2,41.95282,-87.65
TA1308000022,2,13,true,11,5,-6,41.95438,-87.64805
TA1309000026,2,13,true,7,1,-6,41.95601,-87.6802
13379,2,13,true,7,12,5,41.95786,-87.6495
13389,2,13,true,3,6,3,41.961,-87.64958
15621,2,13,true,5,2,-3,41.96103,-87.70586
TA1307000144,2,13,true,7,3,-4,41.96142,-87.6762
KA1503000022,2,13,true,8,3,-5,41.96158,-87.66609
TA1307000107,2,13,true,8,4,-4,41.96164,-87.65464
TA1308000012,2,13,true,9,10,1,41.96398,-87.63818
13074,2,13,true,6,5,-1,41.96521,-87.6582
639,2,13,true,8,10,2,41.96584,-87.64538
TA1307000140,2,13,true,4,5,1,41.96643,-87.68865
TA1309000014,2,13,true,4,8,4,41.96709,-87.66744
TA1307000158,2,13,true,5,5,0,41.9671,-87.67904
TA1309000066,2,13,true,3,11,8,41.9691,-87.67423
TA1309000041,2,13,true,6,4,-2,41.96951,-87.65471
KA1504000146,2,13,true,2,7,5,41.978,-87.66805
13109,2,13,true,11,2,-9,41.97835,-87.65976
KA1504000152,2,13,true,11,7,-4,41.98403,-87.65231
15575,2,13,true,6,6,0,41.98975,-87.66014
E008,2,13,true,3,7,4,42.05049,-87.67782
604,2,13,true,6,3,-3,42.05824,-87.67744
15491,2,14,false,6,7,1,41.78096,-87.57624
KA1503000014,2,14,false,6,1,-5,41.7851,-87.60108
TA1309000011,2,14,false,10,2,-8,41.78873,-87.60131
KA1503000071,2,14,false,6,9,3,41.79148,-87.59988
KA1503000074,2,14,false,24,8,-16,41.79174,-87.58395
TA1308000009,2,14,false,7,10,3,41.79522,-87.58075
KA1503000059,2,14,false,7,9,2,41.79952,-87.58643
TA1309000037,2,14,false,3,11,8,41.79957,-87.59474
KA1503000004,2,14,false,5,4,-1,41.83127,-87.6088
TA1307000048,2,14,false,5,16,11,41.83855,-87.60821
13075,2,14,false,7,3,-4,41.8531,-87.63192
TA1307000124,2,14,false,5,3,-2,41.86411,-87.62372
13029,2,14,false,13,14,1,41.86531,-87.6179
13431,2,14,false,15,13,-2,41.8661,-87.60728
TA1305000002,2,14,false,10,21,11,41.86721,-87.62597
15544,2,14,false,49,46,-3,41.86723,-87.61536
KA1706005007,2,14,false,6,2,-4,41.86749,-87.63219
SL-005,2,14,false,14,14,0,41.8679,-87.62304
13160,2,14,false,2,7,5,41.86947,-87.65548
TA1309000010,2,14,false,10,5,-5,41.87074,-87.62574
SL-008,2,14,false,4,7,3,41.87209,-87.62956
623,2,14,false,7,14,7,41.87272,-87.62399
KA1504000104,2,14,false,5,3,-2,41.87296,-87.66912
SL-007,2,14,false,6,3,-3,41.87404,-87.6277
15541,2,14,false,32,14,-18,41.8758,-87.62086
TA1305000025,2,14,false,2,6,4,41.87773,-87.63528
TA1309000002,2,14,false,7,4,-3,41.87784,-87.62408
TA1309000004,2,14,false,8,3,-5,41.87811,-87.63184
TA1309000008,2,14,false,7,3,-4,41.87933,-87.6355
TA1309000007,2,14,false,6,4,-2,41.88022,-87.63526
13156,2,14,false,8,5,-3,41.88042,-87.65554
13300,2,14,false,32,27,-5,41.88097,-87.61675
13008,2,14,false,41,34,-7,41.88105,-87.62408
TA1305000006,2,14,false,9,11,2,41.88122,-87.6296
13056,2,14,false,3,5,2,41.88168,-87.63951
TA1307000120,2,14,false,5,8,3,41.88188,-87.64879
13036,2,14,false,12,9,-3,41.8821,-87.62513
TA1305000032,2,14,false,3,6,3,41.88218,-87.64109
13006,2,14,false,5,3,-2,41.88268,-87.63252
WL-012,2,14,false,5,7,2,41.88337,-87.6412
13053,2,14,false,8,3,-5,41.88365,-87.64863
13001,2,14,false,21,17,-4,41.88397,-87.62459
TA1306000010,2,14,false,7,8,1,41.88419,-87.62961
TA1305000030,2,14,false,5,5,0,41.88459,-87.63178
15535,2,14,false,9,3,-6,41.8846,-87.64455
TA1305000029,2,14,false,11,6,-5,41.88466,-87.62787
13263,2,14,false,16,13,-3,41.88467,-87.61952
13021,2,14,false,10,6,-4,41.88559,-87.64184
TA1307000111,2,14,false,8,4,-4,41.88582,-87.63548
KA1503000012,2,14,false,8,3,-5,41.88599,-87.63089
TA1305000011,2,14,false,19,23,4,41.886,-87.62418
15534,2,14,false,8,4,-4,41.88627,-87.61749
13197,2,14,false,1,5,4,41.8866,-87.65816
TA1308000029,2,14,false,6,3,-3,41.88673,-87.62225
TA1307000131,2,14,false,8,12,4,41.88688,-87.62606
KA1503000064,2,14,false,22,23,1,41.88697,-87.61281
TA1306000003,2,14,false,6,3,-3,41.88867,-87.64442
KA1503000043,2,14,false,9,7,-2,41.88918,-87.63851
13050,2,14,false,13,6,-7,41.88919,-87.62775
TA1307000151,2,14,false,5,3,-2,41.88993,-87.63427
KA1503000044,2,14,false,8,6,-2,41.89018,-87.6262
13427,2,14,false,6,2,-4,41.89054,-87.62205
13430,2,14,false,13,4,-9,41.89077,-87.63169
TA1306000013,2,14,false,12,19,7,41.89083,-87.61852
TA1307000117,2,14,false,7,26,19,41.89144,-87.62675
TA1305000003,2,14,false,3,11,8,41.89187,-87.62061
13022,2,14,false,110,106,-4,41.89227,-87.61205
TA1306000029,2,14,false,9,10,1,41.89256,-87.61449
13265,2,14,false,6,7,1,41.89383,-87.64172
13045,2,14,false,14,21,7,41.89403,-87.62931
13016,2,14,false,13,7,-6,41.89431,-87.62277
KA1503000041,2,14,false,7,3,-4,41.89452,-87.61798
TA1307000062,2,14,false,2,7,5,41.89466,-87.63839
TA1306000012,2,14,false,4,5,1,41.89475,-87.63438
KP1705001026,2,14,false,8,7,-1,41.89483,-87.6323
15530,2,14,false,17,10,-7,41.89575,-87.62596
13303,2,14,false,3,5,2,41.89672,-87.63088
13017,2,14,false,5,5,0,41.89676,-87.6357
13338,2,14,false,12,11,-1,41.89697,-87.62173
TA1307000061,2,14,false,6,5,-1,41.89745,-87.62873
13034,2,14,false,9,11,2,41.89754,-87.62352
620,2,14,false,5,7,2,41.89817,-87.63754
15529,2,14,false,22,11,-11,41.89858,-87.62206
TA1307000128,2,14,false,2,6,4,41.89896,-87.6299
13042,2,14,false,48,37,-11,41.90097,-87.62377
KA1504000133,2,14,false,10,10,0,41.90234,-87.62773
TA1307000039,2,14,false,9,5,-4,41.90294,-87.63137
KA1504000135,2,14,false,6,16,10,41.90319,-87.63439
13061,2,14,false,11,4,-7,41.90342,-87.66779
KA1504000079,2,14,false,4,6,2,41.9035,-87.64334
TA1308000049,2,14,false,9,5,-4,41.90672,-87.6349
13224,2,14,false,5,1,-4,41.90706,-87.66725
13221,2,14,false,5,1,-4,41.90765,-87.67254
TA1309000024,2,14,false,5,7,2,41.908,-87.63152
TA1305000041,2,14,false,6,9,3,41.9094,-87.67769
331,2,14,false,5,6,1,41.90965,-87.64812
TA1305000037,2,14,false,5,3,-2,41.91018,-87.67003
13154,2,14,false,9,4,-5,41.91054,-87.65312
13058,2,14,false,7,2,-5,41.91059,-87.64942
LF-005,2,14,false,37,46,9,41.91172,-87.62681
TA1308000050,2,14,false,12,7,-5,41.91211,-87.6347
13243,2,14,false,3,7,4,41.91262,-87.6814
13179,2,14,false,15,9,-6,41.9157,-87.63461
13133,2,14,false,1,5,4,41.91598,-87.67733
13146,2,14,false,14,14,0,41.91831,-87.63629
13192,2,14,false,8,2,-6,41.91995,-87.64884
TA1309000030,2,14,false,5,8,3,41.92077,-87.66372
TA1309000033,2,14,false,5,4,-1,41.92158,-87.65381
13193,2,14,false,4,7,3,41.92182,-87.64412
13191,2,14,false,10,1,-9,41.92217,-87.63891
13084,2,14,false,6,4,-2,41.92268,-87.69715
LP-,2,14,false,8,16,8,41.92396,-87.63584
TA1306000026,2,14,false,6,2,-4,41.92558,-87.65842
TA1306000016,2,14,false,8,5,-3,41.9256,-87.65371
TA1309000019,2,14,false,4,10,6,41.92586,-87.63897
TA1309000058,2,14,false,4,5,1,41.92591,-87.64927
TA1308000001,2,14,false,23,22,-1,41.92627,-87.63086
13124,2,14,false,6,18,12,41.92675,-87.63444
TA1309000023,2,14,false,3,6,3,41.9287,-87.65383
TA1308000031,2,14,false,6,2,-4,41.92946,-87.68417
TA1305000014,2,14,false,4,5,1,41.92956,-87.64313
TA1307000142,2,14,false,3,5,2,41.93125,-87.64432
13276,2,14,false,5,7,2,41.93132,-87.63874
TA1309000039,2,14,false,11,11,0,41.93258,-87.63642
TA1307000006,2,14,false,8,2,-6,41.93571,-87.6636
TA1307000136,2,14,false,3,7,4,41.9365,-87.64755
TA1307000041,2,14,false,15,9,-6,41.93669,-87.63683
13137,2,14,false,5,6,1,41.9376,-87.6441
13229,2,14,false,5,3,-2,41.93946,-87.66376
TA1308000019,2,14,false,5,2,-3,41.93973,-87.65886
13277,2,14,false,6,5,-1,41.9401,-87.64546
TA1307000134,2,14,false,8,2,-6,41.94016,-87.65303
TA1309000049,2,14,false,16,11,-5,41.94077,-87.63919
TA1309000025,2,14,false,5,9,4,41.94368,-87.64894
13071,2,14,false,4,6,2,41.94373,-87.66401
13278,2,14,false,11,8,-3,41.94553,-87.64644
13235,2,14,false,6,3,-3,41.94814,-87.66396
13325,2,14,false,5,2,-3,41.94907,-87.64863
TA1307000126,2,14,false,3,9,6,41.94936,-87.65451
TA1307000150,2,14,false,8,5,-3,41.94945,-87.64646
13323,2,14,false,8,2,-6,41.95282,-87.65
TA1309000043,2,14,false,5,3,-2,41.95417,-87.66434
13063,2,14,false,6,5,-1,41.95424,-87.65441
TA1308000022,2,14,false,10,3,-7,41.95438,-87.64805
13379,2,14,false,6,1,-5,41.95786,-87.6495
TA1307000107,2,14,false,10,3,-7,41.96164,-87.65464
TA1308000012,2,14,false,24,10,-14,41.96398,-87.63818
639,2,14,false,5,5,0,41.96584,-87.64538
13108,2,14,false,8,1,-7,41.97379,-87.65971
KA1504000152,2,14,false,10,12,2,41.98403,-87.65231
15575,2,14,false,5,1,-4,41.98975,-87.66014
605,2,14,false,6,5,-1,42.05294,-87.67342
604,2,14,false,1,5,4,42.05824,-87.67744
KA1503000014,2,14,true,9,4,-5,41.7851,-87.60108
TA1309000011,2,14,true,4,5,1,41.78873,-87.60131
KA1503000071,2,14,true,5,11,6,41.79148,-87.59988
TA1308000009,2,14,true,8,7,-1,41.79522,-87.58075
KA1503000007,2,14,true,5,4,-1,41.80242,-87.58689
TA1308000045,2,14,true,6,1,-5,41.83062,-87.64129
13216,2,14,true,7,4,-3,41.83473,-87.62581
TA1307000139,2,14,true,6,6,0,41.84205,-87.61698
15545,2,14,true,7,9,2,41.85627,-87.61334
13135,2,14,true,7,2,-5,41.85753,-87.66157
13102,2,14,true,6,5,-1,41.85762,-87.61942
13150,2,14,true,2,6,4,41.85783,-87.62455
13163,2,14,true,3,6,3,41.85808,-87.65108
13164,2,14,true,5,2,-3,41.85818,-87.65648
SL-012,2,14,true,4,9,5,41.86038,-87.62581
TA1306000002,2,14,true,4,5,1,41.86238,-87.65108
TA1307000124,2,14,true,9,4,-5,41.86411,-87.62372
TA1309000001,2,14,true,5,2,-3,41.86488,-87.64708
WL-008,2,14,true,3,5,2,41.86712,-87.64108
TA1305000002,2,14,true,6,13,7,41.86721,-87.62597
15544,2,14,true,5,6,1,41.86723,-87.61536
SL-005,2,14,true,7,6,-1,41.8679,-87.62304
13285,2,14,true,2,5,3,41.86928,-87.67372
13160,2,14,true,4,7,3,41.86947,-87.65548
TA1309000010,2,14,true,7,12,5,41.87074,-87.62574
TA1309000064,2,14,true,13,8,-5,41.87127,-87.67369
TA1307000130,2,14,true,9,5,-4,41.87178,-87.65103
TA1307000121,2,14,true,7,6,-1,41.87184,-87.64664
SL-008,2,14,true,7,7,0,41.87209,-87.62956
13332,2,14,true,16,9,-7,41.87219,-87.6615
SL-011,2,14,true,7,1,-6,41.87256,-87.63356
623,2,14,true,8,4,-4,41.87272,-87.62399
KA1504000104,2,14,true,11,1,-10,41.87296,-87.66912
TA1306000025,2,14,true,1,8,7,41.87464,-87.65703
13028,2,14,true,6,2,-4,41.87475,-87.64981
15539,2,14,true,3,6,3,41.87763,-87.64405
13158,2,14,true,7,5,-2,41.87764,-87.64957
13157,2,14,true,7,3,-4,41.87773,-87.6548
TA1305000025,2,14,true,7,8,1,41.87773,-87.63528
13206,2,14,true,6,2,-4,41.87794,-87.66201
TA1309000004,2,14,true,20,7,-13,41.87811,-87.63184
638,2,14,true,8,1,-7,41.87827,-87.64078
TA1305000005,2,14,true,4,8,4,41.87924,-87.62975
13011,2,14,true,3,6,3,41.87931,-87.63993
TA1309000008,2,14,true,9,7,-2,41.87933,-87.6355
KA1503000015,2,14,true,3,5,2,41.87948,-87.6257
TA1309000007,2,14,true,7,10,3,41.88022,-87.63526
13156,2,14,true,3,7,4,41.88042,-87.65554
TA1305000006,2,14,true,16,6,-10,41.88122,-87.6296
TA1307000120,2,14,true,16,15,-1,41.88188,-87.64879
13341,2,14,true,1,12,11,41.88208,-87.63985
13036,2,14,true,5,3,-2,41.8821,-87.62513
13006,2,14,true,7,7,0,41.88268,-87.63252
13353,2,14,true,3,5,2,41.88283,-87.6612
654,2,14,true,3,5,2,41.88307,-87.65698
13409,2,14,true,4,6,2,41.8831,-87.6511
KA1503000072,2,14,true,8,3,-5,41.88317,-87.63693
WL-012,2,14,true,3,7,4,41.88337,-87.6412
13053,2,14,true,6,4,-2,41.88365,-87.64863
13001,2,14,true,7,13,6,41.88397,-87.62459
TA1306000010,2,14,true,16,10,-6,41.88419,-87.62961
TA1305000030,2,14,true,11,7,-4,41.88459,-87.63178
TA1305000029,2,14,true,7,4,-3,41.88466,-87.62787
13263,2,14,true,8,5,-3,41.88467,-87.61952
TA1306000015,2,14,true,5,4,-1,41.88549,-87.65232
13021,2,14,true,6,4,-2,41.88559,-87.64184
TA1307000111,2,14,true,6,4,-2,41.88582,-87.63548
KA1503000012,2,14,true,8,7,-1,41.88599,-87.63089
TA1305000011,2,14,true,9,8,-1,41.886,-87.62418
15534,2,14,true,2,9,7,41.88627,-87.61749
TA1308000029,2,14,true,6,5,-1,41.88673,-87.62225
TA1305000022,2,14,true,4,5,1,41.88817,-87.63656
TA1306000003,2,14,true,10,9,-1,41.88867,-87.64442
KA1503000043,2,14,true,12,9,-3,41.88918,-87.63851
13050,2,14,true,13,5,-8,41.88919,-87.62775
TA1307000151,2,14,true,7,10,3,41.88993,-87.63427
KA1503000044,2,14,true,5,2,-3,41.89018,-87.6262
13427,2,14,true,10,5,-5,41.89054,-87.62205
13430,2,14,true,9,4,-5,41.89077,-87.63169
TA1306000013,2,14,true,5,8,3,41.89083,-87.61852
RN-,2,14,true,6,7,1,41.89102,-87.63546
TA1307000117,2,14,true,5,9,4,41.89144,-87.62675
13033,2,14,true,5,4,-1,41.8916,-87.64835
13194,2,14,true,4,9,5,41.8918,-87.65878
TA1305000003,2,14,true,10,8,-2,41.89187,-87.62061
13022,2,14,true,15,11,-4,41.89227,-87.61205
TA1306000029,2,14,true,6,5,-1,41.89256,-87.61449
13265,2,14,true,5,11,6,41.89383,-87.64172
13045,2,14,true,13,15,2,41.89403,-87.62931
13016,2,14,true,20,5,-15,41.89431,-87.62277
KA1503000041,2,14,true,9,6,-3,41.89452,-87.61798
13196,2,14,true,4,5,1,41.89455,-87.65345
TA1307000062,2,14,true,8,8,0,41.89466,-87.63839
TA1306000012,2,14,true,10,8,-2,41.89475,-87.63438
637,2,14,true,2,6,4,41.89563,-87.67209
13132,2,14,true,1,5,4,41.89573,-87.67718
15530,2,14,true,13,5,-8,41.89575,-87.62596
18003,2,14,true,3,5,2,41.89575,-87.62011
13289,2,14,true,5,3,-2,41.89638,-87.661
13017,2,14,true,2,7,5,41.89676,-87.6357
13338,2,14,true,18,5,-13,41.89697,-87.62173
13034,2,14,true,6,3,-3,41.89754,-87.62352
TA1306000009,2,14,true,6,3,-3,41.89772,-87.64299
620,2,14,true,3,6,3,41.89817,-87.63754
15529,2,14,true,4,6,2,41.89858,-87.62206
TA1307000128,2,14,true,12,11,-1,41.89896,-87.6299
13290,2,14,true,5,5,0,41.90069,-87.66259
13042,2,14,true,12,16,4,41.90097,-87.62377
KA1504000133,2,14,true,7,6,-1,41.90234,-87.62773
TA1307000039,2,14,true,6,16,10,41.90294,-87.63137
KA1504000135,2,14,true,10,11,1,41.90319,-87.63439
13136,2,14,true,4,5,1,41.90326,-87.67845
13061,2,14,true,8,4,-4,41.90342,-87.66779
KA1504000079,2,14,true,6,7,1,41.9035,-87.64334
TA1308000049,2,14,true,5,9,4,41.90672,-87.6349
KA1504000134,2,14,true,2,10,8,41.90687,-87.6262
TA1309000024,2,14,true,5,10,5,41.908,-87.63152
TA1305000041,2,14,true,6,6,0,41.9094,-87.67769
331,2,14,true,7,6,-1,41.90965,-87.64812
13154,2,14,true,11,12,1,41.91054,-87.65312
13058,2,14,true,4,8,4,41.91059,-87.64942
TA1307000038,2,14,true,5,8,3,41.91138,-87.63868
LF-005,2,14,true,12,12,0,41.91172,-87.62681
TA1308000050,2,14,true,17,11,-6,41.91211,-87.6347
13243,2,14,true,5,4,-1,41.91262,-87.6814
TA1306000032,2,14,true,9,5,-4,41.9137,-87.65285
TA1307000166,2,14,true,5,4,-1,41.91386,-87.64877
18017,2,14,true,5,5,0,41.91416,-87.71676
18067,2,14,true,7,9,2,41.9146,-87.66796
TA1306000007,2,14,true,1,7,6,41.91469,-87.64333
13179,2,14,true,14,12,-2,41.9157,-87.63461
13133,2,14,true,2,5,3,41.91598,-87.67733
13146,2,14,true,11,10,-1,41.91831,-87.63629
13059,2,14,true,5,5,0,41.91845,-87.65222
13192,2,14,true,8,9,1,41.91995,-87.64884
TA1309000030,2,14,true,3,8,5,41.92077,-87.66372
TA1309000033,2,14,true,8,3,-5,41.92158,-87.65381
13193,2,14,true,7,14,7,41.92182,-87.64412
13191,2,14,true,5,2,-3,41.92217,-87.63891
TA1307000001,2,14,true,5,9,4,41.92535,-87.66581
TA1306000026,2,14,true,5,11,6,41.92558,-87.65842
TA1306000016,2,14,true,7,3,-4,41.9256,-87.65371
TA1309000019,2,14,true,4,9,5,41.92586,-87.63897
TA1309000058,2,14,true,5,10,5,41.92591,-87.64927
TA1308000001,2,14,true,8,12,4,41.92627,-87.63086
TA1309000023,2,14,true,2,7,5,41.9287,-87.65383
TA1309000061,2,14,true,7,7,0,41.92915,-87.64909
TA1305000014,2,14,true,7,7,0,41.92956,-87.64313
TA1307000142,2,14,true,7,7,0,41.93125,-87.64432
TA1307000064,2,14,true,5,5,0,41.93222,-87.65864
TA1306000014,2,14,true,6,6,0,41.93242,-87.65271
TA1309000039,2,14,true,7,9,2,41.93258,-87.63642
TA1309000036,2,14,true,11,7,-4,41.93313,-87.64776
TA1307000136,2,14,true,4,12,8,41.9365,-87.64755
TA1307000041,2,14,true,9,14,5,41.93669,-87.63683
13137,2,14,true,13,17,4,41.9376,-87.6441
13229,2,14,true,1,5,4,41.93946,-87.66376
TA1308000019,2,14,true,7,5,-2,41.93973,-87.65886
13277,2,14,true,4,7,3,41.9401,-87.64546
TA1307000134,2,14,true,7,6,-1,41.94016,-87.65303
TA1309000049,2,14,true,5,6,1,41.94077,-87.63919
TA1307000138,2,14,true,4,5,1,41.94334,-87.67094
TA1309000025,2,14,true,7,8,1,41.94368,-87.64894
13071,2,14,true,6,7,1,41.94373,-87.66401
632,2,14,true,5,2,-3,41.94453,-87.6547
13278,2,14,true,13,8,-5,41.94553,-87.64644
13235,2,14,true,8,6,-2,41.94814,-87.66396
13325,2,14,true,12,9,-3,41.94907,-87.64863
TA1307000126,2,14,true,7,6,-1,41.94936,-87.65451
TA1307000150,2,14,true,8,10,2,41.94945,-87.64646
TA1307000127,2,14,true,7,6,-1,41.9508,-87.65918
13323,2,14,true,8,5,-3,41.95282,-87.65
13063,2,14,true,4,8,4,41.95424,-87.65441
13379,2,14,true,6,5,-1,41.95786,-87.6495
13389,2,14,true,8,1,-7,41.961,-87.64958
TA1307000107,2,14,true,7,6,-1,41.96164,-87.65464
TA1307000156,2,14,true,5,3,-2,41.96301,-87.68479
TA1308000012,2,14,true,12,17,5,41.96398,-87.63818
13074,2,14,true,7,5,-2,41.96521,-87.6582
639,2,14,true,1,6,5,41.96584,-87.64538
TA1309000014,2,14,true,3,6,3,41.96709,-87.66744
TA1307000158,2,14,true,5,5,0,41.9671,-87.67904
KA1504000171,2,14,true,2,9,7,41.97161,-87.65016
13108,2,14,true,5,7,2,41.97379,-87.65971
KA1504000152,2,14,true,6,6,0,41.98403,-87.65231
RP-008,2,14,true,3,5,2,42.00446,-87.6724
660,2,14,true,3,7,4,42.00458,-87.66143
596,2,14,true,4,5,1,42.04822,-87.68348
TA1309000011,2,15,false,5,6,1,41.78873,-87.60131
KA1503000071,2,15,false,6,6,0,41.79148,-87.59988
KA1503000074,2,15,false,10,4,-6,41.79174,-87.58395
TA1309000063,2,15,false,1,6,5,41.79325,-87.5878
TA1308000009,2,15,false,3,6,3,41.79522,-87.58075
KA1503000052,2,15,false,1,6,5,41.79935,-87.60097
KA1503000059,2,15,false,6,4,-2,41.79952,-87.58643
KA1503000007,2,15,false,4,9,5,41.80242,-87.58689
KA1503000004,2,15,false,7,3,-4,41.83127,-87.6088
13217,2,15,false,1,6,5,41.83488,-87.61792
TA1307000048,2,15,false,10,7,-3,41.83855,-87.60821
13075,2,15,false,7,2,-5,41.8531,-87.63192
15545,2,15,false,4,5,1,41.85627,-87.61334
SL-006,2,15,false,5,8,3,41.8568,-87.63387
13150,2,15,false,3,7,4,41.85783,-87.62455
13164,2,15,false,3,5,2,41.85818,-87.65648
SL-012,2,15,false,6,9,3,41.86038,-87.62581
TA1307000124,2,15,false,1,5,4,41.86411,-87.62372
13431,2,15,false,34,23,-11,41.8661,-87.60728
TA1305000002,2,15,false,16,13,-3,41.86721,-87.62597
15544,2,15,false,51,32,-19,41.86723,-87.61536
SL-005,2,15,false,12,21,9,41.8679,-87.62304
13285,2,15,false,9,1,-8,41.86928,-87.67372
13160,2,15,false,5,3,-2,41.86947,-87.65548
TA1309000010,2,15,false,6,10,4,41.87074,-87.62574
SL-009,2,15,false,5,5,0,41.87081,-87.63121
TA1307000121,2,15,false,5,3,-2,41.87184,-87.64664
SL-008,2,15,false,6,8,2,41.87209,-87.62956
623,2,15,false,10,12,2,41.87272,-87.62399
15541,2,15,false,28,36,8,41.8758,-87.62086
TA1305000010,2,15,false,6,7,1,41.87623,-87.62444
13158,2,15,false,1,6,5,41.87764,-87.64957
TA1305000025,2,15,false,10,7,-3,41.87773,-87.63528
TA1309000002,2,15,false,8,14,6,41.87784,-87.62408
13206,2,15,false,5,2,-3,41.87794,-87.66201
TA1309000004,2,15,false,11,2,-9,41.87811,-87.63184
TA1305000005,2,15,false,8,1,-7,41.87924,-87.62975
13011,2,15,false,9,8,-1,41.87931,-87.63993
TA1309000008,2,15,false,6,7,1,41.87933,-87.6355
KA1503000015,2,15,false,3,6,3,41.87948,-87.6257
TA1309000007,2,15,false,7,1,-6,41.88022,-87.63526
WL-011,2,15,false,7,3,-4,41.88034,-87.64273
13300,2,15,false,38,28,-10,41.88097,-87.61675
13008,2,15,false,31,27,-4,41.88105,-87.62408
TA1305000006,2,15,false,2,11,9,41.88122,-87.6296
13056,2,15,false,12,7,-5,41.88168,-87.63951
TA1307000120,2,15,false,5,15,10,41.88188,-87.64879
13341,2,15,false,13,8,-5,41.88208,-87.63985
13036,2,15,false,11,5,-6,41.8821,-87.62513
TA1305000032,2,15,false,10,9,-1,41.88218,-87.64109
13006,2,15,false,5,2,-3,41.88268,-87.63252
654,2,15,false,5,3,-2,41.88307,-87.65698
WL-012,2,15,false,3,12,9,41.88337,-87.6412
13053,2,15,false,4,9,5,41.88365,-87.64863
13001,2,15,false,11,7,-4,41.88397,-87.62459
18062,2,15,false,6,1,-5,41.88412,-87.65427
TA1306000010,2,15,false,11,4,-7,41.88419,-87.62961
TA1305000030,2,15,false,8,8,0,41.88459,-87.63178
TA1305000029,2,15,false,7,10,3,41.88466,-87.62787
13263,2,15,false,11,15,4,41.88467,-87.61952
TA1306000015,2,15,false,6,4,-2,41.88549,-87.65232
13021,2,15,false,5,2,-3,41.88559,-87.64184
TA1307000111,2,15,false,5,3,-2,41.88582,-87.63548
TA1305000011,2,15,false,25,25,0,41.886,-87.62418
15534,2,15,false,7,15,8,41.88627,-87.61749
TA1308000029,2,15,false,2,6,4,41.88673,-87.62225
TA1307000131,2,15,false,18,10,-8,41.88688,-87.62606
KA1503000064,2,15,false,17,22,5,41.88697,-87.61281
TA1305000022,2,15,false,7,2,-5,41.88817,-87.63656
TA1306000003,2,15,false,5,10,5,41.88867,-87.64442
KA1503000043,2,15,false,5,6,1,41.88918,-87.63851
13050,2,15,false,9,10,1,41.88919,-87.62775
TA1307000151,2,15,false,6,8,2,41.88993,-87.63427
KA1503000044,2,15,false,6,12,6,41.89018,-87.6262
13427,2,15,false,7,12,5,41.89054,-87.62205
13430,2,15,false,8,15,7,41.89077,-87.63169
TA1306000013,2,15,false,9,9,0,41.89083,-87.61852
13434,2,15,false,5,3,-2,41.89108,-87.66663
TA1307000117,2,15,false,13,16,3,41.89144,-87.62675
13033,2,15,false,5,4,-1,41.8916,-87.64835
13194,2,15,false,7,2,-5,41.8918,-87.65878
TA1305000003,2,15,false,12,7,-5,41.89187,-87.62061
13022,2,15,false,127,113,-14,41.89227,-87.61205
TA1306000029,2,15,false,12,7,-5,41.89256,-87.61449
13265,2,15,false,7,5,-2,41.89383,-87.64172
13045,2,15,false,12,10,-2,41.89403,-87.62931
13016,2,15,false,11,19,8,41.89431,-87.62277
KA1503000041,2,15,false,7,4,-3,41.89452,-87.61798
TA1307000062,2,15,false,6,6,0,41.89466,-87.63839
TA1306000012,2,15,false,6,11,5,41.89475,-87.63438
KP1705001026,2,15,false,4,10,6,41.89483,-87.6323
13132,2,15,false,1,6,5,41.89573,-87.67718
15530,2,15,false,13,10,-3,41.89575,-87.62596
13017,2,15,false,6,4,-2,41.89676,-87.6357
13338,2,15,false,6,14,8,41.89697,-87.62173
TA1307000061,2,15,false,6,4,-2,41.89745,-87.62873
13034,2,15,false,11,6,-5,41.89754,-87.62352
TA1306000009,2,15,false,5,2,-3,41.89772,-87.64299
15529,2,15,false,14,16,2,41.89858,-87.62206
TA1307000128,2,15,false,6,8,2,41.89896,-87.6299
13248,2,15,false,5,1,-4,41.89964,-87.66788
13290,2,15,false,6,1,-5,41.90069,-87.66259
13042,2,15,false,27,43,16,41.90097,-87.62377
KA1504000133,2,15,false,5,6,1,41.90234,-87.62773
TA1307000039,2,15,false,6,5,-1,41.90294,-87.63137
TA1305000034,2,15,false,5,2,-3,41.90313,-87.67391
KA1504000135,2,15,false,13,10,-3,41.90319,-87.63439
13061,2,15,false,13,6,-7,41.90342,-87.66779
KA1504000079,2,15,false,3,8,5,41.9035,-87.64334
TA1308000049,2,15,false,8,4,-4,41.90672,-87.6349
13221,2,15,false,3,6,3,41.90765,-87.67254
TA1309000024,2,15,false,6,15,9,41.908,-87.63152
TA1305000041,2,15,false,5,9,4,41.9094,-87.67769
331,2,15,false,9,5,-4,41.90965,-87.64812
TA1305000037,2,15,false,7,2,-5,41.91018,-87.67003
TA1307000038,2,15,false,4,7,3,41.91138,-87.63868
LF-005,2,15,false,48,45,-3,41.91172,-87.62681
TA1308000050,2,15,false,5,9,4,41.91211,-87.6347
13243,2,15,false,3,6,3,41.91262,-87.6814
TA1306000032,2,15,false,5,3,-2,41.9137,-87.65285
13179,2,15,false,6,10,4,41.9157,-87.63461
13133,2,15,false,1,9,8,41.91598,-87.67733
13266,2,15,false,6,4,-2,41.91774,-87.69142
13146,2,15,false,12,1,-11,41.91831,-87.63629
13059,2,15,false,6,5,-1,41.91845,-87.65222
13192,2,15,false,7,6,-1,41.91995,-87.64884
TA1309000030,2,15,false,5,3,-2,41.92077,-87.66372
TA1309000033,2,15,false,6,5,-1,41.92158,-87.65381
13193,2,15,false,13,4,-9,41.92182,-87.64412
LP-,2,15,false,14,19,5,41.92396,-87.63584
TA1307000001,2,15,false,7,3,-4,41.92535,-87.66581
TA1306000016,2,15,false,6,7,1,41.9256,-87.65371
TA1309000019,2,15,false,6,17,11,41.92586,-87.63897
TA1309000058,2,15,false,10,6,-4,41.92591,-87.64927
TA1308000001,2,15,false,10,21,11,41.92627,-87.63086
13124,2,15,false,6,12,6,41.92675,-87.63444
TA1309000023,2,15,false,6,3,-3,41.9287,-87.65383
TA1309000061,2,15,false,1,5,4,41.92915,-87.64909
TA1305000014,2,15,false,10,5,-5,41.92956,-87.64313
13085,2,15,false,4,8,4,41.92958,-87.70789
TA1307000142,2,15,false,5,11,6,41.93125,-87.64432
13276,2,15,false,10,11,1,41.93132,-87.63874
TA1306000014,2,15,false,1,8,7,41.93242,-87.65271
TA1309000039,2,15,false,7,4,-3,41.93258,-87.63642
13294,2,15,false,6,2,-4,41.9326,-87.66595
TA1307000006,2,15,false,5,4,-1,41.93571,-87.6636
TA1307000052,2,15,false,3,7,4,41.93628,-87.65266
TA1307000041,2,15,false,8,11,3,41.93669,-87.63683
13137,2,15,false,8,8,0,41.9376,-87.6441
13277,2,15,false,2,6,4,41.9401,-87.64546
TA1307000134,2,15,false,9,7,-2,41.94016,-87.65303
TA1309000049,2,15,false,13,14,1,41.94077,-87.63919
TA1309000025,2,15,false,6,3,-3,41.94368,-87.64894
13071,2,15,false,2,9,7,41.94373,-87.66401
632,2,15,false,3,8,5,41.94453,-87.6547
13235,2,15,false,4,6,2,41.94814,-87.66396
13325,2,15,false,6,9,3,41.94907,-87.64863
TA1307000126,2,15,false,5,16,11,41.94936,-87.65451
TA1307000150,2,15,false,7,7,0,41.94945,-87.64646
TA1307000127,2,15,false,10,12,2,41.9508,-87.65918
13323,2,15,false,5,7,2,41.95282,-87.65
13063,2,15,false,5,4,-1,41.95424,-87.65441
TA1308000022,2,15,false,6,7,1,41.95438,-87.64805
13379,2,15,false,3,8,5,41.95786,-87.6495
TA1307000107,2,15,false,12,2,-10,41.96164,-87.65464
TA1308000012,2,15,false,12,19,7,41.96398,-87.63818
13074,2,15,false,1,7,6,41.96521,-87.6582
TA1309000066,2,15,false,5,3,-2,41.9691,-87.67423
KA1504000171,2,15,false,5,4,-1,41.97161,-87.65016
TA1309000035,2,15,false,5,3,-2,41.97335,-87.66785
KA1504000152,2,15,false,5,11,6,41.98403,-87.65231
15571,2,15,false,6,4,-2,41.99478,-87.66028
596,2,15,false,2,9,7,42.04822,-87.68348
E008,2,15,false,7,6,-1,42.05049,-87.67782
604,2,15,false,3,8,5,42.05824,-87.67744
KA1503000014,2,15,true,5,9,4,41.7851,-87.60108
TA1309000011,2,15,true,9,1,-8,41.78873,-87.60131
KA1503000071,2,15,true,11,3,-8,41.79148,-87.59988
TA1309000063,2,15,true,6,4,-2,41.79325,-87.5878
KA1503000052,2,15,true,2,5,3,41.79935,-87.60097
KA1503000059,2,15,true,2,7,5,41.79952,-87.58643
TA1309000037,2,15,true,5,6,1,41.79957,-87.59474
13216,2,15,true,6,8,2,41.83473,-87.62581
13217,2,15,true,9,5,-4,41.83488,-87.61792
TA1309000055,2,15,true,4,6,2,41.8382,-87.64514
15545,2,15,true,13,10,-3,41.85627,-87.61334
13102,2,15,true,5,3,-2,41.85762,-87.61942
13150,2,15,true,5,1,-4,41.85783,-87.62455
13164,2,15,true,3,6,3,41.85818,-87.65648
SL-012,2,15,true,8,11,3,41.86038,-87.62581
TA1306000002,2,15,true,4,7,3,41.86238,-87.65108
TA1307000124,2,15,true,8,6,-2,41.86411,-87.62372
TA1309000001,2,15,true,4,7,3,41.86488,-87.64708
13431,2,15,true,12,7,-5,41.8661,-87.60728
WL-008,2,15,true,6,4,-2,41.86712,-87.64108
TA1305000002,2,15,true,10,12,2,41.86721,-87.62597
15544,2,15,true,8,5,-3,41.86723,-87.61536
SL-005,2,15,true,9,12,3,41.8679,-87.62304
644,2,15,true,5,4,-1,41.86859,-87.68625
13285,2,15,true,7,7,0,41.86928,-87.67372
13160,2,15,true,8,5,-3,41.86947,-87.65548
TA1309000010,2,15,true,7,8,1,41.87074,-87.62574
SL-009,2,15,true,3,5,2,41.87081,-87.63121
TA1309000064,2,15,true,11,3,-8,41.87127,-87.67369
TA1307000130,2,15,true,10,4,-6,41.87178,-87.65103
TA1307000121,2,15,true,3,11,8,41.87184,-87.64664
SL-008,2,15,true,12,8,-4,41.87209,-87.62956
13332,2,15,true,12,12,0,41.87219,-87.6615
SL-011,2,15,true,3,5,2,41.87256,-87.63356
623,2,15,true,1,6,5,41.87272,-87.62399
KA1504000104,2,15,true,30,6,-24,41.87296,-87.66912
SL-010,2,15,true,7,9,2,41.87501,-87.63309
TA1305000010,2,15,true,7,1,-6,41.87623,-87.62444
13158,2,15,true,9,8,-1,41.87764,-87.64957
13157,2,15,true,7,7,0,41.87773,-87.6548
TA1305000025,2,15,true,18,3,-15,41.87773,-87.63528
13206,2,15,true,5,3,-2,41.87794,-87.66201
TA1309000004,2,15,true,33,9,-24,41.87811,-87.63184
638,2,15,true,8,21,13,41.87827,-87.64078
13011,2,15,true,8,14,6,41.87931,-87.63993
TA1309000008,2,15,true,12,9,-3,41.87933,-87.6355
TA1309000007,2,15,true,43,3,-40,41.88022,-87.63526
13300,2,15,true,8,13,5,41.88097,-87.61675
13008,2,15,true,1,6,5,41.88105,-87.62408
TA1305000006,2,15,true,22,5,-17,41.88122,-87.6296
13056,2,15,true,8,5,-3,41.88168,-87.63951
TA1307000120,2,15,true,11,14,3,41.88188,-87.64879
13341,2,15,true,4,15,11,41.88208,-87.63985
13036,2,15,true,11,9,-2,41.8821,-87.62513
TA1305000032,2,15,true,16,22,6,41.88218,-87.64109
13006,2,15,true,9,4,-5,41.88268,-87.63252
KA1503000072,2,15,true,4,5,1,41.88317,-87.63693
WL-012,2,15,true,10,26,16,41.88337,-87.6412
13053,2,15,true,9,7,-2,41.88365,-87.64863
13001,2,15,true,11,8,-3,41.88397,-87.62459
13155,2,15,true,5,3,-2,41.88407,-87.65689
TA1306000010,2,15,true,13,6,-7,41.88419,-87.62961
TA1305000030,2,15,true,11,6,-5,41.88459,-87.63178
15535,2,15,true,3,6,3,41.8846,-87.64455
TA1305000029,2,15,true,6,7,1,41.88466,-87.62787
13263,2,15,true,7,12,5,41.88467,-87.61952
TA1306000015,2,15,true,5,4,-1,41.88549,-87.65232
13021,2,15,true,10,9,-1,41.88559,-87.64184
TA1307000111,2,15,true,14,5,-9,41.88582,-87.63548
KA1503000012,2,15,true,5,6,1,41.88599,-87.63089
TA1305000011,2,15,true,17,8,-9,41.886,-87.62418
15534,2,15,true,7,7,0,41.88627,-87.61749
TA1308000029,2,15,true,8,1,-7,41.88673,-87.62225
TA1307000131,2,15,true,13,8,-5,41.88688,-87.62606
KA1503000064,2,15,true,6,5,-1,41.88697,-87.61281
TA1305000022,2,15,true,15,6,-9,41.88817,-87.63656
TA1306000003,2,15,true,8,9,1,41.88867,-87.64442
KA1503000043,2,15,true,17,24,7,41.88918,-87.63851
13050,2,15,true,8,11,3,41.88919,-87.62775
TA1307000151,2,15,true,16,6,-10,41.88993,-87.63427
636,2,15,true,6,2,-4,41.88997,-87.63662
KA1503000044,2,15,true,7,4,-3,41.89018,-87.6262
13427,2,15,true,6,4,-2,41.89054,-87.62205
13430,2,15,true,9,8,-1,41.89077,-87.63169
TA1306000013,2,15,true,6,15,9,41.89083,-87.61852
RN-,2,15,true,3,6,3,41.89102,-87.63546
TA1308000006,2,15,true,6,4,-2,41.89128,-87.67686
TA1307000117,2,15,true,18,16,-2,41.89144,-87.62675
13033,2,15,true,6,11,5,41.8916,-87.64835
13194,2,15,true,8,3,-5,41.8918,-87.65878
TA1305000003,2,15,true,17,18,1,41.89187,-87.62061
13022,2,15,true,15,21,6,41.89227,-87.61205
TA1306000029,2,15,true,5,5,0,41.89256,-87.61449
13265,2,15,true,12,17,5,41.89383,-87.64172
13045,2,15,true,14,11,-3,41.89403,-87.62931
13016,2,15,true,40,16,-24,41.89431,-87.62277
KA1503000041,2,15,true,27,6,-21,41.89452,-87.61798
13196,2,15,true,5,3,-2,41.89455,-87.65345
TA1307000062,2,15,true,8,9,1,41.89466,-87.63839
TA1306000012,2,15,true,18,17,-1,41.89475,-87.63438
KP1705001026,2,15,true,8,12,4,41.89483,-87.6323
13132,2,15,true,4,8,4,41.89573,-87.67718
15530,2,15,true,12,8,-4,41.89575,-87.62596
18003,2,15,true,13,2,-11,41.89575,-87.62011
13247,2,15,true,5,3,-2,41.89597,-87.66775
TA1305000020,2,15,true,6,7,1,41.89636,-87.65406
13289,2,15,true,4,13,9,41.89638,-87.661
13017,2,15,true,9,7,-2,41.89676,-87.6357
13338,2,15,true,21,9,-12,41.89697,-87.62173
TA1306000009,2,15,true,12,7,-5,41.89772,-87.64299
620,2,15,true,5,6,1,41.89817,-87.63754
15529,2,15,true,14,7,-7,41.89858,-87.62206
TA1307000128,2,15,true,13,22,9,41.89896,-87.6299
KA1504000116,2,15,true,6,7,1,41.90023,-87.64299
13290,2,15,true,5,3,-2,41.90069,-87.66259
13042,2,15,true,22,14,-8,41.90097,-87.62377
TA1307000070,2,15,true,6,2,-4,41.90133,-87.67742
KA1504000133,2,15,true,6,16,10,41.90234,-87.62773
TA1306000006,2,15,true,6,1,-5,41.90292,-87.63772
TA1307000039,2,15,true,11,18,7,41.90294,-87.63137
KA1504000135,2,15,true,23,25,2,41.90319,-87.63439
13061,2,15,true,11,4,-7,41.90342,-87.66779
KA1504000079,2,15,true,14,7,-7,41.9035,-87.64334
TA1307000115,2,15,true,1,6,5,41.9046,-87.64056
TA1308000049,2,15,true,5,8,3,41.90672,-87.6349
KA1504000134,2,15,true,6,5,-1,41.90687,-87.6262
13224,2,15,true,5,5,0,41.90706,-87.66725
TA1309000024,2,15,true,12,12,0,41.908,-87.63152
TA1305000041,2,15,true,4,9,5,41.9094,-87.67769
331,2,15,true,9,9,0,41.90965,-87.64812
13154,2,15,true,6,7,1,41.91054,-87.65312
13058,2,15,true,8,5,-3,41.91059,-87.64942
TA1307000038,2,15,true,1,8,7,41.91138,-87.63868
LF-005,2,15,true,12,13,1,41.91172,-87.62681
13128,2,15,true,7,4,-3,41.91197,-87.63197
TA1308000050,2,15,true,15,26,11,41.91211,-87.6347
13243,2,15,true,5,7,2,41.91262,-87.6814
TA1306000032,2,15,true,7,6,-1,41.9137,-87.65285
TA1307000166,2,15,true,3,7,4,41.91386,-87.64877
18067,2,15,true,5,6,1,41.9146,-87.66796
13068,2,15,true,1,6,5,41.91554,-87.68703
13179,2,15,true,9,10,1,41.9157,-87.63461
TA1307000163,2,15,true,6,6,0,41.91821,-87.65696
13146,2,15,true,11,14,3,41.91831,-87.63629
13059,2,15,true,5,10,5,41.91845,-87.65222
13192,2,15,true,7,7,0,41.91995,-87.64884
TA1309000030,2,15,true,5,8,3,41.92077,-87.66372
13193,2,15,true,13,16,3,41.92182,-87.64412
13191,2,15,true,8,8,0,41.92217,-87.63891
13084,2,15,true,4,6,2,41.92268,-87.69715
TA1307000001,2,15,true,5,6,1,41.92535,-87.66581
TA1306000026,2,15,true,11,8,-3,41.92558,-87.65842
TA1306000016,2,15,true,7,5,-2,41.9256,-87.65371
TA1309000019,2,15,true,12,12,0,41.92586,-87.63897
TA1309000058,2,15,true,2,13,11,41.92591,-87.64927
TA1308000001,2,15,true,18,20,2,41.92627,-87.63086
TA1309000023,2,15,true,7,4,-3,41.9287,-87.65383
TA1309000059,2,15,true,5,3,-2,41.92889,-87.65898
TA1309000061,2,15,true,4,5,1,41.92915,-87.64909
TA1305000014,2,15,true,10,15,5,41.92956,-87.64313
13085,2,15,true,5,3,-2,41.92958,-87.70789
TA1307000142,2,15,true,10,8,-2,41.93125,-87.64432
13276,2,15,true,5,8,3,41.93132,-87.63874
13271,2,15,true,5,4,-1,41.93192,-87.67784
TA1307000064,2,15,true,4,8,4,41.93222,-87.65864
TA1306000014,2,15,true,8,14,6,41.93242,-87.65271
TA1309000039,2,15,true,13,6,-7,41.93258,-87.63642
TA1309000036,2,15,true,5,4,-1,41.93313,-87.64776
TA1307000006,2,15,true,7,10,3,41.93571,-87.6636
13268,2,15,true,1,5,4,41.93588,-87.67843
TA1307000052,2,15,true,8,4,-4,41.93628,-87.65266
TA1307000136,2,15,true,8,9,1,41.9365,-87.64755
TA1307000041,2,15,true,10,10,0,41.93669,-87.63683
13137,2,15,true,14,21,7,41.9376,-87.6441
13277,2,15,true,5,8,3,41.9401,-87.64546
TA1307000134,2,15,true,6,11,5,41.94016,-87.65303
TA1309000049,2,15,true,8,15,7,41.94077,-87.63919
15634,2,15,true,7,2,-5,41.94304,-87.68729
TA1307000138,2,15,true,4,5,1,41.94334,-87.67094
TA1309000025,2,15,true,8,10,2,41.94368,-87.64894
13071,2,15,true,8,9,1,41.94373,-87.66401
632,2,15,true,3,11,8,41.94453,-87.6547
13278,2,15,true,16,9,-7,41.94553,-87.64644
13235,2,15,true,8,14,6,41.94814,-87.66396
13325,2,15,true,8,14,6,41.94907,-87.64863
TA1307000126,2,15,true,3,8,5,41.94936,-87.65451
TA1307000150,2,15,true,8,13,5,41.94945,-87.64646
TA1307000127,2,15,true,3,8,5,41.9508,-87.65918
13323,2,15,true,2,5,3,41.95282,-87.65
13063,2,15,true,9,8,-1,41.95424,-87.65441
TA1309000026,2,15,true,7,4,-3,41.95601,-87.6802
13379,2,15,true,7,11,4,41.95786,-87.6495
13389,2,15,true,6,6,0,41.961,-87.64958
KA1503000022,2,15,true,5,3,-2,41.96158,-87.66609
TA1307000107,2,15,true,9,5,-4,41.96164,-87.65464
TA1308000012,2,15,true,21,16,-5,41.96398,-87.63818
13074,2,15,true,7,5,-2,41.96521,-87.6582
639,2,15,true,5,4,-1,41.96584,-87.64538
KA1504000093,2,15,true,5,2,-3,41.96587,-87.69365
TA1307000119,2,15,true,7,1,-6,41.96796,-87.65
TA1308000021,2,15,true,5,1,-4,41.96883,-87.65765
TA1309000066,2,15,true,7,6,-1,41.9691,-87.67423
KA1504000171,2,15,true,4,6,2,41.97161,-87.65016
13108,2,15,true,4,6,2,41.97379,-87.65971
KA1504000146,2,15,true,4,5,1,41.978,-87.66805
13109,2,15,true,7,7,0,41.97835,-87.65976
KA1504000151,2,15,true,2,5,3,41.98359,-87.66916
KA1504000152,2,15,true,9,11,2,41.98403,-87.65231
15578,2,15,true,5,2,-3,41.98405,-87.66027
15571,2,15,true,7,2,-5,41.99478,-87.66028
RP-009,2,15,true,3,6,3,42.00107,-87.66122
KA1504000175,2,15,true,1,6,5,42.00797,-87.66549
KA1503000014,2,16,false,6,5,-1,41.7851,-87.60108
TA1309000011,2,16,false,6,2,-4,41.78873,-87.60131
KA1503000071,2,16,false,6,5,-1,41.79148,-87.59988
KA1503000074,2,16,false,15,4,-11,41.79174,-87.58395
TA1309000063,2,16,false,3,5,2,41.79325,-87.5878
TA1308000009,2,16,false,12,11,-1,41.79522,-87.58075
TA1307000164,2,16,false,8,4,-4,41.79527,-87.59647
KA1503000052,2,16,false,5,1,-4,41.79935,-87.60097
TA1309000037,2,16,false,6,6,0,41.79957,-87.59474
KA1503000007,2,16,false,7,5,-2,41.80242,-87.58689
TA1308000035,2,16,false,4,6,2,41.80944,-87.59188
TA1308000007,2,16,false,7,2,-5,41.80984,-87.61628
KA1503000004,2,16,false,8,2,-6,41.83127,-87.6088
13345,2,16,false,2,6,4,41.83138,-87.61803
TA1307000048,2,16,false,9,6,-3,41.83855,-87.60821
TA1305000001,2,16,false,5,2,-3,41.85262,-87.6265
13075,2,16,false,2,12,10,41.8531,-87.63192
15545,2,16,false,4,14,10,41.85627,-87.61334
SL-013,2,16,false,5,2,-3,41.85659,-87.62755
SL-006,2,16,false,6,1,-5,41.8568,-87.63387
13150,2,16,false,1,6,5,41.85783,-87.62455
13099,2,16,false,3,5,2,41.85784,-87.64627
TA1307000159,2,16,false,5,1,-4,41.8579,-87.6687
TA1307000124,2,16,false,6,12,6,41.86411,-87.62372
13165,2,16,false,5,7,2,41.86505,-87.65697
13029,2,16,false,8,7,-1,41.86531,-87.6179
13431,2,16,false,16,11,-5,41.8661,-87.60728
TA1305000002,2,16,false,10,17,7,41.86721,-87.62597
15544,2,16,false,37,17,-20,41.86723,-87.61536
SL-005,2,16,false,17,27,10,41.8679,-87.62304
13160,2,16,false,1,5,4,41.86947,-87.65548
TA1309000010,2,16,false,6,4,-2,41.87074,-87.62574
SL-008,2,16,false,11,9,-2,41.87209,-87.62956
SL-011,2,16,false,4,10,6,41.87256,-87.63356
623,2,16,false,22,20,-2,41.87272,-87.62399
KA1504000104,2,16,false,7,2,-5,41.87296,-87.66912
SL-007,2,16,false,7,1,-6,41.87404,-87.6277
13028,2,16,false,5,3,-2,41.87475,-87.64981
15541,2,16,false,54,23,-31,41.8758,-87.62086
TA1305000010,2,16,false,6,10,4,41.87623,-87.62444
624,2,16,false,7,5,-2,41.87626,-87.62923
TA1305000035,2,16,false,9,7,-2,41.87716,-87.62787
13158,2,16,false,2,5,3,41.87764,-87.64957
TA1305000025,2,16,false,15,2,-13,41.87773,-87.63528
TA1309000002,2,16,false,7,10,3,41.87784,-87.62408
TA1309000004,2,16,false,5,3,-2,41.87811,-87.63184
638,2,16,false,5,8,3,41.87827,-87.64078
TA1305000005,2,16,false,12,2,-10,41.87924,-87.62975
13011,2,16,false,8,9,1,41.87931,-87.63993
TA1309000008,2,16,false,8,3,-5,41.87933,-87.6355
KA1503000034,2,16,false,6,4,-2,41.87938,-87.63197
KA1503000015,2,16,false,8,5,-3,41.87948,-87.6257
TA1309000007,2,16,false,13,5,-8,41.88022,-87.63526
WL-011,2,16,false,5,11,6,41.88034,-87.64273
13300,2,16,false,35,40,5,41.88097,-87.61675
13008,2,16,false,44,46,2,41.88105,-87.62408
TA1305000006,2,16,false,11,7,-4,41.88122,-87.6296
13056,2,16,false,5,4,-1,41.88168,-87.63951
TA1307000120,2,16,false,9,10,1,41.88188,-87.64879
13341,2,16,false,15,7,-8,41.88208,-87.63985
13036,2,16,false,5,18,13,41.8821,-87.62513
TA1305000032,2,16,false,13,6,-7,41.88218,-87.64109
13006,2,16,false,7,2,-5,41.88268,-87.63252
13409,2,16,false,4,5,1,41.8831,-87.6511
KA1503000072,2,16,false,8,3,-5,41.88317,-87.63693
WL-012,2,16,false,8,5,-3,41.88337,-87.6412
13053,2,16,false,12,14,2,41.88365,-87.64863
13001,2,16,false,13,16,3,41.88397,-87.62459
18062,2,16,false,5,5,0,41.88412,-87.65427
TA1306000010,2,16,false,16,14,-2,41.88419,-87.62961
TA1305000030,2,16,false,16,7,-9,41.88459,-87.63178
15535,2,16,false,8,12,4,41.8846,-87.64455
TA1305000029,2,16,false,16,26,10,41.88466,-87.62787
13263,2,16,false,8,9,1,41.88467,-87.61952
TA1306000015,2,16,false,11,8,-3,41.88549,-87.65232
13021,2,16,false,13,6,-7,41.88559,-87.64184
TA1307000111,2,16,false,9,2,-7,41.88582,-87.63548
KA1503000012,2,16,false,13,8,-5,41.88599,-87.63089
TA1305000011,2,16,false,10,17,7,41.886,-87.62418
15534,2,16,false,4,5,1,41.88627,-87.61749
13197,2,16,false,8,3,-5,41.8866,-87.65816
TA1308000029,2,16,false,6,9,3,41.88673,-87.62225
TA1307000131,2,16,false,14,19,5,41.88688,-87.62606
KA1503000064,2,16,false,22,20,-2,41.88697,-87.61281
TA1305000022,2,16,false,10,8,-2,41.88817,-87.63656
TA1306000003,2,16,false,18,15,-3,41.88867,-87.64442
KA1503000043,2,16,false,13,10,-3,41.88918,-87.63851
13050,2,16,false,7,14,7,41.88919,-87.62775
TA1307000151,2,16,false,11,11,0,41.88993,-87.63427
KA1503000044,2,16,false,14,2,-12,41.89018,-87.6262
13427,2,16,false,7,10,3,41.89054,-87.62205
13430,2,16,false,1,10,9,41.89077,-87.63169
TA1306000013,2,16,false,20,16,-4,41.89083,-87.61852
RN-,2,16,false,5,3,-2,41.89102,-87.63546
13434,2,16,false,6,2,-4,41.89108,-87.66663
TA1307000117,2,16,false,17,21,4,41.89144,-87.62675
13033,2,16,false,11,12,1,41.8916,-87.64835
13194,2,16,false,3,6,3,41.8918,-87.65878
TA1305000003,2,16,false,17,11,-6,41.89187,-87.62061
13022,2,16,false,138,128,-10,41.89227,-87.61205
TA1306000029,2,16,false,14,14,0,41.89256,-87.61449
13265,2,16,false,15,3,-12,41.89383,-87.64172
13045,2,16,false,7,15,8,41.89403,-87.62931
13016,2,16,false,11,19,8,41.89431,-87.62277
KA1503000041,2,16,false,6,7,1,41.89452,-87.61798
13196,2,16,false,8,5,-3,41.89455,-87.65345
TA1307000062,2,16,false,7,3,-4,41.89466,-87.63839
TA1306000012,2,16,false,10,17,7,41.89475,-87.63438
KP1705001026,2,16,false,6,7,1,41.89483,-87.6323
637,2,16,false,4,6,2,41.89563,-87.67209
15530,2,16,false,13,10,-3,41.89575,-87.62596
TA1305000020,2,16,false,6,5,-1,41.89636,-87.65406
13289,2,16,false,11,3,-8,41.89638,-87.661
13303,2,16,false,6,9,3,41.89672,-87.63088
13017,2,16,false,6,4,-2,41.89676,-87.6357
13338,2,16,false,8,5,-3,41.89697,-87.62173
13034,2,16,false,15,12,-3,41.89754,-87.62352
TA1306000009,2,16,false,8,4,-4,41.89772,-87.64299
620,2,16,false,6,9,3,41.89817,-87.63754
15529,2,16,false,17,11,-6,41.89858,-87.62206
TA1307000128,2,16,false,12,11,-1,41.89896,-87.6299
13042,2,16,false,33,68,35,41.90097,-87.62377
KA1504000133,2,16,false,14,13,-1,41.90234,-87.62773
TA1307000039,2,16,false,17,16,-1,41.90294,-87.63137
TA1305000034,2,16,false,8,4,-4,41.90313,-87.67391
KA1504000135,2,16,false,18,14,-4,41.90319,-87.63439
13061,2,16,false,18,7,-11,41.90342,-87.66779
KA1504000079,2,16,false,4,6,2,41.9035,-87.64334
TA1308000049,2,16,false,9,9,0,41.90672,-87.6349
KA1504000134,2,16,false,12,10,-2,41.90687,-87.6262
13224,2,16,false,11,6,-5,41.90706,-87.66725
18069,2,16,false,5,3,-2,41.90722,-87.65563
13221,2,16,false,10,6,-4,41.90765,-87.67254
TA1309000024,2,16,false,10,4,-6,41.908,-87.63152
TA1305000041,2,16,false,9,5,-4,41.9094,-87.67769
331,2,16,false,5,5,0,41.90965,-87.64812
15653,2,16,false,3,6,3,41.90979,-87.7053
TA1305000037,2,16,false,10,5,-5,41.91018,-87.67003
TA1308000005,2,16,false,4,8,4,41.91042,-87.68238
13154,2,16,false,5,6,1,41.91054,-87.65312
13058,2,16,false,2,5,3,41.91059,-87.64942
TA1307000038,2,16,false,11,7,-4,41.91138,-87.63868
LF-005,2,16,false,35,38,3,41.91172,-87.62681
13128,2,16,false,7,2,-5,41.91197,-87.63197
TA1308000050,2,16,false,11,16,5,41.91211,-87.6347
13243,2,16,false,9,7,-2,41.91262,-87.6814
TA1307000166,2,16,false,5,2,-3,41.91386,-87.64877
13179,2,16,false,26,13,-13,41.9157,-87.63461
TA1305000039,2,16,false,7,6,-1,41.9163,-87.66749
TA1309000006,2,16,false,3,5,2,41.91809,-87.64375
TA1307000163,2,16,false,5,6,1,41.91821,-87.65696
13146,2,16,false,17,8,-9,41.91831,-87.63629
13059,2,16,false,10,18,8,41.91845,-87.65222
13192,2,16,false,4,8,4,41.91995,-87.64884
TA1309000033,2,16,false,5,4,-1,41.92158,-87.65381
13193,2,16,false,12,10,-2,41.92182,-87.64412
13191,2,16,false,7,3,-4,41.92217,-87.63891
LP-,2,16,false,19,12,-7,41.92396,-87.63584
TA1307000001,2,16,false,12,9,-3,41.92535,-87.66581
TA1306000026,2,16,false,1,5,4,41.92558,-87.65842
TA1306000016,2,16,false,6,9,3,41.9256,-87.65371
TA1309000019,2,16,false,13,11,-2,41.92586,-87.63897
TA1309000058,2,16,false,7,11,4,41.92591,-87.64927
TA1308000001,2,16,false,19,37,18,41.92627,-87.63086
13124,2,16,false,11,11,0,41.92675,-87.63444
TA1309000023,2,16,false,5,7,2,41.9287,-87.65383
TA1309000061,2,16,false,9,8,-1,41.92915,-87.64909
TA1308000031,2,16,false,3,5,2,41.92946,-87.68417
TA1305000014,2,16,false,10,14,4,41.92956,-87.64313
13085,2,16,false,10,5,-5,41.92958,-87.70789
TA1307000142,2,16,false,6,5,-1,41.93125,-87.64432
13276,2,16,false,10,9,-1,41.93132,-87.63874
TA1307000064,2,16,false,9,6,-3,41.93222,-87.65864
TA1306000014,2,16,false,7,14,7,41.93242,-87.65271
TA1309000039,2,16,false,9,9,0,41.93258,-87.63642
TA1307000006,2,16,false,6,2,-4,41.93571,-87.6636
TA1307000136,2,16,false,7,8,1,41.9365,-87.64755
TA1307000041,2,16,false,12,11,-1,41.93669,-87.63683
13137,2,16,false,12,17,5,41.9376,-87.6441
15642,2,16,false,3,6,3,41.93843,-87.69801
TA1309000042,2,16,false,7,8,1,41.93937,-87.66836
13277,2,16,false,3,12,9,41.9401,-87.64546
TA1307000134,2,16,false,15,7,-8,41.94016,-87.65303
13143,2,16,false,5,1,-4,41.94059,-87.67853
TA1309000049,2,16,false,15,18,3,41.94077,-87.63919
TA1307000138,2,16,false,4,5,1,41.94334,-87.67094
TA1309000025,2,16,false,8,8,0,41.94368,-87.64894
13071,2,16,false,7,7,0,41.94373,-87.66401
632,2,16,false,6,18,12,41.94453,-87.6547
13278,2,16,false,8,7,-1,41.94553,-87.64644
13235,2,16,false,4,7,3,41.94814,-87.66396
13325,2,16,false,8,10,2,41.94907,-87.64863
TA1307000126,2,16,false,8,13,5,41.94936,-87.65451
TA1307000150,2,16,false,4,15,11,41.94945,-87.64646
13319,2,16,false,6,3,-3,41.95069,-87.6687
TA1307000127,2,16,false,10,12,2,41.9508,-87.65918
13323,2,16,false,7,6,-1,41.95282,-87.65
13063,2,16,false,2,7,5,41.95424,-87.65441
TA1308000022,2,16,false,7,5,-2,41.95438,-87.64805
13379,2,16,false,5,7,2,41.95786,-87.6495
TA1309000027,2,16,false,5,2,-3,41.9585,-87.65499
13389,2,16,false,6,7,1,41.961,-87.64958
TA1307000107,2,16,false,7,2,-5,41.96164,-87.65464
TA1308000012,2,16,false,21,10,-11,41.96398,-87.63818
TA1309000014,2,16,false,1,7,6,41.96709,-87.66744
TA1308000021,2,16,false,9,2,-7,41.96883,-87.65765
KA1504000171,2,16,false,15,5,-10,41.97161,-87.65016
KA1504000151,2,16,false,5,4,-1,41.98359,-87.66916
KA1504000152,2,16,false,6,7,1,41.98403,-87.65231
15578,2,16,false,5,1,-4,41.98405,-87.66027
15571,2,16,false,6,6,0,41.99478,-87.66028
E008,2,16,false,5,4,-1,42.05049,-87.67782
KA1503000014,2,16,true,10,11,1,41.7851,-87.60108
TA1309000011,2,16,true,9,2,-7,41.78873,-87.60131
KA1503000071,2,16,true,20,7,-13,41.79148,-87.59988
TA1309000063,2,16,true,2,6,4,41.79325,-87.5878
TA1308000009,2,16,true,9,8,-1,41.79522,-87.58075
TA1307000164,2,16,true,6,4,-2,41.79527,-87.59647
KA1503000052,2,16,true,5,3,-2,41.79935,-87.60097
TA1309000037,2,16,true,6,11,5,41.79957,-87.59474
KA1503000068,2,16,true,1,7,6,41.82878,-87.68062
TA1308000045,2,16,true,5,3,-2,41.83062,-87.64129
TA1307000129,2,16,true,11,1,-10,41.83104,-87.62683
13216,2,16,true,12,12,0,41.83473,-87.62581
KA1503000038,2,16,true,5,2,-3,41.83845,-87.6354
TA1307000139,2,16,true,8,5,-3,41.84205,-87.61698
TA1307000153,2,16,true,2,5,3,41.84358,-87.64538
TA1307000005,2,16,true,5,5,0,41.84569,-87.6225
13075,2,16,true,5,3,-2,41.8531,-87.63192
15546,2,16,true,2,6,4,41.85416,-87.61916
15545,2,16,true,8,12,4,41.85627,-87.61334
13102,2,16,true,7,10,3,41.85762,-87.61942
13150,2,16,true,14,11,-3,41.85783,-87.62455
13164,2,16,true,8,8,0,41.85818,-87.65648
SL-012,2,16,true,8,10,2,41.86038,-87.62581
TA1306000002,2,16,true,4,5,1,41.86238,-87.65108
TA1307000124,2,16,true,9,16,7,41.86411,-87.62372
13354,2,16,true,5,4,-1,41.86524,-87.66651
13431,2,16,true,7,5,-2,41.8661,-87.60728
WL-008,2,16,true,2,10,8,41.86712,-87.64108
TA1305000002,2,16,true,14,25,11,41.86721,-87.62597
15544,2,16,true,5,6,1,41.86723,-87.61536
TA1305000017,2,16,true,9,4,-5,41.86734,-87.64863
KA1706005007,2,16,true,6,6,0,41.86749,-87.63219
SL-005,2,16,true,17,17,0,41.8679,-87.62304
13139,2,16,true,4,8,4,41.86893,-87.65913
13285,2,16,true,33,5,-28,41.86928,-87.67372
13160,2,16,true,4,14,10,41.86947,-87.65548
TA1309000010,2,16,true,7,11,4,41.87074,-87.62574
SL-009,2,16,true,6,5,-1,41.87081,-87.63121
TA1309000064,2,16,true,20,8,-12,41.87127,-87.67369
TA1307000130,2,16,true,8,7,-1,41.87178,-87.65103
TA1307000121,2,16,true,12,6,-6,41.87184,-87.64664
SL-008,2,16,true,17,16,-1,41.87209,-87.62956
13332,2,16,true,14,15,1,41.87219,-87.6615
SL-011,2,16,true,7,13,6,41.87256,-87.63356
623,2,16,true,8,8,0,41.87272,-87.62399
KA1504000104,2,16,true,37,3,-34,41.87296,-87.66912
SL-007,2,16,true,2,8,6,41.87404,-87.6277
TA1306000025,2,16,true,8,10,2,41.87464,-87.65703
13028,2,16,true,5,7,2,41.87475,-87.64981
13081,2,16,true,5,1,-4,41.87501,-87.67326
SL-010,2,16,true,11,20,9,41.87501,-87.63309
TA1305000009,2,16,true,9,15,6,41.87593,-87.63068
624,2,16,true,6,8,2,41.87626,-87.62923
TA1305000035,2,16,true,7,3,-4,41.87716,-87.62787
13138,2,16,true,12,11,-1,41.87723,-87.63941
15539,2,16,true,9,5,-4,41.87763,-87.64405
13158,2,16,true,9,13,4,41.87764,-87.64957
13157,2,16,true,7,10,3,41.87773,-87.6548
TA1305000025,2,16,true,16,5,-11,41.87773,-87.63528
13206,2,16,true,3,9,6,41.87794,-87.66201
TA1309000004,2,16,true,38,13,-25,41.87811,-87.63184
638,2,16,true,19,23,4,41.87827,-87.64078
TA1305000005,2,16,true,17,7,-10,41.87924,-87.62975
13011,2,16,true,17,39,22,41.87931,-87.63993
TA1309000008,2,16,true,20,7,-13,41.87933,-87.6355
KA1503000034,2,16,true,11,2,-9,41.87938,-87.63197
KA1503000015,2,16,true,14,4,-10,41.87948,-87.6257
TA1309000007,2,16,true,41,5,-36,41.88022,-87.63526
WL-011,2,16,true,6,10,4,41.88034,-87.64273
13156,2,16,true,6,15,9,41.88042,-87.65554
13300,2,16,true,7,18,11,41.88097,-87.61675
13008,2,16,true,9,11,2,41.88105,-87.62408
TA1305000006,2,16,true,41,10,-31,41.88122,-87.6296
13056,2,16,true,22,9,-13,41.88168,-87.63951
TA1307000120,2,16,true,17,19,2,41.88188,-87.64879
13341,2,16,true,21,13,-8,41.88208,-87.63985
13036,2,16,true,11,11,0,41.8821,-87.62513
TA1305000032,2,16,true,32,31,-1,41.88218,-87.64109
13006,2,16,true,11,6,-5,41.88268,-87.63252
13353,2,16,true,11,15,4,41.88283,-87.6612
13409,2,16,true,4,8,4,41.8831,-87.6511
KA1503000072,2,16,true,19,9,-10,41.88317,-87.63693
WL-012,2,16,true,21,52,31,41.88337,-87.6412
13053,2,16,true,10,7,-3,41.88365,-87.64863
13001,2,16,true,8,10,2,41.88397,-87.62459
18062,2,16,true,9,8,-1,41.88412,-87.65427
TA1306000010,2,16,true,30,8,-22,41.88419,-87.62961
TA1305000030,2,16,true,32,8,-24,41.88459,-87.63178
15535,2,16,true,5,9,4,41.8846,-87.64455
TA1305000029,2,16,true,17,14,-3,41.88466,-87.62787
13263,2,16,true,15,14,-1,41.88467,-87.61952
TA1306000015,2,16,true,18,8,-10,41.88549,-87.65232
13021,2,16,true,31,17,-14,41.88559,-87.64184
TA1307000111,2,16,true,35,5,-30,41.88582,-87.63548
KA1503000012,2,16,true,10,8,-2,41.88599,-87.63089
TA1305000011,2,16,true,22,16,-6,41.886,-87.62418
15534,2,16,true,14,8,-6,41.88627,-87.61749
13197,2,16,true,6,2,-4,41.8866,-87.65816
TA1308000029,2,16,true,8,5,-3,41.88673,-87.62225
TA1307000131,2,16,true,18,5,-13,41.88688,-87.62606
KA1503000064,2,16,true,10,10,0,41.88697,-87.61281
TA1305000022,2,16,true,34,10,-24,41.88817,-87.63656
TA1306000003,2,16,true,25,33,8,41.88867,-87.64442
KA1503000043,2,16,true,38,49,11,41.88918,-87.63851
13050,2,16,true,26,9,-17,41.88919,-87.62775
13432,2,16,true,6,9,3,41.88989,-87.67149
TA1307000151,2,16,true,22,10,-12,41.88993,-87.63427
636,2,16,true,7,8,1,41.88997,-87.63662
KA1503000044,2,16,true,12,10,-2,41.89018,-87.6262
13427,2,16,true,6,10,4,41.89054,-87.62205
13430,2,16,true,9,10,1,41.89077,-87.63169
TA1306000013,2,16,true,9,9,0,41.89083,-87.61852
RN-,2,16,true,11,10,-1,41.89102,-87.63546
13434,2,16,true,2,9,7,41.89108,-87.66663
TA1308000006,2,16,true,8,5,-3,41.89128,-87.67686
TA1307000117,2,16,true,29,12,-17,41.89144,-87.62675
13033,2,16,true,13,11,-2,41.8916,-87.64835
13194,2,16,true,8,9,1,41.8918,-87.65878
TA1305000003,2,16,true,19,15,-4,41.89187,-87.62061
13022,2,16,true,22,23,1,41.89227,-87.61205
TA1306000029,2,16,true,20,15,-5,41.89256,-87.61449
13265,2,16,true,20,14,-6,41.89383,-87.64172
13045,2,16,true,18,21,3,41.89403,-87.62931
13016,2,16,true,79,13,-66,41.89431,-87.62277
KA1503000041,2,16,true,38,13,-25,41.89452,-87.61798
13196,2,16,true,6,14,8,41.89455,-87.65345
TA1307000062,2,16,true,14,9,-5,41.89466,-87.63839
TA1306000012,2,16,true,22,22,0,41.89475,-87.63438
KP1705001026,2,16,true,14,7,-7,41.89483,-87.6323
637,2,16,true,5,3,-2,41.89563,-87.67209
13132,2,16,true,9,9,0,41.89573,-87.67718
15530,2,16,true,17,13,-4,41.89575,-87.62596
18003,2,16,true,19,4,-15,41.89575,-87.62011
13247,2,16,true,2,5,3,41.89597,-87.66775
TA1305000020,2,16,true,3,6,3,41.89636,-87.65406
13289,2,16,true,10,12,2,41.89638,-87.661
13303,2,16,true,7,9,2,41.89672,-87.63088
13017,2,16,true,21,23,2,41.89676,-87.6357
13338,2,16,true,17,6,-11,41.89697,-87.62173
TA1307000061,2,16,true,8,6,-2,41.89745,-87.62873
13034,2,16,true,15,5,-10,41.89754,-87.62352
TA1306000009,2,16,true,35,13,-22,41.89772,-87.64299
620,2,16,true,11,12,1,41.89817,-87.63754
15529,2,16,true,20,9,-11,41.89858,-87.62206
TA1307000128,2,16,true,23,30,7,41.89896,-87.6299
657,2,16,true,2,5,3,41.89918,-87.6722
KA1504000117,2,16,true,9,1,-8,41.89936,-87.64848
13248,2,16,true,7,5,-2,41.89964,-87.66788
TA1306000011,2,16,true,5,9,4,41.89994,-87.63443
KA1504000116,2,16,true,8,7,-1,41.90023,-87.64299
13290,2,16,true,3,6,3,41.90069,-87.66259
13042,2,16,true,28,14,-14,41.90097,-87.62377
KA1504000133,2,16,true,14,14,0,41.90234,-87.62773
TA1307000039,2,16,true,22,39,17,41.90294,-87.63137
658,2,16,true,8,4,-4,41.903,-87.6838
TA1305000034,2,16,true,7,10,3,41.90313,-87.67391
KA1504000135,2,16,true,16,35,19,41.90319,-87.63439
13136,2,16,true,8,7,-1,41.90326,-87.67845
13061,2,16,true,11,11,0,41.90342,-87.66779
KA1504000079,2,16,true,18,17,-1,41.9035,-87.64334
TA1307000115,2,16,true,15,5,-10,41.9046,-87.64056
TA1308000049,2,16,true,12,19,7,41.90672,-87.6349
KA1504000134,2,16,true,14,17,3,41.90687,-87.6262
13224,2,16,true,7,7,0,41.90706,-87.66725
TA1307000143,2,16,true,5,3,-2,41.90762,-87.63854
13221,2,16,true,4,16,12,41.90765,-87.67254
TA1309000024,2,16,true,13,22,9,41.908,-87.63152
TA1305000041,2,16,true,12,9,-3,41.9094,-87.67769
331,2,16,true,18,16,-2,41.90965,-87.64812
TA1305000037,2,16,true,11,12,1,41.91018,-87.67003
TA1306000008,2,16,true,6,1,-5,41.9102,-87.6435
TA1308000005,2,16,true,8,9,1,41.91042,-87.68238
13258,2,16,true,6,4,-2,41.91043,-87.69718
13154,2,16,true,9,17,8,41.91054,-87.65312
13058,2,16,true,9,10,1,41.91059,-87.64942
TA1307000038,2,16,true,18,9,-9,41.91138,-87.63868
LF-005,2,16,true,19,9,-10,41.91172,-87.62681
13128,2,16,true,3,9,6,41.91197,-87.63197
TA1308000050,2,16,true,28,38,10,41.91211,-87.6347
13243,2,16,true,6,14,8,41.91262,-87.6814
TA1306000032,2,16,true,10,10,0,41.9137,-87.65285
TA1307000166,2,16,true,13,12,-1,41.91386,-87.64877
15655,2,16,true,2,10,8,41.91401,-87.70514
18067,2,16,true,7,5,-2,41.9146,-87.66796
13068,2,16,true,9,6,-3,41.91554,-87.68703
13179,2,16,true,11,16,5,41.9157,-87.63461
13133,2,16,true,8,10,2,41.91598,-87.67733
TA1305000039,2,16,true,9,7,-2,41.9163,-87.66749
13266,2,16,true,3,5,2,41.91774,-87.69142
TA1309000006,2,16,true,10,5,-5,41.91809,-87.64375
TA1307000163,2,16,true,9,15,6,41.91821,-87.65696
13146,2,16,true,13,24,11,41.91831,-87.63629
13059,2,16,true,12,11,-1,41.91845,-87.65222
13192,2,16,true,8,22,14,41.91995,-87.64884
TA1309000030,2,16,true,10,8,-2,41.92077,-87.66372
TA1309000033,2,16,true,9,11,2,41.92158,-87.65381
13193,2,16,true,12,17,5,41.92182,-87.64412
13191,2,16,true,8,16,8,41.92217,-87.63891
13084,2,16,true,5,4,-1,41.92268,-87.69715
LP-,2,16,true,10,10,0,41.92396,-87.63584
TA1307000001,2,16,true,13,5,-8,41.92535,-87.66581
TA1306000026,2,16,true,8,6,-2,41.92558,-87.65842
TA1306000016,2,16,true,11,8,-3,41.9256,-87.65371
TA1309000019,2,16,true,15,13,-2,41.92586,-87.63897
TA1309000058,2,16,true,14,18,4,41.92591,-87.64927
TA1308000001,2,16,true,19,13,-6,41.92627,-87.63086
TA1309000023,2,16,true,11,15,4,41.9287,-87.65383
TA1307000113,2,16,true,4,7,3,41.92878,-87.66391
TA1309000059,2,16,true,6,2,-4,41.92889,-87.65898
TA1309000061,2,16,true,7,7,0,41.92915,-87.64909
TA1305000014,2,16,true,16,20,4,41.92956,-87.64313
TA1307000142,2,16,true,12,18,6,41.93125,-87.64432
13276,2,16,true,11,17,6,41.93132,-87.63874
13271,2,16,true,7,3,-4,41.93192,-87.67784
TA1307000064,2,16,true,10,7,-3,41.93222,-87.65864
TA1306000014,2,16,true,4,9,5,41.93242,-87.65271
TA1309000039,2,16,true,9,21,12,41.93258,-87.63642
13294,2,16,true,3,9,6,41.9326,-87.66595
TA1309000036,2,16,true,11,16,5,41.93313,-87.64776
TA1307000006,2,16,true,6,7,1,41.93571,-87.6636
13268,2,16,true,5,4,-1,41.93588,-87.67843
13269,2,16,true,1,7,6,41.93609,-87.66983
TA1307000052,2,16,true,13,6,-7,41.93628,-87.65266
TA1307000136,2,16,true,9,9,0,41.9365,-87.64755
TA1307000041,2,16,true,20,9,-11,41.93669,-87.63683
13137,2,16,true,16,23,7,41.9376,-87.6441
TA1309000042,2,16,true,5,8,3,41.93937,-87.66836
13229,2,16,true,6,9,3,41.93946,-87.66376
TA1308000019,2,16,true,9,8,-1,41.93973,-87.65886
13277,2,16,true,7,12,5,41.9401,-87.64546
TA1307000134,2,16,true,13,18,5,41.94016,-87.65303
TA1309000049,2,16,true,14,22,8,41.94077,-87.63919
TA1307000138,2,16,true,4,5,1,41.94334,-87.67094
13144,2,16,true,5,5,0,41.9434,-87.67964
TA1309000025,2,16,true,7,12,5,41.94368,-87.64894
13071,2,16,true,17,12,-5,41.94373,-87.66401
632,2,16,true,8,15,7,41.94453,-87.6547
13278,2,16,true,12,20,8,41.94553,-87.64644
13235,2,16,true,13,8,-5,41.94814,-87.66396
13253,2,16,true,7,7,0,41.9488,-87.67527
13325,2,16,true,26,18,-8,41.94907,-87.64863
TA1307000126,2,16,true,6,9,3,41.94936,-87.65451
TA1307000150,2,16,true,12,23,11,41.94945,-87.64646
13319,2,16,true,16,4,-12,41.95069,-87.6687
TA1307000127,2,16,true,7,6,-1,41.9508,-87.65918
13323,2,16,true,4,6,2,41.95282,-87.65
TA1309000043,2,16,true,9,7,-2,41.95417,-87.66434
13063,2,16,true,14,14,0,41.95424,-87.65441
KA1504000158,2,16,true,1,5,4,41.95432,-87.68607
TA1308000022,2,16,true,8,12,4,41.95438,-87.64805
13379,2,16,true,15,16,1,41.95786,-87.6495
TA1309000027,2,16,true,4,12,8,41.9585,-87.65499
13389,2,16,true,6,11,5,41.961,-87.64958
TA1307000144,2,16,true,7,6,-1,41.96142,-87.6762
KA1503000022,2,16,true,2,6,4,41.96158,-87.66609
TA1307000107,2,16,true,11,11,0,41.96164,-87.65464
TA1307000156,2,16,true,2,6,4,41.96301,-87.68479
TA1308000012,2,16,true,10,8,-2,41.96398,-87.63818
13074,2,16,true,8,8,0,41.96521,-87.6582
639,2,16,true,5,5,0,41.96584,-87.64538
KA1504000127,2,16,true,2,5,3,41.96587,-87.70083
TA1307000140,2,16,true,5,6,1,41.96643,-87.68865
TA1309000014,2,16,true,10,4,-6,41.96709,-87.66744
TA1307000158,2,16,true,9,3,-6,41.9671,-87.67904
KA1504000080,2,16,true,2,6,4,41.96887,-87.69609
TA1309000066,2,16,true,9,5,-4,41.9691,-87.67423
TA1309000041,2,16,true,5,1,-4,41.96951,-87.65471
KA1504000171,2,16,true,6,5,-1,41.97161,-87.65016
TA1309000035,2,16,true,3,8,5,41.97335,-87.66785
13108,2,16,true,7,5,-2,41.97379,-87.65971
KA1504000149,2,16,true,2,6,4,41.97562,-87.67945
13109,2,16,true,6,5,-1,41.97835,-87.65976
KA1504000151,2,16,true,11,8,-3,41.98359,-87.66916
KA1504000152,2,16,true,13,12,-1,41.98403,-87.65231
15578,2,16,true,2,5,3,41.98405,-87.66027
15575,2,16,true,3,7,4,41.98975,-87.66014
15571,2,16,true,5,9,4,41.99478,-87.66028
E002,2,16,true,6,4,-2,42.03256,-87.67912
E014,2,16,true,1,6,5,42.06483,-87.71531
15491,2,17,false,5,1,-4,41.78096,-87.57624
KA1503000014,2,17,false,6,6,0,41.7851,-87.60108
KA1503000074,2,17,false,7,1,-6,41.79174,-87.58395
TA1309000063,2,17,false,6,5,-1,41.79325,-87.5878
TA1308000009,2,17,false,16,18,2,41.79522,-87.58075
TA1307000164,2,17,false,4,7,3,41.79527,-87.59647
KA1503000059,2,17,false,5,3,-2,41.79952,-87.58643
TA1309000037,2,17,false,11,3,-8,41.79957,-87.59474
TA1308000035,2,17,false,6,2,-4,41.80944,-87.59188
TA1308000038,2,17,false,1,6,5,41.82298,-87.6071
13215,2,17,false,6,5,-1,41.83634,-87.6135
TA1307000048,2,17,false,12,14,2,41.83855,-87.60821
TA1307000139,2,17,false,2,5,3,41.84205,-87.61698
TA1308000026,2,17,false,3,5,2,41.85008,-87.63214
13075,2,17,false,12,7,-5,41.8531,-87.63192
13089,2,17,false,1,6,5,41.85497,-87.67567
15545,2,17,false,11,9,-2,41.85627,-87.61334
SL-006,2,17,false,9,6,-3,41.8568,-87.63387
13135,2,17,false,6,4,-2,41.85753,-87.66157
13102,2,17,false,12,12,0,41.85762,-87.61942
13150,2,17,false,5,5,0,41.85783,-87.62455
SL-012,2,17,false,3,6,3,41.86038,-87.62581
TA1307000124,2,17,false,9,6,-3,41.86411,-87.62372
TA1309000001,2,17,false,5,1,-4,41.86488,-87.64708
13029,2,17,false,5,1,-4,41.86531,-87.6179
13431,2,17,false,8,7,-1,41.8661,-87.60728
WL-008,2,17,false,1,5,4,41.86712,-87.64108
TA1305000002,2,17,false,19,10,-9,41.86721,-87.62597
15544,2,17,false,29,29,0,41.86723,-87.61536
KA1706005007,2,17,false,2,5,3,41.86749,-87.63219
SL-005,2,17,false,41,25,-16,41.8679,-87.62304
13139,2,17,false,3,8,5,41.86893,-87.65913
15550,2,17,false,3,7,4,41.87024,-87.63947
TA1309000010,2,17,false,23,7,-16,41.87074,-87.62574
SL-009,2,17,false,6,3,-3,41.87081,-87.63121
TA1309000064,2,17,false,5,1,-4,41.87127,-87.67369
SL-008,2,17,false,12,15,3,41.87209,-87.62956
SL-011,2,17,false,18,13,-5,41.87256,-87.63356
623,2,17,false,9,10,1,41.87272,-87.62399
KA1504000104,2,17,false,6,1,-5,41.87296,-87.66912
SL-007,2,17,false,9,2,-7,41.87404,-87.6277
13028,2,17,false,1,5,4,41.87475,-87.64981
15541,2,17,false,35,29,-6,41.8758,-87.62086
624,2,17,false,5,9,4,41.87626,-87.62923
TA1305000035,2,17,false,14,11,-3,41.87716,-87.62787
15539,2,17,false,7,6,-1,41.87763,-87.64405
13158,2,17,false,5,6,1,41.87764,-87.64957
13157,2,17,false,4,5,1,41.87773,-87.6548
TA1305000025,2,17,false,28,18,-10,41.87773,-87.63528
TA1309000002,2,17,false,18,10,-8,41.87784,-87.62408
13206,2,17,false,4,5,1,41.87794,-87.66201
TA1309000004,2,17,false,5,3,-2,41.87811,-87.63184
638,2,17,false,11,7,-4,41.87827,-87.64078
TA1305000005,2,17,false,8,2,-6,41.87924,-87.62975
13011,2,17,false,15,9,-6,41.87931,-87.63993
TA1309000008,2,17,false,5,2,-3,41.87933,-87.6355
KA1503000034,2,17,false,5,1,-4,41.87938,-87.63197
KA1503000015,2,17,false,9,7,-2,41.87948,-87.6257
TA1309000007,2,17,false,19,2,-17,41.88022,-87.63526
WL-011,2,17,false,13,3,-10,41.88034,-87.64273
13156,2,17,false,16,8,-8,41.88042,-87.65554
13300,2,17,false,62,59,-3,41.88097,-87.61675
13008,2,17,false,47,30,-17,41.88105,-87.62408
TA1305000006,2,17,false,18,3,-15,41.88122,-87.6296
13056,2,17,false,11,3,-8,41.88168,-87.63951
TA1307000120,2,17,false,19,13,-6,41.88188,-87.64879
13341,2,17,false,23,3,-20,41.88208,-87.63985
13036,2,17,false,27,11,-16,41.8821,-87.62513
TA1305000032,2,17,false,29,13,-16,41.88218,-87.64109
13353,2,17,false,5,7,2,41.88283,-87.6612
13409,2,17,false,9,8,-1,41.8831,-87.6511
KA1503000072,2,17,false,13,3,-10,41.88317,-87.63693
WL-012,2,17,false,17,10,-7,41.88337,-87.6412
13053,2,17,false,16,16,0,41.88365,-87.64863
13001,2,17,false,22,19,-3,41.88397,-87.62459
13155,2,17,false,1,5,4,41.88407,-87.65689
18062,2,17,false,5,5,0,41.88412,-87.65427
TA1306000010,2,17,false,17,7,-10,41.88419,-87.62961
TA1305000030,2,17,false,22,8,-14,41.88459,-87.63178
15535,2,17,false,11,20,9,41.8846,-87.64455
TA1305000029,2,17,false,20,18,-2,41.88466,-87.62787
13263,2,17,false,12,14,2,41.88467,-87.61952
TA1306000015,2,17,false,17,21,4,41.88549,-87.65232
13021,2,17,false,12,7,-5,41.88559,-87.64184
TA1307000111,2,17,false,17,10,-7,41.88582,-87.63548
KA1503000012,2,17,false,21,6,-15,41.88599,-87.63089
TA1305000011,2,17,false,16,25,9,41.886,-87.62418
15534,2,17,false,6,4,-2,41.88627,-87.61749
13197,2,17,false,8,6,-2,41.8866,-87.65816
TA1308000029,2,17,false,4,8,4,41.88673,-87.62225
TA1307000131,2,17,false,10,24,14,41.88688,-87.62606
KA1503000064,2,17,false,44,42,-2,41.88697,-87.61281
TA1305000022,2,17,false,16,8,-8,41.88817,-87.63656
TA1306000003,2,17,false,32,18,-14,41.88867,-87.64442
KA1503000043,2,17,false,30,12,-18,41.88918,-87.63851
13050,2,17,false,26,20,-6,41.88919,-87.62775
TA1307000151,2,17,false,23,16,-7,41.88993,-87.63427
636,2,17,false,12,10,-2,41.88997,-87.63662
13427,2,17,false,20,6,-14,41.89054,-87.62205
13430,2,17,false,17,24,7,41.89077,-87.63169
TA1306000013,2,17,false,25,28,3,41.89083,-87.61852
RN-,2,17,false,7,6,-1,41.89102,-87.63546
13434,2,17,false,7,12,5,41.89108,-87.66663
TA1308000006,2,17,false,4,8,4,41.89128,-87.67686
TA1307000117,2,17,false,21,35,14,41.89144,-87.62675
13033,2,17,false,10,10,0,41.8916,-87.64835
13194,2,17,false,8,7,-1,41.8918,-87.65878
TA1305000003,2,17,false,25,26,1,41.89187,-87.62061
13022,2,17,false,101,108,7,41.89227,-87.61205
TA1306000029,2,17,false,27,31,4,41.89256,-87.61449
13265,2,17,false,15,11,-4,41.89383,-87.64172
13045,2,17,false,18,22,4,41.89403,-87.62931
13016,2,17,false,23,22,-1,41.89431,-87.62277
KA1503000041,2,17,false,11,6,-5,41.89452,-87.61798
13196,2,17,false,14,5,-9,41.89455,-87.65345
TA1307000062,2,17,false,5,2,-3,41.89466,-87.63839
TA1306000012,2,17,false,31,30,-1,41.89475,-87.63438
KP1705001026,2,17,false,10,18,8,41.89483,-87.6323
637,2,17,false,6,6,0,41.89563,-87.67209
13132,2,17,false,13,10,-3,41.89573,-87.67718
15530,2,17,false,14,12,-2,41.89575,-87.62596
13247,2,17,false,12,2,-10,41.89597,-87.66775
TA1305000020,2,17,false,10,6,-4,41.89636,-87.65406
13289,2,17,false,9,12,3,41.89638,-87.661
13303,2,17,false,10,7,-3,41.89672,-87.63088
13017,2,17,false,10,5,-5,41.89676,-87.6357
13338,2,17,false,9,8,-1,41.89697,-87.62173
TA1307000061,2,17,false,3,6,3,41.89745,-87.62873
13034,2,17,false,11,10,-1,41.89754,-87.62352
TA1306000009,2,17,false,16,10,-6,41.89772,-87.64299
620,2,17,false,11,6,-5,41.89817,-87.63754
KA1504000103,2,17,false,6,4,-2,41.89842,-87.68659
15529,2,17,false,11,11,0,41.89858,-87.62206
TA1307000128,2,17,false,27,17,-10,41.89896,-87.6299
657,2,17,false,12,2,-10,41.89918,-87.6722
13248,2,17,false,10,7,-3,41.89964,-87.66788
TA1306000011,2,17,false,8,6,-2,41.89994,-87.63443
KA1504000116,2,17,false,6,2,-4,41.90023,-87.64299
17660,2,17,false,12,5,-7,41.90036,-87.69671
13290,2,17,false,9,10,1,41.90069,-87.66259
13042,2,17,false,51,37,-14,41.90097,-87.62377
TA1307000070,2,17,false,4,6,2,41.90133,-87.67742
KA1504000133,2,17,false,15,16,1,41.90234,-87.62773
15654,2,17,false,1,5,4,41.90271,-87.70923
TA1306000006,2,17,false,6,5,-1,41.90292,-87.63772
TA1307000039,2,17,false,20,24,4,41.90294,-87.63137
658,2,17,false,5,3,-2,41.903,-87.6838
TA1305000034,2,17,false,5,10,5,41.90313,-87.67391
KA1504000135,2,17,false,30,27,-3,41.90319,-87.63439
13136,2,17,false,13,5,-8,41.90326,-87.67845
13061,2,17,false,11,17,6,41.90342,-87.66779
KA1504000079,2,17,false,16,12,-4,41.9035,-87.64334
TA1308000049,2,17,false,24,22,-2,41.90672,-87.6349
KA1504000134,2,17,false,17,19,2,41.90687,-87.6262
13224,2,17,false,17,5,-12,41.90706,-87.66725
TA1307000143,2,17,false,3,6,3,41.90762,-87.63854
13221,2,17,false,12,12,0,41.90765,-87.67254
TA1309000024,2,17,false,25,18,-7,41.908,-87.63152
TA1305000041,2,17,false,16,10,-6,41.9094,-87.67769
331,2,17,false,9,20,11,41.90965,-87.64812
TA1305000037,2,17,false,10,4,-6,41.91018,-87.67003
TA1306000008,2,17,false,8,5,-3,41.9102,-87.6435
TA1308000005,2,17,false,5,2,-3,41.91042,-87.68238
13258,2,17,false,5,4,-1,41.91043,-87.69718
13257,2,17,false,9,2,-7,41.91054,-87.68956
13154,2,17,false,14,10,-4,41.91054,-87.65312
13058,2,17,false,11,13,2,41.91059,-87.64942
TA1307000038,2,17,false,10,12,2,41.91138,-87.63868
LF-005,2,17,false,60,91,31,41.91172,-87.62681
13128,2,17,false,2,19,17,41.91197,-87.63197
TA1308000050,2,17,false,22,23,1,41.91211,-87.6347
13243,2,17,false,12,9,-3,41.91262,-87.6814
TA1306000032,2,17,false,6,3,-3,41.9137,-87.65285
TA1307000166,2,17,false,6,9,3,41.91386,-87.64877
18017,2,17,false,5,2,-3,41.91416,-87.71676
18067,2,17,false,8,6,-2,41.9146,-87.66796
TA1306000007,2,17,false,8,4,-4,41.91469,-87.64333
13068,2,17,false,10,10,0,41.91554,-87.68703
13179,2,17,false,26,48,22,41.9157,-87.63461
13133,2,17,false,5,15,10,41.91598,-87.67733
TA1305000039,2,17,false,4,6,2,41.9163,-87.66749
15651,2,17,false,5,3,-2,41.91752,-87.70181
13266,2,17,false,1,5,4,41.91774,-87.69142
TA1309000029,2,17,false,5,3,-2,41.9178,-87.68245
TA1309000006,2,17,false,9,3,-6,41.91809,-87.64375
TA1307000163,2,17,false,10,9,-1,41.91821,-87.65696
13146,2,17,false,29,22,-7,41.91831,-87.63629
13059,2,17,false,20,15,-5,41.91845,-87.65222
13259,2,17,false,2,8,6,41.91852,-87.69744
13192,2,17,false,9,12,3,41.91995,-87.64884
13288,2,17,false,7,3,-4,41.92008,-87.67788
TA1309000030,2,17,false,12,14,2,41.92077,-87.66372
TA1309000033,2,17,false,9,7,-2,41.92158,-87.65381
13193,2,17,false,13,24,11,41.92182,-87.64412
13191,2,17,false,13,8,-5,41.92217,-87.63891
13084,2,17,false,4,7,3,41.92268,-87.69715
LP-,2,17,false,20,11,-9,41.92396,-87.63584
KA1504000140,2,17,false,5,2,-3,41.92409,-87.67646
TA1307000001,2,17,false,11,12,1,41.92535,-87.66581
TA1306000026,2,17,false,11,9,-2,41.92558,-87.65842
TA1306000016,2,17,false,15,8,-7,41.9256,-87.65371
TA1309000019,2,17,false,17,23,6,41.92586,-87.63897
TA1309000058,2,17,false,23,13,-10,41.92591,-87.64927
TA1308000001,2,17,false,24,25,1,41.92627,-87.63086
15646,2,17,false,2,5,3,41.92668,-87.6977
13124,2,17,false,14,8,-6,41.92675,-87.63444
TA1309000023,2,17,false,25,26,1,41.9287,-87.65383
TA1307000113,2,17,false,10,12,2,41.92878,-87.66391
TA1309000059,2,17,false,10,6,-4,41.92889,-87.65898
TA1309000061,2,17,false,10,14,4,41.92915,-87.64909
TA1308000031,2,17,false,6,4,-2,41.92946,-87.68417
TA1305000014,2,17,false,20,20,0,41.92956,-87.64313
13085,2,17,false,9,9,0,41.92958,-87.70789
TA1307000142,2,17,false,29,15,-14,41.93125,-87.64432
13276,2,17,false,22,12,-10,41.93132,-87.63874
13271,2,17,false,10,9,-1,41.93192,-87.67784
TA1307000064,2,17,false,15,6,-9,41.93222,-87.65864
TA1306000014,2,17,false,20,8,-12,41.93242,-87.65271
TA1309000039,2,17,false,14,25,11,41.93258,-87.63642
13294,2,17,false,11,3,-8,41.9326,-87.66595
TA1309000036,2,17,false,10,7,-3,41.93313,-87.64776
TA1307000006,2,17,false,7,6,-1,41.93571,-87.6636
13268,2,17,false,6,7,1,41.93588,-87.67843
13269,2,17,false,6,1,-5,41.93609,-87.66983
TA1307000052,2,17,false,7,6,-1,41.93628,-87.65266
TA1307000136,2,17,false,10,5,-5,41.9365,-87.64755
TA1307000041,2,17,false,26,22,-4,41.93669,-87.63683
13137,2,17,false,27,18,-9,41.9376,-87.6441
15642,2,17,false,2,6,4,41.93843,-87.69801
KA17018068,2,17,false,7,2,-5,41.93935,-87.68327
TA1309000042,2,17,false,7,5,-2,41.93937,-87.66836
13229,2,17,false,17,6,-11,41.93946,-87.66376
TA1308000019,2,17,false,17,13,-4,41.93973,-87.65886
13277,2,17,false,7,8,1,41.9401,-87.64546
TA1307000134,2,17,false,12,28,16,41.94016,-87.65303
13143,2,17,false,5,2,-3,41.94059,-87.67853
TA1309000049,2,17,false,30,27,-3,41.94077,-87.63919
TA1307000138,2,17,false,8,8,0,41.94334,-87.67094
TA1309000025,2,17,false,18,28,10,41.94368,-87.64894
13071,2,17,false,13,13,0,41.94373,-87.66401
632,2,17,false,20,20,0,41.94453,-87.6547
13278,2,17,false,13,15,2,41.94553,-87.64644
TA1309000050,2,17,false,6,2,-4,41.94618,-87.67331
13235,2,17,false,8,18,10,41.94814,-87.66396
13253,2,17,false,2,5,3,41.9488,-87.67527
13325,2,17,false,14,25,11,41.94907,-87.64863
TA1307000126,2,17,false,11,43,32,41.94936,-87.65451
TA1307000150,2,17,false,12,6,-6,41.94945,-87.64646
13319,2,17,false,6,5,-1,41.95069,-87.6687
TA1307000127,2,17,false,11,22,11,41.9508,-87.65918
13323,2,17,false,7,8,1,41.95282,-87.65
TA1309000043,2,17,false,3,8,5,41.95417,-87.66434
13063,2,17,false,11,15,4,41.95424,-87.65441
TA1308000022,2,17,false,6,5,-1,41.95438,-87.64805
TA1309000026,2,17,false,5,5,0,41.95601,-87.6802
13379,2,17,false,9,6,-3,41.95786,-87.6495
TA1309000027,2,17,false,5,3,-2,41.9585,-87.65499
13389,2,17,false,7,8,1,41.961,-87.64958
TA1307000107,2,17,false,8,7,-1,41.96164,-87.65464
TA1307000156,2,17,false,5,3,-2,41.96301,-87.68479
TA1308000012,2,17,false,20,19,-1,41.96398,-87.63818
13074,2,17,false,7,2,-5,41.96521,-87.6582
639,2,17,false,4,8,4,41.96584,-87.64538
TA1309000014,2,17,false,4,8,4,41.96709,-87.66744
TA1307000119,2,17,false,8,8,0,41.96796,-87.65
TA1308000021,2,17,false,10,4,-6,41.96883,-87.65765
TA1309000066,2,17,false,7,6,-1,41.9691,-87.67423
KA1504000171,2,17,false,11,6,-5,41.97161,-87.65016
TA1309000035,2,17,false,5,7,2,41.97335,-87.66785
13108,2,17,false,8,8,0,41.97379,-87.65971
KA1504000078,2,17,false,8,3,-5,41.97491,-87.69258
KA1504000149,2,17,false,1,5,4,41.97562,-87.67945
KA1504000146,2,17,false,3,5,2,41.978,-87.66805
13109,2,17,false,5,1,-4,41.97835,-87.65976
KA1504000152,2,17,false,13,7,-6,41.98403,-87.65231
15578,2,17,false,5,3,-2,41.98405,-87.66027
15575,2,17,false,12,4,-8,41.98975,-87.66014
15571,2,17,false,5,6,1,41.99478,-87.66028
660,2,17,false,5,1,-4,42.00458,-87.66143
KA1503000014,2,17,true,8,7,-1,41.7851,-87.60108
TA1309000011,2,17,true,9,2,-7,41.78873,-87.60131
KA1503000071,2,17,true,14,5,-9,41.79148,-87.59988
KA1504000076,2,17,true,3,7,4,41.7943,-87.60145
TA1308000009,2,17,true,6,7,1,41.79522,-87.58075
TA1307000164,2,17,true,3,9,6,41.79527,-87.59647
KA1503000052,2,17,true,4,8,4,41.79935,-87.60097
KA1503000059,2,17,true,5,4,-1,41.79952,-87.58643
TA1309000037,2,17,true,8,10,2,41.79957,-87.59474
13398,2,17,true,2,5,3,41.80256,-87.59035
TA1308000045,2,17,true,3,5,2,41.83062,-87.64129
15445,2,17,true,6,3,-3,41.83453,-87.63183
13216,2,17,true,11,7,-4,41.83473,-87.62581
13217,2,17,true,3,7,4,41.83488,-87.61792
13215,2,17,true,9,8,-1,41.83634,-87.6135
TA1309000055,2,17,true,5,2,-3,41.8382,-87.64514
KA1503000038,2,17,true,3,8,5,41.83845,-87.6354
TA1307000048,2,17,true,18,13,-5,41.83855,-87.60821
TA1308000036,2,17,true,3,12,9,41.83883,-87.62186
TA1307000139,2,17,true,16,8,-8,41.84205,-87.61698
TA1307000153,2,17,true,4,10,6,41.84358,-87.64538
TA1308000026,2,17,true,5,3,-2,41.85008,-87.63214
13075,2,17,true,10,10,0,41.8531,-87.63192
15546,2,17,true,1,5,4,41.85416,-87.61916
15545,2,17,true,17,19,2,41.85627,-87.61334
SL-013,2,17,true,5,2,-3,41.85659,-87.62755
13135,2,17,true,3,8,5,41.85753,-87.66157
13102,2,17,true,10,20,10,41.85762,-87.61942
13150,2,17,true,11,17,6,41.85783,-87.62455
TA1307000044,2,17,true,5,4,-1,41.85794,-87.64083
13164,2,17,true,4,13,9,41.85818,-87.65648
SL-012,2,17,true,11,16,5,41.86038,-87.62581
13304,2,17,true,1,11,10,41.86126,-87.65659
TA1306000002,2,17,true,8,9,1,41.86238,-87.65108
TA1307000124,2,17,true,10,26,16,41.86411,-87.62372
TA1309000001,2,17,true,13,4,-9,41.86488,-87.64708
13431,2,17,true,5,6,1,41.8661,-87.60728
WL-008,2,17,true,5,13,8,41.86712,-87.64108
TA1305000002,2,17,true,23,37,14,41.86721,-87.62597
15544,2,17,true,5,6,1,41.86723,-87.61536
TA1305000017,2,17,true,6,3,-3,41.86734,-87.64863
KA1706005007,2,17,true,6,10,4,41.86749,-87.63219
SL-005,2,17,true,24,34,10,41.8679,-87.62304
13139,2,17,true,11,8,-3,41.86893,-87.65913
13285,2,17,true,17,4,-13,41.86928,-87.67372
13160,2,17,true,8,12,4,41.86947,-87.65548
15550,2,17,true,6,18,12,41.87024,-87.63947
TA1309000010,2,17,true,13,21,8,41.87074,-87.62574
SL-009,2,17,true,5,9,4,41.87081,-87.63121
TA1309000064,2,17,true,29,3,-26,41.87127,-87.67369
TA1307000130,2,17,true,12,9,-3,41.87178,-87.65103
TA1307000121,2,17,true,9,16,7,41.87184,-87.64664
SL-008,2,17,true,26,36,10,41.87209,-87.62956
13332,2,17,true,29,13,-16,41.87219,-87.6615
SL-011,2,17,true,9,19,10,41.87256,-87.63356
623,2,17,true,6,10,4,41.87272,-87.62399
KA1504000104,2,17,true,12,2,-10,41.87296,-87.66912
SL-007,2,17,true,9,9,0,41.87404,-87.6277
13326,2,17,true,6,5,-1,41.87425,-87.63958
TA1306000025,2,17,true,11,7,-4,41.87464,-87.65703
13028,2,17,true,7,17,10,41.87475,-87.64981
13081,2,17,true,7,1,-6,41.87501,-87.67326
SL-010,2,17,true,6,6,0,41.87501,-87.63309
13037,2,17,true,14,1,-13,41.87588,-87.64078
TA1305000009,2,17,true,10,10,0,41.87593,-87.63068
TA1305000010,2,17,true,10,1,-9,41.87623,-87.62444
624,2,17,true,12,6,-6,41.87626,-87.62923
TA1305000035,2,17,true,25,2,-23,41.87716,-87.62787
13138,2,17,true,32,9,-23,41.87723,-87.63941
15539,2,17,true,11,8,-3,41.87763,-87.64405
13158,2,17,true,16,23,7,41.87764,-87.64957
13157,2,17,true,12,21,9,41.87773,-87.6548
TA1305000025,2,17,true,55,6,-49,41.87773,-87.63528
TA1309000002,2,17,true,9,2,-7,41.87784,-87.62408
13206,2,17,true,8,7,-1,41.87794,-87.66201
TA1309000004,2,17,true,26,5,-21,41.87811,-87.63184
638,2,17,true,55,18,-37,41.87827,-87.64078
TA1305000005,2,17,true,25,3,-22,41.87924,-87.62975
13011,2,17,true,40,25,-15,41.87931,-87.63993
TA1309000008,2,17,true,13,4,-9,41.87933,-87.6355
KA1503000015,2,17,true,23,8,-15,41.87948,-87.6257
TA1309000007,2,17,true,53,2,-51,41.88022,-87.63526
WL-011,2,17,true,28,6,-22,41.88034,-87.64273
13156,2,17,true,21,15,-6,41.88042,-87.65554
13300,2,17,true,18,36,18,41.88097,-87.61675
13008,2,17,true,31,12,-19,41.88105,-87.62408
TA1305000006,2,17,true,56,16,-40,41.88122,-87.6296
13056,2,17,true,23,17,-6,41.88168,-87.63951
TA1307000120,2,17,true,30,36,6,41.88188,-87.64879
13341,2,17,true,32,25,-7,41.88208,-87.63985
13036,2,17,true,14,7,-7,41.8821,-87.62513
TA1305000032,2,17,true,47,48,1,41.88218,-87.64109
13006,2,17,true,20,1,-19,41.88268,-87.63252
13353,2,17,true,10,23,13,41.88283,-87.6612
654,2,17,true,5,4,-1,41.88307,-87.65698
13409,2,17,true,11,15,4,41.8831,-87.6511
KA1503000072,2,17,true,37,5,-32,41.88317,-87.63693
WL-012,2,17,true,53,33,-20,41.88337,-87.6412
13053,2,17,true,17,22,5,41.88365,-87.64863
13001,2,17,true,31,17,-14,41.88397,-87.62459
13155,2,17,true,12,7,-5,41.88407,-87.65689
18062,2,17,true,19,15,-4,41.88412,-87.65427
TA1306000010,2,17,true,55,21,-34,41.88419,-87.62961
TA1305000030,2,17,true,58,8,-50,41.88459,-87.63178
15535,2,17,true,21,25,4,41.8846,-87.64455
TA1305000029,2,17,true,19,13,-6,41.88466,-87.62787
13263,2,17,true,38,20,-18,41.88467,-87.61952
TA1306000015,2,17,true,33,30,-3,41.88549,-87.65232
13021,2,17,true,27,25,-2,41.88559,-87.64184
TA1307000111,2,17,true,42,14,-28,41.88582,-87.63548
13073,2,17,true,6,3,-3,41.88592,-87.66717
KA1503000012,2,17,true,39,15,-24,41.88599,-87.63089
TA1305000011,2,17,true,37,6,-31,41.886,-87.62418
15534,2,17,true,15,10,-5,41.88627,-87.61749
13197,2,17,true,10,6,-4,41.8866,-87.65816
TA1308000029,2,17,true,13,14,1,41.88673,-87.62225
TA1307000131,2,17,true,17,9,-8,41.88688,-87.62606
KA1503000064,2,17,true,15,25,10,41.88697,-87.61281
TA1305000022,2,17,true,66,29,-37,41.88817,-87.63656
TA1306000003,2,17,true,30,34,4,41.88867,-87.64442
KA1503000043,2,17,true,64,60,-4,41.88918,-87.63851
13050,2,17,true,34,17,-17,41.88919,-87.62775
15664,2,17,true,6,5,-1,41.8895,-87.68821
13432,2,17,true,7,6,-1,41.88989,-87.67149
TA1307000151,2,17,true,41,21,-20,41.88993,-87.63427
636,2,17,true,19,15,-4,41.88997,-87.63662
KA1503000044,2,17,true,25,8,-17,41.89018,-87.6262
13427,2,17,true,16,16,0,41.89054,-87.62205
13430,2,17,true,15,20,5,41.89077,-87.63169
TA1306000013,2,17,true,26,29,3,41.89083,-87.61852
RN-,2,17,true,21,16,-5,41.89102,-87.63546
13434,2,17,true,6,7,1,41.89108,-87.66663
TA1308000006,2,17,true,13,3,-10,41.89128,-87.67686
TA1307000117,2,17,true,46,30,-16,41.89144,-87.62675
13033,2,17,true,12,23,11,41.8916,-87.64835
13194,2,17,true,11,11,0,41.8918,-87.65878
TA1305000003,2,17,true,16,20,4,41.89187,-87.62061
643,2,17,true,2,6,4,41.89203,-87.68939
13022,2,17,true,40,31,-9,41.89227,-87.61205
TA1306000029,2,17,true,33,27,-6,41.89256,-87.61449
13265,2,17,true,45,40,-5,41.89383,-87.64172
13045,2,17,true,35,45,10,41.89403,-87.62931
13016,2,17,true,68,6,-62,41.89431,-87.62277
KA1503000041,2,17,true,26,8,-18,41.89452,-87.61798
13196,2,17,true,12,16,4,41.89455,-87.65345
TA1307000062,2,17,true,29,13,-16,41.89466,-87.63839
TA1306000012,2,17,true,44,37,-7,41.89475,-87.63438
KP1705001026,2,17,true,17,11,-6,41.89483,-87.6323
18058,2,17,true,3,5,2,41.8955,-87.68201
637,2,17,true,10,19,9,41.89563,-87.67209
13132,2,17,true,11,24,13,41.89573,-87.67718
15530,2,17,true,21,21,0,41.89575,-87.62596
18003,2,17,true,16,7,-9,41.89575,-87.62011
13247,2,17,true,9,20,11,41.89597,-87.66775
TA1305000020,2,17,true,5,13,8,41.89636,-87.65406
13289,2,17,true,15,20,5,41.89638,-87.661
13303,2,17,true,17,21,4,41.89672,-87.63088
13017,2,17,true,25,17,-8,41.89676,-87.6357
13338,2,17,true,16,19,3,41.89697,-87.62173
TA1307000061,2,17,true,15,16,1,41.89745,-87.62873
13034,2,17,true,11,9,-2,41.89754,-87.62352
TA1306000009,2,17,true,40,14,-26,41.89772,-87.64299
620,2,17,true,22,18,-4,41.89817,-87.63754
KA1504000103,2,17,true,7,9,2,41.89842,-87.68659
15529,2,17,true,25,12,-13,41.89858,-87.62206
TA1307000128,2,17,true,28,32,4,41.89896,-87.6299
657,2,17,true,8,6,-2,41.89918,-87.6722
13248,2,17,true,12,11,-1,41.89964,-87.66788
TA1306000011,2,17,true,14,18,4,41.89994,-87.63443
KA1504000116,2,17,true,11,17,6,41.90023,-87.64299
17660,2,17,true,5,8,3,41.90036,-87.69671
13290,2,17,true,13,14,1,41.90069,-87.66259
13042,2,17,true,45,21,-24,41.90097,-87.62377
TA1307000070,2,17,true,5,16,11,41.90133,-87.67742
KA1504000133,2,17,true,28,16,-12,41.90234,-87.62773
13241,2,17,true,6,4,-2,41.9029,-87.68731
TA1306000006,2,17,true,5,8,3,41.90292,-87.63772
TA1307000039,2,17,true,41,68,27,41.90294,-87.63137
658,2,17,true,14,2,-12,41.903,-87.6838
13256,2,17,true,7,5,-2,41.90302,-87.69749
TA1305000034,2,17,true,9,17,8,41.90313,-87.67391
KA1504000135,2,17,true,34,48,14,41.90319,-87.63439
13136,2,17,true,12,8,-4,41.90326,-87.67845
13061,2,17,true,34,27,-7,41.90342,-87.66779
KA1504000079,2,17,true,18,20,2,41.9035,-87.64334
TA1307000115,2,17,true,10,20,10,41.9046,-87.64056
TA1308000049,2,17,true,22,26,4,41.90672,-87.6349
KA1504000134,2,17,true,11,19,8,41.90687,-87.6262
13224,2,17,true,15,21,6,41.90706,-87.66725
TA1307000143,2,17,true,2,8,6,41.90762,-87.63854
13221,2,17,true,19,13,-6,41.90765,-87.67254
13245,2,17,true,8,4,-4,41.90777,-87.68586
TA1309000024,2,17,true,27,25,-2,41.908,-87.63152
TA1305000041,2,17,true,22,15,-7,41.9094,-87.67769
331,2,17,true,28,31,3,41.90965,-87.64812
TA1305000037,2,17,true,11,17,6,41.91018,-87.67003
TA1306000008,2,17,true,10,10,0,41.9102,-87.6435
TA1308000005,2,17,true,13,7,-6,41.91042,-87.68238
13258,2,17,true,5,8,3,41.91043,-87.69718
13257,2,17,true,2,7,5,41.91054,-87.68956
13154,2,17,true,17,19,2,41.91054,-87.65312
13058,2,17,true,17,21,4,41.91059,-87.64942
TA1307000038,2,17,true,10,25,15,41.91138,-87.63868
LF-005,2,17,true,50,70,20,41.91172,-87.62681
13128,2,17,true,6,16,10,41.91197,-87.63197
TA1308000050,2,17,true,37,43,6,41.91211,-87.6347
13243,2,17,true,11,13,2,41.91262,-87.6814
TA1306000032,2,17,true,12,14,2,41.9137,-87.65285
TA1307000166,2,17,true,21,15,-6,41.91386,-87.64877
15655,2,17,true,7,5,-2,41.91401,-87.70514
18067,2,17,true,11,13,2,41.9146,-87.66796
TA1306000007,2,17,true,8,8,0,41.91469,-87.64333
13068,2,17,true,11,9,-2,41.91554,-87.68703
13179,2,17,true,34,44,10,41.9157,-87.63461
13133,2,17,true,10,18,8,41.91598,-87.67733
TA1305000039,2,17,true,7,4,-3,41.9163,-87.66749
13266,2,17,true,2,5,3,41.91774,-87.69142
TA1309000029,2,17,true,6,5,-1,41.9178,-87.68245
TA1309000006,2,17,true,11,17,6,41.91809,-87.64375
TA1307000163,2,17,true,19,13,-6,41.91821,-87.65696
13146,2,17,true,18,28,10,41.91831,-87.63629
13059,2,17,true,32,26,-6,41.91845,-87.65222
13192,2,17,true,13,27,14,41.91995,-87.64884
13288,2,17,true,1,7,6,41.92008,-87.67788
13242,2,17,true,4,10,6,41.92021,-87.69266
TA1309000030,2,17,true,13,16,3,41.92077,-87.66372
13292,2,17,true,5,6,1,41.92152,-87.70733
TA1309000033,2,17,true,16,17,1,41.92158,-87.65381
13193,2,17,true,27,36,9,41.92182,-87.64412
13191,2,17,true,21,13,-8,41.92217,-87.63891
13084,2,17,true,12,13,1,41.92268,-87.69715
LP-,2,17,true,9,19,10,41.92396,-87.63584
KA1504000140,2,17,true,10,5,-5,41.92409,-87.67646
TA1307000001,2,17,true,15,15,0,41.92535,-87.66581
TA1306000026,2,17,true,14,11,-3,41.92558,-87.65842
TA1306000016,2,17,true,20,16,-4,41.9256,-87.65371
TA1309000019,2,17,true,21,34,13,41.92586,-87.63897
TA1309000058,2,17,true,33,35,2,41.92591,-87.64927
TA1308000001,2,17,true,35,28,-7,41.92627,-87.63086
15646,2,17,true,3,5,2,41.92668,-87.6977
13124,2,17,true,7,7,0,41.92675,-87.63444
TA1309000023,2,17,true,16,27,11,41.9287,-87.65383
TA1307000113,2,17,true,8,15,7,41.92878,-87.66391
13296,2,17,true,6,1,-5,41.92883,-87.66852
TA1309000059,2,17,true,9,10,1,41.92889,-87.65898
TA1309000061,2,17,true,15,27,12,41.92915,-87.64909
TA1308000031,2,17,true,3,10,7,41.92946,-87.68417
TA1305000014,2,17,true,24,13,-11,41.92956,-87.64313
13085,2,17,true,4,5,1,41.92958,-87.70789
TA1307000142,2,17,true,27,25,-2,41.93125,-87.64432
13276,2,17,true,18,27,9,41.93132,-87.63874
13271,2,17,true,1,9,8,41.93192,-87.67784
TA1307000064,2,17,true,27,23,-4,41.93222,-87.65864
TA1306000014,2,17,true,22,21,-1,41.93242,-87.65271
TA1309000039,2,17,true,24,30,6,41.93258,-87.63642
13294,2,17,true,8,9,1,41.9326,-87.66595
TA1309000036,2,17,true,18,29,11,41.93313,-87.64776
TA1307000006,2,17,true,14,19,5,41.93571,-87.6636
13268,2,17,true,3,8,5,41.93588,-87.67843
13269,2,17,true,4,7,3,41.93609,-87.66983
TA1307000052,2,17,true,18,19,1,41.93628,-87.65266
TA1307000136,2,17,true,14,19,5,41.9365,-87.64755
TA1307000041,2,17,true,28,37,9,41.93669,-87.63683
13137,2,17,true,27,46,19,41.9376,-87.6441
KA17018068,2,17,true,4,11,7,41.93935,-87.68327
TA1309000042,2,17,true,16,11,-5,41.93937,-87.66836
KA150400009X,2,17,true,5,4,-1,41.9394,-87.71159
13229,2,17,true,14,14,0,41.93946,-87.66376
TA1308000019,2,17,true,12,17,5,41.93973,-87.65886
13277,2,17,true,15,20,5,41.9401,-87.64546
TA1307000134,2,17,true,19,37,18,41.94016,-87.65303
TA1309000049,2,17,true,24,30,6,41.94077,-87.63919
TA1307000138,2,17,true,20,20,0,41.94334,-87.67094
13144,2,17,true,2,7,5,41.9434,-87.67964
TA1309000025,2,17,true,22,23,1,41.94368,-87.64894
13071,2,17,true,25,22,-3,41.94373,-87.66401
632,2,17,true,8,10,2,41.94453,-87.6547
13278,2,17,true,27,19,-8,41.94553,-87.64644
TA1309000050,2,17,true,6,1,-5,41.94618,-87.67331
KA1504000143,2,17,true,11,5,-6,41.94664,-87.68337
13235,2,17,true,22,27,5,41.94814,-87.66396
13253,2,17,true,10,3,-7,41.9488,-87.67527
13325,2,17,true,18,29,11,41.94907,-87.64863
TA1307000126,2,17,true,11,39,28,41.94936,-87.65451
TA1307000150,2,17,true,23,33,10,41.94945,-87.64646
13319,2,17,true,4,5,1,41.95069,-87.6687
TA1307000127,2,17,true,9,23,14,41.9508,-87.65918
13323,2,17,true,12,13,1,41.95282,-87.65
TA1309000043,2,17,true,11,7,-4,41.95417,-87.66434
13063,2,17,true,18,15,-3,41.95424,-87.65441
TA1308000022,2,17,true,13,10,-3,41.95438,-87.64805
TA1307000149,2,17,true,13,8,-5,41.95467,-87.67392
TA1309000026,2,17,true,7,4,-3,41.95601,-87.6802
TA1308000047,2,17,true,2,5,3,41.95709,-87.6642
13379,2,17,true,16,17,1,41.95786,-87.6495
TA1309000027,2,17,true,3,8,5,41.9585,-87.65499
13389,2,17,true,13,6,-7,41.961,-87.64958
15622,2,17,true,3,5,2,41.96108,-87.69544
TA1307000144,2,17,true,7,7,0,41.96142,-87.6762
TA1309000021,2,17,true,3,9,6,41.9615,-87.6714
15623,2,17,true,4,9,5,41.96154,-87.69117
TA1307000107,2,17,true,19,12,-7,41.96164,-87.65464
TA1307000156,2,17,true,4,7,3,41.96301,-87.68479
TA1309000012,2,17,true,8,4,-4,41.96325,-87.67928
TA1308000012,2,17,true,13,17,4,41.96398,-87.63818
13074,2,17,true,16,12,-4,41.96521,-87.6582
639,2,17,true,9,12,3,41.96584,-87.64538
KA1504000093,2,17,true,6,7,1,41.96587,-87.69365
TA1307000140,2,17,true,7,6,-1,41.96643,-87.68865
TA1309000014,2,17,true,6,10,4,41.96709,-87.66744
TA1307000158,2,17,true,7,6,-1,41.9671,-87.67904
TA1307000119,2,17,true,5,4,-1,41.96796,-87.65
TA1308000021,2,17,true,5,12,7,41.96883,-87.65765
KA1504000080,2,17,true,1,7,6,41.96887,-87.69609
TA1309000066,2,17,true,26,22,-4,41.9691,-87.67423
TA1309000041,2,17,true,8,7,-1,41.96951,-87.65471
KA1504000171,2,17,true,11,8,-3,41.97161,-87.65016
TA1309000035,2,17,true,21,18,-3,41.97335,-87.66785
13108,2,17,true,15,6,-9,41.97379,-87.65971
KA1504000078,2,17,true,1,5,4,41.97491,-87.69258
KA1504000149,2,17,true,7,6,-1,41.97562,-87.67945
KA1504000146,2,17,true,7,5,-2,41.978,-87.66805
13109,2,17,true,11,10,-1,41.97835,-87.65976
KA1504000147,2,17,true,4,5,1,41.97976,-87.67754
655,2,17,true,2,6,4,41.97987,-87.68194
KA1504000151,2,17,true,12,13,1,41.98359,-87.66916
KA1504000152,2,17,true,20,22,2,41.98403,-87.65231
15578,2,17,true,7,6,-1,41.98405,-87.66027
15575,2,17,true,4,8,4,41.98975,-87.66014
KA1504000148,2,17,true,1,7,6,41.99086,-87.66971
15571,2,17,true,7,4,-3,41.99478,-87.66028
KA1504000159,2,17,true,6,7,1,42.01059,-87.66241
520,2,17,true,2,5,3,42.01597,-87.66859
515,2,17,true,5,1,-4,42.01915,-87.67356
523,2,17,true,3,6,3,42.02089,-87.66505
596,2,17,true,10,7,-3,42.04822,-87.68348
604,2,17,true,10,4,-6,42.05824,-87.67744
20236,2,18,false,5,5,0,41.7314,-87.58577
KA1503000002,2,18,false,5,4,-1,41.76641,-87.5657
KA1503000029,2,18,false,5,2,-3,41.77364,-87.56747
15491,2,18,false,3,5,2,41.78096,-87.57624
KA1503000014,2,18,false,6,4,-2,41.7851,-87.60108
KA1503000071,2,18,false,6,2,-4,41.79148,-87.59988
TA1308000009,2,18,false,16,19,3,41.79522,-87.58075
KA1503000052,2,18,false,4,6,2,41.79935,-87.60097
KA1503000059,2,18,false,4,7,3,41.79952,-87.58643
TA1309000037,2,18,false,6,8,2,41.79957,-87.59474
KA1503000007,2,18,false,6,3,-3,41.80242,-87.58689
13398,2,18,false,1,6,5,41.80256,-87.59035
TA1308000035,2,18,false,5,2,-3,41.80944,-87.59188
KA1503000004,2,18,false,5,11,6,41.83127,-87.6088
TA1307000048,2,18,false,19,9,-10,41.83855,-87.60821
TA1307000139,2,18,false,5,2,-3,41.84205,-87.61698
13075,2,18,false,8,8,0,41.8531,-87.63192
15545,2,18,false,7,13,6,41.85627,-87.61334
SL-013,2,18,false,5,3,-2,41.85659,-87.62755
SL-006,2,18,false,2,11,9,41.8568,-87.63387
13102,2,18,false,6,6,0,41.85762,-87.61942
13150,2,18,false,7,7,0,41.85783,-87.62455
13164,2,18,false,5,2,-3,41.85818,-87.65648
SL-012,2,18,false,7,8,1,41.86038,-87.62581
TA1307000124,2,18,false,7,10,3,41.86411,-87.62372
13431,2,18,false,15,12,-3,41.8661,-87.60728
WL-008,2,18,false,6,7,1,41.86712,-87.64108
TA1305000002,2,18,false,15,14,-1,41.86721,-87.62597
15544,2,18,false,8,19,11,41.86723,-87.61536
KA1706005007,2,18,false,9,12,3,41.86749,-87.63219
SL-005,2,18,false,34,26,-8,41.8679,-87.62304
TA1309000010,2,18,false,11,8,-3,41.87074,-87.62574
SL-009,2,18,false,2,5,3,41.87081,-87.63121
SL-008,2,18,false,15,14,-1,41.87209,-87.62956
SL-011,2,18,false,6,3,-3,41.87256,-87.63356
623,2,18,false,34,32,-2,41.87272,-87.62399
SL-007,2,18,false,8,8,0,41.87404,-87.6277
13028,2,18,false,10,4,-6,41.87475,-87.64981
SL-010,2,18,false,14,2,-12,41.87501,-87.63309
16907,2,18,false,6,2,-4,41.87568,-87.71549
15541,2,18,false,31,31,0,41.8758,-87.62086
624,2,18,false,8,3,-5,41.87626,-87.62923
TA1305000035,2,18,false,3,5,2,41.87716,-87.62787
15539,2,18,false,4,10,6,41.87763,-87.64405
13158,2,18,false,11,3,-8,41.87764,-87.64957
TA1305000025,2,18,false,15,1,-14,41.87773,-87.63528
TA1309000002,2,18,false,9,7,-2,41.87784,-87.62408
13206,2,18,false,3,6,3,41.87794,-87.66201
638,2,18,false,10,1,-9,41.87827,-87.64078
TA1305000005,2,18,false,7,6,-1,41.87924,-87.62975
13011,2,18,false,10,3,-7,41.87931,-87.63993
KA1503000015,2,18,false,5,6,1,41.87948,-87.6257
TA1309000007,2,18,false,6,2,-4,41.88022,-87.63526
13156,2,18,false,5,13,8,41.88042,-87.65554
13300,2,18,false,50,49,-1,41.88097,-87.61675
13008,2,18,false,52,48,-4,41.88105,-87.62408
TA1305000006,2,18,false,6,6,0,41.88122,-87.6296
TA1307000120,2,18,false,10,17,7,41.88188,-87.64879
13341,2,18,false,10,9,-1,41.88208,-87.63985
13036,2,18,false,10,7,-3,41.8821,-87.62513
TA1305000032,2,18,false,12,8,-4,41.88218,-87.64109
654,2,18,false,4,7,3,41.88307,-87.65698
13409,2,18,false,5,4,-1,41.8831,-87.6511
WL-012,2,18,false,8,8,0,41.88337,-87.6412
13053,2,18,false,9,6,-3,41.88365,-87.64863
13001,2,18,false,27,12,-15,41.88397,-87.62459
18062,2,18,false,6,6,0,41.88412,-87.65427
TA1306000010,2,18,false,13,5,-8,41.88419,-87.62961
TA1305000030,2,18,false,9,7,-2,41.88459,-87.63178
15535,2,18,false,10,13,3,41.8846,-87.64455
TA1305000029,2,18,false,20,14,-6,41.88466,-87.62787
13263,2,18,false,29,13,-16,41.88467,-87.61952
TA1306000015,2,18,false,13,19,6,41.88549,-87.65232
13021,2,18,false,3,7,4,41.88559,-87.64184
TA1307000111,2,18,false,8,3,-5,41.88582,-87.63548
KA1503000012,2,18,false,12,20,8,41.88599,-87.63089
TA1305000011,2,18,false,12,18,6,41.886,-87.62418
15534,2,18,false,7,5,-2,41.88627,-87.61749
TA1308000029,2,18,false,9,3,-6,41.88673,-87.62225
TA1307000131,2,18,false,13,12,-1,41.88688,-87.62606
KA1503000064,2,18,false,17,32,15,41.88697,-87.61281
TA1305000022,2,18,false,11,5,-6,41.88817,-87.63656
TA1306000003,2,18,false,13,7,-6,41.88867,-87.64442
KA1503000043,2,18,false,28,17,-11,41.88918,-87.63851
13050,2,18,false,14,13,-1,41.88919,-87.62775
13432,2,18,false,5,2,-3,41.88989,-87.67149
TA1307000151,2,18,false,27,10,-17,41.88993,-87.63427
13427,2,18,false,9,6,-3,41.89054,-87.62205
13430,2,18,false,22,23,1,41.89077,-87.63169
TA1306000013,2,18,false,22,28,6,41.89083,-87.61852
RN-,2,18,false,9,10,1,41.89102,-87.63546
13434,2,18,false,6,4,-2,41.89108,-87.66663
TA1307000117,2,18,false,26,25,-1,41.89144,-87.62675
13033,2,18,false,14,10,-4,41.8916,-87.64835
13194,2,18,false,3,15,12,41.8918,-87.65878
TA1305000003,2,18,false,18,18,0,41.89187,-87.62061
13022,2,18,false,86,105,19,41.89227,-87.61205
TA1306000029,2,18,false,13,11,-2,41.89256,-87.61449
13265,2,18,false,7,12,5,41.89383,-87.64172
13045,2,18,false,20,8,-12,41.89403,-87.62931
13016,2,18,false,6,11,5,41.89431,-87.62277
KA1503000041,2,18,false,8,5,-3,41.89452,-87.61798
13196,2,18,false,10,9,-1,41.89455,-87.65345
TA1306000012,2,18,false,25,12,-13,41.89475,-87.63438
KP1705001026,2,18,false,18,11,-7,41.89483,-87.6323
18058,2,18,false,7,2,-5,41.8955,-87.68201
13132,2,18,false,5,5,0,41.89573,-87.67718
15530,2,18,false,13,10,-3,41.89575,-87.62596
TA1305000020,2,18,false,12,5,-7,41.89636,-87.65406
13289,2,18,false,10,5,-5,41.89638,-87.661
13303,2,18,false,18,12,-6,41.89672,-87.63088
13017,2,18,false,8,7,-1,41.89676,-87.6357
13338,2,18,false,9,15,6,41.89697,-87.62173
TA1307000061,2,18,false,8,4,-4,41.89745,-87.62873
13034,2,18,false,15,9,-6,41.89754,-87.62352
TA1306000009,2,18,false,8,4,-4,41.89772,-87.64299
620,2,18,false,9,9,0,41.89817,-87.63754
KA1504000103,2,18,false,6,4,-2,41.89842,-87.68659
15529,2,18,false,7,11,4,41.89858,-87.62206
TA1307000128,2,18,false,18,13,-5,41.89896,-87.6299
13248,2,18,false,6,2,-4,41.89964,-87.66788
TA1306000011,2,18,false,9,8,-1,41.89994,-87.63443
KA1504000116,2,18,false,7,3,-4,41.90023,-87.64299
17660,2,18,false,3,8,5,41.90036,-87.69671
13290,2,18,false,6,2,-4,41.90069,-87.66259
13042,2,18,false,42,49,7,41.90097,-87.62377
TA1307000070,2,18,false,7,6,-1,41.90133,-87.67742
KA1504000133,2,18,false,7,8,1,41.90234,-87.62773
TA1306000006,2,18,false,3,6,3,41.90292,-87.63772
TA1307000039,2,18,false,37,35,-2,41.90294,-87.63137
TA1305000034,2,18,false,7,12,5,41.90313,-87.67391
KA1504000135,2,18,false,25,41,16,41.90319,-87.63439
13136,2,18,false,6,2,-4,41.90326,-87.67845
13061,2,18,false,21,20,-1,41.90342,-87.66779
KA1504000079,2,18,false,23,13,-10,41.9035,-87.64334
TA1307000115,2,18,false,5,2,-3,41.9046,-87.64056
TA1308000049,2,18,false,23,39,16,41.90672,-87.6349
KA1504000134,2,18,false,8,17,9,41.90687,-87.6262
13224,2,18,false,6,4,-2,41.90706,-87.66725
TA1307000143,2,18,false,9,5,-4,41.90762,-87.63854
13221,2,18,false,20,11,-9,41.90765,-87.67254
TA1309000024,2,18,false,21,39,18,41.908,-87.63152
TA1305000041,2,18,false,11,18,7,41.9094,-87.67769
331,2,18,false,17,13,-4,41.90965,-87.64812
TA1305000037,2,18,false,10,9,-1,41.91018,-87.67003
TA1306000008,2,18,false,8,6,-2,41.9102,-87.6435
13257,2,18,false,3,9,6,41.91054,-87.68956
13154,2,18,false,7,6,-1,41.91054,-87.65312
13058,2,18,false,18,12,-6,41.91059,-87.64942
TA1307000038,2,18,false,21,18,-3,41.91138,-87.63868
LF-005,2,18,false,44,223,179,41.91172,-87.62681
13128,2,18,false,8,24,16,41.91197,-87.63197
TA1308000050,2,18,false,28,32,4,41.91211,-87.6347
13243,2,18,false,17,11,-6,41.91262,-87.6814
TA1306000032,2,18,false,15,7,-8,41.9137,-87.65285
TA1307000166,2,18,false,11,4,-7,41.91386,-87.64877
18067,2,18,false,5,1,-4,41.9146,-87.66796
TA1306000007,2,18,false,5,6,1,41.91469,-87.64333
13068,2,18,false,10,5,-5,41.91554,-87.68703
13179,2,18,false,23,34,11,41.9157,-87.63461
13133,2,18,false,5,13,8,41.91598,-87.67733
TA1305000039,2,18,false,7,6,-1,41.9163,-87.66749
15651,2,18,false,8,2,-6,41.91752,-87.70181
13266,2,18,false,4,9,5,41.91774,-87.69142
TA1309000029,2,18,false,6,5,-1,41.9178,-87.68245
TA1309000006,2,18,false,5,8,3,41.91809,-87.64375
TA1307000163,2,18,false,14,5,-9,41.91821,-87.65696
13146,2,18,false,9,44,35,41.91831,-87.63629
13059,2,18,false,19,11,-8,41.91845,-87.65222
13259,2,18,false,2,5,3,41.91852,-87.69744
13192,2,18,false,14,10,-4,41.91995,-87.64884
13288,2,18,false,4,6,2,41.92008,-87.67788
13242,2,18,false,2,7,5,41.92021,-87.69266
TA1309000030,2,18,false,8,6,-2,41.92077,-87.66372
TA1309000033,2,18,false,18,13,-5,41.92158,-87.65381
13193,2,18,false,30,26,-4,41.92182,-87.64412
13191,2,18,false,5,9,4,41.92217,-87.63891
13084,2,18,false,5,4,-1,41.92268,-87.69715
LP-,2,18,false,14,13,-1,41.92396,-87.63584
TA1307000001,2,18,false,12,7,-5,41.92535,-87.66581
TA1306000026,2,18,false,14,8,-6,41.92558,-87.65842
TA1306000016,2,18,false,16,14,-2,41.9256,-87.65371
TA1309000019,2,18,false,35,34,-1,41.92586,-87.63897
TA1309000058,2,18,false,18,23,5,41.92591,-87.64927
TA1308000001,2,18,false,28,32,4,41.92627,-87.63086
15646,2,18,false,8,5,-3,41.92668,-87.6977
13124,2,18,false,15,17,2,41.92675,-87.63444
TA1309000023,2,18,false,23,11,-12,41.9287,-87.65383
TA1307000113,2,18,false,12,12,0,41.92878,-87.66391
13296,2,18,false,10,11,1,41.92883,-87.66852
TA1309000061,2,18,false,19,12,-7,41.92915,-87.64909
TA1308000031,2,18,false,2,5,3,41.92946,-87.68417
TA1305000014,2,18,false,7,13,6,41.92956,-87.64313
13085,2,18,false,2,5,3,41.92958,-87.70789
TA1307000142,2,18,false,24,18,-6,41.93125,-87.64432
13276,2,18,false,22,21,-1,41.93132,-87.63874
13271,2,18,false,6,5,-1,41.93192,-87.67784
TA1307000064,2,18,false,5,6,1,41.93222,-87.65864
TA1306000014,2,18,false,29,9,-20,41.93242,-87.65271
TA1309000039,2,18,false,33,15,-18,41.93258,-87.63642
13294,2,18,false,8,1,-7,41.9326,-87.66595
TA1309000036,2,18,false,15,9,-6,41.93313,-87.64776
TA1307000006,2,18,false,13,9,-4,41.93571,-87.6636
13268,2,18,false,9,6,-3,41.93588,-87.67843
TA1307000052,2,18,false,18,13,-5,41.93628,-87.65266
TA1307000136,2,18,false,32,13,-19,41.9365,-87.64755
TA1307000041,2,18,false,22,17,-5,41.93669,-87.63683
13137,2,18,false,34,31,-3,41.9376,-87.6441
15642,2,18,false,5,3,-2,41.93843,-87.69801
KA17018068,2,18,false,3,6,3,41.93935,-87.68327
TA1309000042,2,18,false,6,1,-5,41.93937,-87.66836
13229,2,18,false,7,15,8,41.93946,-87.66376
TA1308000019,2,18,false,7,22,15,41.93973,-87.65886
13277,2,18,false,16,9,-7,41.9401,-87.64546
TA1307000134,2,18,false,22,17,-5,41.94016,-87.65303
13143,2,18,false,7,4,-3,41.94059,-87.67853
TA1309000049,2,18,false,24,28,4,41.94077,-87.63919
TA1307000138,2,18,false,12,7,-5,41.94334,-87.67094
13144,2,18,false,4,5,1,41.9434,-87.67964
TA1309000025,2,18,false,10,13,3,41.94368,-87.64894
13071,2,18,false,15,19,4,41.94373,-87.66401
632,2,18,false,15,20,5,41.94453,-87.6547
13278,2,18,false,21,20,-1,41.94553,-87.64644
13235,2,18,false,18,29,11,41.94814,-87.66396
13325,2,18,false,12,11,-1,41.94907,-87.64863
TA1307000126,2,18,false,8,63,55,41.94936,-87.65451
TA1307000150,2,18,false,21,19,-2,41.94945,-87.64646
13319,2,18,false,6,5,-1,41.95069,-87.6687
TA1307000127,2,18,false,11,13,2,41.9508,-87.65918
13323,2,18,false,12,10,-2,41.95282,-87.65
TA1309000043,2,18,false,1,7,6,41.95417,-87.66434
13063,2,18,false,9,21,12,41.95424,-87.65441
TA1308000022,2,18,false,15,9,-6,41.95438,-87.64805
TA1309000026,2,18,false,5,4,-1,41.95601,-87.6802
13379,2,18,false,8,9,1,41.95786,-87.6495
TA1309000027,2,18,false,6,1,-5,41.9585,-87.65499
13389,2,18,false,11,11,0,41.961,-87.64958
15622,2,18,false,6,5,-1,41.96108,-87.69544
TA1307000107,2,18,false,10,9,-1,41.96164,-87.65464
TA1308000012,2,18,false,8,25,17,41.96398,-87.63818
13074,2,18,false,5,5,0,41.96521,-87.6582
639,2,18,false,9,7,-2,41.96584,-87.64538
TA1309000014,2,18,false,8,4,-4,41.96709,-87.66744
TA1307000119,2,18,false,4,8,4,41.96796,-87.65
TA1309000066,2,18,false,15,4,-11,41.9691,-87.67423
KA1504000171,2,18,false,6,13,7,41.97161,-87.65016
TA1309000035,2,18,false,8,9,1,41.97335,-87.66785
13108,2,18,false,4,7,3,41.97379,-87.65971
KA1504000149,2,18,false,5,2,-3,41.97562,-87.67945
KA1504000146,2,18,false,7,8,1,41.978,-87.66805
13109,2,18,false,6,4,-2,41.97835,-87.65976
KA1504000151,2,18,false,4,5,1,41.98359,-87.66916
KA1504000152,2,18,false,13,16,3,41.98403,-87.65231
15578,2,18,false,6,7,1,41.98405,-87.66027
15575,2,18,false,6,5,-1,41.98975,-87.66014
15571,2,18,false,3,6,3,41.99478,-87.66028
RP-009,2,18,false,8,3,-5,42.00107,-87.66122
E002,2,18,false,7,2,-5,42.03256,-87.67912
E008,2,18,false,5,5,0,42.05049,-87.67782
E007,2,18,false,1,6,5,42.06431,-87.68615
KA1503000014,2,18,true,8,8,0,41.7851,-87.60108
KA1503000071,2,18,true,8,1,-7,41.79148,-87.59988
KA1504000076,2,18,true,5,4,-1,41.7943,-87.60145
TA1308000009,2,18,true,11,16,5,41.79522,-87.58075
TA1307000164,2,18,true,10,1,-9,41.79527,-87.59647
KA1503000052,2,18,true,3,5,2,41.79935,-87.60097
TA1309000037,2,18,true,12,11,-1,41.79957,-87.59474
KA1503000007,2,18,true,3,8,5,41.80242,-87.58689
13398,2,18,true,6,2,-4,41.80256,-87.59035
TA1309000067,2,18,true,1,6,5,41.80303,-87.60661
TA1308000045,2,18,true,5,10,5,41.83062,-87.64129
KA1503000005,2,18,true,1,9,8,41.83079,-87.6325
KA1503000004,2,18,true,2,5,3,41.83127,-87.6088
13216,2,18,true,18,3,-15,41.83473,-87.62581
13217,2,18,true,9,5,-4,41.83488,-87.61792
13215,2,18,true,1,5,4,41.83634,-87.6135
TA1309000055,2,18,true,6,11,5,41.8382,-87.64514
TA1307000048,2,18,true,11,15,4,41.83855,-87.60821
TA1308000036,2,18,true,4,5,1,41.83883,-87.62186
TA1307000139,2,18,true,4,7,3,41.84205,-87.61698
TA1305000001,2,18,true,5,4,-1,41.85262,-87.6265
13075,2,18,true,6,10,4,41.8531,-87.63192
13096,2,18,true,5,3,-2,41.8538,-87.69577
15546,2,18,true,6,8,2,41.85416,-87.61916
15545,2,18,true,36,25,-11,41.85627,-87.61334
13135,2,18,true,5,8,3,41.85753,-87.66157
13102,2,18,true,9,7,-2,41.85762,-87.61942
13150,2,18,true,10,13,3,41.85783,-87.62455
13099,2,18,true,2,12,10,41.85784,-87.64627
TA1307000159,2,18,true,1,6,5,41.8579,-87.6687
13164,2,18,true,5,11,6,41.85818,-87.65648
SL-012,2,18,true,13,11,-2,41.86038,-87.62581
13304,2,18,true,2,6,4,41.86126,-87.65659
TA1306000002,2,18,true,11,4,-7,41.86238,-87.65108
TA1307000124,2,18,true,16,17,1,41.86411,-87.62372
TA1309000001,2,18,true,7,12,5,41.86488,-87.64708
13431,2,18,true,5,12,7,41.8661,-87.60728
WL-008,2,18,true,16,10,-6,41.86712,-87.64108
TA1305000002,2,18,true,30,26,-4,41.86721,-87.62597
15544,2,18,true,13,11,-2,41.86723,-87.61536
KA1706005007,2,18,true,5,14,9,41.86749,-87.63219
SL-005,2,18,true,10,19,9,41.8679,-87.62304
644,2,18,true,7,4,-3,41.86859,-87.68625
13139,2,18,true,10,4,-6,41.86893,-87.65913
13285,2,18,true,6,3,-3,41.86928,-87.67372
13160,2,18,true,22,13,-9,41.86947,-87.65548
15550,2,18,true,11,8,-3,41.87024,-87.63947
TA1309000010,2,18,true,10,17,7,41.87074,-87.62574
SL-009,2,18,true,8,3,-5,41.87081,-87.63121
TA1309000064,2,18,true,15,9,-6,41.87127,-87.67369
TA1307000130,2,18,true,10,17,7,41.87178,-87.65103
TA1307000121,2,18,true,18,16,-2,41.87184,-87.64664
SL-008,2,18,true,20,26,6,41.87209,-87.62956
13332,2,18,true,19,24,5,41.87219,-87.6615
SL-011,2,18,true,12,9,-3,41.87256,-87.63356
623,2,18,true,5,6,1,41.87272,-87.62399
KA1504000104,2,18,true,5,8,3,41.87296,-87.66912
SL-007,2,18,true,8,5,-3,41.87404,-87.6277
TA1306000025,2,18,true,11,7,-4,41.87464,-87.65703
13028,2,18,true,8,7,-1,41.87475,-87.64981
13081,2,18,true,7,2,-5,41.87501,-87.67326
SL-010,2,18,true,6,8,2,41.87501,-87.63309
15541,2,18,true,6,10,4,41.8758,-87.62086
TA1305000009,2,18,true,5,3,-2,41.87593,-87.63068
624,2,18,true,5,3,-2,41.87626,-87.62923
TA1305000035,2,18,true,6,2,-4,41.87716,-87.62787
13138,2,18,true,15,1,-14,41.87723,-87.63941
15539,2,18,true,11,15,4,41.87763,-87.64405
13158,2,18,true,19,22,3,41.87764,-87.64957
13157,2,18,true,16,11,-5,41.87773,-87.6548
TA1305000025,2,18,true,13,10,-3,41.87773,-87.63528
13206,2,18,true,10,7,-3,41.87794,-87.66201
638,2,18,true,21,8,-13,41.87827,-87.64078
13011,2,18,true,23,13,-10,41.87931,-87.63993
TA1309000008,2,18,true,7,2,-5,41.87933,-87.6355
KA1503000015,2,18,true,18,1,-17,41.87948,-87.6257
TA1309000007,2,18,true,14,6,-8,41.88022,-87.63526
WL-011,2,18,true,8,9,1,41.88034,-87.64273
13156,2,18,true,10,16,6,41.88042,-87.65554
13300,2,18,true,24,32,8,41.88097,-87.61675
13008,2,18,true,11,12,1,41.88105,-87.62408
TA1305000006,2,18,true,22,8,-14,41.88122,-87.6296
13134,2,18,true,1,5,4,41.88138,-87.67493
13056,2,18,true,28,7,-21,41.88168,-87.63951
TA1307000120,2,18,true,31,21,-10,41.88188,-87.64879
13341,2,18,true,21,11,-10,41.88208,-87.63985
13036,2,18,true,14,9,-5,41.8821,-87.62513
TA1305000032,2,18,true,43,13,-30,41.88218,-87.64109
13353,2,18,true,9,7,-2,41.88283,-87.6612
654,2,18,true,5,4,-1,41.88307,-87.65698
13409,2,18,true,20,8,-12,41.8831,-87.6511
WL-012,2,18,true,41,7,-34,41.88337,-87.6412
13053,2,18,true,19,16,-3,41.88365,-87.64863
13001,2,18,true,24,10,-14,41.88397,-87.62459
13155,2,18,true,3,11,8,41.88407,-87.65689
18062,2,18,true,14,14,0,41.88412,-87.65427
TA1306000010,2,18,true,35,20,-15,41.88419,-87.62961
TA1305000030,2,18,true,27,4,-23,41.88459,-87.63178
15535,2,18,true,25,12,-13,41.8846,-87.64455
TA1305000029,2,18,true,19,17,-2,41.88466,-87.62787
13263,2,18,true,22,22,0,41.88467,-87.61952
TA1306000015,2,18,true,19,18,-1,41.88549,-87.65232
13021,2,18,true,19,10,-9,41.88559,-87.64184
TA1307000111,2,18,true,12,13,1,41.88582,-87.63548
13073,2,18,true,6,4,-2,41.88592,-87.66717
KA1503000012,2,18,true,27,12,-15,41.88599,-87.63089
TA1305000011,2,18,true,24,9,-15,41.886,-87.62418
15534,2,18,true,12,12,0,41.88627,-87.61749
13197,2,18,true,12,8,-4,41.8866,-87.65816
TA1308000029,2,18,true,9,7,-2,41.88673,-87.62225
TA1307000131,2,18,true,16,8,-8,41.88688,-87.62606
KA1503000064,2,18,true,9,11,2,41.88697,-87.61281
TA1305000022,2,18,true,22,13,-9,41.88817,-87.63656
TA1306000003,2,18,true,28,38,10,41.88867,-87.64442
KA1503000043,2,18,true,50,37,-13,41.88918,-87.63851
13050,2,18,true,24,17,-7,41.88919,-87.62775
13432,2,18,true,6,4,-2,41.88989,-87.67149
TA1307000151,2,18,true,31,12,-19,41.88993,-87.63427
636,2,18,true,12,11,-1,41.88997,-87.63662
KA1503000044,2,18,true,9,6,-3,41.89018,-87.6262
13427,2,18,true,14,10,-4,41.89054,-87.62205
13430,2,18,true,38,25,-13,41.89077,-87.63169
TA1306000013,2,18,true,20,32,12,41.89083,-87.61852
RN-,2,18,true,22,16,-6,41.89102,-87.63546
13434,2,18,true,2,6,4,41.89108,-87.66663
TA1308000006,2,18,true,7,4,-3,41.89128,-87.67686
TA1307000117,2,18,true,31,23,-8,41.89144,-87.62675
13033,2,18,true,17,27,10,41.8916,-87.64835
13194,2,18,true,9,15,6,41.8918,-87.65878
TA1305000003,2,18,true,23,27,4,41.89187,-87.62061
13022,2,18,true,30,28,-2,41.89227,-87.61205
TA1306000029,2,18,true,25,19,-6,41.89256,-87.61449
13265,2,18,true,23,23,0,41.89383,-87.64172
13045,2,18,true,45,41,-4,41.89403,-87.62931
13016,2,18,true,34,14,-20,41.89431,-87.62277
KA1503000041,2,18,true,16,14,-2,41.89452,-87.61798
13196,2,18,true,7,10,3,41.89455,-87.65345
TA1307000062,2,18,true,23,11,-12,41.89466,-87.63839
TA1306000012,2,18,true,22,39,17,41.89475,-87.63438
KP1705001026,2,18,true,21,19,-2,41.89483,-87.6323
18058,2,18,true,7,12,5,41.8955,-87.68201
637,2,18,true,8,12,4,41.89563,-87.67209
13132,2,18,true,8,11,3,41.89573,-87.67718
15530,2,18,true,17,16,-1,41.89575,-87.62596
18003,2,18,true,7,5,-2,41.89575,-87.62011
13247,2,18,true,12,12,0,41.89597,-87.66775
TA1305000020,2,18,true,8,10,2,41.89636,-87.65406
13289,2,18,true,9,17,8,41.89638,-87.661
13303,2,18,true,12,17,5,41.89672,-87.63088
13017,2,18,true,16,19,3,41.89676,-87.6357
13338,2,18,true,16,19,3,41.89697,-87.62173
TA1307000061,2,18,true,8,9,1,41.89745,-87.62873
13034,2,18,true,19,9,-10,41.89754,-87.62352
TA1306000009,2,18,true,27,16,-11,41.89772,-87.64299
620,2,18,true,19,17,-2,41.89817,-87.63754
KA1504000103,2,18,true,8,10,2,41.89842,-87.68659
15529,2,18,true,15,19,4,41.89858,-87.62206
TA1307000128,2,18,true,36,33,-3,41.89896,-87.6299
657,2,18,true,6,6,0,41.89918,-87.6722
13248,2,18,true,7,18,11,41.89964,-87.66788
TA1306000011,2,18,true,5,16,11,41.89994,-87.63443
KA1504000116,2,18,true,16,8,-8,41.90023,-87.64299
17660,2,18,true,8,16,8,41.90036,-87.69671
13290,2,18,true,11,12,1,41.90069,-87.66259
13042,2,18,true,38,36,-2,41.90097,-87.62377
TA1307000070,2,18,true,6,12,6,41.90133,-87.67742
KA1504000133,2,18,true,18,16,-2,41.90234,-87.62773
TA1306000006,2,18,true,5,19,14,41.90292,-87.63772
TA1307000039,2,18,true,43,46,3,41.90294,-87.63137
658,2,18,true,2,5,3,41.903,-87.6838
13256,2,18,true,6,3,-3,41.90302,-87.69749
TA1305000034,2,18,true,14,19,5,41.90313,-87.67391
KA1504000135,2,18,true,33,41,8,41.90319,-87.63439
13136,2,18,true,12,18,6,41.90326,-87.67845
13061,2,18,true,24,18,-6,41.90342,-87.66779
KA1504000079,2,18,true,9,11,2,41.9035,-87.64334
TA1307000115,2,18,true,11,20,9,41.9046,-87.64056
TA1308000049,2,18,true,22,41,19,41.90672,-87.6349
KA1504000134,2,18,true,9,10,1,41.90687,-87.6262
13224,2,18,true,17,8,-9,41.90706,-87.66725
TA1307000143,2,18,true,2,6,4,41.90762,-87.63854
13221,2,18,true,18,16,-2,41.90765,-87.67254
13245,2,18,true,2,7,5,41.90777,-87.68586
TA1309000024,2,18,true,24,33,9,41.908,-87.63152
TA1305000041,2,18,true,20,17,-3,41.9094,-87.67769
331,2,18,true,27,33,6,41.90965,-87.64812
TA1305000037,2,18,true,8,13,5,41.91018,-87.67003
TA1306000008,2,18,true,9,20,11,41.9102,-87.6435
TA1308000005,2,18,true,12,7,-5,41.91042,-87.68238
13257,2,18,true,1,7,6,41.91054,-87.68956
13154,2,18,true,18,21,3,41.91054,-87.65312
13058,2,18,true,12,17,5,41.91059,-87.64942
TA1307000038,2,18,true,15,25,10,41.91138,-87.63868
LF-005,2,18,true,33,157,124,41.91172,-87.62681
13128,2,18,true,9,20,11,41.91197,-87.63197
TA1308000050,2,18,true,48,59,11,41.91211,-87.6347
13243,2,18,true,27,17,-10,41.91262,-87.6814
TA1306000032,2,18,true,14,12,-2,41.9137,-87.65285
TA1307000166,2,18,true,16,18,2,41.91386,-87.64877
15655,2,18,true,6,6,0,41.91401,-87.70514
18067,2,18,true,16,4,-12,41.9146,-87.66796
TA1306000007,2,18,true,8,12,4,41.91469,-87.64333
13068,2,18,true,9,9,0,41.91554,-87.68703
13179,2,18,true,30,42,12,41.9157,-87.63461
13133,2,18,true,9,25,16,41.91598,-87.67733
15651,2,18,true,3,5,2,41.91752,-87.70181
13266,2,18,true,6,5,-1,41.91774,-87.69142
TA1309000029,2,18,true,1,10,9,41.9178,-87.68245
TA1309000006,2,18,true,12,13,1,41.91809,-87.64375
TA1307000163,2,18,true,13,5,-8,41.91821,-87.65696
13146,2,18,true,32,47,15,41.91831,-87.63629
13059,2,18,true,23,19,-4,41.91845,-87.65222
13192,2,18,true,23,24,1,41.91995,-87.64884
13288,2,18,true,9,11,2,41.92008,-87.67788
13242,2,18,true,4,9,5,41.92021,-87.69266
TA1309000030,2,18,true,15,11,-4,41.92077,-87.66372
TA1309000033,2,18,true,21,21,0,41.92158,-87.65381
13193,2,18,true,26,18,-8,41.92182,-87.64412
13191,2,18,true,8,12,4,41.92217,-87.63891
13084,2,18,true,8,9,1,41.92268,-87.69715
LP-,2,18,true,11,21,10,41.92396,-87.63584
KA1504000140,2,18,true,4,6,2,41.92409,-87.67646
TA1307000001,2,18,true,7,12,5,41.92535,-87.66581
TA1306000026,2,18,true,23,19,-4,41.92558,-87.65842
TA1306000016,2,18,true,16,26,10,41.9256,-87.65371
TA1309000019,2,18,true,31,30,-1,41.92586,-87.63897
TA1309000058,2,18,true,28,30,2,41.92591,-87.64927
TA1308000001,2,18,true,39,32,-7,41.92627,-87.63086
15646,2,18,true,4,8,4,41.92668,-87.6977
13124,2,18,true,7,11,4,41.92675,-87.63444
TA1309000023,2,18,true,27,31,4,41.9287,-87.65383
TA1307000113,2,18,true,15,22,7,41.92878,-87.66391
TA1309000059,2,18,true,11,8,-3,41.92889,-87.65898
TA1309000061,2,18,true,27,23,-4,41.92915,-87.64909
TA1308000031,2,18,true,5,6,1,41.92946,-87.68417
TA1305000014,2,18,true,22,28,6,41.92956,-87.64313
13085,2,18,true,7,11,4,41.92958,-87.70789
TA1307000142,2,18,true,21,24,3,41.93125,-87.64432
13276,2,18,true,19,28,9,41.93132,-87.63874
13271,2,18,true,8,6,-2,41.93192,-87.67784
TA1307000064,2,18,true,8,19,11,41.93222,-87.65864
TA1306000014,2,18,true,25,30,5,41.93242,-87.65271
TA1309000039,2,18,true,22,36,14,41.93258,-87.63642
13294,2,18,true,10,8,-2,41.9326,-87.66595
TA1309000036,2,18,true,30,26,-4,41.93313,-87.64776
TA1307000006,2,18,true,17,15,-2,41.93571,-87.6636
13268,2,18,true,5,13,8,41.93588,-87.67843
13269,2,18,true,9,8,-1,41.93609,-87.66983
TA1307000052,2,18,true,18,20,2,41.93628,-87.65266
TA1307000136,2,18,true,32,29,-3,41.9365,-87.64755
TA1307000041,2,18,true,24,42,18,41.93669,-87.63683
13137,2,18,true,42,27,-15,41.9376,-87.6441
15642,2,18,true,3,5,2,41.93843,-87.69801
KA17018068,2,18,true,4,6,2,41.93935,-87.68327
TA1309000042,2,18,true,12,12,0,41.93937,-87.66836
13229,2,18,true,9,19,10,41.93946,-87.66376
TA1308000019,2,18,true,8,12,4,41.93973,-87.65886
13277,2,18,true,24,21,-3,41.9401,-87.64546
TA1307000134,2,18,true,19,18,-1,41.94016,-87.65303
13143,2,18,true,5,6,1,41.94059,-87.67853
TA1309000049,2,18,true,36,35,-1,41.94077,-87.63919
TA1307000138,2,18,true,15,15,0,41.94334,-87.67094
13144,2,18,true,5,5,0,41.9434,-87.67964
TA1309000025,2,18,true,25,18,-7,41.94368,-87.64894
13071,2,18,true,21,27,6,41.94373,-87.66401
632,2,18,true,13,11,-2,41.94453,-87.6547
15631,2,18,true,1,8,7,41.94524,-87.70665
13278,2,18,true,12,44,32,41.94553,-87.64644
13235,2,18,true,12,23,11,41.94814,-87.66396
13253,2,18,true,8,6,-2,41.9488,-87.67527
13325,2,18,true,14,20,6,41.94907,-87.64863
TA1307000126,2,18,true,8,48,40,41.94936,-87.65451
TA1307000150,2,18,true,20,42,22,41.94945,-87.64646
13319,2,18,true,1,6,5,41.95069,-87.6687
TA1307000127,2,18,true,13,13,0,41.9508,-87.65918
13323,2,18,true,12,19,7,41.95282,-87.65
TA1309000043,2,18,true,7,10,3,41.95417,-87.66434
13063,2,18,true,12,27,15,41.95424,-87.65441
TA1308000022,2,18,true,12,19,7,41.95438,-87.64805
TA1307000149,2,18,true,10,9,-1,41.95467,-87.67392
TA1309000026,2,18,true,11,14,3,41.95601,-87.6802
13249,2,18,true,8,8,0,41.95606,-87.66885
13379,2,18,true,10,19,9,41.95786,-87.6495
TA1309000018,2,18,true,6,3,-3,41.95791,-87.67357
TA1309000027,2,18,true,6,8,2,41.9585,-87.65499
13389,2,18,true,12,13,1,41.961,-87.64958
15622,2,18,true,5,4,-1,41.96108,-87.69544
TA1307000144,2,18,true,4,11,7,41.96142,-87.6762
15623,2,18,true,3,6,3,41.96154,-87.69117
TA1307000107,2,18,true,20,20,0,41.96164,-87.65464
TA1307000156,2,18,true,6,6,0,41.96301,-87.68479
TA1308000012,2,18,true,38,23,-15,41.96398,-87.63818
13074,2,18,true,18,11,-7,41.96521,-87.6582
639,2,18,true,8,21,13,41.96584,-87.64538
TA1307000140,2,18,true,3,5,2,41.96643,-87.68865
TA1309000014,2,18,true,9,7,-2,41.96709,-87.66744
TA1307000158,2,18,true,8,2,-6,41.9671,-87.67904
TA1307000119,2,18,true,10,9,-1,41.96796,-87.65
TA1308000021,2,18,true,2,9,7,41.96883,-87.65765
KA1504000080,2,18,true,5,4,-1,41.96887,-87.69609
TA1309000015,2,18,true,5,2,-3,41.96889,-87.68401
TA1309000066,2,18,true,24,10,-14,41.9691,-87.67423
TA1309000041,2,18,true,8,6,-2,41.96951,-87.65471
KA1504000171,2,18,true,9,14,5,41.97161,-87.65016
TA1309000035,2,18,true,9,18,9,41.97335,-87.66785
13108,2,18,true,15,15,0,41.97379,-87.65971
KA1504000149,2,18,true,6,7,1,41.97562,-87.67945
KA1504000146,2,18,true,5,7,2,41.978,-87.66805
13109,2,18,true,8,5,-3,41.97835,-87.65976
KA1504000151,2,18,true,9,13,4,41.98359,-87.66916
KA1504000152,2,18,true,26,21,-5,41.98403,-87.65231
15578,2,18,true,8,7,-1,41.98405,-87.66027
15575,2,18,true,10,10,0,41.98975,-87.66014
15571,2,18,true,4,8,4,41.99478,-87.66028
660,2,18,true,6,7,1,42.00458,-87.66143
KA1503000029,2,19,false,3,5,2,41.77364,-87.56747
15491,2,19,false,5,6,1,41.78096,-87.57624
TA1309000063,2,19,false,2,5,3,41.79325,-87.5878
TA1308000009,2,19,false,11,15,4,41.79522,-87.58075
TA1307000164,2,19,false,6,5,-1,41.79527,-87.59647
KA1503000059,2,19,false,1,7,6,41.79952,-87.58643
TA1309000037,2,19,false,8,11,3,41.79957,-87.59474
TA1308000002,2,19,false,1,5,4,41.80983,-87.59937
13420,2,19,false,2,6,4,41.82459,-87.61678
KA1503000004,2,19,false,9,1,-8,41.83127,-87.6088
15445,2,19,false,2,6,4,41.83453,-87.63183
TA1307000048,2,19,false,20,16,-4,41.83855,-87.60821
TA1307000139,2,19,false,5,2,-3,41.84205,-87.61698
13075,2,19,false,2,5,3,41.8531,-87.63192
13089,2,19,false,1,5,4,41.85497,-87.67567
13331,2,19,false,3,6,3,41.85515,-87.65414
SL-013,2,19,false,6,7,1,41.85659,-87.62755
13102,2,19,false,2,9,7,41.85762,-87.61942
13150,2,19,false,1,8,7,41.85783,-87.62455
13164,2,19,false,6,3,-3,41.85818,-87.65648
SL-012,2,19,false,4,6,2,41.86038,-87.62581
TA1307000124,2,19,false,6,5,-1,41.86411,-87.62372
13165,2,19,false,4,5,1,41.86505,-87.65697
13431,2,19,false,18,22,4,41.8661,-87.60728
TA1305000002,2,19,false,12,14,2,41.86721,-87.62597
15544,2,19,false,9,8,-1,41.86723,-87.61536
KA1706005007,2,19,false,7,1,-6,41.86749,-87.63219
SL-005,2,19,false,23,37,14,41.8679,-87.62304
13160,2,19,false,7,4,-3,41.86947,-87.65548
TA1309000010,2,19,false,15,24,9,41.87074,-87.62574
SL-008,2,19,false,14,12,-2,41.87209,-87.62956
13332,2,19,false,6,2,-4,41.87219,-87.6615
SL-011,2,19,false,10,10,0,41.87256,-87.63356
623,2,19,false,33,37,4,41.87272,-87.62399
SL-010,2,19,false,12,11,-1,41.87501,-87.63309
15541,2,19,false,47,26,-21,41.8758,-87.62086
13037,2,19,false,5,3,-2,41.87588,-87.64078
TA1305000010,2,19,false,11,7,-4,41.87623,-87.62444
13158,2,19,false,5,11,6,41.87764,-87.64957
13157,2,19,false,6,6,0,41.87773,-87.6548
TA1305000025,2,19,false,7,9,2,41.87773,-87.63528
638,2,19,false,6,2,-4,41.87827,-87.64078
13011,2,19,false,10,2,-8,41.87931,-87.63993
KA1503000015,2,19,false,13,6,-7,41.87948,-87.6257
13300,2,19,false,64,58,-6,41.88097,-87.61675
13008,2,19,false,29,39,10,41.88105,-87.62408
TA1305000006,2,19,false,1,8,7,41.88122,-87.6296
13056,2,19,false,6,2,-4,41.88168,-87.63951
TA1307000120,2,19,false,12,16,4,41.88188,-87.64879
13036,2,19,false,6,1,-5,41.8821,-87.62513
TA1305000032,2,19,false,8,8,0,41.88218,-87.64109
13006,2,19,false,1,5,4,41.88268,-87.63252
13409,2,19,false,2,10,8,41.8831,-87.6511
13053,2,19,false,15,8,-7,41.88365,-87.64863
13001,2,19,false,16,10,-6,41.88397,-87.62459
18062,2,19,false,4,10,6,41.88412,-87.65427
TA1306000010,2,19,false,14,1,-13,41.88419,-87.62961
TA1305000030,2,19,false,6,5,-1,41.88459,-87.63178
15535,2,19,false,10,9,-1,41.8846,-87.64455
TA1305000029,2,19,false,14,7,-7,41.88466,-87.62787
13263,2,19,false,15,18,3,41.88467,-87.61952
TA1306000015,2,19,false,11,18,7,41.88549,-87.65232
TA1307000111,2,19,false,2,5,3,41.88582,-87.63548
KA1503000012,2,19,false,4,6,2,41.88599,-87.63089
TA1305000011,2,19,false,14,29,15,41.886,-87.62418
15534,2,19,false,5,9,4,41.88627,-87.61749
13197,2,19,false,5,1,-4,41.8866,-87.65816
TA1307000131,2,19,false,8,8,0,41.88688,-87.62606
KA1503000064,2,19,false,28,22,-6,41.88697,-87.61281
TA1305000022,2,19,false,5,7,2,41.88817,-87.63656
TA1306000003,2,19,false,14,28,14,41.88867,-87.64442
KA1503000043,2,19,false,8,12,4,41.88918,-87.63851
13050,2,19,false,5,6,1,41.88919,-87.62775
TA1307000151,2,19,false,8,5,-3,41.88993,-87.63427
KA1503000044,2,19,false,2,5,3,41.89018,-87.6262
13427,2,19,false,7,7,0,41.89054,-87.62205
13430,2,19,false,17,19,2,41.89077,-87.63169
TA1306000013,2,19,false,18,21,3,41.89083,-87.61852
RN-,2,19,false,10,8,-2,41.89102,-87.63546
TA1307000117,2,19,false,22,25,3,41.89144,-87.62675
13033,2,19,false,14,10,-4,41.8916,-87.64835
13194,2,19,false,9,5,-4,41.8918,-87.65878
TA1305000003,2,19,false,12,11,-1,41.89187,-87.62061
13022,2,19,false,113,99,-14,41.89227,-87.61205
TA1306000029,2,19,false,14,22,8,41.89256,-87.61449
13265,2,19,false,8,10,2,41.89383,-87.64172
13045,2,19,false,24,15,-9,41.89403,-87.62931
13016,2,19,false,10,10,0,41.89431,-87.62277
KA1503000041,2,19,false,6,7,1,41.89452,-87.61798
13196,2,19,false,11,5,-6,41.89455,-87.65345
TA1307000062,2,19,false,5,9,4,41.89466,-87.63839
TA1306000012,2,19,false,20,30,10,41.89475,-87.63438
KP1705001026,2,19,false,15,10,-5,41.89483,-87.6323
13132,2,19,false,6,7,1,41.89573,-87.67718
15530,2,19,false,16,14,-2,41.89575,-87.62596
TA1305000020,2,19,false,6,6,0,41.89636,-87.65406
13289,2,19,false,5,8,3,41.89638,-87.661
13303,2,19,false,12,8,-4,41.89672,-87.63088
13017,2,19,false,15,5,-10,41.89676,-87.6357
13338,2,19,false,6,2,-4,41.89697,-87.62173
TA1307000061,2,19,false,5,1,-4,41.89745,-87.62873
13034,2,19,false,6,4,-2,41.89754,-87.62352
TA1306000009,2,19,false,5,3,-2,41.89772,-87.64299
620,2,19,false,11,3,-8,41.89817,-87.63754
KA1504000103,2,19,false,6,9,3,41.89842,-87.68659
15529,2,19,false,9,13,4,41.89858,-87.62206
TA1307000128,2,19,false,15,12,-3,41.89896,-87.6299
13248,2,19,false,9,5,-4,41.89964,-87.66788
TA1306000011,2,19,false,4,6,2,41.89994,-87.63443
17660,2,19,false,5,3,-2,41.90036,-87.69671
13042,2,19,false,42,53,11,41.90097,-87.62377
KA1504000133,2,19,false,20,18,-2,41.90234,-87.62773
TA1307000039,2,19,false,25,33,8,41.90294,-87.63137
TA1305000034,2,19,false,10,8,-2,41.90313,-87.67391
KA1504000135,2,19,false,27,22,-5,41.90319,-87.63439
13136,2,19,false,7,7,0,41.90326,-87.67845
13061,2,19,false,17,19,2,41.90342,-87.66779
KA1504000079,2,19,false,11,17,6,41.9035,-87.64334
TA1307000115,2,19,false,3,9,6,41.9046,-87.64056
TA1308000049,2,19,false,29,39,10,41.90672,-87.6349
KA1504000134,2,19,false,12,13,1,41.90687,-87.6262
13224,2,19,false,4,13,9,41.90706,-87.66725
TA1307000143,2,19,false,6,6,0,41.90762,-87.63854
13221,2,19,false,5,12,7,41.90765,-87.67254
TA1309000024,2,19,false,10,22,12,41.908,-87.63152
TA1305000041,2,19,false,6,22,16,41.9094,-87.67769
331,2,19,false,15,14,-1,41.90965,-87.64812
TA1305000037,2,19,false,5,3,-2,41.91018,-87.67003
13257,2,19,false,6,9,3,41.91054,-87.68956
13154,2,19,false,8,10,2,41.91054,-87.65312
13058,2,19,false,6,6,0,41.91059,-87.64942
TA1307000038,2,19,false,12,20,8,41.91138,-87.63868
LF-005,2,19,false,102,204,102,41.91172,-87.62681
13128,2,19,false,11,13,2,41.91197,-87.63197
TA1308000050,2,19,false,23,28,5,41.91211,-87.6347
13243,2,19,false,5,13,8,41.91262,-87.6814
TA1306000032,2,19,false,10,5,-5,41.9137,-87.65285
TA1307000166,2,19,false,11,8,-3,41.91386,-87.64877
15655,2,19,false,7,6,-1,41.91401,-87.70514
18017,2,19,false,9,1,-8,41.91416,-87.71676
18067,2,19,false,6,9,3,41.9146,-87.66796
13068,2,19,false,3,6,3,41.91554,-87.68703
13179,2,19,false,31,48,17,41.9157,-87.63461
13133,2,19,false,14,7,-7,41.91598,-87.67733
15651,2,19,false,6,8,2,41.91752,-87.70181
TA1309000029,2,19,false,5,5,0,41.9178,-87.68245
TA1309000006,2,19,false,4,6,2,41.91809,-87.64375
TA1307000163,2,19,false,8,4,-4,41.91821,-87.65696
13146,2,19,false,19,32,13,41.91831,-87.63629
13059,2,19,false,13,11,-2,41.91845,-87.65222
13192,2,19,false,16,12,-4,41.91995,-87.64884
13242,2,19,false,1,7,6,41.92021,-87.69266
TA1309000030,2,19,false,9,7,-2,41.92077,-87.66372
TA1309000033,2,19,false,8,8,0,41.92158,-87.65381
13193,2,19,false,18,30,12,41.92182,-87.64412
13191,2,19,false,9,10,1,41.92217,-87.63891
13084,2,19,false,5,9,4,41.92268,-87.69715
LP-,2,19,false,12,13,1,41.92396,-87.63584
TA1307000001,2,19,false,4,9,5,41.92535,-87.66581
TA1306000026,2,19,false,5,4,-1,41.92558,-87.65842
TA1306000016,2,19,false,6,8,2,41.9256,-87.65371
TA1309000019,2,19,false,18,19,1,41.92586,-87.63897
TA1309000058,2,19,false,17,15,-2,41.92591,-87.64927
TA1308000001,2,19,false,46,37,-9,41.92627,-87.63086
13124,2,19,false,13,10,-3,41.92675,-87.63444
TA1309000023,2,19,false,22,20,-2,41.9287,-87.65383
TA1307000113,2,19,false,11,20,9,41.92878,-87.66391
13296,2,19,false,2,9,7,41.92883,-87.66852
TA1309000059,2,19,false,3,10,7,41.92889,-87.65898
TA1309000061,2,19,false,10,16,6,41.92915,-87.64909
TA1305000014,2,19,false,15,13,-2,41.92956,-87.64313
13085,2,19,false,11,3,-8,41.92958,-87.70789
TA1307000142,2,19,false,18,16,-2,41.93125,-87.64432
13276,2,19,false,21,19,-2,41.93132,-87.63874
TA1307000064,2,19,false,12,8,-4,41.93222,-87.65864
TA1306000014,2,19,false,11,12,1,41.93242,-87.65271
TA1309000039,2,19,false,20,22,2,41.93258,-87.63642
TA1309000036,2,19,false,10,14,4,41.93313,-87.64776
TA1307000006,2,19,false,16,3,-13,41.93571,-87.6636
13268,2,19,false,6,1,-5,41.93588,-87.67843
TA1307000052,2,19,false,6,15,9,41.93628,-87.65266
TA1307000136,2,19,false,16,16,0,41.9365,-87.64755
TA1307000041,2,19,false,12,24,12,41.93669,-87.63683
13137,2,19,false,30,24,-6,41.9376,-87.6441
15642,2,19,false,5,4,-1,41.93843,-87.69801
TA1309000042,2,19,false,8,7,-1,41.93937,-87.66836
13229,2,19,false,6,7,1,41.93946,-87.66376
TA1308000019,2,19,false,6,11,5,41.93973,-87.65886
13277,2,19,false,9,15,6,41.9401,-87.64546
TA1307000134,2,19,false,11,15,4,41.94016,-87.65303
TA1309000049,2,19,false,20,24,4,41.94077,-87.63919
TA1307000138,2,19,false,2,7,5,41.94334,-87.67094
13144,2,19,false,5,2,-3,41.9434,-87.67964
TA1309000025,2,19,false,16,10,-6,41.94368,-87.64894
13071,2,19,false,8,14,6,41.94373,-87.66401
632,2,19,false,13,10,-3,41.94453,-87.6547
13278,2,19,false,9,15,6,41.94553,-87.64644
13235,2,19,false,5,7,2,41.94814,-87.66396
13253,2,19,false,1,7,6,41.9488,-87.67527
13325,2,19,false,11,4,-7,41.94907,-87.64863
TA1307000126,2,19,false,5,45,40,41.94936,-87.65451
TA1307000150,2,19,false,14,11,-3,41.94945,-87.64646
13319,2,19,false,5,4,-1,41.95069,-87.6687
TA1307000127,2,19,false,13,13,0,41.9508,-87.65918
13323,2,19,false,9,21,12,41.95282,-87.65
TA1309000043,2,19,false,4,9,5,41.95417,-87.66434
13063,2,19,false,6,4,-2,41.95424,-87.65441
TA1308000022,2,19,false,8,12,4,41.95438,-87.64805
13379,2,19,false,13,15,2,41.95786,-87.6495
13389,2,19,false,5,9,4,41.961,-87.64958
TA1307000107,2,19,false,6,7,1,41.96164,-87.65464
TA1308000012,2,19,false,29,28,-1,41.96398,-87.63818
13074,2,19,false,1,7,6,41.96521,-87.6582
639,2,19,false,7,8,1,41.96584,-87.64538
KA1504000171,2,19,false,8,7,-1,41.97161,-87.65016
TA1309000035,2,19,false,4,7,3,41.97335,-87.66785
KA1504000146,2,19,false,7,5,-2,41.978,-87.66805
KA1504000152,2,19,false,10,5,-5,41.98403,-87.65231
15575,2,19,false,2,5,3,41.98975,-87.66014
RP-009,2,19,false,1,6,5,42.00107,-87.66122
KA1504000159,2,19,false,6,3,-3,42.01059,-87.66241
523,2,19,false,3,8,5,42.02089,-87.66505
596,2,19,false,3,7,4,42.04822,-87.68348
604,2,19,false,6,5,-1,42.05824,-87.67744
KA1503000014,2,19,true,9,9,0,41.7851,-87.60108
KA1503000071,2,19,true,8,9,1,41.79148,-87.59988
TA1309000063,2,19,true,5,1,-4,41.79325,-87.5878
KA1504000076,2,19,true,5,5,0,41.7943,-87.60145
TA1308000009,2,19,true,6,6,0,41.79522,-87.58075
TA1307000164,2,19,true,6,4,-2,41.79527,-87.59647
KA1503000059,2,19,true,7,1,-6,41.79952,-87.58643
TA1309000037,2,19,true,10,17,7,41.79957,-87.59474
KA1503000007,2,19,true,3,8,5,41.80242,-87.58689
13398,2,19,true,2,7,5,41.80256,-87.59035
TA1308000045,2,19,true,1,5,4,41.83062,-87.64129
15445,2,19,true,5,5,0,41.83453,-87.63183
13215,2,19,true,2,5,3,41.83634,-87.6135
TA1309000055,2,19,true,5,4,-1,41.8382,-87.64514
KA1503000038,2,19,true,6,5,-1,41.83845,-87.6354
TA1307000048,2,19,true,14,15,1,41.83855,-87.60821
TA1308000036,2,19,true,8,5,-3,41.83883,-87.62186
TA1307000139,2,19,true,5,14,9,41.84205,-87.61698
TA1305000001,2,19,true,5,5,0,41.85262,-87.6265
13075,2,19,true,1,5,4,41.8531,-87.63192
13091,2,19,true,1,5,4,41.85409,-87.68585
13307,2,19,true,6,4,-2,41.85489,-87.66359
15545,2,19,true,22,18,-4,41.85627,-87.61334
13102,2,19,true,3,9,6,41.85762,-87.61942
13150,2,19,true,4,10,6,41.85783,-87.62455
13099,2,19,true,4,8,4,41.85784,-87.64627
13163,2,19,true,1,5,4,41.85808,-87.65108
SL-012,2,19,true,9,7,-2,41.86038,-87.62581
13304,2,19,true,6,10,4,41.86126,-87.65659
TA1306000002,2,19,true,3,7,4,41.86238,-87.65108
TA1307000124,2,19,true,6,8,2,41.86411,-87.62372
TA1309000001,2,19,true,4,6,2,41.86488,-87.64708
13354,2,19,true,8,5,-3,41.86524,-87.66651
13431,2,19,true,17,14,-3,41.8661,-87.60728
WL-008,2,19,true,15,17,2,41.86712,-87.64108
TA1305000002,2,19,true,24,27,3,41.86721,-87.62597
15544,2,19,true,9,8,-1,41.86723,-87.61536
KA1706005007,2,19,true,15,8,-7,41.86749,-87.63219
SL-005,2,19,true,30,29,-1,41.8679,-87.62304
644,2,19,true,7,6,-1,41.86859,-87.68625
13139,2,19,true,3,6,3,41.86893,-87.65913
13160,2,19,true,13,8,-5,41.86947,-87.65548
15550,2,19,true,6,4,-2,41.87024,-87.63947
TA1309000010,2,19,true,9,13,4,41.87074,-87.62574
SL-009,2,19,true,5,5,0,41.87081,-87.63121
TA1307000130,2,19,true,12,5,-7,41.87178,-87.65103
TA1307000121,2,19,true,16,6,-10,41.87184,-87.64664
SL-008,2,19,true,21,23,2,41.87209,-87.62956
13332,2,19,true,14,28,14,41.87219,-87.6615
SL-011,2,19,true,14,10,-4,41.87256,-87.63356
623,2,19,true,7,12,5,41.87272,-87.62399
KA1504000104,2,19,true,11,6,-5,41.87296,-87.66912
SL-007,2,19,true,7,10,3,41.87404,-87.6277
TA1306000025,2,19,true,14,13,-1,41.87464,-87.65703
15668,2,19,true,5,4,-1,41.87471,-87.68642
13028,2,19,true,10,11,1,41.87475,-87.64981
SL-010,2,19,true,3,5,2,41.87501,-87.63309
15541,2,19,true,15,14,-1,41.8758,-87.62086
TA1305000010,2,19,true,4,10,6,41.87623,-87.62444
624,2,19,true,7,4,-3,41.87626,-87.62923
TA1305000035,2,19,true,5,2,-3,41.87716,-87.62787
13138,2,19,true,8,1,-7,41.87723,-87.63941
15539,2,19,true,15,7,-8,41.87763,-87.64405
13158,2,19,true,15,16,1,41.87764,-87.64957
13157,2,19,true,13,15,2,41.87773,-87.6548
TA1305000025,2,19,true,10,9,-1,41.87773,-87.63528
13206,2,19,true,7,8,1,41.87794,-87.66201
638,2,19,true,13,8,-5,41.87827,-87.64078
TA1305000005,2,19,true,7,3,-4,41.87924,-87.62975
13011,2,19,true,11,4,-7,41.87931,-87.63993
15667,2,19,true,3,11,8,41.8798,-87.68609
WL-011,2,19,true,3,9,6,41.88034,-87.64273
13156,2,19,true,9,10,1,41.88042,-87.65554
13300,2,19,true,18,17,-1,41.88097,-87.61675
13008,2,19,true,9,5,-4,41.88105,-87.62408
TA1305000006,2,19,true,8,7,-1,41.88122,-87.6296
13056,2,19,true,14,2,-12,41.88168,-87.63951
TA1307000120,2,19,true,23,18,-5,41.88188,-87.64879
13341,2,19,true,6,7,1,41.88208,-87.63985
13036,2,19,true,7,1,-6,41.8821,-87.62513
TA1305000032,2,19,true,28,24,-4,41.88218,-87.64109
13006,2,19,true,5,2,-3,41.88268,-87.63252
13353,2,19,true,12,9,-3,41.88283,-87.6612
654,2,19,true,5,2,-3,41.88307,-87.65698
13409,2,19,true,3,6,3,41.8831,-87.6511
WL-012,2,19,true,10,5,-5,41.88337,-87.6412
13053,2,19,true,9,8,-1,41.88365,-87.64863
13001,2,19,true,13,8,-5,41.88397,-87.62459
18062,2,19,true,6,14,8,41.88412,-87.65427
TA1306000010,2,19,true,26,14,-12,41.88419,-87.62961
TA1305000030,2,19,true,5,3,-2,41.88459,-87.63178
15535,2,19,true,13,20,7,41.8846,-87.64455
TA1305000029,2,19,true,11,7,-4,41.88466,-87.62787
13263,2,19,true,15,16,1,41.88467,-87.61952
TA1306000015,2,19,true,16,14,-2,41.88549,-87.65232
13021,2,19,true,12,16,4,41.88559,-87.64184
TA1307000111,2,19,true,7,9,2,41.88582,-87.63548
13073,2,19,true,4,6,2,41.88592,-87.66717
KA1503000012,2,19,true,8,8,0,41.88599,-87.63089
TA1305000011,2,19,true,15,7,-8,41.886,-87.62418
15534,2,19,true,4,6,2,41.88627,-87.61749
13197,2,19,true,4,10,6,41.8866,-87.65816
TA1307000131,2,19,true,13,8,-5,41.88688,-87.62606
KA1503000064,2,19,true,14,16,2,41.88697,-87.61281
TA1305000022,2,19,true,17,11,-6,41.88817,-87.63656
TA1306000003,2,19,true,39,37,-2,41.88867,-87.64442
KA1503000043,2,19,true,25,25,0,41.88918,-87.63851
13050,2,19,true,15,9,-6,41.88919,-87.62775
TA1307000151,2,19,true,12,16,4,41.88993,-87.63427
636,2,19,true,9,8,-1,41.88997,-87.63662
KA1503000044,2,19,true,3,7,4,41.89018,-87.6262
13427,2,19,true,10,8,-2,41.89054,-87.62205
13430,2,19,true,38,21,-17,41.89077,-87.63169
TA1306000013,2,19,true,18,18,0,41.89083,-87.61852
RN-,2,19,true,12,19,7,41.89102,-87.63546
TA1308000006,2,19,true,4,5,1,41.89128,-87.67686
TA1307000117,2,19,true,36,29,-7,41.89144,-87.62675
13033,2,19,true,13,17,4,41.8916,-87.64835
13194,2,19,true,4,9,5,41.8918,-87.65878
TA1305000003,2,19,true,23,21,-2,41.89187,-87.62061
13022,2,19,true,47,42,-5,41.89227,-87.61205
TA1306000029,2,19,true,20,30,10,41.89256,-87.61449
13265,2,19,true,14,16,2,41.89383,-87.64172
13045,2,19,true,30,26,-4,41.89403,-87.62931
13016,2,19,true,20,10,-10,41.89431,-87.62277
KA1503000041,2,19,true,13,10,-3,41.89452,-87.61798
13196,2,19,true,4,7,3,41.89455,-87.65345
TA1307000062,2,19,true,13,14,1,41.89466,-87.63839
TA1306000012,2,19,true,29,24,-5,41.89475,-87.63438
KP1705001026,2,19,true,14,11,-3,41.89483,-87.6323
637,2,19,true,2,6,4,41.89563,-87.67209
13132,2,19,true,9,15,6,41.89573,-87.67718
15530,2,19,true,16,16,0,41.89575,-87.62596
18003,2,19,true,3,5,2,41.89575,-87.62011
13247,2,19,true,6,4,-2,41.89597,-87.66775
TA1305000020,2,19,true,8,11,3,41.89636,-87.65406
13289,2,19,true,3,12,9,41.89638,-87.661
13303,2,19,true,12,14,2,41.89672,-87.63088
13017,2,19,true,9,14,5,41.89676,-87.6357
13338,2,19,true,12,6,-6,41.89697,-87.62173
TA1307000061,2,19,true,10,11,1,41.89745,-87.62873
13034,2,19,true,7,4,-3,41.89754,-87.62352
TA1306000009,2,19,true,13,7,-6,41.89772,-87.64299
620,2,19,true,10,10,0,41.89817,-87.63754
KA1504000103,2,19,true,7,8,1,41.89842,-87.68659
15529,2,19,true,29,16,-13,41.89858,-87.62206
TA1307000128,2,19,true,21,31,10,41.89896,-87.6299
13248,2,19,true,10,6,-4,41.89964,-87.66788
TA1306000011,2,19,true,16,10,-6,41.89994,-87.63443
KA1504000116,2,19,true,2,6,4,41.90023,-87.64299
17660,2,19,true,5,3,-2,41.90036,-87.69671
13290,2,19,true,6,19,13,41.90069,-87.66259
13042,2,19,true,41,39,-2,41.90097,-87.62377
TA1307000070,2,19,true,3,11,8,41.90133,-87.67742
KA1504000133,2,19,true,19,13,-6,41.90234,-87.62773
TA1307000039,2,19,true,39,39,0,41.90294,-87.63137
13256,2,19,true,5,4,-1,41.90302,-87.69749
TA1305000034,2,19,true,5,5,0,41.90313,-87.67391
KA1504000135,2,19,true,40,35,-5,41.90319,-87.63439
13136,2,19,true,7,8,1,41.90326,-87.67845
13061,2,19,true,12,15,3,41.90342,-87.66779
KA1504000079,2,19,true,12,13,1,41.9035,-87.64334
TA1307000115,2,19,true,9,9,0,41.9046,-87.64056
TA1308000049,2,19,true,33,31,-2,41.90672,-87.6349
KA1504000134,2,19,true,11,11,0,41.90687,-87.6262
13224,2,19,true,5,11,6,41.90706,-87.66725
TA1307000143,2,19,true,4,11,7,41.90762,-87.63854
13221,2,19,true,10,12,2,41.90765,-87.67254
TA1309000024,2,19,true,18,24,6,41.908,-87.63152
TA1305000041,2,19,true,12,17,5,41.9094,-87.67769
331,2,19,true,17,20,3,41.90965,-87.64812
TA1305000037,2,19,true,4,10,6,41.91018,-87.67003
TA1306000008,2,19,true,9,11,2,41.9102,-87.6435
TA1308000005,2,19,true,6,11,5,41.91042,-87.68238
13258,2,19,true,9,6,-3,41.91043,-87.69718
13154,2,19,true,20,18,-2,41.91054,-87.65312
13058,2,19,true,9,11,2,41.91059,-87.64942
TA1307000038,2,19,true,13,17,4,41.91138,-87.63868
LF-005,2,19,true,71,109,38,41.91172,-87.62681
13128,2,19,true,6,8,2,41.91197,-87.63197
TA1308000050,2,19,true,36,36,0,41.91211,-87.6347
13243,2,19,true,12,10,-2,41.91262,-87.6814
TA1306000032,2,19,true,16,14,-2,41.9137,-87.65285
TA1307000166,2,19,true,4,12,8,41.91386,-87.64877
18067,2,19,true,5,7,2,41.9146,-87.66796
TA1306000007,2,19,true,5,8,3,41.91469,-87.64333
13068,2,19,true,3,5,2,41.91554,-87.68703
13179,2,19,true,46,35,-11,41.9157,-87.63461
13133,2,19,true,9,10,1,41.91598,-87.67733
TA1309000029,2,19,true,5,5,0,41.9178,-87.68245
TA1309000006,2,19,true,15,19,4,41.91809,-87.64375
TA1307000163,2,19,true,9,16,7,41.91821,-87.65696
13146,2,19,true,23,31,8,41.91831,-87.63629
13059,2,19,true,10,18,8,41.91845,-87.65222
13192,2,19,true,16,18,2,41.91995,-87.64884
13288,2,19,true,2,9,7,41.92008,-87.67788
13242,2,19,true,4,7,3,41.92021,-87.69266
TA1309000030,2,19,true,14,15,1,41.92077,-87.66372
13292,2,19,true,1,6,5,41.92152,-87.70733
TA1309000033,2,19,true,11,22,11,41.92158,-87.65381
13193,2,19,true,19,31,12,41.92182,-87.64412
13191,2,19,true,12,23,11,41.92217,-87.63891
13084,2,19,true,5,11,6,41.92268,-87.69715
LP-,2,19,true,7,16,9,41.92396,-87.63584
KA1504000140,2,19,true,5,5,0,41.92409,-87.67646
TA1307000001,2,19,true,10,14,4,41.92535,-87.66581
TA1306000026,2,19,true,14,11,-3,41.92558,-87.65842
TA1306000016,2,19,true,18,8,-10,41.9256,-87.65371
TA1309000019,2,19,true,25,23,-2,41.92586,-87.63897
TA1309000058,2,19,true,19,12,-7,41.92591,-87.64927
TA1308000001,2,19,true,40,29,-11,41.92627,-87.63086
13124,2,19,true,5,5,0,41.92675,-87.63444
TA1309000023,2,19,true,13,22,9,41.9287,-87.65383
TA1307000113,2,19,true,7,11,4,41.92878,-87.66391
13296,2,19,true,6,4,-2,41.92883,-87.66852
TA1309000059,2,19,true,5,12,7,41.92889,-87.65898
TA1309000061,2,19,true,16,18,2,41.92915,-87.64909
TA1308000031,2,19,true,3,7,4,41.92946,-87.68417
TA1305000014,2,19,true,13,18,5,41.92956,-87.64313
13085,2,19,true,6,8,2,41.92958,-87.70789
TA1307000142,2,19,true,23,29,6,41.93125,-87.64432
13276,2,19,true,18,22,4,41.93132,-87.63874
TA1307000064,2,19,true,11,14,3,41.93222,-87.65864
TA1306000014,2,19,true,15,18,3,41.93242,-87.65271
TA1309000039,2,19,true,22,28,6,41.93258,-87.63642
TA1309000036,2,19,true,21,16,-5,41.93313,-87.64776
TA1307000006,2,19,true,11,10,-1,41.93571,-87.6636
13268,2,19,true,7,2,-5,41.93588,-87.67843
13269,2,19,true,4,9,5,41.93609,-87.66983
TA1307000052,2,19,true,11,20,9,41.93628,-87.65266
TA1307000136,2,19,true,10,28,18,41.9365,-87.64755
TA1307000041,2,19,true,29,30,1,41.93669,-87.63683
13137,2,19,true,21,34,13,41.9376,-87.6441
KA17018068,2,19,true,1,7,6,41.93935,-87.68327
TA1309000042,2,19,true,9,15,6,41.93937,-87.66836
KA150400009X,2,19,true,1,5,4,41.9394,-87.71159
13229,2,19,true,6,9,3,41.93946,-87.66376
TA1308000019,2,19,true,8,17,9,41.93973,-87.65886
13277,2,19,true,15,21,6,41.9401,-87.64546
TA1307000134,2,19,true,15,18,3,41.94016,-87.65303
TA1309000049,2,19,true,19,18,-1,41.94077,-87.63919
TA1307000138,2,19,true,7,6,-1,41.94334,-87.67094
TA1309000025,2,19,true,21,18,-3,41.94368,-87.64894
13071,2,19,true,6,9,3,41.94373,-87.66401
632,2,19,true,6,14,8,41.94453,-87.6547
13278,2,19,true,20,15,-5,41.94553,-87.64644
13235,2,19,true,13,14,1,41.94814,-87.66396
13325,2,19,true,17,15,-2,41.94907,-87.64863
TA1307000126,2,19,true,14,19,5,41.94936,-87.65451
TA1307000150,2,19,true,16,13,-3,41.94945,-87.64646
13319,2,19,true,3,9,6,41.95069,-87.6687
TA1307000127,2,19,true,8,5,-3,41.9508,-87.65918
15628,2,19,true,5,5,0,41.95216,-87.69806
13323,2,19,true,21,16,-5,41.95282,-87.65
TA1309000043,2,19,true,4,8,4,41.95417,-87.66434
13063,2,19,true,10,7,-3,41.95424,-87.65441
TA1308000022,2,19,true,11,17,6,41.95438,-87.64805
TA1307000149,2,19,true,5,2,-3,41.95467,-87.67392
TA1309000026,2,19,true,6,9,3,41.95601,-87.6802
13379,2,19,true,13,19,6,41.95786,-87.6495
TA1309000027,2,19,true,3,7,4,41.9585,-87.65499
13389,2,19,true,10,13,3,41.961,-87.64958
TA1307000144,2,19,true,4,10,6,41.96142,-87.6762
KA1503000022,2,19,true,5,6,1,41.96158,-87.66609
TA1307000107,2,19,true,6,21,15,41.96164,-87.65464
TA1307000156,2,19,true,6,5,-1,41.96301,-87.68479
TA1308000012,2,19,true,25,36,11,41.96398,-87.63818
13074,2,19,true,11,9,-2,41.96521,-87.6582
639,2,19,true,24,10,-14,41.96584,-87.64538
TA1307000140,2,19,true,2,6,4,41.96643,-87.68865
KA1504000126,2,19,true,1,5,4,41.96668,-87.70807
TA1309000014,2,19,true,4,8,4,41.96709,-87.66744
TA1307000158,2,19,true,6,7,1,41.9671,-87.67904
TA1307000119,2,19,true,1,10,9,41.96796,-87.65
TA1308000021,2,19,true,6,6,0,41.96883,-87.65765
KA1504000080,2,19,true,2,5,3,41.96887,-87.69609
TA1309000066,2,19,true,15,11,-4,41.9691,-87.67423
KA1504000171,2,19,true,6,7,1,41.97161,-87.65016
TA1309000035,2,19,true,10,8,-2,41.97335,-87.66785
13108,2,19,true,6,11,5,41.97379,-87.65971
KA1504000146,2,19,true,5,11,6,41.978,-87.66805
13109,2,19,true,4,5,1,41.97835,-87.65976
KA1504000151,2,19,true,5,11,6,41.98359,-87.66916
KA1504000152,2,19,true,18,18,0,41.98403,-87.65231
15578,2,19,true,4,5,1,41.98405,-87.66027
15575,2,19,true,8,10,2,41.98975,-87.66014
15571,2,19,true,3,9,6,41.99478,-87.66028
660,2,19,true,2,10,8,42.00458,-87.66143
E002,2,19,true,1,5,4,42.03256,-87.67912
604,2,19,true,6,2,-4,42.05824,-87.67744
15491,2,20,false,3,6,3,41.78096,-87.57624
561,2,20,false,5,5,0,41.7857,-87.67409
TA1308000009,2,20,false,8,7,-1,41.79522,-87.58075
TA1307000164,2,20,false,1,5,4,41.79527,-87.59647
TA1309000037,2,20,false,10,6,-4,41.79957,-87.59474
13398,2,20,false,7,5,-2,41.80256,-87.59035
TA1308000038,2,20,false,3,6,3,41.82298,-87.6071
KA1503000004,2,20,false,12,12,0,41.83127,-87.6088
TA1307000048,2,20,false,13,21,8,41.83855,-87.60821
TA1308000036,2,20,false,2,5,3,41.83883,-87.62186
TA1305000001,2,20,false,4,5,1,41.85262,-87.6265
13075,2,20,false,5,7,2,41.8531,-87.63192
13135,2,20,false,4,5,1,41.85753,-87.66157
13102,2,20,false,7,3,-4,41.85762,-87.61942
13164,2,20,false,6,6,0,41.85818,-87.65648
SL-012,2,20,false,1,5,4,41.86038,-87.62581
TA1307000124,2,20,false,6,2,-4,41.86411,-87.62372
13431,2,20,false,7,8,1,41.8661,-87.60728
WL-008,2,20,false,9,3,-6,41.86712,-87.64108
TA1305000002,2,20,false,8,14,6,41.86721,-87.62597
KA1706005007,2,20,false,5,3,-2,41.86749,-87.63219
SL-005,2,20,false,13,35,22,41.8679,-87.62304
13160,2,20,false,2,7,5,41.86947,-87.65548
TA1309000010,2,20,false,5,14,9,41.87074,-87.62574
SL-008,2,20,false,4,8,4,41.87209,-87.62956
SL-011,2,20,false,7,4,-3,41.87256,-87.63356
623,2,20,false,14,23,9,41.87272,-87.62399
SL-007,2,20,false,11,8,-3,41.87404,-87.6277
15541,2,20,false,37,33,-4,41.8758,-87.62086
13138,2,20,false,1,5,4,41.87723,-87.63941
15539,2,20,false,5,4,-1,41.87763,-87.64405
13158,2,20,false,5,3,-2,41.87764,-87.64957
13157,2,20,false,2,5,3,41.87773,-87.6548
13011,2,20,false,3,6,3,41.87931,-87.63993
WL-011,2,20,false,4,6,2,41.88034,-87.64273
13300,2,20,false,52,24,-28,41.88097,-87.61675
13008,2,20,false,44,48,4,41.88105,-87.62408
TA1305000006,2,20,false,7,4,-3,41.88122,-87.6296
TA1307000120,2,20,false,7,12,5,41.88188,-87.64879
13036,2,20,false,5,4,-1,41.8821,-87.62513
TA1305000032,2,20,false,6,9,3,41.88218,-87.64109
13353,2,20,false,5,4,-1,41.88283,-87.6612
654,2,20,false,5,2,-3,41.88307,-87.65698
WL-012,2,20,false,7,9,2,41.88337,-87.6412
13053,2,20,false,17,14,-3,41.88365,-87.64863
13001,2,20,false,3,9,6,41.88397,-87.62459
TA1306000010,2,20,false,2,5,3,41.88419,-87.62961
15535,2,20,false,8,8,0,41.8846,-87.64455
13263,2,20,false,14,14,0,41.88467,-87.61952
TA1306000015,2,20,false,11,10,-1,41.88549,-87.65232
13021,2,20,false,6,6,0,41.88559,-87.64184
TA1307000111,2,20,false,2,6,4,41.88582,-87.63548
KA1503000012,2,20,false,4,10,6,41.88599,-87.63089
TA1305000011,2,20,false,22,13,-9,41.886,-87.62418
15534,2,20,false,5,13,8,41.88627,-87.61749
TA1308000029,2,20,false,4,8,4,41.88673,-87.62225
TA1307000131,2,20,false,9,6,-3,41.88688,-87.62606
KA1503000064,2,20,false,24,14,-10,41.88697,-87.61281
TA1306000003,2,20,false,10,13,3,41.88867,-87.64442
KA1503000043,2,20,false,11,17,6,41.88918,-87.63851
13050,2,20,false,7,8,1,41.88919,-87.62775
TA1307000151,2,20,false,4,8,4,41.88993,-87.63427
KA1503000044,2,20,false,14,7,-7,41.89018,-87.6262
13427,2,20,false,6,6,0,41.89054,-87.62205
13430,2,20,false,14,16,2,41.89077,-87.63169
TA1306000013,2,20,false,17,12,-5,41.89083,-87.61852
RN-,2,20,false,2,7,5,41.89102,-87.63546
TA1307000117,2,20,false,30,23,-7,41.89144,-87.62675
13033,2,20,false,3,11,8,41.8916,-87.64835
13194,2,20,false,4,5,1,41.8918,-87.65878
TA1305000003,2,20,false,18,21,3,41.89187,-87.62061
13022,2,20,false,86,68,-18,41.89227,-87.61205
TA1306000029,2,20,false,11,8,-3,41.89256,-87.61449
13265,2,20,false,4,7,3,41.89383,-87.64172
13045,2,20,false,8,11,3,41.89403,-87.62931
13016,2,20,false,6,6,0,41.89431,-87.62277
KA1503000041,2,20,false,4,9,5,41.89452,-87.61798
TA1306000012,2,20,false,21,19,-2,41.89475,-87.63438
KP1705001026,2,20,false,7,11,4,41.89483,-87.6323
637,2,20,false,4,5,1,41.89563,-87.67209
13132,2,20,false,3,8,5,41.89573,-87.67718
15530,2,20,false,9,10,1,41.89575,-87.62596
13303,2,20,false,8,6,-2,41.89672,-87.63088
13034,2,20,false,4,13,9,41.89754,-87.62352
TA1306000009,2,20,false,5,1,-4,41.89772,-87.64299
620,2,20,false,1,7,6,41.89817,-87.63754
TA1307000128,2,20,false,12,15,3,41.89896,-87.6299
657,2,20,false,3,5,2,41.89918,-87.6722
13248,2,20,false,2,8,6,41.89964,-87.66788
TA1306000011,2,20,false,4,6,2,41.89994,-87.63443
13042,2,20,false,38,40,2,41.90097,-87.62377
KA1504000133,2,20,false,4,12,8,41.90234,-87.62773
13241,2,20,false,5,4,-1,41.9029,-87.68731
TA1307000039,2,20,false,20,23,3,41.90294,-87.63137
TA1305000034,2,20,false,3,9,6,41.90313,-87.67391
KA1504000135,2,20,false,24,23,-1,41.90319,-87.63439
13136,2,20,false,5,7,2,41.90326,-87.67845
13061,2,20,false,3,8,5,41.90342,-87.66779
KA1504000079,2,20,false,9,6,-3,41.9035,-87.64334
TA1308000049,2,20,false,26,18,-8,41.90672,-87.6349
KA1504000134,2,20,false,14,5,-9,41.90687,-87.6262
13224,2,20,false,3,17,14,41.90706,-87.66725
TA1307000143,2,20,false,2,11,9,41.90762,-87.63854
13221,2,20,false,4,5,1,41.90765,-87.67254
TA1309000024,2,20,false,8,8,0,41.908,-87.63152
TA1305000041,2,20,false,11,13,2,41.9094,-87.67769
331,2,20,false,7,15,8,41.90965,-87.64812
15653,2,20,false,2,5,3,41.90979,-87.7053
13058,2,20,false,12,5,-7,41.91059,-87.64942
TA1307000038,2,20,false,10,12,2,41.91138,-87.63868
LF-005,2,20,false,127,58,-69,41.91172,-87.62681
13128,2,20,false,10,7,-3,41.91197,-87.63197
TA1308000050,2,20,false,28,32,4,41.91211,-87.6347
TA1306000032,2,20,false,3,7,4,41.9137,-87.65285
TA1307000166,2,20,false,6,6,0,41.91386,-87.64877
18017,2,20,false,4,14,10,41.91416,-87.71676
18067,2,20,false,11,4,-7,41.9146,-87.66796
13068,2,20,false,2,6,4,41.91554,-87.68703
13179,2,20,false,42,36,-6,41.9157,-87.63461
13133,2,20,false,16,5,-11,41.91598,-87.67733
TA1305000039,2,20,false,6,3,-3,41.9163,-87.66749
15651,2,20,false,2,7,5,41.91752,-87.70181
13266,2,20,false,7,3,-4,41.91774,-87.69142
TA1309000006,2,20,false,2,9,7,41.91809,-87.64375
TA1307000163,2,20,false,4,7,3,41.91821,-87.65696
13146,2,20,false,15,13,-2,41.91831,-87.63629
13059,2,20,false,6,13,7,41.91845,-87.65222
13192,2,20,false,8,11,3,41.91995,-87.64884
13242,2,20,false,6,2,-4,41.92021,-87.69266
TA1309000030,2,20,false,5,4,-1,41.92077,-87.66372
TA1309000033,2,20,false,15,12,-3,41.92158,-87.65381
13193,2,20,false,11,20,9,41.92182,-87.64412
13191,2,20,false,7,4,-3,41.92217,-87.63891
LP-,2,20,false,7,19,12,41.92396,-87.63584
TA1307000001,2,20,false,2,11,9,41.92535,-87.66581
TA1306000026,2,20,false,3,12,9,41.92558,-87.65842
TA1306000016,2,20,false,5,7,2,41.9256,-87.65371
TA1309000019,2,20,false,22,17,-5,41.92586,-87.63897
TA1309000058,2,20,false,14,13,-1,41.92591,-87.64927
TA1308000001,2,20,false,34,32,-2,41.92627,-87.63086
13124,2,20,false,20,3,-17,41.92675,-87.63444
TA1309000023,2,20,false,8,7,-1,41.9287,-87.65383
TA1307000113,2,20,false,10,15,5,41.92878,-87.66391
TA1309000061,2,20,false,11,11,0,41.92915,-87.64909
TA1308000031,2,20,false,5,2,-3,41.92946,-87.68417
TA1305000014,2,20,false,6,13,7,41.92956,-87.64313
13085,2,20,false,8,15,7,41.92958,-87.70789
TA1307000142,2,20,false,6,17,11,41.93125,-87.64432
13276,2,20,false,7,23,16,41.93132,-87.63874
TA1307000064,2,20,false,3,6,3,41.93222,-87.65864
TA1306000014,2,20,false,2,7,5,41.93242,-87.65271
TA1309000039,2,20,false,24,16,-8,41.93258,-87.63642
13294,2,20,false,1,10,9,41.9326,-87.66595
TA1309000036,2,20,false,7,11,4,41.93313,-87.64776
TA1307000006,2,20,false,5,9,4,41.93571,-87.6636
13268,2,20,false,5,6,1,41.93588,-87.67843
TA1307000052,2,20,false,5,4,-1,41.93628,-87.65266
TA1307000136,2,20,false,7,5,-2,41.9365,-87.64755
TA1307000041,2,20,false,11,11,0,41.93669,-87.63683
13137,2,20,false,15,24,9,41.9376,-87.6441
TA1309000042,2,20,false,6,2,-4,41.93937,-87.66836
13229,2,20,false,4,9,5,41.93946,-87.66376
13277,2,20,false,5,7,2,41.9401,-87.64546
TA1307000134,2,20,false,10,18,8,41.94016,-87.65303
TA1309000049,2,20,false,12,19,7,41.94077,-87.63919
TA1309000025,2,20,false,8,14,6,41.94368,-87.64894
13071,2,20,false,4,10,6,41.94373,-87.66401
632,2,20,false,17,13,-4,41.94453,-87.6547
13278,2,20,false,1,12,11,41.94553,-87.64644
13235,2,20,false,6,10,4,41.94814,-87.66396
13325,2,20,false,7,12,5,41.94907,-87.64863
TA1307000126,2,20,false,7,11,4,41.94936,-87.65451
TA1307000150,2,20,false,8,17,9,41.94945,-87.64646
TA1307000127,2,20,false,5,8,3,41.9508,-87.65918
13323,2,20,false,3,10,7,41.95282,-87.65
TA1309000043,2,20,false,5,5,0,41.95417,-87.66434
TA1308000022,2,20,false,8,8,0,41.95438,-87.64805
13379,2,20,false,3,6,3,41.95786,-87.6495
TA1309000027,2,20,false,7,6,-1,41.9585,-87.65499
13389,2,20,false,4,8,4,41.961,-87.64958
TA1307000144,2,20,false,5,5,0,41.96142,-87.6762
TA1307000107,2,20,false,3,6,3,41.96164,-87.65464
TA1307000156,2,20,false,6,6,0,41.96301,-87.68479
TA1308000012,2,20,false,32,15,-17,41.96398,-87.63818
13074,2,20,false,3,8,5,41.96521,-87.6582
TA1307000119,2,20,false,6,8,2,41.96796,-87.65
13108,2,20,false,1,5,4,41.97379,-87.65971
13109,2,20,false,1,5,4,41.97835,-87.65976
KA1504000152,2,20,false,10,10,0,41.98403,-87.65231
599,2,20,false,8,5,-3,42.03972,-87.69942
TA1308000009,2,20,true,9,8,-1,41.79522,-87.58075
TA1309000037,2,20,true,6,5,-1,41.79957,-87.59474
KA1503000007,2,20,true,4,14,10,41.80242,-87.58689
TA1309000055,2,20,true,4,5,1,41.8382,-87.64514
KA1503000038,2,20,true,6,4,-2,41.83845,-87.6354
TA1307000048,2,20,true,12,12,0,41.83855,-87.60821
TA1307000139,2,20,true,9,10,1,41.84205,-87.61698
TA1307000153,2,20,true,2,6,4,41.84358,-87.64538
TA1307000005,2,20,true,5,5,0,41.84569,-87.6225
13075,2,20,true,5,3,-2,41.8531,-87.63192
15545,2,20,true,11,11,0,41.85627,-87.61334
13102,2,20,true,4,11,7,41.85762,-87.61942
13150,2,20,true,4,9,5,41.85783,-87.62455
SL-012,2,20,true,6,7,1,41.86038,-87.62581
13431,2,20,true,6,5,-1,41.8661,-87.60728
WL-008,2,20,true,6,4,-2,41.86712,-87.64108
TA1305000002,2,20,true,20,15,-5,41.86721,-87.62597
15544,2,20,true,4,6,2,41.86723,-87.61536
KA1706005007,2,20,true,7,3,-4,41.86749,-87.63219
SL-005,2,20,true,8,18,10,41.8679,-87.62304
13139,2,20,true,3,9,6,41.86893,-87.65913
13160,2,20,true,7,9,2,41.86947,-87.65548
15550,2,20,true,9,6,-3,41.87024,-87.63947
TA1309000010,2,20,true,7,8,1,41.87074,-87.62574
SL-009,2,20,true,4,8,4,41.87081,-87.63121
TA1309000064,2,20,true,5,4,-1,41.87127,-87.67369
TA1307000130,2,20,true,3,6,3,41.87178,-87.65103
TA1307000121,2,20,true,16,1,-15,41.87184,-87.64664
SL-008,2,20,true,8,11,3,41.87209,-87.62956
13332,2,20,true,15,13,-2,41.87219,-87.6615
SL-011,2,20,true,10,14,4,41.87256,-87.63356
623,2,20,true,6,3,-3,41.87272,-87.62399
SL-007,2,20,true,6,8,2,41.87404,-87.6277
13028,2,20,true,9,6,-3,41.87475,-87.64981
15541,2,20,true,9,4,-5,41.8758,-87.62086
15539,2,20,true,6,7,1,41.87763,-87.64405
13158,2,20,true,5,8,3,41.87764,-87.64957
13157,2,20,true,7,10,3,41.87773,-87.6548
TA1305000025,2,20,true,2,7,5,41.87773,-87.63528
13206,2,20,true,3,5,2,41.87794,-87.66201
15667,2,20,true,2,6,4,41.8798,-87.68609
TA1309000007,2,20,true,5,3,-2,41.88022,-87.63526
WL-011,2,20,true,9,12,3,41.88034,-87.64273
13156,2,20,true,9,5,-4,41.88042,-87.65554
13300,2,20,true,13,16,3,41.88097,-87.61675
13008,2,20,true,15,7,-8,41.88105,-87.62408
TA1307000120,2,20,true,17,10,-7,41.88188,-87.64879
13341,2,20,true,9,5,-4,41.88208,-87.63985
TA1305000032,2,20,true,13,23,10,41.88218,-87.64109
13353,2,20,true,5,5,0,41.88283,-87.6612
654,2,20,true,1,7,6,41.88307,-87.65698
13409,2,20,true,6,7,1,41.8831,-87.6511
WL-012,2,20,true,7,2,-5,41.88337,-87.6412
13053,2,20,true,17,10,-7,41.88365,-87.64863
13001,2,20,true,10,5,-5,41.88397,-87.62459
13155,2,20,true,12,6,-6,41.88407,-87.65689
18062,2,20,true,8,5,-3,41.88412,-87.65427
TA1306000010,2,20,true,10,4,-6,41.88419,-87.62961
15535,2,20,true,12,9,-3,41.8846,-87.64455
TA1305000029,2,20,true,9,6,-3,41.88466,-87.62787
13263,2,20,true,13,16,3,41.88467,-87.61952
TA1306000015,2,20,true,9,5,-4,41.88549,-87.65232
13021,2,20,true,7,8,1,41.88559,-87.64184
TA1307000111,2,20,true,7,2,-5,41.88582,-87.63548
KA1503000012,2,20,true,4,5,1,41.88599,-87.63089
TA1305000011,2,20,true,9,7,-2,41.886,-87.62418
15534,2,20,true,5,11,6,41.88627,-87.61749
TA1308000029,2,20,true,5,4,-1,41.88673,-87.62225
TA1307000131,2,20,true,5,5,0,41.88688,-87.62606
KA1503000064,2,20,true,14,11,-3,41.88697,-87.61281
TA1305000022,2,20,true,7,11,4,41.88817,-87.63656
TA1306000003,2,20,true,13,15,2,41.88867,-87.64442
KA1503000043,2,20,true,17,17,0,41.88918,-87.63851
13050,2,20,true,4,6,2,41.88919,-87.62775
TA1307000151,2,20,true,9,12,3,41.88993,-87.63427
636,2,20,true,3,7,4,41.88997,-87.63662
13427,2,20,true,5,8,3,41.89054,-87.62205
13430,2,20,true,11,7,-4,41.89077,-87.63169
TA1306000013,2,20,true,16,21,5,41.89083,-87.61852
RN-,2,20,true,9,11,2,41.89102,-87.63546
TA1307000117,2,20,true,13,10,-3,41.89144,-87.62675
13033,2,20,true,17,8,-9,41.8916,-87.64835
13194,2,20,true,3,9,6,41.8918,-87.65878
TA1305000003,2,20,true,8,10,2,41.89187,-87.62061
13022,2,20,true,24,26,2,41.89227,-87.61205
TA1306000029,2,20,true,12,15,3,41.89256,-87.61449
13265,2,20,true,12,13,1,41.89383,-87.64172
13045,2,20,true,20,21,1,41.89403,-87.62931
KA1503000041,2,20,true,7,7,0,41.89452,-87.61798
13196,2,20,true,3,9,6,41.89455,-87.65345
TA1307000062,2,20,true,7,14,7,41.89466,-87.63839
TA1306000012,2,20,true,13,19,6,41.89475,-87.63438
KP1705001026,2,20,true,6,15,9,41.89483,-87.6323
13132,2,20,true,5,6,1,41.89573,-87.67718
15530,2,20,true,6,13,7,41.89575,-87.62596
13247,2,20,true,4,7,3,41.89597,-87.66775
TA1305000020,2,20,true,8,3,-5,41.89636,-87.65406
13289,2,20,true,6,15,9,41.89638,-87.661
13303,2,20,true,10,13,3,41.89672,-87.63088
13017,2,20,true,9,1,-8,41.89676,-87.6357
TA1307000061,2,20,true,6,8,2,41.89745,-87.62873
TA1306000009,2,20,true,7,5,-2,41.89772,-87.64299
620,2,20,true,6,9,3,41.89817,-87.63754
15529,2,20,true,11,9,-2,41.89858,-87.62206
TA1307000128,2,20,true,26,21,-5,41.89896,-87.6299
13248,2,20,true,3,9,6,41.89964,-87.66788
TA1306000011,2,20,true,9,20,11,41.89994,-87.63443
13042,2,20,true,21,10,-11,41.90097,-87.62377
KA1504000133,2,20,true,10,12,2,41.90234,-87.62773
TA1306000006,2,20,true,5,3,-2,41.90292,-87.63772
TA1307000039,2,20,true,14,31,17,41.90294,-87.63137
TA1305000034,2,20,true,6,10,4,41.90313,-87.67391
KA1504000135,2,20,true,27,31,4,41.90319,-87.63439
13136,2,20,true,3,12,9,41.90326,-87.67845
13061,2,20,true,19,18,-1,41.90342,-87.66779
KA1504000079,2,20,true,13,3,-10,41.9035,-87.64334
TA1308000049,2,20,true,24,23,-1,41.90672,-87.6349
KA1504000134,2,20,true,5,11,6,41.90687,-87.6262
TA1307000143,2,20,true,2,5,3,41.90762,-87.63854
13221,2,20,true,5,11,6,41.90765,-87.67254
TA1309000024,2,20,true,10,13,3,41.908,-87.63152
TA1305000041,2,20,true,4,7,3,41.9094,-87.67769
331,2,20,true,15,11,-4,41.90965,-87.64812
TA1305000037,2,20,true,7,7,0,41.91018,-87.67003
TA1308000005,2,20,true,4,11,7,41.91042,-87.68238
13154,2,20,true,14,10,-4,41.91054,-87.65312
13058,2,20,true,2,7,5,41.91059,-87.64942
TA1307000038,2,20,true,9,12,3,41.91138,-87.63868
LF-005,2,20,true,89,32,-57,41.91172,-87.62681
13128,2,20,true,12,9,-3,41.91197,-87.63197
TA1308000050,2,20,true,28,26,-2,41.91211,-87.6347
13243,2,20,true,8,16,8,41.91262,-87.6814
TA1306000032,2,20,true,6,5,-1,41.9137,-87.65285
TA1307000166,2,20,true,5,5,0,41.91386,-87.64877
15655,2,20,true,1,5,4,41.91401,-87.70514
13179,2,20,true,32,33,1,41.9157,-87.63461
13133,2,20,true,12,7,-5,41.91598,-87.67733
15651,2,20,true,4,7,3,41.91752,-87.70181
TA1309000029,2,20,true,5,6,1,41.9178,-87.68245
TA1309000006,2,20,true,7,7,0,41.91809,-87.64375
TA1307000163,2,20,true,4,5,1,41.91821,-87.65696
13146,2,20,true,13,13,0,41.91831,-87.63629
13059,2,20,true,10,17,7,41.91845,-87.65222
13192,2,20,true,7,6,-1,41.91995,-87.64884
13242,2,20,true,4,7,3,41.92021,-87.69266
TA1309000030,2,20,true,7,4,-3,41.92077,-87.66372
TA1309000033,2,20,true,15,9,-6,41.92158,-87.65381
13193,2,20,true,14,23,9,41.92182,-87.64412
13191,2,20,true,8,21,13,41.92217,-87.63891
TA1307000001,2,20,true,4,7,3,41.92535,-87.66581
TA1306000026,2,20,true,13,5,-8,41.92558,-87.65842
TA1306000016,2,20,true,8,4,-4,41.9256,-87.65371
TA1309000019,2,20,true,11,23,12,41.92586,-87.63897
TA1309000058,2,20,true,6,19,13,41.92591,-87.64927
TA1308000001,2,20,true,31,22,-9,41.92627,-87.63086
15646,2,20,true,6,4,-2,41.92668,-87.6977
TA1309000023,2,20,true,6,5,-1,41.9287,-87.65383
TA1307000113,2,20,true,16,3,-13,41.92878,-87.66391
TA1309000059,2,20,true,1,11,10,41.92889,-87.65898
TA1309000061,2,20,true,11,14,3,41.92915,-87.64909
TA1305000014,2,20,true,7,16,9,41.92956,-87.64313
13085,2,20,true,5,6,1,41.92958,-87.70789
TA1307000142,2,20,true,16,24,8,41.93125,-87.64432
13276,2,20,true,15,18,3,41.93132,-87.63874
TA1307000064,2,20,true,5,6,1,41.93222,-87.65864
TA1306000014,2,20,true,6,17,11,41.93242,-87.65271
TA1309000039,2,20,true,20,25,5,41.93258,-87.63642
13294,2,20,true,2,6,4,41.9326,-87.66595
TA1309000036,2,20,true,12,9,-3,41.93313,-87.64776
TA1307000006,2,20,true,6,10,4,41.93571,-87.6636
13268,2,20,true,6,8,2,41.93588,-87.67843
13269,2,20,true,6,4,-2,41.93609,-87.66983
TA1307000052,2,20,true,6,22,16,41.93628,-87.65266
TA1307000136,2,20,true,9,12,3,41.9365,-87.64755
TA1307000041,2,20,true,13,12,-1,41.93669,-87.63683
13137,2,20,true,24,27,3,41.9376,-87.6441
15642,2,20,true,6,3,-3,41.93843,-87.69801
TA1309000042,2,20,true,6,7,1,41.93937,-87.66836
13229,2,20,true,3,5,2,41.93946,-87.66376
TA1308000019,2,20,true,5,6,1,41.93973,-87.65886
13277,2,20,true,13,3,-10,41.9401,-87.64546
TA1307000134,2,20,true,15,14,-1,41.94016,-87.65303
13143,2,20,true,1,5,4,41.94059,-87.67853
TA1309000049,2,20,true,16,14,-2,41.94077,-87.63919
TA1307000138,2,20,true,3,10,7,41.94334,-87.67094
TA1309000025,2,20,true,8,12,4,41.94368,-87.64894
13071,2,20,true,11,7,-4,41.94373,-87.66401
632,2,20,true,10,6,-4,41.94453,-87.6547
15631,2,20,true,3,6,3,41.94524,-87.70665
13278,2,20,true,9,10,1,41.94553,-87.64644
15632,2,20,true,5,6,1,41.94664,-87.69463
13235,2,20,true,11,14,3,41.94814,-87.66396
13325,2,20,true,9,13,4,41.94907,-87.64863
TA1307000126,2,20,true,3,9,6,41.94936,-87.65451
TA1307000150,2,20,true,15,8,-7,41.94945,-87.64646
TA1307000127,2,20,true,4,7,3,41.9508,-87.65918
13323,2,20,true,8,3,-5,41.95282,-87.65
13063,2,20,true,7,10,3,41.95424,-87.65441
TA1308000022,2,20,true,5,10,5,41.95438,-87.64805
TA1309000026,2,20,true,1,6,5,41.95601,-87.6802
13379,2,20,true,8,14,6,41.95786,-87.6495
TA1309000027,2,20,true,1,9,8,41.9585,-87.65499
13389,2,20,true,2,10,8,41.961,-87.64958
KA1503000022,2,20,true,5,6,1,41.96158,-87.66609
TA1307000107,2,20,true,8,16,8,41.96164,-87.65464
TA1309000012,2,20,true,6,5,-1,41.96325,-87.67928
TA1308000012,2,20,true,17,12,-5,41.96398,-87.63818
13074,2,20,true,8,5,-3,41.96521,-87.6582
639,2,20,true,13,8,-5,41.96584,-87.64538
TA1307000158,2,20,true,1,8,7,41.9671,-87.67904
TA1309000066,2,20,true,6,9,3,41.9691,-87.67423
TA1309000041,2,20,true,5,2,-3,41.96951,-87.65471
KA1504000171,2,20,true,5,6,1,41.97161,-87.65016
TA1309000035,2,20,true,7,10,3,41.97335,-87.66785
13108,2,20,true,4,7,3,41.97379,-87.65971
KA1504000146,2,20,true,5,8,3,41.978,-87.66805
13109,2,20,true,2,6,4,41.97835,-87.65976
KA1504000151,2,20,true,3,5,2,41.98359,-87.66916
KA1504000152,2,20,true,9,8,-1,41.98403,-87.65231
15575,2,20,true,7,2,-5,41.98975,-87.66014
15571,2,20,true,2,5,3,41.99478,-87.66028
KA1504000175,2,20,true,3,8,5,42.00797,-87.66549
KA1503000030,2,21,false,1,5,4,41.77352,-87.57722
KA1503000029,2,21,false,1,6,5,41.77364,-87.56747
KA1503000014,2,21,false,7,8,1,41.7851,-87.60108
KA1503000004,2,21,false,6,11,5,41.83127,-87.6088
TA1307000048,2,21,false,10,16,6,41.83855,-87.60821
TA1308000036,2,21,false,7,3,-4,41.83883,-87.62186
TA1305000002,2,21,false,7,15,8,41.86721,-87.62597
SL-005,2,21,false,10,22,12,41.8679,-87.62304
TA1309000010,2,21,false,4,12,8,41.87074,-87.62574
SL-008,2,21,false,3,9,6,41.87209,-87.62956
SL-011,2,21,false,3,5,2,41.87256,-87.63356
623,2,21,false,10,16,6,41.87272,-87.62399
SL-007,2,21,false,4,18,14,41.87404,-87.6277
SL-010,2,21,false,1,5,4,41.87501,-87.63309
15541,2,21,false,21,26,5,41.8758,-87.62086
TA1305000010,2,21,false,2,9,7,41.87623,-87.62444
TA1305000035,2,21,false,3,5,2,41.87716,-87.62787
TA1305000025,2,21,false,3,6,3,41.87773,-87.63528
TA1309000002,2,21,false,13,18,5,41.87784,-87.62408
13300,2,21,false,11,19,8,41.88097,-87.61675
13008,2,21,false,28,25,-3,41.88105,-87.62408
TA1307000120,2,21,false,3,7,4,41.88188,-87.64879
TA1305000032,2,21,false,6,16,10,41.88218,-87.64109
13409,2,21,false,8,1,-7,41.8831,-87.6511
WL-012,2,21,false,4,6,2,41.88337,-87.6412
13053,2,21,false,5,7,2,41.88365,-87.64863
13001,2,21,false,13,7,-6,41.88397,-87.62459
13263,2,21,false,11,11,0,41.88467,-87.61952
13021,2,21,false,1,6,5,41.88559,-87.64184
KA1503000012,2,21,false,6,1,-5,41.88599,-87.63089
TA1305000011,2,21,false,7,10,3,41.886,-87.62418
15534,2,21,false,3,7,4,41.88627,-87.61749
TA1307000131,2,21,false,7,15,8,41.88688,-87.62606
KA1503000064,2,21,false,12,5,-7,41.88697,-87.61281
TA1305000022,2,21,false,3,17,14,41.88817,-87.63656
TA1306000003,2,21,false,4,8,4,41.88867,-87.64442
KA1503000043,2,21,false,12,7,-5,41.88918,-87.63851
13050,2,21,false,10,7,-3,41.88919,-87.62775
TA1307000151,2,21,false,6,6,0,41.88993,-87.63427
13430,2,21,false,13,8,-5,41.89077,-87.63169
TA1306000013,2,21,false,4,7,3,41.89083,-87.61852
RN-,2,21,false,8,7,-1,41.89102,-87.63546
TA1307000117,2,21,false,5,30,25,41.89144,-87.62675
TA1305000003,2,21,false,14,15,1,41.89187,-87.62061
13022,2,21,false,72,34,-38,41.89227,-87.61205
TA1306000029,2,21,false,11,10,-1,41.89256,-87.61449
13265,2,21,false,7,8,1,41.89383,-87.64172
13045,2,21,false,13,14,1,41.89403,-87.62931
13016,2,21,false,7,7,0,41.89431,-87.62277
KA1503000041,2,21,false,3,7,4,41.89452,-87.61798
13196,2,21,false,2,6,4,41.89455,-87.65345
TA1306000012,2,21,false,8,12,4,41.89475,-87.63438
KP1705001026,2,21,false,9,11,2,41.89483,-87.6323
15530,2,21,false,8,7,-1,41.89575,-87.62596
13247,2,21,false,2,6,4,41.89597,-87.66775
13338,2,21,false,3,5,2,41.89697,-87.62173
13034,2,21,false,7,1,-6,41.89754,-87.62352
620,2,21,false,2,8,6,41.89817,-87.63754
15529,2,21,false,6,5,-1,41.89858,-87.62206
TA1307000128,2,21,false,3,9,6,41.89896,-87.6299
13248,2,21,false,10,3,-7,41.89964,-87.66788
TA1306000011,2,21,false,6,7,1,41.89994,-87.63443
13290,2,21,false,5,3,-2,41.90069,-87.66259
13042,2,21,false,18,24,6,41.90097,-87.62377
KA1504000133,2,21,false,8,8,0,41.90234,-87.62773
TA1307000039,2,21,false,16,13,-3,41.90294,-87.63137
TA1305000034,2,21,false,5,4,-1,41.90313,-87.67391
KA1504000135,2,21,false,30,9,-21,41.90319,-87.63439
13136,2,21,false,5,2,-3,41.90326,-87.67845
13061,2,21,false,6,12,6,41.90342,-87.66779
KA1504000079,2,21,false,5,4,-1,41.9035,-87.64334
TA1307000115,2,21,false,5,5,0,41.9046,-87.64056
TA1308000049,2,21,false,35,15,-20,41.90672,-87.6349
KA1504000134,2,21,false,5,6,1,41.90687,-87.6262
13221,2,21,false,5,3,-2,41.90765,-87.67254
TA1305000041,2,21,false,6,2,-4,41.9094,-87.67769
331,2,21,false,5,6,1,41.90965,-87.64812
TA1305000037,2,21,false,3,8,5,41.91018,-87.67003
13058,2,21,false,6,11,5,41.91059,-87.64942
TA1307000038,2,21,false,9,6,-3,41.91138,-87.63868
LF-005,2,21,false,36,35,-1,41.91172,-87.62681
13128,2,21,false,17,5,-12,41.91197,-87.63197
TA1308000050,2,21,false,39,33,-6,41.91211,-87.6347
13243,2,21,false,1,5,4,41.91262,-87.6814
TA1306000032,2,21,false,7,5,-2,41.9137,-87.65285
TA1307000166,2,21,false,4,8,4,41.91386,-87.64877
15655,2,21,false,6,1,-5,41.91401,-87.70514
18067,2,21,false,1,5,4,41.9146,-87.66796
13179,2,21,false,40,22,-18,41.9157,-87.63461
15650,2,21,false,4,7,3,41.91711,-87.71023
15651,2,21,false,2,5,3,41.91752,-87.70181
TA1309000006,2,21,false,6,6,0,41.91809,-87.64375
TA1307000163,2,21,false,4,14,10,41.91821,-87.65696
13146,2,21,false,20,12,-8,41.91831,-87.63629
13059,2,21,false,10,11,1,41.91845,-87.65222
13192,2,21,false,4,5,1,41.91995,-87.64884
TA1309000033,2,21,false,4,13,9,41.92158,-87.65381
13193,2,21,false,21,20,-1,41.92182,-87.64412
13191,2,21,false,7,10,3,41.92217,-87.63891
LP-,2,21,false,22,14,-8,41.92396,-87.63584
TA1307000001,2,21,false,5,8,3,41.92535,-87.66581
TA1306000026,2,21,false,1,9,8,41.92558,-87.65842
TA1309000019,2,21,false,9,21,12,41.92586,-87.63897
TA1309000058,2,21,false,8,8,0,41.92591,-87.64927
TA1308000001,2,21,false,16,15,-1,41.92627,-87.63086
13124,2,21,false,7,9,2,41.92675,-87.63444
TA1309000023,2,21,false,14,13,-1,41.9287,-87.65383
TA1307000113,2,21,false,10,11,1,41.92878,-87.66391
TA1309000061,2,21,false,13,6,-7,41.92915,-87.64909
TA1305000014,2,21,false,7,11,4,41.92956,-87.64313
13085,2,21,false,3,11,8,41.92958,-87.70789
TA1307000142,2,21,false,5,18,13,41.93125,-87.64432
13276,2,21,false,10,9,-1,41.93132,-87.63874
TA1307000064,2,21,false,4,9,5,41.93222,-87.65864
TA1306000014,2,21,false,9,8,-1,41.93242,-87.65271
TA1309000039,2,21,false,13,3,-10,41.93258,-87.63642
TA1309000036,2,21,false,3,6,3,41.93313,-87.64776
13268,2,21,false,5,4,-1,41.93588,-87.67843
TA1307000052,2,21,false,6,3,-3,41.93628,-87.65266
TA1307000136,2,21,false,9,10,1,41.9365,-87.64755
TA1307000041,2,21,false,1,7,6,41.93669,-87.63683
13137,2,21,false,10,16,6,41.9376,-87.6441
TA1308000019,2,21,false,4,11,7,41.93973,-87.65886
13277,2,21,false,5,12,7,41.9401,-87.64546
TA1307000134,2,21,false,10,8,-2,41.94016,-87.65303
TA1309000049,2,21,false,3,11,8,41.94077,-87.63919
TA1309000025,2,21,false,8,9,1,41.94368,-87.64894
13071,2,21,false,9,6,-3,41.94373,-87.66401
632,2,21,false,12,14,2,41.94453,-87.6547
13278,2,21,false,5,4,-1,41.94553,-87.64644
TA1309000050,2,21,false,1,5,4,41.94618,-87.67331
13235,2,21,false,1,11,10,41.94814,-87.66396
13325,2,21,false,3,7,4,41.94907,-87.64863
TA1307000126,2,21,false,29,13,-16,41.94936,-87.65451
TA1307000150,2,21,false,4,8,4,41.94945,-87.64646
TA1307000127,2,21,false,6,1,-5,41.9508,-87.65918
13323,2,21,false,7,7,0,41.95282,-87.65
TA1308000022,2,21,false,4,18,14,41.95438,-87.64805
13379,2,21,false,3,6,3,41.95786,-87.6495
TA1307000107,2,21,false,3,12,9,41.96164,-87.65464
TA1308000012,2,21,false,6,8,2,41.96398,-87.63818
639,2,21,false,8,8,0,41.96584,-87.64538
15578,2,21,false,1,7,6,41.98405,-87.66027
604,2,21,false,3,5,2,42.05824,-87.67744
13216,2,21,true,10,5,-5,41.83473,-87.62581
13217,2,21,true,7,11,4,41.83488,-87.61792
TA1309000055,2,21,true,5,2,-3,41.8382,-87.64514
KA1503000038,2,21,true,3,9,6,41.83845,-87.6354
TA1307000139,2,21,true,2,10,8,41.84205,-87.61698
15443,2,21,true,1,6,5,41.84275,-87.63549
WL-008,2,21,true,8,1,-7,41.86712,-87.64108
TA1305000002,2,21,true,10,14,4,41.86721,-87.62597
SL-005,2,21,true,5,12,7,41.8679,-87.62304
644,2,21,true,1,5,4,41.86859,-87.68625
13160,2,21,true,7,3,-4,41.86947,-87.65548
SL-009,2,21,true,5,9,4,41.87081,-87.63121
SL-008,2,21,true,9,9,0,41.87209,-87.62956
13332,2,21,true,6,10,4,41.87219,-87.6615
SL-011,2,21,true,7,10,3,41.87256,-87.63356
623,2,21,true,3,7,4,41.87272,-87.62399
13028,2,21,true,4,5,1,41.87475,-87.64981
13158,2,21,true,6,9,3,41.87764,-87.64957
13157,2,21,true,7,6,-1,41.87773,-87.6548
TA1305000025,2,21,true,7,7,0,41.87773,-87.63528
TA1309000007,2,21,true,7,2,-5,41.88022,-87.63526
WL-011,2,21,true,2,12,10,41.88034,-87.64273
13300,2,21,true,10,11,1,41.88097,-87.61675
13008,2,21,true,9,2,-7,41.88105,-87.62408
TA1307000120,2,21,true,11,4,-7,41.88188,-87.64879
TA1305000032,2,21,true,13,9,-4,41.88218,-87.64109
13409,2,21,true,3,5,2,41.8831,-87.6511
13053,2,21,true,16,13,-3,41.88365,-87.64863
13001,2,21,true,6,4,-2,41.88397,-87.62459
18062,2,21,true,7,5,-2,41.88412,-87.65427
TA1306000010,2,21,true,8,5,-3,41.88419,-87.62961
15535,2,21,true,7,7,0,41.8846,-87.64455
TA1305000029,2,21,true,10,1,-9,41.88466,-87.62787
13263,2,21,true,8,6,-2,41.88467,-87.61952
13021,2,21,true,7,4,-3,41.88559,-87.64184
TA1307000111,2,21,true,6,8,2,41.88582,-87.63548
KA1503000012,2,21,true,3,5,2,41.88599,-87.63089
TA1305000011,2,21,true,9,6,-3,41.886,-87.62418
15534,2,21,true,2,6,4,41.88627,-87.61749
TA1307000131,2,21,true,6,5,-1,41.88688,-87.62606
TA1305000022,2,21,true,9,10,1,41.88817,-87.63656
TA1306000003,2,21,true,18,12,-6,41.88867,-87.64442
KA1503000043,2,21,true,25,26,1,41.88918,-87.63851
13050,2,21,true,9,6,-3,41.88919,-87.62775
TA1307000151,2,21,true,8,4,-4,41.88993,-87.63427
13430,2,21,true,11,7,-4,41.89077,-87.63169
TA1306000013,2,21,true,8,10,2,41.89083,-87.61852
RN-,2,21,true,3,5,2,41.89102,-87.63546
13434,2,21,true,1,5,4,41.89108,-87.66663
TA1307000117,2,21,true,14,15,1,41.89144,-87.62675
13033,2,21,true,18,9,-9,41.8916,-87.64835
TA1305000003,2,21,true,1,8,7,41.89187,-87.62061
13022,2,21,true,14,8,-6,41.89227,-87.61205
TA1306000029,2,21,true,8,12,4,41.89256,-87.61449
13265,2,21,true,9,17,8,41.89383,-87.64172
13045,2,21,true,8,12,4,41.89403,-87.62931
13016,2,21,true,1,6,5,41.89431,-87.62277
KA1503000041,2,21,true,7,6,-1,41.89452,-87.61798
13196,2,21,true,5,3,-2,41.89455,-87.65345
TA1307000062,2,21,true,3,6,3,41.89466,-87.63839
TA1306000012,2,21,true,8,21,13,41.89475,-87.63438
KP1705001026,2,21,true,2,7,5,41.89483,-87.6323
15530,2,21,true,5,8,3,41.89575,-87.62596
13289,2,21,true,8,3,-5,41.89638,-87.661
13303,2,21,true,5,7,2,41.89672,-87.63088
13338,2,21,true,1,7,6,41.89697,-87.62173
13034,2,21,true,6,3,-3,41.89754,-87.62352
TA1306000009,2,21,true,1,5,4,41.89772,-87.64299
620,2,21,true,1,5,4,41.89817,-87.63754
15529,2,21,true,2,7,5,41.89858,-87.62206
TA1307000128,2,21,true,4,11,7,41.89896,-87.6299
TA1306000011,2,21,true,9,3,-6,41.89994,-87.63443
13290,2,21,true,3,11,8,41.90069,-87.66259
KA1504000133,2,21,true,5,7,2,41.90234,-87.62773
TA1306000006,2,21,true,6,4,-2,41.90292,-87.63772
TA1307000039,2,21,true,17,25,8,41.90294,-87.63137
KA1504000135,2,21,true,11,15,4,41.90319,-87.63439
13136,2,21,true,5,5,0,41.90326,-87.67845
13061,2,21,true,9,20,11,41.90342,-87.66779
KA1504000079,2,21,true,1,7,6,41.9035,-87.64334
TA1308000049,2,21,true,17,16,-1,41.90672,-87.6349
KA1504000134,2,21,true,2,13,11,41.90687,-87.6262
13224,2,21,true,5,9,4,41.90706,-87.66725
TA1307000143,2,21,true,2,5,3,41.90762,-87.63854
13221,2,21,true,5,4,-1,41.90765,-87.67254
TA1309000024,2,21,true,6,7,1,41.908,-87.63152
TA1305000041,2,21,true,6,4,-2,41.9094,-87.67769
331,2,21,true,6,4,-2,41.90965,-87.64812
TA1305000037,2,21,true,6,7,1,41.91018,-87.67003
TA1308000005,2,21,true,3,6,3,41.91042,-87.68238
13058,2,21,true,4,6,2,41.91059,-87.64942
TA1307000038,2,21,true,3,9,6,41.91138,-87.63868
LF-005,2,21,true,11,17,6,41.91172,-87.62681
13128,2,21,true,9,2,-7,41.91197,-87.63197
TA1308000050,2,21,true,32,23,-9,41.91211,-87.6347
13243,2,21,true,6,3,-3,41.91262,-87.6814
TA1306000032,2,21,true,6,3,-3,41.9137,-87.65285
TA1307000166,2,21,true,6,6,0,41.91386,-87.64877
TA1306000007,2,21,true,1,6,5,41.91469,-87.64333
13179,2,21,true,16,28,12,41.9157,-87.63461
13133,2,21,true,8,3,-5,41.91598,-87.67733
TA1309000006,2,21,true,4,10,6,41.91809,-87.64375
TA1307000163,2,21,true,8,7,-1,41.91821,-87.65696
13146,2,21,true,23,14,-9,41.91831,-87.63629
13059,2,21,true,6,9,3,41.91845,-87.65222
13192,2,21,true,7,7,0,41.91995,-87.64884
TA1309000030,2,21,true,6,3,-3,41.92077,-87.66372
TA1309000033,2,21,true,6,8,2,41.92158,-87.65381
13193,2,21,true,10,14,4,41.92182,-87.64412
13191,2,21,true,5,5,0,41.92217,-87.63891
13084,2,21,true,5,3,-2,41.92268,-87.69715
TA1307000001,2,21,true,7,6,-1,41.92535,-87.66581
TA1306000026,2,21,true,9,7,-2,41.92558,-87.65842
TA1306000016,2,21,true,5,7,2,41.9256,-87.65371
TA1309000019,2,21,true,9,9,0,41.92586,-87.63897
TA1309000058,2,21,true,15,6,-9,41.92591,-87.64927
TA1308000001,2,21,true,12,4,-8,41.92627,-87.63086
TA1309000023,2,21,true,20,6,-14,41.9287,-87.65383
TA1307000113,2,21,true,11,3,-8,41.92878,-87.66391
13296,2,21,true,1,5,4,41.92883,-87.66852
TA1309000061,2,21,true,6,6,0,41.92915,-87.64909
TA1308000031,2,21,true,7,2,-5,41.92946,-87.68417
TA1305000014,2,21,true,10,12,2,41.92956,-87.64313
TA1307000142,2,21,true,15,12,-3,41.93125,-87.64432
13276,2,21,true,8,5,-3,41.93132,-87.63874
TA1307000064,2,21,true,5,9,4,41.93222,-87.65864
TA1306000014,2,21,true,5,7,2,41.93242,-87.65271
TA1309000039,2,21,true,8,6,-2,41.93258,-87.63642
TA1309000036,2,21,true,4,5,1,41.93313,-87.64776
13268,2,21,true,3,7,4,41.93588,-87.67843
TA1307000052,2,21,true,6,5,-1,41.93628,-87.65266
TA1307000136,2,21,true,5,7,2,41.9365,-87.64755
TA1307000041,2,21,true,8,7,-1,41.93669,-87.63683
13137,2,21,true,11,12,1,41.9376,-87.6441
TA1309000042,2,21,true,7,6,-1,41.93937,-87.66836
13277,2,21,true,10,17,7,41.9401,-87.64546
TA1307000134,2,21,true,7,10,3,41.94016,-87.65303
13144,2,21,true,7,4,-3,41.9434,-87.67964
TA1309000025,2,21,true,11,8,-3,41.94368,-87.64894
13071,2,21,true,8,8,0,41.94373,-87.66401
632,2,21,true,18,11,-7,41.94453,-87.6547
13278,2,21,true,5,6,1,41.94553,-87.64644
15632,2,21,true,6,4,-2,41.94664,-87.69463
13235,2,21,true,1,5,4,41.94814,-87.66396
TA1307000126,2,21,true,20,4,-16,41.94936,-87.65451
TA1307000150,2,21,true,6,11,5,41.94945,-87.64646
13319,2,21,true,1,8,7,41.95069,-87.6687
TA1307000127,2,21,true,2,14,12,41.9508,-87.65918
13063,2,21,true,2,5,3,41.95424,-87.65441
TA1308000022,2,21,true,4,6,2,41.95438,-87.64805
13379,2,21,true,7,5,-2,41.95786,-87.6495
TA1309000027,2,21,true,2,11,9,41.9585,-87.65499
13389,2,21,true,3,9,6,41.961,-87.64958
TA1307000107,2,21,true,6,2,-4,41.96164,-87.65464
TA1308000012,2,21,true,16,2,-14,41.96398,-87.63818
13074,2,21,true,4,6,2,41.96521,-87.6582
639,2,21,true,5,3,-2,41.96584,-87.64538
TA1307000158,2,21,true,2,8,6,41.9671,-87.67904
TA1309000041,2,21,true,1,9,8,41.96951,-87.65471
KA1504000146,2,21,true,6,4,-2,41.978,-87.66805
KA1504000152,2,21,true,3,7,4,41.98403,-87.65231
15571,2,21,true,1,7,6,41.99478,-87.66028
TA1308000009,2,22,false,4,5,1,41.79522,-87.58075
TA1309000037,2,22,false,5,1,-4,41.79957,-87.59474
KA1503000005,2,22,false,7,1,-6,41.83079,-87.6325
TA1307000048,2,22,false,5,14,9,41.83855,-87.60821
TA1305000004,2,22,false,4,6,2,41.8514,-87.61884
13150,2,22,false,7,4,-3,41.85783,-87.62455
13029,2,22,false,1,5,4,41.86531,-87.6179
TA1305000002,2,22,false,14,7,-7,41.86721,-87.62597
15544,2,22,false,1,6,5,41.86723,-87.61536
SL-005,2,22,false,7,23,16,41.8679,-87.62304
TA1309000010,2,22,false,9,5,-4,41.87074,-87.62574
SL-008,2,22,false,4,11,7,41.87209,-87.62956
623,2,22,false,14,18,4,41.87272,-87.62399
SL-007,2,22,false,6,3,-3,41.87404,-87.6277
15541,2,22,false,10,15,5,41.8758,-87.62086
TA1305000010,2,22,false,8,9,1,41.87623,-87.62444
TA1305000035,2,22,false,7,3,-4,41.87716,-87.62787
TA1309000002,2,22,false,6,2,-4,41.87784,-87.62408
13300,2,22,false,12,9,-3,41.88097,-87.61675
13008,2,22,false,40,27,-13,41.88105,-87.62408
TA1307000120,2,22,false,10,4,-6,41.88188,-87.64879
13341,2,22,false,5,2,-3,41.88208,-87.63985
13053,2,22,false,19,12,-7,41.88365,-87.64863
13001,2,22,false,14,5,-9,41.88397,-87.62459
15535,2,22,false,7,4,-3,41.8846,-87.64455
13263,2,22,false,12,11,-1,41.88467,-87.61952
TA1306000015,2,22,false,6,2,-4,41.88549,-87.65232
13021,2,22,false,3,6,3,41.88559,-87.64184
TA1307000111,2,22,false,7,6,-1,41.88582,-87.63548
KA1503000012,2,22,false,8,6,-2,41.88599,-87.63089
TA1305000011,2,22,false,12,14,2,41.886,-87.62418
15534,2,22,false,7,3,-4,41.88627,-87.61749
TA1307000131,2,22,false,23,10,-13,41.88688,-87.62606
TA1305000022,2,22,false,4,5,1,41.88817,-87.63656
TA1306000003,2,22,false,12,11,-1,41.88867,-87.64442
KA1503000043,2,22,false,2,7,5,41.88918,-87.63851
13050,2,22,false,5,8,3,41.88919,-87.62775
13427,2,22,false,5,7,2,41.89054,-87.62205
13430,2,22,false,15,4,-11,41.89077,-87.63169
TA1306000013,2,22,false,20,12,-8,41.89083,-87.61852
RN-,2,22,false,5,5,0,41.89102,-87.63546
TA1307000117,2,22,false,15,24,9,41.89144,-87.62675
13033,2,22,false,5,1,-4,41.8916,-87.64835
TA1305000003,2,22,false,2,6,4,41.89187,-87.62061
13022,2,22,false,35,43,8,41.89227,-87.61205
TA1306000029,2,22,false,8,7,-1,41.89256,-87.61449
13265,2,22,false,2,8,6,41.89383,-87.64172
13016,2,22,false,1,9,8,41.89431,-87.62277
KA1503000041,2,22,false,5,5,0,41.89452,-87.61798
13196,2,22,false,2,6,4,41.89455,-87.65345
TA1307000062,2,22,false,2,5,3,41.89466,-87.63839
TA1306000012,2,22,false,16,15,-1,41.89475,-87.63438
KP1705001026,2,22,false,21,8,-13,41.89483,-87.6323
15530,2,22,false,10,3,-7,41.89575,-87.62596
TA1305000020,2,22,false,2,11,9,41.89636,-87.65406
13289,2,22,false,3,6,3,41.89638,-87.661
13303,2,22,false,5,5,0,41.89672,-87.63088
TA1307000061,2,22,false,12,2,-10,41.89745,-87.62873
620,2,22,false,3,8,5,41.89817,-87.63754
15529,2,22,false,6,8,2,41.89858,-87.62206
TA1307000128,2,22,false,1,6,5,41.89896,-87.6299
13248,2,22,false,1,5,4,41.89964,-87.66788
TA1306000011,2,22,false,7,6,-1,41.89994,-87.63443
13290,2,22,false,3,5,2,41.90069,-87.66259
13042,2,22,false,18,18,0,41.90097,-87.62377
KA1504000133,2,22,false,7,5,-2,41.90234,-87.62773
TA1306000006,2,22,false,6,3,-3,41.90292,-87.63772
TA1307000039,2,22,false,22,11,-11,41.90294,-87.63137
KA1504000135,2,22,false,15,16,1,41.90319,-87.63439
13061,2,22,false,4,19,15,41.90342,-87.66779
KA1504000079,2,22,false,1,7,6,41.9035,-87.64334
TA1308000049,2,22,false,24,14,-10,41.90672,-87.6349
13224,2,22,false,4,6,2,41.90706,-87.66725
13221,2,22,false,5,7,2,41.90765,-87.67254
TA1309000024,2,22,false,19,10,-9,41.908,-87.63152
TA1305000041,2,22,false,11,10,-1,41.9094,-87.67769
331,2,22,false,4,6,2,41.90965,-87.64812
15653,2,22,false,1,5,4,41.90979,-87.7053
TA1305000037,2,22,false,3,8,5,41.91018,-87.67003
TA1306000008,2,22,false,2,6,4,41.9102,-87.6435
TA1308000005,2,22,false,2,6,4,41.91042,-87.68238
13058,2,22,false,16,4,-12,41.91059,-87.64942
TA1307000038,2,22,false,9,13,4,41.91138,-87.63868
LF-005,2,22,false,16,6,-10,41.91172,-87.62681
13128,2,22,false,13,4,-9,41.91197,-87.63197
TA1308000050,2,22,false,15,16,1,41.91211,-87.6347
13243,2,22,false,4,8,4,41.91262,-87.6814
TA1306000032,2,22,false,2,5,3,41.9137,-87.65285
TA1307000166,2,22,false,3,7,4,41.91386,-87.64877
18067,2,22,false,2,15,13,41.9146,-87.66796
13179,2,22,false,34,20,-14,41.9157,-87.63461
TA1305000039,2,22,false,1,6,5,41.9163,-87.66749
TA1309000029,2,22,false,1,6,5,41.9178,-87.68245
TA1309000006,2,22,false,4,9,5,41.91809,-87.64375
13146,2,22,false,23,18,-5,41.91831,-87.63629
13059,2,22,false,10,2,-8,41.91845,-87.65222
13192,2,22,false,5,5,0,41.91995,-87.64884
TA1309000030,2,22,false,5,2,-3,41.92077,-87.66372
TA1309000033,2,22,false,8,2,-6,41.92158,-87.65381
13193,2,22,false,12,10,-2,41.92182,-87.64412
13191,2,22,false,3,9,6,41.92217,-87.63891
13084,2,22,false,5,5,0,41.92268,-87.69715
LP-,2,22,false,2,7,5,41.92396,-87.63584
TA1307000001,2,22,false,1,7,6,41.92535,-87.66581
TA1306000026,2,22,false,10,6,-4,41.92558,-87.65842
TA1306000016,2,22,false,11,5,-6,41.9256,-87.65371
TA1309000058,2,22,false,7,5,-2,41.92591,-87.64927
13124,2,22,false,2,19,17,41.92675,-87.63444
TA1309000023,2,22,false,5,13,8,41.9287,-87.65383
TA1307000113,2,22,false,12,11,-1,41.92878,-87.66391
13296,2,22,false,2,6,4,41.92883,-87.66852
TA1309000061,2,22,false,6,7,1,41.92915,-87.64909
TA1307000142,2,22,false,11,9,-2,41.93125,-87.64432
13276,2,22,false,7,8,1,41.93132,-87.63874
TA1306000014,2,22,false,5,10,5,41.93242,-87.65271
TA1309000039,2,22,false,6,10,4,41.93258,-87.63642
TA1309000036,2,22,false,9,4,-5,41.93313,-87.64776
TA1307000006,2,22,false,5,14,9,41.93571,-87.6636
TA1307000052,2,22,false,20,7,-13,41.93628,-87.65266
TA1307000136,2,22,false,19,13,-6,41.9365,-87.64755
13137,2,22,false,9,13,4,41.9376,-87.6441
TA1309000042,2,22,false,5,3,-2,41.93937,-87.66836
TA1308000019,2,22,false,19,13,-6,41.93973,-87.65886
13277,2,22,false,5,12,7,41.9401,-87.64546
TA1307000134,2,22,false,26,8,-18,41.94016,-87.65303
TA1309000049,2,22,false,5,7,2,41.94077,-87.63919
15634,2,22,false,2,5,3,41.94304,-87.68729
TA1307000138,2,22,false,6,5,-1,41.94334,-87.67094
TA1309000025,2,22,false,14,7,-7,41.94368,-87.64894
13071,2,22,false,24,7,-17,41.94373,-87.66401
632,2,22,false,20,17,-3,41.94453,-87.6547
13278,2,22,false,7,4,-3,41.94553,-87.64644
KA1504000143,2,22,false,5,7,2,41.94664,-87.68337
13235,2,22,false,16,5,-11,41.94814,-87.66396
13325,2,22,false,12,5,-7,41.94907,-87.64863
TA1307000126,2,22,false,18,11,-7,41.94936,-87.65451
TA1307000127,2,22,false,25,4,-21,41.9508,-87.65918
13323,2,22,false,1,6,5,41.95282,-87.65
13063,2,22,false,5,10,5,41.95424,-87.65441
TA1308000047,2,22,false,5,2,-3,41.95709,-87.6642
TA1309000027,2,22,false,1,5,4,41.9585,-87.65499
13389,2,22,false,3,5,2,41.961,-87.64958
TA1307000107,2,22,false,7,6,-1,41.96164,-87.65464
TA1308000012,2,22,false,10,3,-7,41.96398,-87.63818
13074,2,22,false,2,5,3,41.96521,-87.6582
TA1309000066,2,22,false,6,1,-5,41.9691,-87.67423
KA1504000146,2,22,false,4,8,4,41.978,-87.66805
KA1504000151,2,22,false,1,6,5,41.98359,-87.66916
KA1504000152,2,22,false,6,7,1,41.98403,-87.65231
15578,2,22,false,1,5,4,41.98405,-87.66027
13150,2,22,true,1,5,4,41.85783,-87.62455
TA1306000002,2,22,true,5,3,-2,41.86238,-87.65108
TA1309000001,2,22,true,6,1,-5,41.86488,-87.64708
SL-005,2,22,true,2,6,4,41.8679,-87.62304
TA1309000010,2,22,true,6,4,-2,41.87074,-87.62574
TA1307000130,2,22,true,4,7,3,41.87178,-87.65103
SL-008,2,22,true,4,6,2,41.87209,-87.62956
13332,2,22,true,4,7,3,41.87219,-87.6615
SL-011,2,22,true,5,5,0,41.87256,-87.63356
13028,2,22,true,1,8,7,41.87475,-87.64981
13158,2,22,true,3,7,4,41.87764,-87.64957
WL-011,2,22,true,2,7,5,41.88034,-87.64273
13300,2,22,true,8,4,-4,41.88097,-87.61675
TA1307000120,2,22,true,6,11,5,41.88188,-87.64879
TA1305000032,2,22,true,6,6,0,41.88218,-87.64109
13353,2,22,true,1,5,4,41.88283,-87.6612
13053,2,22,true,10,5,-5,41.88365,-87.64863
15535,2,22,true,4,5,1,41.8846,-87.64455
13263,2,22,true,6,4,-2,41.88467,-87.61952
TA1306000015,2,22,true,5,2,-3,41.88549,-87.65232
13021,2,22,true,7,8,1,41.88559,-87.64184
TA1305000011,2,22,true,4,8,4,41.886,-87.62418
15534,2,22,true,1,8,7,41.88627,-87.61749
TA1307000131,2,22,true,3,6,3,41.88688,-87.62606
TA1305000022,2,22,true,6,4,-2,41.88817,-87.63656
TA1306000003,2,22,true,16,14,-2,41.88867,-87.64442
KA1503000043,2,22,true,6,9,3,41.88918,-87.63851
13050,2,22,true,8,3,-5,41.88919,-87.62775
TA1307000151,2,22,true,6,5,-1,41.88993,-87.63427
13430,2,22,true,8,5,-3,41.89077,-87.63169
TA1306000013,2,22,true,14,1,-13,41.89083,-87.61852
RN-,2,22,true,5,2,-3,41.89102,-87.63546
TA1307000117,2,22,true,13,3,-10,41.89144,-87.62675
13033,2,22,true,5,11,6,41.8916,-87.64835
13265,2,22,true,2,11,9,41.89383,-87.64172
13045,2,22,true,4,8,4,41.89403,-87.62931
13016,2,22,true,5,4,-1,41.89431,-87.62277
KA1503000041,2,22,true,6,5,-1,41.89452,-87.61798
TA1306000012,2,22,true,3,5,2,41.89475,-87.63438
15530,2,22,true,3,6,3,41.89575,-87.62596
13289,2,22,true,2,6,4,41.89638,-87.661
13303,2,22,true,6,11,5,41.89672,-87.63088
13017,2,22,true,5,3,-2,41.89676,-87.6357
TA1307000061,2,22,true,4,5,1,41.89745,-87.62873
620,2,22,true,7,3,-4,41.89817,-87.63754
TA1307000128,2,22,true,7,6,-1,41.89896,-87.6299
KA1504000133,2,22,true,9,14,5,41.90234,-87.62773
TA1307000039,2,22,true,13,19,6,41.90294,-87.63137
KA1504000135,2,22,true,21,13,-8,41.90319,-87.63439
13061,2,22,true,10,14,4,41.90342,-87.66779
TA1308000049,2,22,true,18,10,-8,41.90672,-87.6349
13224,2,22,true,1,9,8,41.90706,-87.66725
TA1309000024,2,22,true,12,1,-11,41.908,-87.63152
331,2,22,true,1,6,5,41.90965,-87.64812
TA1306000008,2,22,true,1,5,4,41.9102,-87.6435
TA1307000038,2,22,true,13,6,-7,41.91138,-87.63868
LF-005,2,22,true,13,5,-8,41.91172,-87.62681
13128,2,22,true,10,4,-6,41.91197,-87.63197
TA1308000050,2,22,true,16,11,-5,41.91211,-87.6347
13243,2,22,true,4,7,3,41.91262,-87.6814
TA1306000032,2,22,true,1,5,4,41.9137,-87.65285
13068,2,22,true,2,6,4,41.91554,-87.68703
13179,2,22,true,25,13,-12,41.9157,-87.63461
13133,2,22,true,2,5,3,41.91598,-87.67733
TA1309000029,2,22,true,3,5,2,41.9178,-87.68245
TA1309000006,2,22,true,5,3,-2,41.91809,-87.64375
TA1307000163,2,22,true,5,7,2,41.91821,-87.65696
13146,2,22,true,18,10,-8,41.91831,-87.63629
13059,2,22,true,4,6,2,41.91845,-87.65222
13192,2,22,true,9,4,-5,41.91995,-87.64884
TA1309000030,2,22,true,1,7,6,41.92077,-87.66372
TA1309000033,2,22,true,3,7,4,41.92158,-87.65381
13193,2,22,true,10,7,-3,41.92182,-87.64412
13191,2,22,true,3,8,5,41.92217,-87.63891
13084,2,22,true,5,5,0,41.92268,-87.69715
TA1307000001,2,22,true,4,7,3,41.92535,-87.66581
TA1306000026,2,22,true,1,10,9,41.92558,-87.65842
TA1309000058,2,22,true,13,5,-8,41.92591,-87.64927
TA1309000023,2,22,true,9,4,-5,41.9287,-87.65383
TA1307000113,2,22,true,6,10,4,41.92878,-87.66391
TA1309000061,2,22,true,4,6,2,41.92915,-87.64909
TA1305000014,2,22,true,2,11,9,41.92956,-87.64313
13085,2,22,true,5,4,-1,41.92958,-87.70789
TA1307000142,2,22,true,3,17,14,41.93125,-87.64432
13276,2,22,true,2,7,5,41.93132,-87.63874
TA1306000014,2,22,true,9,4,-5,41.93242,-87.65271
TA1309000039,2,22,true,2,6,4,41.93258,-87.63642
TA1309000036,2,22,true,5,6,1,41.93313,-87.64776
TA1307000006,2,22,true,2,9,7,41.93571,-87.6636
TA1307000052,2,22,true,4,7,3,41.93628,-87.65266
TA1307000136,2,22,true,7,9,2,41.9365,-87.64755
13137,2,22,true,3,8,5,41.9376,-87.6441
TA1309000042,2,22,true,8,2,-6,41.93937,-87.66836
TA1308000019,2,22,true,15,3,-12,41.93973,-87.65886
13277,2,22,true,5,6,1,41.9401,-87.64546
TA1307000134,2,22,true,14,11,-3,41.94016,-87.65303
TA1309000049,2,22,true,3,6,3,41.94077,-87.63919
TA1307000138,2,22,true,6,6,0,41.94334,-87.67094
TA1309000025,2,22,true,10,6,-4,41.94368,-87.64894
13071,2,22,true,9,2,-7,41.94373,-87.66401
632,2,22,true,20,9,-11,41.94453,-87.6547
13235,2,22,true,16,4,-12,41.94814,-87.66396
13325,2,22,true,6,3,-3,41.94907,-87.64863
TA1307000126,2,22,true,14,7,-7,41.94936,-87.65451
TA1307000150,2,22,true,6,6,0,41.94945,-87.64646
TA1307000127,2,22,true,19,2,-17,41.9508,-87.65918
13323,2,22,true,2,8,6,41.95282,-87.65
TA1309000043,2,22,true,1,5,4,41.95417,-87.66434
13063,2,22,true,6,5,-1,41.95424,-87.65441
TA1309000027,2,22,true,1,5,4,41.9585,-87.65499
KA1503000022,2,22,true,1,5,4,41.96158,-87.66609
TA1307000156,2,22,true,1,5,4,41.96301,-87.68479
13074,2,22,true,4,5,1,41.96521,-87.6582
TA1309000041,2,22,true,2,5,3,41.96951,-87.65471
KA1503000014,2,23,false,1,5,4,41.7851,-87.60108
TA1308000009,2,23,false,6,2,-4,41.79522,-87.58075
TA1307000164,2,23,false,1,6,5,41.79527,-87.59647
SL-013,2,23,false,1,5,4,41.85659,-87.62755
TA1305000002,2,23,false,13,11,-2,41.86721,-87.62597
SL-005,2,23,false,3,7,4,41.8679,-87.62304
13160,2,23,false,2,5,3,41.86947,-87.65548
TA1309000010,2,23,false,1,5,4,41.87074,-87.62574
SL-008,2,23,false,7,6,-1,41.87209,-87.62956
623,2,23,false,13,26,13,41.87272,-87.62399
15541,2,23,false,4,15,11,41.8758,-87.62086
TA1305000010,2,23,false,8,4,-4,41.87623,-87.62444
TA1309000002,2,23,false,9,2,-7,41.87784,-87.62408
13008,2,23,false,14,34,20,41.88105,-87.62408
TA1307000120,2,23,false,3,6,3,41.88188,-87.64879
13341,2,23,false,2,6,4,41.88208,-87.63985
TA1305000032,2,23,false,3,6,3,41.88218,-87.64109
13001,2,23,false,12,11,-1,41.88397,-87.62459
13263,2,23,false,1,6,5,41.88467,-87.61952
TA1306000015,2,23,false,10,2,-8,41.88549,-87.65232
13021,2,23,false,6,5,-1,41.88559,-87.64184
TA1307000111,2,23,false,2,7,5,41.88582,-87.63548
KA1503000012,2,23,false,1,5,4,41.88599,-87.63089
TA1305000011,2,23,false,9,8,-1,41.886,-87.62418
15534,2,23,false,6,11,5,41.88627,-87.61749
TA1308000029,2,23,false,1,7,6,41.88673,-87.62225
TA1307000131,2,23,false,8,6,-2,41.88688,-87.62606
13050,2,23,false,6,9,3,41.88919,-87.62775
TA1307000151,2,23,false,2,5,3,41.88993,-87.63427
13430,2,23,false,5,2,-3,41.89077,-87.63169
TA1306000013,2,23,false,5,8,3,41.89083,-87.61852
TA1307000117,2,23,false,8,18,10,41.89144,-87.62675
13022,2,23,false,14,6,-8,41.89227,-87.61205
TA1306000029,2,23,false,5,3,-2,41.89256,-87.61449
13045,2,23,false,6,10,4,41.89403,-87.62931
13016,2,23,false,10,17,7,41.89431,-87.62277
KA1503000041,2,23,false,2,5,3,41.89452,-87.61798
TA1306000012,2,23,false,12,7,-5,41.89475,-87.63438
KP1705001026,2,23,false,8,9,1,41.89483,-87.6323
15530,2,23,false,1,5,4,41.89575,-87.62596
13289,2,23,false,6,3,-3,41.89638,-87.661
TA1307000061,2,23,false,4,6,2,41.89745,-87.62873
620,2,23,false,8,10,2,41.89817,-87.63754
TA1307000128,2,23,false,9,6,-3,41.89896,-87.6299
13042,2,23,false,8,15,7,41.90097,-87.62377
KA1504000133,2,23,false,8,2,-6,41.90234,-87.62773
TA1307000039,2,23,false,6,9,3,41.90294,-87.63137
KA1504000135,2,23,false,7,9,2,41.90319,-87.63439
13136,2,23,false,5,1,-4,41.90326,-87.67845
13061,2,23,false,4,7,3,41.90342,-87.66779
TA1308000049,2,23,false,5,5,0,41.90672,-87.6349
KA1504000134,2,23,false,5,3,-2,41.90687,-87.6262
TA1309000024,2,23,false,11,10,-1,41.908,-87.63152
331,2,23,false,5,5,0,41.90965,-87.64812
13058,2,23,false,5,1,-4,41.91059,-87.64942
LF-005,2,23,false,13,6,-7,41.91172,-87.62681
TA1308000050,2,23,false,11,9,-2,41.91211,-87.6347
13243,2,23,false,3,5,2,41.91262,-87.6814
13133,2,23,false,6,9,3,41.91598,-87.67733
13146,2,23,false,22,21,-1,41.91831,-87.63629
13059,2,23,false,4,8,4,41.91845,-87.65222
13192,2,23,false,4,8,4,41.91995,-87.64884
TA1309000033,2,23,false,5,1,-4,41.92158,-87.65381
13193,2,23,false,4,10,6,41.92182,-87.64412
13084,2,23,false,4,6,2,41.92268,-87.69715
TA1309000058,2,23,false,5,2,-3,41.92591,-87.64927
TA1309000023,2,23,false,5,9,4,41.9287,-87.65383
TA1307000113,2,23,false,1,5,4,41.92878,-87.66391
TA1309000061,2,23,false,1,5,4,41.92915,-87.64909
TA1305000014,2,23,false,4,6,2,41.92956,-87.64313
13085,2,23,false,2,7,5,41.92958,-87.70789
TA1307000142,2,23,false,3,8,5,41.93125,-87.64432
TA1307000064,2,23,false,8,4,-4,41.93222,-87.65864
TA1306000014,2,23,false,3,9,6,41.93242,-87.65271
13268,2,23,false,1,9,8,41.93588,-87.67843
TA1307000136,2,23,false,4,8,4,41.9365,-87.64755
13229,2,23,false,6,3,-3,41.93946,-87.66376
13277,2,23,false,1,5,4,41.9401,-87.64546
TA1307000134,2,23,false,13,7,-6,41.94016,-87.65303
TA1309000025,2,23,false,7,9,2,41.94368,-87.64894
13071,2,23,false,6,2,-4,41.94373,-87.66401
632,2,23,false,6,11,5,41.94453,-87.6547
13235,2,23,false,11,4,-7,41.94814,-87.66396
13325,2,23,false,5,7,2,41.94907,-87.64863
TA1307000126,2,23,false,4,5,1,41.94936,-87.65451
TA1309000043,2,23,false,10,3,-7,41.95417,-87.66434
13063,2,23,false,1,5,4,41.95424,-87.65441
KA1503000038,2,23,true,1,5,4,41.83845,-87.6354
13160,2,23,true,1,5,4,41.86947,-87.65548
13332,2,23,true,3,6,3,41.87219,-87.6615
SL-007,2,23,true,1,6,5,41.87404,-87.6277
TA1305000025,2,23,true,2,7,5,41.87773,-87.63528
WL-011,2,23,true,5,2,-3,41.88034,-87.64273
TA1305000032,2,23,true,2,5,3,41.88218,-87.64109
13053,2,23,true,8,3,-5,41.88365,-87.64863
15535,2,23,true,2,5,3,41.8846,-87.64455
TA1306000015,2,23,true,7,1,-6,41.88549,-87.65232
13021,2,23,true,2,6,4,41.88559,-87.64184
TA1306000003,2,23,true,11,7,-4,41.88867,-87.64442
13430,2,23,true,4,7,3,41.89077,-87.63169
TA1306000013,2,23,true,5,4,-1,41.89083,-87.61852
TA1307000117,2,23,true,5,2,-3,41.89144,-87.62675
13033,2,23,true,5,6,1,41.8916,-87.64835
TA1305000003,2,23,true,6,3,-3,41.89187,-87.62061
13045,2,23,true,6,4,-2,41.89403,-87.62931
TA1307000061,2,23,true,5,1,-4,41.89745,-87.62873
15529,2,23,true,2,5,3,41.89858,-87.62206
TA1307000128,2,23,true,5,6,1,41.89896,-87.6299
KA1504000133,2,23,true,3,5,2,41.90234,-87.62773
KA1504000135,2,23,true,3,6,3,41.90319,-87.63439
13061,2,23,true,3,8,5,41.90342,-87.66779
TA1307000143,2,23,true,5,2,-3,41.90762,-87.63854
331,2,23,true,4,5,1,41.90965,-87.64812
TA1307000038,2,23,true,11,3,-8,41.91138,-87.63868
TA1308000050,2,23,true,6,4,-2,41.91211,-87.6347
13133,2,23,true,1,6,5,41.91598,-87.67733
TA1309000006,2,23,true,4,6,2,41.91809,-87.64375
13146,2,23,true,15,3,-12,41.91831,-87.63629
13059,2,23,true,2,6,4,41.91845,-87.65222
13192,2,23,true,3,6,3,41.91995,-87.64884
TA1306000026,2,23,true,1,7,6,41.92558,-87.65842
TA1309000058,2,23,true,3,6,3,41.92591,-87.64927
TA1309000023,2,23,true,4,6,2,41.9287,-87.65383
TA1309000059,2,23,true,1,5,4,41.92889,-87.65898
TA1305000014,2,23,true,6,7,1,41.92956,-87.64313
TA1307000142,2,23,true,4,12,8,41.93125,-87.64432
TA1307000064,2,23,true,3,6,3,41.93222,-87.65864
TA1306000014,2,23,true,8,7,-1,41.93242,-87.65271
TA1307000006,2,23,true,2,8,6,41.93571,-87.6636
TA1307000052,2,23,true,5,6,1,41.93628,-87.65266
TA1307000136,2,23,true,9,6,-3,41.9365,-87.64755
13137,2,23,true,6,6,0,41.9376,-87.6441
TA1307000134,2,23,true,11,3,-8,41.94016,-87.65303
TA1309000025,2,23,true,10,5,-5,41.94368,-87.64894
13071,2,23,true,5,6,1,41.94373,-87.66401
632,2,23,true,9,1,-8,41.94453,-87.6547
13278,2,23,true,5,6,1,41.94553,-87.64644
13235,2,23,true,9,2,-7,41.94814,-87.66396
TA1307000126,2,23,true,6,1,-5,41.94936,-87.65451
TA1307000048,3,0,false,6,9,3,41.83855,-87.60821
TA1305000004,3,0,false,2,5,3,41.8514,-87.61884
TA1305000002,3,0,false,3,8,5,41.86721,-87.62597
SL-005,3,0,false,7,5,-2,41.8679,-87.62304
TA1309000010,3,0,false,8,6,-2,41.87074,-87.62574
SL-011,3,0,false,1,5,4,41.87256,-87.63356
623,3,0,false,21,30,9,41.87272,-87.62399
15541,3,0,false,5,4,-1,41.8758,-87.62086
TA1305000010,3,0,false,4,5,1,41.87623,-87.62444
TA1305000035,3,0,false,2,6,4,41.87716,-87.62787
TA1309000002,3,0,false,3,8,5,41.87784,-87.62408
KA1503000015,3,0,false,7,4,-3,41.87948,-87.6257
WL-011,3,0,false,3,6,3,41.88034,-87.64273
13300,3,0,false,4,8,4,41.88097,-87.61675
13008,3,0,false,18,30,12,41.88105,-87.62408
TA1305000011,3,0,false,6,10,4,41.886,-87.62418
TA1307000131,3,0,false,5,2,-3,41.88688,-87.62606
TA1306000013,3,0,false,2,5,3,41.89083,-87.61852
TA1305000003,3,0,false,7,1,-6,41.89187,-87.62061
13022,3,0,false,21,14,-7,41.89227,-87.61205
13045,3,0,false,4,6,2,41.89403,-87.62931
KA1503000041,3,0,false,3,5,2,41.89452,-87.61798
13289,3,0,false,1,5,4,41.89638,-87.661
13017,3,0,false,1,5,4,41.89676,-87.6357
13042,3,0,false,12,3,-9,41.90097,-87.62377
LF-005,3,0,false,7,3,-4,41.91172,-87.62681
TA1308000050,3,0,false,1,7,6,41.91211,-87.6347
13146,3,0,false,15,4,-11,41.91831,-87.63629
TA1309000033,3,0,false,3,5,2,41.92158,-87.65381
LP-,3,0,false,2,5,3,41.92396,-87.63584
TA1309000058,3,0,false,5,1,-4,41.92591,-87.64927
TA1307000136,3,0,false,4,5,1,41.9365,-87.64755
TA1307000134,3,0,false,5,5,0,41.94016,-87.65303
TA1309000025,3,0,false,6,4,-2,41.94368,-87.64894
632,3,0,false,3,7,4,41.94453,-87.6547
13325,3,0,false,7,2,-5,41.94907,-87.64863
13323,3,0,false,5,2,-3,41.95282,-87.65
13063,3,0,false,8,4,-4,41.95424,-87.65441
TA1305000032,3,0,true,2,7,5,41.88218,-87.64109
KA1504000135,3,0,true,5,1,-4,41.90319,-87.63439
13146,3,0,true,5,3,-2,41.91831,-87.63629
TA1306000026,3,0,true,4,13,9,41.92558,-87.65842
SL-005,3,1,false,11,8,-3,41.8679,-87.62304
623,3,1,false,9,4,-5,41.87272,-87.62399
TA1305000010,3,1,false,3,6,3,41.87623,-87.62444
TA1305000035,3,1,false,5,5,0,41.87716,-87.62787
TA1309000002,3,1,false,1,6,5,41.87784,-87.62408
13300,3,1,false,5,3,-2,41.88097,-87.61675
KA1503000012,3,1,false,4,7,3,41.88599,-87.63089
13022,3,1,false,2,14,12,41.89227,-87.61205
TA1305000041,3,1,false,1,5,4,41.9094,-87.67769
TA1308000001,3,1,false,7,5,-2,41.92627,-87.63086
TA1306000014,3,1,false,6,2,-4,41.93242,-87.65271
TA1307000124,3,2,false,5,6,1,41.86411,-87.62372
SL-005,3,2,false,8,16,8,41.8679,-87.62304
SL-010,3,2,false,2,6,4,41.87501,-87.63309
KA1503000015,3,2,false,4,9,5,41.87948,-87.6257
TA1307000107,3,2,false,3,6,3,41.96164,-87.65464
13022,3,3,false,5,4,-1,41.89227,-87.61205
KA1503000041,3,3,false,1,5,4,41.89452,-87.61798
13179,3,4,true,1,5,4,41.9157,-87.63461
13011,3,5,true,5,4,-1,41.87931,-87.63993
TA1307000120,3,5,true,5,3,-2,41.88188,-87.64879
TA1305000032,3,5,true,1,6,5,41.88218,-87.64109
TA1306000010,3,5,true,1,7,6,41.88419,-87.62961
13263,3,5,true,15,1,-14,41.88467,-87.61952
KA1503000043,3,5,true,5,7,2,41.88918,-87.63851
13430,3,5,true,5,3,-2,41.89077,-87.63169
TA1307000117,3,5,true,8,4,-4,41.89144,-87.62675
TA1306000029,3,5,true,10,1,-9,41.89256,-87.61449
13265,3,5,true,6,1,-5,41.89383,-87.64172
13045,3,5,true,7,6,-1,41.89403,-87.62931
13016,3,5,true,4,14,10,41.89431,-87.62277
KA1503000041,3,5,true,4,10,6,41.89452,-87.61798
620,3,5,true,5,3,-2,41.89817,-87.63754
13042,3,5,true,2,9,7,41.90097,-87.62377
TA1307000039,3,5,true,14,9,-5,41.90294,-87.63137
KA1504000135,3,5,true,7,1,-6,41.90319,-87.63439
KA1504000079,3,5,true,3,6,3,41.9035,-87.64334
13221,3,5,true,5,1,-4,41.90765,-87.67254
TA1305000041,3,5,true,11,1,-10,41.9094,-87.67769
TA1307000038,3,5,true,2,5,3,41.91138,-87.63868
TA1309000030,3,5,true,1,5,4,41.92077,-87.66372
TA1309000058,3,5,true,2,19,17,41.92591,-87.64927
TA1307000136,3,5,true,5,2,-3,41.9365,-87.64755
13137,3,5,true,6,4,-2,41.9376,-87.6441
13325,3,5,true,5,5,0,41.94907,-87.64863
TA1307000150,3,5,true,14,4,-10,41.94945,-87.64646
13063,3,5,true,7,1,-6,41.95424,-87.65441
TA1309000007,3,6,false,1,5,4,41.88022,-87.63526
TA1307000120,3,6,false,6,3,-3,41.88188,-87.64879
13053,3,6,false,1,5,4,41.88365,-87.64863
13045,3,6,false,4,6,2,41.89403,-87.62931
13338,3,6,false,2,5,3,41.89697,-87.62173
TA1306000009,3,6,false,1,7,6,41.89772,-87.64299
13042,3,6,false,5,4,-1,41.90097,-87.62377
TA1307000039,3,6,false,7,2,-5,41.90294,-87.63137
TA1308000050,3,6,false,5,4,-1,41.91211,-87.6347
13193,3,6,false,6,3,-3,41.92182,-87.64412
TA1309000058,3,6,false,1,5,4,41.92591,-87.64927
TA1309000011,3,6,true,1,6,5,41.78873,-87.60131
TA1307000048,3,6,true,6,2,-4,41.83855,-87.60821
TA1307000139,3,6,true,5,2,-3,41.84205,-87.61698
15546,3,6,true,6,1,-5,41.85416,-87.61916
SL-012,3,6,true,8,1,-7,41.86038,-87.62581
TA1307000124,3,6,true,13,2,-11,41.86411,-87.62372
TA1305000002,3,6,true,5,4,-1,41.86721,-87.62597
SL-005,3,6,true,10,9,-1,41.8679,-87.62304
TA1309000064,3,6,true,3,19,16,41.87127,-87.67369
SL-008,3,6,true,8,6,-2,41.87209,-87.62956
SL-011,3,6,true,13,2,-11,41.87256,-87.63356
623,3,6,true,8,1,-7,41.87272,-87.62399
KA1504000104,3,6,true,2,35,33,41.87296,-87.66912
SL-010,3,6,true,5,3,-2,41.87501,-87.63309
TA1305000009,3,6,true,2,5,3,41.87593,-87.63068
15539,3,6,true,3,6,3,41.87763,-87.64405
13158,3,6,true,6,4,-2,41.87764,-87.64957
TA1305000025,3,6,true,8,2,-6,41.87773,-87.63528
13206,3,6,true,7,4,-3,41.87794,-87.66201
TA1309000004,3,6,true,9,35,26,41.87811,-87.63184
638,3,6,true,13,20,7,41.87827,-87.64078
13011,3,6,true,10,14,4,41.87931,-87.63993
TA1309000008,3,6,true,1,12,11,41.87933,-87.6355
TA1309000007,3,6,true,4,32,28,41.88022,-87.63526
WL-011,3,6,true,2,6,4,41.88034,-87.64273
13008,3,6,true,3,6,3,41.88105,-87.62408
TA1305000006,3,6,true,2,32,30,41.88122,-87.6296
13056,3,6,true,1,8,7,41.88168,-87.63951
TA1307000120,3,6,true,16,10,-6,41.88188,-87.64879
13341,3,6,true,3,7,4,41.88208,-87.63985
TA1305000032,3,6,true,30,30,0,41.88218,-87.64109
13006,3,6,true,1,15,14,41.88268,-87.63252
KA1503000072,3,6,true,10,8,-2,41.88317,-87.63693
WL-012,3,6,true,23,11,-12,41.88337,-87.6412
13053,3,6,true,1,6,5,41.88365,-87.64863
13001,3,6,true,11,9,-2,41.88397,-87.62459
TA1306000010,3,6,true,1,11,10,41.88419,-87.62961
TA1305000030,3,6,true,3,9,6,41.88459,-87.63178
15535,3,6,true,9,2,-7,41.8846,-87.64455
13263,3,6,true,18,12,-6,41.88467,-87.61952
TA1306000015,3,6,true,1,8,7,41.88549,-87.65232
13021,3,6,true,10,3,-7,41.88559,-87.64184
TA1307000111,3,6,true,2,8,6,41.88582,-87.63548
TA1305000011,3,6,true,12,20,8,41.886,-87.62418
15534,3,6,true,4,6,2,41.88627,-87.61749
13197,3,6,true,1,7,6,41.8866,-87.65816
TA1307000131,3,6,true,3,8,5,41.88688,-87.62606
TA1305000022,3,6,true,11,10,-1,41.88817,-87.63656
TA1306000003,3,6,true,15,5,-10,41.88867,-87.64442
KA1503000043,3,6,true,23,21,-2,41.88918,-87.63851
15664,3,6,true,5,3,-2,41.8895,-87.68821
TA1307000151,3,6,true,3,7,4,41.88993,-87.63427
KA1503000044,3,6,true,7,3,-4,41.89018,-87.6262
13427,3,6,true,6,5,-1,41.89054,-87.62205
TA1306000013,3,6,true,7,2,-5,41.89083,-87.61852
RN-,3,6,true,4,6,2,41.89102,-87.63546
TA1307000117,3,6,true,4,6,2,41.89144,-87.62675
13033,3,6,true,5,6,1,41.8916,-87.64835
13194,3,6,true,13,1,-12,41.8918,-87.65878
13022,3,6,true,8,20,12,41.89227,-87.61205
TA1306000029,3,6,true,11,3,-8,41.89256,-87.61449
13265,3,6,true,25,1,-24,41.89383,-87.64172
13045,3,6,true,16,28,12,41.89403,-87.62931
13016,3,6,true,7,53,46,41.89431,-87.62277
KA1503000041,3,6,true,7,35,28,41.89452,-87.61798
TA1307000062,3,6,true,6,7,1,41.89466,-87.63839
TA1306000012,3,6,true,14,17,3,41.89475,-87.63438
KP1705001026,3,6,true,9,3,-6,41.89483,-87.6323
18058,3,6,true,5,1,-4,41.8955,-87.68201
13132,3,6,true,9,5,-4,41.89573,-87.67718
15530,3,6,true,5,15,10,41.89575,-87.62596
18003,3,6,true,2,13,11,41.89575,-87.62011
13247,3,6,true,8,2,-6,41.89597,-87.66775
TA1305000020,3,6,true,9,4,-5,41.89636,-87.65406
13303,3,6,true,10,4,-6,41.89672,-87.63088
13017,3,6,true,5,16,11,41.89676,-87.6357
13338,3,6,true,10,40,30,41.89697,-87.62173
13034,3,6,true,6,13,7,41.89754,-87.62352
TA1306000009,3,6,true,5,8,3,41.89772,-87.64299
620,3,6,true,6,1,-5,41.89817,-87.63754
KA1504000103,3,6,true,5,1,-4,41.89842,-87.68659
15529,3,6,true,6,13,7,41.89858,-87.62206
TA1307000128,3,6,true,9,2,-7,41.89896,-87.6299
13248,3,6,true,5,5,0,41.89964,-87.66788
TA1306000011,3,6,true,6,1,-5,41.89994,-87.63443
13290,3,6,true,8,3,-5,41.90069,-87.66259
KA1504000133,3,6,true,7,2,-5,41.90234,-87.62773
TA1307000039,3,6,true,23,11,-12,41.90294,-87.63137
KA1504000135,3,6,true,15,3,-12,41.90319,-87.63439
13136,3,6,true,6,1,-5,41.90326,-87.67845
13061,3,6,true,10,3,-7,41.90342,-87.66779
TA1308000049,3,6,true,14,3,-11,41.90672,-87.6349
13221,3,6,true,8,7,-1,41.90765,-87.67254
TA1309000024,3,6,true,16,3,-13,41.908,-87.63152
331,3,6,true,6,4,-2,41.90965,-87.64812
TA1305000037,3,6,true,6,1,-5,41.91018,-87.67003
13154,3,6,true,1,8,7,41.91054,-87.65312
TA1307000038,3,6,true,3,10,7,41.91138,-87.63868
LF-005,3,6,true,7,2,-5,41.91172,-87.62681
TA1308000050,3,6,true,10,14,4,41.91211,-87.6347
13243,3,6,true,2,6,4,41.91262,-87.6814
TA1307000166,3,6,true,8,1,-7,41.91386,-87.64877
13179,3,6,true,9,8,-1,41.9157,-87.63461
TA1305000039,3,6,true,5,2,-3,41.9163,-87.66749
13146,3,6,true,16,3,-13,41.91831,-87.63629
13059,3,6,true,5,1,-4,41.91845,-87.65222
13192,3,6,true,7,5,-2,41.91995,-87.64884
TA1309000030,3,6,true,4,5,1,41.92077,-87.66372
TA1309000033,3,6,true,4,7,3,41.92158,-87.65381
13193,3,6,true,12,4,-8,41.92182,-87.64412
13191,3,6,true,11,4,-7,41.92217,-87.63891
LP-,3,6,true,7,2,-5,41.92396,-87.63584
TA1307000001,3,6,true,6,1,-5,41.92535,-87.66581
TA1306000016,3,6,true,1,20,19,41.9256,-87.65371
TA1309000019,3,6,true,14,4,-10,41.92586,-87.63897
TA1309000058,3,6,true,6,5,-1,41.92591,-87.64927
TA1307000113,3,6,true,7,2,-5,41.92878,-87.66391
TA1309000061,3,6,true,13,2,-11,41.92915,-87.64909
TA1305000014,3,6,true,9,2,-7,41.92956,-87.64313
TA1307000142,3,6,true,8,5,-3,41.93125,-87.64432
13276,3,6,true,11,3,-8,41.93132,-87.63874
TA1307000064,3,6,true,6,5,-1,41.93222,-87.65864
TA1306000014,3,6,true,14,13,-1,41.93242,-87.65271
TA1309000039,3,6,true,9,3,-6,41.93258,-87.63642
TA1309000036,3,6,true,4,8,4,41.93313,-87.64776
TA1307000052,3,6,true,9,7,-2,41.93628,-87.65266
TA1307000136,3,6,true,6,7,1,41.9365,-87.64755
TA1307000041,3,6,true,4,5,1,41.93669,-87.63683
13137,3,6,true,6,5,-1,41.9376,-87.6441
TA1307000134,3,6,true,6,3,-3,41.94016,-87.65303
TA1309000049,3,6,true,4,5,1,41.94077,-87.63919
13071,3,6,true,6,4,-2,41.94373,-87.66401
13278,3,6,true,7,3,-4,41.94553,-87.64644
13325,3,6,true,6,10,4,41.94907,-87.64863
TA1307000126,3,6,true,6,1,-5,41.94936,-87.65451
13323,3,6,true,2,5,3,41.95282,-87.65
13063,3,6,true,10,1,-9,41.95424,-87.65441
13389,3,6,true,5,1,-4,41.961,-87.64958
TA1309000066,3,6,true,1,8,7,41.9691,-87.67423
SL-005,3,7,false,5,2,-3,41.8679,-87.62304
SL-011,3,7,false,4,6,2,41.87256,-87.63356
623,3,7,false,8,1,-7,41.87272,-87.62399
638,3,7,false,2,5,3,41.87827,-87.64078
13011,3,7,false,2,6,4,41.87931,-87.63993
WL-011,3,7,false,6,3,-3,41.88034,-87.64273
13008,3,7,false,6,6,0,41.88105,-87.62408
TA1305000006,3,7,false,2,13,11,41.88122,-87.6296
13341,3,7,false,1,6,5,41.88208,-87.63985
13006,3,7,false,4,6,2,41.88268,-87.63252
KA1503000072,3,7,false,3,6,3,41.88317,-87.63693
WL-012,3,7,false,3,7,4,41.88337,-87.6412
TA1305000030,3,7,false,2,11,9,41.88459,-87.63178
TA1305000029,3,7,false,4,6,2,41.88466,-87.62787
TA1306000015,3,7,false,2,7,5,41.88549,-87.65232
KA1503000012,3,7,false,2,7,5,41.88599,-87.63089
TA1305000011,3,7,false,1,6,5,41.886,-87.62418
TA1305000022,3,7,false,9,5,-4,41.88817,-87.63656
TA1306000003,3,7,false,5,2,-3,41.88867,-87.64442
KA1503000043,3,7,false,6,7,1,41.88918,-87.63851
13050,3,7,false,1,9,8,41.88919,-87.62775
TA1307000151,3,7,false,3,10,7,41.88993,-87.63427
TA1306000013,3,7,false,6,6,0,41.89083,-87.61852
TA1307000117,3,7,false,6,2,-4,41.89144,-87.62675
13194,3,7,false,5,2,-3,41.8918,-87.65878
13022,3,7,false,7,3,-4,41.89227,-87.61205
13045,3,7,false,9,10,1,41.89403,-87.62931
13016,3,7,false,5,6,1,41.89431,-87.62277
TA1306000012,3,7,false,10,5,-5,41.89475,-87.63438
KP1705001026,3,7,false,6,3,-3,41.89483,-87.6323
13132,3,7,false,5,1,-4,41.89573,-87.67718
13289,3,7,false,5,2,-3,41.89638,-87.661
13338,3,7,false,10,4,-6,41.89697,-87.62173
TA1306000009,3,7,false,7,13,6,41.89772,-87.64299
TA1307000128,3,7,false,8,1,-7,41.89896,-87.6299
TA1306000011,3,7,false,8,4,-4,41.89994,-87.63443
13042,3,7,false,8,9,1,41.90097,-87.62377
TA1307000039,3,7,false,14,3,-11,41.90294,-87.63137
KA1504000135,3,7,false,2,9,7,41.90319,-87.63439
KA1504000079,3,7,false,5,3,-2,41.9035,-87.64334
KA1504000134,3,7,false,5,1,-4,41.90687,-87.6262
TA1305000041,3,7,false,4,5,1,41.9094,-87.67769
331,3,7,false,1,5,4,41.90965,-87.64812
13179,3,7,false,8,6,-2,41.9157,-87.63461
13059,3,7,false,10,3,-7,41.91845,-87.65222
13192,3,7,false,8,4,-4,41.91995,-87.64884
TA1309000030,3,7,false,1,6,5,41.92077,-87.66372
13191,3,7,false,6,3,-3,41.92217,-87.63891
LP-,3,7,false,5,3,-2,41.92396,-87.63584
TA1306000016,3,7,false,3,9,6,41.9256,-87.65371
TA1307000113,3,7,false,7,2,-5,41.92878,-87.66391
TA1309000061,3,7,false,6,1,-5,41.92915,-87.64909
TA1305000014,3,7,false,9,2,-7,41.92956,-87.64313
13276,3,7,false,5,1,-4,41.93132,-87.63874
TA1307000041,3,7,false,5,5,0,41.93669,-87.63683
TA1307000138,3,7,false,1,6,5,41.94334,-87.67094
TA1308000009,3,7,true,6,3,-3,41.79522,-87.58075
TA1308000045,3,7,true,2,5,3,41.83062,-87.64129
TA1307000129,3,7,true,1,5,4,41.83104,-87.62683
15546,3,7,true,6,3,-3,41.85416,-87.61916
15545,3,7,true,3,8,5,41.85627,-87.61334
13102,3,7,true,11,1,-10,41.85762,-87.61942
13150,3,7,true,5,3,-2,41.85783,-87.62455
SL-012,3,7,true,12,2,-10,41.86038,-87.62581
13304,3,7,true,7,1,-6,41.86126,-87.65659
TA1306000002,3,7,true,9,4,-5,41.86238,-87.65108
TA1307000124,3,7,true,10,4,-6,41.86411,-87.62372
TA1309000001,3,7,true,9,5,-4,41.86488,-87.64708
TA1305000002,3,7,true,26,1,-25,41.86721,-87.62597
15544,3,7,true,4,9,5,41.86723,-87.61536
KA1706005007,3,7,true,3,5,2,41.86749,-87.63219
SL-005,3,7,true,28,11,-17,41.8679,-87.62304
13139,3,7,true,8,4,-4,41.86893,-87.65913
TA1309000010,3,7,true,9,6,-3,41.87074,-87.62574
TA1309000064,3,7,true,1,35,34,41.87127,-87.67369
TA1307000130,3,7,true,2,5,3,41.87178,-87.65103
SL-008,3,7,true,10,4,-6,41.87209,-87.62956
SL-011,3,7,true,20,5,-15,41.87256,-87.63356
623,3,7,true,8,11,3,41.87272,-87.62399
KA1504000104,3,7,true,10,34,24,41.87296,-87.66912
SL-010,3,7,true,19,6,-13,41.87501,-87.63309
TA1305000009,3,7,true,6,4,-2,41.87593,-87.63068
TA1305000010,3,7,true,5,4,-1,41.87623,-87.62444
TA1305000035,3,7,true,2,18,16,41.87716,-87.62787
13138,3,7,true,8,11,3,41.87723,-87.63941
15539,3,7,true,6,8,2,41.87763,-87.64405
13158,3,7,true,29,8,-21,41.87764,-87.64957
13157,3,7,true,14,5,-9,41.87773,-87.6548
TA1305000025,3,7,true,7,25,18,41.87773,-87.63528
TA1309000004,3,7,true,5,52,47,41.87811,-87.63184
638,3,7,true,27,26,-1,41.87827,-87.64078
TA1305000005,3,7,true,2,22,20,41.87924,-87.62975
13011,3,7,true,28,12,-16,41.87931,-87.63993
TA1309000008,3,7,true,8,38,30,41.87933,-87.6355
KA1503000034,3,7,true,2,14,12,41.87938,-87.63197
KA1503000015,3,7,true,2,23,21,41.87948,-87.6257
TA1309000007,3,7,true,2,44,42,41.88022,-87.63526
WL-011,3,7,true,7,13,6,41.88034,-87.64273
13156,3,7,true,13,2,-11,41.88042,-87.65554
13008,3,7,true,4,12,8,41.88105,-87.62408
TA1305000006,3,7,true,6,47,41,41.88122,-87.6296
13056,3,7,true,14,22,8,41.88168,-87.63951
TA1307000120,3,7,true,17,12,-5,41.88188,-87.64879
13341,3,7,true,18,13,-5,41.88208,-87.63985
13036,3,7,true,1,7,6,41.8821,-87.62513
TA1305000032,3,7,true,26,27,1,41.88218,-87.64109
13006,3,7,true,5,24,19,41.88268,-87.63252
13353,3,7,true,6,4,-2,41.88283,-87.6612
654,3,7,true,7,1,-6,41.88307,-87.65698
13409,3,7,true,8,3,-5,41.8831,-87.6511
KA1503000072,3,7,true,6,34,28,41.88317,-87.63693
WL-012,3,7,true,39,17,-22,41.88337,-87.6412
13053,3,7,true,7,9,2,41.88365,-87.64863
13001,3,7,true,5,22,17,41.88397,-87.62459
18062,3,7,true,10,12,2,41.88412,-87.65427
TA1306000010,3,7,true,3,23,20,41.88419,-87.62961
TA1305000030,3,7,true,7,23,16,41.88459,-87.63178
15535,3,7,true,11,3,-8,41.8846,-87.64455
TA1305000029,3,7,true,5,8,3,41.88466,-87.62787
13263,3,7,true,26,12,-14,41.88467,-87.61952
TA1306000015,3,7,true,3,20,17,41.88549,-87.65232
13021,3,7,true,21,27,6,41.88559,-87.64184
TA1307000111,3,7,true,8,35,27,41.88582,-87.63548
KA1503000012,3,7,true,7,5,-2,41.88599,-87.63089
TA1305000011,3,7,true,5,48,43,41.886,-87.62418
15534,3,7,true,12,6,-6,41.88627,-87.61749
13197,3,7,true,4,6,2,41.8866,-87.65816
TA1308000029,3,7,true,6,8,2,41.88673,-87.62225
TA1307000131,3,7,true,6,8,2,41.88688,-87.62606
KA1503000064,3,7,true,6,6,0,41.88697,-87.61281
TA1305000022,3,7,true,24,29,5,41.88817,-87.63656
TA1306000003,3,7,true,16,7,-9,41.88867,-87.64442
KA1503000043,3,7,true,23,23,0,41.88918,-87.63851
13050,3,7,true,7,17,10,41.88919,-87.62775
13432,3,7,true,5,7,2,41.88989,-87.67149
TA1307000151,3,7,true,19,33,14,41.88993,-87.63427
636,3,7,true,7,8,1,41.88997,-87.63662
KA1503000044,3,7,true,7,12,5,41.89018,-87.6262
13427,3,7,true,10,4,-6,41.89054,-87.62205
TA1306000013,3,7,true,13,4,-9,41.89083,-87.61852
RN-,3,7,true,18,4,-14,41.89102,-87.63546
13434,3,7,true,8,1,-7,41.89108,-87.66663
TA1308000006,3,7,true,4,8,4,41.89128,-87.67686
TA1307000117,3,7,true,16,15,-1,41.89144,-87.62675
13033,3,7,true,12,8,-4,41.8916,-87.64835
13194,3,7,true,8,1,-7,41.8918,-87.65878
TA1305000003,3,7,true,5,9,4,41.89187,-87.62061
13022,3,7,true,26,12,-14,41.89227,-87.61205
TA1306000029,3,7,true,12,14,2,41.89256,-87.61449
13265,3,7,true,17,7,-10,41.89383,-87.64172
13045,3,7,true,29,29,0,41.89403,-87.62931
13016,3,7,true,11,91,80,41.89431,-87.62277
KA1503000041,3,7,true,15,29,14,41.89452,-87.61798
TA1307000062,3,7,true,15,15,0,41.89466,-87.63839
TA1306000012,3,7,true,34,16,-18,41.89475,-87.63438
KP1705001026,3,7,true,11,8,-3,41.89483,-87.6323
13132,3,7,true,6,4,-2,41.89573,-87.67718
15530,3,7,true,10,31,21,41.89575,-87.62596
13247,3,7,true,10,8,-2,41.89597,-87.66775
TA1305000020,3,7,true,5,5,0,41.89636,-87.65406
13289,3,7,true,14,2,-12,41.89638,-87.661
13303,3,7,true,5,4,-1,41.89672,-87.63088
13017,3,7,true,18,14,-4,41.89676,-87.6357
13338,3,7,true,29,24,-5,41.89697,-87.62173
TA1307000061,3,7,true,10,1,-9,41.89745,-87.62873
13034,3,7,true,3,14,11,41.89754,-87.62352
TA1306000009,3,7,true,27,48,21,41.89772,-87.64299
620,3,7,true,6,4,-2,41.89817,-87.63754
KA1504000103,3,7,true,11,1,-10,41.89842,-87.68659
15529,3,7,true,14,14,0,41.89858,-87.62206
TA1307000128,3,7,true,28,8,-20,41.89896,-87.6299
13248,3,7,true,8,4,-4,41.89964,-87.66788
TA1306000011,3,7,true,25,4,-21,41.89994,-87.63443
KA1504000116,3,7,true,11,2,-9,41.90023,-87.64299
13042,3,7,true,16,9,-7,41.90097,-87.62377
TA1306000006,3,7,true,8,7,-1,41.90292,-87.63772
TA1307000039,3,7,true,50,25,-25,41.90294,-87.63137
658,3,7,true,3,5,2,41.903,-87.6838
KA1504000135,3,7,true,16,7,-9,41.90319,-87.63439
13061,3,7,true,13,13,0,41.90342,-87.66779
KA1504000079,3,7,true,14,6,-8,41.9035,-87.64334
TA1307000115,3,7,true,11,2,-9,41.9046,-87.64056
TA1308000049,3,7,true,15,6,-9,41.90672,-87.6349
KA1504000134,3,7,true,9,2,-7,41.90687,-87.6262
13224,3,7,true,7,2,-5,41.90706,-87.66725
TA1307000143,3,7,true,11,1,-10,41.90762,-87.63854
13221,3,7,true,21,3,-18,41.90765,-87.67254
TA1309000024,3,7,true,13,4,-9,41.908,-87.63152
TA1305000041,3,7,true,12,10,-2,41.9094,-87.67769
331,3,7,true,14,15,1,41.90965,-87.64812
TA1305000037,3,7,true,13,3,-10,41.91018,-87.67003
TA1306000008,3,7,true,10,4,-6,41.9102,-87.6435
13154,3,7,true,9,4,-5,41.91054,-87.65312
13058,3,7,true,6,10,4,41.91059,-87.64942
TA1307000038,3,7,true,14,7,-7,41.91138,-87.63868
LF-005,3,7,true,17,6,-11,41.91172,-87.62681
13128,3,7,true,12,10,-2,41.91197,-87.63197
TA1308000050,3,7,true,32,25,-7,41.91211,-87.6347
13243,3,7,true,11,5,-6,41.91262,-87.6814
TA1306000032,3,7,true,7,3,-4,41.9137,-87.65285
TA1307000166,3,7,true,6,6,0,41.91386,-87.64877
18067,3,7,true,10,6,-4,41.9146,-87.66796
13068,3,7,true,10,1,-9,41.91554,-87.68703
13179,3,7,true,27,10,-17,41.9157,-87.63461
13133,3,7,true,8,3,-5,41.91598,-87.67733
15651,3,7,true,6,1,-5,41.91752,-87.70181
13266,3,7,true,6,1,-5,41.91774,-87.69142
TA1309000006,3,7,true,8,3,-5,41.91809,-87.64375
TA1307000163,3,7,true,8,8,0,41.91821,-87.65696
13146,3,7,true,20,10,-10,41.91831,-87.63629
13059,3,7,true,12,19,7,41.91845,-87.65222
13192,3,7,true,14,6,-8,41.91995,-87.64884
13288,3,7,true,5,1,-4,41.92008,-87.67788
TA1309000030,3,7,true,6,4,-2,41.92077,-87.66372
13292,3,7,true,5,3,-2,41.92152,-87.70733
TA1309000033,3,7,true,7,8,1,41.92158,-87.65381
13193,3,7,true,9,8,-1,41.92182,-87.64412
13191,3,7,true,11,7,-4,41.92217,-87.63891
LP-,3,7,true,8,2,-6,41.92396,-87.63584
TA1307000001,3,7,true,8,2,-6,41.92535,-87.66581
TA1306000016,3,7,true,8,18,10,41.9256,-87.65371
TA1309000019,3,7,true,17,12,-5,41.92586,-87.63897
TA1309000058,3,7,true,26,15,-11,41.92591,-87.64927
TA1308000001,3,7,true,10,6,-4,41.92627,-87.63086
TA1309000023,3,7,true,7,2,-5,41.9287,-87.65383
TA1307000113,3,7,true,8,1,-7,41.92878,-87.66391
13296,3,7,true,5,4,-1,41.92883,-87.66852
TA1309000061,3,7,true,9,6,-3,41.92915,-87.64909
TA1305000014,3,7,true,16,9,-7,41.92956,-87.64313
TA1307000142,3,7,true,6,3,-3,41.93125,-87.64432
13276,3,7,true,18,12,-6,41.93132,-87.63874
TA1307000064,3,7,true,8,12,4,41.93222,-87.65864
TA1306000014,3,7,true,12,13,1,41.93242,-87.65271
TA1309000039,3,7,true,18,13,-5,41.93258,-87.63642
13294,3,7,true,10,2,-8,41.9326,-87.66595
TA1309000036,3,7,true,14,7,-7,41.93313,-87.64776
TA1307000006,3,7,true,16,6,-10,41.93571,-87.6636
13268,3,7,true,7,3,-4,41.93588,-87.67843
13269,3,7,true,7,3,-4,41.93609,-87.66983
TA1307000052,3,7,true,15,13,-2,41.93628,-87.65266
TA1307000136,3,7,true,4,13,9,41.9365,-87.64755
TA1307000041,3,7,true,10,2,-8,41.93669,-87.63683
13137,3,7,true,23,12,-11,41.9376,-87.6441
TA1309000042,3,7,true,11,11,0,41.93937,-87.66836
TA1308000019,3,7,true,7,5,-2,41.93973,-87.65886
13277,3,7,true,7,7,0,41.9401,-87.64546
TA1307000134,3,7,true,9,16,7,41.94016,-87.65303
TA1309000049,3,7,true,5,6,1,41.94077,-87.63919
TA1307000138,3,7,true,9,4,-5,41.94334,-87.67094
TA1309000025,3,7,true,7,7,0,41.94368,-87.64894
13071,3,7,true,4,7,3,41.94373,-87.66401
13278,3,7,true,15,1,-14,41.94553,-87.64644
13253,3,7,true,10,2,-8,41.9488,-87.67527
13325,3,7,true,19,6,-13,41.94907,-87.64863
TA1307000126,3,7,true,2,6,4,41.94936,-87.65451
TA1307000150,3,7,true,12,8,-4,41.94945,-87.64646
13323,3,7,true,6,3,-3,41.95282,-87.65
13063,3,7,true,7,8,1,41.95424,-87.65441
TA1308000022,3,7,true,2,6,4,41.95438,-87.64805
TA1307000149,3,7,true,2,7,5,41.95467,-87.67392
13249,3,7,true,10,2,-8,41.95606,-87.66885
13379,3,7,true,11,4,-7,41.95786,-87.6495
13389,3,7,true,9,8,-1,41.961,-87.64958
TA1307000144,3,7,true,2,9,7,41.96142,-87.6762
13074,3,7,true,1,6,5,41.96521,-87.6582
639,3,7,true,8,1,-7,41.96584,-87.64538
KA1504000093,3,7,true,5,7,2,41.96587,-87.69365
TA1307000158,3,7,true,2,7,5,41.9671,-87.67904
TA1309000066,3,7,true,9,12,3,41.9691,-87.67423
TA1309000035,3,7,true,10,4,-6,41.97335,-87.66785
13108,3,7,true,9,1,-8,41.97379,-87.65971
KA1504000151,3,7,true,11,3,-8,41.98359,-87.66916
KA1504000152,3,7,true,6,2,-4,41.98403,-87.65231
15578,3,7,true,6,7,1,41.98405,-87.66027
15575,3,7,true,2,5,3,41.98975,-87.66014
KA1503000014,3,8,false,4,6,2,41.7851,-87.60108
TA1308000009,3,8,false,8,1,-7,41.79522,-87.58075
SL-005,3,8,false,10,1,-9,41.8679,-87.62304
623,3,8,false,4,6,2,41.87272,-87.62399
SL-010,3,8,false,1,5,4,41.87501,-87.63309
13158,3,8,false,7,1,-6,41.87764,-87.64957
TA1305000025,3,8,false,4,14,10,41.87773,-87.63528
TA1309000004,3,8,false,2,6,4,41.87811,-87.63184
638,3,8,false,1,7,6,41.87827,-87.64078
13011,3,8,false,5,12,7,41.87931,-87.63993
TA1309000008,3,8,false,1,5,4,41.87933,-87.6355
KA1503000034,3,8,false,1,6,5,41.87938,-87.63197
TA1309000007,3,8,false,1,7,6,41.88022,-87.63526
WL-011,3,8,false,4,10,6,41.88034,-87.64273
13300,3,8,false,7,8,1,41.88097,-87.61675
TA1307000120,3,8,false,12,5,-7,41.88188,-87.64879
13341,3,8,false,9,5,-4,41.88208,-87.63985
TA1305000032,3,8,false,3,5,2,41.88218,-87.64109
13409,3,8,false,3,6,3,41.8831,-87.6511
KA1503000072,3,8,false,1,8,7,41.88317,-87.63693
WL-012,3,8,false,3,7,4,41.88337,-87.6412
13053,3,8,false,3,6,3,41.88365,-87.64863
13001,3,8,false,13,1,-12,41.88397,-87.62459
TA1305000030,3,8,false,6,15,9,41.88459,-87.63178
15535,3,8,false,3,9,6,41.8846,-87.64455
TA1306000015,3,8,false,4,11,7,41.88549,-87.65232
13021,3,8,false,4,5,1,41.88559,-87.64184
TA1307000111,3,8,false,2,11,9,41.88582,-87.63548
TA1305000011,3,8,false,12,9,-3,41.886,-87.62418
13197,3,8,false,2,8,6,41.8866,-87.65816
TA1305000022,3,8,false,8,7,-1,41.88817,-87.63656
TA1306000003,3,8,false,6,1,-5,41.88867,-87.64442
KA1503000043,3,8,false,8,17,9,41.88918,-87.63851
13050,3,8,false,3,6,3,41.88919,-87.62775
TA1307000151,3,8,false,2,14,12,41.88993,-87.63427
KA1503000044,3,8,false,2,8,6,41.89018,-87.6262
TA1306000013,3,8,false,13,3,-10,41.89083,-87.61852
RN-,3,8,false,1,7,6,41.89102,-87.63546
TA1307000117,3,8,false,6,7,1,41.89144,-87.62675
TA1305000003,3,8,false,5,6,1,41.89187,-87.62061
13265,3,8,false,5,7,2,41.89383,-87.64172
13045,3,8,false,10,8,-2,41.89403,-87.62931
13016,3,8,false,1,7,6,41.89431,-87.62277
KA1503000041,3,8,false,5,1,-4,41.89452,-87.61798
13196,3,8,false,9,1,-8,41.89455,-87.65345
TA1307000062,3,8,false,5,4,-1,41.89466,-87.63839
TA1306000012,3,8,false,12,9,-3,41.89475,-87.63438
KP1705001026,3,8,false,4,6,2,41.89483,-87.6323
TA1305000020,3,8,false,7,3,-4,41.89636,-87.65406
TA1307000061,3,8,false,5,2,-3,41.89745,-87.62873
13034,3,8,false,6,2,-4,41.89754,-87.62352
TA1306000009,3,8,false,2,10,8,41.89772,-87.64299
620,3,8,false,5,4,-1,41.89817,-87.63754
13290,3,8,false,8,4,-4,41.90069,-87.66259
13042,3,8,false,9,8,-1,41.90097,-87.62377
KA1504000133,3,8,false,3,6,3,41.90234,-87.62773
TA1307000039,3,8,false,12,3,-9,41.90294,-87.63137
TA1305000034,3,8,false,6,1,-5,41.90313,-87.67391
KA1504000135,3,8,false,1,8,7,41.90319,-87.63439
13061,3,8,false,5,6,1,41.90342,-87.66779
TA1308000049,3,8,false,6,3,-3,41.90672,-87.6349
KA1504000134,3,8,false,6,4,-2,41.90687,-87.6262
TA1305000041,3,8,false,2,7,5,41.9094,-87.67769
331,3,8,false,5,3,-2,41.90965,-87.64812
TA1305000037,3,8,false,6,2,-4,41.91018,-87.67003
13058,3,8,false,1,5,4,41.91059,-87.64942
LF-005,3,8,false,2,7,5,41.91172,-87.62681
TA1308000050,3,8,false,7,7,0,41.91211,-87.6347
13243,3,8,false,4,7,3,41.91262,-87.6814
TA1309000032,3,8,false,1,5,4,41.91293,-87.66417
13179,3,8,false,4,5,1,41.9157,-87.63461
13193,3,8,false,11,4,-7,41.92182,-87.64412
TA1307000001,3,8,false,5,2,-3,41.92535,-87.66581
TA1306000026,3,8,false,3,8,5,41.92558,-87.65842
TA1306000016,3,8,false,3,8,5,41.9256,-87.65371
TA1309000019,3,8,false,5,1,-4,41.92586,-87.63897
TA1309000058,3,8,false,8,2,-6,41.92591,-87.64927
TA1307000113,3,8,false,7,3,-4,41.92878,-87.66391
TA1305000014,3,8,false,7,5,-2,41.92956,-87.64313
TA1307000142,3,8,false,9,3,-6,41.93125,-87.64432
TA1306000014,3,8,false,3,6,3,41.93242,-87.65271
TA1307000041,3,8,false,7,3,-4,41.93669,-87.63683
13137,3,8,false,2,7,5,41.9376,-87.6441
13229,3,8,false,1,6,5,41.93946,-87.66376
TA1307000134,3,8,false,6,3,-3,41.94016,-87.65303
TA1309000049,3,8,false,11,4,-7,41.94077,-87.63919
TA1309000025,3,8,false,1,5,4,41.94368,-87.64894
13278,3,8,false,1,6,5,41.94553,-87.64644
13325,3,8,false,8,4,-4,41.94907,-87.64863
13323,3,8,false,8,4,-4,41.95282,-87.65
TA1309000027,3,8,false,5,1,-4,41.9585,-87.65499
TA1309000066,3,8,false,1,6,5,41.9691,-87.67423
TA1309000011,3,8,true,1,7,6,41.78873,-87.60131
KA1504000076,3,8,true,6,6,0,41.7943,-87.60145
TA1308000009,3,8,true,9,2,-7,41.79522,-87.58075
KA1503000052,3,8,true,7,5,-2,41.79935,-87.60097
KA1503000007,3,8,true,6,1,-5,41.80242,-87.58689
TA1307000129,3,8,true,3,9,6,41.83104,-87.62683
13216,3,8,true,5,6,1,41.83473,-87.62581
TA1307000048,3,8,true,5,2,-3,41.83855,-87.60821
TA1308000036,3,8,true,4,5,1,41.83883,-87.62186
TA1307000005,3,8,true,2,12,10,41.84569,-87.6225
TA1305000001,3,8,true,6,6,0,41.85262,-87.6265
15545,3,8,true,7,4,-3,41.85627,-87.61334
13135,3,8,true,6,1,-5,41.85753,-87.66157
13102,3,8,true,13,2,-11,41.85762,-87.61942
13150,3,8,true,20,5,-15,41.85783,-87.62455
13163,3,8,true,7,1,-6,41.85808,-87.65108
SL-012,3,8,true,8,1,-7,41.86038,-87.62581
TA1306000002,3,8,true,3,5,2,41.86238,-87.65108
TA1307000124,3,8,true,10,4,-6,41.86411,-87.62372
TA1309000001,3,8,true,4,5,1,41.86488,-87.64708
TA1305000002,3,8,true,18,10,-8,41.86721,-87.62597
15544,3,8,true,4,7,3,41.86723,-87.61536
SL-005,3,8,true,24,6,-18,41.8679,-87.62304
13285,3,8,true,1,12,11,41.86928,-87.67372
TA1309000010,3,8,true,16,3,-13,41.87074,-87.62574
SL-009,3,8,true,8,1,-7,41.87081,-87.63121
TA1309000064,3,8,true,4,19,15,41.87127,-87.67369
TA1307000130,3,8,true,11,6,-5,41.87178,-87.65103
TA1307000121,3,8,true,3,8,5,41.87184,-87.64664
SL-008,3,8,true,22,10,-12,41.87209,-87.62956
13332,3,8,true,19,1,-18,41.87219,-87.6615
SL-011,3,8,true,14,5,-9,41.87256,-87.63356
KA1504000104,3,8,true,3,26,23,41.87296,-87.66912
SL-007,3,8,true,14,3,-11,41.87404,-87.6277
13326,3,8,true,1,10,9,41.87425,-87.63958
13028,3,8,true,6,3,-3,41.87475,-87.64981
SL-010,3,8,true,12,7,-5,41.87501,-87.63309
13037,3,8,true,1,8,7,41.87588,-87.64078
TA1305000009,3,8,true,7,9,2,41.87593,-87.63068
TA1305000010,3,8,true,7,3,-4,41.87623,-87.62444
624,3,8,true,4,12,8,41.87626,-87.62923
TA1305000035,3,8,true,5,16,11,41.87716,-87.62787
13138,3,8,true,8,20,12,41.87723,-87.63941
15539,3,8,true,4,7,3,41.87763,-87.64405
13158,3,8,true,13,11,-2,41.87764,-87.64957
13157,3,8,true,7,5,-2,41.87773,-87.6548
TA1305000025,3,8,true,12,52,40,41.87773,-87.63528
TA1309000002,3,8,true,3,9,6,41.87784,-87.62408
TA1309000004,3,8,true,8,32,24,41.87811,-87.63184
638,3,8,true,19,31,12,41.87827,-87.64078
TA1305000005,3,8,true,2,32,30,41.87924,-87.62975
13011,3,8,true,28,21,-7,41.87931,-87.63993
TA1309000008,3,8,true,7,15,8,41.87933,-87.6355
KA1503000015,3,8,true,3,16,13,41.87948,-87.6257
TA1309000007,3,8,true,8,54,46,41.88022,-87.63526
WL-011,3,8,true,11,9,-2,41.88034,-87.64273
13156,3,8,true,10,9,-1,41.88042,-87.65554
13300,3,8,true,6,6,0,41.88097,-87.61675
13008,3,8,true,3,9,6,41.88105,-87.62408
TA1305000006,3,8,true,2,45,43,41.88122,-87.6296
13056,3,8,true,13,21,8,41.88168,-87.63951
TA1307000120,3,8,true,26,12,-14,41.88188,-87.64879
13341,3,8,true,30,32,2,41.88208,-87.63985
13036,3,8,true,7,19,12,41.8821,-87.62513
TA1305000032,3,8,true,19,23,4,41.88218,-87.64109
13006,3,8,true,9,16,7,41.88268,-87.63252
13353,3,8,true,14,11,-3,41.88283,-87.6612
654,3,8,true,6,3,-3,41.88307,-87.65698
13409,3,8,true,7,13,6,41.8831,-87.6511
KA1503000072,3,8,true,7,23,16,41.88317,-87.63693
WL-012,3,8,true,39,47,8,41.88337,-87.6412
13053,3,8,true,10,16,6,41.88365,-87.64863
13001,3,8,true,21,26,5,41.88397,-87.62459
13155,3,8,true,2,10,8,41.88407,-87.65689
18062,3,8,true,8,9,1,41.88412,-87.65427
TA1306000010,3,8,true,10,50,40,41.88419,-87.62961
TA1305000030,3,8,true,8,70,62,41.88459,-87.63178
15535,3,8,true,9,4,-5,41.8846,-87.64455
TA1305000029,3,8,true,12,11,-1,41.88466,-87.62787
13263,3,8,true,35,14,-21,41.88467,-87.61952
TA1306000015,3,8,true,5,18,13,41.88549,-87.65232
13021,3,8,true,23,41,18,41.88559,-87.64184
TA1307000111,3,8,true,7,36,29,41.88582,-87.63548
13073,3,8,true,2,5,3,41.88592,-87.66717
KA1503000012,3,8,true,10,24,14,41.88599,-87.63089
TA1305000011,3,8,true,15,41,26,41.886,-87.62418
15534,3,8,true,14,5,-9,41.88627,-87.61749
13197,3,8,true,5,8,3,41.8866,-87.65816
TA1308000029,3,8,true,5,13,8,41.88673,-87.62225
TA1307000131,3,8,true,7,13,6,41.88688,-87.62606
KA1503000064,3,8,true,4,8,4,41.88697,-87.61281
TA1305000022,3,8,true,14,39,25,41.88817,-87.63656
TA1306000003,3,8,true,15,16,1,41.88867,-87.64442
KA1503000043,3,8,true,38,39,1,41.88918,-87.63851
13050,3,8,true,8,31,23,41.88919,-87.62775
15664,3,8,true,7,1,-6,41.8895,-87.68821
13432,3,8,true,9,6,-3,41.88989,-87.67149
TA1307000151,3,8,true,22,59,37,41.88993,-87.63427
636,3,8,true,10,25,15,41.88997,-87.63662
KA1503000044,3,8,true,11,15,4,41.89018,-87.6262
13427,3,8,true,10,8,-2,41.89054,-87.62205
13430,3,8,true,7,19,12,41.89077,-87.63169
TA1306000013,3,8,true,10,10,0,41.89083,-87.61852
RN-,3,8,true,6,7,1,41.89102,-87.63546
TA1308000006,3,8,true,2,5,3,41.89128,-87.67686
TA1307000117,3,8,true,11,18,7,41.89144,-87.62675
13033,3,8,true,15,19,4,41.8916,-87.64835
13194,3,8,true,11,12,1,41.8918,-87.65878
TA1305000003,3,8,true,22,19,-3,41.89187,-87.62061
13022,3,8,true,18,5,-13,41.89227,-87.61205
TA1306000029,3,8,true,10,11,1,41.89256,-87.61449
13265,3,8,true,28,19,-9,41.89383,-87.64172
13045,3,8,true,37,20,-17,41.89403,-87.62931
13016,3,8,true,14,46,32,41.89431,-87.62277
KA1503000041,3,8,true,17,21,4,41.89452,-87.61798
13196,3,8,true,8,1,-7,41.89455,-87.65345
TA1307000062,3,8,true,20,15,-5,41.89466,-87.63839
TA1306000012,3,8,true,32,32,0,41.89475,-87.63438
KP1705001026,3,8,true,14,9,-5,41.89483,-87.6323
18058,3,8,true,5,1,-4,41.8955,-87.68201
637,3,8,true,10,4,-6,41.89563,-87.67209
13132,3,8,true,7,6,-1,41.89573,-87.67718
15530,3,8,true,22,19,-3,41.89575,-87.62596
18003,3,8,true,3,10,7,41.89575,-87.62011
TA1305000020,3,8,true,5,9,4,41.89636,-87.65406
13289,3,8,true,16,2,-14,41.89638,-87.661
13303,3,8,true,13,2,-11,41.89672,-87.63088
13017,3,8,true,18,15,-3,41.89676,-87.6357
13338,3,8,true,10,9,-1,41.89697,-87.62173
TA1307000061,3,8,true,15,7,-8,41.89745,-87.62873
13034,3,8,true,3,11,8,41.89754,-87.62352
TA1306000009,3,8,true,15,54,39,41.89772,-87.64299
620,3,8,true,14,3,-11,41.89817,-87.63754
15529,3,8,true,7,9,2,41.89858,-87.62206
TA1307000128,3,8,true,13,9,-4,41.89896,-87.6299
657,3,8,true,10,1,-9,41.89918,-87.6722
KA1504000117,3,8,true,2,8,6,41.89936,-87.64848
13248,3,8,true,14,5,-9,41.89964,-87.66788
TA1306000011,3,8,true,20,5,-15,41.89994,-87.63443
KA1504000116,3,8,true,10,5,-5,41.90023,-87.64299
13290,3,8,true,17,7,-10,41.90069,-87.66259
13042,3,8,true,17,18,1,41.90097,-87.62377
TA1307000070,3,8,true,11,1,-10,41.90133,-87.67742
KA1504000133,3,8,true,7,5,-2,41.90234,-87.62773
13241,3,8,true,7,4,-3,41.9029,-87.68731
TA1307000039,3,8,true,29,10,-19,41.90294,-87.63137
658,3,8,true,1,5,4,41.903,-87.6838
KA1504000135,3,8,true,16,9,-7,41.90319,-87.63439
13136,3,8,true,6,9,3,41.90326,-87.67845
13061,3,8,true,20,12,-8,41.90342,-87.66779
KA1504000079,3,8,true,9,7,-2,41.9035,-87.64334
TA1307000115,3,8,true,13,3,-10,41.9046,-87.64056
TA1308000049,3,8,true,6,12,6,41.90672,-87.6349
KA1504000134,3,8,true,6,6,0,41.90687,-87.6262
13224,3,8,true,7,5,-2,41.90706,-87.66725
13221,3,8,true,5,4,-1,41.90765,-87.67254
TA1309000024,3,8,true,12,10,-2,41.908,-87.63152
TA1305000041,3,8,true,5,9,4,41.9094,-87.67769
331,3,8,true,8,10,2,41.90965,-87.64812
TA1305000037,3,8,true,6,9,3,41.91018,-87.67003
TA1306000008,3,8,true,6,2,-4,41.9102,-87.6435
13154,3,8,true,8,10,2,41.91054,-87.65312
13058,3,8,true,7,1,-6,41.91059,-87.64942
TA1307000038,3,8,true,12,6,-6,41.91138,-87.63868
LF-005,3,8,true,19,10,-9,41.91172,-87.62681
13128,3,8,true,6,7,1,41.91197,-87.63197
TA1308000050,3,8,true,13,8,-5,41.91211,-87.6347
13243,3,8,true,11,2,-9,41.91262,-87.6814
TA1306000032,3,8,true,5,5,0,41.9137,-87.65285
TA1307000166,3,8,true,5,6,1,41.91386,-87.64877
TA1306000007,3,8,true,12,5,-7,41.91469,-87.64333
13179,3,8,true,17,12,-5,41.9157,-87.63461
13133,3,8,true,11,7,-4,41.91598,-87.67733
TA1309000029,3,8,true,6,5,-1,41.9178,-87.68245
TA1309000006,3,8,true,5,3,-2,41.91809,-87.64375
TA1307000163,3,8,true,13,10,-3,41.91821,-87.65696
13146,3,8,true,14,15,1,41.91831,-87.63629
13059,3,8,true,6,12,6,41.91845,-87.65222
13192,3,8,true,11,2,-9,41.91995,-87.64884
13288,3,8,true,6,1,-5,41.92008,-87.67788
TA1309000030,3,8,true,5,9,4,41.92077,-87.66372
TA1309000033,3,8,true,7,3,-4,41.92158,-87.65381
13193,3,8,true,20,15,-5,41.92182,-87.64412
13191,3,8,true,15,4,-11,41.92217,-87.63891
LP-,3,8,true,11,3,-8,41.92396,-87.63584
TA1307000001,3,8,true,8,3,-5,41.92535,-87.66581
TA1306000026,3,8,true,10,6,-4,41.92558,-87.65842
TA1306000016,3,8,true,7,15,8,41.9256,-87.65371
TA1309000019,3,8,true,14,5,-9,41.92586,-87.63897
TA1309000058,3,8,true,21,16,-5,41.92591,-87.64927
TA1308000001,3,8,true,7,5,-2,41.92627,-87.63086
TA1309000023,3,8,true,10,6,-4,41.9287,-87.65383
13296,3,8,true,7,6,-1,41.92883,-87.66852
TA1309000059,3,8,true,8,7,-1,41.92889,-87.65898
TA1309000061,3,8,true,9,6,-3,41.92915,-87.64909
TA1305000014,3,8,true,17,15,-2,41.92956,-87.64313
13085,3,8,true,5,1,-4,41.92958,-87.70789
TA1307000142,3,8,true,18,7,-11,41.93125,-87.64432
13276,3,8,true,14,7,-7,41.93132,-87.63874
TA1307000064,3,8,true,16,4,-12,41.93222,-87.65864
TA1306000014,3,8,true,8,9,1,41.93242,-87.65271
TA1309000039,3,8,true,17,8,-9,41.93258,-87.63642
TA1309000036,3,8,true,4,7,3,41.93313,-87.64776
TA1307000006,3,8,true,8,3,-5,41.93571,-87.6636
TA1307000052,3,8,true,15,17,2,41.93628,-87.65266
TA1307000136,3,8,true,10,9,-1,41.9365,-87.64755
TA1307000041,3,8,true,19,10,-9,41.93669,-87.63683
13137,3,8,true,15,14,-1,41.9376,-87.6441
TA1309000042,3,8,true,5,1,-4,41.93937,-87.66836
13229,3,8,true,9,6,-3,41.93946,-87.66376
TA1308000019,3,8,true,6,4,-2,41.93973,-87.65886
13277,3,8,true,12,4,-8,41.9401,-87.64546
TA1307000134,3,8,true,9,17,8,41.94016,-87.65303
TA1309000049,3,8,true,17,11,-6,41.94077,-87.63919
15634,3,8,true,5,2,-3,41.94304,-87.68729
TA1307000138,3,8,true,6,6,0,41.94334,-87.67094
13144,3,8,true,5,3,-2,41.9434,-87.67964
TA1309000025,3,8,true,7,4,-3,41.94368,-87.64894
13071,3,8,true,4,10,6,41.94373,-87.66401
632,3,8,true,7,5,-2,41.94453,-87.6547
13278,3,8,true,2,10,8,41.94553,-87.64644
13235,3,8,true,5,7,2,41.94814,-87.66396
13253,3,8,true,6,1,-5,41.9488,-87.67527
13325,3,8,true,9,6,-3,41.94907,-87.64863
TA1307000126,3,8,true,2,5,3,41.94936,-87.65451
TA1307000150,3,8,true,11,8,-3,41.94945,-87.64646
13319,3,8,true,3,6,3,41.95069,-87.6687
TA1307000127,3,8,true,6,3,-3,41.9508,-87.65918
13323,3,8,true,5,3,-2,41.95282,-87.65
TA1309000043,3,8,true,8,4,-4,41.95417,-87.66434
13063,3,8,true,3,7,4,41.95424,-87.65441
TA1308000022,3,8,true,6,6,0,41.95438,-87.64805
13379,3,8,true,13,1,-12,41.95786,-87.6495
TA1309000027,3,8,true,8,9,1,41.9585,-87.65499
13389,3,8,true,11,5,-6,41.961,-87.64958
TA1307000144,3,8,true,3,5,2,41.96142,-87.6762
15623,3,8,true,9,2,-7,41.96154,-87.69117
KA1503000022,3,8,true,2,6,4,41.96158,-87.66609
TA1307000107,3,8,true,6,6,0,41.96164,-87.65464
KA1504000093,3,8,true,5,1,-4,41.96587,-87.69365
TA1307000140,3,8,true,5,6,1,41.96643,-87.68865
TA1309000014,3,8,true,5,9,4,41.96709,-87.66744
TA1307000158,3,8,true,7,2,-5,41.9671,-87.67904
TA1309000066,3,8,true,13,7,-6,41.9691,-87.67423
KA1504000171,3,8,true,5,2,-3,41.97161,-87.65016
TA1309000035,3,8,true,8,6,-2,41.97335,-87.66785
13108,3,8,true,6,2,-4,41.97379,-87.65971
KA1504000146,3,8,true,3,5,2,41.978,-87.66805
KA1504000151,3,8,true,6,3,-3,41.98359,-87.66916
KA1504000152,3,8,true,6,9,3,41.98403,-87.65231
15571,3,8,true,6,2,-4,41.99478,-87.66028
E002,3,8,true,5,2,-3,42.03256,-87.67912
WL-008,3,9,false,7,2,-5,41.86712,-87.64108
15544,3,9,false,5,17,12,41.86723,-87.61536
SL-005,3,9,false,10,1,-9,41.8679,-87.62304
623,3,9,false,15,3,-12,41.87272,-87.62399
13158,3,9,false,1,5,4,41.87764,-87.64957
TA1305000025,3,9,false,2,8,6,41.87773,-87.63528
TA1309000007,3,9,false,4,10,6,41.88022,-87.63526
13300,3,9,false,12,6,-6,41.88097,-87.61675
13008,3,9,false,5,17,12,41.88105,-87.62408
13341,3,9,false,4,5,1,41.88208,-87.63985
WL-012,3,9,false,5,2,-3,41.88337,-87.6412
13053,3,9,false,3,5,2,41.88365,-87.64863
13001,3,9,false,5,7,2,41.88397,-87.62459
TA1305000030,3,9,false,3,8,5,41.88459,-87.63178
13263,3,9,false,3,6,3,41.88467,-87.61952
TA1306000015,3,9,false,4,7,3,41.88549,-87.65232
13021,3,9,false,1,5,4,41.88559,-87.64184
TA1307000111,3,9,false,3,7,4,41.88582,-87.63548
KA1503000012,3,9,false,4,7,3,41.88599,-87.63089
TA1305000011,3,9,false,11,3,-8,41.886,-87.62418
TA1308000029,3,9,false,5,2,-3,41.88673,-87.62225
TA1307000131,3,9,false,4,5,1,41.88688,-87.62606
KA1503000043,3,9,false,5,4,-1,41.88918,-87.63851
TA1307000151,3,9,false,5,9,4,41.88993,-87.63427
KA1503000044,3,9,false,5,3,-2,41.89018,-87.6262
13430,3,9,false,3,6,3,41.89077,-87.63169
TA1307000117,3,9,false,17,7,-10,41.89144,-87.62675
TA1305000003,3,9,false,3,5,2,41.89187,-87.62061
13022,3,9,false,12,13,1,41.89227,-87.61205
TA1306000029,3,9,false,7,1,-6,41.89256,-87.61449
13045,3,9,false,11,4,-7,41.89403,-87.62931
13016,3,9,false,7,1,-6,41.89431,-87.62277
KA1503000041,3,9,false,7,5,-2,41.89452,-87.61798
TA1307000062,3,9,false,10,4,-6,41.89466,-87.63839
TA1306000012,3,9,false,6,6,0,41.89475,-87.63438
13303,3,9,false,2,5,3,41.89672,-87.63088
TA1306000009,3,9,false,2,9,7,41.89772,-87.64299
13042,3,9,false,19,17,-2,41.90097,-87.62377
TA1307000039,3,9,false,5,12,7,41.90294,-87.63137
KA1504000135,3,9,false,6,8,2,41.90319,-87.63439
KA1504000134,3,9,false,6,1,-5,41.90687,-87.6262
LF-005,3,9,false,8,8,0,41.91172,-87.62681
13128,3,9,false,5,2,-3,41.91197,-87.63197
13179,3,9,false,3,5,2,41.9157,-87.63461
TA1309000019,3,9,false,8,6,-2,41.92586,-87.63897
TA1309000058,3,9,false,3,5,2,41.92591,-87.64927
TA1309000039,3,9,false,5,5,0,41.93258,-87.63642
13137,3,9,false,6,4,-2,41.9376,-87.6441
13229,3,9,false,4,7,3,41.93946,-87.66376
TA1309000049,3,9,false,8,2,-6,41.94077,-87.63919
TA1309000025,3,9,false,7,2,-5,41.94368,-87.64894
13325,3,9,false,6,3,-3,41.94907,-87.64863
TA1307000127,3,9,false,5,3,-2,41.9508,-87.65918
TA1309000027,3,9,false,5,3,-2,41.9585,-87.65499
KA1503000071,3,9,true,2,9,7,41.79148,-87.59988
KA1503000059,3,9,true,3,5,2,41.79952,-87.58643
TA1309000037,3,9,true,7,2,-5,41.79957,-87.59474
KA1503000007,3,9,true,5,1,-4,41.80242,-87.58689
TA1308000045,3,9,true,5,2,-3,41.83062,-87.64129
13217,3,9,true,8,2,-6,41.83488,-87.61792
TA1308000036,3,9,true,8,5,-3,41.83883,-87.62186
13075,3,9,true,1,5,4,41.8531,-87.63192
13102,3,9,true,6,1,-5,41.85762,-87.61942
13150,3,9,true,6,6,0,41.85783,-87.62455
TA1307000159,3,9,true,5,2,-3,41.8579,-87.6687
13164,3,9,true,6,4,-2,41.85818,-87.65648
SL-012,3,9,true,5,4,-1,41.86038,-87.62581
TA1305000002,3,9,true,7,5,-2,41.86721,-87.62597
SL-005,3,9,true,10,3,-7,41.8679,-87.62304
644,3,9,true,8,1,-7,41.86859,-87.68625
13285,3,9,true,3,15,12,41.86928,-87.67372
15550,3,9,true,1,6,5,41.87024,-87.63947
TA1309000010,3,9,true,5,3,-2,41.87074,-87.62574
TA1309000064,3,9,true,9,16,7,41.87127,-87.67369
TA1307000130,3,9,true,7,12,5,41.87178,-87.65103
TA1307000121,3,9,true,5,4,-1,41.87184,-87.64664
13332,3,9,true,21,10,-11,41.87219,-87.6615
623,3,9,true,9,3,-6,41.87272,-87.62399
KA1504000104,3,9,true,3,7,4,41.87296,-87.66912
SL-010,3,9,true,5,4,-1,41.87501,-87.63309
624,3,9,true,5,4,-1,41.87626,-87.62923
TA1305000035,3,9,true,5,3,-2,41.87716,-87.62787
13138,3,9,true,3,6,3,41.87723,-87.63941
13158,3,9,true,3,10,7,41.87764,-87.64957
13157,3,9,true,5,7,2,41.87773,-87.6548
TA1305000025,3,9,true,2,15,13,41.87773,-87.63528
TA1309000002,3,9,true,4,9,5,41.87784,-87.62408
TA1309000004,3,9,true,5,11,6,41.87811,-87.63184
638,3,9,true,8,17,9,41.87827,-87.64078
TA1305000005,3,9,true,3,14,11,41.87924,-87.62975
KA1503000034,3,9,true,1,7,6,41.87938,-87.63197
KA1503000015,3,9,true,3,6,3,41.87948,-87.6257
TA1309000007,3,9,true,5,28,23,41.88022,-87.63526
WL-011,3,9,true,6,6,0,41.88034,-87.64273
13156,3,9,true,1,8,7,41.88042,-87.65554
13008,3,9,true,3,12,9,41.88105,-87.62408
TA1305000006,3,9,true,2,5,3,41.88122,-87.6296
13056,3,9,true,8,5,-3,41.88168,-87.63951
TA1307000120,3,9,true,11,11,0,41.88188,-87.64879
13341,3,9,true,4,15,11,41.88208,-87.63985
13036,3,9,true,7,5,-2,41.8821,-87.62513
TA1305000032,3,9,true,3,6,3,41.88218,-87.64109
13006,3,9,true,7,11,4,41.88268,-87.63252
654,3,9,true,6,5,-1,41.88307,-87.65698
13409,3,9,true,5,2,-3,41.8831,-87.6511
KA1503000072,3,9,true,2,5,3,41.88317,-87.63693
WL-012,3,9,true,15,22,7,41.88337,-87.6412
13053,3,9,true,8,17,9,41.88365,-87.64863
13001,3,9,true,4,19,15,41.88397,-87.62459
TA1306000010,3,9,true,6,34,28,41.88419,-87.62961
TA1305000030,3,9,true,9,27,18,41.88459,-87.63178
TA1305000029,3,9,true,5,10,5,41.88466,-87.62787
13263,3,9,true,6,6,0,41.88467,-87.61952
TA1306000015,3,9,true,9,12,3,41.88549,-87.65232
13021,3,9,true,10,14,4,41.88559,-87.64184
TA1307000111,3,9,true,7,9,2,41.88582,-87.63548
KA1503000012,3,9,true,5,20,15,41.88599,-87.63089
TA1305000011,3,9,true,11,15,4,41.886,-87.62418
TA1308000029,3,9,true,8,7,-1,41.88673,-87.62225
TA1307000131,3,9,true,1,8,7,41.88688,-87.62606
KA1503000064,3,9,true,4,6,2,41.88697,-87.61281
TA1305000022,3,9,true,11,20,9,41.88817,-87.63656
TA1306000003,3,9,true,6,10,4,41.88867,-87.64442
KA1503000043,3,9,true,22,23,1,41.88918,-87.63851
13050,3,9,true,7,15,8,41.88919,-87.62775
TA1307000151,3,9,true,13,25,12,41.88993,-87.63427
636,3,9,true,9,9,0,41.88997,-87.63662
KA1503000044,3,9,true,4,7,3,41.89018,-87.6262
13427,3,9,true,3,5,2,41.89054,-87.62205
13430,3,9,true,5,11,6,41.89077,-87.63169
TA1306000013,3,9,true,7,3,-4,41.89083,-87.61852
RN-,3,9,true,4,11,7,41.89102,-87.63546
13434,3,9,true,5,4,-1,41.89108,-87.66663
TA1308000006,3,9,true,6,2,-4,41.89128,-87.67686
TA1307000117,3,9,true,6,19,13,41.89144,-87.62675
13033,3,9,true,11,5,-6,41.8916,-87.64835
13194,3,9,true,10,4,-6,41.8918,-87.65878
TA1305000003,3,9,true,10,8,-2,41.89187,-87.62061
13022,3,9,true,1,5,4,41.89227,-87.61205
TA1306000029,3,9,true,5,3,-2,41.89256,-87.61449
13265,3,9,true,9,8,-1,41.89383,-87.64172
13045,3,9,true,12,8,-4,41.89403,-87.62931
13016,3,9,true,7,19,12,41.89431,-87.62277
KA1503000041,3,9,true,10,21,11,41.89452,-87.61798
TA1307000062,3,9,true,12,8,-4,41.89466,-87.63839
TA1306000012,3,9,true,13,18,5,41.89475,-87.63438
KP1705001026,3,9,true,6,8,2,41.89483,-87.6323
15530,3,9,true,8,12,4,41.89575,-87.62596
18003,3,9,true,3,7,4,41.89575,-87.62011
TA1305000020,3,9,true,2,8,6,41.89636,-87.65406
13303,3,9,true,6,1,-5,41.89672,-87.63088
13017,3,9,true,13,6,-7,41.89676,-87.6357
13338,3,9,true,3,5,2,41.89697,-87.62173
TA1307000061,3,9,true,1,5,4,41.89745,-87.62873
TA1306000009,3,9,true,9,21,12,41.89772,-87.64299
620,3,9,true,5,2,-3,41.89817,-87.63754
15529,3,9,true,7,15,8,41.89858,-87.62206
13042,3,9,true,11,21,10,41.90097,-87.62377
KA1504000133,3,9,true,6,4,-2,41.90234,-87.62773
13241,3,9,true,4,5,1,41.9029,-87.68731
TA1307000039,3,9,true,19,14,-5,41.90294,-87.63137
KA1504000135,3,9,true,7,11,4,41.90319,-87.63439
13136,3,9,true,6,1,-5,41.90326,-87.67845
13061,3,9,true,14,11,-3,41.90342,-87.66779
KA1504000079,3,9,true,8,3,-5,41.9035,-87.64334
TA1308000049,3,9,true,6,3,-3,41.90672,-87.6349
KA1504000134,3,9,true,8,7,-1,41.90687,-87.6262
13224,3,9,true,5,5,0,41.90706,-87.66725
13221,3,9,true,8,6,-2,41.90765,-87.67254
TA1305000041,3,9,true,2,7,5,41.9094,-87.67769
331,3,9,true,8,4,-4,41.90965,-87.64812
TA1305000037,3,9,true,6,4,-2,41.91018,-87.67003
13154,3,9,true,5,6,1,41.91054,-87.65312
LF-005,3,9,true,9,8,-1,41.91172,-87.62681
TA1308000050,3,9,true,9,7,-2,41.91211,-87.6347
TA1306000032,3,9,true,8,4,-4,41.9137,-87.65285
TA1307000166,3,9,true,5,6,1,41.91386,-87.64877
TA1306000007,3,9,true,6,4,-2,41.91469,-87.64333
13068,3,9,true,3,10,7,41.91554,-87.68703
13179,3,9,true,9,13,4,41.9157,-87.63461
13133,3,9,true,10,1,-9,41.91598,-87.67733
13146,3,9,true,9,7,-2,41.91831,-87.63629
13059,3,9,true,11,4,-7,41.91845,-87.65222
13192,3,9,true,6,4,-2,41.91995,-87.64884
TA1309000030,3,9,true,3,5,2,41.92077,-87.66372
13193,3,9,true,11,5,-6,41.92182,-87.64412
13191,3,9,true,6,5,-1,41.92217,-87.63891
TA1307000001,3,9,true,5,1,-4,41.92535,-87.66581
TA1306000026,3,9,true,3,7,4,41.92558,-87.65842
TA1306000016,3,9,true,9,8,-1,41.9256,-87.65371
TA1309000058,3,9,true,4,9,5,41.92591,-87.64927
TA1308000001,3,9,true,8,12,4,41.92627,-87.63086
TA1309000059,3,9,true,7,4,-3,41.92889,-87.65898
TA1305000014,3,9,true,13,4,-9,41.92956,-87.64313
TA1307000142,3,9,true,5,5,0,41.93125,-87.64432
13276,3,9,true,12,9,-3,41.93132,-87.63874
TA1307000064,3,9,true,6,8,2,41.93222,-87.65864
TA1306000014,3,9,true,5,5,0,41.93242,-87.65271
TA1309000039,3,9,true,5,2,-3,41.93258,-87.63642
TA1309000036,3,9,true,8,4,-4,41.93313,-87.64776
TA1307000052,3,9,true,8,4,-4,41.93628,-87.65266
TA1307000136,3,9,true,6,8,2,41.9365,-87.64755
TA1307000041,3,9,true,9,7,-2,41.93669,-87.63683
13137,3,9,true,7,4,-3,41.9376,-87.6441
TA1307000134,3,9,true,2,9,7,41.94016,-87.65303
TA1309000049,3,9,true,8,6,-2,41.94077,-87.63919
TA1307000138,3,9,true,8,7,-1,41.94334,-87.67094
TA1309000025,3,9,true,8,4,-4,41.94368,-87.64894
13071,3,9,true,8,7,-1,41.94373,-87.66401
632,3,9,true,1,5,4,41.94453,-87.6547
13278,3,9,true,7,2,-5,41.94553,-87.64644
13235,3,9,true,7,9,2,41.94814,-87.66396
13325,3,9,true,6,13,7,41.94907,-87.64863
TA1307000126,3,9,true,4,5,1,41.94936,-87.65451
TA1307000150,3,9,true,11,3,-8,41.94945,-87.64646
13319,3,9,true,6,3,-3,41.95069,-87.6687
TA1307000127,3,9,true,8,6,-2,41.9508,-87.65918
13323,3,9,true,9,2,-7,41.95282,-87.65
13063,3,9,true,3,6,3,41.95424,-87.65441
TA1308000022,3,9,true,5,3,-2,41.95438,-87.64805
TA1307000149,3,9,true,3,5,2,41.95467,-87.67392
13379,3,9,true,6,7,1,41.95786,-87.6495
TA1309000027,3,9,true,10,4,-6,41.9585,-87.65499
KA1503000022,3,9,true,2,6,4,41.96158,-87.66609
TA1307000107,3,9,true,5,3,-2,41.96164,-87.65464
TA1307000156,3,9,true,5,2,-3,41.96301,-87.68479
TA1309000014,3,9,true,10,7,-3,41.96709,-87.66744
TA1307000158,3,9,true,3,5,2,41.9671,-87.67904
TA1309000041,3,9,true,3,5,2,41.96951,-87.65471
TA1309000035,3,9,true,6,2,-4,41.97335,-87.66785
KA1504000146,3,9,true,3,5,2,41.978,-87.66805
13109,3,9,true,4,5,1,41.97835,-87.65976
KA1504000151,3,9,true,3,5,2,41.98359,-87.66916
KA1504000152,3,9,true,7,5,-2,41.98403,-87.65231
596,3,9,true,5,1,-4,42.04822,-87.68348
KA1503000074,3,10,false,7,13,6,41.79174,-87.58395
TA1308000009,3,10,false,2,5,3,41.79522,-87.58075
KA1503000059,3,10,false,6,2,-4,41.79952,-87.58643
TA1309000037,3,10,false,3,6,3,41.79957,-87.59474
KA1503000004,3,10,false,1,5,4,41.83127,-87.6088
TA1307000048,3,10,false,7,5,-2,41.83855,-87.60821
WL-008,3,10,false,5,3,-2,41.86712,-87.64108
15544,3,10,false,4,19,15,41.86723,-87.61536
SL-005,3,10,false,11,5,-6,41.8679,-87.62304
623,3,10,false,13,7,-6,41.87272,-87.62399
SL-007,3,10,false,5,1,-4,41.87404,-87.6277
15541,3,10,false,6,2,-4,41.8758,-87.62086
TA1309000002,3,10,false,6,2,-4,41.87784,-87.62408
TA1309000008,3,10,false,6,4,-2,41.87933,-87.6355
TA1309000007,3,10,false,6,8,2,41.88022,-87.63526
13156,3,10,false,5,2,-3,41.88042,-87.65554
13300,3,10,false,19,17,-2,41.88097,-87.61675
13008,3,10,false,18,11,-7,41.88105,-87.62408
TA1305000006,3,10,false,9,5,-4,41.88122,-87.6296
13001,3,10,false,8,7,-1,41.88397,-87.62459
TA1306000010,3,10,false,11,6,-5,41.88419,-87.62961
TA1305000030,3,10,false,5,2,-3,41.88459,-87.63178
TA1305000029,3,10,false,12,6,-6,41.88466,-87.62787
13263,3,10,false,11,1,-10,41.88467,-87.61952
TA1306000015,3,10,false,2,5,3,41.88549,-87.65232
TA1307000111,3,10,false,3,5,2,41.88582,-87.63548
KA1503000012,3,10,false,3,7,4,41.88599,-87.63089
TA1305000011,3,10,false,15,7,-8,41.886,-87.62418
TA1307000131,3,10,false,11,5,-6,41.88688,-87.62606
KA1503000064,3,10,false,9,2,-7,41.88697,-87.61281
KA1503000043,3,10,false,7,2,-5,41.88918,-87.63851
TA1307000151,3,10,false,5,3,-2,41.88993,-87.63427
13430,3,10,false,9,7,-2,41.89077,-87.63169
TA1306000013,3,10,false,7,8,1,41.89083,-87.61852
TA1307000117,3,10,false,10,4,-6,41.89144,-87.62675
13033,3,10,false,1,6,5,41.8916,-87.64835
TA1305000003,3,10,false,8,4,-4,41.89187,-87.62061
13022,3,10,false,31,43,12,41.89227,-87.61205
TA1306000029,3,10,false,3,5,2,41.89256,-87.61449
13016,3,10,false,6,8,2,41.89431,-87.62277
KA1503000041,3,10,false,5,6,1,41.89452,-87.61798
TA1306000012,3,10,false,4,5,1,41.89475,-87.63438
13132,3,10,false,2,5,3,41.89573,-87.67718
15530,3,10,false,13,10,-3,41.89575,-87.62596
13247,3,10,false,5,6,1,41.89597,-87.66775
13017,3,10,false,3,5,2,41.89676,-87.6357
15529,3,10,false,6,5,-1,41.89858,-87.62206
TA1306000011,3,10,false,5,5,0,41.89994,-87.63443
13042,3,10,false,14,13,-1,41.90097,-87.62377
KA1504000133,3,10,false,10,2,-8,41.90234,-87.62773
TA1307000039,3,10,false,7,7,0,41.90294,-87.63137
KA1504000135,3,10,false,6,6,0,41.90319,-87.63439
331,3,10,false,1,6,5,41.90965,-87.64812
TA1307000038,3,10,false,8,3,-5,41.91138,-87.63868
LF-005,3,10,false,4,7,3,41.91172,-87.62681
13128,3,10,false,5,2,-3,41.91197,-87.63197
TA1308000050,3,10,false,7,5,-2,41.91211,-87.6347
13179,3,10,false,7,8,1,41.9157,-87.63461
13133,3,10,false,5,1,-4,41.91598,-87.67733
13191,3,10,false,6,2,-4,41.92217,-87.63891
TA1309000058,3,10,false,1,8,7,41.92591,-87.64927
TA1308000001,3,10,false,12,9,-3,41.92627,-87.63086
TA1307000142,3,10,false,9,2,-7,41.93125,-87.64432
13276,3,10,false,6,4,-2,41.93132,-87.63874
TA1309000039,3,10,false,5,2,-3,41.93258,-87.63642
TA1307000134,3,10,false,6,6,0,41.94016,-87.65303
TA1309000049,3,10,false,7,4,-3,41.94077,-87.63919
13235,3,10,false,5,1,-4,41.94814,-87.66396
TA1307000150,3,10,false,5,1,-4,41.94945,-87.64646
KA1503000014,3,10,true,5,2,-3,41.7851,-87.60108
TA1309000011,3,10,true,2,5,3,41.78873,-87.60131
KA1503000071,3,10,true,3,11,8,41.79148,-87.59988
KA1504000076,3,10,true,2,6,4,41.7943,-87.60145
TA1308000036,3,10,true,6,2,-4,41.83883,-87.62186
15545,3,10,true,8,6,-2,41.85627,-87.61334
13102,3,10,true,7,4,-3,41.85762,-87.61942
13150,3,10,true,5,3,-2,41.85783,-87.62455
SL-005,3,10,true,9,10,1,41.8679,-87.62304
13285,3,10,true,2,12,10,41.86928,-87.67372
TA1309000010,3,10,true,4,6,2,41.87074,-87.62574
TA1309000064,3,10,true,1,6,5,41.87127,-87.67369
TA1307000130,3,10,true,7,9,2,41.87178,-87.65103
TA1307000121,3,10,true,9,14,5,41.87184,-87.64664
13332,3,10,true,9,9,0,41.87219,-87.6615
KA1504000104,3,10,true,10,4,-6,41.87296,-87.66912
TA1306000025,3,10,true,5,2,-3,41.87464,-87.65703
13158,3,10,true,9,4,-5,41.87764,-87.64957
13157,3,10,true,2,5,3,41.87773,-87.6548
TA1305000025,3,10,true,6,9,3,41.87773,-87.63528
TA1309000004,3,10,true,1,6,5,41.87811,-87.63184
638,3,10,true,5,4,-1,41.87827,-87.64078
13011,3,10,true,4,8,4,41.87931,-87.63993
TA1309000008,3,10,true,2,5,3,41.87933,-87.6355
TA1309000007,3,10,true,5,5,0,41.88022,-87.63526
13008,3,10,true,2,7,5,41.88105,-87.62408
TA1305000006,3,10,true,10,11,1,41.88122,-87.6296
13341,3,10,true,3,9,6,41.88208,-87.63985
13036,3,10,true,1,8,7,41.8821,-87.62513
TA1305000032,3,10,true,5,9,4,41.88218,-87.64109
13006,3,10,true,3,5,2,41.88268,-87.63252
13409,3,10,true,1,5,4,41.8831,-87.6511
KA1503000072,3,10,true,5,3,-2,41.88317,-87.63693
WL-012,3,10,true,2,9,7,41.88337,-87.6412
13001,3,10,true,10,5,-5,41.88397,-87.62459
TA1306000010,3,10,true,5,21,16,41.88419,-87.62961
TA1305000030,3,10,true,5,4,-1,41.88459,-87.63178
15535,3,10,true,1,5,4,41.8846,-87.64455
TA1305000029,3,10,true,6,10,4,41.88466,-87.62787
13263,3,10,true,8,15,7,41.88467,-87.61952
13021,3,10,true,2,10,8,41.88559,-87.64184
TA1307000111,3,10,true,3,7,4,41.88582,-87.63548
TA1305000011,3,10,true,10,6,-4,41.886,-87.62418
TA1308000029,3,10,true,1,9,8,41.88673,-87.62225
TA1305000022,3,10,true,10,6,-4,41.88817,-87.63656
TA1306000003,3,10,true,11,4,-7,41.88867,-87.64442
KA1503000043,3,10,true,12,13,1,41.88918,-87.63851
13050,3,10,true,5,6,1,41.88919,-87.62775
TA1307000151,3,10,true,7,11,4,41.88993,-87.63427
TA1306000013,3,10,true,6,4,-2,41.89083,-87.61852
RN-,3,10,true,6,5,-1,41.89102,-87.63546
TA1307000117,3,10,true,7,12,5,41.89144,-87.62675
13033,3,10,true,6,2,-4,41.8916,-87.64835
TA1305000003,3,10,true,9,6,-3,41.89187,-87.62061
13022,3,10,true,9,10,1,41.89227,-87.61205
13265,3,10,true,8,3,-5,41.89383,-87.64172
13045,3,10,true,11,16,5,41.89403,-87.62931
13016,3,10,true,3,6,3,41.89431,-87.62277
KA1503000041,3,10,true,11,14,3,41.89452,-87.61798
TA1307000062,3,10,true,6,5,-1,41.89466,-87.63839
TA1306000012,3,10,true,17,13,-4,41.89475,-87.63438
KP1705001026,3,10,true,5,3,-2,41.89483,-87.6323
13132,3,10,true,5,3,-2,41.89573,-87.67718
15530,3,10,true,8,7,-1,41.89575,-87.62596
13289,3,10,true,6,3,-3,41.89638,-87.661
13017,3,10,true,7,4,-3,41.89676,-87.6357
13338,3,10,true,7,12,5,41.89697,-87.62173
TA1307000061,3,10,true,8,7,-1,41.89745,-87.62873
TA1306000009,3,10,true,6,9,3,41.89772,-87.64299
620,3,10,true,5,2,-3,41.89817,-87.63754
15529,3,10,true,3,9,6,41.89858,-87.62206
13248,3,10,true,8,2,-6,41.89964,-87.66788
TA1306000011,3,10,true,7,2,-5,41.89994,-87.63443
13042,3,10,true,7,12,5,41.90097,-87.62377
KA1504000133,3,10,true,8,13,5,41.90234,-87.62773
TA1307000039,3,10,true,12,17,5,41.90294,-87.63137
TA1305000034,3,10,true,2,6,4,41.90313,-87.67391
KA1504000135,3,10,true,8,8,0,41.90319,-87.63439
13061,3,10,true,12,6,-6,41.90342,-87.66779
TA1308000049,3,10,true,5,5,0,41.90672,-87.6349
KA1504000134,3,10,true,1,6,5,41.90687,-87.6262
TA1309000024,3,10,true,11,4,-7,41.908,-87.63152
TA1305000041,3,10,true,3,5,2,41.9094,-87.67769
331,3,10,true,3,7,4,41.90965,-87.64812
13154,3,10,true,5,3,-2,41.91054,-87.65312
TA1307000038,3,10,true,7,7,0,41.91138,-87.63868
LF-005,3,10,true,6,7,1,41.91172,-87.62681
TA1308000050,3,10,true,6,8,2,41.91211,-87.6347
13243,3,10,true,2,6,4,41.91262,-87.6814
TA1306000032,3,10,true,9,5,-4,41.9137,-87.65285
TA1307000166,3,10,true,2,6,4,41.91386,-87.64877
13068,3,10,true,7,4,-3,41.91554,-87.68703
13179,3,10,true,6,11,5,41.9157,-87.63461
13146,3,10,true,5,5,0,41.91831,-87.63629
13059,3,10,true,6,4,-2,41.91845,-87.65222
13192,3,10,true,6,5,-1,41.91995,-87.64884
TA1309000033,3,10,true,7,6,-1,41.92158,-87.65381
13193,3,10,true,8,10,2,41.92182,-87.64412
13191,3,10,true,5,3,-2,41.92217,-87.63891
TA1307000001,3,10,true,4,9,5,41.92535,-87.66581
TA1309000019,3,10,true,5,5,0,41.92586,-87.63897
TA1309000058,3,10,true,7,4,-3,41.92591,-87.64927
TA1308000001,3,10,true,13,9,-4,41.92627,-87.63086
TA1309000061,3,10,true,5,5,0,41.92915,-87.64909
TA1305000014,3,10,true,8,3,-5,41.92956,-87.64313
TA1307000142,3,10,true,8,10,2,41.93125,-87.64432
13276,3,10,true,8,9,1,41.93132,-87.63874
TA1307000064,3,10,true,6,3,-3,41.93222,-87.65864
TA1309000039,3,10,true,6,3,-3,41.93258,-87.63642
TA1309000036,3,10,true,8,6,-2,41.93313,-87.64776
TA1307000006,3,10,true,2,5,3,41.93571,-87.6636
13269,3,10,true,5,3,-2,41.93609,-87.66983
TA1307000136,3,10,true,7,5,-2,41.9365,-87.64755
TA1307000041,3,10,true,4,5,1,41.93669,-87.63683
13137,3,10,true,9,4,-5,41.9376,-87.6441
TA1308000019,3,10,true,5,1,-4,41.93973,-87.65886
13277,3,10,true,5,2,-3,41.9401,-87.64546
TA1307000134,3,10,true,6,7,1,41.94016,-87.65303
13071,3,10,true,3,9,6,41.94373,-87.66401
632,3,10,true,9,5,-4,41.94453,-87.6547
13278,3,10,true,9,4,-5,41.94553,-87.64644
13235,3,10,true,6,9,3,41.94814,-87.66396
13325,3,10,true,14,5,-9,41.94907,-87.64863
TA1307000127,3,10,true,3,5,2,41.9508,-87.65918
13063,3,10,true,2,5,3,41.95424,-87.65441
13379,3,10,true,6,7,1,41.95786,-87.6495
TA1307000107,3,10,true,7,3,-4,41.96164,-87.65464
TA1309000014,3,10,true,9,4,-5,41.96709,-87.66744
TA1309000066,3,10,true,4,8,4,41.9691,-87.67423
TA1309000035,3,10,true,7,2,-5,41.97335,-87.66785
KA1504000152,3,10,true,5,7,2,41.98403,-87.65231
15571,3,10,true,4,5,1,41.99478,-87.66028
KA1503000074,3,11,false,13,14,1,41.79174,-87.58395
KA1503000059,3,11,false,3,8,5,41.79952,-87.58643
KA1503000007,3,11,false,1,5,4,41.80242,-87.58689
TA1307000048,3,11,false,4,7,3,41.83855,-87.60821
13102,3,11,false,5,2,-3,41.85762,-87.61942
13431,3,11,false,6,3,-3,41.8661,-87.60728
WL-008,3,11,false,2,6,4,41.86712,-87.64108
15544,3,11,false,35,20,-15,41.86723,-87.61536
SL-005,3,11,false,9,13,4,41.8679,-87.62304
TA1309000010,3,11,false,6,2,-4,41.87074,-87.62574
SL-008,3,11,false,4,5,1,41.87209,-87.62956
623,3,11,false,19,4,-15,41.87272,-87.62399
15541,3,11,false,13,7,-6,41.8758,-87.62086
TA1305000025,3,11,false,6,5,-1,41.87773,-87.63528
TA1309000002,3,11,false,9,1,-8,41.87784,-87.62408
TA1309000007,3,11,false,5,1,-4,41.88022,-87.63526
13300,3,11,false,31,16,-15,41.88097,-87.61675
13008,3,11,false,30,25,-5,41.88105,-87.62408
TA1305000006,3,11,false,10,3,-7,41.88122,-87.6296
TA1307000120,3,11,false,4,6,2,41.88188,-87.64879
13341,3,11,false,8,2,-6,41.88208,-87.63985
13036,3,11,false,10,4,-6,41.8821,-87.62513
13353,3,11,false,5,4,-1,41.88283,-87.6612
KA1503000072,3,11,false,7,2,-5,41.88317,-87.63693
13053,3,11,false,4,6,2,41.88365,-87.64863
13001,3,11,false,13,18,5,41.88397,-87.62459
TA1306000010,3,11,false,6,3,-3,41.88419,-87.62961
TA1305000029,3,11,false,7,4,-3,41.88466,-87.62787
13263,3,11,false,23,2,-21,41.88467,-87.61952
TA1307000111,3,11,false,7,1,-6,41.88582,-87.63548
KA1503000012,3,11,false,7,5,-2,41.88599,-87.63089
TA1305000011,3,11,false,6,9,3,41.886,-87.62418
TA1308000029,3,11,false,5,5,0,41.88673,-87.62225
TA1307000131,3,11,false,6,8,2,41.88688,-87.62606
KA1503000064,3,11,false,8,10,2,41.88697,-87.61281
13050,3,11,false,7,8,1,41.88919,-87.62775
TA1307000151,3,11,false,8,2,-6,41.88993,-87.63427
13427,3,11,false,7,5,-2,41.89054,-87.62205
TA1306000013,3,11,false,13,3,-10,41.89083,-87.61852
TA1308000006,3,11,false,5,1,-4,41.89128,-87.67686
TA1307000117,3,11,false,8,10,2,41.89144,-87.62675
13033,3,11,false,2,5,3,41.8916,-87.64835
TA1305000003,3,11,false,16,13,-3,41.89187,-87.62061
13022,3,11,false,36,38,2,41.89227,-87.61205
13045,3,11,false,8,5,-3,41.89403,-87.62931
13016,3,11,false,8,5,-3,41.89431,-87.62277
KA1503000041,3,11,false,13,2,-11,41.89452,-87.61798
TA1307000062,3,11,false,5,2,-3,41.89466,-87.63839
TA1306000012,3,11,false,10,11,1,41.89475,-87.63438
KP1705001026,3,11,false,6,1,-5,41.89483,-87.6323
15530,3,11,false,3,5,2,41.89575,-87.62596
13017,3,11,false,7,4,-3,41.89676,-87.6357
13034,3,11,false,11,18,7,41.89754,-87.62352
15529,3,11,false,5,5,0,41.89858,-87.62206
TA1307000128,3,11,false,4,7,3,41.89896,-87.6299
13042,3,11,false,23,23,0,41.90097,-87.62377
KA1504000133,3,11,false,5,9,4,41.90234,-87.62773
TA1307000039,3,11,false,9,8,-1,41.90294,-87.63137
13061,3,11,false,12,10,-2,41.90342,-87.66779
TA1308000049,3,11,false,5,3,-2,41.90672,-87.6349
TA1309000024,3,11,false,7,3,-4,41.908,-87.63152
13154,3,11,false,5,1,-4,41.91054,-87.65312
LF-005,3,11,false,14,16,2,41.91172,-87.62681
13243,3,11,false,5,3,-2,41.91262,-87.6814
13179,3,11,false,9,3,-6,41.9157,-87.63461
13146,3,11,false,4,9,5,41.91831,-87.63629
13059,3,11,false,2,5,3,41.91845,-87.65222
13193,3,11,false,6,7,1,41.92182,-87.64412
LP-,3,11,false,5,7,2,41.92396,-87.63584
TA1306000016,3,11,false,8,3,-5,41.9256,-87.65371
TA1309000058,3,11,false,2,7,5,41.92591,-87.64927
TA1308000001,3,11,false,2,18,16,41.92627,-87.63086
13124,3,11,false,3,6,3,41.92675,-87.63444
TA1305000014,3,11,false,7,5,-2,41.92956,-87.64313
13085,3,11,false,2,5,3,41.92958,-87.70789
15643,3,11,false,5,3,-2,41.93057,-87.7238
TA1307000142,3,11,false,6,1,-5,41.93125,-87.64432
13276,3,11,false,5,5,0,41.93132,-87.63874
TA1309000039,3,11,false,1,5,4,41.93258,-87.63642
TA1307000006,3,11,false,5,1,-4,41.93571,-87.6636
TA1307000041,3,11,false,6,3,-3,41.93669,-87.63683
13137,3,11,false,14,5,-9,41.9376,-87.6441
13277,3,11,false,7,2,-5,41.9401,-87.64546
TA1309000025,3,11,false,5,9,4,41.94368,-87.64894
13278,3,11,false,6,1,-5,41.94553,-87.64644
TA1307000126,3,11,false,2,8,6,41.94936,-87.65451
TA1307000107,3,11,false,5,3,-2,41.96164,-87.65464
KA1504000171,3,11,false,5,3,-2,41.97161,-87.65016
KA1504000152,3,11,false,8,4,-4,41.98403,-87.65231
15575,3,11,false,5,1,-4,41.98975,-87.66014
596,3,11,false,1,5,4,42.04822,-87.68348
E006,3,11,false,1,5,4,42.06367,-87.69871
KA1503000071,3,11,true,3,6,3,41.79148,-87.59988
TA1308000009,3,11,true,8,2,-6,41.79522,-87.58075
TA1307000129,3,11,true,6,3,-3,41.83104,-87.62683
13216,3,11,true,5,7,2,41.83473,-87.62581
13075,3,11,true,3,8,5,41.8531,-87.63192
15545,3,11,true,11,12,1,41.85627,-87.61334
13102,3,11,true,4,6,2,41.85762,-87.61942
TA1307000159,3,11,true,5,3,-2,41.8579,-87.6687
TA1307000044,3,11,true,2,5,3,41.85794,-87.64083
13164,3,11,true,7,3,-4,41.85818,-87.65648
WL-008,3,11,true,5,3,-2,41.86712,-87.64108
TA1305000002,3,11,true,8,7,-1,41.86721,-87.62597
SL-005,3,11,true,5,11,6,41.8679,-87.62304
13285,3,11,true,8,5,-3,41.86928,-87.67372
13160,3,11,true,3,5,2,41.86947,-87.65548
15550,3,11,true,6,2,-4,41.87024,-87.63947
TA1309000010,3,11,true,3,6,3,41.87074,-87.62574
TA1307000121,3,11,true,9,7,-2,41.87184,-87.64664
SL-008,3,11,true,6,2,-4,41.87209,-87.62956
13332,3,11,true,13,12,-1,41.87219,-87.6615
KA1504000104,3,11,true,9,5,-4,41.87296,-87.66912
TA1305000035,3,11,true,6,1,-5,41.87716,-87.62787
13138,3,11,true,4,5,1,41.87723,-87.63941
15539,3,11,true,6,3,-3,41.87763,-87.64405
13158,3,11,true,7,10,3,41.87764,-87.64957
13157,3,11,true,8,11,3,41.87773,-87.6548
TA1305000025,3,11,true,6,5,-1,41.87773,-87.63528
TA1309000004,3,11,true,6,12,6,41.87811,-87.63184
TA1305000005,3,11,true,7,3,-4,41.87924,-87.62975
TA1309000007,3,11,true,13,9,-4,41.88022,-87.63526
WL-011,3,11,true,7,9,2,41.88034,-87.64273
13156,3,11,true,5,6,1,41.88042,-87.65554
13008,3,11,true,1,9,8,41.88105,-87.62408
TA1305000006,3,11,true,7,9,2,41.88122,-87.6296
TA1307000120,3,11,true,11,13,2,41.88188,-87.64879
13036,3,11,true,4,5,1,41.8821,-87.62513
TA1305000032,3,11,true,6,9,3,41.88218,-87.64109
13006,3,11,true,7,5,-2,41.88268,-87.63252
13353,3,11,true,3,5,2,41.88283,-87.6612
13409,3,11,true,5,3,-2,41.8831,-87.6511
WL-012,3,11,true,6,3,-3,41.88337,-87.6412
13053,3,11,true,7,5,-2,41.88365,-87.64863
13001,3,11,true,4,11,7,41.88397,-87.62459
TA1306000010,3,11,true,8,9,1,41.88419,-87.62961
TA1305000030,3,11,true,5,12,7,41.88459,-87.63178
TA1305000029,3,11,true,9,5,-4,41.88466,-87.62787
13263,3,11,true,13,13,0,41.88467,-87.61952
TA1306000015,3,11,true,8,7,-1,41.88549,-87.65232
13021,3,11,true,16,6,-10,41.88559,-87.64184
TA1307000111,3,11,true,5,9,4,41.88582,-87.63548
KA1503000012,3,11,true,5,2,-3,41.88599,-87.63089
TA1305000011,3,11,true,10,7,-3,41.886,-87.62418
TA1308000029,3,11,true,8,4,-4,41.88673,-87.62225
TA1305000022,3,11,true,11,7,-4,41.88817,-87.63656
TA1306000003,3,11,true,7,5,-2,41.88867,-87.64442
KA1503000043,3,11,true,9,14,5,41.88918,-87.63851
13050,3,11,true,5,7,2,41.88919,-87.62775
TA1307000151,3,11,true,8,5,-3,41.88993,-87.63427
636,3,11,true,3,7,4,41.88997,-87.63662
KA1503000044,3,11,true,6,1,-5,41.89018,-87.6262
13427,3,11,true,6,5,-1,41.89054,-87.62205
13430,3,11,true,3,8,5,41.89077,-87.63169
RN-,3,11,true,6,9,3,41.89102,-87.63546
TA1307000117,3,11,true,11,10,-1,41.89144,-87.62675
13033,3,11,true,9,3,-6,41.8916,-87.64835
13194,3,11,true,6,5,-1,41.8918,-87.65878
TA1305000003,3,11,true,7,11,4,41.89187,-87.62061
13022,3,11,true,9,12,3,41.89227,-87.61205
TA1306000029,3,11,true,5,8,3,41.89256,-87.61449
13265,3,11,true,11,13,2,41.89383,-87.64172
13045,3,11,true,10,13,3,41.89403,-87.62931
13016,3,11,true,10,7,-3,41.89431,-87.62277
KA1503000041,3,11,true,8,10,2,41.89452,-87.61798
TA1307000062,3,11,true,4,5,1,41.89466,-87.63839
TA1306000012,3,11,true,14,13,-1,41.89475,-87.63438
KP1705001026,3,11,true,6,5,-1,41.89483,-87.6323
15530,3,11,true,14,16,2,41.89575,-87.62596
18003,3,11,true,10,6,-4,41.89575,-87.62011
13289,3,11,true,5,2,-3,41.89638,-87.661
13303,3,11,true,5,1,-4,41.89672,-87.63088
13017,3,11,true,13,5,-8,41.89676,-87.6357
13338,3,11,true,11,10,-1,41.89697,-87.62173
13034,3,11,true,5,2,-3,41.89754,-87.62352
TA1306000009,3,11,true,8,8,0,41.89772,-87.64299
15529,3,11,true,6,6,0,41.89858,-87.62206
TA1307000128,3,11,true,10,10,0,41.89896,-87.6299
TA1306000011,3,11,true,5,6,1,41.89994,-87.63443
13042,3,11,true,12,8,-4,41.90097,-87.62377
KA1504000133,3,11,true,12,8,-4,41.90234,-87.62773
TA1306000006,3,11,true,1,5,4,41.90292,-87.63772
TA1307000039,3,11,true,13,10,-3,41.90294,-87.63137
TA1305000034,3,11,true,3,9,6,41.90313,-87.67391
KA1504000135,3,11,true,11,6,-5,41.90319,-87.63439
13136,3,11,true,4,6,2,41.90326,-87.67845
13061,3,11,true,9,7,-2,41.90342,-87.66779
TA1308000049,3,11,true,4,10,6,41.90672,-87.6349
KA1504000134,3,11,true,6,2,-4,41.90687,-87.6262
13221,3,11,true,8,5,-3,41.90765,-87.67254
TA1309000024,3,11,true,8,6,-2,41.908,-87.63152
TA1305000041,3,11,true,5,3,-2,41.9094,-87.67769
331,3,11,true,3,5,2,41.90965,-87.64812
TA1306000008,3,11,true,6,2,-4,41.9102,-87.6435
13154,3,11,true,5,2,-3,41.91054,-87.65312
TA1307000038,3,11,true,8,9,1,41.91138,-87.63868
LF-005,3,11,true,13,8,-5,41.91172,-87.62681
TA1308000050,3,11,true,10,10,0,41.91211,-87.6347
13243,3,11,true,5,3,-2,41.91262,-87.6814
13179,3,11,true,15,16,1,41.9157,-87.63461
TA1309000006,3,11,true,3,5,2,41.91809,-87.64375
13146,3,11,true,14,5,-9,41.91831,-87.63629
13059,3,11,true,6,4,-2,41.91845,-87.65222
13192,3,11,true,6,7,1,41.91995,-87.64884
13288,3,11,true,5,2,-3,41.92008,-87.67788
TA1309000033,3,11,true,6,4,-2,41.92158,-87.65381
13193,3,11,true,7,5,-2,41.92182,-87.64412
13191,3,11,true,5,4,-1,41.92217,-87.63891
TA1307000001,3,11,true,7,5,-2,41.92535,-87.66581
TA1306000026,3,11,true,6,6,0,41.92558,-87.65842
TA1309000019,3,11,true,4,6,2,41.92586,-87.63897
TA1309000058,3,11,true,8,13,5,41.92591,-87.64927
TA1308000001,3,11,true,7,8,1,41.92627,-87.63086
TA1307000113,3,11,true,5,8,3,41.92878,-87.66391
TA1309000061,3,11,true,5,5,0,41.92915,-87.64909
TA1307000142,3,11,true,11,5,-6,41.93125,-87.64432
13276,3,11,true,9,10,1,41.93132,-87.63874
TA1307000064,3,11,true,6,10,4,41.93222,-87.65864
TA1309000036,3,11,true,6,4,-2,41.93313,-87.64776
TA1307000006,3,11,true,6,4,-2,41.93571,-87.6636
TA1307000052,3,11,true,6,4,-2,41.93628,-87.65266
TA1307000136,3,11,true,12,12,0,41.9365,-87.64755
TA1307000041,3,11,true,10,4,-6,41.93669,-87.63683
13137,3,11,true,7,10,3,41.9376,-87.6441
TA1309000042,3,11,true,4,5,1,41.93937,-87.66836
13229,3,11,true,5,1,-4,41.93946,-87.66376
13277,3,11,true,7,7,0,41.9401,-87.64546
TA1307000134,3,11,true,3,8,5,41.94016,-87.65303
TA1309000049,3,11,true,11,5,-6,41.94077,-87.63919
TA1307000138,3,11,true,5,8,3,41.94334,-87.67094
TA1309000025,3,11,true,4,7,3,41.94368,-87.64894
13071,3,11,true,6,5,-1,41.94373,-87.66401
13278,3,11,true,13,6,-7,41.94553,-87.64644
13235,3,11,true,5,5,0,41.94814,-87.66396
13325,3,11,true,9,15,6,41.94907,-87.64863
TA1307000150,3,11,true,4,13,9,41.94945,-87.64646
TA1307000127,3,11,true,6,3,-3,41.9508,-87.65918
13323,3,11,true,9,8,-1,41.95282,-87.65
13063,3,11,true,8,9,1,41.95424,-87.65441
13379,3,11,true,5,3,-2,41.95786,-87.6495
13389,3,11,true,7,1,-6,41.961,-87.64958
TA1307000107,3,11,true,7,6,-1,41.96164,-87.65464
TA1308000012,3,11,true,6,3,-3,41.96398,-87.63818
13074,3,11,true,8,2,-6,41.96521,-87.6582
TA1309000014,3,11,true,6,4,-2,41.96709,-87.66744
TA1309000015,3,11,true,2,5,3,41.96889,-87.68401
TA1309000066,3,11,true,7,8,1,41.9691,-87.67423
TA1309000035,3,11,true,7,4,-3,41.97335,-87.66785
13108,3,11,true,5,3,-2,41.97379,-87.65971
KA1504000146,3,11,true,5,1,-4,41.978,-87.66805
KA1504000151,3,11,true,8,5,-3,41.98359,-87.66916
KA1504000152,3,11,true,9,5,-4,41.98403,-87.65231
15491,3,12,false,7,3,-4,41.78096,-87.57624
TA1309000011,3,12,false,2,5,3,41.78873,-87.60131
KA1503000071,3,12,false,6,2,-4,41.79148,-87.59988
TA1308000009,3,12,false,8,6,-2,41.79522,-87.58075
TA1307000164,3,12,false,5,1,-4,41.79527,-87.59647
KA1503000052,3,12,false,5,1,-4,41.79935,-87.60097
KA1503000059,3,12,false,11,4,-7,41.79952,-87.58643
TA1309000037,3,12,false,5,1,-4,41.79957,-87.59474
KA1503000007,3,12,false,3,5,2,41.80242,-87.58689
13075,3,12,false,2,11,9,41.8531,-87.63192
15545,3,12,false,3,7,4,41.85627,-87.61334
13150,3,12,false,7,2,-5,41.85783,-87.62455
13029,3,12,false,9,3,-6,41.86531,-87.6179
13431,3,12,false,1,8,7,41.8661,-87.60728
TA1305000002,3,12,false,8,6,-2,41.86721,-87.62597
15544,3,12,false,52,26,-26,41.86723,-87.61536
KA1706005007,3,12,false,1,5,4,41.86749,-87.63219
SL-005,3,12,false,15,6,-9,41.8679,-87.62304
TA1309000010,3,12,false,5,3,-2,41.87074,-87.62574
SL-011,3,12,false,3,8,5,41.87256,-87.63356
623,3,12,false,13,9,-4,41.87272,-87.62399
15541,3,12,false,14,19,5,41.8758,-87.62086
TA1305000010,3,12,false,6,5,-1,41.87623,-87.62444
TA1305000035,3,12,false,5,1,-4,41.87716,-87.62787
13158,3,12,false,4,5,1,41.87764,-87.64957
TA1305000025,3,12,false,10,2,-8,41.87773,-87.63528
TA1309000002,3,12,false,2,9,7,41.87784,-87.62408
TA1309000004,3,12,false,2,5,3,41.87811,-87.63184
638,3,12,false,2,7,5,41.87827,-87.64078
TA1305000005,3,12,false,6,3,-3,41.87924,-87.62975
13011,3,12,false,1,8,7,41.87931,-87.63993
TA1309000008,3,12,false,8,3,-5,41.87933,-87.6355
13300,3,12,false,32,26,-6,41.88097,-87.61675
13008,3,12,false,27,24,-3,41.88105,-87.62408
TA1305000006,3,12,false,12,8,-4,41.88122,-87.6296
TA1307000120,3,12,false,4,7,3,41.88188,-87.64879
13341,3,12,false,1,7,6,41.88208,-87.63985
13036,3,12,false,8,4,-4,41.8821,-87.62513
TA1305000032,3,12,false,6,7,1,41.88218,-87.64109
654,3,12,false,5,1,-4,41.88307,-87.65698
13409,3,12,false,5,5,0,41.8831,-87.6511
KA1503000072,3,12,false,5,2,-3,41.88317,-87.63693
13053,3,12,false,2,10,8,41.88365,-87.64863
13001,3,12,false,16,4,-12,41.88397,-87.62459
TA1306000010,3,12,false,3,7,4,41.88419,-87.62961
TA1305000029,3,12,false,4,11,7,41.88466,-87.62787
13263,3,12,false,9,4,-5,41.88467,-87.61952
TA1306000015,3,12,false,4,10,6,41.88549,-87.65232
13021,3,12,false,5,3,-2,41.88559,-87.64184
TA1307000111,3,12,false,7,6,-1,41.88582,-87.63548
KA1503000012,3,12,false,8,3,-5,41.88599,-87.63089
TA1305000011,3,12,false,8,5,-3,41.886,-87.62418
TA1307000131,3,12,false,9,13,4,41.88688,-87.62606
KA1503000064,3,12,false,20,16,-4,41.88697,-87.61281
TA1305000022,3,12,false,6,4,-2,41.88817,-87.63656
TA1306000003,3,12,false,5,6,1,41.88867,-87.64442
KA1503000043,3,12,false,7,8,1,41.88918,-87.63851
13050,3,12,false,5,3,-2,41.88919,-87.62775
TA1307000151,3,12,false,5,8,3,41.88993,-87.63427
KA1503000044,3,12,false,6,3,-3,41.89018,-87.6262
13430,3,12,false,8,11,3,41.89077,-87.63169
TA1306000013,3,12,false,1,12,11,41.89083,-87.61852
RN-,3,12,false,11,5,-6,41.89102,-87.63546
TA1307000117,3,12,false,13,5,-8,41.89144,-87.62675
13033,3,12,false,2,5,3,41.8916,-87.64835
TA1305000003,3,12,false,8,5,-3,41.89187,-87.62061
13022,3,12,false,42,78,36,41.89227,-87.61205
TA1306000029,3,12,false,4,7,3,41.89256,-87.61449
13265,3,12,false,5,3,-2,41.89383,-87.64172
13045,3,12,false,7,9,2,41.89403,-87.62931
13016,3,12,false,8,3,-5,41.89431,-87.62277
KA1503000041,3,12,false,11,2,-9,41.89452,-87.61798
TA1307000062,3,12,false,6,5,-1,41.89466,-87.63839
TA1306000012,3,12,false,2,5,3,41.89475,-87.63438
15530,3,12,false,9,8,-1,41.89575,-87.62596
13034,3,12,false,13,13,0,41.89754,-87.62352
15529,3,12,false,6,4,-2,41.89858,-87.62206
TA1307000128,3,12,false,6,7,1,41.89896,-87.6299
TA1306000011,3,12,false,7,1,-6,41.89994,-87.63443
13042,3,12,false,26,20,-6,41.90097,-87.62377
KA1504000133,3,12,false,4,9,5,41.90234,-87.62773
TA1307000039,3,12,false,8,9,1,41.90294,-87.63137
TA1305000034,3,12,false,3,5,2,41.90313,-87.67391
13061,3,12,false,5,4,-1,41.90342,-87.66779
KA1504000079,3,12,false,5,6,1,41.9035,-87.64334
13221,3,12,false,6,6,0,41.90765,-87.67254
TA1309000024,3,12,false,6,8,2,41.908,-87.63152
331,3,12,false,7,2,-5,41.90965,-87.64812
15653,3,12,false,5,1,-4,41.90979,-87.7053
TA1305000037,3,12,false,4,5,1,41.91018,-87.67003
LF-005,3,12,false,19,25,6,41.91172,-87.62681
13128,3,12,false,6,5,-1,41.91197,-87.63197
TA1308000050,3,12,false,15,8,-7,41.91211,-87.6347
TA1306000032,3,12,false,5,7,2,41.9137,-87.65285
15655,3,12,false,5,3,-2,41.91401,-87.70514
13179,3,12,false,6,13,7,41.9157,-87.63461
TA1309000006,3,12,false,5,2,-3,41.91809,-87.64375
13146,3,12,false,8,6,-2,41.91831,-87.63629
13059,3,12,false,4,7,3,41.91845,-87.65222
13193,3,12,false,7,6,-1,41.92182,-87.64412
TA1306000026,3,12,false,3,6,3,41.92558,-87.65842
TA1309000019,3,12,false,8,1,-7,41.92586,-87.63897
TA1309000058,3,12,false,8,3,-5,41.92591,-87.64927
TA1308000001,3,12,false,10,12,2,41.92627,-87.63086
13124,3,12,false,5,3,-2,41.92675,-87.63444
13296,3,12,false,8,4,-4,41.92883,-87.66852
13085,3,12,false,6,4,-2,41.92958,-87.70789
TA1307000142,3,12,false,1,5,4,41.93125,-87.64432
13276,3,12,false,9,2,-7,41.93132,-87.63874
TA1306000014,3,12,false,6,3,-3,41.93242,-87.65271
TA1309000039,3,12,false,13,18,5,41.93258,-87.63642
TA1307000006,3,12,false,8,4,-4,41.93571,-87.6636
TA1307000052,3,12,false,5,5,0,41.93628,-87.65266
TA1307000041,3,12,false,6,3,-3,41.93669,-87.63683
13137,3,12,false,3,7,4,41.9376,-87.6441
TA1309000042,3,12,false,4,5,1,41.93937,-87.66836
TA1307000134,3,12,false,3,5,2,41.94016,-87.65303
TA1309000049,3,12,false,5,5,0,41.94077,-87.63919
TA1309000025,3,12,false,6,2,-4,41.94368,-87.64894
13071,3,12,false,2,6,4,41.94373,-87.66401
632,3,12,false,3,12,9,41.94453,-87.6547
13235,3,12,false,3,5,2,41.94814,-87.66396
TA1307000126,3,12,false,1,22,21,41.94936,-87.65451
TA1307000150,3,12,false,7,1,-6,41.94945,-87.64646
TA1307000127,3,12,false,8,18,10,41.9508,-87.65918
13063,3,12,false,7,4,-3,41.95424,-87.65441
TA1308000022,3,12,false,6,9,3,41.95438,-87.64805
TA1309000026,3,12,false,6,1,-5,41.95601,-87.6802
13389,3,12,false,5,4,-1,41.961,-87.64958
TA1308000012,3,12,false,8,7,-1,41.96398,-87.63818
KA1504000152,3,12,false,9,4,-5,41.98403,-87.65231
KA1503000071,3,12,true,3,9,6,41.79148,-87.59988
TA1308000009,3,12,true,3,7,4,41.79522,-87.58075
KA1503000007,3,12,true,6,2,-4,41.80242,-87.58689
TA1308000035,3,12,true,5,4,-1,41.80944,-87.59188
13216,3,12,true,5,1,-4,41.83473,-87.62581
KA1503000038,3,12,true,1,5,4,41.83845,-87.6354
15545,3,12,true,13,9,-4,41.85627,-87.61334
13135,3,12,true,1,5,4,41.85753,-87.66157
13102,3,12,true,8,5,-3,41.85762,-87.61942
13150,3,12,true,6,6,0,41.85783,-87.62455
13164,3,12,true,7,3,-4,41.85818,-87.65648
SL-012,3,12,true,7,5,-2,41.86038,-87.62581
TA1306000002,3,12,true,5,1,-4,41.86238,-87.65108
TA1307000124,3,12,true,7,5,-2,41.86411,-87.62372
TA1309000001,3,12,true,7,2,-5,41.86488,-87.64708
WL-008,3,12,true,5,10,5,41.86712,-87.64108
TA1305000002,3,12,true,12,8,-4,41.86721,-87.62597
SL-005,3,12,true,8,12,4,41.8679,-87.62304
644,3,12,true,5,2,-3,41.86859,-87.68625
13139,3,12,true,5,5,0,41.86893,-87.65913
13285,3,12,true,4,5,1,41.86928,-87.67372
13160,3,12,true,7,5,-2,41.86947,-87.65548
TA1309000010,3,12,true,7,6,-1,41.87074,-87.62574
TA1309000064,3,12,true,6,5,-1,41.87127,-87.67369
TA1307000130,3,12,true,17,15,-2,41.87178,-87.65103
TA1307000121,3,12,true,6,10,4,41.87184,-87.64664
SL-008,3,12,true,8,12,4,41.87209,-87.62956
13332,3,12,true,13,16,3,41.87219,-87.6615
SL-011,3,12,true,6,2,-4,41.87256,-87.63356
KA1504000104,3,12,true,5,10,5,41.87296,-87.66912
SL-007,3,12,true,4,5,1,41.87404,-87.6277
TA1305000035,3,12,true,6,7,1,41.87716,-87.62787
13138,3,12,true,6,4,-2,41.87723,-87.63941
15539,3,12,true,3,6,3,41.87763,-87.64405
13158,3,12,true,8,6,-2,41.87764,-87.64957
13157,3,12,true,6,5,-1,41.87773,-87.6548
TA1305000025,3,12,true,8,11,3,41.87773,-87.63528
TA1309000004,3,12,true,5,8,3,41.87811,-87.63184
638,3,12,true,2,6,4,41.87827,-87.64078
13011,3,12,true,7,9,2,41.87931,-87.63993
TA1309000008,3,12,true,6,6,0,41.87933,-87.6355
TA1309000007,3,12,true,15,9,-6,41.88022,-87.63526
WL-011,3,12,true,10,4,-6,41.88034,-87.64273
13156,3,12,true,6,2,-4,41.88042,-87.65554
13300,3,12,true,9,8,-1,41.88097,-87.61675
13008,3,12,true,3,7,4,41.88105,-87.62408
TA1305000006,3,12,true,10,8,-2,41.88122,-87.6296
TA1307000120,3,12,true,13,10,-3,41.88188,-87.64879
13341,3,12,true,6,4,-2,41.88208,-87.63985
13036,3,12,true,9,7,-2,41.8821,-87.62513
TA1305000032,3,12,true,6,11,5,41.88218,-87.64109
13006,3,12,true,11,10,-1,41.88268,-87.63252
13353,3,12,true,5,2,-3,41.88283,-87.6612
654,3,12,true,3,9,6,41.88307,-87.65698
13409,3,12,true,4,6,2,41.8831,-87.6511
KA1503000072,3,12,true,2,7,5,41.88317,-87.63693
13053,3,12,true,8,8,0,41.88365,-87.64863
13001,3,12,true,11,11,0,41.88397,-87.62459
18062,3,12,true,6,5,-1,41.88412,-87.65427
TA1306000010,3,12,true,14,14,0,41.88419,-87.62961
TA1305000030,3,12,true,14,10,-4,41.88459,-87.63178
TA1305000029,3,12,true,5,7,2,41.88466,-87.62787
13263,3,12,true,12,10,-2,41.88467,-87.61952
TA1306000015,3,12,true,7,10,3,41.88549,-87.65232
13021,3,12,true,13,6,-7,41.88559,-87.64184
TA1307000111,3,12,true,6,7,1,41.88582,-87.63548
KA1503000012,3,12,true,7,16,9,41.88599,-87.63089
TA1305000011,3,12,true,11,10,-1,41.886,-87.62418
TA1307000131,3,12,true,5,6,1,41.88688,-87.62606
TA1305000022,3,12,true,11,9,-2,41.88817,-87.63656
TA1306000003,3,12,true,7,9,2,41.88867,-87.64442
KA1503000043,3,12,true,16,12,-4,41.88918,-87.63851
13050,3,12,true,9,11,2,41.88919,-87.62775
TA1307000151,3,12,true,13,12,-1,41.88993,-87.63427
636,3,12,true,5,7,2,41.88997,-87.63662
KA1503000044,3,12,true,3,8,5,41.89018,-87.6262
13427,3,12,true,6,2,-4,41.89054,-87.62205
13430,3,12,true,5,8,3,41.89077,-87.63169
RN-,3,12,true,8,10,2,41.89102,-87.63546
TA1307000117,3,12,true,18,21,3,41.89144,-87.62675
13033,3,12,true,5,9,4,41.8916,-87.64835
13194,3,12,true,6,8,2,41.8918,-87.65878
TA1305000003,3,12,true,10,12,2,41.89187,-87.62061
13022,3,12,true,9,9,0,41.89227,-87.61205
13265,3,12,true,6,7,1,41.89383,-87.64172
13045,3,12,true,20,11,-9,41.89403,-87.62931
13016,3,12,true,24,12,-12,41.89431,-87.62277
KA1503000041,3,12,true,10,11,1,41.89452,-87.61798
TA1307000062,3,12,true,5,7,2,41.89466,-87.63839
TA1306000012,3,12,true,14,11,-3,41.89475,-87.63438
KP1705001026,3,12,true,5,7,2,41.89483,-87.6323
15530,3,12,true,10,10,0,41.89575,-87.62596
18003,3,12,true,5,6,1,41.89575,-87.62011
13247,3,12,true,6,3,-3,41.89597,-87.66775
13017,3,12,true,2,5,3,41.89676,-87.6357
13338,3,12,true,9,11,2,41.89697,-87.62173
TA1307000061,3,12,true,6,9,3,41.89745,-87.62873
13034,3,12,true,4,6,2,41.89754,-87.62352
TA1306000009,3,12,true,10,7,-3,41.89772,-87.64299
15529,3,12,true,15,6,-9,41.89858,-87.62206
TA1307000128,3,12,true,5,12,7,41.89896,-87.6299
13248,3,12,true,5,2,-3,41.89964,-87.66788
TA1306000011,3,12,true,9,3,-6,41.89994,-87.63443
KA1504000116,3,12,true,3,5,2,41.90023,-87.64299
13042,3,12,true,13,12,-1,41.90097,-87.62377
TA1307000070,3,12,true,5,3,-2,41.90133,-87.67742
KA1504000133,3,12,true,6,9,3,41.90234,-87.62773
TA1307000039,3,12,true,12,13,1,41.90294,-87.63137
TA1305000034,3,12,true,5,8,3,41.90313,-87.67391
KA1504000135,3,12,true,6,10,4,41.90319,-87.63439
13136,3,12,true,6,1,-5,41.90326,-87.67845
13061,3,12,true,4,10,6,41.90342,-87.66779
KA1504000079,3,12,true,5,10,5,41.9035,-87.64334
TA1307000115,3,12,true,2,7,5,41.9046,-87.64056
TA1308000049,3,12,true,5,3,-2,41.90672,-87.6349
KA1504000134,3,12,true,9,5,-4,41.90687,-87.6262
13221,3,12,true,11,5,-6,41.90765,-87.67254
TA1309000024,3,12,true,10,7,-3,41.908,-87.63152
TA1305000041,3,12,true,6,7,1,41.9094,-87.67769
331,3,12,true,8,4,-4,41.90965,-87.64812
TA1305000037,3,12,true,3,8,5,41.91018,-87.67003
13154,3,12,true,4,10,6,41.91054,-87.65312
13058,3,12,true,2,8,6,41.91059,-87.64942
TA1307000038,3,12,true,7,2,-5,41.91138,-87.63868
LF-005,3,12,true,14,4,-10,41.91172,-87.62681
TA1308000050,3,12,true,10,10,0,41.91211,-87.6347
13243,3,12,true,7,7,0,41.91262,-87.6814
TA1306000032,3,12,true,6,8,2,41.9137,-87.65285
13179,3,12,true,12,14,2,41.9157,-87.63461
13133,3,12,true,5,2,-3,41.91598,-87.67733
TA1305000039,3,12,true,6,2,-4,41.9163,-87.66749
TA1309000006,3,12,true,5,12,7,41.91809,-87.64375
TA1307000163,3,12,true,7,8,1,41.91821,-87.65696
13146,3,12,true,13,8,-5,41.91831,-87.63629
13059,3,12,true,6,6,0,41.91845,-87.65222
13192,3,12,true,10,6,-4,41.91995,-87.64884
TA1309000030,3,12,true,2,6,4,41.92077,-87.66372
TA1309000033,3,12,true,8,3,-5,41.92158,-87.65381
13193,3,12,true,13,10,-3,41.92182,-87.64412
13191,3,12,true,8,5,-3,41.92217,-87.63891
13084,3,12,true,7,4,-3,41.92268,-87.69715
TA1307000001,3,12,true,5,8,3,41.92535,-87.66581
TA1306000026,3,12,true,6,6,0,41.92558,-87.65842
TA1306000016,3,12,true,7,12,5,41.9256,-87.65371
TA1309000019,3,12,true,10,14,4,41.92586,-87.63897
TA1309000058,3,12,true,11,16,5,41.92591,-87.64927
TA1308000001,3,12,true,17,19,2,41.92627,-87.63086
13124,3,12,true,5,1,-4,41.92675,-87.63444
TA1309000023,3,12,true,5,5,0,41.9287,-87.65383
TA1307000113,3,12,true,6,3,-3,41.92878,-87.66391
TA1309000061,3,12,true,7,6,-1,41.92915,-87.64909
TA1305000014,3,12,true,8,13,5,41.92956,-87.64313
TA1307000142,3,12,true,18,10,-8,41.93125,-87.64432
13276,3,12,true,6,7,1,41.93132,-87.63874
TA1307000064,3,12,true,5,8,3,41.93222,-87.65864
TA1306000014,3,12,true,5,6,1,41.93242,-87.65271
TA1309000039,3,12,true,7,8,1,41.93258,-87.63642
13294,3,12,true,5,3,-2,41.9326,-87.66595
TA1309000036,3,12,true,8,10,2,41.93313,-87.64776
TA1307000006,3,12,true,7,4,-3,41.93571,-87.6636
TA1307000052,3,12,true,5,7,2,41.93628,-87.65266
TA1307000136,3,12,true,11,7,-4,41.9365,-87.64755
TA1307000041,3,12,true,3,6,3,41.93669,-87.63683
13137,3,12,true,21,13,-8,41.9376,-87.6441
TA1309000042,3,12,true,6,6,0,41.93937,-87.66836
13229,3,12,true,6,1,-5,41.93946,-87.66376
TA1308000019,3,12,true,3,9,6,41.93973,-87.65886
13277,3,12,true,10,8,-2,41.9401,-87.64546
TA1307000134,3,12,true,9,8,-1,41.94016,-87.65303
TA1309000049,3,12,true,2,8,6,41.94077,-87.63919
TA1307000138,3,12,true,2,5,3,41.94334,-87.67094
13144,3,12,true,4,6,2,41.9434,-87.67964
TA1309000025,3,12,true,7,12,5,41.94368,-87.64894
13071,3,12,true,6,5,-1,41.94373,-87.66401
632,3,12,true,3,11,8,41.94453,-87.6547
13278,3,12,true,8,11,3,41.94553,-87.64644
13235,3,12,true,4,8,4,41.94814,-87.66396
13325,3,12,true,9,10,1,41.94907,-87.64863
TA1307000126,3,12,true,15,14,-1,41.94936,-87.65451
TA1307000150,3,12,true,12,7,-5,41.94945,-87.64646
13319,3,12,true,1,5,4,41.95069,-87.6687
TA1307000127,3,12,true,9,12,3,41.9508,-87.65918
13323,3,12,true,8,4,-4,41.95282,-87.65
13063,3,12,true,10,3,-7,41.95424,-87.65441
TA1308000022,3,12,true,8,9,1,41.95438,-87.64805
TA1307000149,3,12,true,6,2,-4,41.95467,-87.67392
13379,3,12,true,7,4,-3,41.95786,-87.6495
13389,3,12,true,6,5,-1,41.961,-87.64958
KA1503000022,3,12,true,5,4,-1,41.96158,-87.66609
TA1307000107,3,12,true,5,7,2,41.96164,-87.65464
TA1308000012,3,12,true,7,5,-2,41.96398,-87.63818
13074,3,12,true,4,7,3,41.96521,-87.6582
TA1307000140,3,12,true,1,8,7,41.96643,-87.68865
TA1307000158,3,12,true,6,2,-4,41.9671,-87.67904
TA1307000119,3,12,true,8,3,-5,41.96796,-87.65
TA1308000021,3,12,true,5,2,-3,41.96883,-87.65765
KA1504000080,3,12,true,3,5,2,41.96887,-87.69609
TA1309000066,3,12,true,4,7,3,41.9691,-87.67423
TA1309000035,3,12,true,7,6,-1,41.97335,-87.66785
13108,3,12,true,6,7,1,41.97379,-87.65971
KA1504000146,3,12,true,5,3,-2,41.978,-87.66805
KA1504000151,3,12,true,4,7,3,41.98359,-87.66916
KA1504000152,3,12,true,9,12,3,41.98403,-87.65231
15578,3,12,true,6,4,-2,41.98405,-87.66027
KA1503000071,3,13,false,6,6,0,41.79148,-87.59988
KA1503000074,3,13,false,8,7,-1,41.79174,-87.58395
TA1309000063,3,13,false,7,4,-3,41.79325,-87.5878
KA1504000076,3,13,false,8,2,-6,41.7943,-87.60145
KA1503000059,3,13,false,2,13,11,41.79952,-87.58643
13075,3,13,false,4,7,3,41.8531,-87.63192
15545,3,13,false,8,6,-2,41.85627,-87.61334
13135,3,13,false,2,7,5,41.85753,-87.66157
13163,3,13,false,5,2,-3,41.85808,-87.65108
13431,3,13,false,11,11,0,41.8661,-87.60728
WL-008,3,13,false,5,2,-3,41.86712,-87.64108
TA1305000002,3,13,false,8,5,-3,41.86721,-87.62597
15544,3,13,false,38,39,1,41.86723,-87.61536
SL-005,3,13,false,10,8,-2,41.8679,-87.62304
SL-008,3,13,false,3,6,3,41.87209,-87.62956
SL-011,3,13,false,5,3,-2,41.87256,-87.63356
623,3,13,false,5,8,3,41.87272,-87.62399
15541,3,13,false,22,12,-10,41.8758,-87.62086
13158,3,13,false,2,5,3,41.87764,-87.64957
TA1309000002,3,13,false,8,4,-4,41.87784,-87.62408
TA1309000004,3,13,false,4,5,1,41.87811,-87.63184
638,3,13,false,6,1,-5,41.87827,-87.64078
TA1305000005,3,13,false,1,6,5,41.87924,-87.62975
13011,3,13,false,2,7,5,41.87931,-87.63993
TA1309000008,3,13,false,7,2,-5,41.87933,-87.6355
KA1503000015,3,13,false,7,5,-2,41.87948,-87.6257
TA1309000007,3,13,false,2,7,5,41.88022,-87.63526
13156,3,13,false,7,1,-6,41.88042,-87.65554
13300,3,13,false,27,46,19,41.88097,-87.61675
13008,3,13,false,32,30,-2,41.88105,-87.62408
TA1307000120,3,13,false,7,6,-1,41.88188,-87.64879
13341,3,13,false,8,1,-7,41.88208,-87.63985
13053,3,13,false,5,2,-3,41.88365,-87.64863
13001,3,13,false,11,9,-2,41.88397,-87.62459
TA1306000010,3,13,false,2,5,3,41.88419,-87.62961
TA1305000030,3,13,false,9,5,-4,41.88459,-87.63178
TA1305000029,3,13,false,7,4,-3,41.88466,-87.62787
13263,3,13,false,9,4,-5,41.88467,-87.61952
TA1306000015,3,13,false,9,5,-4,41.88549,-87.65232
13021,3,13,false,4,5,1,41.88559,-87.64184
TA1307000111,3,13,false,6,8,2,41.88582,-87.63548
KA1503000012,3,13,false,2,9,7,41.88599,-87.63089
TA1305000011,3,13,false,26,17,-9,41.886,-87.62418
15534,3,13,false,3,7,4,41.88627,-87.61749
TA1307000131,3,13,false,11,11,0,41.88688,-87.62606
KA1503000064,3,13,false,18,15,-3,41.88697,-87.61281
TA1305000022,3,13,false,6,3,-3,41.88817,-87.63656
KA1503000043,3,13,false,5,6,1,41.88918,-87.63851
13050,3,13,false,6,9,3,41.88919,-87.62775
TA1307000151,3,13,false,5,6,1,41.88993,-87.63427
KA1503000044,3,13,false,6,2,-4,41.89018,-87.6262
13427,3,13,false,6,9,3,41.89054,-87.62205
13430,3,13,false,4,8,4,41.89077,-87.63169
TA1306000013,3,13,false,15,16,1,41.89083,-87.61852
RN-,3,13,false,1,7,6,41.89102,-87.63546
TA1307000117,3,13,false,12,11,-1,41.89144,-87.62675
13033,3,13,false,5,3,-2,41.8916,-87.64835
TA1305000003,3,13,false,18,15,-3,41.89187,-87.62061
13022,3,13,false,73,79,6,41.89227,-87.61205
13045,3,13,false,7,7,0,41.89403,-87.62931
13016,3,13,false,6,14,8,41.89431,-87.62277
KA1503000041,3,13,false,10,2,-8,41.89452,-87.61798
TA1307000062,3,13,false,3,7,4,41.89466,-87.63839
TA1306000012,3,13,false,5,3,-2,41.89475,-87.63438
KP1705001026,3,13,false,4,7,3,41.89483,-87.6323
13132,3,13,false,1,5,4,41.89573,-87.67718
15530,3,13,false,7,3,-4,41.89575,-87.62596
18003,3,13,false,6,5,-1,41.89575,-87.62011
TA1305000020,3,13,false,8,2,-6,41.89636,-87.65406
13017,3,13,false,5,4,-1,41.89676,-87.6357
13338,3,13,false,9,3,-6,41.89697,-87.62173
13034,3,13,false,14,4,-10,41.89754,-87.62352
620,3,13,false,1,6,5,41.89817,-87.63754
15529,3,13,false,7,16,9,41.89858,-87.62206
TA1307000128,3,13,false,3,8,5,41.89896,-87.6299
13042,3,13,false,17,28,11,41.90097,-87.62377
KA1504000133,3,13,false,6,8,2,41.90234,-87.62773
TA1307000039,3,13,false,8,7,-1,41.90294,-87.63137
TA1305000034,3,13,false,6,3,-3,41.90313,-87.67391
KA1504000135,3,13,false,6,8,2,41.90319,-87.63439
13061,3,13,false,8,9,1,41.90342,-87.66779
KA1504000079,3,13,false,6,3,-3,41.9035,-87.64334
TA1308000049,3,13,false,4,12,8,41.90672,-87.6349
KA1504000134,3,13,false,4,5,1,41.90687,-87.6262
13221,3,13,false,2,9,7,41.90765,-87.67254
TA1309000024,3,13,false,6,7,1,41.908,-87.63152
TA1305000041,3,13,false,5,7,2,41.9094,-87.67769
331,3,13,false,2,7,5,41.90965,-87.64812
15653,3,13,false,2,5,3,41.90979,-87.7053
13154,3,13,false,4,6,2,41.91054,-87.65312
13058,3,13,false,7,8,1,41.91059,-87.64942
LF-005,3,13,false,26,31,5,41.91172,-87.62681
13128,3,13,false,7,11,4,41.91197,-87.63197
TA1308000050,3,13,false,7,7,0,41.91211,-87.6347
13179,3,13,false,10,7,-3,41.9157,-87.63461
TA1309000006,3,13,false,1,5,4,41.91809,-87.64375
13146,3,13,false,11,6,-5,41.91831,-87.63629
13059,3,13,false,9,7,-2,41.91845,-87.65222
13192,3,13,false,2,7,5,41.91995,-87.64884
13193,3,13,false,3,8,5,41.92182,-87.64412
LP-,3,13,false,13,10,-3,41.92396,-87.63584
TA1309000019,3,13,false,3,5,2,41.92586,-87.63897
TA1309000058,3,13,false,8,7,-1,41.92591,-87.64927
TA1308000001,3,13,false,9,14,5,41.92627,-87.63086
13124,3,13,false,2,10,8,41.92675,-87.63444
TA1309000023,3,13,false,6,1,-5,41.9287,-87.65383
TA1305000014,3,13,false,8,6,-2,41.92956,-87.64313
TA1306000014,3,13,false,10,3,-7,41.93242,-87.65271
TA1309000039,3,13,false,7,9,2,41.93258,-87.63642
TA1307000041,3,13,false,4,5,1,41.93669,-87.63683
13137,3,13,false,3,7,4,41.9376,-87.6441
TA1307000134,3,13,false,6,6,0,41.94016,-87.65303
TA1309000049,3,13,false,7,2,-5,41.94077,-87.63919
TA1307000138,3,13,false,5,1,-4,41.94334,-87.67094
TA1309000025,3,13,false,3,6,3,41.94368,-87.64894
13278,3,13,false,2,5,3,41.94553,-87.64644
13325,3,13,false,3,6,3,41.94907,-87.64863
TA1307000126,3,13,false,5,15,10,41.94936,-87.65451
TA1307000150,3,13,false,7,4,-3,41.94945,-87.64646
TA1307000127,3,13,false,2,6,4,41.9508,-87.65918
13063,3,13,false,1,5,4,41.95424,-87.65441
TA1308000022,3,13,false,4,5,1,41.95438,-87.64805
TA1307000107,3,13,false,5,2,-3,41.96164,-87.65464
TA1308000012,3,13,false,3,6,3,41.96398,-87.63818
639,3,13,false,3,6,3,41.96584,-87.64538
KA1504000152,3,13,false,12,4,-8,41.98403,-87.65231
15575,3,13,false,4,6,2,41.98975,-87.66014
TA1309000011,3,13,true,3,6,3,41.78873,-87.60131
KA1503000071,3,13,true,10,5,-5,41.79148,-87.59988
TA1309000063,3,13,true,5,2,-3,41.79325,-87.5878
TA1308000009,3,13,true,5,3,-2,41.79522,-87.58075
TA1309000037,3,13,true,5,5,0,41.79957,-87.59474
KA1503000007,3,13,true,4,5,1,41.80242,-87.58689
TA1308000045,3,13,true,4,5,1,41.83062,-87.64129
TA1307000129,3,13,true,1,7,6,41.83104,-87.62683
15445,3,13,true,1,7,6,41.83453,-87.63183
13216,3,13,true,7,6,-1,41.83473,-87.62581
TA1309000055,3,13,true,8,4,-4,41.8382,-87.64514
TA1307000048,3,13,true,2,6,4,41.83855,-87.60821
TA1307000139,3,13,true,5,2,-3,41.84205,-87.61698
15545,3,13,true,5,3,-2,41.85627,-87.61334
13150,3,13,true,7,4,-3,41.85783,-87.62455
13164,3,13,true,1,5,4,41.85818,-87.65648
TA1307000124,3,13,true,6,4,-2,41.86411,-87.62372
TA1309000001,3,13,true,7,4,-3,41.86488,-87.64708
WL-008,3,13,true,3,6,3,41.86712,-87.64108
TA1305000002,3,13,true,4,7,3,41.86721,-87.62597
15544,3,13,true,1,9,8,41.86723,-87.61536
SL-005,3,13,true,17,6,-11,41.8679,-87.62304
644,3,13,true,6,1,-5,41.86859,-87.68625
13160,3,13,true,7,7,0,41.86947,-87.65548
15550,3,13,true,7,6,-1,41.87024,-87.63947
TA1309000064,3,13,true,8,3,-5,41.87127,-87.67369
TA1307000130,3,13,true,13,11,-2,41.87178,-87.65103
TA1307000121,3,13,true,10,8,-2,41.87184,-87.64664
SL-008,3,13,true,7,4,-3,41.87209,-87.62956
13332,3,13,true,12,10,-2,41.87219,-87.6615
KA1504000104,3,13,true,6,8,2,41.87296,-87.66912
SL-007,3,13,true,5,3,-2,41.87404,-87.6277
13028,3,13,true,5,2,-3,41.87475,-87.64981
TA1305000010,3,13,true,1,7,6,41.87623,-87.62444
624,3,13,true,2,5,3,41.87626,-87.62923
TA1305000035,3,13,true,9,8,-1,41.87716,-87.62787
13138,3,13,true,3,10,7,41.87723,-87.63941
13158,3,13,true,6,16,10,41.87764,-87.64957
13157,3,13,true,10,9,-1,41.87773,-87.6548
TA1305000025,3,13,true,5,7,2,41.87773,-87.63528
TA1309000004,3,13,true,7,6,-1,41.87811,-87.63184
638,3,13,true,8,10,2,41.87827,-87.64078
TA1305000005,3,13,true,5,4,-1,41.87924,-87.62975
13011,3,13,true,6,2,-4,41.87931,-87.63993
KA1503000015,3,13,true,9,4,-5,41.87948,-87.6257
TA1309000007,3,13,true,8,6,-2,41.88022,-87.63526
13300,3,13,true,8,4,-4,41.88097,-87.61675
13008,3,13,true,4,7,3,41.88105,-87.62408
TA1305000006,3,13,true,18,9,-9,41.88122,-87.6296
13056,3,13,true,5,3,-2,41.88168,-87.63951
TA1307000120,3,13,true,14,14,0,41.88188,-87.64879
13341,3,13,true,8,5,-3,41.88208,-87.63985
13036,3,13,true,5,2,-3,41.8821,-87.62513
TA1305000032,3,13,true,5,4,-1,41.88218,-87.64109
13006,3,13,true,11,10,-1,41.88268,-87.63252
13409,3,13,true,7,5,-2,41.8831,-87.6511
WL-012,3,13,true,6,9,3,41.88337,-87.6412
13053,3,13,true,6,9,3,41.88365,-87.64863
13001,3,13,true,12,3,-9,41.88397,-87.62459
TA1306000010,3,13,true,8,10,2,41.88419,-87.62961
TA1305000030,3,13,true,9,9,0,41.88459,-87.63178
15535,3,13,true,2,10,8,41.8846,-87.64455
TA1305000029,3,13,true,5,6,1,41.88466,-87.62787
13263,3,13,true,10,10,0,41.88467,-87.61952
TA1306000015,3,13,true,8,6,-2,41.88549,-87.65232
13021,3,13,true,9,10,1,41.88559,-87.64184
TA1307000111,3,13,true,12,8,-4,41.88582,-87.63548
KA1503000012,3,13,true,8,5,-3,41.88599,-87.63089
TA1305000011,3,13,true,10,11,1,41.886,-87.62418
TA1307000131,3,13,true,4,7,3,41.88688,-87.62606
KA1503000064,3,13,true,4,6,2,41.88697,-87.61281
TA1305000022,3,13,true,13,7,-6,41.88817,-87.63656
TA1306000003,3,13,true,7,6,-1,41.88867,-87.64442
KA1503000043,3,13,true,23,22,-1,41.88918,-87.63851
13050,3,13,true,5,4,-1,41.88919,-87.62775
TA1307000151,3,13,true,16,10,-6,41.88993,-87.63427
636,3,13,true,5,4,-1,41.88997,-87.63662
13427,3,13,true,2,5,3,41.89054,-87.62205
13430,3,13,true,12,11,-1,41.89077,-87.63169
TA1306000013,3,13,true,2,7,5,41.89083,-87.61852
RN-,3,13,true,3,6,3,41.89102,-87.63546
TA1307000117,3,13,true,19,18,-1,41.89144,-87.62675
13033,3,13,true,9,7,-2,41.8916,-87.64835
13194,3,13,true,6,4,-2,41.8918,-87.65878
TA1305000003,3,13,true,7,10,3,41.89187,-87.62061
13022,3,13,true,11,11,0,41.89227,-87.61205
TA1306000029,3,13,true,5,3,-2,41.89256,-87.61449
13265,3,13,true,11,14,3,41.89383,-87.64172
13045,3,13,true,12,19,7,41.89403,-87.62931
13016,3,13,true,13,12,-1,41.89431,-87.62277
KA1503000041,3,13,true,4,5,1,41.89452,-87.61798
13196,3,13,true,5,3,-2,41.89455,-87.65345
TA1307000062,3,13,true,8,15,7,41.89466,-87.63839
TA1306000012,3,13,true,11,11,0,41.89475,-87.63438
KP1705001026,3,13,true,8,4,-4,41.89483,-87.6323
13132,3,13,true,3,5,2,41.89573,-87.67718
15530,3,13,true,11,11,0,41.89575,-87.62596
18003,3,13,true,5,7,2,41.89575,-87.62011
13247,3,13,true,5,3,-2,41.89597,-87.66775
13303,3,13,true,6,4,-2,41.89672,-87.63088
13338,3,13,true,7,2,-5,41.89697,-87.62173
TA1307000061,3,13,true,1,6,5,41.89745,-87.62873
13034,3,13,true,2,6,4,41.89754,-87.62352
TA1306000009,3,13,true,10,9,-1,41.89772,-87.64299
620,3,13,true,4,7,3,41.89817,-87.63754
15529,3,13,true,10,13,3,41.89858,-87.62206
TA1307000128,3,13,true,10,18,8,41.89896,-87.6299
TA1306000011,3,13,true,7,5,-2,41.89994,-87.63443
13042,3,13,true,12,11,-1,41.90097,-87.62377
KA1504000133,3,13,true,9,13,4,41.90234,-87.62773
TA1307000039,3,13,true,13,10,-3,41.90294,-87.63137
KA1504000135,3,13,true,5,11,6,41.90319,-87.63439
13061,3,13,true,3,6,3,41.90342,-87.66779
KA1504000079,3,13,true,6,4,-2,41.9035,-87.64334
TA1307000115,3,13,true,5,1,-4,41.9046,-87.64056
TA1308000049,3,13,true,11,21,10,41.90672,-87.6349
13224,3,13,true,5,4,-1,41.90706,-87.66725
13221,3,13,true,2,6,4,41.90765,-87.67254
TA1309000024,3,13,true,9,6,-3,41.908,-87.63152
331,3,13,true,7,11,4,41.90965,-87.64812
TA1305000037,3,13,true,8,3,-5,41.91018,-87.67003
13154,3,13,true,8,7,-1,41.91054,-87.65312
13058,3,13,true,8,2,-6,41.91059,-87.64942
TA1307000038,3,13,true,4,8,4,41.91138,-87.63868
LF-005,3,13,true,14,8,-6,41.91172,-87.62681
TA1308000050,3,13,true,16,13,-3,41.91211,-87.6347
13243,3,13,true,4,6,2,41.91262,-87.6814
TA1306000032,3,13,true,10,8,-2,41.9137,-87.65285
TA1307000166,3,13,true,4,5,1,41.91386,-87.64877
18067,3,13,true,6,4,-2,41.9146,-87.66796
TA1306000007,3,13,true,4,6,2,41.91469,-87.64333
13179,3,13,true,9,6,-3,41.9157,-87.63461
TA1309000006,3,13,true,9,5,-4,41.91809,-87.64375
TA1307000163,3,13,true,6,3,-3,41.91821,-87.65696
13146,3,13,true,5,11,6,41.91831,-87.63629
13059,3,13,true,4,8,4,41.91845,-87.65222
13192,3,13,true,7,9,2,41.91995,-87.64884
TA1309000030,3,13,true,3,8,5,41.92077,-87.66372
TA1309000033,3,13,true,7,8,1,41.92158,-87.65381
13193,3,13,true,10,11,1,41.92182,-87.64412
13191,3,13,true,5,8,3,41.92217,-87.63891
LP-,3,13,true,8,6,-2,41.92396,-87.63584
TA1307000001,3,13,true,4,7,3,41.92535,-87.66581
TA1306000016,3,13,true,6,8,2,41.9256,-87.65371
TA1309000019,3,13,true,4,10,6,41.92586,-87.63897
TA1309000058,3,13,true,16,6,-10,41.92591,-87.64927
TA1308000001,3,13,true,12,12,0,41.92627,-87.63086
13296,3,13,true,3,6,3,41.92883,-87.66852
TA1305000014,3,13,true,10,8,-2,41.92956,-87.64313
TA1307000142,3,13,true,10,10,0,41.93125,-87.64432
13276,3,13,true,3,6,3,41.93132,-87.63874
TA1307000064,3,13,true,6,2,-4,41.93222,-87.65864
TA1306000014,3,13,true,5,6,1,41.93242,-87.65271
TA1309000039,3,13,true,10,7,-3,41.93258,-87.63642
TA1309000036,3,13,true,3,5,2,41.93313,-87.64776
13269,3,13,true,6,4,-2,41.93609,-87.66983
TA1307000052,3,13,true,6,5,-1,41.93628,-87.65266
TA1307000136,3,13,true,12,12,0,41.9365,-87.64755
TA1307000041,3,13,true,4,6,2,41.93669,-87.63683
13137,3,13,true,7,8,1,41.9376,-87.6441
TA1309000042,3,13,true,6,1,-5,41.93937,-87.66836
13229,3,13,true,5,2,-3,41.93946,-87.66376
TA1308000019,3,13,true,8,6,-2,41.93973,-87.65886
13277,3,13,true,5,6,1,41.9401,-87.64546
TA1307000134,3,13,true,12,14,2,41.94016,-87.65303
TA1309000049,3,13,true,5,8,3,41.94077,-87.63919
TA1309000025,3,13,true,8,8,0,41.94368,-87.64894
13071,3,13,true,1,11,10,41.94373,-87.66401
632,3,13,true,5,5,0,41.94453,-87.6547
15631,3,13,true,6,1,-5,41.94524,-87.70665
13278,3,13,true,5,5,0,41.94553,-87.64644
13235,3,13,true,12,4,-8,41.94814,-87.66396
13325,3,13,true,16,4,-12,41.94907,-87.64863
TA1307000126,3,13,true,6,9,3,41.94936,-87.65451
TA1307000150,3,13,true,12,14,2,41.94945,-87.64646
13319,3,13,true,5,1,-4,41.95069,-87.6687
TA1307000127,3,13,true,5,11,6,41.9508,-87.65918
13323,3,13,true,8,4,-4,41.95282,-87.65
13063,3,13,true,5,9,4,41.95424,-87.65441
TA1308000022,3,13,true,7,8,1,41.95438,-87.64805
13379,3,13,true,8,12,4,41.95786,-87.6495
TA1309000027,3,13,true,5,1,-4,41.9585,-87.65499
TA1307000144,3,13,true,5,2,-3,41.96142,-87.6762
TA1307000107,3,13,true,8,9,1,41.96164,-87.65464
TA1308000012,3,13,true,6,7,1,41.96398,-87.63818
13074,3,13,true,7,6,-1,41.96521,-87.6582
639,3,13,true,6,6,0,41.96584,-87.64538
TA1309000014,3,13,true,3,5,2,41.96709,-87.66744
TA1307000158,3,13,true,1,5,4,41.9671,-87.67904
TA1307000119,3,13,true,5,4,-1,41.96796,-87.65
TA1309000066,3,13,true,7,8,1,41.9691,-87.67423
TA1309000035,3,13,true,5,6,1,41.97335,-87.66785
13108,3,13,true,5,6,1,41.97379,-87.65971
13109,3,13,true,5,2,-3,41.97835,-87.65976
KA1504000151,3,13,true,5,4,-1,41.98359,-87.66916
KA1504000152,3,13,true,7,7,0,41.98403,-87.65231
15578,3,13,true,5,4,-1,41.98405,-87.66027
15575,3,13,true,2,7,5,41.98975,-87.66014
660,3,13,true,5,3,-2,42.00458,-87.66143
523,3,13,true,2,6,4,42.02089,-87.66505
KA1503000071,3,14,false,5,1,-4,41.79148,-87.59988
KA1503000074,3,14,false,13,4,-9,41.79174,-87.58395
KA1504000076,3,14,false,5,5,0,41.7943,-87.60145
TA1308000009,3,14,false,8,9,1,41.79522,-87.58075
KA1503000059,3,14,false,1,6,5,41.79952,-87.58643
KA1503000007,3,14,false,6,5,-1,41.80242,-87.58689
13075,3,14,false,6,8,2,41.8531,-87.63192
15545,3,14,false,7,6,-1,41.85627,-87.61334
SL-012,3,14,false,5,2,-3,41.86038,-87.62581
TA1309000001,3,14,false,5,5,0,41.86488,-87.64708
13029,3,14,false,11,1,-10,41.86531,-87.6179
13431,3,14,false,8,12,4,41.8661,-87.60728
TA1305000002,3,14,false,5,8,3,41.86721,-87.62597
15544,3,14,false,49,37,-12,41.86723,-87.61536
SL-005,3,14,false,10,7,-3,41.8679,-87.62304
15550,3,14,false,1,10,9,41.87024,-87.63947
TA1309000010,3,14,false,3,8,5,41.87074,-87.62574
SL-008,3,14,false,6,9,3,41.87209,-87.62956
623,3,14,false,2,7,5,41.87272,-87.62399
SL-007,3,14,false,4,6,2,41.87404,-87.6277
15541,3,14,false,29,20,-9,41.8758,-87.62086
TA1305000010,3,14,false,2,8,6,41.87623,-87.62444
TA1305000035,3,14,false,5,3,-2,41.87716,-87.62787
TA1305000025,3,14,false,20,7,-13,41.87773,-87.63528
TA1309000002,3,14,false,5,2,-3,41.87784,-87.62408
TA1309000004,3,14,false,5,3,-2,41.87811,-87.63184
TA1309000008,3,14,false,7,3,-4,41.87933,-87.6355
KA1503000015,3,14,false,12,3,-9,41.87948,-87.6257
WL-011,3,14,false,5,2,-3,41.88034,-87.64273
13156,3,14,false,5,3,-2,41.88042,-87.65554
13300,3,14,false,47,45,-2,41.88097,-87.61675
13008,3,14,false,29,20,-9,41.88105,-87.62408
TA1305000006,3,14,false,4,9,5,41.88122,-87.6296
TA1307000120,3,14,false,6,10,4,41.88188,-87.64879
13341,3,14,false,2,5,3,41.88208,-87.63985
13036,3,14,false,7,10,3,41.8821,-87.62513
TA1305000032,3,14,false,4,8,4,41.88218,-87.64109
KA1503000072,3,14,false,9,4,-5,41.88317,-87.63693
13001,3,14,false,15,15,0,41.88397,-87.62459
TA1306000010,3,14,false,2,5,3,41.88419,-87.62961
TA1305000030,3,14,false,7,5,-2,41.88459,-87.63178
TA1305000029,3,14,false,13,8,-5,41.88466,-87.62787
13263,3,14,false,5,6,1,41.88467,-87.61952
TA1307000111,3,14,false,8,6,-2,41.88582,-87.63548
KA1503000012,3,14,false,7,7,0,41.88599,-87.63089
TA1305000011,3,14,false,16,15,-1,41.886,-87.62418
15534,3,14,false,8,2,-6,41.88627,-87.61749
TA1308000029,3,14,false,6,8,2,41.88673,-87.62225
TA1307000131,3,14,false,9,10,1,41.88688,-87.62606
KA1503000064,3,14,false,15,14,-1,41.88697,-87.61281
TA1305000022,3,14,false,7,4,-3,41.88817,-87.63656
TA1306000003,3,14,false,7,7,0,41.88867,-87.64442
KA1503000043,3,14,false,9,6,-3,41.88918,-87.63851
TA1307000151,3,14,false,5,3,-2,41.88993,-87.63427
KA1503000044,3,14,false,5,2,-3,41.89018,-87.6262
13427,3,14,false,3,7,4,41.89054,-87.62205
13430,3,14,false,12,6,-6,41.89077,-87.63169
TA1306000013,3,14,false,10,3,-7,41.89083,-87.61852
RN-,3,14,false,7,3,-4,41.89102,-87.63546
TA1307000117,3,14,false,20,12,-8,41.89144,-87.62675
13033,3,14,false,3,9,6,41.8916,-87.64835
TA1305000003,3,14,false,7,8,1,41.89187,-87.62061
13022,3,14,false,66,63,-3,41.89227,-87.61205
TA1306000029,3,14,false,10,6,-4,41.89256,-87.61449
13045,3,14,false,11,11,0,41.89403,-87.62931
13016,3,14,false,6,8,2,41.89431,-87.62277
KA1503000041,3,14,false,8,6,-2,41.89452,-87.61798
KP1705001026,3,14,false,5,9,4,41.89483,-87.6323
15530,3,14,false,11,8,-3,41.89575,-87.62596
18003,3,14,false,7,4,-3,41.89575,-87.62011
13303,3,14,false,5,3,-2,41.89672,-87.63088
13017,3,14,false,5,2,-3,41.89676,-87.6357
13338,3,14,false,5,11,6,41.89697,-87.62173
TA1307000061,3,14,false,3,5,2,41.89745,-87.62873
13034,3,14,false,12,5,-7,41.89754,-87.62352
TA1306000009,3,14,false,9,1,-8,41.89772,-87.64299
15529,3,14,false,11,10,-1,41.89858,-87.62206
TA1307000128,3,14,false,4,8,4,41.89896,-87.6299
TA1306000011,3,14,false,1,6,5,41.89994,-87.63443
13042,3,14,false,27,28,1,41.90097,-87.62377
KA1504000133,3,14,false,4,7,3,41.90234,-87.62773
TA1307000039,3,14,false,8,10,2,41.90294,-87.63137
TA1308000049,3,14,false,5,3,-2,41.90672,-87.6349
13221,3,14,false,6,6,0,41.90765,-87.67254
TA1309000024,3,14,false,5,2,-3,41.908,-87.63152
TA1305000041,3,14,false,8,11,3,41.9094,-87.67769
331,3,14,false,10,6,-4,41.90965,-87.64812
15653,3,14,false,9,2,-7,41.90979,-87.7053
13154,3,14,false,1,7,6,41.91054,-87.65312
13058,3,14,false,5,6,1,41.91059,-87.64942
TA1307000038,3,14,false,5,9,4,41.91138,-87.63868
LF-005,3,14,false,28,36,8,41.91172,-87.62681
13128,3,14,false,5,8,3,41.91197,-87.63197
TA1308000050,3,14,false,7,4,-3,41.91211,-87.6347
13179,3,14,false,2,9,7,41.9157,-87.63461
15651,3,14,false,13,8,-5,41.91752,-87.70181
TA1307000163,3,14,false,3,5,2,41.91821,-87.65696
13146,3,14,false,10,11,1,41.91831,-87.63629
13059,3,14,false,10,2,-8,41.91845,-87.65222
13192,3,14,false,6,3,-3,41.91995,-87.64884
TA1309000030,3,14,false,5,5,0,41.92077,-87.66372
13292,3,14,false,5,1,-4,41.92152,-87.70733
13193,3,14,false,8,4,-4,41.92182,-87.64412
13191,3,14,false,5,3,-2,41.92217,-87.63891
LP-,3,14,false,8,12,4,41.92396,-87.63584
TA1306000016,3,14,false,4,7,3,41.9256,-87.65371
TA1309000019,3,14,false,11,2,-9,41.92586,-87.63897
TA1308000001,3,14,false,23,21,-2,41.92627,-87.63086
TA1309000061,3,14,false,5,2,-3,41.92915,-87.64909
TA1305000014,3,14,false,10,14,4,41.92956,-87.64313
13085,3,14,false,5,7,2,41.92958,-87.70789
TA1307000142,3,14,false,8,7,-1,41.93125,-87.64432
13276,3,14,false,8,6,-2,41.93132,-87.63874
TA1307000064,3,14,false,7,4,-3,41.93222,-87.65864
TA1309000039,3,14,false,7,12,5,41.93258,-87.63642
13294,3,14,false,5,1,-4,41.9326,-87.66595
TA1309000036,3,14,false,5,4,-1,41.93313,-87.64776
TA1307000006,3,14,false,9,3,-6,41.93571,-87.6636
TA1307000041,3,14,false,5,9,4,41.93669,-87.63683
13137,3,14,false,11,4,-7,41.9376,-87.6441
TA1309000042,3,14,false,4,5,1,41.93937,-87.66836
13229,3,14,false,6,1,-5,41.93946,-87.66376
TA1307000134,3,14,false,8,5,-3,41.94016,-87.65303
TA1309000049,3,14,false,11,9,-2,41.94077,-87.63919
TA1309000025,3,14,false,5,5,0,41.94368,-87.64894
13071,3,14,false,12,4,-8,41.94373,-87.66401
632,3,14,false,5,7,2,41.94453,-87.6547
13325,3,14,false,6,5,-1,41.94907,-87.64863
TA1307000126,3,14,false,6,3,-3,41.94936,-87.65451
TA1307000150,3,14,false,7,8,1,41.94945,-87.64646
13063,3,14,false,2,7,5,41.95424,-87.65441
13379,3,14,false,5,3,-2,41.95786,-87.6495
13389,3,14,false,5,1,-4,41.961,-87.64958
TA1308000012,3,14,false,6,12,6,41.96398,-87.63818
13074,3,14,false,5,2,-3,41.96521,-87.6582
639,3,14,false,11,6,-5,41.96584,-87.64538
KA1504000152,3,14,false,5,12,7,41.98403,-87.65231
15575,3,14,false,5,5,0,41.98975,-87.66014
596,3,14,false,2,10,8,42.04822,-87.68348
605,3,14,false,7,2,-5,42.05294,-87.67342
KA1503000014,3,14,true,8,1,-7,41.7851,-87.60108
TA1309000011,3,14,true,6,3,-3,41.78873,-87.60131
KA1503000071,3,14,true,7,7,0,41.79148,-87.59988
TA1308000009,3,14,true,5,5,0,41.79522,-87.58075
KA1503000059,3,14,true,1,5,4,41.79952,-87.58643
KA1503000007,3,14,true,4,7,3,41.80242,-87.58689
15445,3,14,true,5,3,-2,41.83453,-87.63183
13216,3,14,true,7,8,1,41.83473,-87.62581
TA1308000046,3,14,true,5,2,-3,41.83779,-87.65115
TA1309000055,3,14,true,6,7,1,41.8382,-87.64514
TA1307000048,3,14,true,6,4,-2,41.83855,-87.60821
TA1308000036,3,14,true,8,3,-5,41.83883,-87.62186
TA1307000139,3,14,true,7,8,1,41.84205,-87.61698
TA1305000001,3,14,true,3,8,5,41.85262,-87.6265
15545,3,14,true,13,15,2,41.85627,-87.61334
13102,3,14,true,6,1,-5,41.85762,-87.61942
13150,3,14,true,6,2,-4,41.85783,-87.62455
SL-012,3,14,true,5,8,3,41.86038,-87.62581
WL-008,3,14,true,13,6,-7,41.86712,-87.64108
TA1305000002,3,14,true,6,11,5,41.86721,-87.62597
15544,3,14,true,9,10,1,41.86723,-87.61536
KA1706005007,3,14,true,5,3,-2,41.86749,-87.63219
SL-005,3,14,true,5,5,0,41.8679,-87.62304
644,3,14,true,2,7,5,41.86859,-87.68625
13139,3,14,true,3,5,2,41.86893,-87.65913
13285,3,14,true,8,4,-4,41.86928,-87.67372
13160,3,14,true,9,6,-3,41.86947,-87.65548
TA1309000010,3,14,true,4,10,6,41.87074,-87.62574
TA1309000064,3,14,true,8,8,0,41.87127,-87.67369
TA1307000130,3,14,true,5,3,-2,41.87178,-87.65103
TA1307000121,3,14,true,6,4,-2,41.87184,-87.64664
SL-008,3,14,true,11,15,4,41.87209,-87.62956
13332,3,14,true,9,13,4,41.87219,-87.6615
623,3,14,true,3,5,2,41.87272,-87.62399
KA1504000104,3,14,true,11,7,-4,41.87296,-87.66912
13028,3,14,true,5,5,0,41.87475,-87.64981
TA1305000035,3,14,true,2,6,4,41.87716,-87.62787
15539,3,14,true,4,5,1,41.87763,-87.64405
13158,3,14,true,9,10,1,41.87764,-87.64957
13157,3,14,true,6,6,0,41.87773,-87.6548
TA1305000025,3,14,true,5,4,-1,41.87773,-87.63528
TA1309000004,3,14,true,18,1,-17,41.87811,-87.63184
638,3,14,true,7,3,-4,41.87827,-87.64078
TA1305000005,3,14,true,5,4,-1,41.87924,-87.62975
13011,3,14,true,6,7,1,41.87931,-87.63993
KA1503000015,3,14,true,2,6,4,41.87948,-87.6257
TA1309000007,3,14,true,7,4,-3,41.88022,-87.63526
WL-011,3,14,true,5,3,-2,41.88034,-87.64273
13156,3,14,true,6,6,0,41.88042,-87.65554
13300,3,14,true,15,11,-4,41.88097,-87.61675
13008,3,14,true,5,10,5,41.88105,-87.62408
TA1305000006,3,14,true,16,5,-11,41.88122,-87.6296
13134,3,14,true,1,5,4,41.88138,-87.67493
TA1307000120,3,14,true,8,14,6,41.88188,-87.64879
13341,3,14,true,6,10,4,41.88208,-87.63985
TA1305000032,3,14,true,5,7,2,41.88218,-87.64109
13006,3,14,true,9,5,-4,41.88268,-87.63252
KA1503000072,3,14,true,7,4,-3,41.88317,-87.63693
WL-012,3,14,true,6,15,9,41.88337,-87.6412
13053,3,14,true,7,9,2,41.88365,-87.64863
13001,3,14,true,2,5,3,41.88397,-87.62459
18062,3,14,true,6,4,-2,41.88412,-87.65427
TA1306000010,3,14,true,9,7,-2,41.88419,-87.62961
TA1305000030,3,14,true,9,6,-3,41.88459,-87.63178
TA1305000029,3,14,true,8,11,3,41.88466,-87.62787
13263,3,14,true,8,7,-1,41.88467,-87.61952
TA1306000015,3,14,true,9,7,-2,41.88549,-87.65232
13021,3,14,true,7,8,1,41.88559,-87.64184
KA1503000012,3,14,true,9,8,-1,41.88599,-87.63089
TA1305000011,3,14,true,11,6,-5,41.886,-87.62418
15534,3,14,true,5,7,2,41.88627,-87.61749
TA1308000029,3,14,true,9,4,-5,41.88673,-87.62225
KA1503000064,3,14,true,10,11,1,41.88697,-87.61281
TA1305000022,3,14,true,8,5,-3,41.88817,-87.63656
TA1306000003,3,14,true,8,6,-2,41.88867,-87.64442
KA1503000043,3,14,true,20,15,-5,41.88918,-87.63851
13050,3,14,true,6,4,-2,41.88919,-87.62775
13432,3,14,true,3,5,2,41.88989,-87.67149
TA1307000151,3,14,true,8,10,2,41.88993,-87.63427
636,3,14,true,3,7,4,41.88997,-87.63662
13430,3,14,true,2,6,4,41.89077,-87.63169
TA1306000013,3,14,true,3,7,4,41.89083,-87.61852
RN-,3,14,true,8,1,-7,41.89102,-87.63546
TA1307000117,3,14,true,13,8,-5,41.89144,-87.62675
13033,3,14,true,8,7,-1,41.8916,-87.64835
13194,3,14,true,5,2,-3,41.8918,-87.65878
TA1305000003,3,14,true,5,6,1,41.89187,-87.62061
13022,3,14,true,15,16,1,41.89227,-87.61205
TA1306000029,3,14,true,7,3,-4,41.89256,-87.61449
13265,3,14,true,9,14,5,41.89383,-87.64172
13045,3,14,true,13,11,-2,41.89403,-87.62931
13016,3,14,true,10,6,-4,41.89431,-87.62277
KA1503000041,3,14,true,17,8,-9,41.89452,-87.61798
TA1307000062,3,14,true,9,5,-4,41.89466,-87.63839
TA1306000012,3,14,true,12,10,-2,41.89475,-87.63438
KP1705001026,3,14,true,4,7,3,41.89483,-87.6323
15530,3,14,true,14,8,-6,41.89575,-87.62596
18003,3,14,true,8,1,-7,41.89575,-87.62011
13289,3,14,true,2,5,3,41.89638,-87.661
13303,3,14,true,6,6,0,41.89672,-87.63088
13017,3,14,true,6,7,1,41.89676,-87.6357
13338,3,14,true,7,7,0,41.89697,-87.62173
TA1307000061,3,14,true,4,6,2,41.89745,-87.62873
13034,3,14,true,5,3,-2,41.89754,-87.62352
TA1306000009,3,14,true,9,2,-7,41.89772,-87.64299
620,3,14,true,3,6,3,41.89817,-87.63754
15529,3,14,true,5,4,-1,41.89858,-87.62206
TA1307000128,3,14,true,9,16,7,41.89896,-87.6299
KA1504000116,3,14,true,1,6,5,41.90023,-87.64299
13042,3,14,true,12,10,-2,41.90097,-87.62377
KA1504000133,3,14,true,6,10,4,41.90234,-87.62773
TA1307000039,3,14,true,11,12,1,41.90294,-87.63137
KA1504000135,3,14,true,6,8,2,41.90319,-87.63439
13061,3,14,true,14,8,-6,41.90342,-87.66779
TA1308000049,3,14,true,7,5,-2,41.90672,-87.6349
KA1504000134,3,14,true,2,6,4,41.90687,-87.6262
13221,3,14,true,3,5,2,41.90765,-87.67254
TA1309000024,3,14,true,5,7,2,41.908,-87.63152
TA1305000041,3,14,true,5,6,1,41.9094,-87.67769
331,3,14,true,13,6,-7,41.90965,-87.64812
TA1305000037,3,14,true,4,5,1,41.91018,-87.67003
TA1306000008,3,14,true,1,5,4,41.9102,-87.6435
TA1307000038,3,14,true,5,6,1,41.91138,-87.63868
LF-005,3,14,true,10,15,5,41.91172,-87.62681
13128,3,14,true,5,4,-1,41.91197,-87.63197
TA1308000050,3,14,true,7,19,12,41.91211,-87.6347
13243,3,14,true,5,3,-2,41.91262,-87.6814
TA1306000032,3,14,true,5,3,-2,41.9137,-87.65285
TA1307000166,3,14,true,2,7,5,41.91386,-87.64877
18067,3,14,true,5,7,2,41.9146,-87.66796
13179,3,14,true,6,6,0,41.9157,-87.63461
13133,3,14,true,2,8,6,41.91598,-87.67733
TA1309000006,3,14,true,6,4,-2,41.91809,-87.64375
TA1307000163,3,14,true,2,7,5,41.91821,-87.65696
13146,3,14,true,14,11,-3,41.91831,-87.63629
13059,3,14,true,10,7,-3,41.91845,-87.65222
13259,3,14,true,5,1,-4,41.91852,-87.69744
13192,3,14,true,11,8,-3,41.91995,-87.64884
TA1309000033,3,14,true,3,5,2,41.92158,-87.65381
13193,3,14,true,8,12,4,41.92182,-87.64412
13191,3,14,true,9,9,0,41.92217,-87.63891
13084,3,14,true,6,2,-4,41.92268,-87.69715
TA1307000001,3,14,true,4,5,1,41.92535,-87.66581
TA1306000026,3,14,true,11,8,-3,41.92558,-87.65842
TA1306000016,3,14,true,7,4,-3,41.9256,-87.65371
TA1309000019,3,14,true,6,9,3,41.92586,-87.63897
TA1309000058,3,14,true,5,4,-1,41.92591,-87.64927
TA1308000001,3,14,true,12,16,4,41.92627,-87.63086
13124,3,14,true,2,5,3,41.92675,-87.63444
13296,3,14,true,2,5,3,41.92883,-87.66852
TA1309000059,3,14,true,5,5,0,41.92889,-87.65898
TA1309000061,3,14,true,5,7,2,41.92915,-87.64909
TA1305000014,3,14,true,4,6,2,41.92956,-87.64313
TA1307000142,3,14,true,14,9,-5,41.93125,-87.64432
13271,3,14,true,6,7,1,41.93192,-87.67784
TA1307000064,3,14,true,5,1,-4,41.93222,-87.65864
TA1306000014,3,14,true,9,5,-4,41.93242,-87.65271
TA1309000039,3,14,true,5,9,4,41.93258,-87.63642
13294,3,14,true,1,5,4,41.9326,-87.66595
TA1309000036,3,14,true,5,5,0,41.93313,-87.64776
TA1307000006,3,14,true,1,8,7,41.93571,-87.6636
13269,3,14,true,4,5,1,41.93609,-87.66983
TA1307000052,3,14,true,5,8,3,41.93628,-87.65266
TA1307000136,3,14,true,8,7,-1,41.9365,-87.64755
TA1307000041,3,14,true,4,8,4,41.93669,-87.63683
13137,3,14,true,11,13,2,41.9376,-87.6441
TA1309000042,3,14,true,6,4,-2,41.93937,-87.66836
TA1308000019,3,14,true,5,7,2,41.93973,-87.65886
13277,3,14,true,7,4,-3,41.9401,-87.64546
TA1307000134,3,14,true,6,7,1,41.94016,-87.65303
TA1309000049,3,14,true,5,10,5,41.94077,-87.63919
TA1307000138,3,14,true,6,6,0,41.94334,-87.67094
TA1309000025,3,14,true,8,8,0,41.94368,-87.64894
13071,3,14,true,8,3,-5,41.94373,-87.66401
632,3,14,true,7,4,-3,41.94453,-87.6547
13278,3,14,true,6,9,3,41.94553,-87.64644
13235,3,14,true,13,9,-4,41.94814,-87.66396
13253,3,14,true,5,1,-4,41.9488,-87.67527
13325,3,14,true,5,7,2,41.94907,-87.64863
TA1307000126,3,14,true,4,7,3,41.94936,-87.65451
TA1307000150,3,14,true,11,5,-6,41.94945,-87.64646
TA1307000127,3,14,true,10,5,-5,41.9508,-87.65918
13323,3,14,true,3,6,3,41.95282,-87.65
TA1308000022,3,14,true,7,5,-2,41.95438,-87.64805
13379,3,14,true,5,7,2,41.95786,-87.6495
TA1309000027,3,14,true,5,4,-1,41.9585,-87.65499
13389,3,14,true,5,3,-2,41.961,-87.64958
KA1503000022,3,14,true,5,3,-2,41.96158,-87.66609
TA1307000107,3,14,true,4,6,2,41.96164,-87.65464
TA1307000156,3,14,true,4,6,2,41.96301,-87.68479
TA1308000012,3,14,true,10,16,6,41.96398,-87.63818
13074,3,14,true,6,10,4,41.96521,-87.6582
TA1309000066,3,14,true,11,2,-9,41.9691,-87.67423
KA1504000171,3,14,true,6,1,-5,41.97161,-87.65016
13108,3,14,true,5,5,0,41.97379,-87.65971
KA1504000146,3,14,true,2,6,4,41.978,-87.66805
KA1504000151,3,14,true,1,5,4,41.98359,-87.66916
KA1504000152,3,14,true,14,10,-4,41.98403,-87.65231
15578,3,14,true,2,5,3,41.98405,-87.66027
15575,3,14,true,5,2,-3,41.98975,-87.66014
KA1503000071,3,15,false,7,2,-5,41.79148,-87.59988
KA1503000074,3,15,false,3,6,3,41.79174,-87.58395
TA1309000063,3,15,false,6,5,-1,41.79325,-87.5878
TA1308000009,3,15,false,18,14,-4,41.79522,-87.58075
TA1307000164,3,15,false,4,5,1,41.79527,-87.59647
KA1503000059,3,15,false,11,4,-7,41.79952,-87.58643
TA1309000037,3,15,false,1,6,5,41.79957,-87.59474
KA1503000007,3,15,false,6,4,-2,41.80242,-87.58689
13420,3,15,false,2,5,3,41.82459,-87.61678
KA1503000004,3,15,false,6,6,0,41.83127,-87.6088
TA1307000048,3,15,false,4,5,1,41.83855,-87.60821
TA1308000026,3,15,false,6,1,-5,41.85008,-87.63214
15545,3,15,false,5,8,3,41.85627,-87.61334
13150,3,15,false,4,6,2,41.85783,-87.62455
SL-012,3,15,false,5,1,-4,41.86038,-87.62581
TA1307000124,3,15,false,2,7,5,41.86411,-87.62372
13029,3,15,false,5,1,-4,41.86531,-87.6179
13431,3,15,false,13,8,-5,41.8661,-87.60728
TA1305000002,3,15,false,3,7,4,41.86721,-87.62597
15544,3,15,false,48,48,0,41.86723,-87.61536
KA1706005007,3,15,false,6,5,-1,41.86749,-87.63219
SL-005,3,15,false,7,12,5,41.8679,-87.62304
15550,3,15,false,10,2,-8,41.87024,-87.63947
TA1309000010,3,15,false,5,4,-1,41.87074,-87.62574
SL-008,3,15,false,6,5,-1,41.87209,-87.62956
SL-011,3,15,false,2,6,4,41.87256,-87.63356
623,3,15,false,5,12,7,41.87272,-87.62399
KA1504000104,3,15,false,5,1,-4,41.87296,-87.66912
15541,3,15,false,23,9,-14,41.8758,-87.62086
TA1305000010,3,15,false,9,3,-6,41.87623,-87.62444
624,3,15,false,4,5,1,41.87626,-87.62923
TA1305000035,3,15,false,6,4,-2,41.87716,-87.62787
13158,3,15,false,4,5,1,41.87764,-87.64957
13157,3,15,false,2,6,4,41.87773,-87.6548
TA1305000025,3,15,false,10,11,1,41.87773,-87.63528
TA1309000002,3,15,false,9,7,-2,41.87784,-87.62408
TA1309000008,3,15,false,6,8,2,41.87933,-87.6355
KA1503000015,3,15,false,3,7,4,41.87948,-87.6257
TA1309000007,3,15,false,10,2,-8,41.88022,-87.63526
13300,3,15,false,39,29,-10,41.88097,-87.61675
13008,3,15,false,36,28,-8,41.88105,-87.62408
TA1305000006,3,15,false,9,2,-7,41.88122,-87.6296
13056,3,15,false,8,4,-4,41.88168,-87.63951
TA1307000120,3,15,false,12,12,0,41.88188,-87.64879
13341,3,15,false,5,5,0,41.88208,-87.63985
13036,3,15,false,4,9,5,41.8821,-87.62513
TA1305000032,3,15,false,6,6,0,41.88218,-87.64109
13006,3,15,false,7,3,-4,41.88268,-87.63252
13409,3,15,false,5,3,-2,41.8831,-87.6511
WL-012,3,15,false,2,8,6,41.88337,-87.6412
13053,3,15,false,8,4,-4,41.88365,-87.64863
13001,3,15,false,13,17,4,41.88397,-87.62459
TA1306000010,3,15,false,15,8,-7,41.88419,-87.62961
TA1305000030,3,15,false,9,5,-4,41.88459,-87.63178
15535,3,15,false,3,6,3,41.8846,-87.64455
TA1305000029,3,15,false,19,16,-3,41.88466,-87.62787
13263,3,15,false,7,7,0,41.88467,-87.61952
TA1306000015,3,15,false,10,8,-2,41.88549,-87.65232
TA1307000111,3,15,false,12,3,-9,41.88582,-87.63548
KA1503000012,3,15,false,8,6,-2,41.88599,-87.63089
TA1305000011,3,15,false,21,22,1,41.886,-87.62418
15534,3,15,false,5,3,-2,41.88627,-87.61749
KA1503000064,3,15,false,29,17,-12,41.88697,-87.61281
TA1305000022,3,15,false,8,4,-4,41.88817,-87.63656
TA1306000003,3,15,false,1,6,5,41.88867,-87.64442
13050,3,15,false,4,7,3,41.88919,-87.62775
TA1307000151,3,15,false,11,4,-7,41.88993,-87.63427
13427,3,15,false,8,1,-7,41.89054,-87.62205
13430,3,15,false,9,15,6,41.89077,-87.63169
TA1306000013,3,15,false,13,10,-3,41.89083,-87.61852
RN-,3,15,false,3,6,3,41.89102,-87.63546
TA1307000117,3,15,false,15,13,-2,41.89144,-87.62675
13033,3,15,false,6,6,0,41.8916,-87.64835
TA1305000003,3,15,false,11,9,-2,41.89187,-87.62061
13022,3,15,false,76,90,14,41.89227,-87.61205
TA1306000029,3,15,false,6,14,8,41.89256,-87.61449
13045,3,15,false,14,12,-2,41.89403,-87.62931
13016,3,15,false,3,6,3,41.89431,-87.62277
KA1503000041,3,15,false,9,3,-6,41.89452,-87.61798
13196,3,15,false,1,6,5,41.89455,-87.65345
TA1306000012,3,15,false,12,9,-3,41.89475,-87.63438
KP1705001026,3,15,false,5,4,-1,41.89483,-87.6323
18058,3,15,false,5,1,-4,41.8955,-87.68201
637,3,15,false,5,5,0,41.89563,-87.67209
15530,3,15,false,4,7,3,41.89575,-87.62596
13247,3,15,false,3,8,5,41.89597,-87.66775
13289,3,15,false,5,2,-3,41.89638,-87.661
13338,3,15,false,11,5,-6,41.89697,-87.62173
TA1307000061,3,15,false,4,5,1,41.89745,-87.62873
13034,3,15,false,6,10,4,41.89754,-87.62352
TA1306000009,3,15,false,9,3,-6,41.89772,-87.64299
15529,3,15,false,10,6,-4,41.89858,-87.62206
TA1307000128,3,15,false,10,5,-5,41.89896,-87.6299
13042,3,15,false,30,25,-5,41.90097,-87.62377
KA1504000133,3,15,false,6,6,0,41.90234,-87.62773
TA1307000039,3,15,false,2,10,8,41.90294,-87.63137
TA1305000034,3,15,false,5,4,-1,41.90313,-87.67391
KA1504000135,3,15,false,6,13,7,41.90319,-87.63439
13136,3,15,false,3,5,2,41.90326,-87.67845
13061,3,15,false,3,5,2,41.90342,-87.66779
KA1504000079,3,15,false,7,6,-1,41.9035,-87.64334
TA1308000049,3,15,false,6,7,1,41.90672,-87.6349
KA1504000134,3,15,false,2,6,4,41.90687,-87.6262
13221,3,15,false,5,4,-1,41.90765,-87.67254
TA1309000024,3,15,false,1,5,4,41.908,-87.63152
TA1305000041,3,15,false,7,6,-1,41.9094,-87.67769
15653,3,15,false,2,10,8,41.90979,-87.7053
TA1308000005,3,15,false,5,1,-4,41.91042,-87.68238
LF-005,3,15,false,21,21,0,41.91172,-87.62681
13128,3,15,false,6,5,-1,41.91197,-87.63197
TA1308000050,3,15,false,11,16,5,41.91211,-87.6347
18067,3,15,false,5,6,1,41.9146,-87.66796
13179,3,15,false,13,11,-2,41.9157,-87.63461
13133,3,15,false,5,4,-1,41.91598,-87.67733
13146,3,15,false,3,8,5,41.91831,-87.63629
13059,3,15,false,5,6,1,41.91845,-87.65222
13192,3,15,false,8,5,-3,41.91995,-87.64884
13292,3,15,false,2,7,5,41.92152,-87.70733
TA1309000033,3,15,false,9,2,-7,41.92158,-87.65381
13193,3,15,false,8,4,-4,41.92182,-87.64412
13191,3,15,false,10,9,-1,41.92217,-87.63891
13084,3,15,false,3,10,7,41.92268,-87.69715
LP-,3,15,false,10,27,17,41.92396,-87.63584
KA1504000140,3,15,false,7,2,-5,41.92409,-87.67646
TA1306000026,3,15,false,3,6,3,41.92558,-87.65842
TA1309000058,3,15,false,5,8,3,41.92591,-87.64927
TA1308000001,3,15,false,23,21,-2,41.92627,-87.63086
13124,3,15,false,16,5,-11,41.92675,-87.63444
TA1307000113,3,15,false,3,8,5,41.92878,-87.66391
TA1305000014,3,15,false,9,5,-4,41.92956,-87.64313
13085,3,15,false,1,8,7,41.92958,-87.70789
TA1307000142,3,15,false,9,8,-1,41.93125,-87.64432
13276,3,15,false,5,11,6,41.93132,-87.63874
TA1307000064,3,15,false,5,4,-1,41.93222,-87.65864
TA1306000014,3,15,false,2,5,3,41.93242,-87.65271
TA1309000039,3,15,false,13,8,-5,41.93258,-87.63642
TA1307000006,3,15,false,9,6,-3,41.93571,-87.6636
TA1307000041,3,15,false,9,2,-7,41.93669,-87.63683
13137,3,15,false,9,10,1,41.9376,-87.6441
TA1309000042,3,15,false,9,1,-8,41.93937,-87.66836
TA1307000134,3,15,false,9,4,-5,41.94016,-87.65303
TA1309000049,3,15,false,3,10,7,41.94077,-87.63919
13144,3,15,false,8,3,-5,41.9434,-87.67964
TA1309000025,3,15,false,3,6,3,41.94368,-87.64894
13071,3,15,false,5,7,2,41.94373,-87.66401
632,3,15,false,10,7,-3,41.94453,-87.6547
13278,3,15,false,10,3,-7,41.94553,-87.64644
13235,3,15,false,5,2,-3,41.94814,-87.66396
TA1307000126,3,15,false,6,5,-1,41.94936,-87.65451
TA1307000150,3,15,false,4,7,3,41.94945,-87.64646
13323,3,15,false,2,5,3,41.95282,-87.65
TA1308000022,3,15,false,9,5,-4,41.95438,-87.64805
TA1309000027,3,15,false,1,5,4,41.9585,-87.65499
TA1308000012,3,15,false,20,13,-7,41.96398,-87.63818
639,3,15,false,6,6,0,41.96584,-87.64538
KA1504000146,3,15,false,4,6,2,41.978,-87.66805
KA1504000151,3,15,false,1,7,6,41.98359,-87.66916
KA1504000152,3,15,false,5,8,3,41.98403,-87.65231
15575,3,15,false,1,5,4,41.98975,-87.66014
596,3,15,false,2,6,4,42.04822,-87.68348
TA1309000011,3,15,true,10,2,-8,41.78873,-87.60131
KA1503000071,3,15,true,6,1,-5,41.79148,-87.59988
KA1503000074,3,15,true,1,12,11,41.79174,-87.58395
TA1308000009,3,15,true,5,7,2,41.79522,-87.58075
13216,3,15,true,15,10,-5,41.83473,-87.62581
13217,3,15,true,4,6,2,41.83488,-87.61792
TA1309000055,3,15,true,5,3,-2,41.8382,-87.64514
KA1503000038,3,15,true,5,2,-3,41.83845,-87.6354
TA1307000048,3,15,true,5,5,0,41.83855,-87.60821
TA1307000139,3,15,true,6,3,-3,41.84205,-87.61698
TA1307000005,3,15,true,3,7,4,41.84569,-87.6225
TA1305000001,3,15,true,6,2,-4,41.85262,-87.6265
13075,3,15,true,1,7,6,41.8531,-87.63192
15545,3,15,true,12,10,-2,41.85627,-87.61334
13102,3,15,true,2,7,5,41.85762,-87.61942
13099,3,15,true,5,5,0,41.85784,-87.64627
13164,3,15,true,6,4,-2,41.85818,-87.65648
SL-012,3,15,true,7,3,-4,41.86038,-87.62581
TA1307000124,3,15,true,7,13,6,41.86411,-87.62372
WL-008,3,15,true,4,7,3,41.86712,-87.64108
TA1305000002,3,15,true,9,17,8,41.86721,-87.62597
15544,3,15,true,5,3,-2,41.86723,-87.61536
TA1305000017,3,15,true,5,2,-3,41.86734,-87.64863
SL-005,3,15,true,8,9,1,41.8679,-87.62304
13139,3,15,true,4,8,4,41.86893,-87.65913
13285,3,15,true,10,6,-4,41.86928,-87.67372
13160,3,15,true,4,13,9,41.86947,-87.65548
15550,3,15,true,5,4,-1,41.87024,-87.63947
TA1309000010,3,15,true,7,14,7,41.87074,-87.62574
SL-009,3,15,true,3,6,3,41.87081,-87.63121
TA1309000064,3,15,true,19,10,-9,41.87127,-87.67369
TA1307000130,3,15,true,13,4,-9,41.87178,-87.65103
TA1307000121,3,15,true,9,4,-5,41.87184,-87.64664
SL-008,3,15,true,12,8,-4,41.87209,-87.62956
13332,3,15,true,8,16,8,41.87219,-87.6615
SL-011,3,15,true,7,7,0,41.87256,-87.63356
KA1504000104,3,15,true,40,3,-37,41.87296,-87.66912
SL-007,3,15,true,5,5,0,41.87404,-87.6277
TA1306000025,3,15,true,5,9,4,41.87464,-87.65703
13028,3,15,true,1,6,5,41.87475,-87.64981
SL-010,3,15,true,1,6,5,41.87501,-87.63309
TA1305000010,3,15,true,5,4,-1,41.87623,-87.62444
13138,3,15,true,5,2,-3,41.87723,-87.63941
15539,3,15,true,6,4,-2,41.87763,-87.64405
13158,3,15,true,12,9,-3,41.87764,-87.64957
13157,3,15,true,5,7,2,41.87773,-87.6548
TA1305000025,3,15,true,18,3,-15,41.87773,-87.63528
13206,3,15,true,5,3,-2,41.87794,-87.66201
TA1309000004,3,15,true,36,9,-27,41.87811,-87.63184
638,3,15,true,6,21,15,41.87827,-87.64078
TA1305000005,3,15,true,8,6,-2,41.87924,-87.62975
13011,3,15,true,13,13,0,41.87931,-87.63993
TA1309000008,3,15,true,12,7,-5,41.87933,-87.6355
KA1503000034,3,15,true,6,1,-5,41.87938,-87.63197
KA1503000015,3,15,true,4,5,1,41.87948,-87.6257
TA1309000007,3,15,true,16,6,-10,41.88022,-87.63526
13156,3,15,true,1,7,6,41.88042,-87.65554
13300,3,15,true,10,7,-3,41.88097,-87.61675
13008,3,15,true,9,6,-3,41.88105,-87.62408
TA1305000006,3,15,true,20,7,-13,41.88122,-87.6296
13056,3,15,true,5,3,-2,41.88168,-87.63951
TA1307000120,3,15,true,9,7,-2,41.88188,-87.64879
13341,3,15,true,8,17,9,41.88208,-87.63985
13036,3,15,true,5,7,2,41.8821,-87.62513
TA1305000032,3,15,true,5,24,19,41.88218,-87.64109
13006,3,15,true,10,4,-6,41.88268,-87.63252
13353,3,15,true,8,5,-3,41.88283,-87.6612
13409,3,15,true,7,3,-4,41.8831,-87.6511
WL-012,3,15,true,8,34,26,41.88337,-87.6412
13001,3,15,true,13,15,2,41.88397,-87.62459
18062,3,15,true,9,7,-2,41.88412,-87.65427
TA1306000010,3,15,true,18,7,-11,41.88419,-87.62961
TA1305000030,3,15,true,14,12,-2,41.88459,-87.63178
15535,3,15,true,6,5,-1,41.8846,-87.64455
TA1305000029,3,15,true,14,12,-2,41.88466,-87.62787
13263,3,15,true,9,12,3,41.88467,-87.61952
TA1306000015,3,15,true,6,7,1,41.88549,-87.65232
13021,3,15,true,8,13,5,41.88559,-87.64184
TA1307000111,3,15,true,9,4,-5,41.88582,-87.63548
13073,3,15,true,5,1,-4,41.88592,-87.66717
KA1503000012,3,15,true,7,5,-2,41.88599,-87.63089
TA1305000011,3,15,true,22,5,-17,41.886,-87.62418
15534,3,15,true,9,10,1,41.88627,-87.61749
13197,3,15,true,5,1,-4,41.8866,-87.65816
TA1308000029,3,15,true,8,4,-4,41.88673,-87.62225
TA1307000131,3,15,true,8,4,-4,41.88688,-87.62606
KA1503000064,3,15,true,9,11,2,41.88697,-87.61281
TA1305000022,3,15,true,11,4,-7,41.88817,-87.63656
TA1306000003,3,15,true,4,5,1,41.88867,-87.64442
KA1503000043,3,15,true,21,23,2,41.88918,-87.63851
13050,3,15,true,17,7,-10,41.88919,-87.62775
15664,3,15,true,1,9,8,41.8895,-87.68821
TA1307000151,3,15,true,18,7,-11,41.88993,-87.63427
636,3,15,true,12,7,-5,41.88997,-87.63662
KA1503000044,3,15,true,6,7,1,41.89018,-87.6262
13427,3,15,true,6,3,-3,41.89054,-87.62205
TA1306000013,3,15,true,7,7,0,41.89083,-87.61852
RN-,3,15,true,9,13,4,41.89102,-87.63546
TA1307000117,3,15,true,20,12,-8,41.89144,-87.62675
13033,3,15,true,9,7,-2,41.8916,-87.64835
TA1305000003,3,15,true,12,5,-7,41.89187,-87.62061
13022,3,15,true,13,15,2,41.89227,-87.61205
TA1306000029,3,15,true,4,5,1,41.89256,-87.61449
13265,3,15,true,16,20,4,41.89383,-87.64172
13045,3,15,true,14,15,1,41.89403,-87.62931
13016,3,15,true,37,7,-30,41.89431,-87.62277
KA1503000041,3,15,true,21,8,-13,41.89452,-87.61798
TA1307000062,3,15,true,9,5,-4,41.89466,-87.63839
TA1306000012,3,15,true,10,12,2,41.89475,-87.63438
KP1705001026,3,15,true,9,7,-2,41.89483,-87.6323
637,3,15,true,5,6,1,41.89563,-87.67209
13132,3,15,true,9,6,-3,41.89573,-87.67718
15530,3,15,true,16,5,-11,41.89575,-87.62596
18003,3,15,true,19,13,-6,41.89575,-87.62011
13289,3,15,true,3,8,5,41.89638,-87.661
13303,3,15,true,10,6,-4,41.89672,-87.63088
13017,3,15,true,9,6,-3,41.89676,-87.6357
13338,3,15,true,15,3,-12,41.89697,-87.62173
TA1307000061,3,15,true,1,6,5,41.89745,-87.62873
13034,3,15,true,6,2,-4,41.89754,-87.62352
TA1306000009,3,15,true,18,10,-8,41.89772,-87.64299
620,3,15,true,5,4,-1,41.89817,-87.63754
15529,3,15,true,14,6,-8,41.89858,-87.62206
TA1307000128,3,15,true,7,25,18,41.89896,-87.6299
657,3,15,true,1,7,6,41.89918,-87.6722
KA1504000116,3,15,true,8,8,0,41.90023,-87.64299
13042,3,15,true,13,6,-7,41.90097,-87.62377
KA1504000133,3,15,true,8,7,-1,41.90234,-87.62773
TA1307000039,3,15,true,13,17,4,41.90294,-87.63137
658,3,15,true,5,1,-4,41.903,-87.6838
TA1305000034,3,15,true,10,4,-6,41.90313,-87.67391
KA1504000135,3,15,true,17,24,7,41.90319,-87.63439
13136,3,15,true,2,5,3,41.90326,-87.67845
13061,3,15,true,9,10,1,41.90342,-87.66779
KA1504000079,3,15,true,11,8,-3,41.9035,-87.64334
TA1307000115,3,15,true,4,6,2,41.9046,-87.64056
TA1308000049,3,15,true,9,15,6,41.90672,-87.6349
KA1504000134,3,15,true,5,9,4,41.90687,-87.6262
13224,3,15,true,1,5,4,41.90706,-87.66725
13221,3,15,true,7,7,0,41.90765,-87.67254
TA1309000024,3,15,true,4,17,13,41.908,-87.63152
TA1305000041,3,15,true,7,8,1,41.9094,-87.67769
331,3,15,true,19,11,-8,41.90965,-87.64812
TA1305000037,3,15,true,1,6,5,41.91018,-87.67003
TA1306000008,3,15,true,4,6,2,41.9102,-87.6435
13154,3,15,true,7,7,0,41.91054,-87.65312
13058,3,15,true,9,9,0,41.91059,-87.64942
TA1307000038,3,15,true,3,6,3,41.91138,-87.63868
LF-005,3,15,true,5,10,5,41.91172,-87.62681
13128,3,15,true,4,6,2,41.91197,-87.63197
TA1308000050,3,15,true,19,17,-2,41.91211,-87.6347
13243,3,15,true,7,8,1,41.91262,-87.6814
TA1306000032,3,15,true,8,13,5,41.9137,-87.65285
TA1307000166,3,15,true,6,3,-3,41.91386,-87.64877
18017,3,15,true,5,5,0,41.91416,-87.71676
18067,3,15,true,7,9,2,41.9146,-87.66796
13068,3,15,true,4,6,2,41.91554,-87.68703
13179,3,15,true,10,10,0,41.9157,-87.63461
13133,3,15,true,4,7,3,41.91598,-87.67733
TA1307000163,3,15,true,9,2,-7,41.91821,-87.65696
13146,3,15,true,13,10,-3,41.91831,-87.63629
13192,3,15,true,8,9,1,41.91995,-87.64884
TA1309000033,3,15,true,12,11,-1,41.92158,-87.65381
13193,3,15,true,8,7,-1,41.92182,-87.64412
13191,3,15,true,7,9,2,41.92217,-87.63891
TA1307000001,3,15,true,5,9,4,41.92535,-87.66581
TA1306000026,3,15,true,13,6,-7,41.92558,-87.65842
TA1306000016,3,15,true,7,10,3,41.9256,-87.65371
TA1309000019,3,15,true,8,8,0,41.92586,-87.63897
TA1309000058,3,15,true,6,6,0,41.92591,-87.64927
TA1308000001,3,15,true,12,8,-4,41.92627,-87.63086
TA1309000023,3,15,true,3,5,2,41.9287,-87.65383
13296,3,15,true,3,7,4,41.92883,-87.66852
TA1309000061,3,15,true,2,10,8,41.92915,-87.64909
TA1305000014,3,15,true,11,12,1,41.92956,-87.64313
TA1307000142,3,15,true,8,6,-2,41.93125,-87.64432
13276,3,15,true,4,8,4,41.93132,-87.63874
13271,3,15,true,4,5,1,41.93192,-87.67784
TA1307000064,3,15,true,4,5,1,41.93222,-87.65864
TA1306000014,3,15,true,8,15,7,41.93242,-87.65271
TA1309000039,3,15,true,15,19,4,41.93258,-87.63642
TA1309000036,3,15,true,5,6,1,41.93313,-87.64776
TA1307000006,3,15,true,7,2,-5,41.93571,-87.6636
13269,3,15,true,6,4,-2,41.93609,-87.66983
TA1307000052,3,15,true,12,2,-10,41.93628,-87.65266
TA1307000136,3,15,true,11,12,1,41.9365,-87.64755
TA1307000041,3,15,true,7,8,1,41.93669,-87.63683
13137,3,15,true,12,12,0,41.9376,-87.6441
TA1309000042,3,15,true,5,7,2,41.93937,-87.66836
13229,3,15,true,3,5,2,41.93946,-87.66376
13277,3,15,true,3,7,4,41.9401,-87.64546
TA1307000134,3,15,true,9,8,-1,41.94016,-87.65303
TA1309000049,3,15,true,12,12,0,41.94077,-87.63919
TA1307000138,3,15,true,9,7,-2,41.94334,-87.67094
TA1309000025,3,15,true,6,5,-1,41.94368,-87.64894
13071,3,15,true,9,8,-1,41.94373,-87.66401
632,3,15,true,7,7,0,41.94453,-87.6547
13278,3,15,true,11,13,2,41.94553,-87.64644
13235,3,15,true,9,14,5,41.94814,-87.66396
13325,3,15,true,6,11,5,41.94907,-87.64863
TA1307000126,3,15,true,4,8,4,41.94936,-87.65451
TA1307000150,3,15,true,6,13,7,41.94945,-87.64646
13319,3,15,true,5,1,-4,41.95069,-87.6687
TA1307000127,3,15,true,8,5,-3,41.9508,-87.65918
13323,3,15,true,5,9,4,41.95282,-87.65
TA1309000043,3,15,true,5,3,-2,41.95417,-87.66434
13063,3,15,true,7,8,1,41.95424,-87.65441
TA1308000022,3,15,true,4,5,1,41.95438,-87.64805
TA1307000149,3,15,true,7,2,-5,41.95467,-87.67392
TA1309000026,3,15,true,6,3,-3,41.95601,-87.6802
13379,3,15,true,5,5,0,41.95786,-87.6495
TA1309000027,3,15,true,6,5,-1,41.9585,-87.65499
13389,3,15,true,7,3,-4,41.961,-87.64958
TA1307000144,3,15,true,2,5,3,41.96142,-87.6762
15623,3,15,true,3,5,2,41.96154,-87.69117
TA1307000107,3,15,true,11,6,-5,41.96164,-87.65464
TA1307000156,3,15,true,7,2,-5,41.96301,-87.68479
TA1308000012,3,15,true,5,9,4,41.96398,-87.63818
13074,3,15,true,3,7,4,41.96521,-87.6582
639,3,15,true,5,7,2,41.96584,-87.64538
TA1307000140,3,15,true,3,5,2,41.96643,-87.68865
TA1307000158,3,15,true,6,2,-4,41.9671,-87.67904
TA1307000119,3,15,true,6,1,-5,41.96796,-87.65
TA1308000021,3,15,true,5,5,0,41.96883,-87.65765
TA1309000066,3,15,true,1,7,6,41.9691,-87.67423
TA1309000035,3,15,true,1,6,5,41.97335,-87.66785
13108,3,15,true,5,7,2,41.97379,-87.65971
KA1504000149,3,15,true,1,5,4,41.97562,-87.67945
KA1504000146,3,15,true,5,4,-1,41.978,-87.66805
13109,3,15,true,10,5,-5,41.97835,-87.65976
KA1504000151,3,15,true,5,6,1,41.98359,-87.66916
KA1504000152,3,15,true,8,7,-1,41.98403,-87.65231
15575,3,15,true,5,2,-3,41.98975,-87.66014
15491,3,16,false,5,6,1,41.78096,-87.57624
KA1503000071,3,16,false,4,5,1,41.79148,-87.59988
KA1503000074,3,16,false,7,2,-5,41.79174,-87.58395
TA1309000063,3,16,false,2,7,5,41.79325,-87.5878
TA1308000009,3,16,false,4,6,2,41.79522,-87.58075
KA1503000052,3,16,false,2,8,6,41.79935,-87.60097
TA1309000037,3,16,false,5,10,5,41.79957,-87.59474
TA1308000007,3,16,false,5,3,-2,41.80984,-87.61628
TA1309000055,3,16,false,1,5,4,41.8382,-87.64514
TA1307000048,3,16,false,17,15,-2,41.83855,-87.60821
13075,3,16,false,5,7,2,41.8531,-87.63192
15545,3,16,false,5,5,0,41.85627,-87.61334
SL-006,3,16,false,6,1,-5,41.8568,-87.63387
13150,3,16,false,3,5,2,41.85783,-87.62455
13163,3,16,false,3,8,5,41.85808,-87.65108
TA1307000124,3,16,false,9,4,-5,41.86411,-87.62372
13029,3,16,false,8,7,-1,41.86531,-87.6179
13431,3,16,false,19,9,-10,41.8661,-87.60728
TA1305000002,3,16,false,12,7,-5,41.86721,-87.62597
15544,3,16,false,47,31,-16,41.86723,-87.61536
KA1706005007,3,16,false,5,7,2,41.86749,-87.63219
SL-005,3,16,false,18,16,-2,41.8679,-87.62304
13160,3,16,false,4,5,1,41.86947,-87.65548
TA1309000010,3,16,false,5,5,0,41.87074,-87.62574
SL-009,3,16,false,8,6,-2,41.87081,-87.63121
TA1309000064,3,16,false,5,1,-4,41.87127,-87.67369
TA1307000130,3,16,false,1,5,4,41.87178,-87.65103
SL-008,3,16,false,5,4,-1,41.87209,-87.62956
13332,3,16,false,3,5,2,41.87219,-87.6615
SL-011,3,16,false,6,10,4,41.87256,-87.63356
623,3,16,false,22,19,-3,41.87272,-87.62399
15541,3,16,false,18,28,10,41.8758,-87.62086
624,3,16,false,6,5,-1,41.87626,-87.62923
TA1305000035,3,16,false,14,4,-10,41.87716,-87.62787
15539,3,16,false,5,3,-2,41.87763,-87.64405
13158,3,16,false,2,6,4,41.87764,-87.64957
TA1305000025,3,16,false,22,8,-14,41.87773,-87.63528
TA1309000002,3,16,false,12,5,-7,41.87784,-87.62408
638,3,16,false,7,4,-3,41.87827,-87.64078
13011,3,16,false,5,7,2,41.87931,-87.63993
TA1309000008,3,16,false,5,2,-3,41.87933,-87.6355
KA1503000034,3,16,false,5,2,-3,41.87938,-87.63197
TA1309000007,3,16,false,21,6,-15,41.88022,-87.63526
WL-011,3,16,false,6,4,-2,41.88034,-87.64273
13156,3,16,false,4,12,8,41.88042,-87.65554
13300,3,16,false,45,34,-11,41.88097,-87.61675
13008,3,16,false,36,63,27,41.88105,-87.62408
TA1305000006,3,16,false,15,2,-13,41.88122,-87.6296
13056,3,16,false,13,5,-8,41.88168,-87.63951
TA1307000120,3,16,false,5,13,8,41.88188,-87.64879
13341,3,16,false,10,8,-2,41.88208,-87.63985
TA1305000032,3,16,false,12,9,-3,41.88218,-87.64109
13409,3,16,false,6,10,4,41.8831,-87.6511
KA1503000072,3,16,false,11,3,-8,41.88317,-87.63693
WL-012,3,16,false,6,3,-3,41.88337,-87.6412
13053,3,16,false,4,7,3,41.88365,-87.64863
13001,3,16,false,14,23,9,41.88397,-87.62459
13155,3,16,false,6,3,-3,41.88407,-87.65689
TA1306000010,3,16,false,10,4,-6,41.88419,-87.62961
TA1305000030,3,16,false,9,6,-3,41.88459,-87.63178
15535,3,16,false,3,5,2,41.8846,-87.64455
TA1305000029,3,16,false,15,17,2,41.88466,-87.62787
13263,3,16,false,5,8,3,41.88467,-87.61952
TA1306000015,3,16,false,10,12,2,41.88549,-87.65232
13021,3,16,false,7,6,-1,41.88559,-87.64184
TA1307000111,3,16,false,24,5,-19,41.88582,-87.63548
KA1503000012,3,16,false,6,10,4,41.88599,-87.63089
TA1305000011,3,16,false,18,16,-2,41.886,-87.62418
15534,3,16,false,5,7,2,41.88627,-87.61749
13197,3,16,false,7,1,-6,41.8866,-87.65816
TA1308000029,3,16,false,5,1,-4,41.88673,-87.62225
TA1307000131,3,16,false,13,11,-2,41.88688,-87.62606
KA1503000064,3,16,false,19,22,3,41.88697,-87.61281
TA1305000022,3,16,false,11,10,-1,41.88817,-87.63656
TA1306000003,3,16,false,13,8,-5,41.88867,-87.64442
KA1503000043,3,16,false,17,7,-10,41.88918,-87.63851
13050,3,16,false,11,6,-5,41.88919,-87.62775
TA1307000151,3,16,false,11,6,-5,41.88993,-87.63427
636,3,16,false,11,2,-9,41.88997,-87.63662
KA1503000044,3,16,false,6,3,-3,41.89018,-87.6262
13427,3,16,false,14,13,-1,41.89054,-87.62205
13430,3,16,false,17,10,-7,41.89077,-87.63169
TA1306000013,3,16,false,8,15,7,41.89083,-87.61852
RN-,3,16,false,11,5,-6,41.89102,-87.63546
13434,3,16,false,6,3,-3,41.89108,-87.66663
TA1308000006,3,16,false,6,4,-2,41.89128,-87.67686
TA1307000117,3,16,false,14,13,-1,41.89144,-87.62675
13033,3,16,false,13,9,-4,41.8916,-87.64835
13194,3,16,false,7,3,-4,41.8918,-87.65878
TA1305000003,3,16,false,9,13,4,41.89187,-87.62061
13022,3,16,false,108,106,-2,41.89227,-87.61205
TA1306000029,3,16,false,12,7,-5,41.89256,-87.61449
13265,3,16,false,5,9,4,41.89383,-87.64172
13045,3,16,false,9,17,8,41.89403,-87.62931
13016,3,16,false,12,6,-6,41.89431,-87.62277
KA1503000041,3,16,false,15,7,-8,41.89452,-87.61798
TA1306000012,3,16,false,13,8,-5,41.89475,-87.63438
KP1705001026,3,16,false,3,6,3,41.89483,-87.6323
13132,3,16,false,7,7,0,41.89573,-87.67718
15530,3,16,false,8,19,11,41.89575,-87.62596
13247,3,16,false,6,2,-4,41.89597,-87.66775
TA1305000020,3,16,false,1,8,7,41.89636,-87.65406
13303,3,16,false,5,6,1,41.89672,-87.63088
13017,3,16,false,2,5,3,41.89676,-87.6357
13338,3,16,false,11,5,-6,41.89697,-87.62173
TA1307000061,3,16,false,4,6,2,41.89745,-87.62873
13034,3,16,false,11,7,-4,41.89754,-87.62352
TA1306000009,3,16,false,9,2,-7,41.89772,-87.64299
620,3,16,false,8,13,5,41.89817,-87.63754
KA1504000103,3,16,false,5,1,-4,41.89842,-87.68659
15529,3,16,false,9,10,1,41.89858,-87.62206
TA1307000128,3,16,false,10,14,4,41.89896,-87.6299
13248,3,16,false,5,3,-2,41.89964,-87.66788
KA1504000116,3,16,false,3,6,3,41.90023,-87.64299
13042,3,16,false,42,45,3,41.90097,-87.62377
KA1504000133,3,16,false,24,11,-13,41.90234,-87.62773
TA1307000039,3,16,false,20,16,-4,41.90294,-87.63137
TA1305000034,3,16,false,6,6,0,41.90313,-87.67391
KA1504000135,3,16,false,13,17,4,41.90319,-87.63439
13061,3,16,false,8,12,4,41.90342,-87.66779
KA1504000079,3,16,false,5,7,2,41.9035,-87.64334
TA1308000049,3,16,false,15,6,-9,41.90672,-87.6349
KA1504000134,3,16,false,9,4,-5,41.90687,-87.6262
TA1307000143,3,16,false,5,2,-3,41.90762,-87.63854
13221,3,16,false,4,8,4,41.90765,-87.67254
TA1309000024,3,16,false,20,13,-7,41.908,-87.63152
TA1305000041,3,16,false,10,6,-4,41.9094,-87.67769
331,3,16,false,7,12,5,41.90965,-87.64812
TA1305000037,3,16,false,9,1,-8,41.91018,-87.67003
13257,3,16,false,1,7,6,41.91054,-87.68956
13154,3,16,false,9,6,-3,41.91054,-87.65312
13058,3,16,false,9,5,-4,41.91059,-87.64942
TA1307000038,3,16,false,3,8,5,41.91138,-87.63868
LF-005,3,16,false,32,27,-5,41.91172,-87.62681
13128,3,16,false,10,5,-5,41.91197,-87.63197
TA1308000050,3,16,false,17,29,12,41.91211,-87.6347
13243,3,16,false,12,9,-3,41.91262,-87.6814
TA1306000032,3,16,false,7,8,1,41.9137,-87.65285
18067,3,16,false,3,5,2,41.9146,-87.66796
13179,3,16,false,7,14,7,41.9157,-87.63461
13133,3,16,false,5,7,2,41.91598,-87.67733
TA1305000039,3,16,false,6,11,5,41.9163,-87.66749
TA1309000006,3,16,false,5,2,-3,41.91809,-87.64375
13146,3,16,false,27,19,-8,41.91831,-87.63629
13059,3,16,false,7,17,10,41.91845,-87.65222
13192,3,16,false,9,9,0,41.91995,-87.64884
TA1309000030,3,16,false,8,6,-2,41.92077,-87.66372
TA1309000033,3,16,false,1,5,4,41.92158,-87.65381
13193,3,16,false,12,14,2,41.92182,-87.64412
13191,3,16,false,9,8,-1,41.92217,-87.63891
13084,3,16,false,5,3,-2,41.92268,-87.69715
LP-,3,16,false,22,12,-10,41.92396,-87.63584
TA1307000001,3,16,false,7,7,0,41.92535,-87.66581
TA1306000026,3,16,false,3,10,7,41.92558,-87.65842
TA1306000016,3,16,false,13,6,-7,41.9256,-87.65371
TA1309000019,3,16,false,13,19,6,41.92586,-87.63897
TA1309000058,3,16,false,10,9,-1,41.92591,-87.64927
TA1308000001,3,16,false,34,33,-1,41.92627,-87.63086
13124,3,16,false,5,7,2,41.92675,-87.63444
TA1309000023,3,16,false,14,13,-1,41.9287,-87.65383
13296,3,16,false,5,4,-1,41.92883,-87.66852
TA1309000061,3,16,false,8,7,-1,41.92915,-87.64909
TA1308000031,3,16,false,4,5,1,41.92946,-87.68417
TA1305000014,3,16,false,12,8,-4,41.92956,-87.64313
13085,3,16,false,3,5,2,41.92958,-87.70789
TA1307000142,3,16,false,12,8,-4,41.93125,-87.64432
13276,3,16,false,11,4,-7,41.93132,-87.63874
TA1307000064,3,16,false,8,3,-5,41.93222,-87.65864
TA1306000014,3,16,false,9,11,2,41.93242,-87.65271
TA1309000039,3,16,false,9,8,-1,41.93258,-87.63642
13294,3,16,false,6,2,-4,41.9326,-87.66595
TA1309000036,3,16,false,4,8,4,41.93313,-87.64776
TA1307000006,3,16,false,12,3,-9,41.93571,-87.6636
TA1307000052,3,16,false,9,9,0,41.93628,-87.65266
TA1307000136,3,16,false,8,9,1,41.9365,-87.64755
TA1307000041,3,16,false,9,10,1,41.93669,-87.63683
13137,3,16,false,19,14,-5,41.9376,-87.6441
15642,3,16,false,2,5,3,41.93843,-87.69801
TA1309000042,3,16,false,4,7,3,41.93937,-87.66836
13229,3,16,false,8,3,-5,41.93946,-87.66376
TA1308000019,3,16,false,7,9,2,41.93973,-87.65886
13277,3,16,false,2,6,4,41.9401,-87.64546
TA1307000134,3,16,false,16,8,-8,41.94016,-87.65303
TA1309000049,3,16,false,10,15,5,41.94077,-87.63919
TA1307000138,3,16,false,4,5,1,41.94334,-87.67094
TA1309000025,3,16,false,10,7,-3,41.94368,-87.64894
13071,3,16,false,19,16,-3,41.94373,-87.66401
632,3,16,false,14,10,-4,41.94453,-87.6547
13278,3,16,false,14,5,-9,41.94553,-87.64644
13235,3,16,false,8,5,-3,41.94814,-87.66396
13325,3,16,false,8,3,-5,41.94907,-87.64863
TA1307000126,3,16,false,21,13,-8,41.94936,-87.65451
TA1307000150,3,16,false,12,13,1,41.94945,-87.64646
13319,3,16,false,1,5,4,41.95069,-87.6687
TA1307000127,3,16,false,6,5,-1,41.9508,-87.65918
13323,3,16,false,10,6,-4,41.95282,-87.65
TA1308000022,3,16,false,6,5,-1,41.95438,-87.64805
TA1309000026,3,16,false,3,8,5,41.95601,-87.6802
13379,3,16,false,6,8,2,41.95786,-87.6495
TA1309000018,3,16,false,5,3,-2,41.95791,-87.67357
TA1307000107,3,16,false,7,4,-3,41.96164,-87.65464
TA1308000012,3,16,false,12,10,-2,41.96398,-87.63818
13074,3,16,false,5,3,-2,41.96521,-87.6582
639,3,16,false,6,10,4,41.96584,-87.64538
TA1307000140,3,16,false,3,5,2,41.96643,-87.68865
TA1309000066,3,16,false,5,5,0,41.9691,-87.67423
TA1309000035,3,16,false,5,2,-3,41.97335,-87.66785
KA1504000146,3,16,false,6,5,-1,41.978,-87.66805
13109,3,16,false,8,2,-6,41.97835,-87.65976
KA1504000151,3,16,false,6,5,-1,41.98359,-87.66916
KA1504000152,3,16,false,9,13,4,41.98403,-87.65231
15575,3,16,false,6,4,-2,41.98975,-87.66014
15571,3,16,false,6,6,0,41.99478,-87.66028
RP-009,3,16,false,3,7,4,42.00107,-87.66122
KA1504000159,3,16,false,1,5,4,42.01059,-87.66241
596,3,16,false,7,4,-3,42.04822,-87.68348
KA1503000014,3,16,true,5,6,1,41.7851,-87.60108
TA1309000011,3,16,true,9,1,-8,41.78873,-87.60131
KA1503000071,3,16,true,11,7,-4,41.79148,-87.59988
TA1309000063,3,16,true,7,3,-4,41.79325,-87.5878
TA1308000009,3,16,true,8,13,5,41.79522,-87.58075
TA1307000164,3,16,true,1,6,5,41.79527,-87.59647
KA1503000052,3,16,true,6,2,-4,41.79935,-87.60097
KA1503000059,3,16,true,2,5,3,41.79952,-87.58643
TA1309000037,3,16,true,6,8,2,41.79957,-87.59474
KA1503000007,3,16,true,4,5,1,41.80242,-87.58689
13398,3,16,true,5,4,-1,41.80256,-87.59035
KA1503000068,3,16,true,1,7,6,41.82878,-87.68062
TA1308000045,3,16,true,8,2,-6,41.83062,-87.64129
TA1308000043,3,16,true,5,3,-2,41.83066,-87.64715
TA1307000129,3,16,true,8,1,-7,41.83104,-87.62683
KA1503000004,3,16,true,5,3,-2,41.83127,-87.6088
15445,3,16,true,5,3,-2,41.83453,-87.63183
13216,3,16,true,16,13,-3,41.83473,-87.62581
13217,3,16,true,5,10,5,41.83488,-87.61792
TA1309000055,3,16,true,6,5,-1,41.8382,-87.64514
TA1308000036,3,16,true,3,6,3,41.83883,-87.62186
TA1307000139,3,16,true,6,7,1,41.84205,-87.61698
TA1307000153,3,16,true,2,9,7,41.84358,-87.64538
TA1307000005,3,16,true,5,3,-2,41.84569,-87.6225
13075,3,16,true,8,9,1,41.8531,-87.63192
15546,3,16,true,6,1,-5,41.85416,-87.61916
15545,3,16,true,15,14,-1,41.85627,-87.61334
SL-013,3,16,true,4,5,1,41.85659,-87.62755
13135,3,16,true,3,5,2,41.85753,-87.66157
13102,3,16,true,10,13,3,41.85762,-87.61942
13150,3,16,true,10,10,0,41.85783,-87.62455
TA1307000044,3,16,true,5,3,-2,41.85794,-87.64083
13163,3,16,true,2,6,4,41.85808,-87.65108
13164,3,16,true,6,8,2,41.85818,-87.65648
SL-012,3,16,true,4,8,4,41.86038,-87.62581
TA1307000124,3,16,true,10,17,7,41.86411,-87.62372
13354,3,16,true,2,5,3,41.86524,-87.66651
13029,3,16,true,7,4,-3,41.86531,-87.6179
13431,3,16,true,9,3,-6,41.8661,-87.60728
WL-008,3,16,true,9,12,3,41.86712,-87.64108
TA1305000002,3,16,true,17,24,7,41.86721,-87.62597
15544,3,16,true,6,1,-5,41.86723,-87.61536
TA1305000017,3,16,true,6,1,-5,41.86734,-87.64863
KA1706005007,3,16,true,4,6,2,41.86749,-87.63219
SL-005,3,16,true,15,29,14,41.8679,-87.62304
644,3,16,true,8,5,-3,41.86859,-87.68625
13139,3,16,true,6,2,-4,41.86893,-87.65913
13285,3,16,true,26,1,-25,41.86928,-87.67372
13160,3,16,true,6,9,3,41.86947,-87.65548
15550,3,16,true,7,6,-1,41.87024,-87.63947
TA1309000010,3,16,true,6,6,0,41.87074,-87.62574
SL-009,3,16,true,4,9,5,41.87081,-87.63121
TA1309000064,3,16,true,28,1,-27,41.87127,-87.67369
TA1307000130,3,16,true,14,6,-8,41.87178,-87.65103
TA1307000121,3,16,true,9,8,-1,41.87184,-87.64664
SL-008,3,16,true,16,16,0,41.87209,-87.62956
13332,3,16,true,13,20,7,41.87219,-87.6615
SL-011,3,16,true,5,13,8,41.87256,-87.63356
623,3,16,true,10,12,2,41.87272,-87.62399
SL-007,3,16,true,10,6,-4,41.87404,-87.6277
TA1306000025,3,16,true,3,5,2,41.87464,-87.65703
13028,3,16,true,10,4,-6,41.87475,-87.64981
13081,3,16,true,7,1,-6,41.87501,-87.67326
SL-010,3,16,true,6,16,10,41.87501,-87.63309
13037,3,16,true,5,2,-3,41.87588,-87.64078
TA1305000009,3,16,true,7,10,3,41.87593,-87.63068
624,3,16,true,5,4,-1,41.87626,-87.62923
TA1305000035,3,16,true,17,8,-9,41.87716,-87.62787
13138,3,16,true,6,3,-3,41.87723,-87.63941
15539,3,16,true,12,12,0,41.87763,-87.64405
13158,3,16,true,27,13,-14,41.87764,-87.64957
13157,3,16,true,10,7,-3,41.87773,-87.6548
TA1305000025,3,16,true,18,5,-13,41.87773,-87.63528
TA1309000002,3,16,true,6,2,-4,41.87784,-87.62408
13206,3,16,true,4,10,6,41.87794,-87.66201
TA1309000004,3,16,true,35,8,-27,41.87811,-87.63184
638,3,16,true,21,24,3,41.87827,-87.64078
TA1305000005,3,16,true,28,4,-24,41.87924,-87.62975
13011,3,16,true,12,39,27,41.87931,-87.63993
TA1309000008,3,16,true,22,4,-18,41.87933,-87.6355
KA1503000034,3,16,true,10,2,-8,41.87938,-87.63197
KA1503000015,3,16,true,16,4,-12,41.87948,-87.6257
WL-011,3,16,true,10,3,-7,41.88034,-87.64273
13156,3,16,true,5,10,5,41.88042,-87.65554
13300,3,16,true,7,15,8,41.88097,-87.61675
13008,3,16,true,12,11,-1,41.88105,-87.62408
TA1305000006,3,16,true,51,9,-42,41.88122,-87.6296
13056,3,16,true,25,6,-19,41.88168,-87.63951
TA1307000120,3,16,true,18,22,4,41.88188,-87.64879
13341,3,16,true,28,15,-13,41.88208,-87.63985
13036,3,16,true,16,10,-6,41.8821,-87.62513
TA1305000032,3,16,true,37,50,13,41.88218,-87.64109
13006,3,16,true,17,11,-6,41.88268,-87.63252
13353,3,16,true,9,18,9,41.88283,-87.6612
654,3,16,true,2,6,4,41.88307,-87.65698
13409,3,16,true,11,10,-1,41.8831,-87.6511
KA1503000072,3,16,true,15,5,-10,41.88317,-87.63693
WL-012,3,16,true,17,45,28,41.88337,-87.6412
13053,3,16,true,8,10,2,41.88365,-87.64863
13001,3,16,true,26,16,-10,41.88397,-87.62459
18062,3,16,true,7,12,5,41.88412,-87.65427
TA1306000010,3,16,true,33,10,-23,41.88419,-87.62961
TA1305000030,3,16,true,32,9,-23,41.88459,-87.63178
15535,3,16,true,11,12,1,41.8846,-87.64455
TA1305000029,3,16,true,13,19,6,41.88466,-87.62787
13263,3,16,true,19,11,-8,41.88467,-87.61952
TA1306000015,3,16,true,21,12,-9,41.88549,-87.65232
13021,3,16,true,21,15,-6,41.88559,-87.64184
TA1307000111,3,16,true,34,8,-26,41.88582,-87.63548
KA1503000012,3,16,true,25,9,-16,41.88599,-87.63089
TA1305000011,3,16,true,26,5,-21,41.886,-87.62418
15534,3,16,true,9,11,2,41.88627,-87.61749
13197,3,16,true,6,4,-2,41.8866,-87.65816
TA1308000029,3,16,true,11,7,-4,41.88673,-87.62225
TA1307000131,3,16,true,8,4,-4,41.88688,-87.62606
KA1503000064,3,16,true,11,23,12,41.88697,-87.61281
TA1305000022,3,16,true,22,21,-1,41.88817,-87.63656
TA1306000003,3,16,true,18,25,7,41.88867,-87.64442
KA1503000043,3,16,true,29,40,11,41.88918,-87.63851
13050,3,16,true,34,17,-17,41.88919,-87.62775
13432,3,16,true,5,10,5,41.88989,-87.67149
TA1307000151,3,16,true,22,13,-9,41.88993,-87.63427
636,3,16,true,6,6,0,41.88997,-87.63662
KA1503000044,3,16,true,18,3,-15,41.89018,-87.6262
13427,3,16,true,2,6,4,41.89054,-87.62205
13430,3,16,true,12,16,4,41.89077,-87.63169
TA1306000013,3,16,true,22,19,-3,41.89083,-87.61852
RN-,3,16,true,14,10,-4,41.89102,-87.63546
13434,3,16,true,4,6,2,41.89108,-87.66663
TA1308000006,3,16,true,5,4,-1,41.89128,-87.67686
TA1307000117,3,16,true,23,12,-11,41.89144,-87.62675
13033,3,16,true,21,24,3,41.8916,-87.64835
13194,3,16,true,10,9,-1,41.8918,-87.65878
TA1305000003,3,16,true,20,8,-12,41.89187,-87.62061
13022,3,16,true,24,21,-3,41.89227,-87.61205
TA1306000029,3,16,true,19,7,-12,41.89256,-87.61449
13265,3,16,true,22,16,-6,41.89383,-87.64172
13045,3,16,true,20,19,-1,41.89403,-87.62931
13016,3,16,true,69,14,-55,41.89431,-87.62277
KA1503000041,3,16,true,32,13,-19,41.89452,-87.61798
13196,3,16,true,9,4,-5,41.89455,-87.65345
TA1307000062,3,16,true,16,8,-8,41.89466,-87.63839
TA1306000012,3,16,true,27,30,3,41.89475,-87.63438
KP1705001026,3,16,true,10,5,-5,41.89483,-87.6323
637,3,16,true,8,6,-2,41.89563,-87.67209
13132,3,16,true,9,3,-6,41.89573,-87.67718
15530,3,16,true,27,10,-17,41.89575,-87.62596
18003,3,16,true,10,3,-7,41.89575,-87.62011
13247,3,16,true,2,9,7,41.89597,-87.66775
TA1305000020,3,16,true,7,5,-2,41.89636,-87.65406
13289,3,16,true,6,8,2,41.89638,-87.661
13303,3,16,true,5,15,10,41.89672,-87.63088
13017,3,16,true,14,10,-4,41.89676,-87.6357
13338,3,16,true,21,6,-15,41.89697,-87.62173
TA1307000061,3,16,true,5,7,2,41.89745,-87.62873
13034,3,16,true,18,6,-12,41.89754,-87.62352
TA1306000009,3,16,true,45,6,-39,41.89772,-87.64299
620,3,16,true,6,8,2,41.89817,-87.63754
KA1504000103,3,16,true,2,7,5,41.89842,-87.68659
15529,3,16,true,32,12,-20,41.89858,-87.62206
TA1307000128,3,16,true,27,18,-9,41.89896,-87.6299
657,3,16,true,4,6,2,41.89918,-87.6722
TA1306000011,3,16,true,8,10,2,41.89994,-87.63443
KA1504000116,3,16,true,11,15,4,41.90023,-87.64299
13290,3,16,true,6,7,1,41.90069,-87.66259
13042,3,16,true,24,19,-5,41.90097,-87.62377
TA1307000070,3,16,true,3,5,2,41.90133,-87.67742
KA1504000133,3,16,true,14,9,-5,41.90234,-87.62773
TA1307000039,3,16,true,23,31,8,41.90294,-87.63137
658,3,16,true,6,2,-4,41.903,-87.6838
TA1305000034,3,16,true,6,10,4,41.90313,-87.67391
KA1504000135,3,16,true,17,30,13,41.90319,-87.63439
13136,3,16,true,3,6,3,41.90326,-87.67845
13061,3,16,true,16,18,2,41.90342,-87.66779
KA1504000079,3,16,true,16,13,-3,41.9035,-87.64334
TA1307000115,3,16,true,5,7,2,41.9046,-87.64056
TA1308000049,3,16,true,7,11,4,41.90672,-87.6349
KA1504000134,3,16,true,5,14,9,41.90687,-87.6262
13224,3,16,true,8,5,-3,41.90706,-87.66725
18069,3,16,true,6,3,-3,41.90722,-87.65563
TA1307000143,3,16,true,5,9,4,41.90762,-87.63854
13221,3,16,true,5,11,6,41.90765,-87.67254
TA1309000024,3,16,true,12,18,6,41.908,-87.63152
TA1305000041,3,16,true,14,13,-1,41.9094,-87.67769
331,3,16,true,14,15,1,41.90965,-87.64812
TA1305000037,3,16,true,7,8,1,41.91018,-87.67003
TA1306000008,3,16,true,5,6,1,41.9102,-87.6435
TA1308000005,3,16,true,4,5,1,41.91042,-87.68238
13258,3,16,true,1,7,6,41.91043,-87.69718
13154,3,16,true,14,12,-2,41.91054,-87.65312
13058,3,16,true,8,9,1,41.91059,-87.64942
TA1307000038,3,16,true,10,10,0,41.91138,-87.63868
LF-005,3,16,true,25,19,-6,41.91172,-87.62681
13128,3,16,true,10,9,-1,41.91197,-87.63197
TA1308000050,3,16,true,23,35,12,41.91211,-87.6347
13243,3,16,true,8,8,0,41.91262,-87.6814
TA1306000032,3,16,true,11,16,5,41.9137,-87.65285
TA1307000166,3,16,true,9,10,1,41.91386,-87.64877
15655,3,16,true,4,7,3,41.91401,-87.70514
TA1306000007,3,16,true,3,5,2,41.91469,-87.64333
13068,3,16,true,15,6,-9,41.91554,-87.68703
13179,3,16,true,17,11,-6,41.9157,-87.63461
13133,3,16,true,8,9,1,41.91598,-87.67733
TA1305000039,3,16,true,7,11,4,41.9163,-87.66749
15651,3,16,true,3,7,4,41.91752,-87.70181
TA1309000006,3,16,true,4,6,2,41.91809,-87.64375
TA1307000163,3,16,true,5,10,5,41.91821,-87.65696
13146,3,16,true,13,19,6,41.91831,-87.63629
13059,3,16,true,13,20,7,41.91845,-87.65222
13192,3,16,true,6,18,12,41.91995,-87.64884
13288,3,16,true,3,6,3,41.92008,-87.67788
13242,3,16,true,6,2,-4,41.92021,-87.69266
TA1309000030,3,16,true,12,10,-2,41.92077,-87.66372
TA1309000033,3,16,true,16,13,-3,41.92158,-87.65381
13193,3,16,true,9,18,9,41.92182,-87.64412
13191,3,16,true,10,11,1,41.92217,-87.63891
13084,3,16,true,3,8,5,41.92268,-87.69715
LP-,3,16,true,10,13,3,41.92396,-87.63584
KA1504000140,3,16,true,6,2,-4,41.92409,-87.67646
TA1307000001,3,16,true,10,14,4,41.92535,-87.66581
TA1306000026,3,16,true,9,4,-5,41.92558,-87.65842
TA1306000016,3,16,true,15,10,-5,41.9256,-87.65371
TA1309000019,3,16,true,20,17,-3,41.92586,-87.63897
TA1309000058,3,16,true,7,13,6,41.92591,-87.64927
TA1308000001,3,16,true,16,14,-2,41.92627,-87.63086
15646,3,16,true,5,2,-3,41.92668,-87.6977
TA1309000023,3,16,true,8,8,0,41.9287,-87.65383
TA1307000113,3,16,true,7,3,-4,41.92878,-87.66391
13296,3,16,true,7,7,0,41.92883,-87.66852
TA1309000059,3,16,true,5,7,2,41.92889,-87.65898
TA1309000061,3,16,true,11,8,-3,41.92915,-87.64909
TA1305000014,3,16,true,13,13,0,41.92956,-87.64313
13085,3,16,true,2,9,7,41.92958,-87.70789
TA1307000142,3,16,true,9,14,5,41.93125,-87.64432
13276,3,16,true,15,16,1,41.93132,-87.63874
13271,3,16,true,6,8,2,41.93192,-87.67784
TA1307000064,3,16,true,10,11,1,41.93222,-87.65864
TA1306000014,3,16,true,6,15,9,41.93242,-87.65271
TA1309000039,3,16,true,15,17,2,41.93258,-87.63642
13294,3,16,true,6,7,1,41.9326,-87.66595
TA1309000036,3,16,true,5,7,2,41.93313,-87.64776
TA1307000006,3,16,true,6,5,-1,41.93571,-87.6636
13269,3,16,true,4,7,3,41.93609,-87.66983
TA1307000052,3,16,true,16,10,-6,41.93628,-87.65266
TA1307000136,3,16,true,11,14,3,41.9365,-87.64755
TA1307000041,3,16,true,9,12,3,41.93669,-87.63683
13137,3,16,true,10,17,7,41.9376,-87.6441
TA1309000042,3,16,true,8,9,1,41.93937,-87.66836
TA1308000019,3,16,true,6,9,3,41.93973,-87.65886
13277,3,16,true,5,11,6,41.9401,-87.64546
TA1307000134,3,16,true,15,16,1,41.94016,-87.65303
TA1309000049,3,16,true,13,13,0,41.94077,-87.63919
TA1307000138,3,16,true,9,8,-1,41.94334,-87.67094
13144,3,16,true,6,5,-1,41.9434,-87.67964
TA1309000025,3,16,true,12,6,-6,41.94368,-87.64894
13071,3,16,true,20,12,-8,41.94373,-87.66401
632,3,16,true,7,11,4,41.94453,-87.6547
13278,3,16,true,12,22,10,41.94553,-87.64644
13235,3,16,true,12,11,-1,41.94814,-87.66396
13325,3,16,true,17,16,-1,41.94907,-87.64863
TA1307000126,3,16,true,14,6,-8,41.94936,-87.65451
TA1307000150,3,16,true,16,17,1,41.94945,-87.64646
13319,3,16,true,7,1,-6,41.95069,-87.6687
TA1307000127,3,16,true,12,7,-5,41.9508,-87.65918
13323,3,16,true,10,10,0,41.95282,-87.65
TA1309000043,3,16,true,1,7,6,41.95417,-87.66434
13063,3,16,true,11,9,-2,41.95424,-87.65441
TA1308000022,3,16,true,7,6,-1,41.95438,-87.64805
TA1307000149,3,16,true,9,5,-4,41.95467,-87.67392
TA1309000026,3,16,true,8,8,0,41.95601,-87.6802
13379,3,16,true,8,11,3,41.95786,-87.6495
TA1309000027,3,16,true,8,4,-4,41.9585,-87.65499
13389,3,16,true,7,6,-1,41.961,-87.64958
TA1307000144,3,16,true,6,2,-4,41.96142,-87.6762
15623,3,16,true,3,5,2,41.96154,-87.69117
KA1503000022,3,16,true,5,8,3,41.96158,-87.66609
TA1307000107,3,16,true,7,6,-1,41.96164,-87.65464
TA1309000012,3,16,true,6,7,1,41.96325,-87.67928
TA1308000012,3,16,true,6,11,5,41.96398,-87.63818
13074,3,16,true,11,12,1,41.96521,-87.6582
639,3,16,true,6,7,1,41.96584,-87.64538
TA1307000140,3,16,true,2,8,6,41.96643,-87.68865
TA1309000014,3,16,true,15,6,-9,41.96709,-87.66744
TA1307000158,3,16,true,10,3,-7,41.9671,-87.67904
TA1309000066,3,16,true,15,6,-9,41.9691,-87.67423
TA1309000041,3,16,true,5,5,0,41.96951,-87.65471
KA1504000171,3,16,true,5,2,-3,41.97161,-87.65016
TA1309000035,3,16,true,10,4,-6,41.97335,-87.66785
13108,3,16,true,12,6,-6,41.97379,-87.65971
13109,3,16,true,5,4,-1,41.97835,-87.65976
KA1504000151,3,16,true,6,4,-2,41.98359,-87.66916
KA1504000152,3,16,true,9,13,4,41.98403,-87.65231
15578,3,16,true,4,6,2,41.98405,-87.66027
15571,3,16,true,5,9,4,41.99478,-87.66028
RP-009,3,16,true,6,1,-5,42.00107,-87.66122
RP-008,3,16,true,1,5,4,42.00446,-87.6724
E002,3,16,true,3,6,3,42.03256,-87.67912
596,3,16,true,4,6,2,42.04822,-87.68348
KA1503000029,3,17,false,5,1,-4,41.77364,-87.56747
15491,3,17,false,10,5,-5,41.78096,-87.57624
KA1503000014,3,17,false,2,6,4,41.7851,-87.60108
KA1503000074,3,17,false,5,5,0,41.79174,-87.58395
TA1308000009,3,17,false,14,9,-5,41.79522,-87.58075
KA1503000059,3,17,false,8,5,-3,41.79952,-87.58643
TA1309000037,3,17,false,7,4,-3,41.79957,-87.59474
KA1503000007,3,17,false,1,5,4,41.80242,-87.58689
13398,3,17,false,5,2,-3,41.80256,-87.59035
TA1308000038,3,17,false,8,3,-5,41.82298,-87.6071
13420,3,17,false,5,1,-4,41.82459,-87.61678
KA1503000004,3,17,false,2,6,4,41.83127,-87.6088
TA1309000055,3,17,false,8,2,-6,41.8382,-87.64514
TA1307000048,3,17,false,30,11,-19,41.83855,-87.60821
TA1305000001,3,17,false,4,6,2,41.85262,-87.6265
13075,3,17,false,5,6,1,41.8531,-87.63192
15545,3,17,false,12,18,6,41.85627,-87.61334
13135,3,17,false,6,7,1,41.85753,-87.66157
13102,3,17,false,5,1,-4,41.85762,-87.61942
13150,3,17,false,9,4,-5,41.85783,-87.62455
13163,3,17,false,4,5,1,41.85808,-87.65108
13164,3,17,false,4,5,1,41.85818,-87.65648
TA1307000124,3,17,false,9,8,-1,41.86411,-87.62372
13029,3,17,false,9,6,-3,41.86531,-87.6179
13431,3,17,false,12,12,0,41.8661,-87.60728
TA1305000002,3,17,false,15,18,3,41.86721,-87.62597
15544,3,17,false,37,21,-16,41.86723,-87.61536
SL-005,3,17,false,35,26,-9,41.8679,-87.62304
TA1309000010,3,17,false,12,10,-2,41.87074,-87.62574
SL-009,3,17,false,6,10,4,41.87081,-87.63121
TA1309000064,3,17,false,6,2,-4,41.87127,-87.67369
SL-008,3,17,false,19,14,-5,41.87209,-87.62956
SL-011,3,17,false,12,12,0,41.87256,-87.63356
623,3,17,false,11,21,10,41.87272,-87.62399
SL-007,3,17,false,10,6,-4,41.87404,-87.6277
15541,3,17,false,34,25,-9,41.8758,-87.62086
TA1305000010,3,17,false,6,3,-3,41.87623,-87.62444
624,3,17,false,3,13,10,41.87626,-87.62923
TA1305000035,3,17,false,17,5,-12,41.87716,-87.62787
13138,3,17,false,7,2,-5,41.87723,-87.63941
15539,3,17,false,3,6,3,41.87763,-87.64405
13158,3,17,false,7,8,1,41.87764,-87.64957
13157,3,17,false,8,3,-5,41.87773,-87.6548
TA1305000025,3,17,false,37,16,-21,41.87773,-87.63528
TA1309000002,3,17,false,13,16,3,41.87784,-87.62408
13206,3,17,false,2,6,4,41.87794,-87.66201
TA1309000004,3,17,false,11,3,-8,41.87811,-87.63184
638,3,17,false,17,3,-14,41.87827,-87.64078
TA1305000005,3,17,false,5,5,0,41.87924,-87.62975
13011,3,17,false,16,8,-8,41.87931,-87.63993
TA1309000008,3,17,false,2,6,4,41.87933,-87.6355
KA1503000015,3,17,false,10,5,-5,41.87948,-87.6257
TA1309000007,3,17,false,23,1,-22,41.88022,-87.63526
WL-011,3,17,false,12,3,-9,41.88034,-87.64273
13156,3,17,false,9,4,-5,41.88042,-87.65554
13300,3,17,false,56,59,3,41.88097,-87.61675
13008,3,17,false,57,54,-3,41.88105,-87.62408
TA1305000006,3,17,false,9,11,2,41.88122,-87.6296
13056,3,17,false,11,2,-9,41.88168,-87.63951
TA1307000120,3,17,false,36,10,-26,41.88188,-87.64879
13341,3,17,false,23,8,-15,41.88208,-87.63985
13036,3,17,false,14,11,-3,41.8821,-87.62513
TA1305000032,3,17,false,14,13,-1,41.88218,-87.64109
13353,3,17,false,8,6,-2,41.88283,-87.6612
654,3,17,false,9,2,-7,41.88307,-87.65698
13409,3,17,false,7,6,-1,41.8831,-87.6511
WL-012,3,17,false,13,5,-8,41.88337,-87.6412
13053,3,17,false,14,15,1,41.88365,-87.64863
13001,3,17,false,22,24,2,41.88397,-87.62459
13155,3,17,false,3,5,2,41.88407,-87.65689
18062,3,17,false,11,1,-10,41.88412,-87.65427
TA1306000010,3,17,false,14,4,-10,41.88419,-87.62961
TA1305000030,3,17,false,39,8,-31,41.88459,-87.63178
15535,3,17,false,15,14,-1,41.8846,-87.64455
TA1305000029,3,17,false,25,9,-16,41.88466,-87.62787
13263,3,17,false,21,9,-12,41.88467,-87.61952
TA1306000015,3,17,false,12,24,12,41.88549,-87.65232
13021,3,17,false,14,11,-3,41.88559,-87.64184
TA1307000111,3,17,false,10,4,-6,41.88582,-87.63548
KA17018054,3,17,false,5,3,-2,41.88595,-87.67701
KA1503000012,3,17,false,30,10,-20,41.88599,-87.63089
TA1305000011,3,17,false,28,21,-7,41.886,-87.62418
15534,3,17,false,13,4,-9,41.88627,-87.61749
TA1308000029,3,17,false,6,5,-1,41.88673,-87.62225
TA1307000131,3,17,false,9,15,6,41.88688,-87.62606
KA1503000064,3,17,false,48,35,-13,41.88697,-87.61281
TA1305000022,3,17,false,33,7,-26,41.88817,-87.63656
TA1306000003,3,17,false,16,20,4,41.88867,-87.64442
KA1503000043,3,17,false,34,15,-19,41.88918,-87.63851
13050,3,17,false,23,13,-10,41.88919,-87.62775
13432,3,17,false,5,2,-3,41.88989,-87.67149
TA1307000151,3,17,false,30,5,-25,41.88993,-87.63427
636,3,17,false,3,5,2,41.88997,-87.63662
13427,3,17,false,6,8,2,41.89054,-87.62205
13430,3,17,false,28,20,-8,41.89077,-87.63169
TA1306000013,3,17,false,29,24,-5,41.89083,-87.61852
RN-,3,17,false,10,6,-4,41.89102,-87.63546
TA1308000006,3,17,false,6,9,3,41.89128,-87.67686
TA1307000117,3,17,false,27,34,7,41.89144,-87.62675
13033,3,17,false,17,12,-5,41.8916,-87.64835
13194,3,17,false,7,8,1,41.8918,-87.65878
TA1305000003,3,17,false,14,36,22,41.89187,-87.62061
13022,3,17,false,107,134,27,41.89227,-87.61205
TA1306000029,3,17,false,17,17,0,41.89256,-87.61449
13265,3,17,false,12,11,-1,41.89383,-87.64172
13045,3,17,false,30,24,-6,41.89403,-87.62931
13016,3,17,false,18,12,-6,41.89431,-87.62277
KA1503000041,3,17,false,3,7,4,41.89452,-87.61798
13196,3,17,false,13,2,-11,41.89455,-87.65345
TA1307000062,3,17,false,13,4,-9,41.89466,-87.63839
TA1306000012,3,17,false,25,21,-4,41.89475,-87.63438
KP1705001026,3,17,false,4,11,7,41.89483,-87.6323
637,3,17,false,3,5,2,41.89563,-87.67209
13132,3,17,false,16,15,-1,41.89573,-87.67718
15530,3,17,false,10,25,15,41.89575,-87.62596
13247,3,17,false,2,6,4,41.89597,-87.66775
TA1305000020,3,17,false,18,11,-7,41.89636,-87.65406
13289,3,17,false,6,9,3,41.89638,-87.661
13303,3,17,false,15,12,-3,41.89672,-87.63088
13017,3,17,false,16,8,-8,41.89676,-87.6357
13338,3,17,false,10,9,-1,41.89697,-87.62173
TA1307000061,3,17,false,11,7,-4,41.89745,-87.62873
13034,3,17,false,18,12,-6,41.89754,-87.62352
TA1306000009,3,17,false,17,6,-11,41.89772,-87.64299
620,3,17,false,12,8,-4,41.89817,-87.63754
15529,3,17,false,10,6,-4,41.89858,-87.62206
TA1307000128,3,17,false,24,15,-9,41.89896,-87.6299
657,3,17,false,7,3,-4,41.89918,-87.6722
13248,3,17,false,11,8,-3,41.89964,-87.66788
TA1306000011,3,17,false,12,6,-6,41.89994,-87.63443
13290,3,17,false,8,7,-1,41.90069,-87.66259
13042,3,17,false,41,51,10,41.90097,-87.62377
TA1307000070,3,17,false,7,6,-1,41.90133,-87.67742
KA1504000133,3,17,false,21,22,1,41.90234,-87.62773
13241,3,17,false,8,6,-2,41.9029,-87.68731
TA1306000006,3,17,false,3,5,2,41.90292,-87.63772
TA1307000039,3,17,false,19,37,18,41.90294,-87.63137
13256,3,17,false,3,5,2,41.90302,-87.69749
TA1305000034,3,17,false,14,13,-1,41.90313,-87.67391
KA1504000135,3,17,false,32,40,8,41.90319,-87.63439
13136,3,17,false,4,7,3,41.90326,-87.67845
13061,3,17,false,20,19,-1,41.90342,-87.66779
KA1504000079,3,17,false,9,12,3,41.9035,-87.64334
TA1307000115,3,17,false,5,6,1,41.9046,-87.64056
TA1308000049,3,17,false,24,28,4,41.90672,-87.6349
KA1504000134,3,17,false,15,15,0,41.90687,-87.6262
13224,3,17,false,7,6,-1,41.90706,-87.66725
TA1307000143,3,17,false,3,5,2,41.90762,-87.63854
13221,3,17,false,21,17,-4,41.90765,-87.67254
TA1309000024,3,17,false,24,15,-9,41.908,-87.63152
TA1305000041,3,17,false,13,18,5,41.9094,-87.67769
331,3,17,false,15,30,15,41.90965,-87.64812
TA1305000037,3,17,false,13,13,0,41.91018,-87.67003
TA1306000008,3,17,false,6,17,11,41.9102,-87.6435
TA1308000005,3,17,false,7,8,1,41.91042,-87.68238
13258,3,17,false,4,6,2,41.91043,-87.69718
13257,3,17,false,7,5,-2,41.91054,-87.68956
13154,3,17,false,11,13,2,41.91054,-87.65312
13058,3,17,false,9,13,4,41.91059,-87.64942
TA1307000038,3,17,false,13,10,-3,41.91138,-87.63868
LF-005,3,17,false,36,109,73,41.91172,-87.62681
13128,3,17,false,5,25,20,41.91197,-87.63197
TA1308000050,3,17,false,27,34,7,41.91211,-87.6347
13243,3,17,false,21,6,-15,41.91262,-87.6814
TA1306000032,3,17,false,10,12,2,41.9137,-87.65285
TA1307000166,3,17,false,7,5,-2,41.91386,-87.64877
18067,3,17,false,8,5,-3,41.9146,-87.66796
13068,3,17,false,10,7,-3,41.91554,-87.68703
13179,3,17,false,28,48,20,41.9157,-87.63461
13133,3,17,false,13,16,3,41.91598,-87.67733
TA1305000039,3,17,false,14,5,-9,41.9163,-87.66749
15650,3,17,false,1,8,7,41.91711,-87.71023
TA1309000029,3,17,false,7,2,-5,41.9178,-87.68245
TA1309000006,3,17,false,8,6,-2,41.91809,-87.64375
TA1307000163,3,17,false,5,4,-1,41.91821,-87.65696
13146,3,17,false,31,28,-3,41.91831,-87.63629
13059,3,17,false,29,18,-11,41.91845,-87.65222
13259,3,17,false,5,5,0,41.91852,-87.69744
13192,3,17,false,9,14,5,41.91995,-87.64884
TA1309000030,3,17,false,5,18,13,41.92077,-87.66372
TA1309000033,3,17,false,12,14,2,41.92158,-87.65381
13193,3,17,false,16,16,0,41.92182,-87.64412
13191,3,17,false,8,9,1,41.92217,-87.63891
13084,3,17,false,6,7,1,41.92268,-87.69715
LP-,3,17,false,29,10,-19,41.92396,-87.63584
KA1504000140,3,17,false,4,5,1,41.92409,-87.67646
TA1307000001,3,17,false,17,7,-10,41.92535,-87.66581
TA1306000026,3,17,false,17,10,-7,41.92558,-87.65842
TA1306000016,3,17,false,14,15,1,41.9256,-87.65371
TA1309000019,3,17,false,20,14,-6,41.92586,-87.63897
TA1309000058,3,17,false,27,26,-1,41.92591,-87.64927
TA1308000001,3,17,false,30,49,19,41.92627,-87.63086
13124,3,17,false,6,11,5,41.92675,-87.63444
TA1309000023,3,17,false,11,13,2,41.9287,-87.65383
TA1307000113,3,17,false,9,11,2,41.92878,-87.66391
13296,3,17,false,9,7,-2,41.92883,-87.66852
TA1309000059,3,17,false,9,8,-1,41.92889,-87.65898
TA1309000061,3,17,false,15,13,-2,41.92915,-87.64909
TA1308000031,3,17,false,4,9,5,41.92946,-87.68417
TA1305000014,3,17,false,25,25,0,41.92956,-87.64313
13085,3,17,false,9,14,5,41.92958,-87.70789
15643,3,17,false,5,2,-3,41.93057,-87.7238
TA1307000142,3,17,false,32,23,-9,41.93125,-87.64432
13276,3,17,false,16,17,1,41.93132,-87.63874
13271,3,17,false,13,2,-11,41.93192,-87.67784
TA1307000064,3,17,false,8,11,3,41.93222,-87.65864
TA1306000014,3,17,false,12,8,-4,41.93242,-87.65271
TA1309000039,3,17,false,22,27,5,41.93258,-87.63642
13294,3,17,false,14,3,-11,41.9326,-87.66595
TA1309000036,3,17,false,11,10,-1,41.93313,-87.64776
TA1307000006,3,17,false,10,6,-4,41.93571,-87.6636
TA1307000052,3,17,false,17,11,-6,41.93628,-87.65266
TA1307000136,3,17,false,16,7,-9,41.9365,-87.64755
TA1307000041,3,17,false,22,29,7,41.93669,-87.63683
13137,3,17,false,32,21,-11,41.9376,-87.6441
KA17018068,3,17,false,1,5,4,41.93935,-87.68327
TA1309000042,3,17,false,13,5,-8,41.93937,-87.66836
13229,3,17,false,10,5,-5,41.93946,-87.66376
TA1308000019,3,17,false,14,8,-6,41.93973,-87.65886
13277,3,17,false,18,11,-7,41.9401,-87.64546
TA1307000134,3,17,false,30,19,-11,41.94016,-87.65303
TA1309000049,3,17,false,26,23,-3,41.94077,-87.63919
TA1307000138,3,17,false,12,7,-5,41.94334,-87.67094
13144,3,17,false,5,1,-4,41.9434,-87.67964
TA1309000025,3,17,false,21,11,-10,41.94368,-87.64894
13071,3,17,false,20,10,-10,41.94373,-87.66401
632,3,17,false,21,9,-12,41.94453,-87.6547
13278,3,17,false,19,10,-9,41.94553,-87.64644
13235,3,17,false,7,10,3,41.94814,-87.66396
13325,3,17,false,7,13,6,41.94907,-87.64863
TA1307000126,3,17,false,26,9,-17,41.94936,-87.65451
TA1307000150,3,17,false,23,13,-10,41.94945,-87.64646
13319,3,17,false,6,6,0,41.95069,-87.6687
TA1307000127,3,17,false,12,11,-1,41.9508,-87.65918
13323,3,17,false,11,6,-5,41.95282,-87.65
KA1504000139,3,17,false,1,5,4,41.954,-87.71909
13063,3,17,false,4,7,3,41.95424,-87.65441
TA1308000022,3,17,false,6,7,1,41.95438,-87.64805
TA1307000149,3,17,false,3,5,2,41.95467,-87.67392
TA1309000026,3,17,false,6,4,-2,41.95601,-87.6802
13379,3,17,false,13,9,-4,41.95786,-87.6495
TA1309000027,3,17,false,5,8,3,41.9585,-87.65499
13389,3,17,false,8,6,-2,41.961,-87.64958
TA1307000144,3,17,false,8,2,-6,41.96142,-87.6762
TA1307000107,3,17,false,10,12,2,41.96164,-87.65464
TA1308000012,3,17,false,19,38,19,41.96398,-87.63818
639,3,17,false,3,9,6,41.96584,-87.64538
TA1309000014,3,17,false,4,5,1,41.96709,-87.66744
TA1307000119,3,17,false,5,3,-2,41.96796,-87.65
TA1308000021,3,17,false,7,3,-4,41.96883,-87.65765
TA1309000066,3,17,false,9,5,-4,41.9691,-87.67423
TA1309000041,3,17,false,7,1,-6,41.96951,-87.65471
KA1504000171,3,17,false,5,7,2,41.97161,-87.65016
TA1309000035,3,17,false,6,6,0,41.97335,-87.66785
13108,3,17,false,7,6,-1,41.97379,-87.65971
KA1504000146,3,17,false,6,8,2,41.978,-87.66805
KA1504000151,3,17,false,3,5,2,41.98359,-87.66916
KA1504000152,3,17,false,16,11,-5,41.98403,-87.65231
15575,3,17,false,5,6,1,41.98975,-87.66014
15571,3,17,false,5,5,0,41.99478,-87.66028
RP-001,3,17,false,6,2,-4,42.00179,-87.68883
596,3,17,false,10,6,-4,42.04822,-87.68348
E008,3,17,false,5,3,-2,42.05049,-87.67782
605,3,17,false,2,7,5,42.05294,-87.67342
KA1503000014,3,17,true,8,5,-3,41.7851,-87.60108
TA1309000011,3,17,true,12,2,-10,41.78873,-87.60131
KA1503000071,3,17,true,6,6,0,41.79148,-87.59988
TA1309000063,3,17,true,5,8,3,41.79325,-87.5878
TA1308000009,3,17,true,13,18,5,41.79522,-87.58075
KA1503000059,3,17,true,8,3,-5,41.79952,-87.58643
TA1309000037,3,17,true,9,13,4,41.79957,-87.59474
KA1503000007,3,17,true,7,8,1,41.80242,-87.58689
13398,3,17,true,2,6,4,41.80256,-87.59035
TA1307000129,3,17,true,8,1,-7,41.83104,-87.62683
KA1503000004,3,17,true,3,6,3,41.83127,-87.6088
15445,3,17,true,2,6,4,41.83453,-87.63183
13216,3,17,true,15,7,-8,41.83473,-87.62581
13217,3,17,true,5,9,4,41.83488,-87.61792
13215,3,17,true,5,6,1,41.83634,-87.6135
TA1309000055,3,17,true,4,8,4,41.8382,-87.64514
KA1503000038,3,17,true,5,2,-3,41.83845,-87.6354
TA1307000048,3,17,true,7,6,-1,41.83855,-87.60821
TA1308000036,3,17,true,4,10,6,41.83883,-87.62186
TA1307000139,3,17,true,10,1,-9,41.84205,-87.61698
TA1307000153,3,17,true,6,9,3,41.84358,-87.64538
TA1307000005,3,17,true,5,1,-4,41.84569,-87.6225
TA1305000001,3,17,true,1,8,7,41.85262,-87.6265
13075,3,17,true,10,6,-4,41.8531,-87.63192
15546,3,17,true,1,6,5,41.85416,-87.61916
15545,3,17,true,16,21,5,41.85627,-87.61334
SL-013,3,17,true,8,6,-2,41.85659,-87.62755
13135,3,17,true,9,11,2,41.85753,-87.66157
13102,3,17,true,10,13,3,41.85762,-87.61942
13150,3,17,true,10,15,5,41.85783,-87.62455
13099,3,17,true,9,4,-5,41.85784,-87.64627
TA1307000159,3,17,true,1,9,8,41.8579,-87.6687
TA1307000044,3,17,true,9,3,-6,41.85794,-87.64083
13164,3,17,true,7,13,6,41.85818,-87.65648
SL-012,3,17,true,9,7,-2,41.86038,-87.62581
13304,3,17,true,4,5,1,41.86126,-87.65659
TA1306000002,3,17,true,2,8,6,41.86238,-87.65108
TA1307000124,3,17,true,15,29,14,41.86411,-87.62372
TA1309000001,3,17,true,6,6,0,41.86488,-87.64708
13165,3,17,true,2,5,3,41.86505,-87.65697
13354,3,17,true,4,9,5,41.86524,-87.66651
13431,3,17,true,7,13,6,41.8661,-87.60728
WL-008,3,17,true,3,9,6,41.86712,-87.64108
TA1305000002,3,17,true,23,47,24,41.86721,-87.62597
15544,3,17,true,10,16,6,41.86723,-87.61536
TA1305000017,3,17,true,9,5,-4,41.86734,-87.64863
KA1706005007,3,17,true,7,7,0,41.86749,-87.63219
SL-005,3,17,true,33,30,-3,41.8679,-87.62304
13139,3,17,true,10,6,-4,41.86893,-87.65913
13285,3,17,true,24,5,-19,41.86928,-87.67372
13160,3,17,true,14,20,6,41.86947,-87.65548
15550,3,17,true,6,9,3,41.87024,-87.63947
TA1309000010,3,17,true,9,25,16,41.87074,-87.62574
SL-009,3,17,true,6,9,3,41.87081,-87.63121
TA1309000064,3,17,true,30,8,-22,41.87127,-87.67369
15542,3,17,true,6,1,-5,41.87146,-87.64095
TA1307000130,3,17,true,12,12,0,41.87178,-87.65103
TA1307000121,3,17,true,11,12,1,41.87184,-87.64664
SL-008,3,17,true,26,38,12,41.87209,-87.62956
13332,3,17,true,25,24,-1,41.87219,-87.6615
SL-011,3,17,true,12,15,3,41.87256,-87.63356
623,3,17,true,16,22,6,41.87272,-87.62399
KA1504000104,3,17,true,12,4,-8,41.87296,-87.66912
SL-007,3,17,true,3,8,5,41.87404,-87.6277
13326,3,17,true,8,1,-7,41.87425,-87.63958
TA1306000025,3,17,true,5,3,-2,41.87464,-87.65703
13028,3,17,true,7,8,1,41.87475,-87.64981
SL-010,3,17,true,8,12,4,41.87501,-87.63309
15541,3,17,true,4,9,5,41.8758,-87.62086
13037,3,17,true,8,2,-6,41.87588,-87.64078
TA1305000009,3,17,true,12,5,-7,41.87593,-87.63068
624,3,17,true,18,9,-9,41.87626,-87.62923
TA1305000035,3,17,true,24,5,-19,41.87716,-87.62787
13138,3,17,true,22,8,-14,41.87723,-87.63941
15539,3,17,true,14,11,-3,41.87763,-87.64405
13158,3,17,true,19,35,16,41.87764,-87.64957
13157,3,17,true,11,19,8,41.87773,-87.6548
TA1305000025,3,17,true,26,11,-15,41.87773,-87.63528
TA1309000002,3,17,true,10,7,-3,41.87784,-87.62408
13206,3,17,true,13,13,0,41.87794,-87.66201
TA1309000004,3,17,true,39,4,-35,41.87811,-87.63184
638,3,17,true,42,23,-19,41.87827,-87.64078
TA1305000005,3,17,true,29,4,-25,41.87924,-87.62975
13011,3,17,true,44,38,-6,41.87931,-87.63993
TA1309000008,3,17,true,8,1,-7,41.87933,-87.6355
KA1503000034,3,17,true,15,2,-13,41.87938,-87.63197
KA1503000015,3,17,true,17,8,-9,41.87948,-87.6257
TA1309000007,3,17,true,55,4,-51,41.88022,-87.63526
WL-011,3,17,true,20,7,-13,41.88034,-87.64273
13156,3,17,true,18,27,9,41.88042,-87.65554
13300,3,17,true,27,43,16,41.88097,-87.61675
13008,3,17,true,28,11,-17,41.88105,-87.62408
TA1305000006,3,17,true,43,11,-32,41.88122,-87.6296
13134,3,17,true,5,3,-2,41.88138,-87.67493
13056,3,17,true,26,17,-9,41.88168,-87.63951
TA1307000120,3,17,true,25,33,8,41.88188,-87.64879
13341,3,17,true,45,25,-20,41.88208,-87.63985
13036,3,17,true,16,12,-4,41.8821,-87.62513
TA1305000032,3,17,true,44,37,-7,41.88218,-87.64109
13006,3,17,true,14,6,-8,41.88268,-87.63252
13353,3,17,true,8,14,6,41.88283,-87.6612
654,3,17,true,11,14,3,41.88307,-87.65698
13409,3,17,true,11,22,11,41.8831,-87.6511
KA1503000072,3,17,true,22,10,-12,41.88317,-87.63693
WL-012,3,17,true,42,30,-12,41.88337,-87.6412
13053,3,17,true,29,28,-1,41.88365,-87.64863
13001,3,17,true,43,15,-28,41.88397,-87.62459
13155,3,17,true,12,12,0,41.88407,-87.65689
18062,3,17,true,18,19,1,41.88412,-87.65427
TA1306000010,3,17,true,67,18,-49,41.88419,-87.62961
TA1305000030,3,17,true,65,6,-59,41.88459,-87.63178
15535,3,17,true,15,17,2,41.8846,-87.64455
TA1305000029,3,17,true,17,15,-2,41.88466,-87.62787
13263,3,17,true,18,25,7,41.88467,-87.61952
TA1306000015,3,17,true,23,25,2,41.88549,-87.65232
13021,3,17,true,48,26,-22,41.88559,-87.64184
TA1307000111,3,17,true,36,3,-33,41.88582,-87.63548
13073,3,17,true,6,8,2,41.88592,-87.66717
KA17018054,3,17,true,6,3,-3,41.88595,-87.67701
KA1503000012,3,17,true,33,16,-17,41.88599,-87.63089
TA1305000011,3,17,true,40,14,-26,41.886,-87.62418
15534,3,17,true,13,14,1,41.88627,-87.61749
13197,3,17,true,5,13,8,41.8866,-87.65816
TA1308000029,3,17,true,9,7,-2,41.88673,-87.62225
TA1307000131,3,17,true,19,10,-9,41.88688,-87.62606
KA1503000064,3,17,true,11,52,41,41.88697,-87.61281
TA1305000022,3,17,true,70,19,-51,41.88817,-87.63656
TA1306000003,3,17,true,33,41,8,41.88867,-87.64442
KA1503000043,3,17,true,60,65,5,41.88918,-87.63851
13050,3,17,true,35,18,-17,41.88919,-87.62775
15664,3,17,true,4,5,1,41.8895,-87.68821
13432,3,17,true,12,4,-8,41.88989,-87.67149
TA1307000151,3,17,true,52,31,-21,41.88993,-87.63427
636,3,17,true,23,11,-12,41.88997,-87.63662
KA1503000044,3,17,true,13,10,-3,41.89018,-87.6262
13427,3,17,true,19,7,-12,41.89054,-87.62205
13430,3,17,true,36,25,-11,41.89077,-87.63169
TA1306000013,3,17,true,20,26,6,41.89083,-87.61852
RN-,3,17,true,19,21,2,41.89102,-87.63546
13434,3,17,true,6,8,2,41.89108,-87.66663
TA1308000006,3,17,true,8,7,-1,41.89128,-87.67686
TA1307000117,3,17,true,39,26,-13,41.89144,-87.62675
13033,3,17,true,27,21,-6,41.8916,-87.64835
13194,3,17,true,12,22,10,41.8918,-87.65878
TA1305000003,3,17,true,23,20,-3,41.89187,-87.62061
13022,3,17,true,44,44,0,41.89227,-87.61205
TA1306000029,3,17,true,25,23,-2,41.89256,-87.61449
13265,3,17,true,38,34,-4,41.89383,-87.64172
13045,3,17,true,39,40,1,41.89403,-87.62931
13016,3,17,true,59,16,-43,41.89431,-87.62277
KA1503000041,3,17,true,18,11,-7,41.89452,-87.61798
13196,3,17,true,9,16,7,41.89455,-87.65345
TA1307000062,3,17,true,26,12,-14,41.89466,-87.63839
TA1306000012,3,17,true,34,35,1,41.89475,-87.63438
KP1705001026,3,17,true,27,15,-12,41.89483,-87.6323
637,3,17,true,1,7,6,41.89563,-87.67209
13132,3,17,true,13,21,8,41.89573,-87.67718
15530,3,17,true,34,24,-10,41.89575,-87.62596
18003,3,17,true,9,11,2,41.89575,-87.62011
13247,3,17,true,5,20,15,41.89597,-87.66775
TA1305000020,3,17,true,11,14,3,41.89636,-87.65406
13289,3,17,true,12,24,12,41.89638,-87.661
13303,3,17,true,14,9,-5,41.89672,-87.63088
13017,3,17,true,25,16,-9,41.89676,-87.6357
13338,3,17,true,16,10,-6,41.89697,-87.62173
TA1307000061,3,17,true,14,16,2,41.89745,-87.62873
13034,3,17,true,17,12,-5,41.89754,-87.62352
TA1306000009,3,17,true,46,14,-32,41.89772,-87.64299
620,3,17,true,15,20,5,41.89817,-87.63754
KA1504000103,3,17,true,8,10,2,41.89842,-87.68659
15529,3,17,true,24,16,-8,41.89858,-87.62206
TA1307000128,3,17,true,39,44,5,41.89896,-87.6299
657,3,17,true,6,18,12,41.89918,-87.6722
13248,3,17,true,7,16,9,41.89964,-87.66788
TA1306000011,3,17,true,11,9,-2,41.89994,-87.63443
KA1504000116,3,17,true,22,15,-7,41.90023,-87.64299
17660,3,17,true,10,13,3,41.90036,-87.69671
13290,3,17,true,12,18,6,41.90069,-87.66259
13042,3,17,true,44,21,-23,41.90097,-87.62377
TA1307000070,3,17,true,11,20,9,41.90133,-87.67742
KA1504000133,3,17,true,20,19,-1,41.90234,-87.62773
13241,3,17,true,9,5,-4,41.9029,-87.68731
TA1306000006,3,17,true,2,6,4,41.90292,-87.63772
TA1307000039,3,17,true,32,70,38,41.90294,-87.63137
658,3,17,true,14,6,-8,41.903,-87.6838
13256,3,17,true,8,2,-6,41.90302,-87.69749
TA1305000034,3,17,true,12,11,-1,41.90313,-87.67391
KA1504000135,3,17,true,35,42,7,41.90319,-87.63439
13136,3,17,true,12,13,1,41.90326,-87.67845
13061,3,17,true,39,18,-21,41.90342,-87.66779
KA1504000079,3,17,true,8,17,9,41.9035,-87.64334
TA1307000115,3,17,true,19,8,-11,41.9046,-87.64056
TA1308000049,3,17,true,23,42,19,41.90672,-87.6349
KA1504000134,3,17,true,15,29,14,41.90687,-87.6262
13224,3,17,true,13,11,-2,41.90706,-87.66725
18069,3,17,true,12,1,-11,41.90722,-87.65563
TA1307000143,3,17,true,2,14,12,41.90762,-87.63854
13221,3,17,true,18,17,-1,41.90765,-87.67254
TA1309000024,3,17,true,17,35,18,41.908,-87.63152
TA1305000041,3,17,true,19,25,6,41.9094,-87.67769
331,3,17,true,23,28,5,41.90965,-87.64812
TA1305000037,3,17,true,5,11,6,41.91018,-87.67003
TA1306000008,3,17,true,13,3,-10,41.9102,-87.6435
TA1308000005,3,17,true,7,8,1,41.91042,-87.68238
13257,3,17,true,6,10,4,41.91054,-87.68956
13154,3,17,true,22,32,10,41.91054,-87.65312
13058,3,17,true,21,20,-1,41.91059,-87.64942
TA1307000038,3,17,true,19,18,-1,41.91138,-87.63868
LF-005,3,17,true,23,86,63,41.91172,-87.62681
13128,3,17,true,8,27,19,41.91197,-87.63197
TA1308000050,3,17,true,41,50,9,41.91211,-87.6347
13243,3,17,true,17,20,3,41.91262,-87.6814
TA1309000032,3,17,true,3,5,2,41.91293,-87.66417
TA1306000032,3,17,true,21,19,-2,41.9137,-87.65285
TA1307000166,3,17,true,12,11,-1,41.91386,-87.64877
18067,3,17,true,7,11,4,41.9146,-87.66796
TA1306000007,3,17,true,6,9,3,41.91469,-87.64333
13068,3,17,true,11,8,-3,41.91554,-87.68703
13179,3,17,true,36,58,22,41.9157,-87.63461
13133,3,17,true,6,25,19,41.91598,-87.67733
TA1305000039,3,17,true,16,14,-2,41.9163,-87.66749
15650,3,17,true,8,1,-7,41.91711,-87.71023
TA1309000029,3,17,true,4,7,3,41.9178,-87.68245
TA1309000006,3,17,true,10,13,3,41.91809,-87.64375
TA1307000163,3,17,true,15,8,-7,41.91821,-87.65696
13146,3,17,true,28,48,20,41.91831,-87.63629
13059,3,17,true,33,41,8,41.91845,-87.65222
13192,3,17,true,13,29,16,41.91995,-87.64884
13288,3,17,true,11,7,-4,41.92008,-87.67788
TA1309000030,3,17,true,13,17,4,41.92077,-87.66372
TA1309000033,3,17,true,22,15,-7,41.92158,-87.65381
13193,3,17,true,30,39,9,41.92182,-87.64412
13191,3,17,true,15,18,3,41.92217,-87.63891
13084,3,17,true,10,12,2,41.92268,-87.69715
LP-,3,17,true,17,12,-5,41.92396,-87.63584
15648,3,17,true,6,2,-4,41.92464,-87.68931
TA1307000001,3,17,true,22,14,-8,41.92535,-87.66581
TA1306000026,3,17,true,26,13,-13,41.92558,-87.65842
TA1306000016,3,17,true,32,21,-11,41.9256,-87.65371
TA1309000019,3,17,true,34,22,-12,41.92586,-87.63897
TA1309000058,3,17,true,27,29,2,41.92591,-87.64927
TA1308000001,3,17,true,36,48,12,41.92627,-87.63086
13124,3,17,true,9,9,0,41.92675,-87.63444
TA1309000023,3,17,true,22,27,5,41.9287,-87.65383
TA1307000113,3,17,true,6,18,12,41.92878,-87.66391
13296,3,17,true,9,4,-5,41.92883,-87.66852
TA1309000059,3,17,true,6,12,6,41.92889,-87.65898
TA1309000061,3,17,true,27,21,-6,41.92915,-87.64909
TA1308000031,3,17,true,2,9,7,41.92946,-87.68417
TA1305000014,3,17,true,27,29,2,41.92956,-87.64313
TA1307000142,3,17,true,29,33,4,41.93125,-87.64432
13276,3,17,true,19,25,6,41.93132,-87.63874
13271,3,17,true,9,6,-3,41.93192,-87.67784
TA1307000064,3,17,true,34,13,-21,41.93222,-87.65864
TA1306000014,3,17,true,21,24,3,41.93242,-87.65271
TA1309000039,3,17,true,23,33,10,41.93258,-87.63642
13294,3,17,true,5,10,5,41.9326,-87.66595
TA1309000036,3,17,true,18,23,5,41.93313,-87.64776
TA1307000006,3,17,true,6,14,8,41.93571,-87.6636
13268,3,17,true,9,11,2,41.93588,-87.67843
13269,3,17,true,7,7,0,41.93609,-87.66983
TA1307000052,3,17,true,25,16,-9,41.93628,-87.65266
TA1307000136,3,17,true,22,29,7,41.9365,-87.64755
TA1307000041,3,17,true,23,28,5,41.93669,-87.63683
13137,3,17,true,28,47,19,41.9376,-87.6441
15642,3,17,true,5,1,-4,41.93843,-87.69801
KA17018068,3,17,true,3,5,2,41.93935,-87.68327
TA1309000042,3,17,true,10,16,6,41.93937,-87.66836
13229,3,17,true,10,8,-2,41.93946,-87.66376
TA1308000019,3,17,true,17,10,-7,41.93973,-87.65886
13277,3,17,true,25,19,-6,41.9401,-87.64546
TA1307000134,3,17,true,29,26,-3,41.94016,-87.65303
TA1309000049,3,17,true,25,34,9,41.94077,-87.63919
TA1307000138,3,17,true,20,23,3,41.94334,-87.67094
13144,3,17,true,3,8,5,41.9434,-87.67964
TA1309000025,3,17,true,26,20,-6,41.94368,-87.64894
13071,3,17,true,14,21,7,41.94373,-87.66401
632,3,17,true,14,16,2,41.94453,-87.6547
13278,3,17,true,26,25,-1,41.94553,-87.64644
TA1309000050,3,17,true,8,5,-3,41.94618,-87.67331
13235,3,17,true,33,25,-8,41.94814,-87.66396
13253,3,17,true,9,7,-2,41.9488,-87.67527
13325,3,17,true,23,23,0,41.94907,-87.64863
TA1307000126,3,17,true,11,9,-2,41.94936,-87.65451
TA1307000150,3,17,true,25,32,7,41.94945,-87.64646
13319,3,17,true,17,7,-10,41.95069,-87.6687
TA1307000127,3,17,true,14,13,-1,41.9508,-87.65918
13323,3,17,true,8,14,6,41.95282,-87.65
TA1309000043,3,17,true,10,7,-3,41.95417,-87.66434
13063,3,17,true,15,9,-6,41.95424,-87.65441
TA1308000022,3,17,true,23,23,0,41.95438,-87.64805
TA1307000149,3,17,true,18,9,-9,41.95467,-87.67392
TA1309000026,3,17,true,6,7,1,41.95601,-87.6802
TA1308000047,3,17,true,3,5,2,41.95709,-87.6642
13379,3,17,true,23,19,-4,41.95786,-87.6495
TA1309000018,3,17,true,5,4,-1,41.95791,-87.67357
TA1309000027,3,17,true,10,10,0,41.9585,-87.65499
13389,3,17,true,15,18,3,41.961,-87.64958
TA1309000021,3,17,true,1,5,4,41.9615,-87.6714
KA1503000022,3,17,true,8,4,-4,41.96158,-87.66609
TA1307000107,3,17,true,20,19,-1,41.96164,-87.65464
TA1307000156,3,17,true,4,6,2,41.96301,-87.68479
TA1309000012,3,17,true,6,5,-1,41.96325,-87.67928
TA1308000012,3,17,true,15,33,18,41.96398,-87.63818
13074,3,17,true,15,11,-4,41.96521,-87.6582
639,3,17,true,11,17,6,41.96584,-87.64538
TA1307000140,3,17,true,2,9,7,41.96643,-87.68865
TA1309000014,3,17,true,10,16,6,41.96709,-87.66744
TA1307000158,3,17,true,11,5,-6,41.9671,-87.67904
TA1307000119,3,17,true,4,8,4,41.96796,-87.65
TA1308000021,3,17,true,6,5,-1,41.96883,-87.65765
KA1504000080,3,17,true,6,6,0,41.96887,-87.69609
TA1309000066,3,17,true,24,14,-10,41.9691,-87.67423
TA1309000041,3,17,true,5,5,0,41.96951,-87.65471
KA1504000171,3,17,true,9,10,1,41.97161,-87.65016
TA1309000035,3,17,true,10,10,0,41.97335,-87.66785
13108,3,17,true,14,8,-6,41.97379,-87.65971
KA1504000078,3,17,true,1,7,6,41.97491,-87.69258
KA1504000149,3,17,true,6,6,0,41.97562,-87.67945
KA1504000146,3,17,true,4,11,7,41.978,-87.66805
13109,3,17,true,2,9,7,41.97835,-87.65976
KA1504000151,3,17,true,7,12,5,41.98359,-87.66916
KA1504000152,3,17,true,17,21,4,41.98403,-87.65231
15578,3,17,true,9,7,-2,41.98405,-87.66027
15575,3,17,true,6,13,7,41.98975,-87.66014
15571,3,17,true,8,2,-6,41.99478,-87.66028
KA1504000162,3,17,true,5,1,-4,42.00907,-87.67422
E002,3,17,true,4,9,5,42.03256,-87.67912
596,3,17,true,4,8,4,42.04822,-87.68348
604,3,17,true,14,3,-11,42.05824,-87.67744
15491,3,18,false,3,8,5,41.78096,-87.57624
KA1503000014,3,18,false,10,5,-5,41.7851,-87.60108
KA1503000074,3,18,false,5,4,-1,41.79174,-87.58395
TA1308000009,3,18,false,10,14,4,41.79522,-87.58075
KA1503000052,3,18,false,2,5,3,41.79935,-87.60097
KA1503000059,3,18,false,3,5,2,41.79952,-87.58643
TA1309000037,3,18,false,5,3,-2,41.79957,-87.59474
KA1503000007,3,18,false,5,2,-3,41.80242,-87.58689
13398,3,18,false,5,1,-4,41.80256,-87.59035
TA1308000038,3,18,false,5,2,-3,41.82298,-87.6071
KA1503000004,3,18,false,5,4,-1,41.83127,-87.6088
13215,3,18,false,7,7,0,41.83634,-87.6135
TA1307000048,3,18,false,11,14,3,41.83855,-87.60821
TA1305000004,3,18,false,3,5,2,41.8514,-87.61884
13075,3,18,false,7,4,-3,41.8531,-87.63192
15545,3,18,false,11,10,-1,41.85627,-87.61334
SL-013,3,18,false,4,5,1,41.85659,-87.62755
SL-006,3,18,false,4,5,1,41.8568,-87.63387
13135,3,18,false,6,3,-3,41.85753,-87.66157
13102,3,18,false,7,10,3,41.85762,-87.61942
13150,3,18,false,10,5,-5,41.85783,-87.62455
13163,3,18,false,6,3,-3,41.85808,-87.65108
13164,3,18,false,7,5,-2,41.85818,-87.65648
SL-012,3,18,false,4,5,1,41.86038,-87.62581
TA1306000002,3,18,false,9,6,-3,41.86238,-87.65108
13029,3,18,false,3,16,13,41.86531,-87.6179
13431,3,18,false,8,8,0,41.8661,-87.60728
WL-008,3,18,false,4,6,2,41.86712,-87.64108
TA1305000002,3,18,false,15,9,-6,41.86721,-87.62597
15544,3,18,false,15,37,22,41.86723,-87.61536
KA1706005007,3,18,false,5,6,1,41.86749,-87.63219
SL-005,3,18,false,12,21,9,41.8679,-87.62304
TA1309000010,3,18,false,11,12,1,41.87074,-87.62574
SL-009,3,18,false,13,7,-6,41.87081,-87.63121
SL-008,3,18,false,7,15,8,41.87209,-87.62956
13332,3,18,false,6,3,-3,41.87219,-87.6615
SL-011,3,18,false,13,6,-7,41.87256,-87.63356
623,3,18,false,25,21,-4,41.87272,-87.62399
13028,3,18,false,1,7,6,41.87475,-87.64981
SL-010,3,18,false,8,4,-4,41.87501,-87.63309
15541,3,18,false,26,24,-2,41.8758,-87.62086
TA1305000010,3,18,false,5,6,1,41.87623,-87.62444
624,3,18,false,1,6,5,41.87626,-87.62923
TA1305000035,3,18,false,9,10,1,41.87716,-87.62787
13138,3,18,false,6,9,3,41.87723,-87.63941
15539,3,18,false,6,7,1,41.87763,-87.64405
13158,3,18,false,9,8,-1,41.87764,-87.64957
13157,3,18,false,11,11,0,41.87773,-87.6548
TA1305000025,3,18,false,10,7,-3,41.87773,-87.63528
TA1309000002,3,18,false,4,13,9,41.87784,-87.62408
638,3,18,false,13,6,-7,41.87827,-87.64078
TA1305000005,3,18,false,3,5,2,41.87924,-87.62975
13011,3,18,false,13,10,-3,41.87931,-87.63993
TA1309000008,3,18,false,4,9,5,41.87933,-87.6355
WL-011,3,18,false,4,6,2,41.88034,-87.64273
13156,3,18,false,3,10,7,41.88042,-87.65554
13300,3,18,false,38,63,25,41.88097,-87.61675
13008,3,18,false,40,42,2,41.88105,-87.62408
TA1305000006,3,18,false,5,10,5,41.88122,-87.6296
TA1307000120,3,18,false,18,18,0,41.88188,-87.64879
13341,3,18,false,16,10,-6,41.88208,-87.63985
13036,3,18,false,11,6,-5,41.8821,-87.62513
TA1305000032,3,18,false,22,9,-13,41.88218,-87.64109
13006,3,18,false,2,6,4,41.88268,-87.63252
13353,3,18,false,6,6,0,41.88283,-87.6612
654,3,18,false,1,6,5,41.88307,-87.65698
13409,3,18,false,9,10,1,41.8831,-87.6511
WL-012,3,18,false,20,5,-15,41.88337,-87.6412
13053,3,18,false,9,14,5,41.88365,-87.64863
13001,3,18,false,21,12,-9,41.88397,-87.62459
13155,3,18,false,6,5,-1,41.88407,-87.65689
18062,3,18,false,6,7,1,41.88412,-87.65427
TA1306000010,3,18,false,12,9,-3,41.88419,-87.62961
15535,3,18,false,16,18,2,41.8846,-87.64455
TA1305000029,3,18,false,22,17,-5,41.88466,-87.62787
13263,3,18,false,9,14,5,41.88467,-87.61952
TA1306000015,3,18,false,13,30,17,41.88549,-87.65232
13021,3,18,false,12,3,-9,41.88559,-87.64184
TA1307000111,3,18,false,5,5,0,41.88582,-87.63548
13073,3,18,false,4,7,3,41.88592,-87.66717
KA1503000012,3,18,false,19,14,-5,41.88599,-87.63089
TA1305000011,3,18,false,17,17,0,41.886,-87.62418
15534,3,18,false,8,9,1,41.88627,-87.61749
13197,3,18,false,6,10,4,41.8866,-87.65816
TA1308000029,3,18,false,2,7,5,41.88673,-87.62225
TA1307000131,3,18,false,9,9,0,41.88688,-87.62606
KA1503000064,3,18,false,29,23,-6,41.88697,-87.61281
TA1305000022,3,18,false,16,10,-6,41.88817,-87.63656
TA1306000003,3,18,false,31,15,-16,41.88867,-87.64442
KA1503000043,3,18,false,21,12,-9,41.88918,-87.63851
13050,3,18,false,7,12,5,41.88919,-87.62775
TA1307000151,3,18,false,12,15,3,41.88993,-87.63427
636,3,18,false,8,4,-4,41.88997,-87.63662
KA1503000044,3,18,false,5,6,1,41.89018,-87.6262
13427,3,18,false,9,8,-1,41.89054,-87.62205
13430,3,18,false,36,28,-8,41.89077,-87.63169
TA1306000013,3,18,false,23,24,1,41.89083,-87.61852
RN-,3,18,false,14,13,-1,41.89102,-87.63546
13434,3,18,false,6,6,0,41.89108,-87.66663
TA1308000006,3,18,false,10,8,-2,41.89128,-87.67686
TA1307000117,3,18,false,19,25,6,41.89144,-87.62675
13033,3,18,false,17,16,-1,41.8916,-87.64835
13194,3,18,false,9,15,6,41.8918,-87.65878
TA1305000003,3,18,false,15,12,-3,41.89187,-87.62061
13022,3,18,false,104,108,4,41.89227,-87.61205
TA1306000029,3,18,false,15,22,7,41.89256,-87.61449
13265,3,18,false,13,8,-5,41.89383,-87.64172
13045,3,18,false,27,16,-11,41.89403,-87.62931
13016,3,18,false,10,15,5,41.89431,-87.62277
KA1503000041,3,18,false,9,12,3,41.89452,-87.61798
13196,3,18,false,6,4,-2,41.89455,-87.65345
TA1307000062,3,18,false,7,6,-1,41.89466,-87.63839
TA1306000012,3,18,false,20,22,2,41.89475,-87.63438
KP1705001026,3,18,false,18,14,-4,41.89483,-87.6323
637,3,18,false,4,6,2,41.89563,-87.67209
13132,3,18,false,11,9,-2,41.89573,-87.67718
15530,3,18,false,14,5,-9,41.89575,-87.62596
13247,3,18,false,7,4,-3,41.89597,-87.66775
TA1305000020,3,18,false,12,12,0,41.89636,-87.65406
13289,3,18,false,12,11,-1,41.89638,-87.661
13303,3,18,false,12,16,4,41.89672,-87.63088
13017,3,18,false,21,10,-11,41.89676,-87.6357
13338,3,18,false,3,7,4,41.89697,-87.62173
TA1307000061,3,18,false,11,6,-5,41.89745,-87.62873
13034,3,18,false,10,8,-2,41.89754,-87.62352
TA1306000009,3,18,false,4,8,4,41.89772,-87.64299
620,3,18,false,11,11,0,41.89817,-87.63754
15529,3,18,false,9,17,8,41.89858,-87.62206
TA1307000128,3,18,false,25,15,-10,41.89896,-87.6299
13248,3,18,false,6,14,8,41.89964,-87.66788
TA1306000011,3,18,false,13,14,1,41.89994,-87.63443
KA1504000116,3,18,false,6,7,1,41.90023,-87.64299
13290,3,18,false,7,8,1,41.90069,-87.66259
13042,3,18,false,52,84,32,41.90097,-87.62377
TA1307000070,3,18,false,8,6,-2,41.90133,-87.67742
KA1504000133,3,18,false,13,19,6,41.90234,-87.62773
13241,3,18,false,5,2,-3,41.9029,-87.68731
TA1306000006,3,18,false,4,9,5,41.90292,-87.63772
TA1307000039,3,18,false,21,41,20,41.90294,-87.63137
TA1305000034,3,18,false,6,10,4,41.90313,-87.67391
KA1504000135,3,18,false,38,33,-5,41.90319,-87.63439
13136,3,18,false,9,15,6,41.90326,-87.67845
13061,3,18,false,20,12,-8,41.90342,-87.66779
KA1504000079,3,18,false,31,19,-12,41.9035,-87.64334
TA1307000115,3,18,false,6,7,1,41.9046,-87.64056
TA1308000049,3,18,false,22,30,8,41.90672,-87.6349
KA1504000134,3,18,false,19,13,-6,41.90687,-87.6262
13224,3,18,false,16,13,-3,41.90706,-87.66725
TA1307000143,3,18,false,5,8,3,41.90762,-87.63854
13221,3,18,false,12,17,5,41.90765,-87.67254
13245,3,18,false,7,1,-6,41.90777,-87.68586
TA1309000024,3,18,false,22,42,20,41.908,-87.63152
TA1305000041,3,18,false,21,11,-10,41.9094,-87.67769
15652,3,18,false,5,2,-3,41.90965,-87.71664
331,3,18,false,22,13,-9,41.90965,-87.64812
TA1305000037,3,18,false,8,8,0,41.91018,-87.67003
TA1306000008,3,18,false,10,6,-4,41.9102,-87.6435
TA1308000005,3,18,false,1,5,4,41.91042,-87.68238
13257,3,18,false,5,7,2,41.91054,-87.68956
13154,3,18,false,14,7,-7,41.91054,-87.65312
13058,3,18,false,22,12,-10,41.91059,-87.64942
TA1307000038,3,18,false,10,39,29,41.91138,-87.63868
LF-005,3,18,false,43,196,153,41.91172,-87.62681
13128,3,18,false,8,13,5,41.91197,-87.63197
TA1308000050,3,18,false,39,45,6,41.91211,-87.6347
13243,3,18,false,9,3,-6,41.91262,-87.6814
TA1306000032,3,18,false,12,10,-2,41.9137,-87.65285
TA1307000166,3,18,false,14,6,-8,41.91386,-87.64877
15655,3,18,false,4,5,1,41.91401,-87.70514
18017,3,18,false,4,5,1,41.91416,-87.71676
18067,3,18,false,10,10,0,41.9146,-87.66796
TA1306000007,3,18,false,5,10,5,41.91469,-87.64333
13068,3,18,false,15,9,-6,41.91554,-87.68703
13179,3,18,false,21,40,19,41.9157,-87.63461
13133,3,18,false,13,12,-1,41.91598,-87.67733
TA1305000039,3,18,false,10,4,-6,41.9163,-87.66749
15650,3,18,false,8,7,-1,41.91711,-87.71023
15651,3,18,false,5,3,-2,41.91752,-87.70181
13266,3,18,false,5,7,2,41.91774,-87.69142
TA1309000006,3,18,false,8,16,8,41.91809,-87.64375
TA1307000163,3,18,false,4,7,3,41.91821,-87.65696
13146,3,18,false,25,80,55,41.91831,-87.63629
13059,3,18,false,26,13,-13,41.91845,-87.65222
13192,3,18,false,13,18,5,41.91995,-87.64884
TA1309000030,3,18,false,8,6,-2,41.92077,-87.66372
TA1309000033,3,18,false,20,24,4,41.92158,-87.65381
13193,3,18,false,31,41,10,41.92182,-87.64412
13191,3,18,false,14,18,4,41.92217,-87.63891
13084,3,18,false,6,6,0,41.92268,-87.69715
LP-,3,18,false,15,14,-1,41.92396,-87.63584
TA1307000001,3,18,false,15,18,3,41.92535,-87.66581
TA1306000026,3,18,false,9,15,6,41.92558,-87.65842
TA1306000016,3,18,false,15,10,-5,41.9256,-87.65371
TA1309000019,3,18,false,24,26,2,41.92586,-87.63897
TA1309000058,3,18,false,23,27,4,41.92591,-87.64927
TA1308000001,3,18,false,44,80,36,41.92627,-87.63086
15646,3,18,false,5,3,-2,41.92668,-87.6977
13124,3,18,false,13,11,-2,41.92675,-87.63444
TA1309000023,3,18,false,29,26,-3,41.9287,-87.65383
TA1307000113,3,18,false,23,23,0,41.92878,-87.66391
13296,3,18,false,12,12,0,41.92883,-87.66852
TA1309000059,3,18,false,8,7,-1,41.92889,-87.65898
TA1309000061,3,18,false,10,14,4,41.92915,-87.64909
TA1308000031,3,18,false,6,6,0,41.92946,-87.68417
TA1305000014,3,18,false,11,17,6,41.92956,-87.64313
13085,3,18,false,5,11,6,41.92958,-87.70789
TA1307000142,3,18,false,20,15,-5,41.93125,-87.64432
13276,3,18,false,21,15,-6,41.93132,-87.63874
13271,3,18,false,5,8,3,41.93192,-87.67784
TA1307000064,3,18,false,9,13,4,41.93222,-87.65864
TA1306000014,3,18,false,26,8,-18,41.93242,-87.65271
TA1309000039,3,18,false,34,20,-14,41.93258,-87.63642
13294,3,18,false,7,2,-5,41.9326,-87.66595
TA1309000036,3,18,false,27,24,-3,41.93313,-87.64776
TA1307000006,3,18,false,13,9,-4,41.93571,-87.6636
13268,3,18,false,6,5,-1,41.93588,-87.67843
TA1307000052,3,18,false,15,14,-1,41.93628,-87.65266
TA1307000136,3,18,false,13,8,-5,41.9365,-87.64755
TA1307000041,3,18,false,33,27,-6,41.93669,-87.63683
13137,3,18,false,45,24,-21,41.9376,-87.6441
TA1309000042,3,18,false,8,7,-1,41.93937,-87.66836
15640,3,18,false,6,2,-4,41.93941,-87.72357
13229,3,18,false,13,7,-6,41.93946,-87.66376
TA1308000019,3,18,false,19,19,0,41.93973,-87.65886
13277,3,18,false,13,21,8,41.9401,-87.64546
TA1307000134,3,18,false,27,15,-12,41.94016,-87.65303
13143,3,18,false,11,2,-9,41.94059,-87.67853
TA1309000049,3,18,false,28,18,-10,41.94077,-87.63919
TA1307000138,3,18,false,14,7,-7,41.94334,-87.67094
TA1309000025,3,18,false,10,24,14,41.94368,-87.64894
13071,3,18,false,20,24,4,41.94373,-87.66401
632,3,18,false,24,18,-6,41.94453,-87.6547
13278,3,18,false,13,10,-3,41.94553,-87.64644
KA1504000143,3,18,false,1,5,4,41.94664,-87.68337
13235,3,18,false,15,8,-7,41.94814,-87.66396
13325,3,18,false,21,7,-14,41.94907,-87.64863
TA1307000126,3,18,false,16,9,-7,41.94936,-87.65451
TA1307000150,3,18,false,21,12,-9,41.94945,-87.64646
13319,3,18,false,6,3,-3,41.95069,-87.6687
TA1307000127,3,18,false,22,8,-14,41.9508,-87.65918
13323,3,18,false,15,14,-1,41.95282,-87.65
13063,3,18,false,8,6,-2,41.95424,-87.65441
TA1308000022,3,18,false,11,10,-1,41.95438,-87.64805
TA1307000149,3,18,false,5,5,0,41.95467,-87.67392
TA1309000026,3,18,false,3,5,2,41.95601,-87.6802
13379,3,18,false,11,7,-4,41.95786,-87.6495
TA1309000027,3,18,false,10,6,-4,41.9585,-87.65499
13389,3,18,false,7,13,6,41.961,-87.64958
TA1307000144,3,18,false,5,5,0,41.96142,-87.6762
TA1309000021,3,18,false,1,5,4,41.9615,-87.6714
KA1503000022,3,18,false,4,6,2,41.96158,-87.66609
TA1307000107,3,18,false,23,18,-5,41.96164,-87.65464
TA1308000012,3,18,false,15,29,14,41.96398,-87.63818
13074,3,18,false,11,8,-3,41.96521,-87.6582
639,3,18,false,13,19,6,41.96584,-87.64538
TA1309000014,3,18,false,6,10,4,41.96709,-87.66744
TA1307000119,3,18,false,5,13,8,41.96796,-87.65
TA1308000021,3,18,false,6,5,-1,41.96883,-87.65765
TA1309000066,3,18,false,9,4,-5,41.9691,-87.67423
TA1309000041,3,18,false,4,6,2,41.96951,-87.65471
KA1504000171,3,18,false,6,8,2,41.97161,-87.65016
TA1309000035,3,18,false,16,7,-9,41.97335,-87.66785
13108,3,18,false,4,10,6,41.97379,-87.65971
KA1504000146,3,18,false,3,6,3,41.978,-87.66805
KA1504000152,3,18,false,21,13,-8,41.98403,-87.65231
15578,3,18,false,5,1,-4,41.98405,-87.66027
15575,3,18,false,10,6,-4,41.98975,-87.66014
RP-009,3,18,false,9,8,-1,42.00107,-87.66122
RP-001,3,18,false,5,9,4,42.00179,-87.68883
660,3,18,false,6,4,-2,42.00458,-87.66143
520,3,18,false,5,2,-3,42.01597,-87.66859
596,3,18,false,2,10,8,42.04822,-87.68348
KA1503000014,3,18,true,6,10,4,41.7851,-87.60108
KA1503000070,3,18,true,7,8,1,41.78794,-87.58831
KA1503000071,3,18,true,10,2,-8,41.79148,-87.59988
KA1503000074,3,18,true,8,3,-5,41.79174,-87.58395
TA1309000063,3,18,true,4,5,1,41.79325,-87.5878
TA1308000009,3,18,true,9,10,1,41.79522,-87.58075
TA1307000164,3,18,true,5,6,1,41.79527,-87.59647
KA1503000052,3,18,true,4,5,1,41.79935,-87.60097
TA1309000037,3,18,true,10,9,-1,41.79957,-87.59474
KA1503000007,3,18,true,6,7,1,41.80242,-87.58689
13398,3,18,true,3,6,3,41.80256,-87.59035
13216,3,18,true,12,2,-10,41.83473,-87.62581
13217,3,18,true,7,10,3,41.83488,-87.61792
13215,3,18,true,7,10,3,41.83634,-87.6135
TA1308000046,3,18,true,3,5,2,41.83779,-87.65115
TA1309000055,3,18,true,16,6,-10,41.8382,-87.64514
KA1503000038,3,18,true,5,3,-2,41.83845,-87.6354
TA1307000048,3,18,true,21,11,-10,41.83855,-87.60821
TA1308000036,3,18,true,3,11,8,41.83883,-87.62186
TA1307000139,3,18,true,5,6,1,41.84205,-87.61698
TA1305000001,3,18,true,1,6,5,41.85262,-87.6265
13091,3,18,true,8,4,-4,41.85409,-87.68585
13307,3,18,true,2,5,3,41.85489,-87.66359
13089,3,18,true,10,3,-7,41.85497,-87.67567
15545,3,18,true,26,27,1,41.85627,-87.61334
SL-006,3,18,true,2,6,4,41.8568,-87.63387
13135,3,18,true,4,6,2,41.85753,-87.66157
13102,3,18,true,8,10,2,41.85762,-87.61942
13150,3,18,true,8,12,4,41.85783,-87.62455
13163,3,18,true,3,7,4,41.85808,-87.65108
13164,3,18,true,3,16,13,41.85818,-87.65648
SL-012,3,18,true,6,15,9,41.86038,-87.62581
TA1306000002,3,18,true,4,7,3,41.86238,-87.65108
TA1307000124,3,18,true,14,13,-1,41.86411,-87.62372
TA1309000001,3,18,true,8,8,0,41.86488,-87.64708
13431,3,18,true,18,16,-2,41.8661,-87.60728
WL-008,3,18,true,4,8,4,41.86712,-87.64108
TA1305000002,3,18,true,29,25,-4,41.86721,-87.62597
15544,3,18,true,10,13,3,41.86723,-87.61536
KA1706005007,3,18,true,5,7,2,41.86749,-87.63219
SL-005,3,18,true,11,25,14,41.8679,-87.62304
644,3,18,true,4,8,4,41.86859,-87.68625
13139,3,18,true,7,2,-5,41.86893,-87.65913
13285,3,18,true,12,9,-3,41.86928,-87.67372
13160,3,18,true,20,11,-9,41.86947,-87.65548
15550,3,18,true,7,11,4,41.87024,-87.63947
TA1309000010,3,18,true,20,22,2,41.87074,-87.62574
SL-009,3,18,true,7,8,1,41.87081,-87.63121
TA1309000064,3,18,true,15,2,-13,41.87127,-87.67369
TA1307000130,3,18,true,11,10,-1,41.87178,-87.65103
TA1307000121,3,18,true,10,19,9,41.87184,-87.64664
SL-008,3,18,true,23,20,-3,41.87209,-87.62956
13332,3,18,true,35,21,-14,41.87219,-87.6615
SL-011,3,18,true,7,9,2,41.87256,-87.63356
623,3,18,true,8,10,2,41.87272,-87.62399
KA1504000104,3,18,true,9,5,-4,41.87296,-87.66912
SL-007,3,18,true,7,10,3,41.87404,-87.6277
TA1306000025,3,18,true,7,8,1,41.87464,-87.65703
13028,3,18,true,7,11,4,41.87475,-87.64981
SL-010,3,18,true,12,9,-3,41.87501,-87.63309
15541,3,18,true,9,6,-3,41.8758,-87.62086
13037,3,18,true,6,3,-3,41.87588,-87.64078
TA1305000009,3,18,true,6,4,-2,41.87593,-87.63068
624,3,18,true,14,7,-7,41.87626,-87.62923
TA1305000035,3,18,true,7,1,-6,41.87716,-87.62787
13138,3,18,true,8,3,-5,41.87723,-87.63941
15539,3,18,true,6,11,5,41.87763,-87.64405
13158,3,18,true,15,19,4,41.87764,-87.64957
13157,3,18,true,15,22,7,41.87773,-87.6548
TA1305000025,3,18,true,19,11,-8,41.87773,-87.63528
13206,3,18,true,9,11,2,41.87794,-87.66201
TA1309000004,3,18,true,17,6,-11,41.87811,-87.63184
638,3,18,true,23,4,-19,41.87827,-87.64078
TA1305000005,3,18,true,6,4,-2,41.87924,-87.62975
13011,3,18,true,35,15,-20,41.87931,-87.63993
TA1309000008,3,18,true,7,2,-5,41.87933,-87.6355
15667,3,18,true,6,7,1,41.8798,-87.68609
TA1309000007,3,18,true,11,5,-6,41.88022,-87.63526
WL-011,3,18,true,8,11,3,41.88034,-87.64273
13156,3,18,true,7,19,12,41.88042,-87.65554
13300,3,18,true,43,44,1,41.88097,-87.61675
13008,3,18,true,19,7,-12,41.88105,-87.62408
TA1305000006,3,18,true,13,7,-6,41.88122,-87.6296
13056,3,18,true,17,6,-11,41.88168,-87.63951
TA1307000120,3,18,true,28,40,12,41.88188,-87.64879
13341,3,18,true,35,22,-13,41.88208,-87.63985
13036,3,18,true,10,5,-5,41.8821,-87.62513
TA1305000032,3,18,true,57,27,-30,41.88218,-87.64109
13006,3,18,true,7,2,-5,41.88268,-87.63252
13353,3,18,true,11,7,-4,41.88283,-87.6612
654,3,18,true,4,6,2,41.88307,-87.65698
13409,3,18,true,17,13,-4,41.8831,-87.6511
KA1503000072,3,18,true,7,5,-2,41.88317,-87.63693
WL-012,3,18,true,38,15,-23,41.88337,-87.6412
13053,3,18,true,17,14,-3,41.88365,-87.64863
13001,3,18,true,17,8,-9,41.88397,-87.62459
13155,3,18,true,8,5,-3,41.88407,-87.65689
18062,3,18,true,13,13,0,41.88412,-87.65427
TA1306000010,3,18,true,33,15,-18,41.88419,-87.62961
TA1305000030,3,18,true,17,3,-14,41.88459,-87.63178
15535,3,18,true,18,25,7,41.8846,-87.64455
TA1305000029,3,18,true,31,21,-10,41.88466,-87.62787
13263,3,18,true,27,17,-10,41.88467,-87.61952
TA1306000015,3,18,true,16,17,1,41.88549,-87.65232
13021,3,18,true,21,13,-8,41.88559,-87.64184
TA1307000111,3,18,true,12,12,0,41.88582,-87.63548
13073,3,18,true,2,8,6,41.88592,-87.66717
KA1503000012,3,18,true,23,12,-11,41.88599,-87.63089
TA1305000011,3,18,true,24,19,-5,41.886,-87.62418
15534,3,18,true,6,14,8,41.88627,-87.61749
13197,3,18,true,17,6,-11,41.8866,-87.65816
TA1308000029,3,18,true,9,9,0,41.88673,-87.62225
TA1307000131,3,18,true,13,8,-5,41.88688,-87.62606
KA1503000064,3,18,true,17,17,0,41.88697,-87.61281
TA1305000022,3,18,true,32,11,-21,41.88817,-87.63656
TA1306000003,3,18,true,48,32,-16,41.88867,-87.64442
KA1503000043,3,18,true,35,27,-8,41.88918,-87.63851
13050,3,18,true,21,14,-7,41.88919,-87.62775
15664,3,18,true,2,5,3,41.8895,-87.68821
13432,3,18,true,9,7,-2,41.88989,-87.67149
TA1307000151,3,18,true,18,14,-4,41.88993,-87.63427
636,3,18,true,13,13,0,41.88997,-87.63662
KA1503000044,3,18,true,17,14,-3,41.89018,-87.6262
13427,3,18,true,12,13,1,41.89054,-87.62205
13430,3,18,true,41,20,-21,41.89077,-87.63169
TA1306000013,3,18,true,25,26,1,41.89083,-87.61852
RN-,3,18,true,16,18,2,41.89102,-87.63546
13434,3,18,true,4,5,1,41.89108,-87.66663
TA1308000006,3,18,true,4,5,1,41.89128,-87.67686
TA1307000117,3,18,true,35,23,-12,41.89144,-87.62675
13033,3,18,true,28,31,3,41.8916,-87.64835
13194,3,18,true,13,14,1,41.8918,-87.65878
TA1305000003,3,18,true,31,16,-15,41.89187,-87.62061
643,3,18,true,3,5,2,41.89203,-87.68939
13022,3,18,true,56,55,-1,41.89227,-87.61205
TA1306000029,3,18,true,17,18,1,41.89256,-87.61449
13265,3,18,true,31,34,3,41.89383,-87.64172
13045,3,18,true,39,35,-4,41.89403,-87.62931
13016,3,18,true,43,13,-30,41.89431,-87.62277
KA1503000041,3,18,true,23,22,-1,41.89452,-87.61798
13196,3,18,true,7,13,6,41.89455,-87.65345
TA1307000062,3,18,true,17,12,-5,41.89466,-87.63839
TA1306000012,3,18,true,36,29,-7,41.89475,-87.63438
KP1705001026,3,18,true,15,16,1,41.89483,-87.6323
18058,3,18,true,4,5,1,41.8955,-87.68201
637,3,18,true,11,16,5,41.89563,-87.67209
13132,3,18,true,12,21,9,41.89573,-87.67718
15530,3,18,true,19,20,1,41.89575,-87.62596
18003,3,18,true,10,4,-6,41.89575,-87.62011
13247,3,18,true,8,18,10,41.89597,-87.66775
TA1305000020,3,18,true,22,13,-9,41.89636,-87.65406
13289,3,18,true,18,21,3,41.89638,-87.661
13303,3,18,true,25,25,0,41.89672,-87.63088
13017,3,18,true,23,21,-2,41.89676,-87.6357
13338,3,18,true,14,24,10,41.89697,-87.62173
TA1307000061,3,18,true,8,7,-1,41.89745,-87.62873
13034,3,18,true,13,11,-2,41.89754,-87.62352
TA1306000009,3,18,true,16,10,-6,41.89772,-87.64299
620,3,18,true,18,13,-5,41.89817,-87.63754
KA1504000103,3,18,true,7,6,-1,41.89842,-87.68659
15529,3,18,true,18,15,-3,41.89858,-87.62206
TA1307000128,3,18,true,27,40,13,41.89896,-87.6299
657,3,18,true,9,5,-4,41.89918,-87.6722
KA1504000117,3,18,true,7,4,-3,41.89936,-87.64848
13248,3,18,true,11,21,10,41.89964,-87.66788
TA1306000011,3,18,true,20,19,-1,41.89994,-87.63443
KA1504000116,3,18,true,17,13,-4,41.90023,-87.64299
17660,3,18,true,5,4,-1,41.90036,-87.69671
13290,3,18,true,11,10,-1,41.90069,-87.66259
13042,3,18,true,56,65,9,41.90097,-87.62377
TA1307000070,3,18,true,9,17,8,41.90133,-87.67742
KA1504000133,3,18,true,29,31,2,41.90234,-87.62773
TA1306000006,3,18,true,7,13,6,41.90292,-87.63772
TA1307000039,3,18,true,48,58,10,41.90294,-87.63137
658,3,18,true,8,4,-4,41.903,-87.6838
13256,3,18,true,8,6,-2,41.90302,-87.69749
TA1305000034,3,18,true,14,20,6,41.90313,-87.67391
KA1504000135,3,18,true,47,51,4,41.90319,-87.63439
13136,3,18,true,13,15,2,41.90326,-87.67845
13061,3,18,true,25,23,-2,41.90342,-87.66779
KA1504000079,3,18,true,17,22,5,41.9035,-87.64334
TA1307000115,3,18,true,9,14,5,41.9046,-87.64056
TA1308000049,3,18,true,17,34,17,41.90672,-87.6349
KA1504000134,3,18,true,11,18,7,41.90687,-87.6262
13224,3,18,true,13,18,5,41.90706,-87.66725
TA1307000143,3,18,true,4,14,10,41.90762,-87.63854
13221,3,18,true,16,21,5,41.90765,-87.67254
TA1309000024,3,18,true,21,27,6,41.908,-87.63152
TA1305000041,3,18,true,19,25,6,41.9094,-87.67769
331,3,18,true,31,40,9,41.90965,-87.64812
TA1305000037,3,18,true,14,12,-2,41.91018,-87.67003
TA1306000008,3,18,true,11,18,7,41.9102,-87.6435
TA1308000005,3,18,true,8,9,1,41.91042,-87.68238
13258,3,18,true,3,6,3,41.91043,-87.69718
13257,3,18,true,5,10,5,41.91054,-87.68956
13154,3,18,true,24,22,-2,41.91054,-87.65312
13058,3,18,true,10,20,10,41.91059,-87.64942
TA1307000038,3,18,true,16,30,14,41.91138,-87.63868
LF-005,3,18,true,54,145,91,41.91172,-87.62681
13128,3,18,true,13,17,4,41.91197,-87.63197
TA1308000050,3,18,true,49,53,4,41.91211,-87.6347
13243,3,18,true,20,22,2,41.91262,-87.6814
TA1306000032,3,18,true,27,17,-10,41.9137,-87.65285
TA1307000166,3,18,true,11,13,2,41.91386,-87.64877
15655,3,18,true,6,1,-5,41.91401,-87.70514
18017,3,18,true,1,5,4,41.91416,-87.71676
18067,3,18,true,17,13,-4,41.9146,-87.66796
TA1306000007,3,18,true,6,18,12,41.91469,-87.64333
13068,3,18,true,11,16,5,41.91554,-87.68703
13179,3,18,true,39,30,-9,41.9157,-87.63461
13133,3,18,true,13,24,11,41.91598,-87.67733
15650,3,18,true,7,5,-2,41.91711,-87.71023
15651,3,18,true,8,10,2,41.91752,-87.70181
13266,3,18,true,7,6,-1,41.91774,-87.69142
TA1309000029,3,18,true,13,12,-1,41.9178,-87.68245
TA1309000006,3,18,true,21,22,1,41.91809,-87.64375
TA1307000163,3,18,true,9,12,3,41.91821,-87.65696
13146,3,18,true,47,73,26,41.91831,-87.63629
13059,3,18,true,21,24,3,41.91845,-87.65222
13259,3,18,true,7,3,-4,41.91852,-87.69744
13192,3,18,true,23,22,-1,41.91995,-87.64884
13288,3,18,true,6,8,2,41.92008,-87.67788
13242,3,18,true,2,9,7,41.92021,-87.69266
TA1309000030,3,18,true,21,18,-3,41.92077,-87.66372
13292,3,18,true,6,2,-4,41.92152,-87.70733
TA1309000033,3,18,true,19,30,11,41.92158,-87.65381
13193,3,18,true,41,41,0,41.92182,-87.64412
13191,3,18,true,15,25,10,41.92217,-87.63891
13084,3,18,true,13,20,7,41.92268,-87.69715
LP-,3,18,true,7,10,3,41.92396,-87.63584
KA1504000140,3,18,true,5,4,-1,41.92409,-87.67646
15648,3,18,true,3,6,3,41.92464,-87.68931
TA1307000001,3,18,true,12,21,9,41.92535,-87.66581
TA1306000026,3,18,true,8,17,9,41.92558,-87.65842
TA1306000016,3,18,true,19,23,4,41.9256,-87.65371
TA1309000019,3,18,true,17,29,12,41.92586,-87.63897
TA1309000058,3,18,true,30,40,10,41.92591,-87.64927
TA1308000001,3,18,true,48,50,2,41.92627,-87.63086
15646,3,18,true,4,10,6,41.92668,-87.6977
13124,3,18,true,8,18,10,41.92675,-87.63444
TA1309000023,3,18,true,19,17,-2,41.9287,-87.65383
TA1307000113,3,18,true,10,23,13,41.92878,-87.66391
13296,3,18,true,8,16,8,41.92883,-87.66852
TA1309000059,3,18,true,8,14,6,41.92889,-87.65898
TA1309000061,3,18,true,20,28,8,41.92915,-87.64909
TA1308000031,3,18,true,9,6,-3,41.92946,-87.68417
TA1305000014,3,18,true,17,20,3,41.92956,-87.64313
13085,3,18,true,6,12,6,41.92958,-87.70789
TA1307000142,3,18,true,31,23,-8,41.93125,-87.64432
13276,3,18,true,23,16,-7,41.93132,-87.63874
13271,3,18,true,12,3,-9,41.93192,-87.67784
TA1307000064,3,18,true,24,18,-6,41.93222,-87.65864
TA1306000014,3,18,true,21,14,-7,41.93242,-87.65271
TA1309000039,3,18,true,29,35,6,41.93258,-87.63642
13294,3,18,true,7,9,2,41.9326,-87.66595
TA1309000036,3,18,true,32,23,-9,41.93313,-87.64776
TA1307000006,3,18,true,12,14,2,41.93571,-87.6636
13268,3,18,true,2,6,4,41.93588,-87.67843
13269,3,18,true,4,10,6,41.93609,-87.66983
TA1307000052,3,18,true,27,25,-2,41.93628,-87.65266
TA1307000136,3,18,true,23,25,2,41.9365,-87.64755
TA1307000041,3,18,true,36,33,-3,41.93669,-87.63683
13137,3,18,true,41,41,0,41.9376,-87.6441
15642,3,18,true,4,5,1,41.93843,-87.69801
KA17018068,3,18,true,2,6,4,41.93935,-87.68327
TA1309000042,3,18,true,8,13,5,41.93937,-87.66836
KA150400009X,3,18,true,5,3,-2,41.9394,-87.71159
13229,3,18,true,12,11,-1,41.93946,-87.66376
TA1308000019,3,18,true,17,17,0,41.93973,-87.65886
13277,3,18,true,28,20,-8,41.9401,-87.64546
TA1307000134,3,18,true,18,38,20,41.94016,-87.65303
TA1309000049,3,18,true,29,29,0,41.94077,-87.63919
15634,3,18,true,2,6,4,41.94304,-87.68729
TA1307000138,3,18,true,13,15,2,41.94334,-87.67094
13144,3,18,true,8,9,1,41.9434,-87.67964
TA1309000025,3,18,true,24,14,-10,41.94368,-87.64894
13071,3,18,true,23,20,-3,41.94373,-87.66401
632,3,18,true,18,26,8,41.94453,-87.6547
13278,3,18,true,17,27,10,41.94553,-87.64644
15632,3,18,true,2,6,4,41.94664,-87.69463
13235,3,18,true,33,31,-2,41.94814,-87.66396
13253,3,18,true,8,8,0,41.9488,-87.67527
13325,3,18,true,22,25,3,41.94907,-87.64863
TA1307000126,3,18,true,21,17,-4,41.94936,-87.65451
TA1307000150,3,18,true,35,38,3,41.94945,-87.64646
13319,3,18,true,7,8,1,41.95069,-87.6687
TA1307000127,3,18,true,16,12,-4,41.9508,-87.65918
13323,3,18,true,17,18,1,41.95282,-87.65
TA1309000043,3,18,true,8,8,0,41.95417,-87.66434
13063,3,18,true,8,8,0,41.95424,-87.65441
TA1308000022,3,18,true,24,18,-6,41.95438,-87.64805
TA1307000149,3,18,true,9,12,3,41.95467,-87.67392
TA1309000026,3,18,true,3,12,9,41.95601,-87.6802
13249,3,18,true,6,3,-3,41.95606,-87.66885
13379,3,18,true,15,22,7,41.95786,-87.6495
TA1309000018,3,18,true,9,6,-3,41.95791,-87.67357
TA1309000027,3,18,true,15,13,-2,41.9585,-87.65499
13389,3,18,true,16,19,3,41.961,-87.64958
15622,3,18,true,3,5,2,41.96108,-87.69544
TA1307000144,3,18,true,12,10,-2,41.96142,-87.6762
15623,3,18,true,7,1,-6,41.96154,-87.69117
KA1503000022,3,18,true,5,5,0,41.96158,-87.66609
TA1307000107,3,18,true,19,21,2,41.96164,-87.65464
TA1307000156,3,18,true,6,8,2,41.96301,-87.68479
TA1308000012,3,18,true,24,40,16,41.96398,-87.63818
13074,3,18,true,4,9,5,41.96521,-87.6582
639,3,18,true,20,34,14,41.96584,-87.64538
TA1307000140,3,18,true,8,6,-2,41.96643,-87.68865
TA1309000014,3,18,true,7,9,2,41.96709,-87.66744
TA1307000158,3,18,true,4,6,2,41.9671,-87.67904
TA1307000119,3,18,true,2,5,3,41.96796,-87.65
TA1308000021,3,18,true,5,10,5,41.96883,-87.65765
KA1504000080,3,18,true,7,2,-5,41.96887,-87.69609
TA1309000066,3,18,true,21,10,-11,41.9691,-87.67423
TA1309000041,3,18,true,9,8,-1,41.96951,-87.65471
KA1504000171,3,18,true,8,6,-2,41.97161,-87.65016
TA1309000035,3,18,true,7,21,14,41.97335,-87.66785
13108,3,18,true,15,18,3,41.97379,-87.65971
KA1504000078,3,18,true,4,5,1,41.97491,-87.69258
KA1504000149,3,18,true,6,9,3,41.97562,-87.67945
KA1504000146,3,18,true,5,12,7,41.978,-87.66805
13109,3,18,true,8,13,5,41.97835,-87.65976
KA1504000151,3,18,true,7,7,0,41.98359,-87.66916
KA1504000152,3,18,true,17,23,6,41.98403,-87.65231
15578,3,18,true,6,14,8,41.98405,-87.66027
15575,3,18,true,8,8,0,41.98975,-87.66014
15571,3,18,true,8,12,4,41.99478,-87.66028
RP-009,3,18,true,6,8,2,42.00107,-87.66122
660,3,18,true,9,6,-3,42.00458,-87.66143
E002,3,18,true,5,4,-1,42.03256,-87.67912
596,3,18,true,7,4,-3,42.04822,-87.68348
KA1503000002,3,19,false,2,5,3,41.76641,-87.5657
KA1503000029,3,19,false,6,2,-4,41.77364,-87.56747
15491,3,19,false,9,4,-5,41.78096,-87.57624
TA1308000009,3,19,false,9,14,5,41.79522,-87.58075
KA1503000059,3,19,false,9,9,0,41.79952,-87.58643
TA1309000037,3,19,false,3,7,4,41.79957,-87.59474
15470,3,19,false,3,5,2,41.80228,-87.61807
KA1503000007,3,19,false,5,8,3,41.80242,-87.58689
13398,3,19,false,5,3,-2,41.80256,-87.59035
TA1308000038,3,19,false,6,11,5,41.82298,-87.6071
KA1503000004,3,19,false,4,6,2,41.83127,-87.6088
TA1309000055,3,19,false,3,7,4,41.8382,-87.64514
TA1307000048,3,19,false,14,13,-1,41.83855,-87.60821
15443,3,19,false,4,6,2,41.84275,-87.63549
TA1307000005,3,19,false,7,3,-4,41.84569,-87.6225
13075,3,19,false,5,10,5,41.8531,-87.63192
15546,3,19,false,4,8,4,41.85416,-87.61916
13307,3,19,false,6,3,-3,41.85489,-87.66359
13331,3,19,false,1,6,5,41.85515,-87.65414
15545,3,19,false,12,3,-9,41.85627,-87.61334
SL-013,3,19,false,7,4,-3,41.85659,-87.62755
SL-006,3,19,false,5,5,0,41.8568,-87.63387
13102,3,19,false,3,8,5,41.85762,-87.61942
13150,3,19,false,3,7,4,41.85783,-87.62455
13164,3,19,false,8,4,-4,41.85818,-87.65648
SL-012,3,19,false,10,8,-2,41.86038,-87.62581
TA1306000002,3,19,false,1,7,6,41.86238,-87.65108
TA1307000124,3,19,false,4,10,6,41.86411,-87.62372
13029,3,19,false,3,11,8,41.86531,-87.6179
13431,3,19,false,8,6,-2,41.8661,-87.60728
WL-008,3,19,false,5,2,-3,41.86712,-87.64108
TA1305000002,3,19,false,24,11,-13,41.86721,-87.62597
15544,3,19,false,33,25,-8,41.86723,-87.61536
KA1706005007,3,19,false,10,2,-8,41.86749,-87.63219
SL-005,3,19,false,17,19,2,41.8679,-87.62304
13160,3,19,false,1,8,7,41.86947,-87.65548
15550,3,19,false,7,5,-2,41.87024,-87.63947
TA1309000010,3,19,false,11,9,-2,41.87074,-87.62574
SL-009,3,19,false,9,13,4,41.87081,-87.63121
SL-008,3,19,false,12,8,-4,41.87209,-87.62956
SL-011,3,19,false,7,5,-2,41.87256,-87.63356
623,3,19,false,23,25,2,41.87272,-87.62399
SL-007,3,19,false,7,2,-5,41.87404,-87.6277
13028,3,19,false,6,4,-2,41.87475,-87.64981
15541,3,19,false,31,21,-10,41.8758,-87.62086
TA1305000010,3,19,false,7,4,-3,41.87623,-87.62444
13138,3,19,false,5,1,-4,41.87723,-87.63941
13158,3,19,false,9,8,-1,41.87764,-87.64957
13157,3,19,false,5,3,-2,41.87773,-87.6548
TA1305000025,3,19,false,3,5,2,41.87773,-87.63528
TA1309000002,3,19,false,18,4,-14,41.87784,-87.62408
13206,3,19,false,7,4,-3,41.87794,-87.66201
13011,3,19,false,6,3,-3,41.87931,-87.63993
KA1503000015,3,19,false,5,8,3,41.87948,-87.6257
WL-011,3,19,false,4,5,1,41.88034,-87.64273
13300,3,19,false,72,48,-24,41.88097,-87.61675
13008,3,19,false,38,30,-8,41.88105,-87.62408
TA1305000006,3,19,false,4,8,4,41.88122,-87.6296
TA1307000120,3,19,false,16,15,-1,41.88188,-87.64879
13341,3,19,false,8,7,-1,41.88208,-87.63985
13036,3,19,false,7,8,1,41.8821,-87.62513
TA1305000032,3,19,false,13,8,-5,41.88218,-87.64109
13353,3,19,false,2,6,4,41.88283,-87.6612
13409,3,19,false,6,12,6,41.8831,-87.6511
WL-012,3,19,false,12,6,-6,41.88337,-87.6412
13053,3,19,false,22,13,-9,41.88365,-87.64863
13001,3,19,false,22,14,-8,41.88397,-87.62459
18062,3,19,false,12,9,-3,41.88412,-87.65427
TA1306000010,3,19,false,5,7,2,41.88419,-87.62961
TA1305000030,3,19,false,2,5,3,41.88459,-87.63178
15535,3,19,false,16,7,-9,41.8846,-87.64455
TA1305000029,3,19,false,5,11,6,41.88466,-87.62787
13263,3,19,false,22,11,-11,41.88467,-87.61952
TA1306000015,3,19,false,12,13,1,41.88549,-87.65232
13021,3,19,false,8,5,-3,41.88559,-87.64184
KA1503000012,3,19,false,8,8,0,41.88599,-87.63089
TA1305000011,3,19,false,19,12,-7,41.886,-87.62418
TA1308000029,3,19,false,6,7,1,41.88673,-87.62225
TA1307000131,3,19,false,4,21,17,41.88688,-87.62606
KA1503000064,3,19,false,23,23,0,41.88697,-87.61281
TA1306000003,3,19,false,12,18,6,41.88867,-87.64442
KA1503000043,3,19,false,10,11,1,41.88918,-87.63851
13050,3,19,false,8,12,4,41.88919,-87.62775
13432,3,19,false,6,2,-4,41.88989,-87.67149
TA1307000151,3,19,false,3,13,10,41.88993,-87.63427
KA1503000044,3,19,false,4,5,1,41.89018,-87.6262
13427,3,19,false,23,4,-19,41.89054,-87.62205
13430,3,19,false,17,29,12,41.89077,-87.63169
TA1306000013,3,19,false,21,15,-6,41.89083,-87.61852
RN-,3,19,false,8,11,3,41.89102,-87.63546
13434,3,19,false,6,6,0,41.89108,-87.66663
TA1307000117,3,19,false,16,21,5,41.89144,-87.62675
13033,3,19,false,12,19,7,41.8916,-87.64835
13194,3,19,false,4,8,4,41.8918,-87.65878
TA1305000003,3,19,false,16,21,5,41.89187,-87.62061
13022,3,19,false,102,131,29,41.89227,-87.61205
TA1306000029,3,19,false,14,16,2,41.89256,-87.61449
13265,3,19,false,5,9,4,41.89383,-87.64172
13045,3,19,false,19,13,-6,41.89403,-87.62931
13016,3,19,false,10,3,-7,41.89431,-87.62277
KA1503000041,3,19,false,10,2,-8,41.89452,-87.61798
13196,3,19,false,9,7,-2,41.89455,-87.65345
TA1307000062,3,19,false,6,2,-4,41.89466,-87.63839
TA1306000012,3,19,false,20,15,-5,41.89475,-87.63438
KP1705001026,3,19,false,7,7,0,41.89483,-87.6323
637,3,19,false,3,7,4,41.89563,-87.67209
13132,3,19,false,2,11,9,41.89573,-87.67718
15530,3,19,false,16,17,1,41.89575,-87.62596
13247,3,19,false,1,6,5,41.89597,-87.66775
TA1305000020,3,19,false,9,9,0,41.89636,-87.65406
13289,3,19,false,8,6,-2,41.89638,-87.661
13303,3,19,false,8,8,0,41.89672,-87.63088
13017,3,19,false,12,4,-8,41.89676,-87.6357
13338,3,19,false,16,8,-8,41.89697,-87.62173
TA1307000061,3,19,false,6,3,-3,41.89745,-87.62873
13034,3,19,false,14,8,-6,41.89754,-87.62352
TA1306000009,3,19,false,8,5,-3,41.89772,-87.64299
620,3,19,false,6,3,-3,41.89817,-87.63754
KA1504000103,3,19,false,7,1,-6,41.89842,-87.68659
15529,3,19,false,14,11,-3,41.89858,-87.62206
TA1307000128,3,19,false,23,10,-13,41.89896,-87.6299
657,3,19,false,4,5,1,41.89918,-87.6722
13248,3,19,false,5,6,1,41.89964,-87.66788
TA1306000011,3,19,false,9,20,11,41.89994,-87.63443
13290,3,19,false,5,3,-2,41.90069,-87.66259
13042,3,19,false,61,67,6,41.90097,-87.62377
KA1504000133,3,19,false,19,27,8,41.90234,-87.62773
TA1306000006,3,19,false,4,9,5,41.90292,-87.63772
TA1307000039,3,19,false,21,25,4,41.90294,-87.63137
TA1305000034,3,19,false,5,9,4,41.90313,-87.67391
KA1504000135,3,19,false,40,38,-2,41.90319,-87.63439
13136,3,19,false,6,7,1,41.90326,-87.67845
13061,3,19,false,10,9,-1,41.90342,-87.66779
KA1504000079,3,19,false,12,17,5,41.9035,-87.64334
TA1307000115,3,19,false,2,9,7,41.9046,-87.64056
TA1308000049,3,19,false,11,13,2,41.90672,-87.6349
KA1504000134,3,19,false,11,17,6,41.90687,-87.6262
13224,3,19,false,9,11,2,41.90706,-87.66725
TA1307000143,3,19,false,4,7,3,41.90762,-87.63854
13221,3,19,false,16,10,-6,41.90765,-87.67254
TA1309000024,3,19,false,19,14,-5,41.908,-87.63152
TA1305000041,3,19,false,17,15,-2,41.9094,-87.67769
331,3,19,false,9,18,9,41.90965,-87.64812
TA1305000037,3,19,false,9,11,2,41.91018,-87.67003
TA1306000008,3,19,false,6,8,2,41.9102,-87.6435
TA1308000005,3,19,false,9,6,-3,41.91042,-87.68238
13257,3,19,false,7,4,-3,41.91054,-87.68956
13154,3,19,false,12,9,-3,41.91054,-87.65312
13058,3,19,false,10,15,5,41.91059,-87.64942
TA1307000038,3,19,false,15,7,-8,41.91138,-87.63868
LF-005,3,19,false,72,236,164,41.91172,-87.62681
13128,3,19,false,16,9,-7,41.91197,-87.63197
TA1308000050,3,19,false,32,33,1,41.91211,-87.6347
13243,3,19,false,5,9,4,41.91262,-87.6814
TA1306000032,3,19,false,15,13,-2,41.9137,-87.65285
TA1307000166,3,19,false,5,9,4,41.91386,-87.64877
15655,3,19,false,5,7,2,41.91401,-87.70514
18017,3,19,false,7,4,-3,41.91416,-87.71676
TA1306000007,3,19,false,3,11,8,41.91469,-87.64333
13068,3,19,false,6,5,-1,41.91554,-87.68703
13179,3,19,false,32,26,-6,41.9157,-87.63461
13133,3,19,false,6,11,5,41.91598,-87.67733
15650,3,19,false,5,1,-4,41.91711,-87.71023
15651,3,19,false,6,8,2,41.91752,-87.70181
TA1309000006,3,19,false,10,23,13,41.91809,-87.64375
13146,3,19,false,24,25,1,41.91831,-87.63629
13059,3,19,false,20,18,-2,41.91845,-87.65222
13192,3,19,false,15,15,0,41.91995,-87.64884
13288,3,19,false,9,3,-6,41.92008,-87.67788
TA1309000030,3,19,false,12,11,-1,41.92077,-87.66372
TA1309000033,3,19,false,13,16,3,41.92158,-87.65381
13193,3,19,false,30,32,2,41.92182,-87.64412
13191,3,19,false,11,16,5,41.92217,-87.63891
13084,3,19,false,6,5,-1,41.92268,-87.69715
LP-,3,19,false,11,24,13,41.92396,-87.63584
TA1307000001,3,19,false,11,4,-7,41.92535,-87.66581
TA1306000016,3,19,false,10,9,-1,41.9256,-87.65371
TA1309000019,3,19,false,25,38,13,41.92586,-87.63897
TA1309000058,3,19,false,18,18,0,41.92591,-87.64927
TA1308000001,3,19,false,55,37,-18,41.92627,-87.63086
13124,3,19,false,11,11,0,41.92675,-87.63444
TA1309000023,3,19,false,27,14,-13,41.9287,-87.65383
TA1307000113,3,19,false,14,18,4,41.92878,-87.66391
13296,3,19,false,1,6,5,41.92883,-87.66852
TA1309000059,3,19,false,6,3,-3,41.92889,-87.65898
TA1309000061,3,19,false,19,28,9,41.92915,-87.64909
TA1305000014,3,19,false,18,19,1,41.92956,-87.64313
13085,3,19,false,9,7,-2,41.92958,-87.70789
15643,3,19,false,4,5,1,41.93057,-87.7238
TA1307000142,3,19,false,15,10,-5,41.93125,-87.64432
13276,3,19,false,26,20,-6,41.93132,-87.63874
13271,3,19,false,3,6,3,41.93192,-87.67784
TA1307000064,3,19,false,6,11,5,41.93222,-87.65864
TA1306000014,3,19,false,15,10,-5,41.93242,-87.65271
TA1309000039,3,19,false,20,17,-3,41.93258,-87.63642
13294,3,19,false,6,3,-3,41.9326,-87.66595
TA1309000036,3,19,false,10,16,6,41.93313,-87.64776
TA1307000006,3,19,false,10,7,-3,41.93571,-87.6636
TA1307000052,3,19,false,8,15,7,41.93628,-87.65266
TA1307000136,3,19,false,9,13,4,41.9365,-87.64755
TA1307000041,3,19,false,22,23,1,41.93669,-87.63683
13137,3,19,false,30,23,-7,41.9376,-87.6441
TA1309000042,3,19,false,13,8,-5,41.93937,-87.66836
13229,3,19,false,12,10,-2,41.93946,-87.66376
TA1308000019,3,19,false,10,5,-5,41.93973,-87.65886
13277,3,19,false,19,15,-4,41.9401,-87.64546
TA1307000134,3,19,false,11,14,3,41.94016,-87.65303
TA1309000049,3,19,false,17,15,-2,41.94077,-87.63919
TA1307000138,3,19,false,3,5,2,41.94334,-87.67094
TA1309000025,3,19,false,22,21,-1,41.94368,-87.64894
13071,3,19,false,14,10,-4,41.94373,-87.66401
632,3,19,false,18,12,-6,41.94453,-87.6547
13278,3,19,false,9,7,-2,41.94553,-87.64644
13235,3,19,false,9,6,-3,41.94814,-87.66396
13325,3,19,false,11,13,2,41.94907,-87.64863
TA1307000126,3,19,false,12,18,6,41.94936,-87.65451
TA1307000150,3,19,false,19,14,-5,41.94945,-87.64646
13319,3,19,false,4,5,1,41.95069,-87.6687
TA1307000127,3,19,false,9,12,3,41.9508,-87.65918
13323,3,19,false,11,8,-3,41.95282,-87.65
13063,3,19,false,13,2,-11,41.95424,-87.65441
TA1308000022,3,19,false,6,12,6,41.95438,-87.64805
TA1309000026,3,19,false,4,9,5,41.95601,-87.6802
13379,3,19,false,5,6,1,41.95786,-87.6495
TA1309000027,3,19,false,5,1,-4,41.9585,-87.65499
13389,3,19,false,12,9,-3,41.961,-87.64958
TA1307000144,3,19,false,4,5,1,41.96142,-87.6762
KA1503000022,3,19,false,5,5,0,41.96158,-87.66609
TA1307000107,3,19,false,6,13,7,41.96164,-87.65464
TA1307000156,3,19,false,4,7,3,41.96301,-87.68479
TA1308000012,3,19,false,25,21,-4,41.96398,-87.63818
13074,3,19,false,8,6,-2,41.96521,-87.6582
639,3,19,false,24,11,-13,41.96584,-87.64538
TA1309000014,3,19,false,2,8,6,41.96709,-87.66744
TA1307000119,3,19,false,10,6,-4,41.96796,-87.65
TA1308000021,3,19,false,6,5,-1,41.96883,-87.65765
TA1309000066,3,19,false,7,5,-2,41.9691,-87.67423
TA1309000035,3,19,false,7,7,0,41.97335,-87.66785
13108,3,19,false,4,7,3,41.97379,-87.65971
KA1504000146,3,19,false,5,4,-1,41.978,-87.66805
13109,3,19,false,5,5,0,41.97835,-87.65976
KA1504000151,3,19,false,2,6,4,41.98359,-87.66916
KA1504000152,3,19,false,11,12,1,41.98403,-87.65231
15575,3,19,false,3,11,8,41.98975,-87.66014
KA1504000129,3,19,false,1,5,4,41.99417,-87.68945
15571,3,19,false,4,6,2,41.99478,-87.66028
E008,3,19,false,4,5,1,42.05049,-87.67782
KA1503000014,3,19,true,5,12,7,41.7851,-87.60108
KA1503000071,3,19,true,5,5,0,41.79148,-87.59988
KA1504000076,3,19,true,7,5,-2,41.7943,-87.60145
TA1308000009,3,19,true,14,11,-3,41.79522,-87.58075
KA1503000059,3,19,true,6,5,-1,41.79952,-87.58643
TA1309000037,3,19,true,9,5,-4,41.79957,-87.59474
KA1503000007,3,19,true,6,5,-1,41.80242,-87.58689
TA1308000002,3,19,true,2,5,3,41.80983,-87.59937
TA1308000045,3,19,true,4,5,1,41.83062,-87.64129
13216,3,19,true,6,5,-1,41.83473,-87.62581
13217,3,19,true,6,9,3,41.83488,-87.61792
13215,3,19,true,3,5,2,41.83634,-87.6135
TA1308000046,3,19,true,5,4,-1,41.83779,-87.65115
TA1309000055,3,19,true,11,15,4,41.8382,-87.64514
TA1307000048,3,19,true,4,9,5,41.83855,-87.60821
TA1308000036,3,19,true,11,5,-6,41.83883,-87.62186
TA1307000139,3,19,true,6,12,6,41.84205,-87.61698
TA1307000005,3,19,true,8,4,-4,41.84569,-87.6225
TA1305000001,3,19,true,5,3,-2,41.85262,-87.6265
13075,3,19,true,8,4,-4,41.8531,-87.63192
15546,3,19,true,1,5,4,41.85416,-87.61916
13307,3,19,true,6,3,-3,41.85489,-87.66359
13089,3,19,true,5,3,-2,41.85497,-87.67567
15545,3,19,true,40,35,-5,41.85627,-87.61334
13135,3,19,true,4,8,4,41.85753,-87.66157
13102,3,19,true,5,7,2,41.85762,-87.61942
13150,3,19,true,4,8,4,41.85783,-87.62455
TA1307000159,3,19,true,5,4,-1,41.8579,-87.6687
13163,3,19,true,4,5,1,41.85808,-87.65108
13164,3,19,true,9,1,-8,41.85818,-87.65648
SL-012,3,19,true,3,11,8,41.86038,-87.62581
TA1306000002,3,19,true,4,8,4,41.86238,-87.65108
TA1307000124,3,19,true,8,13,5,41.86411,-87.62372
TA1309000001,3,19,true,5,6,1,41.86488,-87.64708
13354,3,19,true,7,1,-6,41.86524,-87.66651
13431,3,19,true,15,15,0,41.8661,-87.60728
WL-008,3,19,true,10,5,-5,41.86712,-87.64108
TA1305000002,3,19,true,18,22,4,41.86721,-87.62597
15544,3,19,true,13,15,2,41.86723,-87.61536
KA1706005007,3,19,true,11,8,-3,41.86749,-87.63219
SL-005,3,19,true,16,27,11,41.8679,-87.62304
644,3,19,true,5,8,3,41.86859,-87.68625
13139,3,19,true,10,5,-5,41.86893,-87.65913
13160,3,19,true,11,7,-4,41.86947,-87.65548
15550,3,19,true,3,5,2,41.87024,-87.63947
TA1309000010,3,19,true,21,6,-15,41.87074,-87.62574
TA1309000064,3,19,true,10,7,-3,41.87127,-87.67369
TA1307000130,3,19,true,9,4,-5,41.87178,-87.65103
TA1307000121,3,19,true,7,4,-3,41.87184,-87.64664
SL-008,3,19,true,11,14,3,41.87209,-87.62956
13332,3,19,true,13,23,10,41.87219,-87.6615
SL-011,3,19,true,3,12,9,41.87256,-87.63356
623,3,19,true,6,8,2,41.87272,-87.62399
KA1504000104,3,19,true,6,3,-3,41.87296,-87.66912
TA1306000025,3,19,true,6,4,-2,41.87464,-87.65703
13028,3,19,true,10,3,-7,41.87475,-87.64981
SL-010,3,19,true,9,9,0,41.87501,-87.63309
15541,3,19,true,11,5,-6,41.8758,-87.62086
624,3,19,true,4,5,1,41.87626,-87.62923
TA1305000035,3,19,true,1,5,4,41.87716,-87.62787
15539,3,19,true,8,11,3,41.87763,-87.64405
13158,3,19,true,15,26,11,41.87764,-87.64957
13157,3,19,true,13,13,0,41.87773,-87.6548
TA1305000025,3,19,true,9,9,0,41.87773,-87.63528
TA1309000002,3,19,true,8,7,-1,41.87784,-87.62408
13206,3,19,true,4,7,3,41.87794,-87.66201
638,3,19,true,10,4,-6,41.87827,-87.64078
13011,3,19,true,18,4,-14,41.87931,-87.63993
WL-011,3,19,true,7,3,-4,41.88034,-87.64273
13156,3,19,true,6,4,-2,41.88042,-87.65554
13300,3,19,true,32,32,0,41.88097,-87.61675
13008,3,19,true,17,8,-9,41.88105,-87.62408
TA1305000006,3,19,true,8,3,-5,41.88122,-87.6296
TA1307000120,3,19,true,23,31,8,41.88188,-87.64879
13341,3,19,true,14,9,-5,41.88208,-87.63985
13036,3,19,true,10,5,-5,41.8821,-87.62513
TA1305000032,3,19,true,33,17,-16,41.88218,-87.64109
13353,3,19,true,9,11,2,41.88283,-87.6612
13409,3,19,true,4,17,13,41.8831,-87.6511
WL-012,3,19,true,17,4,-13,41.88337,-87.6412
13053,3,19,true,16,16,0,41.88365,-87.64863
13001,3,19,true,15,5,-10,41.88397,-87.62459
13155,3,19,true,6,5,-1,41.88407,-87.65689
18062,3,19,true,13,13,0,41.88412,-87.65427
TA1306000010,3,19,true,18,18,0,41.88419,-87.62961
TA1305000030,3,19,true,7,5,-2,41.88459,-87.63178
15535,3,19,true,30,14,-16,41.8846,-87.64455
TA1305000029,3,19,true,14,5,-9,41.88466,-87.62787
13263,3,19,true,22,13,-9,41.88467,-87.61952
TA1306000015,3,19,true,17,8,-9,41.88549,-87.65232
13021,3,19,true,12,15,3,41.88559,-87.64184
TA1307000111,3,19,true,7,4,-3,41.88582,-87.63548
13073,3,19,true,10,3,-7,41.88592,-87.66717
KA1503000012,3,19,true,18,6,-12,41.88599,-87.63089
TA1305000011,3,19,true,6,8,2,41.886,-87.62418
15534,3,19,true,6,12,6,41.88627,-87.61749
13197,3,19,true,5,4,-1,41.8866,-87.65816
TA1308000029,3,19,true,5,6,1,41.88673,-87.62225
TA1307000131,3,19,true,19,6,-13,41.88688,-87.62606
KA1503000064,3,19,true,17,16,-1,41.88697,-87.61281
TA1305000022,3,19,true,8,7,-1,41.88817,-87.63656
TA1306000003,3,19,true,33,27,-6,41.88867,-87.64442
KA1503000043,3,19,true,20,19,-1,41.88918,-87.63851
13050,3,19,true,11,10,-1,41.88919,-87.62775
TA1307000151,3,19,true,14,8,-6,41.88993,-87.63427
636,3,19,true,6,9,3,41.88997,-87.63662
13427,3,19,true,11,5,-6,41.89054,-87.62205
13430,3,19,true,33,35,2,41.89077,-87.63169
TA1306000013,3,19,true,13,19,6,41.89083,-87.61852
RN-,3,19,true,12,9,-3,41.89102,-87.63546
TA1308000006,3,19,true,5,4,-1,41.89128,-87.67686
TA1307000117,3,19,true,22,15,-7,41.89144,-87.62675
13033,3,19,true,24,15,-9,41.8916,-87.64835
13194,3,19,true,10,10,0,41.8918,-87.65878
TA1305000003,3,19,true,17,17,0,41.89187,-87.62061
13022,3,19,true,42,38,-4,41.89227,-87.61205
TA1306000029,3,19,true,18,18,0,41.89256,-87.61449
13265,3,19,true,15,21,6,41.89383,-87.64172
13045,3,19,true,19,23,4,41.89403,-87.62931
13016,3,19,true,34,5,-29,41.89431,-87.62277
KA1503000041,3,19,true,14,10,-4,41.89452,-87.61798
13196,3,19,true,5,8,3,41.89455,-87.65345
TA1307000062,3,19,true,7,13,6,41.89466,-87.63839
TA1306000012,3,19,true,19,31,12,41.89475,-87.63438
KP1705001026,3,19,true,13,22,9,41.89483,-87.6323
18058,3,19,true,2,7,5,41.8955,-87.68201
637,3,19,true,3,13,10,41.89563,-87.67209
13132,3,19,true,11,18,7,41.89573,-87.67718
15530,3,19,true,19,19,0,41.89575,-87.62596
18003,3,19,true,5,6,1,41.89575,-87.62011
13247,3,19,true,10,9,-1,41.89597,-87.66775
TA1305000020,3,19,true,6,10,4,41.89636,-87.65406
13289,3,19,true,7,21,14,41.89638,-87.661
13303,3,19,true,12,14,2,41.89672,-87.63088
13017,3,19,true,10,12,2,41.89676,-87.6357
13338,3,19,true,13,8,-5,41.89697,-87.62173
TA1307000061,3,19,true,14,10,-4,41.89745,-87.62873
13034,3,19,true,8,6,-2,41.89754,-87.62352
TA1306000009,3,19,true,13,13,0,41.89772,-87.64299
620,3,19,true,9,8,-1,41.89817,-87.63754
KA1504000103,3,19,true,6,6,0,41.89842,-87.68659
15529,3,19,true,22,9,-13,41.89858,-87.62206
TA1307000128,3,19,true,19,27,8,41.89896,-87.6299
657,3,19,true,3,7,4,41.89918,-87.6722
KA1504000117,3,19,true,6,2,-4,41.89936,-87.64848
13248,3,19,true,7,15,8,41.89964,-87.66788
TA1306000011,3,19,true,8,23,15,41.89994,-87.63443
KA1504000116,3,19,true,9,8,-1,41.90023,-87.64299
17660,3,19,true,7,7,0,41.90036,-87.69671
13290,3,19,true,5,5,0,41.90069,-87.66259
13042,3,19,true,46,26,-20,41.90097,-87.62377
TA1307000070,3,19,true,6,7,1,41.90133,-87.67742
KA1504000133,3,19,true,22,26,4,41.90234,-87.62773
13241,3,19,true,3,5,2,41.9029,-87.68731
TA1306000006,3,19,true,3,13,10,41.90292,-87.63772
TA1307000039,3,19,true,45,42,-3,41.90294,-87.63137
13256,3,19,true,2,5,3,41.90302,-87.69749
TA1305000034,3,19,true,11,17,6,41.90313,-87.67391
KA1504000135,3,19,true,34,55,21,41.90319,-87.63439
13136,3,19,true,12,16,4,41.90326,-87.67845
13061,3,19,true,19,21,2,41.90342,-87.66779
KA1504000079,3,19,true,13,14,1,41.9035,-87.64334
TA1307000115,3,19,true,9,16,7,41.9046,-87.64056
TA1308000049,3,19,true,15,24,9,41.90672,-87.6349
KA1504000134,3,19,true,14,16,2,41.90687,-87.6262
13224,3,19,true,6,10,4,41.90706,-87.66725
TA1307000143,3,19,true,3,8,5,41.90762,-87.63854
13221,3,19,true,14,14,0,41.90765,-87.67254
TA1309000024,3,19,true,17,20,3,41.908,-87.63152
TA1305000041,3,19,true,20,21,1,41.9094,-87.67769
331,3,19,true,20,26,6,41.90965,-87.64812
15653,3,19,true,5,9,4,41.90979,-87.7053
TA1305000037,3,19,true,9,18,9,41.91018,-87.67003
TA1306000008,3,19,true,6,17,11,41.9102,-87.6435
TA1308000005,3,19,true,9,11,2,41.91042,-87.68238
13258,3,19,true,8,2,-6,41.91043,-87.69718
13257,3,19,true,3,6,3,41.91054,-87.68956
13154,3,19,true,16,14,-2,41.91054,-87.65312
13058,3,19,true,12,14,2,41.91059,-87.64942
TA1307000038,3,19,true,10,17,7,41.91138,-87.63868
LF-005,3,19,true,70,143,73,41.91172,-87.62681
13128,3,19,true,13,17,4,41.91197,-87.63197
TA1308000050,3,19,true,31,32,1,41.91211,-87.6347
13243,3,19,true,12,13,1,41.91262,-87.6814
TA1306000032,3,19,true,8,10,2,41.9137,-87.65285
TA1307000166,3,19,true,18,9,-9,41.91386,-87.64877
15655,3,19,true,2,6,4,41.91401,-87.70514
18017,3,19,true,2,6,4,41.91416,-87.71676
18067,3,19,true,10,10,0,41.9146,-87.66796
TA1306000007,3,19,true,12,7,-5,41.91469,-87.64333
13068,3,19,true,7,9,2,41.91554,-87.68703
13179,3,19,true,29,33,4,41.9157,-87.63461
13133,3,19,true,11,11,0,41.91598,-87.67733
TA1305000039,3,19,true,6,4,-2,41.9163,-87.66749
15651,3,19,true,3,7,4,41.91752,-87.70181
13266,3,19,true,5,5,0,41.91774,-87.69142
TA1309000006,3,19,true,17,18,1,41.91809,-87.64375
TA1307000163,3,19,true,6,4,-2,41.91821,-87.65696
13146,3,19,true,23,25,2,41.91831,-87.63629
13059,3,19,true,17,27,10,41.91845,-87.65222
13192,3,19,true,21,22,1,41.91995,-87.64884
13288,3,19,true,1,10,9,41.92008,-87.67788
13242,3,19,true,3,10,7,41.92021,-87.69266
TA1309000030,3,19,true,12,14,2,41.92077,-87.66372
TA1309000033,3,19,true,9,7,-2,41.92158,-87.65381
13193,3,19,true,27,36,9,41.92182,-87.64412
13191,3,19,true,5,16,11,41.92217,-87.63891
13084,3,19,true,5,14,9,41.92268,-87.69715
LP-,3,19,true,11,23,12,41.92396,-87.63584
15648,3,19,true,6,5,-1,41.92464,-87.68931
TA1307000001,3,19,true,9,17,8,41.92535,-87.66581
TA1306000026,3,19,true,14,12,-2,41.92558,-87.65842
TA1306000016,3,19,true,18,4,-14,41.9256,-87.65371
TA1309000019,3,19,true,13,19,6,41.92586,-87.63897
TA1309000058,3,19,true,32,25,-7,41.92591,-87.64927
TA1308000001,3,19,true,52,36,-16,41.92627,-87.63086
15646,3,19,true,5,3,-2,41.92668,-87.6977
13124,3,19,true,7,7,0,41.92675,-87.63444
TA1309000023,3,19,true,19,19,0,41.9287,-87.65383
TA1307000113,3,19,true,16,15,-1,41.92878,-87.66391
13296,3,19,true,5,10,5,41.92883,-87.66852
TA1309000059,3,19,true,7,11,4,41.92889,-87.65898
TA1309000061,3,19,true,15,19,4,41.92915,-87.64909
TA1305000014,3,19,true,24,27,3,41.92956,-87.64313
13085,3,19,true,5,6,1,41.92958,-87.70789
TA1307000142,3,19,true,18,15,-3,41.93125,-87.64432
13276,3,19,true,12,27,15,41.93132,-87.63874
13271,3,19,true,5,7,2,41.93192,-87.67784
TA1307000064,3,19,true,14,12,-2,41.93222,-87.65864
TA1306000014,3,19,true,12,9,-3,41.93242,-87.65271
TA1309000039,3,19,true,28,29,1,41.93258,-87.63642
13294,3,19,true,5,4,-1,41.9326,-87.66595
TA1309000036,3,19,true,12,24,12,41.93313,-87.64776
TA1307000006,3,19,true,10,12,2,41.93571,-87.6636
13269,3,19,true,11,4,-7,41.93609,-87.66983
TA1307000052,3,19,true,16,18,2,41.93628,-87.65266
TA1307000136,3,19,true,16,22,6,41.9365,-87.64755
TA1307000041,3,19,true,21,31,10,41.93669,-87.63683
13137,3,19,true,23,31,8,41.9376,-87.6441
KA17018068,3,19,true,6,2,-4,41.93935,-87.68327
TA1309000042,3,19,true,14,7,-7,41.93937,-87.66836
13229,3,19,true,5,9,4,41.93946,-87.66376
TA1308000019,3,19,true,7,11,4,41.93973,-87.65886
13277,3,19,true,19,14,-5,41.9401,-87.64546
TA1307000134,3,19,true,17,17,0,41.94016,-87.65303
TA1309000049,3,19,true,8,11,3,41.94077,-87.63919
TA1307000138,3,19,true,7,4,-3,41.94334,-87.67094
13144,3,19,true,3,6,3,41.9434,-87.67964
TA1309000025,3,19,true,13,17,4,41.94368,-87.64894
13071,3,19,true,19,12,-7,41.94373,-87.66401
632,3,19,true,8,19,11,41.94453,-87.6547
15631,3,19,true,1,5,4,41.94524,-87.70665
13278,3,19,true,19,21,2,41.94553,-87.64644
15632,3,19,true,6,4,-2,41.94664,-87.69463
13235,3,19,true,23,22,-1,41.94814,-87.66396
13253,3,19,true,5,2,-3,41.9488,-87.67527
13325,3,19,true,18,23,5,41.94907,-87.64863
TA1307000126,3,19,true,12,6,-6,41.94936,-87.65451
TA1307000150,3,19,true,14,23,9,41.94945,-87.64646
13319,3,19,true,3,7,4,41.95069,-87.6687
TA1307000127,3,19,true,8,11,3,41.9508,-87.65918
13323,3,19,true,7,10,3,41.95282,-87.65
KA1504000139,3,19,true,5,1,-4,41.954,-87.71909
TA1309000043,3,19,true,3,5,2,41.95417,-87.66434
13063,3,19,true,12,7,-5,41.95424,-87.65441
TA1308000022,3,19,true,21,13,-8,41.95438,-87.64805
TA1307000149,3,19,true,11,4,-7,41.95467,-87.67392
TA1309000026,3,19,true,4,9,5,41.95601,-87.6802
13249,3,19,true,3,7,4,41.95606,-87.66885
13379,3,19,true,12,17,5,41.95786,-87.6495
TA1309000018,3,19,true,7,1,-6,41.95791,-87.67357
TA1309000027,3,19,true,8,9,1,41.9585,-87.65499
13389,3,19,true,11,13,2,41.961,-87.64958
15622,3,19,true,3,5,2,41.96108,-87.69544
TA1307000144,3,19,true,4,6,2,41.96142,-87.6762
TA1309000021,3,19,true,5,2,-3,41.9615,-87.6714
15623,3,19,true,2,6,4,41.96154,-87.69117
KA1503000022,3,19,true,6,8,2,41.96158,-87.66609
TA1307000107,3,19,true,7,13,6,41.96164,-87.65464
TA1307000156,3,19,true,9,10,1,41.96301,-87.68479
TA1308000012,3,19,true,22,17,-5,41.96398,-87.63818
13074,3,19,true,5,8,3,41.96521,-87.6582
639,3,19,true,23,9,-14,41.96584,-87.64538
KA1504000093,3,19,true,2,6,4,41.96587,-87.69365
TA1307000140,3,19,true,7,3,-4,41.96643,-87.68865
TA1309000014,3,19,true,8,14,6,41.96709,-87.66744
TA1307000158,3,19,true,6,7,1,41.9671,-87.67904
TA1307000119,3,19,true,3,6,3,41.96796,-87.65
TA1308000021,3,19,true,2,10,8,41.96883,-87.65765
TA1309000015,3,19,true,1,6,5,41.96889,-87.68401
TA1309000066,3,19,true,12,13,1,41.9691,-87.67423
KA1504000171,3,19,true,5,4,-1,41.97161,-87.65016
TA1309000035,3,19,true,14,11,-3,41.97335,-87.66785
13108,3,19,true,10,7,-3,41.97379,-87.65971
KA1504000160,3,19,true,5,3,-2,41.97564,-87.70143
KA1504000146,3,19,true,6,13,7,41.978,-87.66805
13109,3,19,true,7,7,0,41.97835,-87.65976
KA1504000152,3,19,true,14,12,-2,41.98403,-87.65231
15578,3,19,true,4,7,3,41.98405,-87.66027
15575,3,19,true,5,2,-3,41.98975,-87.66014
15571,3,19,true,4,12,8,41.99478,-87.66028
RP-009,3,19,true,5,5,0,42.00107,-87.66122
660,3,19,true,1,5,4,42.00458,-87.66143
KA1504000162,3,19,true,5,2,-3,42.00907,-87.67422
523,3,19,true,2,6,4,42.02089,-87.66505
15491,3,20,false,2,14,12,41.78096,-87.57624
KA1503000014,3,20,false,7,5,-2,41.7851,-87.60108
TA1308000009,3,20,false,13,11,-2,41.79522,-87.58075
KA1503000059,3,20,false,3,6,3,41.79952,-87.58643
TA1309000037,3,20,false,9,2,-7,41.79957,-87.59474
13398,3,20,false,2,7,5,41.80256,-87.59035
TA1309000055,3,20,false,6,3,-3,41.8382,-87.64514
TA1307000048,3,20,false,20,18,-2,41.83855,-87.60821
TA1308000036,3,20,false,1,5,4,41.83883,-87.62186
TA1307000139,3,20,false,1,6,5,41.84205,-87.61698
TA1308000013,3,20,false,5,2,-3,41.84719,-87.64681
13075,3,20,false,14,13,-1,41.8531,-87.63192
15545,3,20,false,7,13,6,41.85627,-87.61334
13135,3,20,false,8,3,-5,41.85753,-87.66157
13102,3,20,false,9,12,3,41.85762,-87.61942
13150,3,20,false,3,6,3,41.85783,-87.62455
TA1307000159,3,20,false,5,2,-3,41.8579,-87.6687
13164,3,20,false,5,1,-4,41.85818,-87.65648
SL-012,3,20,false,3,7,4,41.86038,-87.62581
TA1307000124,3,20,false,10,7,-3,41.86411,-87.62372
13029,3,20,false,5,1,-4,41.86531,-87.6179
13431,3,20,false,6,7,1,41.8661,-87.60728
WL-008,3,20,false,1,5,4,41.86712,-87.64108
TA1305000002,3,20,false,14,15,1,41.86721,-87.62597
15544,3,20,false,17,17,0,41.86723,-87.61536
SL-005,3,20,false,21,18,-3,41.8679,-87.62304
13160,3,20,false,3,6,3,41.86947,-87.65548
TA1309000010,3,20,false,11,12,1,41.87074,-87.62574
SL-009,3,20,false,4,5,1,41.87081,-87.63121
SL-008,3,20,false,8,13,5,41.87209,-87.62956
623,3,20,false,27,18,-9,41.87272,-87.62399
TA1306000025,3,20,false,1,8,7,41.87464,-87.65703
SL-010,3,20,false,9,3,-6,41.87501,-87.63309
16907,3,20,false,4,5,1,41.87568,-87.71549
15541,3,20,false,13,29,16,41.8758,-87.62086
TA1305000010,3,20,false,11,6,-5,41.87623,-87.62444
13157,3,20,false,4,6,2,41.87773,-87.6548
TA1305000025,3,20,false,7,8,1,41.87773,-87.63528
13011,3,20,false,5,3,-2,41.87931,-87.63993
TA1309000008,3,20,false,3,11,8,41.87933,-87.6355
13156,3,20,false,5,1,-4,41.88042,-87.65554
13300,3,20,false,54,39,-15,41.88097,-87.61675
13008,3,20,false,19,37,18,41.88105,-87.62408
TA1307000120,3,20,false,9,10,1,41.88188,-87.64879
13341,3,20,false,8,4,-4,41.88208,-87.63985
13036,3,20,false,9,6,-3,41.8821,-87.62513
TA1305000032,3,20,false,6,6,0,41.88218,-87.64109
13353,3,20,false,7,3,-4,41.88283,-87.6612
13409,3,20,false,9,2,-7,41.8831,-87.6511
WL-012,3,20,false,1,7,6,41.88337,-87.6412
13053,3,20,false,4,9,5,41.88365,-87.64863
13001,3,20,false,7,6,-1,41.88397,-87.62459
18062,3,20,false,5,1,-4,41.88412,-87.65427
TA1306000010,3,20,false,4,5,1,41.88419,-87.62961
15535,3,20,false,13,20,7,41.8846,-87.64455
13263,3,20,false,11,4,-7,41.88467,-87.61952
TA1306000015,3,20,false,20,17,-3,41.88549,-87.65232
13021,3,20,false,1,15,14,41.88559,-87.64184
TA1307000111,3,20,false,3,11,8,41.88582,-87.63548
KA1503000012,3,20,false,6,9,3,41.88599,-87.63089
TA1305000011,3,20,false,11,19,8,41.886,-87.62418
15534,3,20,false,9,9,0,41.88627,-87.61749
13197,3,20,false,3,7,4,41.8866,-87.65816
TA1308000029,3,20,false,3,8,5,41.88673,-87.62225
TA1307000131,3,20,false,10,10,0,41.88688,-87.62606
KA1503000064,3,20,false,35,31,-4,41.88697,-87.61281
TA1305000022,3,20,false,10,8,-2,41.88817,-87.63656
TA1306000003,3,20,false,9,13,4,41.88867,-87.64442
KA1503000043,3,20,false,10,16,6,41.88918,-87.63851
13050,3,20,false,8,15,7,41.88919,-87.62775
TA1307000151,3,20,false,8,10,2,41.88993,-87.63427
13427,3,20,false,8,4,-4,41.89054,-87.62205
13430,3,20,false,21,24,3,41.89077,-87.63169
TA1306000013,3,20,false,16,18,2,41.89083,-87.61852
RN-,3,20,false,5,4,-1,41.89102,-87.63546
TA1307000117,3,20,false,8,20,12,41.89144,-87.62675
13033,3,20,false,11,15,4,41.8916,-87.64835
13194,3,20,false,6,2,-4,41.8918,-87.65878
TA1305000003,3,20,false,13,18,5,41.89187,-87.62061
13022,3,20,false,90,103,13,41.89227,-87.61205
TA1306000029,3,20,false,17,21,4,41.89256,-87.61449
13265,3,20,false,12,9,-3,41.89383,-87.64172
13045,3,20,false,12,8,-4,41.89403,-87.62931
KA1503000041,3,20,false,1,12,11,41.89452,-87.61798
13196,3,20,false,7,7,0,41.89455,-87.65345
TA1307000062,3,20,false,5,4,-1,41.89466,-87.63839
TA1306000012,3,20,false,17,10,-7,41.89475,-87.63438
KP1705001026,3,20,false,10,13,3,41.89483,-87.6323
637,3,20,false,5,4,-1,41.89563,-87.67209
13132,3,20,false,3,6,3,41.89573,-87.67718
15530,3,20,false,10,9,-1,41.89575,-87.62596
TA1305000020,3,20,false,4,11,7,41.89636,-87.65406
13289,3,20,false,4,6,2,41.89638,-87.661
13303,3,20,false,7,8,1,41.89672,-87.63088
13338,3,20,false,3,8,5,41.89697,-87.62173
TA1307000061,3,20,false,9,4,-5,41.89745,-87.62873
620,3,20,false,7,1,-6,41.89817,-87.63754
15529,3,20,false,6,6,0,41.89858,-87.62206
TA1307000128,3,20,false,10,4,-6,41.89896,-87.6299
13248,3,20,false,5,6,1,41.89964,-87.66788
TA1306000011,3,20,false,14,10,-4,41.89994,-87.63443
13290,3,20,false,1,5,4,41.90069,-87.66259
13042,3,20,false,53,36,-17,41.90097,-87.62377
KA1504000133,3,20,false,7,6,-1,41.90234,-87.62773
13241,3,20,false,3,5,2,41.9029,-87.68731
TA1307000039,3,20,false,12,17,5,41.90294,-87.63137
TA1305000034,3,20,false,5,8,3,41.90313,-87.67391
KA1504000135,3,20,false,30,29,-1,41.90319,-87.63439
13136,3,20,false,6,7,1,41.90326,-87.67845
13061,3,20,false,14,19,5,41.90342,-87.66779
KA1504000079,3,20,false,11,6,-5,41.9035,-87.64334
TA1307000115,3,20,false,3,8,5,41.9046,-87.64056
TA1308000049,3,20,false,16,13,-3,41.90672,-87.6349
KA1504000134,3,20,false,6,7,1,41.90687,-87.6262
13224,3,20,false,4,8,4,41.90706,-87.66725
13221,3,20,false,3,7,4,41.90765,-87.67254
TA1309000024,3,20,false,7,11,4,41.908,-87.63152
TA1305000041,3,20,false,12,15,3,41.9094,-87.67769
331,3,20,false,10,6,-4,41.90965,-87.64812
TA1305000037,3,20,false,3,7,4,41.91018,-87.67003
TA1306000008,3,20,false,5,3,-2,41.9102,-87.6435
TA1308000005,3,20,false,2,5,3,41.91042,-87.68238
13257,3,20,false,3,6,3,41.91054,-87.68956
13154,3,20,false,8,3,-5,41.91054,-87.65312
TA1307000038,3,20,false,12,9,-3,41.91138,-87.63868
LF-005,3,20,false,106,88,-18,41.91172,-87.62681
13128,3,20,false,8,14,6,41.91197,-87.63197
TA1308000050,3,20,false,34,25,-9,41.91211,-87.6347
13243,3,20,false,9,9,0,41.91262,-87.6814
TA1306000032,3,20,false,2,7,5,41.9137,-87.65285
TA1307000166,3,20,false,2,10,8,41.91386,-87.64877
18017,3,20,false,8,10,2,41.91416,-87.71676
18067,3,20,false,8,4,-4,41.9146,-87.66796
13068,3,20,false,4,11,7,41.91554,-87.68703
13179,3,20,false,34,31,-3,41.9157,-87.63461
13133,3,20,false,10,10,0,41.91598,-87.67733
TA1309000006,3,20,false,5,6,1,41.91809,-87.64375
TA1307000163,3,20,false,6,2,-4,41.91821,-87.65696
13146,3,20,false,20,32,12,41.91831,-87.63629
13059,3,20,false,10,10,0,41.91845,-87.65222
13192,3,20,false,7,21,14,41.91995,-87.64884
13242,3,20,false,5,4,-1,41.92021,-87.69266
TA1309000030,3,20,false,8,7,-1,41.92077,-87.66372
TA1309000033,3,20,false,14,18,4,41.92158,-87.65381
13193,3,20,false,19,15,-4,41.92182,-87.64412
13191,3,20,false,6,4,-2,41.92217,-87.63891
13084,3,20,false,3,5,2,41.92268,-87.69715
LP-,3,20,false,19,15,-4,41.92396,-87.63584
TA1307000001,3,20,false,3,9,6,41.92535,-87.66581
TA1306000026,3,20,false,3,5,2,41.92558,-87.65842
TA1306000016,3,20,false,7,2,-5,41.9256,-87.65371
TA1309000019,3,20,false,18,13,-5,41.92586,-87.63897
TA1309000058,3,20,false,19,10,-9,41.92591,-87.64927
TA1308000001,3,20,false,56,45,-11,41.92627,-87.63086
15646,3,20,false,2,7,5,41.92668,-87.6977
13124,3,20,false,25,11,-14,41.92675,-87.63444
TA1309000023,3,20,false,12,17,5,41.9287,-87.65383
TA1307000113,3,20,false,18,14,-4,41.92878,-87.66391
13296,3,20,false,1,8,7,41.92883,-87.66852
TA1309000059,3,20,false,8,7,-1,41.92889,-87.65898
TA1309000061,3,20,false,8,16,8,41.92915,-87.64909
TA1308000031,3,20,false,3,9,6,41.92946,-87.68417
TA1305000014,3,20,false,5,10,5,41.92956,-87.64313
13085,3,20,false,9,5,-4,41.92958,-87.70789
15643,3,20,false,4,5,1,41.93057,-87.7238
TA1307000142,3,20,false,12,14,2,41.93125,-87.64432
13276,3,20,false,12,17,5,41.93132,-87.63874
TA1307000064,3,20,false,7,6,-1,41.93222,-87.65864
TA1306000014,3,20,false,4,9,5,41.93242,-87.65271
TA1309000039,3,20,false,25,9,-16,41.93258,-87.63642
TA1309000036,3,20,false,8,9,1,41.93313,-87.64776
TA1307000006,3,20,false,4,6,2,41.93571,-87.6636
TA1307000052,3,20,false,9,8,-1,41.93628,-87.65266
TA1307000136,3,20,false,9,6,-3,41.9365,-87.64755
TA1307000041,3,20,false,18,15,-3,41.93669,-87.63683
13137,3,20,false,16,13,-3,41.9376,-87.6441
TA1309000042,3,20,false,3,8,5,41.93937,-87.66836
13229,3,20,false,3,5,2,41.93946,-87.66376
TA1308000019,3,20,false,4,14,10,41.93973,-87.65886
13277,3,20,false,6,19,13,41.9401,-87.64546
TA1307000134,3,20,false,10,16,6,41.94016,-87.65303
TA1309000049,3,20,false,10,25,15,41.94077,-87.63919
TA1307000138,3,20,false,4,6,2,41.94334,-87.67094
TA1309000025,3,20,false,15,18,3,41.94368,-87.64894
13071,3,20,false,10,17,7,41.94373,-87.66401
632,3,20,false,19,16,-3,41.94453,-87.6547
13278,3,20,false,9,12,3,41.94553,-87.64644
13235,3,20,false,4,15,11,41.94814,-87.66396
13325,3,20,false,12,16,4,41.94907,-87.64863
TA1307000126,3,20,false,4,13,9,41.94936,-87.65451
TA1307000150,3,20,false,10,8,-2,41.94945,-87.64646
TA1307000127,3,20,false,9,9,0,41.9508,-87.65918
13323,3,20,false,4,12,8,41.95282,-87.65
13063,3,20,false,3,6,3,41.95424,-87.65441
TA1308000022,3,20,false,12,7,-5,41.95438,-87.64805
TA1309000026,3,20,false,5,1,-4,41.95601,-87.6802
13379,3,20,false,6,8,2,41.95786,-87.6495
TA1309000027,3,20,false,5,9,4,41.9585,-87.65499
13389,3,20,false,6,8,2,41.961,-87.64958
KA1503000022,3,20,false,4,5,1,41.96158,-87.66609
TA1307000107,3,20,false,10,17,7,41.96164,-87.65464
TA1308000012,3,20,false,39,24,-15,41.96398,-87.63818
639,3,20,false,7,12,5,41.96584,-87.64538
TA1309000014,3,20,false,6,2,-4,41.96709,-87.66744
TA1307000119,3,20,false,7,6,-1,41.96796,-87.65
TA1309000041,3,20,false,7,4,-3,41.96951,-87.65471
TA1309000035,3,20,false,6,4,-2,41.97335,-87.66785
13109,3,20,false,2,7,5,41.97835,-87.65976
KA1504000152,3,20,false,6,11,5,41.98403,-87.65231
15575,3,20,false,4,15,11,41.98975,-87.66014
15571,3,20,false,7,4,-3,41.99478,-87.66028
RP-009,3,20,false,4,9,5,42.00107,-87.66122
TA1308000009,3,20,true,10,9,-1,41.79522,-87.58075
TA1307000164,3,20,true,5,2,-3,41.79527,-87.59647
KA1503000052,3,20,true,1,9,8,41.79935,-87.60097
TA1308000045,3,20,true,1,5,4,41.83062,-87.64129
13216,3,20,true,6,10,4,41.83473,-87.62581
13215,3,20,true,1,6,5,41.83634,-87.6135
TA1308000046,3,20,true,3,6,3,41.83779,-87.65115
TA1309000055,3,20,true,5,8,3,41.8382,-87.64514
KA1503000038,3,20,true,7,4,-3,41.83845,-87.6354
TA1307000048,3,20,true,5,8,3,41.83855,-87.60821
TA1308000036,3,20,true,5,3,-2,41.83883,-87.62186
TA1307000139,3,20,true,8,11,3,41.84205,-87.61698
13091,3,20,true,2,6,4,41.85409,-87.68585
15545,3,20,true,10,14,4,41.85627,-87.61334
13135,3,20,true,6,3,-3,41.85753,-87.66157
13102,3,20,true,9,10,1,41.85762,-87.61942
13150,3,20,true,8,7,-1,41.85783,-87.62455
13099,3,20,true,1,6,5,41.85784,-87.64627
13164,3,20,true,4,6,2,41.85818,-87.65648
TA1306000002,3,20,true,2,7,5,41.86238,-87.65108
TA1307000124,3,20,true,4,13,9,41.86411,-87.62372
TA1309000001,3,20,true,3,5,2,41.86488,-87.64708
13431,3,20,true,18,19,1,41.8661,-87.60728
WL-008,3,20,true,5,3,-2,41.86712,-87.64108
TA1305000002,3,20,true,14,11,-3,41.86721,-87.62597
15544,3,20,true,11,7,-4,41.86723,-87.61536
SL-005,3,20,true,12,19,7,41.8679,-87.62304
13139,3,20,true,2,8,6,41.86893,-87.65913
13160,3,20,true,3,10,7,41.86947,-87.65548
15550,3,20,true,6,5,-1,41.87024,-87.63947
TA1309000010,3,20,true,9,12,3,41.87074,-87.62574
SL-009,3,20,true,2,7,5,41.87081,-87.63121
TA1309000064,3,20,true,5,1,-4,41.87127,-87.67369
TA1307000121,3,20,true,13,2,-11,41.87184,-87.64664
SL-008,3,20,true,10,15,5,41.87209,-87.62956
13332,3,20,true,6,19,13,41.87219,-87.6615
SL-011,3,20,true,7,4,-3,41.87256,-87.63356
623,3,20,true,10,8,-2,41.87272,-87.62399
KA1504000104,3,20,true,6,2,-4,41.87296,-87.66912
13028,3,20,true,5,6,1,41.87475,-87.64981
SL-010,3,20,true,1,5,4,41.87501,-87.63309
15539,3,20,true,6,8,2,41.87763,-87.64405
13158,3,20,true,6,14,8,41.87764,-87.64957
13157,3,20,true,12,11,-1,41.87773,-87.6548
13011,3,20,true,5,2,-3,41.87931,-87.63993
KA1503000015,3,20,true,6,6,0,41.87948,-87.6257
WL-011,3,20,true,4,7,3,41.88034,-87.64273
13156,3,20,true,6,7,1,41.88042,-87.65554
13300,3,20,true,19,19,0,41.88097,-87.61675
13008,3,20,true,11,4,-7,41.88105,-87.62408
TA1307000120,3,20,true,11,8,-3,41.88188,-87.64879
13341,3,20,true,10,3,-7,41.88208,-87.63985
13036,3,20,true,6,7,1,41.8821,-87.62513
TA1305000032,3,20,true,14,18,4,41.88218,-87.64109
13006,3,20,true,1,5,4,41.88268,-87.63252
13353,3,20,true,8,8,0,41.88283,-87.6612
13409,3,20,true,7,7,0,41.8831,-87.6511
WL-012,3,20,true,11,4,-7,41.88337,-87.6412
13053,3,20,true,19,10,-9,41.88365,-87.64863
13001,3,20,true,7,8,1,41.88397,-87.62459
13155,3,20,true,5,2,-3,41.88407,-87.65689
18062,3,20,true,5,6,1,41.88412,-87.65427
TA1306000010,3,20,true,15,10,-5,41.88419,-87.62961
15535,3,20,true,8,10,2,41.8846,-87.64455
TA1305000029,3,20,true,5,5,0,41.88466,-87.62787
13263,3,20,true,8,14,6,41.88467,-87.61952
TA1306000015,3,20,true,12,5,-7,41.88549,-87.65232
13021,3,20,true,9,7,-2,41.88559,-87.64184
TA1307000111,3,20,true,7,11,4,41.88582,-87.63548
KA1503000012,3,20,true,9,8,-1,41.88599,-87.63089
TA1305000011,3,20,true,17,7,-10,41.886,-87.62418
15534,3,20,true,7,10,3,41.88627,-87.61749
13197,3,20,true,1,8,7,41.8866,-87.65816
TA1307000131,3,20,true,10,8,-2,41.88688,-87.62606
KA1503000064,3,20,true,21,17,-4,41.88697,-87.61281
TA1305000022,3,20,true,8,14,6,41.88817,-87.63656
TA1306000003,3,20,true,15,21,6,41.88867,-87.64442
KA1503000043,3,20,true,19,22,3,41.88918,-87.63851
13050,3,20,true,6,7,1,41.88919,-87.62775
TA1307000151,3,20,true,9,10,1,41.88993,-87.63427
636,3,20,true,8,9,1,41.88997,-87.63662
KA1503000044,3,20,true,6,5,-1,41.89018,-87.6262
13427,3,20,true,4,6,2,41.89054,-87.62205
13430,3,20,true,23,17,-6,41.89077,-87.63169
TA1306000013,3,20,true,9,21,12,41.89083,-87.61852
RN-,3,20,true,3,12,9,41.89102,-87.63546
13434,3,20,true,3,5,2,41.89108,-87.66663
TA1307000117,3,20,true,21,11,-10,41.89144,-87.62675
13033,3,20,true,13,16,3,41.8916,-87.64835
13194,3,20,true,9,14,5,41.8918,-87.65878
TA1305000003,3,20,true,9,12,3,41.89187,-87.62061
13022,3,20,true,37,30,-7,41.89227,-87.61205
TA1306000029,3,20,true,11,21,10,41.89256,-87.61449
13265,3,20,true,14,21,7,41.89383,-87.64172
13045,3,20,true,12,21,9,41.89403,-87.62931
13016,3,20,true,7,5,-2,41.89431,-87.62277
KA1503000041,3,20,true,5,13,8,41.89452,-87.61798
13196,3,20,true,6,7,1,41.89455,-87.65345
TA1307000062,3,20,true,6,7,1,41.89466,-87.63839
TA1306000012,3,20,true,14,14,0,41.89475,-87.63438
KP1705001026,3,20,true,11,5,-6,41.89483,-87.6323
13132,3,20,true,10,8,-2,41.89573,-87.67718
15530,3,20,true,10,14,4,41.89575,-87.62596
13247,3,20,true,4,5,1,41.89597,-87.66775
TA1305000020,3,20,true,5,11,6,41.89636,-87.65406
13289,3,20,true,9,7,-2,41.89638,-87.661
13303,3,20,true,12,15,3,41.89672,-87.63088
13017,3,20,true,9,9,0,41.89676,-87.6357
13338,3,20,true,9,5,-4,41.89697,-87.62173
TA1307000061,3,20,true,11,6,-5,41.89745,-87.62873
13034,3,20,true,3,7,4,41.89754,-87.62352
TA1306000009,3,20,true,11,5,-6,41.89772,-87.64299
620,3,20,true,6,11,5,41.89817,-87.63754
KA1504000103,3,20,true,5,8,3,41.89842,-87.68659
15529,3,20,true,6,18,12,41.89858,-87.62206
TA1307000128,3,20,true,14,21,7,41.89896,-87.6299
657,3,20,true,3,7,4,41.89918,-87.6722
13248,3,20,true,12,10,-2,41.89964,-87.66788
TA1306000011,3,20,true,11,20,9,41.89994,-87.63443
KA1504000116,3,20,true,4,6,2,41.90023,-87.64299
17660,3,20,true,2,5,3,41.90036,-87.69671
13290,3,20,true,6,11,5,41.90069,-87.66259
13042,3,20,true,45,18,-27,41.90097,-87.62377
TA1307000070,3,20,true,4,9,5,41.90133,-87.67742
KA1504000133,3,20,true,10,10,0,41.90234,-87.62773
TA1306000006,3,20,true,5,6,1,41.90292,-87.63772
TA1307000039,3,20,true,25,35,10,41.90294,-87.63137
TA1305000034,3,20,true,4,10,6,41.90313,-87.67391
KA1504000135,3,20,true,30,24,-6,41.90319,-87.63439
13136,3,20,true,3,10,7,41.90326,-87.67845
13061,3,20,true,16,26,10,41.90342,-87.66779
KA1504000079,3,20,true,3,5,2,41.9035,-87.64334
TA1307000115,3,20,true,3,7,4,41.9046,-87.64056
TA1308000049,3,20,true,11,12,1,41.90672,-87.6349
KA1504000134,3,20,true,2,5,3,41.90687,-87.6262
13224,3,20,true,7,7,0,41.90706,-87.66725
13221,3,20,true,13,18,5,41.90765,-87.67254
TA1309000024,3,20,true,12,13,1,41.908,-87.63152
TA1305000041,3,20,true,16,11,-5,41.9094,-87.67769
331,3,20,true,20,12,-8,41.90965,-87.64812
TA1306000008,3,20,true,2,7,5,41.9102,-87.6435
TA1308000005,3,20,true,8,9,1,41.91042,-87.68238
13154,3,20,true,8,5,-3,41.91054,-87.65312
13058,3,20,true,5,3,-2,41.91059,-87.64942
TA1307000038,3,20,true,5,13,8,41.91138,-87.63868
LF-005,3,20,true,104,47,-57,41.91172,-87.62681
13128,3,20,true,21,8,-13,41.91197,-87.63197
TA1308000050,3,20,true,31,26,-5,41.91211,-87.6347
13243,3,20,true,18,15,-3,41.91262,-87.6814
TA1306000032,3,20,true,8,11,3,41.9137,-87.65285
TA1307000166,3,20,true,6,7,1,41.91386,-87.64877
15655,3,20,true,2,5,3,41.91401,-87.70514
18067,3,20,true,7,9,2,41.9146,-87.66796
TA1306000007,3,20,true,2,6,4,41.91469,-87.64333
13068,3,20,true,3,8,5,41.91554,-87.68703
13179,3,20,true,27,28,1,41.9157,-87.63461
13133,3,20,true,12,11,-1,41.91598,-87.67733
TA1309000029,3,20,true,1,5,4,41.9178,-87.68245
TA1309000006,3,20,true,12,13,1,41.91809,-87.64375
TA1307000163,3,20,true,7,7,0,41.91821,-87.65696
13146,3,20,true,16,17,1,41.91831,-87.63629
13059,3,20,true,12,15,3,41.91845,-87.65222
13192,3,20,true,23,18,-5,41.91995,-87.64884
13242,3,20,true,8,2,-6,41.92021,-87.69266
TA1309000030,3,20,true,9,8,-1,41.92077,-87.66372
13292,3,20,true,5,3,-2,41.92152,-87.70733
TA1309000033,3,20,true,10,12,2,41.92158,-87.65381
13193,3,20,true,22,21,-1,41.92182,-87.64412
13191,3,20,true,3,5,2,41.92217,-87.63891
13084,3,20,true,7,3,-4,41.92268,-87.69715
LP-,3,20,true,7,6,-1,41.92396,-87.63584
TA1307000001,3,20,true,7,14,7,41.92535,-87.66581
TA1306000026,3,20,true,4,22,18,41.92558,-87.65842
TA1306000016,3,20,true,7,7,0,41.9256,-87.65371
TA1309000019,3,20,true,14,17,3,41.92586,-87.63897
TA1309000058,3,20,true,17,12,-5,41.92591,-87.64927
TA1308000001,3,20,true,44,29,-15,41.92627,-87.63086
TA1309000023,3,20,true,15,16,1,41.9287,-87.65383
TA1307000113,3,20,true,17,10,-7,41.92878,-87.66391
TA1309000059,3,20,true,2,6,4,41.92889,-87.65898
TA1309000061,3,20,true,20,20,0,41.92915,-87.64909
TA1308000031,3,20,true,7,1,-6,41.92946,-87.68417
TA1305000014,3,20,true,13,16,3,41.92956,-87.64313
TA1307000142,3,20,true,9,25,16,41.93125,-87.64432
13276,3,20,true,9,11,2,41.93132,-87.63874
13271,3,20,true,6,2,-4,41.93192,-87.67784
TA1307000064,3,20,true,3,21,18,41.93222,-87.65864
TA1306000014,3,20,true,13,8,-5,41.93242,-87.65271
TA1309000039,3,20,true,14,30,16,41.93258,-87.63642
TA1309000036,3,20,true,7,12,5,41.93313,-87.64776
TA1307000006,3,20,true,9,9,0,41.93571,-87.6636
TA1307000052,3,20,true,14,20,6,41.93628,-87.65266
TA1307000136,3,20,true,10,16,6,41.9365,-87.64755
TA1307000041,3,20,true,23,20,-3,41.93669,-87.63683
13137,3,20,true,18,17,-1,41.9376,-87.6441
TA1309000042,3,20,true,3,5,2,41.93937,-87.66836
TA1308000019,3,20,true,11,13,2,41.93973,-87.65886
13277,3,20,true,10,13,3,41.9401,-87.64546
TA1307000134,3,20,true,12,22,10,41.94016,-87.65303
TA1309000049,3,20,true,15,23,8,41.94077,-87.63919
TA1307000138,3,20,true,4,5,1,41.94334,-87.67094
TA1309000025,3,20,true,13,22,9,41.94368,-87.64894
13071,3,20,true,11,8,-3,41.94373,-87.66401
632,3,20,true,9,7,-2,41.94453,-87.6547
13278,3,20,true,8,20,12,41.94553,-87.64644
15632,3,20,true,8,3,-5,41.94664,-87.69463
13235,3,20,true,8,15,7,41.94814,-87.66396
13253,3,20,true,1,6,5,41.9488,-87.67527
13325,3,20,true,11,12,1,41.94907,-87.64863
TA1307000126,3,20,true,10,11,1,41.94936,-87.65451
TA1307000150,3,20,true,5,13,8,41.94945,-87.64646
TA1307000127,3,20,true,6,9,3,41.9508,-87.65918
13323,3,20,true,7,7,0,41.95282,-87.65
13063,3,20,true,2,10,8,41.95424,-87.65441
TA1308000022,3,20,true,7,16,9,41.95438,-87.64805
TA1307000149,3,20,true,5,6,1,41.95467,-87.67392
TA1309000026,3,20,true,5,5,0,41.95601,-87.6802
13379,3,20,true,10,17,7,41.95786,-87.6495
TA1309000027,3,20,true,2,8,6,41.9585,-87.65499
13389,3,20,true,13,9,-4,41.961,-87.64958
KA1503000022,3,20,true,7,2,-5,41.96158,-87.66609
TA1307000107,3,20,true,7,19,12,41.96164,-87.65464
TA1308000012,3,20,true,32,13,-19,41.96398,-87.63818
13074,3,20,true,2,5,3,41.96521,-87.6582
639,3,20,true,7,8,1,41.96584,-87.64538
TA1307000140,3,20,true,9,1,-8,41.96643,-87.68865
TA1309000014,3,20,true,6,6,0,41.96709,-87.66744
TA1307000158,3,20,true,3,11,8,41.9671,-87.67904
TA1307000119,3,20,true,5,2,-3,41.96796,-87.65
KA1504000171,3,20,true,5,4,-1,41.97161,-87.65016
TA1309000035,3,20,true,7,11,4,41.97335,-87.66785
13108,3,20,true,5,2,-3,41.97379,-87.65971
13109,3,20,true,5,6,1,41.97835,-87.65976
KA1504000152,3,20,true,6,11,5,41.98403,-87.65231
15575,3,20,true,5,4,-1,41.98975,-87.66014
15571,3,20,true,6,7,1,41.99478,-87.66028
KA1504000175,3,20,true,2,5,3,42.00797,-87.66549
TA1308000009,3,21,false,9,4,-5,41.79522,-87.58075
KA1503000052,3,21,false,3,8,5,41.79935,-87.60097
KA1503000059,3,21,false,5,3,-2,41.79952,-87.58643
KA1503000007,3,21,false,5,2,-3,41.80242,-87.58689
KA1503000004,3,21,false,2,6,4,41.83127,-87.6088
TA1307000048,3,21,false,8,7,-1,41.83855,-87.60821
TA1307000139,3,21,false,1,5,4,41.84205,-87.61698
13075,3,21,false,12,5,-7,41.8531,-87.63192
SL-006,3,21,false,3,6,3,41.8568,-87.63387
13102,3,21,false,6,3,-3,41.85762,-87.61942
SL-012,3,21,false,5,4,-1,41.86038,-87.62581
TA1307000124,3,21,false,7,13,6,41.86411,-87.62372
TA1309000001,3,21,false,4,6,2,41.86488,-87.64708
13029,3,21,false,32,5,-27,41.86531,-87.6179
13431,3,21,false,11,11,0,41.8661,-87.60728
TA1305000002,3,21,false,17,23,6,41.86721,-87.62597
15544,3,21,false,24,20,-4,41.86723,-87.61536
SL-005,3,21,false,17,20,3,41.8679,-87.62304
TA1309000010,3,21,false,19,15,-4,41.87074,-87.62574
SL-008,3,21,false,5,2,-3,41.87209,-87.62956
SL-011,3,21,false,7,3,-4,41.87256,-87.63356
623,3,21,false,13,22,9,41.87272,-87.62399
SL-007,3,21,false,5,6,1,41.87404,-87.6277
SL-010,3,21,false,2,6,4,41.87501,-87.63309
15541,3,21,false,10,15,5,41.8758,-87.62086
13037,3,21,false,5,4,-1,41.87588,-87.64078
TA1305000009,3,21,false,5,5,0,41.87593,-87.63068
TA1305000010,3,21,false,4,5,1,41.87623,-87.62444
624,3,21,false,2,6,4,41.87626,-87.62923
TA1305000035,3,21,false,5,6,1,41.87716,-87.62787
13157,3,21,false,5,5,0,41.87773,-87.6548
TA1305000025,3,21,false,7,1,-6,41.87773,-87.63528
TA1309000002,3,21,false,5,7,2,41.87784,-87.62408
KA1503000015,3,21,false,2,5,3,41.87948,-87.6257
13300,3,21,false,28,16,-12,41.88097,-87.61675
13008,3,21,false,32,20,-12,41.88105,-87.62408
TA1307000120,3,21,false,2,16,14,41.88188,-87.64879
TA1305000032,3,21,false,6,5,-1,41.88218,-87.64109
13353,3,21,false,2,5,3,41.88283,-87.6612
13053,3,21,false,14,12,-2,41.88365,-87.64863
13001,3,21,false,14,16,2,41.88397,-87.62459
18062,3,21,false,3,5,2,41.88412,-87.65427
TA1305000029,3,21,false,9,12,3,41.88466,-87.62787
13263,3,21,false,12,13,1,41.88467,-87.61952
TA1306000015,3,21,false,12,2,-10,41.88549,-87.65232
13021,3,21,false,5,4,-1,41.88559,-87.64184
TA1307000111,3,21,false,7,8,1,41.88582,-87.63548
KA1503000012,3,21,false,5,3,-2,41.88599,-87.63089
TA1305000011,3,21,false,10,18,8,41.886,-87.62418
15534,3,21,false,3,7,4,41.88627,-87.61749
TA1308000029,3,21,false,8,4,-4,41.88673,-87.62225
TA1307000131,3,21,false,6,14,8,41.88688,-87.62606
KA1503000064,3,21,false,14,10,-4,41.88697,-87.61281
TA1306000003,3,21,false,4,12,8,41.88867,-87.64442
KA1503000043,3,21,false,7,11,4,41.88918,-87.63851
13050,3,21,false,8,8,0,41.88919,-87.62775
TA1307000151,3,21,false,5,18,13,41.88993,-87.63427
13427,3,21,false,4,8,4,41.89054,-87.62205
13430,3,21,false,17,17,0,41.89077,-87.63169
TA1306000013,3,21,false,26,20,-6,41.89083,-87.61852
RN-,3,21,false,5,6,1,41.89102,-87.63546
13434,3,21,false,8,6,-2,41.89108,-87.66663
TA1307000117,3,21,false,25,19,-6,41.89144,-87.62675
13033,3,21,false,5,7,2,41.8916,-87.64835
13194,3,21,false,5,6,1,41.8918,-87.65878
TA1305000003,3,21,false,15,21,6,41.89187,-87.62061
13022,3,21,false,120,70,-50,41.89227,-87.61205
TA1306000029,3,21,false,14,37,23,41.89256,-87.61449
13265,3,21,false,4,11,7,41.89383,-87.64172
13045,3,21,false,6,8,2,41.89403,-87.62931
KA1503000041,3,21,false,12,11,-1,41.89452,-87.61798
13196,3,21,false,2,5,3,41.89455,-87.65345
TA1307000062,3,21,false,7,4,-3,41.89466,-87.63839
TA1306000012,3,21,false,9,22,13,41.89475,-87.63438
15530,3,21,false,21,15,-6,41.89575,-87.62596
TA1305000020,3,21,false,4,8,4,41.89636,-87.65406
13303,3,21,false,11,18,7,41.89672,-87.63088
15529,3,21,false,15,6,-9,41.89858,-87.62206
TA1307000128,3,21,false,10,17,7,41.89896,-87.6299
13042,3,21,false,8,23,15,41.90097,-87.62377
TA1307000070,3,21,false,4,5,1,41.90133,-87.67742
KA1504000133,3,21,false,21,7,-14,41.90234,-87.62773
TA1307000039,3,21,false,11,12,1,41.90294,-87.63137
KA1504000135,3,21,false,30,17,-13,41.90319,-87.63439
13136,3,21,false,6,2,-4,41.90326,-87.67845
13061,3,21,false,6,12,6,41.90342,-87.66779
KA1504000079,3,21,false,11,4,-7,41.9035,-87.64334
TA1308000049,3,21,false,39,19,-20,41.90672,-87.6349
KA1504000134,3,21,false,8,4,-4,41.90687,-87.6262
13224,3,21,false,1,8,7,41.90706,-87.66725
13221,3,21,false,6,2,-4,41.90765,-87.67254
TA1309000024,3,21,false,11,9,-2,41.908,-87.63152
TA1305000041,3,21,false,7,4,-3,41.9094,-87.67769
331,3,21,false,5,2,-3,41.90965,-87.64812
TA1305000037,3,21,false,4,10,6,41.91018,-87.67003
TA1308000005,3,21,false,2,6,4,41.91042,-87.68238
TA1307000038,3,21,false,18,6,-12,41.91138,-87.63868
LF-005,3,21,false,60,47,-13,41.91172,-87.62681
13128,3,21,false,16,6,-10,41.91197,-87.63197
TA1308000050,3,21,false,45,14,-31,41.91211,-87.6347
13243,3,21,false,4,6,2,41.91262,-87.6814
15655,3,21,false,5,3,-2,41.91401,-87.70514
13068,3,21,false,5,1,-4,41.91554,-87.68703
13179,3,21,false,37,17,-20,41.9157,-87.63461
13133,3,21,false,9,4,-5,41.91598,-87.67733
15651,3,21,false,6,3,-3,41.91752,-87.70181
TA1309000006,3,21,false,8,6,-2,41.91809,-87.64375
13146,3,21,false,15,14,-1,41.91831,-87.63629
13059,3,21,false,14,14,0,41.91845,-87.65222
13192,3,21,false,3,9,6,41.91995,-87.64884
13288,3,21,false,3,5,2,41.92008,-87.67788
13242,3,21,false,2,5,3,41.92021,-87.69266
TA1309000030,3,21,false,5,4,-1,41.92077,-87.66372
TA1309000033,3,21,false,10,16,6,41.92158,-87.65381
13193,3,21,false,16,21,5,41.92182,-87.64412
LP-,3,21,false,10,18,8,41.92396,-87.63584
TA1307000001,3,21,false,2,5,3,41.92535,-87.66581
TA1306000026,3,21,false,12,6,-6,41.92558,-87.65842
TA1309000019,3,21,false,4,14,10,41.92586,-87.63897
TA1309000058,3,21,false,9,9,0,41.92591,-87.64927
TA1308000001,3,21,false,27,20,-7,41.92627,-87.63086
TA1309000023,3,21,false,5,9,4,41.9287,-87.65383
TA1307000113,3,21,false,10,3,-7,41.92878,-87.66391
TA1309000059,3,21,false,1,9,8,41.92889,-87.65898
TA1309000061,3,21,false,7,8,1,41.92915,-87.64909
TA1305000014,3,21,false,8,10,2,41.92956,-87.64313
TA1307000142,3,21,false,14,10,-4,41.93125,-87.64432
13276,3,21,false,10,5,-5,41.93132,-87.63874
TA1307000064,3,21,false,1,9,8,41.93222,-87.65864
TA1306000014,3,21,false,6,7,1,41.93242,-87.65271
TA1309000039,3,21,false,8,12,4,41.93258,-87.63642
TA1309000036,3,21,false,7,8,1,41.93313,-87.64776
TA1307000006,3,21,false,2,5,3,41.93571,-87.6636
13268,3,21,false,1,7,6,41.93588,-87.67843
TA1307000052,3,21,false,15,5,-10,41.93628,-87.65266
TA1307000041,3,21,false,3,15,12,41.93669,-87.63683
13137,3,21,false,10,17,7,41.9376,-87.6441
TA1309000042,3,21,false,3,7,4,41.93937,-87.66836
13229,3,21,false,1,6,5,41.93946,-87.66376
TA1308000019,3,21,false,2,14,12,41.93973,-87.65886
13277,3,21,false,9,7,-2,41.9401,-87.64546
TA1307000134,3,21,false,10,9,-1,41.94016,-87.65303
TA1309000049,3,21,false,3,13,10,41.94077,-87.63919
TA1307000138,3,21,false,10,6,-4,41.94334,-87.67094
TA1309000025,3,21,false,13,10,-3,41.94368,-87.64894
13071,3,21,false,6,16,10,41.94373,-87.66401
632,3,21,false,11,17,6,41.94453,-87.6547
13278,3,21,false,4,12,8,41.94553,-87.64644
13235,3,21,false,6,6,0,41.94814,-87.66396
13325,3,21,false,1,11,10,41.94907,-87.64863
TA1307000126,3,21,false,6,12,6,41.94936,-87.65451
TA1307000150,3,21,false,1,11,10,41.94945,-87.64646
TA1307000127,3,21,false,9,5,-4,41.9508,-87.65918
13323,3,21,false,4,8,4,41.95282,-87.65
13063,3,21,false,2,10,8,41.95424,-87.65441
TA1308000022,3,21,false,4,13,9,41.95438,-87.64805
TA1308000012,3,21,false,20,19,-1,41.96398,-87.63818
639,3,21,false,5,2,-3,41.96584,-87.64538
TA1307000119,3,21,false,1,12,11,41.96796,-87.65
KA1504000152,3,21,false,2,8,6,41.98403,-87.65231
KA1503000071,3,21,true,5,5,0,41.79148,-87.59988
TA1307000129,3,21,true,6,3,-3,41.83104,-87.62683
15445,3,21,true,5,2,-3,41.83453,-87.63183
13216,3,21,true,7,1,-6,41.83473,-87.62581
13217,3,21,true,4,11,7,41.83488,-87.61792
13215,3,21,true,2,6,4,41.83634,-87.6135
TA1307000139,3,21,true,4,11,7,41.84205,-87.61698
13135,3,21,true,4,8,4,41.85753,-87.66157
13102,3,21,true,4,5,1,41.85762,-87.61942
13150,3,21,true,3,5,2,41.85783,-87.62455
13164,3,21,true,7,4,-3,41.85818,-87.65648
TA1309000001,3,21,true,6,3,-3,41.86488,-87.64708
13354,3,21,true,1,6,5,41.86524,-87.66651
13431,3,21,true,10,3,-7,41.8661,-87.60728
TA1305000002,3,21,true,9,14,5,41.86721,-87.62597
15544,3,21,true,9,3,-6,41.86723,-87.61536
KA1706005007,3,21,true,6,4,-2,41.86749,-87.63219
SL-005,3,21,true,9,9,0,41.8679,-87.62304
13160,3,21,true,5,6,1,41.86947,-87.65548
15550,3,21,true,9,1,-8,41.87024,-87.63947
TA1309000010,3,21,true,4,7,3,41.87074,-87.62574
TA1307000130,3,21,true,6,5,-1,41.87178,-87.65103
SL-008,3,21,true,4,6,2,41.87209,-87.62956
13332,3,21,true,6,7,1,41.87219,-87.6615
SL-011,3,21,true,1,5,4,41.87256,-87.63356
623,3,21,true,6,6,0,41.87272,-87.62399
15539,3,21,true,4,5,1,41.87763,-87.64405
13157,3,21,true,2,6,4,41.87773,-87.6548
TA1305000025,3,21,true,2,7,5,41.87773,-87.63528
13011,3,21,true,5,1,-4,41.87931,-87.63993
WL-011,3,21,true,7,8,1,41.88034,-87.64273
13300,3,21,true,13,5,-8,41.88097,-87.61675
13008,3,21,true,6,2,-4,41.88105,-87.62408
TA1305000006,3,21,true,7,1,-6,41.88122,-87.6296
TA1307000120,3,21,true,10,12,2,41.88188,-87.64879
TA1305000032,3,21,true,7,15,8,41.88218,-87.64109
13409,3,21,true,7,4,-3,41.8831,-87.6511
13053,3,21,true,22,7,-15,41.88365,-87.64863
13001,3,21,true,10,3,-7,41.88397,-87.62459
18062,3,21,true,6,4,-2,41.88412,-87.65427
TA1306000010,3,21,true,4,5,1,41.88419,-87.62961
TA1305000030,3,21,true,6,3,-3,41.88459,-87.63178
15535,3,21,true,6,9,3,41.8846,-87.64455
TA1305000029,3,21,true,8,5,-3,41.88466,-87.62787
13263,3,21,true,9,12,3,41.88467,-87.61952
TA1306000015,3,21,true,13,4,-9,41.88549,-87.65232
13021,3,21,true,8,21,13,41.88559,-87.64184
TA1307000111,3,21,true,7,3,-4,41.88582,-87.63548
KA1503000012,3,21,true,5,4,-1,41.88599,-87.63089
TA1305000011,3,21,true,6,2,-4,41.886,-87.62418
15534,3,21,true,7,6,-1,41.88627,-87.61749
TA1307000131,3,21,true,4,5,1,41.88688,-87.62606
KA1503000064,3,21,true,15,8,-7,41.88697,-87.61281
TA1305000022,3,21,true,7,12,5,41.88817,-87.63656
TA1306000003,3,21,true,13,16,3,41.88867,-87.64442
KA1503000043,3,21,true,15,25,10,41.88918,-87.63851
13050,3,21,true,14,2,-12,41.88919,-87.62775
TA1307000151,3,21,true,7,12,5,41.88993,-87.63427
636,3,21,true,4,7,3,41.88997,-87.63662
13430,3,21,true,16,6,-10,41.89077,-87.63169
TA1306000013,3,21,true,3,16,13,41.89083,-87.61852
RN-,3,21,true,8,13,5,41.89102,-87.63546
TA1307000117,3,21,true,6,12,6,41.89144,-87.62675
13033,3,21,true,7,9,2,41.8916,-87.64835
TA1305000003,3,21,true,8,7,-1,41.89187,-87.62061
13022,3,21,true,34,26,-8,41.89227,-87.61205
TA1306000029,3,21,true,9,5,-4,41.89256,-87.61449
13265,3,21,true,7,23,16,41.89383,-87.64172
13045,3,21,true,16,10,-6,41.89403,-87.62931
KA1503000041,3,21,true,6,10,4,41.89452,-87.61798
13196,3,21,true,5,2,-3,41.89455,-87.65345
TA1307000062,3,21,true,5,5,0,41.89466,-87.63839
TA1306000012,3,21,true,21,12,-9,41.89475,-87.63438
KP1705001026,3,21,true,6,5,-1,41.89483,-87.6323
13132,3,21,true,6,3,-3,41.89573,-87.67718
15530,3,21,true,4,11,7,41.89575,-87.62596
TA1305000020,3,21,true,9,8,-1,41.89636,-87.65406
13289,3,21,true,3,6,3,41.89638,-87.661
13303,3,21,true,9,8,-1,41.89672,-87.63088
13338,3,21,true,6,3,-3,41.89697,-87.62173
TA1307000061,3,21,true,9,7,-2,41.89745,-87.62873
TA1306000009,3,21,true,6,7,1,41.89772,-87.64299
620,3,21,true,3,10,7,41.89817,-87.63754
KA1504000103,3,21,true,1,6,5,41.89842,-87.68659
15529,3,21,true,8,21,13,41.89858,-87.62206
TA1307000128,3,21,true,5,8,3,41.89896,-87.6299
13248,3,21,true,7,5,-2,41.89964,-87.66788
TA1306000011,3,21,true,2,5,3,41.89994,-87.63443
13290,3,21,true,5,5,0,41.90069,-87.66259
13042,3,21,true,7,7,0,41.90097,-87.62377
TA1307000070,3,21,true,1,6,5,41.90133,-87.67742
KA1504000133,3,21,true,11,6,-5,41.90234,-87.62773
TA1307000039,3,21,true,24,19,-5,41.90294,-87.63137
TA1305000034,3,21,true,11,11,0,41.90313,-87.67391
KA1504000135,3,21,true,33,18,-15,41.90319,-87.63439
13136,3,21,true,4,7,3,41.90326,-87.67845
13061,3,21,true,4,21,17,41.90342,-87.66779
KA1504000079,3,21,true,11,9,-2,41.9035,-87.64334
TA1308000049,3,21,true,35,14,-21,41.90672,-87.6349
KA1504000134,3,21,true,3,5,2,41.90687,-87.6262
13224,3,21,true,2,7,5,41.90706,-87.66725
13221,3,21,true,12,6,-6,41.90765,-87.67254
TA1309000024,3,21,true,8,6,-2,41.908,-87.63152
TA1305000041,3,21,true,8,4,-4,41.9094,-87.67769
331,3,21,true,14,9,-5,41.90965,-87.64812
TA1305000037,3,21,true,5,6,1,41.91018,-87.67003
TA1306000008,3,21,true,3,6,3,41.9102,-87.6435
TA1308000005,3,21,true,5,3,-2,41.91042,-87.68238
13154,3,21,true,5,1,-4,41.91054,-87.65312
TA1307000038,3,21,true,18,10,-8,41.91138,-87.63868
LF-005,3,21,true,38,32,-6,41.91172,-87.62681
13128,3,21,true,15,14,-1,41.91197,-87.63197
TA1308000050,3,21,true,33,26,-7,41.91211,-87.6347
13243,3,21,true,7,6,-1,41.91262,-87.6814
TA1306000032,3,21,true,8,10,2,41.9137,-87.65285
TA1307000166,3,21,true,7,7,0,41.91386,-87.64877
18067,3,21,true,2,5,3,41.9146,-87.66796
TA1306000007,3,21,true,3,7,4,41.91469,-87.64333
13179,3,21,true,30,19,-11,41.9157,-87.63461
13133,3,21,true,6,5,-1,41.91598,-87.67733
13266,3,21,true,3,5,2,41.91774,-87.69142
TA1309000006,3,21,true,10,10,0,41.91809,-87.64375
TA1307000163,3,21,true,5,8,3,41.91821,-87.65696
13146,3,21,true,19,11,-8,41.91831,-87.63629
13059,3,21,true,9,23,14,41.91845,-87.65222
13259,3,21,true,1,5,4,41.91852,-87.69744
13192,3,21,true,11,16,5,41.91995,-87.64884
13288,3,21,true,2,5,3,41.92008,-87.67788
TA1309000030,3,21,true,6,7,1,41.92077,-87.66372
TA1309000033,3,21,true,13,10,-3,41.92158,-87.65381
13193,3,21,true,43,20,-23,41.92182,-87.64412
13191,3,21,true,5,7,2,41.92217,-87.63891
13084,3,21,true,4,7,3,41.92268,-87.69715
LP-,3,21,true,6,12,6,41.92396,-87.63584
TA1307000001,3,21,true,8,8,0,41.92535,-87.66581
TA1306000026,3,21,true,6,10,4,41.92558,-87.65842
TA1309000019,3,21,true,9,10,1,41.92586,-87.63897
TA1309000058,3,21,true,18,9,-9,41.92591,-87.64927
TA1308000001,3,21,true,14,14,0,41.92627,-87.63086
TA1309000023,3,21,true,5,10,5,41.9287,-87.65383
TA1307000113,3,21,true,16,8,-8,41.92878,-87.66391
TA1309000061,3,21,true,5,10,5,41.92915,-87.64909
TA1305000014,3,21,true,6,15,9,41.92956,-87.64313
TA1307000142,3,21,true,11,22,11,41.93125,-87.64432
13276,3,21,true,4,14,10,41.93132,-87.63874
TA1307000064,3,21,true,12,18,6,41.93222,-87.65864
TA1306000014,3,21,true,5,10,5,41.93242,-87.65271
TA1309000039,3,21,true,13,16,3,41.93258,-87.63642
TA1309000036,3,21,true,11,9,-2,41.93313,-87.64776
TA1307000006,3,21,true,2,5,3,41.93571,-87.6636
TA1307000052,3,21,true,13,19,6,41.93628,-87.65266
TA1307000136,3,21,true,11,11,0,41.9365,-87.64755
TA1307000041,3,21,true,6,5,-1,41.93669,-87.63683
13137,3,21,true,8,9,1,41.9376,-87.6441
TA1309000042,3,21,true,5,2,-3,41.93937,-87.66836
13229,3,21,true,9,8,-1,41.93946,-87.66376
TA1308000019,3,21,true,4,7,3,41.93973,-87.65886
TA1307000134,3,21,true,12,7,-5,41.94016,-87.65303
TA1309000049,3,21,true,10,11,1,41.94077,-87.63919
TA1307000138,3,21,true,2,7,5,41.94334,-87.67094
TA1309000025,3,21,true,10,9,-1,41.94368,-87.64894
13071,3,21,true,1,12,11,41.94373,-87.66401
632,3,21,true,6,10,4,41.94453,-87.6547
13278,3,21,true,9,18,9,41.94553,-87.64644
13235,3,21,true,6,10,4,41.94814,-87.66396
13325,3,21,true,6,7,1,41.94907,-87.64863
TA1307000126,3,21,true,3,12,9,41.94936,-87.65451
TA1307000150,3,21,true,7,7,0,41.94945,-87.64646
13319,3,21,true,4,6,2,41.95069,-87.6687
TA1307000127,3,21,true,11,8,-3,41.9508,-87.65918
13323,3,21,true,8,8,0,41.95282,-87.65
TA1308000022,3,21,true,5,6,1,41.95438,-87.64805
13379,3,21,true,4,6,2,41.95786,-87.6495
TA1309000027,3,21,true,1,6,5,41.9585,-87.65499
13389,3,21,true,2,7,5,41.961,-87.64958
KA1503000022,3,21,true,4,5,1,41.96158,-87.66609
TA1307000107,3,21,true,8,8,0,41.96164,-87.65464
TA1309000012,3,21,true,1,7,6,41.96325,-87.67928
TA1308000012,3,21,true,18,3,-15,41.96398,-87.63818
13074,3,21,true,5,5,0,41.96521,-87.6582
639,3,21,true,6,3,-3,41.96584,-87.64538
TA1307000140,3,21,true,5,1,-4,41.96643,-87.68865
TA1309000014,3,21,true,2,7,5,41.96709,-87.66744
TA1307000158,3,21,true,5,9,4,41.9671,-87.67904
TA1307000119,3,21,true,1,6,5,41.96796,-87.65
TA1309000066,3,21,true,4,5,1,41.9691,-87.67423
KA1504000171,3,21,true,3,5,2,41.97161,-87.65016
TA1309000035,3,21,true,5,8,3,41.97335,-87.66785
13108,3,21,true,4,8,4,41.97379,-87.65971
KA1504000146,3,21,true,4,5,1,41.978,-87.66805
13109,3,21,true,5,7,2,41.97835,-87.65976
KA1504000152,3,21,true,5,5,0,41.98403,-87.65231
15571,3,21,true,3,5,2,41.99478,-87.66028
TA1309000037,3,22,false,4,7,3,41.79957,-87.59474
KA1503000007,3,22,false,2,6,4,41.80242,-87.58689
TA1309000067,3,22,false,3,5,2,41.80303,-87.60661
TA1307000129,3,22,false,9,4,-5,41.83104,-87.62683
TA1305000004,3,22,false,1,5,4,41.8514,-87.61884
SL-012,3,22,false,6,7,1,41.86038,-87.62581
TA1307000124,3,22,false,2,10,8,41.86411,-87.62372
TA1309000001,3,22,false,2,8,6,41.86488,-87.64708
TA1305000002,3,22,false,13,23,10,41.86721,-87.62597
15544,3,22,false,9,6,-3,41.86723,-87.61536
SL-005,3,22,false,3,22,19,41.8679,-87.62304
13160,3,22,false,2,7,5,41.86947,-87.65548
TA1309000010,3,22,false,5,9,4,41.87074,-87.62574
SL-009,3,22,false,1,7,6,41.87081,-87.63121
SL-008,3,22,false,11,5,-6,41.87209,-87.62956
623,3,22,false,7,20,13,41.87272,-87.62399
SL-007,3,22,false,8,9,1,41.87404,-87.6277
SL-010,3,22,false,2,10,8,41.87501,-87.63309
15541,3,22,false,33,32,-1,41.8758,-87.62086
TA1305000010,3,22,false,4,5,1,41.87623,-87.62444
624,3,22,false,5,5,0,41.87626,-87.62923
15539,3,22,false,3,5,2,41.87763,-87.64405
TA1305000025,3,22,false,2,9,7,41.87773,-87.63528
638,3,22,false,3,5,2,41.87827,-87.64078
13011,3,22,false,5,15,10,41.87931,-87.63993
KA1503000015,3,22,false,12,3,-9,41.87948,-87.6257
13300,3,22,false,23,8,-15,41.88097,-87.61675
13008,3,22,false,33,18,-15,41.88105,-87.62408
TA1305000006,3,22,false,6,4,-2,41.88122,-87.6296
TA1307000120,3,22,false,14,12,-2,41.88188,-87.64879
13036,3,22,false,5,3,-2,41.8821,-87.62513
TA1305000032,3,22,false,1,13,12,41.88218,-87.64109
13409,3,22,false,4,6,2,41.8831,-87.6511
13053,3,22,false,13,13,0,41.88365,-87.64863
13001,3,22,false,8,5,-3,41.88397,-87.62459
18062,3,22,false,8,11,3,41.88412,-87.65427
15535,3,22,false,1,10,9,41.8846,-87.64455
TA1305000029,3,22,false,2,6,4,41.88466,-87.62787
13263,3,22,false,4,6,2,41.88467,-87.61952
TA1306000015,3,22,false,13,1,-12,41.88549,-87.65232
KA1503000012,3,22,false,5,6,1,41.88599,-87.63089
TA1305000011,3,22,false,21,19,-2,41.886,-87.62418
15534,3,22,false,5,6,1,41.88627,-87.61749
TA1307000131,3,22,false,7,10,3,41.88688,-87.62606
KA1503000064,3,22,false,11,4,-7,41.88697,-87.61281
TA1305000022,3,22,false,5,2,-3,41.88817,-87.63656
TA1306000003,3,22,false,6,6,0,41.88867,-87.64442
KA1503000043,3,22,false,8,7,-1,41.88918,-87.63851
13050,3,22,false,6,14,8,41.88919,-87.62775
TA1307000151,3,22,false,14,13,-1,41.88993,-87.63427
636,3,22,false,4,8,4,41.88997,-87.63662
13427,3,22,false,7,4,-3,41.89054,-87.62205
13430,3,22,false,11,16,5,41.89077,-87.63169
TA1306000013,3,22,false,8,12,4,41.89083,-87.61852
RN-,3,22,false,6,4,-2,41.89102,-87.63546
13434,3,22,false,3,9,6,41.89108,-87.66663
TA1307000117,3,22,false,7,8,1,41.89144,-87.62675
13033,3,22,false,5,12,7,41.8916,-87.64835
TA1305000003,3,22,false,14,18,4,41.89187,-87.62061
13022,3,22,false,45,20,-25,41.89227,-87.61205
TA1306000029,3,22,false,24,10,-14,41.89256,-87.61449
13265,3,22,false,4,5,1,41.89383,-87.64172
13045,3,22,false,6,15,9,41.89403,-87.62931
KA1503000041,3,22,false,9,14,5,41.89452,-87.61798
13196,3,22,false,1,8,7,41.89455,-87.65345
TA1307000062,3,22,false,3,9,6,41.89466,-87.63839
TA1306000012,3,22,false,15,19,4,41.89475,-87.63438
KP1705001026,3,22,false,2,6,4,41.89483,-87.6323
637,3,22,false,3,6,3,41.89563,-87.67209
13132,3,22,false,14,2,-12,41.89573,-87.67718
13247,3,22,false,1,5,4,41.89597,-87.66775
TA1305000020,3,22,false,2,9,7,41.89636,-87.65406
13289,3,22,false,5,4,-1,41.89638,-87.661
13303,3,22,false,6,16,10,41.89672,-87.63088
13338,3,22,false,2,10,8,41.89697,-87.62173
TA1307000061,3,22,false,5,8,3,41.89745,-87.62873
13034,3,22,false,1,6,5,41.89754,-87.62352
15529,3,22,false,2,8,6,41.89858,-87.62206
TA1307000128,3,22,false,10,13,3,41.89896,-87.6299
TA1306000011,3,22,false,5,7,2,41.89994,-87.63443
13042,3,22,false,22,20,-2,41.90097,-87.62377
KA1504000133,3,22,false,6,7,1,41.90234,-87.62773
TA1306000006,3,22,false,8,2,-6,41.90292,-87.63772
TA1307000039,3,22,false,15,9,-6,41.90294,-87.63137
TA1305000034,3,22,false,6,11,5,41.90313,-87.67391
KA1504000135,3,22,false,27,16,-11,41.90319,-87.63439
13136,3,22,false,6,3,-3,41.90326,-87.67845
13061,3,22,false,7,15,8,41.90342,-87.66779
TA1308000049,3,22,false,25,14,-11,41.90672,-87.6349
KA1504000134,3,22,false,6,11,5,41.90687,-87.6262
13221,3,22,false,6,11,5,41.90765,-87.67254
TA1309000024,3,22,false,29,8,-21,41.908,-87.63152
TA1305000041,3,22,false,8,9,1,41.9094,-87.67769
331,3,22,false,7,4,-3,41.90965,-87.64812
TA1305000037,3,22,false,6,4,-2,41.91018,-87.67003
13257,3,22,false,1,6,5,41.91054,-87.68956
TA1307000038,3,22,false,26,6,-20,41.91138,-87.63868
LF-005,3,22,false,53,16,-37,41.91172,-87.62681
13128,3,22,false,17,6,-11,41.91197,-87.63197
TA1308000050,3,22,false,21,19,-2,41.91211,-87.6347
TA1307000166,3,22,false,2,8,6,41.91386,-87.64877
13179,3,22,false,24,3,-21,41.9157,-87.63461
13133,3,22,false,4,9,5,41.91598,-87.67733
TA1309000006,3,22,false,6,1,-5,41.91809,-87.64375
TA1307000163,3,22,false,1,8,7,41.91821,-87.65696
13146,3,22,false,29,13,-16,41.91831,-87.63629
13059,3,22,false,15,17,2,41.91845,-87.65222
13192,3,22,false,6,5,-1,41.91995,-87.64884
TA1309000030,3,22,false,9,5,-4,41.92077,-87.66372
TA1309000033,3,22,false,12,11,-1,41.92158,-87.65381
13193,3,22,false,17,21,4,41.92182,-87.64412
13084,3,22,false,6,10,4,41.92268,-87.69715
LP-,3,22,false,12,8,-4,41.92396,-87.63584
TA1307000001,3,22,false,11,6,-5,41.92535,-87.66581
TA1306000026,3,22,false,2,12,10,41.92558,-87.65842
TA1306000016,3,22,false,6,8,2,41.9256,-87.65371
TA1309000019,3,22,false,12,14,2,41.92586,-87.63897
TA1309000058,3,22,false,16,7,-9,41.92591,-87.64927
TA1308000001,3,22,false,13,14,1,41.92627,-87.63086
TA1309000023,3,22,false,4,16,12,41.9287,-87.65383
TA1307000113,3,22,false,8,4,-4,41.92878,-87.66391
13296,3,22,false,5,1,-4,41.92883,-87.66852
TA1309000059,3,22,false,6,10,4,41.92889,-87.65898
TA1309000061,3,22,false,3,5,2,41.92915,-87.64909
TA1308000031,3,22,false,9,1,-8,41.92946,-87.68417
TA1305000014,3,22,false,5,6,1,41.92956,-87.64313
TA1307000142,3,22,false,6,26,20,41.93125,-87.64432
13276,3,22,false,6,15,9,41.93132,-87.63874
TA1306000014,3,22,false,2,5,3,41.93242,-87.65271
TA1309000039,3,22,false,6,12,6,41.93258,-87.63642
TA1309000036,3,22,false,1,9,8,41.93313,-87.64776
TA1307000006,3,22,false,3,11,8,41.93571,-87.6636
TA1307000052,3,22,false,1,10,9,41.93628,-87.65266
TA1307000136,3,22,false,3,7,4,41.9365,-87.64755
TA1307000041,3,22,false,1,5,4,41.93669,-87.63683
13137,3,22,false,4,19,15,41.9376,-87.6441
TA1309000042,3,22,false,7,4,-3,41.93937,-87.66836
13229,3,22,false,5,14,9,41.93946,-87.66376
TA1308000019,3,22,false,9,9,0,41.93973,-87.65886
13277,3,22,false,3,16,13,41.9401,-87.64546
TA1307000134,3,22,false,9,12,3,41.94016,-87.65303
TA1309000049,3,22,false,4,12,8,41.94077,-87.63919
TA1307000138,3,22,false,7,1,-6,41.94334,-87.67094
TA1309000025,3,22,false,9,15,6,41.94368,-87.64894
13071,3,22,false,8,5,-3,41.94373,-87.66401
632,3,22,false,6,17,11,41.94453,-87.6547
13278,3,22,false,2,10,8,41.94553,-87.64644
TA1307000126,3,22,false,8,13,5,41.94936,-87.65451
TA1307000150,3,22,false,1,7,6,41.94945,-87.64646
13323,3,22,false,2,7,5,41.95282,-87.65
TA1308000022,3,22,false,3,5,2,41.95438,-87.64805
TA1307000107,3,22,false,9,6,-3,41.96164,-87.65464
TA1308000012,3,22,false,7,6,-1,41.96398,-87.63818
TA1307000140,3,22,false,2,5,3,41.96643,-87.68865
TA1309000014,3,22,false,8,2,-6,41.96709,-87.66744
15545,3,22,true,7,1,-6,41.85627,-87.61334
13102,3,22,true,1,7,6,41.85762,-87.61942
15544,3,22,true,6,1,-5,41.86723,-87.61536
SL-005,3,22,true,1,14,13,41.8679,-87.62304
13139,3,22,true,1,7,6,41.86893,-87.65913
13160,3,22,true,6,2,-4,41.86947,-87.65548
TA1309000010,3,22,true,2,6,4,41.87074,-87.62574
SL-008,3,22,true,9,6,-3,41.87209,-87.62956
13332,3,22,true,1,15,14,41.87219,-87.6615
623,3,22,true,5,5,0,41.87272,-87.62399
13028,3,22,true,5,4,-1,41.87475,-87.64981
13158,3,22,true,5,4,-1,41.87764,-87.64957
TA1305000025,3,22,true,6,8,2,41.87773,-87.63528
13300,3,22,true,8,1,-7,41.88097,-87.61675
TA1307000120,3,22,true,7,12,5,41.88188,-87.64879
TA1305000032,3,22,true,7,7,0,41.88218,-87.64109
13353,3,22,true,6,2,-4,41.88283,-87.6612
13409,3,22,true,2,5,3,41.8831,-87.6511
13053,3,22,true,11,6,-5,41.88365,-87.64863
13001,3,22,true,6,5,-1,41.88397,-87.62459
13263,3,22,true,9,5,-4,41.88467,-87.61952
TA1306000015,3,22,true,8,6,-2,41.88549,-87.65232
13021,3,22,true,10,9,-1,41.88559,-87.64184
TA1307000111,3,22,true,8,2,-6,41.88582,-87.63548
KA1503000012,3,22,true,1,5,4,41.88599,-87.63089
TA1308000029,3,22,true,6,3,-3,41.88673,-87.62225
TA1307000131,3,22,true,10,9,-1,41.88688,-87.62606
KA1503000064,3,22,true,7,1,-6,41.88697,-87.61281
TA1305000022,3,22,true,6,11,5,41.88817,-87.63656
TA1306000003,3,22,true,8,10,2,41.88867,-87.64442
KA1503000043,3,22,true,10,12,2,41.88918,-87.63851
13050,3,22,true,7,5,-2,41.88919,-87.62775
TA1307000151,3,22,true,11,10,-1,41.88993,-87.63427
13427,3,22,true,4,5,1,41.89054,-87.62205
13430,3,22,true,16,3,-13,41.89077,-87.63169
TA1306000013,3,22,true,6,9,3,41.89083,-87.61852
RN-,3,22,true,3,10,7,41.89102,-87.63546
TA1307000117,3,22,true,11,4,-7,41.89144,-87.62675
13033,3,22,true,11,9,-2,41.8916,-87.64835
TA1305000003,3,22,true,6,12,6,41.89187,-87.62061
13022,3,22,true,13,4,-9,41.89227,-87.61205
TA1306000029,3,22,true,5,7,2,41.89256,-87.61449
13265,3,22,true,3,18,15,41.89383,-87.64172
13045,3,22,true,5,12,7,41.89403,-87.62931
KA1503000041,3,22,true,6,16,10,41.89452,-87.61798
TA1307000062,3,22,true,3,7,4,41.89466,-87.63839
TA1306000012,3,22,true,8,19,11,41.89475,-87.63438
13132,3,22,true,6,6,0,41.89573,-87.67718
15530,3,22,true,5,4,-1,41.89575,-87.62596
13289,3,22,true,5,6,1,41.89638,-87.661
13303,3,22,true,6,7,1,41.89672,-87.63088
13017,3,22,true,7,5,-2,41.89676,-87.6357
TA1307000061,3,22,true,1,10,9,41.89745,-87.62873
620,3,22,true,1,5,4,41.89817,-87.63754
15529,3,22,true,4,8,4,41.89858,-87.62206
TA1307000128,3,22,true,6,6,0,41.89896,-87.6299
TA1306000011,3,22,true,6,1,-5,41.89994,-87.63443
13290,3,22,true,2,6,4,41.90069,-87.66259
13042,3,22,true,5,1,-4,41.90097,-87.62377
KA1504000133,3,22,true,5,12,7,41.90234,-87.62773
TA1307000039,3,22,true,13,14,1,41.90294,-87.63137
TA1305000034,3,22,true,5,4,-1,41.90313,-87.67391
KA1504000135,3,22,true,26,17,-9,41.90319,-87.63439
13136,3,22,true,4,7,3,41.90326,-87.67845
13061,3,22,true,5,14,9,41.90342,-87.66779
TA1307000115,3,22,true,2,5,3,41.9046,-87.64056
TA1308000049,3,22,true,14,10,-4,41.90672,-87.6349
KA1504000134,3,22,true,4,5,1,41.90687,-87.6262
13224,3,22,true,5,4,-1,41.90706,-87.66725
TA1309000024,3,22,true,13,9,-4,41.908,-87.63152
TA1305000041,3,22,true,8,8,0,41.9094,-87.67769
331,3,22,true,10,10,0,41.90965,-87.64812
TA1305000037,3,22,true,2,5,3,41.91018,-87.67003
TA1306000008,3,22,true,1,5,4,41.9102,-87.6435
TA1307000038,3,22,true,22,9,-13,41.91138,-87.63868
LF-005,3,22,true,17,6,-11,41.91172,-87.62681
13128,3,22,true,15,4,-11,41.91197,-87.63197
TA1308000050,3,22,true,15,15,0,41.91211,-87.6347
TA1306000032,3,22,true,6,17,11,41.9137,-87.65285
TA1307000166,3,22,true,6,5,-1,41.91386,-87.64877
TA1306000007,3,22,true,2,5,3,41.91469,-87.64333
13179,3,22,true,26,14,-12,41.9157,-87.63461
13133,3,22,true,9,2,-7,41.91598,-87.67733
13266,3,22,true,5,3,-2,41.91774,-87.69142
TA1309000006,3,22,true,3,8,5,41.91809,-87.64375
TA1307000163,3,22,true,7,7,0,41.91821,-87.65696
13146,3,22,true,34,12,-22,41.91831,-87.63629
13059,3,22,true,6,13,7,41.91845,-87.65222
13192,3,22,true,4,8,4,41.91995,-87.64884
TA1309000030,3,22,true,5,7,2,41.92077,-87.66372
TA1309000033,3,22,true,6,11,5,41.92158,-87.65381
13193,3,22,true,11,10,-1,41.92182,-87.64412
13191,3,22,true,6,4,-2,41.92217,-87.63891
13084,3,22,true,6,5,-1,41.92268,-87.69715
LP-,3,22,true,2,6,4,41.92396,-87.63584
TA1307000001,3,22,true,8,5,-3,41.92535,-87.66581
TA1306000026,3,22,true,6,4,-2,41.92558,-87.65842
TA1306000016,3,22,true,3,9,6,41.9256,-87.65371
TA1309000019,3,22,true,3,6,3,41.92586,-87.63897
TA1309000058,3,22,true,7,11,4,41.92591,-87.64927
TA1308000001,3,22,true,5,4,-1,41.92627,-87.63086
TA1309000023,3,22,true,10,8,-2,41.9287,-87.65383
TA1307000113,3,22,true,9,9,0,41.92878,-87.66391
TA1309000059,3,22,true,6,6,0,41.92889,-87.65898
TA1309000061,3,22,true,7,9,2,41.92915,-87.64909
TA1305000014,3,22,true,7,11,4,41.92956,-87.64313
13085,3,22,true,4,5,1,41.92958,-87.70789
TA1307000142,3,22,true,7,8,1,41.93125,-87.64432
13276,3,22,true,1,6,5,41.93132,-87.63874
13271,3,22,true,1,6,5,41.93192,-87.67784
TA1307000064,3,22,true,3,8,5,41.93222,-87.65864
TA1306000014,3,22,true,5,5,0,41.93242,-87.65271
TA1309000039,3,22,true,5,7,2,41.93258,-87.63642
13294,3,22,true,7,10,3,41.9326,-87.66595
TA1309000036,3,22,true,1,5,4,41.93313,-87.64776
TA1307000006,3,22,true,4,8,4,41.93571,-87.6636
TA1307000052,3,22,true,7,8,1,41.93628,-87.65266
TA1307000136,3,22,true,2,5,3,41.9365,-87.64755
TA1307000041,3,22,true,3,7,4,41.93669,-87.63683
13137,3,22,true,5,11,6,41.9376,-87.6441
13229,3,22,true,1,7,6,41.93946,-87.66376
TA1308000019,3,22,true,9,6,-3,41.93973,-87.65886
13277,3,22,true,5,12,7,41.9401,-87.64546
TA1307000134,3,22,true,10,19,9,41.94016,-87.65303
TA1309000049,3,22,true,6,8,2,41.94077,-87.63919
TA1307000138,3,22,true,6,4,-2,41.94334,-87.67094
TA1309000025,3,22,true,13,19,6,41.94368,-87.64894
13071,3,22,true,7,7,0,41.94373,-87.66401
632,3,22,true,7,7,0,41.94453,-87.6547
13278,3,22,true,6,19,13,41.94553,-87.64644
13235,3,22,true,9,6,-3,41.94814,-87.66396
13325,3,22,true,5,10,5,41.94907,-87.64863
TA1307000126,3,22,true,7,8,1,41.94936,-87.65451
TA1307000150,3,22,true,4,11,7,41.94945,-87.64646
13323,3,22,true,7,16,9,41.95282,-87.65
TA1309000043,3,22,true,3,5,2,41.95417,-87.66434
13063,3,22,true,4,7,3,41.95424,-87.65441
TA1308000022,3,22,true,2,7,5,41.95438,-87.64805
13379,3,22,true,3,5,2,41.95786,-87.6495
TA1307000107,3,22,true,4,7,3,41.96164,-87.65464
TA1307000156,3,22,true,4,5,1,41.96301,-87.68479
TA1308000012,3,22,true,10,1,-9,41.96398,-87.63818
13074,3,22,true,5,3,-2,41.96521,-87.6582
KA1504000171,3,22,true,3,7,4,41.97161,-87.65016
13109,3,22,true,5,4,-1,41.97835,-87.65976
TA1309000063,3,23,false,3,5,2,41.79325,-87.5878
TA1308000009,3,23,false,4,5,1,41.79522,-87.58075
13135,3,23,false,3,6,3,41.85753,-87.66157
TA1307000124,3,23,false,4,6,2,41.86411,-87.62372
TA1305000002,3,23,false,3,10,7,41.86721,-87.62597
KA1706005007,3,23,false,3,8,5,41.86749,-87.63219
SL-005,3,23,false,6,4,-2,41.8679,-87.62304
644,3,23,false,1,5,4,41.86859,-87.68625
623,3,23,false,5,15,10,41.87272,-87.62399
SL-007,3,23,false,7,5,-2,41.87404,-87.6277
SL-010,3,23,false,6,9,3,41.87501,-87.63309
15541,3,23,false,10,12,2,41.8758,-87.62086
TA1305000010,3,23,false,7,4,-3,41.87623,-87.62444
TA1305000025,3,23,false,3,5,2,41.87773,-87.63528
13300,3,23,false,5,3,-2,41.88097,-87.61675
13008,3,23,false,14,22,8,41.88105,-87.62408
TA1305000006,3,23,false,7,5,-2,41.88122,-87.6296
TA1307000120,3,23,false,9,6,-3,41.88188,-87.64879
13053,3,23,false,10,6,-4,41.88365,-87.64863
13001,3,23,false,8,3,-5,41.88397,-87.62459
15535,3,23,false,5,6,1,41.8846,-87.64455
TA1305000029,3,23,false,2,6,4,41.88466,-87.62787
13263,3,23,false,8,7,-1,41.88467,-87.61952
TA1306000015,3,23,false,17,6,-11,41.88549,-87.65232
13021,3,23,false,6,2,-4,41.88559,-87.64184
TA1305000011,3,23,false,1,10,9,41.886,-87.62418
TA1307000131,3,23,false,7,5,-2,41.88688,-87.62606
TA1305000022,3,23,false,8,3,-5,41.88817,-87.63656
TA1306000003,3,23,false,5,3,-2,41.88867,-87.64442
13050,3,23,false,9,8,-1,41.88919,-87.62775
13427,3,23,false,11,1,-10,41.89054,-87.62205
13430,3,23,false,9,1,-8,41.89077,-87.63169
TA1306000013,3,23,false,9,7,-2,41.89083,-87.61852
RN-,3,23,false,2,5,3,41.89102,-87.63546
TA1307000117,3,23,false,9,17,8,41.89144,-87.62675
13033,3,23,false,5,4,-1,41.8916,-87.64835
TA1305000003,3,23,false,11,13,2,41.89187,-87.62061
13022,3,23,false,9,8,-1,41.89227,-87.61205
TA1306000029,3,23,false,17,6,-11,41.89256,-87.61449
13045,3,23,false,3,5,2,41.89403,-87.62931
13016,3,23,false,5,10,5,41.89431,-87.62277
KA1503000041,3,23,false,8,13,5,41.89452,-87.61798
TA1306000012,3,23,false,9,14,5,41.89475,-87.63438
KP1705001026,3,23,false,5,3,-2,41.89483,-87.6323
13132,3,23,false,1,5,4,41.89573,-87.67718
13247,3,23,false,9,2,-7,41.89597,-87.66775
TA1305000020,3,23,false,1,5,4,41.89636,-87.65406
13289,3,23,false,2,5,3,41.89638,-87.661
13303,3,23,false,9,7,-2,41.89672,-87.63088
15529,3,23,false,7,2,-5,41.89858,-87.62206
TA1306000011,3,23,false,6,4,-2,41.89994,-87.63443
13042,3,23,false,9,9,0,41.90097,-87.62377
KA1504000133,3,23,false,7,8,1,41.90234,-87.62773
TA1307000039,3,23,false,15,5,-10,41.90294,-87.63137
KA1504000135,3,23,false,9,7,-2,41.90319,-87.63439
13136,3,23,false,5,3,-2,41.90326,-87.67845
13061,3,23,false,7,4,-3,41.90342,-87.66779
TA1308000049,3,23,false,11,12,1,41.90672,-87.6349
KA1504000134,3,23,false,7,2,-5,41.90687,-87.6262
13224,3,23,false,2,6,4,41.90706,-87.66725
13221,3,23,false,5,6,1,41.90765,-87.67254
TA1309000024,3,23,false,10,5,-5,41.908,-87.63152
TA1305000041,3,23,false,9,3,-6,41.9094,-87.67769
TA1307000038,3,23,false,2,5,3,41.91138,-87.63868
TA1308000050,3,23,false,11,7,-4,41.91211,-87.6347
TA1307000166,3,23,false,3,5,2,41.91386,-87.64877
13179,3,23,false,8,12,4,41.9157,-87.63461
15650,3,23,false,3,5,2,41.91711,-87.71023
13146,3,23,false,32,6,-26,41.91831,-87.63629
13059,3,23,false,5,3,-2,41.91845,-87.65222
TA1309000033,3,23,false,2,5,3,41.92158,-87.65381
13193,3,23,false,7,5,-2,41.92182,-87.64412
13191,3,23,false,7,3,-4,41.92217,-87.63891
13084,3,23,false,3,8,5,41.92268,-87.69715
TA1307000001,3,23,false,3,7,4,41.92535,-87.66581
TA1306000016,3,23,false,6,5,-1,41.9256,-87.65371
TA1309000058,3,23,false,6,6,0,41.92591,-87.64927
TA1309000023,3,23,false,10,6,-4,41.9287,-87.65383
TA1309000061,3,23,false,10,2,-8,41.92915,-87.64909
TA1305000014,3,23,false,6,6,0,41.92956,-87.64313
TA1307000142,3,23,false,9,17,8,41.93125,-87.64432
TA1306000014,3,23,false,1,5,4,41.93242,-87.65271
TA1309000039,3,23,false,2,11,9,41.93258,-87.63642
TA1307000052,3,23,false,7,5,-2,41.93628,-87.65266
TA1307000136,3,23,false,1,10,9,41.9365,-87.64755
TA1308000019,3,23,false,5,8,3,41.93973,-87.65886
13277,3,23,false,1,7,6,41.9401,-87.64546
TA1307000134,3,23,false,7,10,3,41.94016,-87.65303
TA1309000025,3,23,false,2,11,9,41.94368,-87.64894
632,3,23,false,9,13,4,41.94453,-87.6547
13325,3,23,false,2,5,3,41.94907,-87.64863
TA1307000126,3,23,false,7,6,-1,41.94936,-87.65451
13323,3,23,false,6,3,-3,41.95282,-87.65
TA1309000027,3,23,false,2,8,6,41.9585,-87.65499
TA1308000021,3,23,false,2,5,3,41.96883,-87.65765
KA1504000146,3,23,false,6,1,-5,41.978,-87.66805
523,3,23,false,3,5,2,42.02089,-87.66505
KA1503000014,3,23,true,1,5,4,41.7851,-87.60108
TA1305000002,3,23,true,6,6,0,41.86721,-87.62597
TA1309000010,3,23,true,6,4,-2,41.87074,-87.62574
SL-008,3,23,true,3,6,3,41.87209,-87.62956
TA1305000025,3,23,true,1,5,4,41.87773,-87.63528
TA1307000120,3,23,true,5,8,3,41.88188,-87.64879
TA1305000032,3,23,true,4,5,1,41.88218,-87.64109
13053,3,23,true,7,3,-4,41.88365,-87.64863
15535,3,23,true,5,3,-2,41.8846,-87.64455
TA1306000015,3,23,true,5,1,-4,41.88549,-87.65232
15534,3,23,true,1,5,4,41.88627,-87.61749
TA1308000029,3,23,true,5,1,-4,41.88673,-87.62225
TA1307000131,3,23,true,5,4,-1,41.88688,-87.62606
TA1305000022,3,23,true,6,3,-3,41.88817,-87.63656
TA1306000003,3,23,true,12,10,-2,41.88867,-87.64442
TA1307000151,3,23,true,5,2,-3,41.88993,-87.63427
13430,3,23,true,5,1,-4,41.89077,-87.63169
TA1306000013,3,23,true,5,9,4,41.89083,-87.61852
TA1307000117,3,23,true,6,8,2,41.89144,-87.62675
13033,3,23,true,5,3,-2,41.8916,-87.64835
TA1306000029,3,23,true,3,6,3,41.89256,-87.61449
13045,3,23,true,5,2,-3,41.89403,-87.62931
KA1503000041,3,23,true,3,6,3,41.89452,-87.61798
TA1306000012,3,23,true,5,4,-1,41.89475,-87.63438
13303,3,23,true,5,3,-2,41.89672,-87.63088
TA1307000061,3,23,true,3,5,2,41.89745,-87.62873
TA1307000039,3,23,true,11,8,-3,41.90294,-87.63137
KA1504000135,3,23,true,12,9,-3,41.90319,-87.63439
13061,3,23,true,4,7,3,41.90342,-87.66779
KA1504000079,3,23,true,1,6,5,41.9035,-87.64334
TA1308000049,3,23,true,7,3,-4,41.90672,-87.6349
TA1309000024,3,23,true,6,5,-1,41.908,-87.63152
TA1307000038,3,23,true,7,5,-2,41.91138,-87.63868
TA1308000050,3,23,true,3,9,6,41.91211,-87.6347
TA1307000166,3,23,true,7,5,-2,41.91386,-87.64877
13146,3,23,true,9,6,-3,41.91831,-87.63629
13059,3,23,true,5,1,-4,41.91845,-87.65222
13193,3,23,true,10,3,-7,41.92182,-87.64412
13191,3,23,true,7,5,-2,41.92217,-87.63891
TA1306000016,3,23,true,6,4,-2,41.9256,-87.65371
TA1309000058,3,23,true,2,7,5,41.92591,-87.64927
TA1307000113,3,23,true,1,8,7,41.92878,-87.66391
TA1309000061,3,23,true,11,6,-5,41.92915,-87.64909
TA1305000014,3,23,true,6,4,-2,41.92956,-87.64313
TA1307000142,3,23,true,1,6,5,41.93125,-87.64432
TA1307000064,3,23,true,1,5,4,41.93222,-87.65864
13294,3,23,true,2,6,4,41.9326,-87.66595
TA1307000136,3,23,true,2,5,3,41.9365,-87.64755
13137,3,23,true,1,5,4,41.9376,-87.6441
13277,3,23,true,2,7,5,41.9401,-87.64546
TA1307000134,3,23,true,10,3,-7,41.94016,-87.65303
TA1309000025,3,23,true,4,7,3,41.94368,-87.64894
13071,3,23,true,2,5,3,41.94373,-87.66401
632,3,23,true,5,7,2,41.94453,-87.6547
13278,3,23,true,6,3,-3,41.94553,-87.64644
13325,3,23,true,3,6,3,41.94907,-87.64863
TA1307000127,3,23,true,1,5,4,41.9508,-87.65918
TA1308000022,3,23,true,5,5,0,41.95438,-87.64805
13074,3,23,true,3,7,4,41.96521,-87.6582
KA1504000146,3,23,true,6,3,-3,41.978,-87.66805
KA1503000014,4,0,false,1,7,6,41.7851,-87.60108
SL-005,4,0,false,8,5,-3,41.8679,-87.62304
TA1309000010,4,0,false,12,12,0,41.87074,-87.62574
623,4,0,false,3,11,8,41.87272,-87.62399
SL-007,4,0,false,4,7,3,41.87404,-87.6277
15541,4,0,false,5,6,1,41.8758,-87.62086
TA1309000002,4,0,false,4,5,1,41.87784,-87.62408
13008,4,0,false,11,13,2,41.88105,-87.62408
TA1305000006,4,0,false,4,5,1,41.88122,-87.6296
13036,4,0,false,5,6,1,41.8821,-87.62513
13001,4,0,false,9,2,-7,41.88397,-87.62459
TA1305000030,4,0,false,3,6,3,41.88459,-87.63178
15535,4,0,false,4,5,1,41.8846,-87.64455
TA1305000029,4,0,false,2,6,4,41.88466,-87.62787
13263,4,0,false,2,11,9,41.88467,-87.61952
TA1306000015,4,0,false,2,6,4,41.88549,-87.65232
KA1503000012,4,0,false,1,5,4,41.88599,-87.63089
TA1307000131,4,0,false,8,22,14,41.88688,-87.62606
KA1503000044,4,0,false,4,5,1,41.89018,-87.6262
13427,4,0,false,1,5,4,41.89054,-87.62205
TA1307000117,4,0,false,6,4,-2,41.89144,-87.62675
13022,4,0,false,5,6,1,41.89227,-87.61205
13045,4,0,false,6,2,-4,41.89403,-87.62931
KA1503000041,4,0,false,5,5,0,41.89452,-87.61798
15530,4,0,false,2,5,3,41.89575,-87.62596
13017,4,0,false,1,6,5,41.89676,-87.6357
TA1307000061,4,0,false,8,3,-5,41.89745,-87.62873
15529,4,0,false,5,9,4,41.89858,-87.62206
13042,4,0,false,12,9,-3,41.90097,-87.62377
KA1504000133,4,0,false,5,2,-3,41.90234,-87.62773
TA1308000049,4,0,false,1,6,5,41.90672,-87.6349
TA1305000041,4,0,false,2,5,3,41.9094,-87.67769
TA1308000050,4,0,false,5,3,-2,41.91211,-87.6347
13179,4,0,false,4,5,1,41.9157,-87.63461
13146,4,0,false,6,6,0,41.91831,-87.63629
13059,4,0,false,2,5,3,41.91845,-87.65222
TA1309000033,4,0,false,5,5,0,41.92158,-87.65381
LP-,4,0,false,2,7,5,41.92396,-87.63584
TA1309000019,4,0,false,5,7,2,41.92586,-87.63897
TA1309000058,4,0,false,5,6,1,41.92591,-87.64927
TA1309000061,4,0,false,1,6,5,41.92915,-87.64909
TA1309000036,4,0,false,1,5,4,41.93313,-87.64776
TA1307000006,4,0,false,2,5,3,41.93571,-87.6636
TA1307000052,4,0,false,2,6,4,41.93628,-87.65266
TA1307000134,4,0,false,5,5,0,41.94016,-87.65303
13063,4,0,false,1,9,8,41.95424,-87.65441
13045,4,0,true,5,3,-2,41.89403,-87.62931
TA1306000011,4,0,true,5,1,-4,41.89994,-87.63443
13133,4,0,true,6,2,-4,41.91598,-87.67733
13193,4,0,true,1,7,6,41.92182,-87.64412
TA1306000026,4,0,true,4,6,2,41.92558,-87.65842
TA1305000014,4,0,true,6,2,-4,41.92956,-87.64313
TA1306000014,4,0,true,6,2,-4,41.93242,-87.65271
TA1308000009,4,1,false,5,1,-4,41.79522,-87.58075
TA1309000037,4,1,false,1,5,4,41.79957,-87.59474
TA1305000002,4,1,false,6,4,-2,41.86721,-87.62597
SL-005,4,1,false,1,5,4,41.8679,-87.62304
TA1309000010,4,1,false,7,7,0,41.87074,-87.62574
623,4,1,false,12,4,-8,41.87272,-87.62399
13008,4,1,false,6,7,1,41.88105,-87.62408
13263,4,1,false,6,5,-1,41.88467,-87.61952
TA1305000011,4,1,false,5,3,-2,41.886,-87.62418
TA1307000131,4,1,false,5,6,1,41.88688,-87.62606
TA1305000003,4,1,false,1,7,6,41.89187,-87.62061
13303,4,1,false,1,8,7,41.89672,-87.63088
13042,4,1,false,2,12,10,41.90097,-87.62377
TA1307000039,4,1,false,6,1,-5,41.90294,-87.63137
TA1309000025,4,1,false,5,3,-2,41.94368,-87.64894
TA1307000107,4,1,false,5,2,-3,41.96164,-87.65464
TA1307000124,4,2,false,2,5,3,41.86411,-87.62372
TA1309000010,4,2,false,1,9,8,41.87074,-87.62574
623,4,2,false,2,5,3,41.87272,-87.62399
13263,4,2,false,3,9,6,41.88467,-87.61952
KA1503000041,4,4,true,2,5,3,41.89452,-87.61798
13303,4,5,false,5,1,-4,41.89672,-87.63088
SL-012,4,5,true,9,1,-8,41.86038,-87.62581
15544,4,5,true,1,7,6,41.86723,-87.61536
SL-005,4,5,true,9,3,-6,41.8679,-87.62304
SL-008,4,5,true,6,2,-4,41.87209,-87.62956
TA1309000004,4,5,true,1,8,7,41.87811,-87.63184
13011,4,5,true,6,4,-2,41.87931,-87.63993
TA1305000006,4,5,true,1,5,4,41.88122,-87.6296
TA1307000120,4,5,true,11,7,-4,41.88188,-87.64879
TA1305000032,4,5,true,1,8,7,41.88218,-87.64109
13155,4,5,true,3,6,3,41.88407,-87.65689
15534,4,5,true,5,1,-4,41.88627,-87.61749
TA1306000003,4,5,true,6,2,-4,41.88867,-87.64442
KA1503000043,4,5,true,4,16,12,41.88918,-87.63851
13430,4,5,true,6,1,-5,41.89077,-87.63169
TA1307000117,4,5,true,6,1,-5,41.89144,-87.62675
13045,4,5,true,3,10,7,41.89403,-87.62931
13016,4,5,true,3,14,11,41.89431,-87.62277
TA1307000062,4,5,true,8,4,-4,41.89466,-87.63839
13042,4,5,true,4,5,1,41.90097,-87.62377
KA1504000133,4,5,true,6,1,-5,41.90234,-87.62773
TA1307000039,4,5,true,9,10,1,41.90294,-87.63137
KA1504000135,4,5,true,9,2,-7,41.90319,-87.63439
TA1307000038,4,5,true,3,6,3,41.91138,-87.63868
13146,4,5,true,5,1,-4,41.91831,-87.63629
13276,4,5,true,6,2,-4,41.93132,-87.63874
13325,4,5,true,1,5,4,41.94907,-87.64863
TA1307000150,4,5,true,5,4,-1,41.94945,-87.64646
SL-011,4,6,false,5,1,-4,41.87256,-87.63356
TA1307000120,4,6,false,7,3,-4,41.88188,-87.64879
13341,4,6,false,2,6,4,41.88208,-87.63985
TA1305000029,4,6,false,6,3,-3,41.88466,-87.62787
RN-,4,6,false,1,7,6,41.89102,-87.63546
13016,4,6,false,2,9,7,41.89431,-87.62277
TA1306000012,4,6,false,8,3,-5,41.89475,-87.63438
13132,4,6,false,5,3,-2,41.89573,-87.67718
13338,4,6,false,1,7,6,41.89697,-87.62173
KA1504000133,4,6,false,6,2,-4,41.90234,-87.62773
TA1307000039,4,6,false,6,5,-1,41.90294,-87.63137
TA1305000037,4,6,false,7,1,-6,41.91018,-87.67003
TA1307000038,4,6,false,7,1,-6,41.91138,-87.63868
LF-005,4,6,false,1,5,4,41.91172,-87.62681
13193,4,6,false,5,1,-4,41.92182,-87.64412
13191,4,6,false,5,1,-4,41.92217,-87.63891
TA1309000058,4,6,false,1,5,4,41.92591,-87.64927
13276,4,6,false,8,1,-7,41.93132,-87.63874
TA1307000052,4,6,false,1,7,6,41.93628,-87.65266
KA1503000014,4,6,true,5,1,-4,41.7851,-87.60108
TA1307000048,4,6,true,7,5,-2,41.83855,-87.60821
13150,4,6,true,8,4,-4,41.85783,-87.62455
TA1307000124,4,6,true,16,2,-14,41.86411,-87.62372
TA1309000001,4,6,true,7,1,-6,41.86488,-87.64708
TA1305000002,4,6,true,11,1,-10,41.86721,-87.62597
KA1706005007,4,6,true,5,1,-4,41.86749,-87.63219
SL-005,4,6,true,9,5,-4,41.8679,-87.62304
15550,4,6,true,1,5,4,41.87024,-87.63947
TA1309000010,4,6,true,12,4,-8,41.87074,-87.62574
TA1309000064,4,6,true,1,29,28,41.87127,-87.67369
SL-011,4,6,true,10,1,-9,41.87256,-87.63356
623,4,6,true,12,1,-11,41.87272,-87.62399
KA1504000104,4,6,true,2,42,40,41.87296,-87.66912
SL-007,4,6,true,5,1,-4,41.87404,-87.6277
13081,4,6,true,1,5,4,41.87501,-87.67326
SL-010,4,6,true,9,2,-7,41.87501,-87.63309
TA1305000009,4,6,true,6,6,0,41.87593,-87.63068
TA1305000035,4,6,true,1,8,7,41.87716,-87.62787
15539,4,6,true,3,5,2,41.87763,-87.64405
13158,4,6,true,6,1,-5,41.87764,-87.64957
TA1309000004,4,6,true,10,29,19,41.87811,-87.63184
638,4,6,true,14,14,0,41.87827,-87.64078
13011,4,6,true,7,4,-3,41.87931,-87.63993
TA1309000008,4,6,true,2,14,12,41.87933,-87.6355
TA1309000007,4,6,true,1,14,13,41.88022,-87.63526
WL-011,4,6,true,6,4,-2,41.88034,-87.64273
13156,4,6,true,7,1,-6,41.88042,-87.65554
13300,4,6,true,5,5,0,41.88097,-87.61675
13008,4,6,true,2,8,6,41.88105,-87.62408
13056,4,6,true,5,8,3,41.88168,-87.63951
TA1307000120,4,6,true,9,9,0,41.88188,-87.64879
TA1305000032,4,6,true,15,23,8,41.88218,-87.64109
13353,4,6,true,8,2,-6,41.88283,-87.6612
KA1503000072,4,6,true,5,9,4,41.88317,-87.63693
WL-012,4,6,true,24,20,-4,41.88337,-87.6412
13053,4,6,true,1,9,8,41.88365,-87.64863
13001,4,6,true,10,11,1,41.88397,-87.62459
TA1305000030,4,6,true,1,7,6,41.88459,-87.63178
13263,4,6,true,17,12,-5,41.88467,-87.61952
TA1306000015,4,6,true,2,8,6,41.88549,-87.65232
13021,4,6,true,12,7,-5,41.88559,-87.64184
TA1307000111,4,6,true,4,8,4,41.88582,-87.63548
TA1305000011,4,6,true,9,18,9,41.886,-87.62418
15534,4,6,true,5,9,4,41.88627,-87.61749
TA1307000131,4,6,true,6,5,-1,41.88688,-87.62606
KA1503000064,4,6,true,3,5,2,41.88697,-87.61281
TA1305000022,4,6,true,12,9,-3,41.88817,-87.63656
TA1306000003,4,6,true,14,4,-10,41.88867,-87.64442
KA1503000043,4,6,true,24,16,-8,41.88918,-87.63851
TA1307000151,4,6,true,6,8,2,41.88993,-87.63427
636,4,6,true,8,1,-7,41.88997,-87.63662
KA1503000044,4,6,true,3,5,2,41.89018,-87.6262
13427,4,6,true,10,13,3,41.89054,-87.62205
13430,4,6,true,3,5,2,41.89077,-87.63169
13033,4,6,true,7,4,-3,41.8916,-87.64835
13194,4,6,true,11,2,-9,41.8918,-87.65878
TA1305000003,4,6,true,5,5,0,41.89187,-87.62061
13022,4,6,true,9,10,1,41.89227,-87.61205
TA1306000029,4,6,true,9,7,-2,41.89256,-87.61449
13265,4,6,true,14,5,-9,41.89383,-87.64172
13045,4,6,true,17,21,4,41.89403,-87.62931
13016,4,6,true,11,41,30,41.89431,-87.62277
KA1503000041,4,6,true,9,34,25,41.89452,-87.61798
13196,4,6,true,6,2,-4,41.89455,-87.65345
TA1307000062,4,6,true,11,7,-4,41.89466,-87.63839
TA1306000012,4,6,true,21,16,-5,41.89475,-87.63438
KP1705001026,4,6,true,4,7,3,41.89483,-87.6323
15530,4,6,true,7,12,5,41.89575,-87.62596
18003,4,6,true,2,10,8,41.89575,-87.62011
13247,4,6,true,8,1,-7,41.89597,-87.66775
TA1305000020,4,6,true,10,3,-7,41.89636,-87.65406
13289,4,6,true,7,2,-5,41.89638,-87.661
13303,4,6,true,8,10,2,41.89672,-87.63088
13017,4,6,true,9,11,2,41.89676,-87.6357
13338,4,6,true,8,28,20,41.89697,-87.62173
13034,4,6,true,4,10,6,41.89754,-87.62352
TA1306000009,4,6,true,5,11,6,41.89772,-87.64299
620,4,6,true,15,4,-11,41.89817,-87.63754
15529,4,6,true,5,8,3,41.89858,-87.62206
TA1307000128,4,6,true,10,1,-9,41.89896,-87.6299
TA1306000011,4,6,true,12,2,-10,41.89994,-87.63443
13290,4,6,true,7,3,-4,41.90069,-87.66259
13042,4,6,true,2,9,7,41.90097,-87.62377
KA1504000133,4,6,true,7,3,-4,41.90234,-87.62773
TA1307000039,4,6,true,30,17,-13,41.90294,-87.63137
KA1504000135,4,6,true,8,4,-4,41.90319,-87.63439
13061,4,6,true,13,3,-10,41.90342,-87.66779
13224,4,6,true,7,1,-6,41.90706,-87.66725
13221,4,6,true,7,1,-6,41.90765,-87.67254
TA1305000041,4,6,true,2,7,5,41.9094,-87.67769
TA1305000037,4,6,true,10,3,-7,41.91018,-87.67003
LF-005,4,6,true,4,7,3,41.91172,-87.62681
13128,4,6,true,5,1,-4,41.91197,-87.63197
TA1308000050,4,6,true,6,10,4,41.91211,-87.6347
13179,4,6,true,9,7,-2,41.9157,-87.63461
13146,4,6,true,10,1,-9,41.91831,-87.63629
TA1309000033,4,6,true,5,1,-4,41.92158,-87.65381
13193,4,6,true,5,3,-2,41.92182,-87.64412
13191,4,6,true,13,2,-11,41.92217,-87.63891
TA1307000001,4,6,true,4,5,1,41.92535,-87.66581
TA1306000016,4,6,true,3,21,18,41.9256,-87.65371
TA1309000019,4,6,true,9,3,-6,41.92586,-87.63897
TA1309000058,4,6,true,9,6,-3,41.92591,-87.64927
TA1308000001,4,6,true,5,9,4,41.92627,-87.63086
TA1307000113,4,6,true,8,1,-7,41.92878,-87.66391
13296,4,6,true,5,2,-3,41.92883,-87.66852
TA1309000059,4,6,true,8,5,-3,41.92889,-87.65898
TA1309000061,4,6,true,12,2,-10,41.92915,-87.64909
TA1305000014,4,6,true,5,4,-1,41.92956,-87.64313
TA1307000142,4,6,true,6,2,-4,41.93125,-87.64432
13276,4,6,true,10,4,-6,41.93132,-87.63874
TA1307000064,4,6,true,10,6,-4,41.93222,-87.65864
TA1306000014,4,6,true,8,10,2,41.93242,-87.65271
TA1309000039,4,6,true,10,5,-5,41.93258,-87.63642
TA1309000036,4,6,true,4,9,5,41.93313,-87.64776
13268,4,6,true,3,7,4,41.93588,-87.67843
TA1307000052,4,6,true,10,5,-5,41.93628,-87.65266
TA1307000136,4,6,true,4,5,1,41.9365,-87.64755
TA1307000041,4,6,true,6,3,-3,41.93669,-87.63683
13137,4,6,true,2,6,4,41.9376,-87.6441
13277,4,6,true,11,1,-10,41.9401,-87.64546
TA1307000134,4,6,true,9,6,-3,41.94016,-87.65303
TA1309000049,4,6,true,5,4,-1,41.94077,-87.63919
TA1309000025,4,6,true,5,8,3,41.94368,-87.64894
13071,4,6,true,3,7,4,41.94373,-87.66401
13278,4,6,true,7,4,-3,41.94553,-87.64644
13325,4,6,true,5,3,-2,41.94907,-87.64863
TA1307000126,4,6,true,13,2,-11,41.94936,-87.65451
TA1307000150,4,6,true,6,5,-1,41.94945,-87.64646
13319,4,6,true,6,1,-5,41.95069,-87.6687
13063,4,6,true,6,2,-4,41.95424,-87.65441
TA1309000026,4,6,true,5,1,-4,41.95601,-87.6802
15622,4,6,true,1,5,4,41.96108,-87.69544
KA1503000022,4,6,true,5,1,-4,41.96158,-87.66609
TA1307000107,4,6,true,9,3,-6,41.96164,-87.65464
SL-005,4,7,false,6,1,-5,41.8679,-87.62304
TA1309000010,4,7,false,5,1,-4,41.87074,-87.62574
SL-009,4,7,false,5,2,-3,41.87081,-87.63121
TA1309000004,4,7,false,2,6,4,41.87811,-87.63184
638,4,7,false,3,5,2,41.87827,-87.64078
13011,4,7,false,4,6,2,41.87931,-87.63993
WL-011,4,7,false,3,5,2,41.88034,-87.64273
13056,4,7,false,7,2,-5,41.88168,-87.63951
TA1307000120,4,7,false,9,8,-1,41.88188,-87.64879
13341,4,7,false,5,10,5,41.88208,-87.63985
TA1305000032,4,7,false,5,5,0,41.88218,-87.64109
13006,4,7,false,3,13,10,41.88268,-87.63252
KA1503000072,4,7,false,1,8,7,41.88317,-87.63693
WL-012,4,7,false,6,11,5,41.88337,-87.6412
13263,4,7,false,2,5,3,41.88467,-87.61952
TA1306000015,4,7,false,5,10,5,41.88549,-87.65232
13021,4,7,false,6,7,1,41.88559,-87.64184
TA1307000111,4,7,false,2,9,7,41.88582,-87.63548
KA1503000012,4,7,false,4,6,2,41.88599,-87.63089
TA1305000011,4,7,false,7,3,-4,41.886,-87.62418
TA1306000003,4,7,false,8,4,-4,41.88867,-87.64442
KA1503000043,4,7,false,5,5,0,41.88918,-87.63851
TA1307000151,4,7,false,3,6,3,41.88993,-87.63427
TA1306000013,4,7,false,9,3,-6,41.89083,-87.61852
TA1307000117,4,7,false,2,5,3,41.89144,-87.62675
13033,4,7,false,4,5,1,41.8916,-87.64835
13022,4,7,false,3,10,7,41.89227,-87.61205
TA1306000029,4,7,false,5,2,-3,41.89256,-87.61449
13045,4,7,false,11,9,-2,41.89403,-87.62931
13016,4,7,false,7,10,3,41.89431,-87.62277
KA1503000041,4,7,false,5,6,1,41.89452,-87.61798
13196,4,7,false,8,2,-6,41.89455,-87.65345
TA1307000062,4,7,false,6,2,-4,41.89466,-87.63839
TA1306000012,4,7,false,7,9,2,41.89475,-87.63438
KP1705001026,4,7,false,9,3,-6,41.89483,-87.6323
15530,4,7,false,5,4,-1,41.89575,-87.62596
13289,4,7,false,5,1,-4,41.89638,-87.661
13017,4,7,false,1,5,4,41.89676,-87.6357
13338,4,7,false,8,1,-7,41.89697,-87.62173
TA1307000061,4,7,false,5,1,-4,41.89745,-87.62873
TA1306000009,4,7,false,7,11,4,41.89772,-87.64299
620,4,7,false,5,3,-2,41.89817,-87.63754
13042,4,7,false,8,7,-1,41.90097,-87.62377
KA1504000133,4,7,false,6,5,-1,41.90234,-87.62773
TA1307000039,4,7,false,15,1,-14,41.90294,-87.63137
KA1504000135,4,7,false,5,7,2,41.90319,-87.63439
KA1504000079,4,7,false,7,4,-3,41.9035,-87.64334
KA1504000134,4,7,false,4,5,1,41.90687,-87.6262
TA1305000041,4,7,false,4,5,1,41.9094,-87.67769
TA1308000050,4,7,false,2,9,7,41.91211,-87.6347
13179,4,7,false,5,2,-3,41.9157,-87.63461
13059,4,7,false,7,4,-3,41.91845,-87.65222
13192,4,7,false,7,4,-3,41.91995,-87.64884
TA1309000030,4,7,false,1,5,4,41.92077,-87.66372
13191,4,7,false,6,4,-2,41.92217,-87.63891
TA1307000001,4,7,false,6,3,-3,41.92535,-87.66581
TA1306000016,4,7,false,2,5,3,41.9256,-87.65371
TA1309000019,4,7,false,8,2,-6,41.92586,-87.63897
TA1309000058,4,7,false,5,3,-2,41.92591,-87.64927
TA1307000113,4,7,false,5,1,-4,41.92878,-87.66391
TA1305000014,4,7,false,7,4,-3,41.92956,-87.64313
TA1307000142,4,7,false,5,3,-2,41.93125,-87.64432
13276,4,7,false,9,5,-4,41.93132,-87.63874
TA1307000041,4,7,false,2,6,4,41.93669,-87.63683
TA1309000049,4,7,false,5,2,-3,41.94077,-87.63919
TA1307000126,4,7,false,5,4,-1,41.94936,-87.65451
TA1307000127,4,7,false,5,2,-3,41.9508,-87.65918
TA1307000119,4,7,false,5,1,-4,41.96796,-87.65
TA1308000045,4,7,true,3,7,4,41.83062,-87.64129
TA1307000048,4,7,true,4,7,3,41.83855,-87.60821
TA1307000153,4,7,true,10,2,-8,41.84358,-87.64538
15546,4,7,true,6,1,-5,41.85416,-87.61916
15545,4,7,true,3,8,5,41.85627,-87.61334
13102,4,7,true,12,1,-11,41.85762,-87.61942
13150,4,7,true,8,4,-4,41.85783,-87.62455
SL-012,4,7,true,14,6,-8,41.86038,-87.62581
TA1307000124,4,7,true,17,5,-12,41.86411,-87.62372
TA1305000002,4,7,true,12,3,-9,41.86721,-87.62597
15544,4,7,true,6,6,0,41.86723,-87.61536
SL-005,4,7,true,24,8,-16,41.8679,-87.62304
13160,4,7,true,5,2,-3,41.86947,-87.65548
TA1309000010,4,7,true,13,3,-10,41.87074,-87.62574
TA1309000064,4,7,true,2,30,28,41.87127,-87.67369
SL-008,4,7,true,12,5,-7,41.87209,-87.62956
13332,4,7,true,8,4,-4,41.87219,-87.6615
SL-011,4,7,true,14,4,-10,41.87256,-87.63356
623,4,7,true,7,10,3,41.87272,-87.62399
KA1504000104,4,7,true,4,29,25,41.87296,-87.66912
13326,4,7,true,3,6,3,41.87425,-87.63958
SL-010,4,7,true,17,2,-15,41.87501,-87.63309
13037,4,7,true,7,3,-4,41.87588,-87.64078
TA1305000035,4,7,true,3,9,6,41.87716,-87.62787
13138,4,7,true,8,14,6,41.87723,-87.63941
15539,4,7,true,5,2,-3,41.87763,-87.64405
13158,4,7,true,28,6,-22,41.87764,-87.64957
13157,4,7,true,10,6,-4,41.87773,-87.6548
TA1305000025,4,7,true,8,31,23,41.87773,-87.63528
13206,4,7,true,6,4,-2,41.87794,-87.66201
TA1309000004,4,7,true,14,60,46,41.87811,-87.63184
638,4,7,true,25,25,0,41.87827,-87.64078
13011,4,7,true,32,8,-24,41.87931,-87.63993
TA1309000008,4,7,true,9,32,23,41.87933,-87.6355
KA1503000034,4,7,true,1,12,11,41.87938,-87.63197
KA1503000015,4,7,true,1,17,16,41.87948,-87.6257
TA1309000007,4,7,true,4,36,32,41.88022,-87.63526
WL-011,4,7,true,2,6,4,41.88034,-87.64273
13156,4,7,true,12,7,-5,41.88042,-87.65554
13008,4,7,true,1,7,6,41.88105,-87.62408
TA1305000006,4,7,true,4,37,33,41.88122,-87.6296
13134,4,7,true,6,3,-3,41.88138,-87.67493
13056,4,7,true,13,19,6,41.88168,-87.63951
TA1307000120,4,7,true,23,18,-5,41.88188,-87.64879
13341,4,7,true,17,20,3,41.88208,-87.63985
TA1305000032,4,7,true,25,28,3,41.88218,-87.64109
13006,4,7,true,6,16,10,41.88268,-87.63252
13353,4,7,true,10,9,-1,41.88283,-87.6612
654,4,7,true,9,7,-2,41.88307,-87.65698
KA1503000072,4,7,true,3,27,24,41.88317,-87.63693
WL-012,4,7,true,26,14,-12,41.88337,-87.6412
13001,4,7,true,8,19,11,41.88397,-87.62459
13155,4,7,true,7,11,4,41.88407,-87.65689
18062,4,7,true,7,8,1,41.88412,-87.65427
TA1306000010,4,7,true,4,35,31,41.88419,-87.62961
TA1305000030,4,7,true,7,22,15,41.88459,-87.63178
15535,4,7,true,12,6,-6,41.8846,-87.64455
TA1305000029,4,7,true,5,12,7,41.88466,-87.62787
13263,4,7,true,28,11,-17,41.88467,-87.61952
TA1306000015,4,7,true,6,14,8,41.88549,-87.65232
13021,4,7,true,18,38,20,41.88559,-87.64184
TA1307000111,4,7,true,14,44,30,41.88582,-87.63548
KA1503000012,4,7,true,4,17,13,41.88599,-87.63089
TA1305000011,4,7,true,10,38,28,41.886,-87.62418
15534,4,7,true,15,6,-9,41.88627,-87.61749
13197,4,7,true,5,17,12,41.8866,-87.65816
TA1308000029,4,7,true,5,13,8,41.88673,-87.62225
TA1307000131,4,7,true,5,8,3,41.88688,-87.62606
KA1503000064,4,7,true,4,14,10,41.88697,-87.61281
TA1305000022,4,7,true,20,23,3,41.88817,-87.63656
TA1306000003,4,7,true,16,4,-12,41.88867,-87.64442
KA1503000043,4,7,true,44,31,-13,41.88918,-87.63851
13050,4,7,true,5,11,6,41.88919,-87.62775
TA1307000151,4,7,true,12,30,18,41.88993,-87.63427
636,4,7,true,10,5,-5,41.88997,-87.63662
KA1503000044,4,7,true,6,14,8,41.89018,-87.6262
13427,4,7,true,23,8,-15,41.89054,-87.62205
13430,4,7,true,5,9,4,41.89077,-87.63169
TA1306000013,4,7,true,10,5,-5,41.89083,-87.61852
RN-,4,7,true,18,8,-10,41.89102,-87.63546
13434,4,7,true,8,2,-6,41.89108,-87.66663
TA1308000006,4,7,true,3,5,2,41.89128,-87.67686
TA1307000117,4,7,true,13,18,5,41.89144,-87.62675
13033,4,7,true,15,7,-8,41.8916,-87.64835
13194,4,7,true,7,3,-4,41.8918,-87.65878
TA1305000003,4,7,true,7,11,4,41.89187,-87.62061
13022,4,7,true,4,5,1,41.89227,-87.61205
TA1306000029,4,7,true,16,3,-13,41.89256,-87.61449
13265,4,7,true,29,6,-23,41.89383,-87.64172
13045,4,7,true,16,35,19,41.89403,-87.62931
13016,4,7,true,10,86,76,41.89431,-87.62277
KA1503000041,4,7,true,21,24,3,41.89452,-87.61798
13196,4,7,true,7,3,-4,41.89455,-87.65345
TA1307000062,4,7,true,14,21,7,41.89466,-87.63839
TA1306000012,4,7,true,24,12,-12,41.89475,-87.63438
KP1705001026,4,7,true,10,10,0,41.89483,-87.6323
637,4,7,true,12,1,-11,41.89563,-87.67209
15530,4,7,true,13,28,15,41.89575,-87.62596
18003,4,7,true,5,7,2,41.89575,-87.62011
13247,4,7,true,7,2,-5,41.89597,-87.66775
TA1305000020,4,7,true,9,6,-3,41.89636,-87.65406
13289,4,7,true,13,6,-7,41.89638,-87.661
13303,4,7,true,15,9,-6,41.89672,-87.63088
13017,4,7,true,18,15,-3,41.89676,-87.6357
13338,4,7,true,28,31,3,41.89697,-87.62173
TA1307000061,4,7,true,16,9,-7,41.89745,-87.62873
13034,4,7,true,3,7,4,41.89754,-87.62352
TA1306000009,4,7,true,27,41,14,41.89772,-87.64299
620,4,7,true,8,4,-4,41.89817,-87.63754
KA1504000103,4,7,true,12,3,-9,41.89842,-87.68659
15529,4,7,true,17,19,2,41.89858,-87.62206
TA1307000128,4,7,true,30,11,-19,41.89896,-87.6299
657,4,7,true,5,2,-3,41.89918,-87.6722
13248,4,7,true,14,4,-10,41.89964,-87.66788
TA1306000011,4,7,true,11,2,-9,41.89994,-87.63443
KA1504000116,4,7,true,13,6,-7,41.90023,-87.64299
13042,4,7,true,13,14,1,41.90097,-87.62377
KA1504000133,4,7,true,12,7,-5,41.90234,-87.62773
TA1306000006,4,7,true,12,5,-7,41.90292,-87.63772
TA1307000039,4,7,true,67,20,-47,41.90294,-87.63137
KA1504000135,4,7,true,18,12,-6,41.90319,-87.63439
13061,4,7,true,8,12,4,41.90342,-87.66779
KA1504000079,4,7,true,8,8,0,41.9035,-87.64334
TA1307000115,4,7,true,12,5,-7,41.9046,-87.64056
TA1308000049,4,7,true,6,3,-3,41.90672,-87.6349
KA1504000134,4,7,true,14,4,-10,41.90687,-87.6262
13224,4,7,true,12,1,-11,41.90706,-87.66725
TA1307000143,4,7,true,10,3,-7,41.90762,-87.63854
13221,4,7,true,5,4,-1,41.90765,-87.67254
TA1309000024,4,7,true,13,10,-3,41.908,-87.63152
TA1305000041,4,7,true,1,14,13,41.9094,-87.67769
331,4,7,true,7,15,8,41.90965,-87.64812
TA1305000037,4,7,true,7,5,-2,41.91018,-87.67003
TA1306000008,4,7,true,18,1,-17,41.9102,-87.6435
13154,4,7,true,9,14,5,41.91054,-87.65312
13058,4,7,true,4,11,7,41.91059,-87.64942
TA1307000038,4,7,true,8,7,-1,41.91138,-87.63868
LF-005,4,7,true,8,6,-2,41.91172,-87.62681
13128,4,7,true,5,5,0,41.91197,-87.63197
TA1308000050,4,7,true,23,15,-8,41.91211,-87.6347
13243,4,7,true,4,7,3,41.91262,-87.6814
TA1306000032,4,7,true,8,3,-5,41.9137,-87.65285
TA1307000166,4,7,true,10,9,-1,41.91386,-87.64877
13068,4,7,true,8,3,-5,41.91554,-87.68703
13179,4,7,true,11,6,-5,41.9157,-87.63461
13133,4,7,true,7,1,-6,41.91598,-87.67733
15651,4,7,true,9,2,-7,41.91752,-87.70181
TA1309000029,4,7,true,6,1,-5,41.9178,-87.68245
TA1309000006,4,7,true,9,5,-4,41.91809,-87.64375
TA1307000163,4,7,true,8,7,-1,41.91821,-87.65696
13146,4,7,true,10,5,-5,41.91831,-87.63629
13059,4,7,true,9,7,-2,41.91845,-87.65222
13192,4,7,true,14,12,-2,41.91995,-87.64884
13288,4,7,true,6,2,-4,41.92008,-87.67788
13242,4,7,true,5,2,-3,41.92021,-87.69266
TA1309000030,4,7,true,5,1,-4,41.92077,-87.66372
TA1309000033,4,7,true,9,7,-2,41.92158,-87.65381
13193,4,7,true,19,12,-7,41.92182,-87.64412
13191,4,7,true,13,10,-3,41.92217,-87.63891
13084,4,7,true,2,5,3,41.92268,-87.69715
LP-,4,7,true,11,6,-5,41.92396,-87.63584
TA1307000001,4,7,true,9,1,-8,41.92535,-87.66581
TA1306000026,4,7,true,5,7,2,41.92558,-87.65842
TA1306000016,4,7,true,5,15,10,41.9256,-87.65371
TA1309000019,4,7,true,17,8,-9,41.92586,-87.63897
TA1309000058,4,7,true,12,10,-2,41.92591,-87.64927
TA1308000001,4,7,true,13,10,-3,41.92627,-87.63086
TA1309000023,4,7,true,12,5,-7,41.9287,-87.65383
TA1307000113,4,7,true,10,4,-6,41.92878,-87.66391
13296,4,7,true,5,3,-2,41.92883,-87.66852
TA1309000059,4,7,true,15,5,-10,41.92889,-87.65898
TA1305000014,4,7,true,28,8,-20,41.92956,-87.64313
TA1307000142,4,7,true,9,7,-2,41.93125,-87.64432
13276,4,7,true,18,13,-5,41.93132,-87.63874
TA1307000064,4,7,true,10,11,1,41.93222,-87.65864
TA1306000014,4,7,true,14,11,-3,41.93242,-87.65271
TA1309000039,4,7,true,16,6,-10,41.93258,-87.63642
13294,4,7,true,6,1,-5,41.9326,-87.66595
TA1309000036,4,7,true,6,1,-5,41.93313,-87.64776
TA1307000006,4,7,true,15,9,-6,41.93571,-87.6636
13268,4,7,true,12,3,-9,41.93588,-87.67843
13269,4,7,true,8,5,-3,41.93609,-87.66983
TA1307000052,4,7,true,5,24,19,41.93628,-87.65266
TA1307000136,4,7,true,5,4,-1,41.9365,-87.64755
TA1307000041,4,7,true,9,10,1,41.93669,-87.63683
13137,4,7,true,19,5,-14,41.9376,-87.6441
TA1309000042,4,7,true,9,10,1,41.93937,-87.66836
TA1308000019,4,7,true,10,3,-7,41.93973,-87.65886
13277,4,7,true,6,5,-1,41.9401,-87.64546
TA1307000134,4,7,true,2,13,11,41.94016,-87.65303
TA1309000049,4,7,true,7,4,-3,41.94077,-87.63919
TA1307000138,4,7,true,8,5,-3,41.94334,-87.67094
TA1309000025,4,7,true,12,4,-8,41.94368,-87.64894
13071,4,7,true,5,9,4,41.94373,-87.66401
632,4,7,true,5,3,-2,41.94453,-87.6547
13278,4,7,true,13,3,-10,41.94553,-87.64644
KA1504000143,4,7,true,3,6,3,41.94664,-87.68337
13235,4,7,true,8,7,-1,41.94814,-87.66396
13325,4,7,true,10,2,-8,41.94907,-87.64863
TA1307000126,4,7,true,8,2,-6,41.94936,-87.65451
TA1307000150,4,7,true,10,2,-8,41.94945,-87.64646
13319,4,7,true,6,3,-3,41.95069,-87.6687
13323,4,7,true,12,10,-2,41.95282,-87.65
13063,4,7,true,9,7,-2,41.95424,-87.65441
TA1308000022,4,7,true,8,2,-6,41.95438,-87.64805
TA1307000149,4,7,true,3,6,3,41.95467,-87.67392
TA1309000026,4,7,true,5,1,-4,41.95601,-87.6802
13379,4,7,true,7,1,-6,41.95786,-87.6495
TA1309000027,4,7,true,9,1,-8,41.9585,-87.65499
13389,4,7,true,5,3,-2,41.961,-87.64958
TA1307000144,4,7,true,6,8,2,41.96142,-87.6762
TA1307000156,4,7,true,8,1,-7,41.96301,-87.68479
TA1309000012,4,7,true,2,5,3,41.96325,-87.67928
639,4,7,true,6,3,-3,41.96584,-87.64538
TA1309000014,4,7,true,6,1,-5,41.96709,-87.66744
TA1307000158,4,7,true,4,9,5,41.9671,-87.67904
TA1309000066,4,7,true,7,8,1,41.9691,-87.67423
TA1309000035,4,7,true,5,3,-2,41.97335,-87.66785
13108,4,7,true,8,3,-5,41.97379,-87.65971
KA1504000146,4,7,true,6,3,-3,41.978,-87.66805
KA1504000151,4,7,true,7,2,-5,41.98359,-87.66916
KA1504000152,4,7,true,3,5,2,41.98403,-87.65231
15575,4,7,true,3,6,3,41.98975,-87.66014
TA1308000009,4,8,false,8,3,-5,41.79522,-87.58075
SL-005,4,8,false,9,5,-4,41.8679,-87.62304
623,4,8,false,8,3,-5,41.87272,-87.62399
SL-010,4,8,false,2,5,3,41.87501,-87.63309
TA1305000035,4,8,false,1,5,4,41.87716,-87.62787
13157,4,8,false,5,2,-3,41.87773,-87.6548
TA1309000004,4,8,false,1,6,5,41.87811,-87.63184
638,4,8,false,3,7,4,41.87827,-87.64078
13011,4,8,false,8,11,3,41.87931,-87.63993
WL-011,4,8,false,2,8,6,41.88034,-87.64273
13008,4,8,false,3,5,2,41.88105,-87.62408
TA1305000006,4,8,false,3,19,16,41.88122,-87.6296
TA1307000120,4,8,false,10,9,-1,41.88188,-87.64879
13341,4,8,false,10,6,-4,41.88208,-87.63985
13036,4,8,false,2,6,4,41.8821,-87.62513
TA1305000032,4,8,false,6,8,2,41.88218,-87.64109
13006,4,8,false,3,6,3,41.88268,-87.63252
13409,4,8,false,3,5,2,41.8831,-87.6511
KA1503000072,4,8,false,2,8,6,41.88317,-87.63693
WL-012,4,8,false,5,7,2,41.88337,-87.6412
13053,4,8,false,5,2,-3,41.88365,-87.64863
13001,4,8,false,6,8,2,41.88397,-87.62459
18062,4,8,false,6,4,-2,41.88412,-87.65427
TA1305000030,4,8,false,8,12,4,41.88459,-87.63178
15535,4,8,false,6,1,-5,41.8846,-87.64455
TA1305000029,4,8,false,2,5,3,41.88466,-87.62787
13263,4,8,false,8,6,-2,41.88467,-87.61952
TA1306000015,4,8,false,5,8,3,41.88549,-87.65232
13021,4,8,false,3,9,6,41.88559,-87.64184
TA1307000111,4,8,false,2,12,10,41.88582,-87.63548
KA1503000012,4,8,false,5,10,5,41.88599,-87.63089
TA1305000011,4,8,false,10,8,-2,41.886,-87.62418
13197,4,8,false,1,6,5,41.8866,-87.65816
KA1503000064,4,8,false,5,4,-1,41.88697,-87.61281
TA1305000022,4,8,false,8,8,0,41.88817,-87.63656
KA1503000043,4,8,false,11,8,-3,41.88918,-87.63851
13050,4,8,false,1,6,5,41.88919,-87.62775
TA1307000151,4,8,false,12,17,5,41.88993,-87.63427
13430,4,8,false,5,2,-3,41.89077,-87.63169
TA1306000013,4,8,false,6,5,-1,41.89083,-87.61852
RN-,4,8,false,3,11,8,41.89102,-87.63546
TA1305000003,4,8,false,9,6,-3,41.89187,-87.62061
13022,4,8,false,5,4,-1,41.89227,-87.61205
TA1306000029,4,8,false,8,5,-3,41.89256,-87.61449
13045,4,8,false,14,4,-10,41.89403,-87.62931
13016,4,8,false,2,5,3,41.89431,-87.62277
TA1307000062,4,8,false,6,7,1,41.89466,-87.63839
TA1306000012,4,8,false,9,6,-3,41.89475,-87.63438
KP1705001026,4,8,false,2,8,6,41.89483,-87.6323
15530,4,8,false,7,4,-3,41.89575,-87.62596
13017,4,8,false,7,3,-4,41.89676,-87.6357
TA1307000061,4,8,false,6,7,1,41.89745,-87.62873
TA1306000009,4,8,false,6,10,4,41.89772,-87.64299
15529,4,8,false,6,1,-5,41.89858,-87.62206
13042,4,8,false,13,8,-5,41.90097,-87.62377
KA1504000133,4,8,false,1,6,5,41.90234,-87.62773
TA1307000039,4,8,false,13,6,-7,41.90294,-87.63137
KA1504000135,4,8,false,8,4,-4,41.90319,-87.63439
13061,4,8,false,5,3,-2,41.90342,-87.66779
KA1504000079,4,8,false,5,2,-3,41.9035,-87.64334
TA1308000049,4,8,false,1,6,5,41.90672,-87.6349
KA1504000134,4,8,false,7,3,-4,41.90687,-87.6262
331,4,8,false,5,3,-2,41.90965,-87.64812
13058,4,8,false,5,2,-3,41.91059,-87.64942
TA1307000038,4,8,false,5,6,1,41.91138,-87.63868
LF-005,4,8,false,3,6,3,41.91172,-87.62681
TA1308000050,4,8,false,8,12,4,41.91211,-87.6347
13146,4,8,false,2,6,4,41.91831,-87.63629
TA1306000016,4,8,false,3,11,8,41.9256,-87.65371
TA1309000019,4,8,false,9,3,-6,41.92586,-87.63897
TA1309000058,4,8,false,9,6,-3,41.92591,-87.64927
TA1309000059,4,8,false,1,7,6,41.92889,-87.65898
TA1307000064,4,8,false,5,2,-3,41.93222,-87.65864
13268,4,8,false,6,1,-5,41.93588,-87.67843
TA1309000049,4,8,false,7,6,-1,41.94077,-87.63919
632,4,8,false,5,5,0,41.94453,-87.6547
13235,4,8,false,6,5,-1,41.94814,-87.66396
13325,4,8,false,5,2,-3,41.94907,-87.64863
TA1308000022,4,8,false,6,5,-1,41.95438,-87.64805
13389,4,8,false,6,1,-5,41.961,-87.64958
TA1307000107,4,8,false,5,1,-4,41.96164,-87.65464
TA1309000035,4,8,false,1,5,4,41.97335,-87.66785
KA1503000014,4,8,true,2,6,4,41.7851,-87.60108
TA1309000011,4,8,true,1,10,9,41.78873,-87.60131
KA1504000076,4,8,true,3,5,2,41.7943,-87.60145
KA1503000052,4,8,true,5,3,-2,41.79935,-87.60097
TA1309000037,4,8,true,5,7,2,41.79957,-87.59474
TA1307000129,4,8,true,1,8,7,41.83104,-87.62683
13216,4,8,true,3,10,7,41.83473,-87.62581
TA1309000055,4,8,true,7,2,-5,41.8382,-87.64514
TA1307000005,4,8,true,7,8,1,41.84569,-87.6225
15546,4,8,true,7,1,-6,41.85416,-87.61916
15545,4,8,true,13,8,-5,41.85627,-87.61334
13135,4,8,true,9,1,-8,41.85753,-87.66157
13102,4,8,true,8,1,-7,41.85762,-87.61942
13150,4,8,true,9,8,-1,41.85783,-87.62455
13164,4,8,true,7,2,-5,41.85818,-87.65648
SL-012,4,8,true,15,3,-12,41.86038,-87.62581
TA1306000002,4,8,true,7,3,-4,41.86238,-87.65108
TA1307000124,4,8,true,11,3,-8,41.86411,-87.62372
13431,4,8,true,3,5,2,41.8661,-87.60728
TA1305000002,4,8,true,20,8,-12,41.86721,-87.62597
15544,4,8,true,9,9,0,41.86723,-87.61536
TA1305000017,4,8,true,1,8,7,41.86734,-87.64863
SL-005,4,8,true,25,6,-19,41.8679,-87.62304
644,4,8,true,5,1,-4,41.86859,-87.68625
13139,4,8,true,5,1,-4,41.86893,-87.65913
13285,4,8,true,1,15,14,41.86928,-87.67372
TA1309000010,4,8,true,7,4,-3,41.87074,-87.62574
SL-009,4,8,true,9,2,-7,41.87081,-87.63121
TA1309000064,4,8,true,1,20,19,41.87127,-87.67369
TA1307000130,4,8,true,8,3,-5,41.87178,-87.65103
TA1307000121,4,8,true,2,5,3,41.87184,-87.64664
SL-008,4,8,true,12,9,-3,41.87209,-87.62956
13332,4,8,true,20,3,-17,41.87219,-87.6615
SL-011,4,8,true,9,4,-5,41.87256,-87.63356
623,4,8,true,11,3,-8,41.87272,-87.62399
KA1504000104,4,8,true,2,15,13,41.87296,-87.66912
SL-007,4,8,true,11,3,-8,41.87404,-87.6277
13326,4,8,true,4,5,1,41.87425,-87.63958
TA1306000025,4,8,true,5,4,-1,41.87464,-87.65703
13028,4,8,true,2,7,5,41.87475,-87.64981
13081,4,8,true,2,5,3,41.87501,-87.67326
SL-010,4,8,true,20,9,-11,41.87501,-87.63309
TA1305000009,4,8,true,11,4,-7,41.87593,-87.63068
624,4,8,true,6,7,1,41.87626,-87.62923
TA1305000035,4,8,true,7,17,10,41.87716,-87.62787
13138,4,8,true,10,23,13,41.87723,-87.63941
15539,4,8,true,5,7,2,41.87763,-87.64405
13158,4,8,true,18,13,-5,41.87764,-87.64957
13157,4,8,true,13,1,-12,41.87773,-87.6548
TA1305000025,4,8,true,12,53,41,41.87773,-87.63528
TA1309000002,4,8,true,4,5,1,41.87784,-87.62408
13206,4,8,true,7,3,-4,41.87794,-87.66201
TA1309000004,4,8,true,8,39,31,41.87811,-87.63184
638,4,8,true,14,34,20,41.87827,-87.64078
TA1305000005,4,8,true,3,35,32,41.87924,-87.62975
13011,4,8,true,19,17,-2,41.87931,-87.63993
KA1503000034,4,8,true,1,39,38,41.87938,-87.63197
KA1503000015,4,8,true,6,18,12,41.87948,-87.6257
TA1309000007,4,8,true,3,76,73,41.88022,-87.63526
WL-011,4,8,true,14,12,-2,41.88034,-87.64273
13156,4,8,true,15,3,-12,41.88042,-87.65554
13008,4,8,true,3,18,15,41.88105,-87.62408
TA1305000006,4,8,true,4,32,28,41.88122,-87.6296
13134,4,8,true,5,3,-2,41.88138,-87.67493
13056,4,8,true,16,17,1,41.88168,-87.63951
TA1307000120,4,8,true,17,4,-13,41.88188,-87.64879
13341,4,8,true,22,26,4,41.88208,-87.63985
13036,4,8,true,8,11,3,41.8821,-87.62513
TA1305000032,4,8,true,30,33,3,41.88218,-87.64109
13006,4,8,true,4,21,17,41.88268,-87.63252
13353,4,8,true,14,7,-7,41.88283,-87.6612
654,4,8,true,5,4,-1,41.88307,-87.65698
13409,4,8,true,17,5,-12,41.8831,-87.6511
KA1503000072,4,8,true,9,24,15,41.88317,-87.63693
WL-012,4,8,true,41,44,3,41.88337,-87.6412
13053,4,8,true,5,10,5,41.88365,-87.64863
13001,4,8,true,10,30,20,41.88397,-87.62459
13155,4,8,true,3,6,3,41.88407,-87.65689
18062,4,8,true,6,8,2,41.88412,-87.65427
TA1306000010,4,8,true,16,49,33,41.88419,-87.62961
TA1305000030,4,8,true,4,73,69,41.88459,-87.63178
15535,4,8,true,11,10,-1,41.8846,-87.64455
TA1305000029,4,8,true,14,14,0,41.88466,-87.62787
13263,4,8,true,28,12,-16,41.88467,-87.61952
TA1306000015,4,8,true,2,28,26,41.88549,-87.65232
13021,4,8,true,18,34,16,41.88559,-87.64184
TA1307000111,4,8,true,4,28,24,41.88582,-87.63548
KA17018054,4,8,true,1,8,7,41.88595,-87.67701
KA1503000012,4,8,true,16,20,4,41.88599,-87.63089
TA1305000011,4,8,true,9,47,38,41.886,-87.62418
15534,4,8,true,14,9,-5,41.88627,-87.61749
13197,4,8,true,4,5,1,41.8866,-87.65816
TA1308000029,4,8,true,10,14,4,41.88673,-87.62225
TA1307000131,4,8,true,2,17,15,41.88688,-87.62606
TA1305000022,4,8,true,10,35,25,41.88817,-87.63656
TA1306000003,4,8,true,16,7,-9,41.88867,-87.64442
KA1503000043,4,8,true,28,33,5,41.88918,-87.63851
13050,4,8,true,12,39,27,41.88919,-87.62775
13432,4,8,true,6,9,3,41.88989,-87.67149
TA1307000151,4,8,true,18,35,17,41.88993,-87.63427
636,4,8,true,11,19,8,41.88997,-87.63662
KA1503000044,4,8,true,9,17,8,41.89018,-87.6262
13427,4,8,true,13,11,-2,41.89054,-87.62205
13430,4,8,true,7,18,11,41.89077,-87.63169
TA1306000013,4,8,true,9,8,-1,41.89083,-87.61852
RN-,4,8,true,10,6,-4,41.89102,-87.63546
TA1308000006,4,8,true,4,5,1,41.89128,-87.67686
TA1307000117,4,8,true,18,28,10,41.89144,-87.62675
13033,4,8,true,17,17,0,41.8916,-87.64835
13194,4,8,true,11,9,-2,41.8918,-87.65878
TA1305000003,4,8,true,21,17,-4,41.89187,-87.62061
13022,4,8,true,4,5,1,41.89227,-87.61205
TA1306000029,4,8,true,9,2,-7,41.89256,-87.61449
13265,4,8,true,25,15,-10,41.89383,-87.64172
13045,4,8,true,30,24,-6,41.89403,-87.62931
13016,4,8,true,17,40,23,41.89431,-87.62277
KA1503000041,4,8,true,16,30,14,41.89452,-87.61798
13196,4,8,true,12,3,-9,41.89455,-87.65345
TA1307000062,4,8,true,24,20,-4,41.89466,-87.63839
TA1306000012,4,8,true,22,24,2,41.89475,-87.63438
KP1705001026,4,8,true,12,6,-6,41.89483,-87.6323
13132,4,8,true,9,3,-6,41.89573,-87.67718
15530,4,8,true,19,25,6,41.89575,-87.62596
18003,4,8,true,5,5,0,41.89575,-87.62011
13247,4,8,true,8,4,-4,41.89597,-87.66775
TA1305000020,4,8,true,12,9,-3,41.89636,-87.65406
13289,4,8,true,16,1,-15,41.89638,-87.661
13017,4,8,true,21,13,-8,41.89676,-87.6357
13338,4,8,true,10,14,4,41.89697,-87.62173
TA1307000061,4,8,true,13,7,-6,41.89745,-87.62873
13034,4,8,true,1,8,7,41.89754,-87.62352
TA1306000009,4,8,true,16,47,31,41.89772,-87.64299
620,4,8,true,10,4,-6,41.89817,-87.63754
KA1504000103,4,8,true,5,3,-2,41.89842,-87.68659
15529,4,8,true,9,14,5,41.89858,-87.62206
TA1307000128,4,8,true,12,13,1,41.89896,-87.6299
13248,4,8,true,14,1,-13,41.89964,-87.66788
TA1306000011,4,8,true,12,1,-11,41.89994,-87.63443
KA1504000116,4,8,true,7,6,-1,41.90023,-87.64299
13290,4,8,true,10,6,-4,41.90069,-87.66259
13042,4,8,true,9,20,11,41.90097,-87.62377
TA1307000070,4,8,true,5,1,-4,41.90133,-87.67742
KA1504000133,4,8,true,8,3,-5,41.90234,-87.62773
TA1307000039,4,8,true,46,19,-27,41.90294,-87.63137
658,4,8,true,4,9,5,41.903,-87.6838
KA1504000135,4,8,true,8,13,5,41.90319,-87.63439
13136,4,8,true,10,6,-4,41.90326,-87.67845
13061,4,8,true,19,12,-7,41.90342,-87.66779
KA1504000079,4,8,true,13,4,-9,41.9035,-87.64334
TA1307000115,4,8,true,18,2,-16,41.9046,-87.64056
TA1308000049,4,8,true,10,10,0,41.90672,-87.6349
KA1504000134,4,8,true,7,2,-5,41.90687,-87.6262
13224,4,8,true,7,2,-5,41.90706,-87.66725
TA1307000143,4,8,true,10,1,-9,41.90762,-87.63854
TA1309000024,4,8,true,15,9,-6,41.908,-87.63152
TA1305000041,4,8,true,11,7,-4,41.9094,-87.67769
331,4,8,true,7,10,3,41.90965,-87.64812
TA1305000037,4,8,true,12,3,-9,41.91018,-87.67003
TA1306000008,4,8,true,7,1,-6,41.9102,-87.6435
TA1308000005,4,8,true,9,4,-5,41.91042,-87.68238
13258,4,8,true,5,4,-1,41.91043,-87.69718
13154,4,8,true,11,6,-5,41.91054,-87.65312
13058,4,8,true,6,4,-2,41.91059,-87.64942
TA1307000038,4,8,true,6,12,6,41.91138,-87.63868
LF-005,4,8,true,9,3,-6,41.91172,-87.62681
13128,4,8,true,10,9,-1,41.91197,-87.63197
TA1308000050,4,8,true,14,17,3,41.91211,-87.6347
13243,4,8,true,7,3,-4,41.91262,-87.6814
TA1309000032,4,8,true,2,5,3,41.91293,-87.66417
TA1306000032,4,8,true,12,8,-4,41.9137,-87.65285
TA1307000166,4,8,true,9,7,-2,41.91386,-87.64877
TA1306000007,4,8,true,16,2,-14,41.91469,-87.64333
13068,4,8,true,4,8,4,41.91554,-87.68703
13179,4,8,true,14,8,-6,41.9157,-87.63461
13133,4,8,true,13,6,-7,41.91598,-87.67733
TA1305000039,4,8,true,4,16,12,41.9163,-87.66749
TA1309000006,4,8,true,11,5,-6,41.91809,-87.64375
TA1307000163,4,8,true,9,4,-5,41.91821,-87.65696
13146,4,8,true,13,9,-4,41.91831,-87.63629
13059,4,8,true,10,11,1,41.91845,-87.65222
13192,4,8,true,13,4,-9,41.91995,-87.64884
13288,4,8,true,5,1,-4,41.92008,-87.67788
TA1309000030,4,8,true,11,6,-5,41.92077,-87.66372
TA1309000033,4,8,true,5,8,3,41.92158,-87.65381
13193,4,8,true,20,16,-4,41.92182,-87.64412
13191,4,8,true,18,3,-15,41.92217,-87.63891
LP-,4,8,true,15,3,-12,41.92396,-87.63584
TA1306000026,4,8,true,13,8,-5,41.92558,-87.65842
TA1306000016,4,8,true,4,14,10,41.9256,-87.65371
TA1309000019,4,8,true,19,8,-11,41.92586,-87.63897
TA1309000058,4,8,true,15,17,2,41.92591,-87.64927
TA1308000001,4,8,true,7,5,-2,41.92627,-87.63086
15646,4,8,true,5,1,-4,41.92668,-87.6977
TA1309000023,4,8,true,8,6,-2,41.9287,-87.65383
TA1307000113,4,8,true,5,1,-4,41.92878,-87.66391
13296,4,8,true,4,5,1,41.92883,-87.66852
TA1309000059,4,8,true,11,9,-2,41.92889,-87.65898
TA1309000061,4,8,true,15,9,-6,41.92915,-87.64909
TA1308000031,4,8,true,3,5,2,41.92946,-87.68417
TA1305000014,4,8,true,13,7,-6,41.92956,-87.64313
TA1307000142,4,8,true,5,5,0,41.93125,-87.64432
13276,4,8,true,15,9,-6,41.93132,-87.63874
TA1307000064,4,8,true,14,8,-6,41.93222,-87.65864
TA1306000014,4,8,true,13,13,0,41.93242,-87.65271
TA1309000039,4,8,true,21,5,-16,41.93258,-87.63642
13294,4,8,true,1,5,4,41.9326,-87.66595
TA1309000036,4,8,true,9,7,-2,41.93313,-87.64776
TA1307000006,4,8,true,12,5,-7,41.93571,-87.6636
13268,4,8,true,5,2,-3,41.93588,-87.67843
13269,4,8,true,9,3,-6,41.93609,-87.66983
TA1307000052,4,8,true,5,12,7,41.93628,-87.65266
TA1307000136,4,8,true,12,11,-1,41.9365,-87.64755
TA1307000041,4,8,true,11,3,-8,41.93669,-87.63683
13137,4,8,true,10,8,-2,41.9376,-87.6441
TA1309000042,4,8,true,7,3,-4,41.93937,-87.66836
13229,4,8,true,7,5,-2,41.93946,-87.66376
TA1308000019,4,8,true,7,1,-6,41.93973,-87.65886
13277,4,8,true,10,3,-7,41.9401,-87.64546
TA1307000134,4,8,true,7,17,10,41.94016,-87.65303
TA1309000049,4,8,true,8,5,-3,41.94077,-87.63919
TA1307000138,4,8,true,10,4,-6,41.94334,-87.67094
13144,4,8,true,6,2,-4,41.9434,-87.67964
TA1309000025,4,8,true,9,8,-1,41.94368,-87.64894
13071,4,8,true,6,6,0,41.94373,-87.66401
632,4,8,true,10,5,-5,41.94453,-87.6547
13278,4,8,true,15,1,-14,41.94553,-87.64644
13235,4,8,true,5,8,3,41.94814,-87.66396
13325,4,8,true,5,5,0,41.94907,-87.64863
TA1307000126,4,8,true,1,6,5,41.94936,-87.65451
TA1307000150,4,8,true,8,6,-2,41.94945,-87.64646
TA1307000127,4,8,true,7,4,-3,41.9508,-87.65918
13323,4,8,true,9,10,1,41.95282,-87.65
13063,4,8,true,4,13,9,41.95424,-87.65441
TA1308000022,4,8,true,2,5,3,41.95438,-87.64805
13379,4,8,true,12,8,-4,41.95786,-87.6495
TA1309000027,4,8,true,10,3,-7,41.9585,-87.65499
13389,4,8,true,2,9,7,41.961,-87.64958
TA1307000144,4,8,true,1,5,4,41.96142,-87.6762
TA1307000107,4,8,true,5,6,1,41.96164,-87.65464
TA1307000156,4,8,true,7,3,-4,41.96301,-87.68479
TA1309000012,4,8,true,1,7,6,41.96325,-87.67928
639,4,8,true,3,5,2,41.96584,-87.64538
KA1504000127,4,8,true,5,2,-3,41.96587,-87.70083
TA1307000158,4,8,true,7,1,-6,41.9671,-87.67904
TA1307000119,4,8,true,7,2,-5,41.96796,-87.65
TA1309000066,4,8,true,11,8,-3,41.9691,-87.67423
TA1309000035,4,8,true,9,3,-6,41.97335,-87.66785
13108,4,8,true,6,4,-2,41.97379,-87.65971
KA1504000146,4,8,true,5,6,1,41.978,-87.66805
KA1504000151,4,8,true,5,2,-3,41.98359,-87.66916
15575,4,8,true,7,4,-3,41.98975,-87.66014
15571,4,8,true,7,2,-5,41.99478,-87.66028
604,4,8,true,1,5,4,42.05824,-87.67744
KA1503000071,4,9,false,1,7,6,41.79148,-87.59988
15545,4,9,false,3,5,2,41.85627,-87.61334
SL-012,4,9,false,1,5,4,41.86038,-87.62581
WL-008,4,9,false,6,2,-4,41.86712,-87.64108
TA1305000002,4,9,false,3,6,3,41.86721,-87.62597
SL-005,4,9,false,8,4,-4,41.8679,-87.62304
623,4,9,false,17,7,-10,41.87272,-87.62399
SL-007,4,9,false,5,5,0,41.87404,-87.6277
15541,4,9,false,7,2,-5,41.8758,-87.62086
TA1305000025,4,9,false,3,13,10,41.87773,-87.63528
638,4,9,false,6,2,-4,41.87827,-87.64078
TA1305000005,4,9,false,5,1,-4,41.87924,-87.62975
TA1309000007,4,9,false,5,5,0,41.88022,-87.63526
13300,4,9,false,12,5,-7,41.88097,-87.61675
13008,4,9,false,12,13,1,41.88105,-87.62408
13056,4,9,false,4,5,1,41.88168,-87.63951
TA1307000120,4,9,false,11,3,-8,41.88188,-87.64879
13341,4,9,false,5,3,-2,41.88208,-87.63985
13036,4,9,false,1,9,8,41.8821,-87.62513
WL-012,4,9,false,2,5,3,41.88337,-87.6412
13053,4,9,false,1,9,8,41.88365,-87.64863
13001,4,9,false,9,11,2,41.88397,-87.62459
TA1306000010,4,9,false,1,6,5,41.88419,-87.62961
TA1305000030,4,9,false,8,2,-6,41.88459,-87.63178
TA1305000029,4,9,false,4,6,2,41.88466,-87.62787
KA1503000012,4,9,false,6,10,4,41.88599,-87.63089
TA1305000011,4,9,false,2,5,3,41.886,-87.62418
15534,4,9,false,6,2,-4,41.88627,-87.61749
TA1307000131,4,9,false,9,3,-6,41.88688,-87.62606
KA1503000064,4,9,false,6,2,-4,41.88697,-87.61281
TA1305000022,4,9,false,4,6,2,41.88817,-87.63656
TA1306000003,4,9,false,5,6,1,41.88867,-87.64442
KA1503000043,4,9,false,8,7,-1,41.88918,-87.63851
TA1307000151,4,9,false,5,9,4,41.88993,-87.63427
13427,4,9,false,1,5,4,41.89054,-87.62205
13430,4,9,false,5,4,-1,41.89077,-87.63169
TA1306000013,4,9,false,4,5,1,41.89083,-87.61852
TA1307000117,4,9,false,15,7,-8,41.89144,-87.62675
13022,4,9,false,19,15,-4,41.89227,-87.61205
TA1306000029,4,9,false,8,2,-6,41.89256,-87.61449
13045,4,9,false,9,9,0,41.89403,-87.62931
13016,4,9,false,3,6,3,41.89431,-87.62277
KA1503000041,4,9,false,2,5,3,41.89452,-87.61798
TA1307000062,4,9,false,7,3,-4,41.89466,-87.63839
TA1306000012,4,9,false,3,5,2,41.89475,-87.63438
15530,4,9,false,3,6,3,41.89575,-87.62596
TA1306000009,4,9,false,6,9,3,41.89772,-87.64299
15529,4,9,false,6,4,-2,41.89858,-87.62206
13042,4,9,false,9,9,0,41.90097,-87.62377
TA1307000039,4,9,false,6,6,0,41.90294,-87.63137
13061,4,9,false,3,7,4,41.90342,-87.66779
LF-005,4,9,false,7,6,-1,41.91172,-87.62681
13128,4,9,false,5,2,-3,41.91197,-87.63197
TA1308000050,4,9,false,13,6,-7,41.91211,-87.6347
TA1309000029,4,9,false,6,2,-4,41.9178,-87.68245
13146,4,9,false,5,5,0,41.91831,-87.63629
TA1309000019,4,9,false,7,5,-2,41.92586,-87.63897
13124,4,9,false,3,6,3,41.92675,-87.63444
TA1309000039,4,9,false,13,3,-10,41.93258,-87.63642
TA1309000036,4,9,false,1,6,5,41.93313,-87.64776
13137,4,9,false,4,5,1,41.9376,-87.6441
13229,4,9,false,1,5,4,41.93946,-87.66376
TA1308000019,4,9,false,2,6,4,41.93973,-87.65886
TA1307000134,4,9,false,3,8,5,41.94016,-87.65303
TA1309000049,4,9,false,7,2,-5,41.94077,-87.63919
TA1309000025,4,9,false,3,5,2,41.94368,-87.64894
13278,4,9,false,5,5,0,41.94553,-87.64644
TA1308000009,4,9,true,6,4,-2,41.79522,-87.58075
KA1503000059,4,9,true,5,3,-2,41.79952,-87.58643
TA1309000037,4,9,true,5,1,-4,41.79957,-87.59474
13398,4,9,true,5,2,-3,41.80256,-87.59035
TA1308000036,4,9,true,7,3,-4,41.83883,-87.62186
13075,4,9,true,4,5,1,41.8531,-87.63192
15545,4,9,true,4,7,3,41.85627,-87.61334
13102,4,9,true,6,2,-4,41.85762,-87.61942
13150,4,9,true,3,6,3,41.85783,-87.62455
TA1307000159,4,9,true,6,2,-4,41.8579,-87.6687
13164,4,9,true,7,1,-6,41.85818,-87.65648
TA1307000124,4,9,true,6,7,1,41.86411,-87.62372
13354,4,9,true,3,5,2,41.86524,-87.66651
TA1305000002,4,9,true,10,6,-4,41.86721,-87.62597
TA1305000017,4,9,true,1,5,4,41.86734,-87.64863
SL-005,4,9,true,9,1,-8,41.8679,-87.62304
13285,4,9,true,2,12,10,41.86928,-87.67372
TA1309000010,4,9,true,9,4,-5,41.87074,-87.62574
TA1307000130,4,9,true,10,9,-1,41.87178,-87.65103
TA1307000121,4,9,true,5,5,0,41.87184,-87.64664
13332,4,9,true,22,9,-13,41.87219,-87.6615
SL-011,4,9,true,4,5,1,41.87256,-87.63356
623,4,9,true,11,3,-8,41.87272,-87.62399
KA1504000104,4,9,true,5,4,-1,41.87296,-87.66912
13037,4,9,true,1,5,4,41.87588,-87.64078
TA1305000009,4,9,true,1,6,5,41.87593,-87.63068
624,4,9,true,7,7,0,41.87626,-87.62923
TA1305000035,4,9,true,3,10,7,41.87716,-87.62787
13138,4,9,true,1,8,7,41.87723,-87.63941
13158,4,9,true,3,7,4,41.87764,-87.64957
TA1305000025,4,9,true,8,19,11,41.87773,-87.63528
TA1309000002,4,9,true,4,5,1,41.87784,-87.62408
13206,4,9,true,5,1,-4,41.87794,-87.66201
TA1309000004,4,9,true,2,11,9,41.87811,-87.63184
638,4,9,true,7,17,10,41.87827,-87.64078
TA1305000005,4,9,true,3,9,6,41.87924,-87.62975
13011,4,9,true,6,12,6,41.87931,-87.63993
TA1309000008,4,9,true,4,7,3,41.87933,-87.6355
KA1503000015,4,9,true,5,16,11,41.87948,-87.6257
TA1309000007,4,9,true,2,19,17,41.88022,-87.63526
WL-011,4,9,true,9,4,-5,41.88034,-87.64273
13156,4,9,true,3,10,7,41.88042,-87.65554
13008,4,9,true,4,15,11,41.88105,-87.62408
TA1305000006,4,9,true,2,18,16,41.88122,-87.6296
13056,4,9,true,4,9,5,41.88168,-87.63951
TA1307000120,4,9,true,4,11,7,41.88188,-87.64879
13341,4,9,true,6,14,8,41.88208,-87.63985
13036,4,9,true,3,10,7,41.8821,-87.62513
TA1305000032,4,9,true,14,16,2,41.88218,-87.64109
13006,4,9,true,6,5,-1,41.88268,-87.63252
13353,4,9,true,2,7,5,41.88283,-87.6612
13409,4,9,true,6,9,3,41.8831,-87.6511
KA1503000072,4,9,true,2,7,5,41.88317,-87.63693
WL-012,4,9,true,16,17,1,41.88337,-87.6412
13053,4,9,true,11,12,1,41.88365,-87.64863
13001,4,9,true,2,13,11,41.88397,-87.62459
TA1306000010,4,9,true,3,18,15,41.88419,-87.62961
TA1305000030,4,9,true,1,26,25,41.88459,-87.63178
15535,4,9,true,5,3,-2,41.8846,-87.64455
TA1305000029,4,9,true,5,6,1,41.88466,-87.62787
13263,4,9,true,13,7,-6,41.88467,-87.61952
TA1306000015,4,9,true,1,12,11,41.88549,-87.65232
13021,4,9,true,21,22,1,41.88559,-87.64184
TA1307000111,4,9,true,5,4,-1,41.88582,-87.63548
KA1503000012,4,9,true,8,14,6,41.88599,-87.63089
TA1305000011,4,9,true,9,16,7,41.886,-87.62418
15534,4,9,true,9,2,-7,41.88627,-87.61749
TA1308000029,4,9,true,6,5,-1,41.88673,-87.62225
TA1305000022,4,9,true,13,22,9,41.88817,-87.63656
TA1306000003,4,9,true,10,5,-5,41.88867,-87.64442
KA1503000043,4,9,true,19,18,-1,41.88918,-87.63851
13050,4,9,true,9,17,8,41.88919,-87.62775
TA1307000151,4,9,true,8,27,19,41.88993,-87.63427
636,4,9,true,6,3,-3,41.88997,-87.63662
13427,4,9,true,8,3,-5,41.89054,-87.62205
13430,4,9,true,6,13,7,41.89077,-87.63169
TA1306000013,4,9,true,6,4,-2,41.89083,-87.61852
RN-,4,9,true,3,9,6,41.89102,-87.63546
TA1308000006,4,9,true,5,3,-2,41.89128,-87.67686
TA1307000117,4,9,true,6,11,5,41.89144,-87.62675
13033,4,9,true,13,5,-8,41.8916,-87.64835
13194,4,9,true,7,6,-1,41.8918,-87.65878
TA1305000003,4,9,true,10,12,2,41.89187,-87.62061
13022,4,9,true,5,5,0,41.89227,-87.61205
13265,4,9,true,12,9,-3,41.89383,-87.64172
13045,4,9,true,13,18,5,41.89403,-87.62931
13016,4,9,true,9,25,16,41.89431,-87.62277
KA1503000041,4,9,true,10,14,4,41.89452,-87.61798
TA1307000062,4,9,true,19,20,1,41.89466,-87.63839
TA1306000012,4,9,true,7,17,10,41.89475,-87.63438
637,4,9,true,5,2,-3,41.89563,-87.67209
15530,4,9,true,11,11,0,41.89575,-87.62596
TA1305000020,4,9,true,1,8,7,41.89636,-87.65406
13289,4,9,true,12,2,-10,41.89638,-87.661
13303,4,9,true,6,4,-2,41.89672,-87.63088
13017,4,9,true,9,8,-1,41.89676,-87.6357
13338,4,9,true,7,12,5,41.89697,-87.62173
TA1307000061,4,9,true,5,3,-2,41.89745,-87.62873
TA1306000009,4,9,true,10,17,7,41.89772,-87.64299
15529,4,9,true,8,11,3,41.89858,-87.62206
TA1307000128,4,9,true,9,9,0,41.89896,-87.6299
TA1306000011,4,9,true,5,4,-1,41.89994,-87.63443
13290,4,9,true,4,7,3,41.90069,-87.66259
13042,4,9,true,6,16,10,41.90097,-87.62377
KA1504000133,4,9,true,5,11,6,41.90234,-87.62773
TA1307000039,4,9,true,9,9,0,41.90294,-87.63137
KA1504000135,4,9,true,7,10,3,41.90319,-87.63439
13136,4,9,true,7,3,-4,41.90326,-87.67845
13061,4,9,true,9,9,0,41.90342,-87.66779
TA1308000049,4,9,true,9,7,-2,41.90672,-87.6349
18069,4,9,true,1,6,5,41.90722,-87.65563
TA1309000024,4,9,true,7,8,1,41.908,-87.63152
331,4,9,true,9,9,0,41.90965,-87.64812
TA1306000008,4,9,true,8,4,-4,41.9102,-87.6435
13154,4,9,true,2,5,3,41.91054,-87.65312
TA1307000038,4,9,true,6,4,-2,41.91138,-87.63868
LF-005,4,9,true,11,2,-9,41.91172,-87.62681
TA1308000050,4,9,true,11,17,6,41.91211,-87.6347
TA1306000032,4,9,true,10,2,-8,41.9137,-87.65285
TA1307000166,4,9,true,5,5,0,41.91386,-87.64877
13179,4,9,true,8,7,-1,41.9157,-87.63461
TA1309000006,4,9,true,6,3,-3,41.91809,-87.64375
TA1307000163,4,9,true,6,3,-3,41.91821,-87.65696
13146,4,9,true,11,3,-8,41.91831,-87.63629
13059,4,9,true,2,7,5,41.91845,-87.65222
13192,4,9,true,8,5,-3,41.91995,-87.64884
TA1309000030,4,9,true,2,8,6,41.92077,-87.66372
TA1309000033,4,9,true,3,12,9,41.92158,-87.65381
13193,4,9,true,10,7,-3,41.92182,-87.64412
13191,4,9,true,7,5,-2,41.92217,-87.63891
LP-,4,9,true,5,1,-4,41.92396,-87.63584
TA1306000026,4,9,true,5,10,5,41.92558,-87.65842
TA1306000016,4,9,true,9,7,-2,41.9256,-87.65371
TA1309000019,4,9,true,7,1,-6,41.92586,-87.63897
TA1309000058,4,9,true,9,4,-5,41.92591,-87.64927
TA1308000001,4,9,true,8,5,-3,41.92627,-87.63086
TA1309000061,4,9,true,5,5,0,41.92915,-87.64909
TA1305000014,4,9,true,7,12,5,41.92956,-87.64313
TA1307000142,4,9,true,9,3,-6,41.93125,-87.64432
TA1307000064,4,9,true,6,6,0,41.93222,-87.65864
TA1306000014,4,9,true,2,6,4,41.93242,-87.65271
TA1309000039,4,9,true,7,3,-4,41.93258,-87.63642
TA1309000036,4,9,true,6,3,-3,41.93313,-87.64776
TA1307000052,4,9,true,5,3,-2,41.93628,-87.65266
TA1307000041,4,9,true,9,7,-2,41.93669,-87.63683
13137,4,9,true,8,6,-2,41.9376,-87.6441
13277,4,9,true,5,2,-3,41.9401,-87.64546
TA1307000134,4,9,true,6,4,-2,41.94016,-87.65303
TA1307000138,4,9,true,1,5,4,41.94334,-87.67094
TA1309000025,4,9,true,14,1,-13,41.94368,-87.64894
632,4,9,true,5,5,0,41.94453,-87.6547
13278,4,9,true,9,2,-7,41.94553,-87.64644
13235,4,9,true,7,5,-2,41.94814,-87.66396
13325,4,9,true,2,13,11,41.94907,-87.64863
TA1307000126,4,9,true,5,2,-3,41.94936,-87.65451
TA1307000150,4,9,true,5,5,0,41.94945,-87.64646
TA1307000127,4,9,true,9,4,-5,41.9508,-87.65918
13323,4,9,true,11,2,-9,41.95282,-87.65
TA1309000043,4,9,true,6,5,-1,41.95417,-87.66434
13063,4,9,true,2,7,5,41.95424,-87.65441
TA1309000026,4,9,true,1,5,4,41.95601,-87.6802
13379,4,9,true,4,5,1,41.95786,-87.6495
TA1309000018,4,9,true,3,5,2,41.95791,-87.67357
13389,4,9,true,6,2,-4,41.961,-87.64958
TA1307000107,4,9,true,3,5,2,41.96164,-87.65464
TA1308000012,4,9,true,4,6,2,41.96398,-87.63818
13074,4,9,true,3,5,2,41.96521,-87.6582
TA1307000140,4,9,true,5,4,-1,41.96643,-87.68865
TA1309000035,4,9,true,5,1,-4,41.97335,-87.66785
KA1504000146,4,9,true,4,5,1,41.978,-87.66805
13109,4,9,true,5,1,-4,41.97835,-87.65976
KA1504000152,4,9,true,8,7,-1,41.98403,-87.65231
596,4,9,true,5,2,-3,42.04822,-87.68348
604,4,9,true,2,13,11,42.05824,-87.67744
TA1308000009,4,10,false,4,5,1,41.79522,-87.58075
KA1503000059,4,10,false,6,1,-5,41.79952,-87.58643
TA1308000035,4,10,false,5,3,-2,41.80944,-87.59188
15545,4,10,false,6,8,2,41.85627,-87.61334
13150,4,10,false,6,1,-5,41.85783,-87.62455
13164,4,10,false,6,1,-5,41.85818,-87.65648
15544,4,10,false,19,28,9,41.86723,-87.61536
SL-005,4,10,false,9,8,-1,41.8679,-87.62304
623,4,10,false,11,3,-8,41.87272,-87.62399
15541,4,10,false,19,9,-10,41.8758,-87.62086
624,4,10,false,6,2,-4,41.87626,-87.62923
TA1305000025,4,10,false,3,5,2,41.87773,-87.63528
13011,4,10,false,7,3,-4,41.87931,-87.63993
TA1309000008,4,10,false,11,3,-8,41.87933,-87.6355
KA1503000015,4,10,false,4,6,2,41.87948,-87.6257
13300,4,10,false,17,5,-12,41.88097,-87.61675
13008,4,10,false,28,21,-7,41.88105,-87.62408
TA1307000120,4,10,false,4,7,3,41.88188,-87.64879
13036,4,10,false,1,5,4,41.8821,-87.62513
13006,4,10,false,5,2,-3,41.88268,-87.63252
KA1503000072,4,10,false,1,5,4,41.88317,-87.63693
WL-012,4,10,false,2,5,3,41.88337,-87.6412
13001,4,10,false,14,2,-12,41.88397,-87.62459
TA1306000010,4,10,false,3,7,4,41.88419,-87.62961
TA1305000030,4,10,false,7,1,-6,41.88459,-87.63178
TA1305000029,4,10,false,6,6,0,41.88466,-87.62787
13263,4,10,false,15,5,-10,41.88467,-87.61952
13021,4,10,false,6,1,-5,41.88559,-87.64184
KA1503000012,4,10,false,5,5,0,41.88599,-87.63089
TA1305000011,4,10,false,20,8,-12,41.886,-87.62418
TA1307000131,4,10,false,13,2,-11,41.88688,-87.62606
KA1503000064,4,10,false,7,10,3,41.88697,-87.61281
TA1306000003,4,10,false,2,6,4,41.88867,-87.64442
13050,4,10,false,10,3,-7,41.88919,-87.62775
TA1307000151,4,10,false,6,6,0,41.88993,-87.63427
13430,4,10,false,11,5,-6,41.89077,-87.63169
TA1306000013,4,10,false,3,7,4,41.89083,-87.61852
TA1307000117,4,10,false,9,8,-1,41.89144,-87.62675
13033,4,10,false,5,1,-4,41.8916,-87.64835
TA1305000003,4,10,false,13,9,-4,41.89187,-87.62061
13022,4,10,false,17,42,25,41.89227,-87.61205
TA1306000029,4,10,false,8,8,0,41.89256,-87.61449
13045,4,10,false,7,5,-2,41.89403,-87.62931
13016,4,10,false,7,11,4,41.89431,-87.62277
TA1306000012,4,10,false,5,9,4,41.89475,-87.63438
15530,4,10,false,10,7,-3,41.89575,-87.62596
13338,4,10,false,5,4,-1,41.89697,-87.62173
13034,4,10,false,7,7,0,41.89754,-87.62352
15529,4,10,false,6,1,-5,41.89858,-87.62206
13042,4,10,false,26,14,-12,41.90097,-87.62377
TA1307000070,4,10,false,6,2,-4,41.90133,-87.67742
TA1307000039,4,10,false,3,5,2,41.90294,-87.63137
13061,4,10,false,4,8,4,41.90342,-87.66779
TA1309000024,4,10,false,1,6,5,41.908,-87.63152
TA1305000041,4,10,false,3,8,5,41.9094,-87.67769
13154,4,10,false,5,3,-2,41.91054,-87.65312
13058,4,10,false,7,6,-1,41.91059,-87.64942
TA1307000038,4,10,false,5,2,-3,41.91138,-87.63868
LF-005,4,10,false,14,8,-6,41.91172,-87.62681
TA1308000050,4,10,false,7,10,3,41.91211,-87.6347
13146,4,10,false,3,9,6,41.91831,-87.63629
13193,4,10,false,9,3,-6,41.92182,-87.64412
TA1308000001,4,10,false,10,9,-1,41.92627,-87.63086
TA1309000023,4,10,false,5,2,-3,41.9287,-87.65383
TA1307000142,4,10,false,9,4,-5,41.93125,-87.64432
TA1307000064,4,10,false,5,3,-2,41.93222,-87.65864
TA1309000039,4,10,false,12,3,-9,41.93258,-87.63642
TA1307000041,4,10,false,8,1,-7,41.93669,-87.63683
13137,4,10,false,3,8,5,41.9376,-87.6441
13277,4,10,false,5,2,-3,41.9401,-87.64546
TA1307000134,4,10,false,3,9,6,41.94016,-87.65303
TA1309000049,4,10,false,6,4,-2,41.94077,-87.63919
TA1309000025,4,10,false,7,7,0,41.94368,-87.64894
13071,4,10,false,1,5,4,41.94373,-87.66401
632,4,10,false,6,1,-5,41.94453,-87.6547
13278,4,10,false,9,6,-3,41.94553,-87.64644
13325,4,10,false,4,6,2,41.94907,-87.64863
TA1307000126,4,10,false,5,2,-3,41.94936,-87.65451
TA1307000150,4,10,false,9,1,-8,41.94945,-87.64646
TA1308000022,4,10,false,7,1,-6,41.95438,-87.64805
639,4,10,false,5,1,-4,41.96584,-87.64538
TA1308000021,4,10,false,3,6,3,41.96883,-87.65765
KA1504000152,4,10,false,7,5,-2,41.98403,-87.65231
E008,4,10,false,5,1,-4,42.05049,-87.67782
604,4,10,false,6,2,-4,42.05824,-87.67744
KA1503000071,4,10,true,4,14,10,41.79148,-87.59988
TA1308000009,4,10,true,6,2,-4,41.79522,-87.58075
KA1503000059,4,10,true,4,5,1,41.79952,-87.58643
13216,4,10,true,1,8,7,41.83473,-87.62581
TA1307000048,4,10,true,5,2,-3,41.83855,-87.60821
TA1307000139,4,10,true,6,2,-4,41.84205,-87.61698
15545,4,10,true,7,5,-2,41.85627,-87.61334
13135,4,10,true,2,6,4,41.85753,-87.66157
13102,4,10,true,6,3,-3,41.85762,-87.61942
SL-012,4,10,true,4,5,1,41.86038,-87.62581
TA1307000124,4,10,true,5,2,-3,41.86411,-87.62372
TA1305000002,4,10,true,7,5,-2,41.86721,-87.62597
15544,4,10,true,3,8,5,41.86723,-87.61536
SL-005,4,10,true,8,8,0,41.8679,-87.62304
13160,4,10,true,5,3,-2,41.86947,-87.65548
TA1309000010,4,10,true,3,10,7,41.87074,-87.62574
TA1309000064,4,10,true,5,3,-2,41.87127,-87.67369
TA1307000130,4,10,true,5,10,5,41.87178,-87.65103
TA1307000121,4,10,true,3,6,3,41.87184,-87.64664
13332,4,10,true,6,12,6,41.87219,-87.6615
623,4,10,true,8,2,-6,41.87272,-87.62399
KA1504000104,4,10,true,7,6,-1,41.87296,-87.66912
SL-007,4,10,true,5,3,-2,41.87404,-87.6277
13326,4,10,true,5,3,-2,41.87425,-87.63958
TA1305000010,4,10,true,3,5,2,41.87623,-87.62444
15539,4,10,true,8,1,-7,41.87763,-87.64405
13157,4,10,true,4,9,5,41.87773,-87.6548
TA1305000025,4,10,true,7,9,2,41.87773,-87.63528
13206,4,10,true,5,5,0,41.87794,-87.66201
638,4,10,true,5,1,-4,41.87827,-87.64078
KA1503000015,4,10,true,3,8,5,41.87948,-87.6257
TA1309000007,4,10,true,3,12,9,41.88022,-87.63526
13008,4,10,true,1,7,6,41.88105,-87.62408
TA1305000006,4,10,true,4,7,3,41.88122,-87.6296
TA1307000120,4,10,true,9,8,-1,41.88188,-87.64879
13341,4,10,true,5,5,0,41.88208,-87.63985
13036,4,10,true,4,7,3,41.8821,-87.62513
TA1305000032,4,10,true,5,12,7,41.88218,-87.64109
13006,4,10,true,6,7,1,41.88268,-87.63252
13409,4,10,true,3,6,3,41.8831,-87.6511
WL-012,4,10,true,5,6,1,41.88337,-87.6412
13053,4,10,true,3,10,7,41.88365,-87.64863
13001,4,10,true,3,8,5,41.88397,-87.62459
18062,4,10,true,6,3,-3,41.88412,-87.65427
TA1306000010,4,10,true,4,11,7,41.88419,-87.62961
TA1305000030,4,10,true,7,11,4,41.88459,-87.63178
TA1305000029,4,10,true,5,8,3,41.88466,-87.62787
13263,4,10,true,14,10,-4,41.88467,-87.61952
13021,4,10,true,7,10,3,41.88559,-87.64184
TA1307000111,4,10,true,10,7,-3,41.88582,-87.63548
KA1503000012,4,10,true,4,8,4,41.88599,-87.63089
TA1305000011,4,10,true,12,6,-6,41.886,-87.62418
TA1308000029,4,10,true,5,1,-4,41.88673,-87.62225
TA1305000022,4,10,true,8,4,-4,41.88817,-87.63656
TA1306000003,4,10,true,8,8,0,41.88867,-87.64442
KA1503000043,4,10,true,11,10,-1,41.88918,-87.63851
13050,4,10,true,2,6,4,41.88919,-87.62775
TA1307000151,4,10,true,7,13,6,41.88993,-87.63427
636,4,10,true,4,7,3,41.88997,-87.63662
13427,4,10,true,5,3,-2,41.89054,-87.62205
13430,4,10,true,4,11,7,41.89077,-87.63169
TA1306000013,4,10,true,5,3,-2,41.89083,-87.61852
RN-,4,10,true,6,5,-1,41.89102,-87.63546
TA1307000117,4,10,true,8,10,2,41.89144,-87.62675
13194,4,10,true,8,3,-5,41.8918,-87.65878
TA1305000003,4,10,true,10,10,0,41.89187,-87.62061
13022,4,10,true,6,8,2,41.89227,-87.61205
13265,4,10,true,7,5,-2,41.89383,-87.64172
13045,4,10,true,7,8,1,41.89403,-87.62931
13016,4,10,true,8,7,-1,41.89431,-87.62277
KA1503000041,4,10,true,5,9,4,41.89452,-87.61798
13196,4,10,true,6,1,-5,41.89455,-87.65345
TA1307000062,4,10,true,4,8,4,41.89466,-87.63839
TA1306000012,4,10,true,13,11,-2,41.89475,-87.63438
KP1705001026,4,10,true,7,12,5,41.89483,-87.6323
15530,4,10,true,6,14,8,41.89575,-87.62596
TA1305000020,4,10,true,3,5,2,41.89636,-87.65406
13303,4,10,true,4,5,1,41.89672,-87.63088
13338,4,10,true,4,6,2,41.89697,-87.62173
13034,4,10,true,3,6,3,41.89754,-87.62352
TA1306000009,4,10,true,2,6,4,41.89772,-87.64299
15529,4,10,true,8,19,11,41.89858,-87.62206
TA1307000128,4,10,true,7,4,-3,41.89896,-87.6299
TA1306000011,4,10,true,5,1,-4,41.89994,-87.63443
13042,4,10,true,10,17,7,41.90097,-87.62377
KA1504000133,4,10,true,7,8,1,41.90234,-87.62773
TA1307000039,4,10,true,12,10,-2,41.90294,-87.63137
KA1504000135,4,10,true,10,6,-4,41.90319,-87.63439
13061,4,10,true,7,2,-5,41.90342,-87.66779
KA1504000079,4,10,true,4,5,1,41.9035,-87.64334
TA1309000024,4,10,true,7,3,-4,41.908,-87.63152
331,4,10,true,7,12,5,41.90965,-87.64812
13154,4,10,true,8,6,-2,41.91054,-87.65312
13058,4,10,true,2,5,3,41.91059,-87.64942
TA1307000038,4,10,true,4,7,3,41.91138,-87.63868
LF-005,4,10,true,9,4,-5,41.91172,-87.62681
TA1308000050,4,10,true,9,13,4,41.91211,-87.6347
TA1306000032,4,10,true,4,11,7,41.9137,-87.65285
13179,4,10,true,6,9,3,41.9157,-87.63461
TA1305000039,4,10,true,5,1,-4,41.9163,-87.66749
TA1307000163,4,10,true,5,3,-2,41.91821,-87.65696
13146,4,10,true,6,5,-1,41.91831,-87.63629
13059,4,10,true,3,7,4,41.91845,-87.65222
13192,4,10,true,10,5,-5,41.91995,-87.64884
TA1309000033,4,10,true,12,7,-5,41.92158,-87.65381
13193,4,10,true,8,6,-2,41.92182,-87.64412
13191,4,10,true,4,9,5,41.92217,-87.63891
TA1307000001,4,10,true,4,5,1,41.92535,-87.66581
TA1306000026,4,10,true,6,5,-1,41.92558,-87.65842
TA1306000016,4,10,true,5,6,1,41.9256,-87.65371
TA1309000019,4,10,true,8,4,-4,41.92586,-87.63897
TA1308000001,4,10,true,11,8,-3,41.92627,-87.63086
TA1308000031,4,10,true,4,5,1,41.92946,-87.68417
TA1305000014,4,10,true,11,5,-6,41.92956,-87.64313
TA1307000142,4,10,true,10,7,-3,41.93125,-87.64432
13276,4,10,true,1,7,6,41.93132,-87.63874
TA1307000064,4,10,true,2,5,3,41.93222,-87.65864
TA1306000014,4,10,true,7,10,3,41.93242,-87.65271
TA1309000039,4,10,true,4,7,3,41.93258,-87.63642
TA1309000036,4,10,true,11,8,-3,41.93313,-87.64776
TA1307000052,4,10,true,5,6,1,41.93628,-87.65266
TA1307000136,4,10,true,8,3,-5,41.9365,-87.64755
TA1307000041,4,10,true,8,7,-1,41.93669,-87.63683
13137,4,10,true,9,3,-6,41.9376,-87.6441
TA1309000049,4,10,true,5,1,-4,41.94077,-87.63919
TA1307000138,4,10,true,6,7,1,41.94334,-87.67094
TA1309000025,4,10,true,8,5,-3,41.94368,-87.64894
13071,4,10,true,6,1,-5,41.94373,-87.66401
13278,4,10,true,12,6,-6,41.94553,-87.64644
13235,4,10,true,3,10,7,41.94814,-87.66396
13325,4,10,true,8,1,-7,41.94907,-87.64863
TA1307000150,4,10,true,5,7,2,41.94945,-87.64646
13323,4,10,true,3,8,5,41.95282,-87.65
13063,4,10,true,4,6,2,41.95424,-87.65441
TA1309000027,4,10,true,7,7,0,41.9585,-87.65499
13389,4,10,true,6,2,-4,41.961,-87.64958
TA1308000012,4,10,true,6,4,-2,41.96398,-87.63818
639,4,10,true,2,5,3,41.96584,-87.64538
TA1307000140,4,10,true,6,3,-3,41.96643,-87.68865
TA1309000035,4,10,true,5,3,-2,41.97335,-87.66785
KA1504000146,4,10,true,2,10,8,41.978,-87.66805
KA1504000151,4,10,true,5,2,-3,41.98359,-87.66916
KA1504000152,4,10,true,5,4,-1,41.98403,-87.65231
TA1309000011,4,11,false,6,2,-4,41.78873,-87.60131
KA1503000071,4,11,false,5,2,-3,41.79148,-87.59988
KA1503000074,4,11,false,1,5,4,41.79174,-87.58395
TA1308000009,4,11,false,1,5,4,41.79522,-87.58075
KA1503000059,4,11,false,4,6,2,41.79952,-87.58643
13075,4,11,false,8,3,-5,41.8531,-87.63192
13029,4,11,false,2,5,3,41.86531,-87.6179
15544,4,11,false,18,33,15,41.86723,-87.61536
SL-005,4,11,false,6,7,1,41.8679,-87.62304
SL-008,4,11,false,4,6,2,41.87209,-87.62956
623,4,11,false,13,6,-7,41.87272,-87.62399
15541,4,11,false,23,10,-13,41.8758,-87.62086
TA1305000035,4,11,false,5,1,-4,41.87716,-87.62787
TA1309000002,4,11,false,7,3,-4,41.87784,-87.62408
TA1305000005,4,11,false,6,6,0,41.87924,-87.62975
13156,4,11,false,1,6,5,41.88042,-87.65554
13300,4,11,false,18,18,0,41.88097,-87.61675
13008,4,11,false,7,26,19,41.88105,-87.62408
TA1305000006,4,11,false,8,1,-7,41.88122,-87.6296
TA1307000120,4,11,false,6,6,0,41.88188,-87.64879
13036,4,11,false,14,7,-7,41.8821,-87.62513
13006,4,11,false,5,2,-3,41.88268,-87.63252
13409,4,11,false,3,5,2,41.8831,-87.6511
13001,4,11,false,15,11,-4,41.88397,-87.62459
TA1306000010,4,11,false,8,6,-2,41.88419,-87.62961
TA1305000030,4,11,false,5,5,0,41.88459,-87.63178
TA1305000029,4,11,false,4,9,5,41.88466,-87.62787
13021,4,11,false,6,8,2,41.88559,-87.64184
TA1307000111,4,11,false,1,5,4,41.88582,-87.63548
KA1503000012,4,11,false,4,5,1,41.88599,-87.63089
TA1305000011,4,11,false,26,14,-12,41.886,-87.62418
15534,4,11,false,4,5,1,41.88627,-87.61749
TA1307000131,4,11,false,13,8,-5,41.88688,-87.62606
KA1503000064,4,11,false,12,16,4,41.88697,-87.61281
TA1306000003,4,11,false,6,3,-3,41.88867,-87.64442
KA1503000043,4,11,false,5,4,-1,41.88918,-87.63851
13050,4,11,false,4,5,1,41.88919,-87.62775
TA1307000151,4,11,false,8,7,-1,41.88993,-87.63427
636,4,11,false,4,6,2,41.88997,-87.63662
13427,4,11,false,5,5,0,41.89054,-87.62205
13430,4,11,false,8,4,-4,41.89077,-87.63169
TA1306000013,4,11,false,6,5,-1,41.89083,-87.61852
RN-,4,11,false,3,5,2,41.89102,-87.63546
TA1307000117,4,11,false,18,8,-10,41.89144,-87.62675
TA1305000003,4,11,false,10,3,-7,41.89187,-87.62061
13022,4,11,false,54,47,-7,41.89227,-87.61205
TA1306000029,4,11,false,9,13,4,41.89256,-87.61449
13016,4,11,false,12,8,-4,41.89431,-87.62277
KA1503000041,4,11,false,8,4,-4,41.89452,-87.61798
TA1307000062,4,11,false,4,5,1,41.89466,-87.63839
TA1306000012,4,11,false,9,4,-5,41.89475,-87.63438
15530,4,11,false,9,5,-4,41.89575,-87.62596
13017,4,11,false,5,4,-1,41.89676,-87.6357
13338,4,11,false,7,7,0,41.89697,-87.62173
13042,4,11,false,31,19,-12,41.90097,-87.62377
KA1504000133,4,11,false,3,7,4,41.90234,-87.62773
TA1307000039,4,11,false,7,5,-2,41.90294,-87.63137
13061,4,11,false,7,8,1,41.90342,-87.66779
TA1309000024,4,11,false,7,3,-4,41.908,-87.63152
TA1305000041,4,11,false,7,3,-4,41.9094,-87.67769
331,4,11,false,2,6,4,41.90965,-87.64812
13154,4,11,false,2,6,4,41.91054,-87.65312
LF-005,4,11,false,8,12,4,41.91172,-87.62681
TA1308000050,4,11,false,6,6,0,41.91211,-87.6347
13243,4,11,false,6,3,-3,41.91262,-87.6814
13179,4,11,false,9,1,-8,41.9157,-87.63461
13133,4,11,false,8,1,-7,41.91598,-87.67733
13146,4,11,false,6,16,10,41.91831,-87.63629
13059,4,11,false,6,5,-1,41.91845,-87.65222
13288,4,11,false,5,3,-2,41.92008,-87.67788
TA1309000030,4,11,false,1,6,5,41.92077,-87.66372
13191,4,11,false,4,5,1,41.92217,-87.63891
LP-,4,11,false,4,13,9,41.92396,-87.63584
TA1306000026,4,11,false,6,2,-4,41.92558,-87.65842
TA1306000016,4,11,false,5,4,-1,41.9256,-87.65371
TA1309000019,4,11,false,3,5,2,41.92586,-87.63897
TA1309000058,4,11,false,5,2,-3,41.92591,-87.64927
TA1308000001,4,11,false,2,18,16,41.92627,-87.63086
15646,4,11,false,1,5,4,41.92668,-87.6977
TA1307000142,4,11,false,5,3,-2,41.93125,-87.64432
TA1306000014,4,11,false,5,6,1,41.93242,-87.65271
TA1309000039,4,11,false,5,5,0,41.93258,-87.63642
TA1307000136,4,11,false,2,5,3,41.9365,-87.64755
TA1307000041,4,11,false,5,4,-1,41.93669,-87.63683
13137,4,11,false,3,6,3,41.9376,-87.6441
TA1307000134,4,11,false,10,2,-8,41.94016,-87.65303
TA1309000049,4,11,false,9,5,-4,41.94077,-87.63919
TA1307000138,4,11,false,5,6,1,41.94334,-87.67094
632,4,11,false,3,5,2,41.94453,-87.6547
13278,4,11,false,8,3,-5,41.94553,-87.64644
13235,4,11,false,3,5,2,41.94814,-87.66396
13325,4,11,false,7,4,-3,41.94907,-87.64863
TA1307000126,4,11,false,5,2,-3,41.94936,-87.65451
TA1307000150,4,11,false,6,7,1,41.94945,-87.64646
TA1307000127,4,11,false,9,1,-8,41.9508,-87.65918
TA1308000022,4,11,false,7,2,-5,41.95438,-87.64805
TA1307000107,4,11,false,14,2,-12,41.96164,-87.65464
TA1308000012,4,11,false,7,3,-4,41.96398,-87.63818
13108,4,11,false,6,4,-2,41.97379,-87.65971
KA1504000152,4,11,false,8,10,2,41.98403,-87.65231
604,4,11,false,2,6,4,42.05824,-87.67744
KA1503000071,4,11,true,4,13,9,41.79148,-87.59988
TA1308000009,4,11,true,7,3,-4,41.79522,-87.58075
15545,4,11,true,4,5,1,41.85627,-87.61334
13102,4,11,true,6,2,-4,41.85762,-87.61942
TA1307000159,4,11,true,5,2,-3,41.8579,-87.6687
SL-012,4,11,true,5,3,-2,41.86038,-87.62581
TA1307000124,4,11,true,4,7,3,41.86411,-87.62372
TA1305000002,4,11,true,6,6,0,41.86721,-87.62597
KA1706005007,4,11,true,5,1,-4,41.86749,-87.63219
SL-005,4,11,true,12,9,-3,41.8679,-87.62304
13139,4,11,true,6,4,-2,41.86893,-87.65913
TA1309000010,4,11,true,5,2,-3,41.87074,-87.62574
TA1309000064,4,11,true,7,7,0,41.87127,-87.67369
TA1307000130,4,11,true,8,9,1,41.87178,-87.65103
TA1307000121,4,11,true,7,8,1,41.87184,-87.64664
SL-008,4,11,true,3,11,8,41.87209,-87.62956
13332,4,11,true,10,7,-3,41.87219,-87.6615
SL-011,4,11,true,2,6,4,41.87256,-87.63356
623,4,11,true,6,2,-4,41.87272,-87.62399
KA1504000104,4,11,true,8,3,-5,41.87296,-87.66912
13028,4,11,true,8,3,-5,41.87475,-87.64981
13081,4,11,true,1,5,4,41.87501,-87.67326
SL-010,4,11,true,4,5,1,41.87501,-87.63309
624,4,11,true,2,6,4,41.87626,-87.62923
15539,4,11,true,1,7,6,41.87763,-87.64405
13158,4,11,true,10,15,5,41.87764,-87.64957
13157,4,11,true,13,12,-1,41.87773,-87.6548
TA1305000025,4,11,true,5,6,1,41.87773,-87.63528
13206,4,11,true,1,5,4,41.87794,-87.66201
TA1309000004,4,11,true,7,7,0,41.87811,-87.63184
638,4,11,true,3,8,5,41.87827,-87.64078
TA1305000005,4,11,true,6,5,-1,41.87924,-87.62975
13011,4,11,true,2,5,3,41.87931,-87.63993
TA1309000008,4,11,true,9,10,1,41.87933,-87.6355
TA1309000007,4,11,true,6,15,9,41.88022,-87.63526
13156,4,11,true,5,3,-2,41.88042,-87.65554
13300,4,11,true,10,11,1,41.88097,-87.61675
TA1305000006,4,11,true,5,5,0,41.88122,-87.6296
TA1307000120,4,11,true,10,10,0,41.88188,-87.64879
13341,4,11,true,6,4,-2,41.88208,-87.63985
13036,4,11,true,2,9,7,41.8821,-87.62513
TA1305000032,4,11,true,6,5,-1,41.88218,-87.64109
13006,4,11,true,10,4,-6,41.88268,-87.63252
13353,4,11,true,5,3,-2,41.88283,-87.6612
13409,4,11,true,2,7,5,41.8831,-87.6511
KA1503000072,4,11,true,7,5,-2,41.88317,-87.63693
WL-012,4,11,true,8,4,-4,41.88337,-87.6412
13053,4,11,true,4,9,5,41.88365,-87.64863
13001,4,11,true,6,5,-1,41.88397,-87.62459
18062,4,11,true,4,7,3,41.88412,-87.65427
TA1306000010,4,11,true,12,17,5,41.88419,-87.62961
TA1305000030,4,11,true,9,10,1,41.88459,-87.63178
15535,4,11,true,4,6,2,41.8846,-87.64455
TA1305000029,4,11,true,10,8,-2,41.88466,-87.62787
13263,4,11,true,7,7,0,41.88467,-87.61952
TA1306000015,4,11,true,2,8,6,41.88549,-87.65232
13021,4,11,true,17,15,-2,41.88559,-87.64184
TA1307000111,4,11,true,9,4,-5,41.88582,-87.63548
KA1503000012,4,11,true,6,6,0,41.88599,-87.63089
TA1305000011,4,11,true,6,12,6,41.886,-87.62418
15534,4,11,true,1,5,4,41.88627,-87.61749
TA1307000131,4,11,true,8,1,-7,41.88688,-87.62606
TA1305000022,4,11,true,10,5,-5,41.88817,-87.63656
TA1306000003,4,11,true,16,13,-3,41.88867,-87.64442
KA1503000043,4,11,true,9,25,16,41.88918,-87.63851
13050,4,11,true,5,4,-1,41.88919,-87.62775
TA1307000151,4,11,true,10,5,-5,41.88993,-87.63427
13427,4,11,true,7,11,4,41.89054,-87.62205
13430,4,11,true,6,12,6,41.89077,-87.63169
TA1306000013,4,11,true,11,8,-3,41.89083,-87.61852
RN-,4,11,true,6,4,-2,41.89102,-87.63546
TA1307000117,4,11,true,14,11,-3,41.89144,-87.62675
13033,4,11,true,9,7,-2,41.8916,-87.64835
TA1305000003,4,11,true,11,7,-4,41.89187,-87.62061
13022,4,11,true,14,13,-1,41.89227,-87.61205
TA1306000029,4,11,true,9,7,-2,41.89256,-87.61449
13265,4,11,true,7,2,-5,41.89383,-87.64172
13045,4,11,true,17,12,-5,41.89403,-87.62931
13016,4,11,true,8,12,4,41.89431,-87.62277
KA1503000041,4,11,true,15,8,-7,41.89452,-87.61798
13196,4,11,true,7,2,-5,41.89455,-87.65345
TA1307000062,4,11,true,7,4,-3,41.89466,-87.63839
TA1306000012,4,11,true,6,9,3,41.89475,-87.63438
KP1705001026,4,11,true,4,6,2,41.89483,-87.6323
13132,4,11,true,5,1,-4,41.89573,-87.67718
15530,4,11,true,9,8,-1,41.89575,-87.62596
TA1305000020,4,11,true,2,5,3,41.89636,-87.65406
13303,4,11,true,5,4,-1,41.89672,-87.63088
13017,4,11,true,5,4,-1,41.89676,-87.6357
13338,4,11,true,7,6,-1,41.89697,-87.62173
TA1307000061,4,11,true,6,4,-2,41.89745,-87.62873
13034,4,11,true,3,5,2,41.89754,-87.62352
TA1306000009,4,11,true,10,10,0,41.89772,-87.64299
KA1504000103,4,11,true,7,3,-4,41.89842,-87.68659
15529,4,11,true,10,8,-2,41.89858,-87.62206
TA1307000128,4,11,true,8,11,3,41.89896,-87.6299
13290,4,11,true,6,4,-2,41.90069,-87.66259
13042,4,11,true,8,17,9,41.90097,-87.62377
KA1504000133,4,11,true,8,10,2,41.90234,-87.62773
TA1307000039,4,11,true,16,17,1,41.90294,-87.63137
13061,4,11,true,16,8,-8,41.90342,-87.66779
KA1504000079,4,11,true,7,4,-3,41.9035,-87.64334
TA1308000049,4,11,true,6,7,1,41.90672,-87.6349
13221,4,11,true,5,5,0,41.90765,-87.67254
TA1309000024,4,11,true,6,6,0,41.908,-87.63152
TA1305000041,4,11,true,8,6,-2,41.9094,-87.67769
331,4,11,true,11,7,-4,41.90965,-87.64812
TA1305000037,4,11,true,6,6,0,41.91018,-87.67003
13154,4,11,true,2,8,6,41.91054,-87.65312
13058,4,11,true,6,3,-3,41.91059,-87.64942
TA1307000038,4,11,true,7,3,-4,41.91138,-87.63868
LF-005,4,11,true,12,7,-5,41.91172,-87.62681
TA1308000050,4,11,true,12,18,6,41.91211,-87.6347
13146,4,11,true,5,7,2,41.91831,-87.63629
13059,4,11,true,12,2,-10,41.91845,-87.65222
13192,4,11,true,3,5,2,41.91995,-87.64884
TA1309000033,4,11,true,7,6,-1,41.92158,-87.65381
13193,4,11,true,11,4,-7,41.92182,-87.64412
13191,4,11,true,3,5,2,41.92217,-87.63891
LP-,4,11,true,8,6,-2,41.92396,-87.63584
TA1306000026,4,11,true,4,6,2,41.92558,-87.65842
TA1309000019,4,11,true,6,5,-1,41.92586,-87.63897
TA1309000058,4,11,true,4,7,3,41.92591,-87.64927
TA1308000001,4,11,true,10,11,1,41.92627,-87.63086
TA1309000061,4,11,true,9,3,-6,41.92915,-87.64909
TA1305000014,4,11,true,7,7,0,41.92956,-87.64313
TA1307000142,4,11,true,18,14,-4,41.93125,-87.64432
13276,4,11,true,9,5,-4,41.93132,-87.63874
TA1306000014,4,11,true,7,4,-3,41.93242,-87.65271
TA1309000039,4,11,true,10,9,-1,41.93258,-87.63642
TA1307000136,4,11,true,7,4,-3,41.9365,-87.64755
TA1307000041,4,11,true,10,10,0,41.93669,-87.63683
13137,4,11,true,10,9,-1,41.9376,-87.6441
TA1308000019,4,11,true,1,5,4,41.93973,-87.65886
TA1307000134,4,11,true,4,9,5,41.94016,-87.65303
TA1309000049,4,11,true,11,8,-3,41.94077,-87.63919
TA1309000025,4,11,true,7,4,-3,41.94368,-87.64894
13071,4,11,true,4,5,1,41.94373,-87.66401
13278,4,11,true,6,3,-3,41.94553,-87.64644
13235,4,11,true,14,8,-6,41.94814,-87.66396
TA1307000150,4,11,true,3,8,5,41.94945,-87.64646
13319,4,11,true,5,2,-3,41.95069,-87.6687
TA1307000127,4,11,true,5,7,2,41.9508,-87.65918
13323,4,11,true,9,8,-1,41.95282,-87.65
13063,4,11,true,5,3,-2,41.95424,-87.65441
13379,4,11,true,9,4,-5,41.95786,-87.6495
TA1309000027,4,11,true,5,2,-3,41.9585,-87.65499
13389,4,11,true,7,1,-6,41.961,-87.64958
TA1307000107,4,11,true,6,7,1,41.96164,-87.65464
TA1309000012,4,11,true,5,1,-4,41.96325,-87.67928
TA1308000012,4,11,true,8,11,3,41.96398,-87.63818
13074,4,11,true,7,3,-4,41.96521,-87.6582
639,4,11,true,5,3,-2,41.96584,-87.64538
TA1309000014,4,11,true,5,7,2,41.96709,-87.66744
TA1307000158,4,11,true,7,5,-2,41.9671,-87.67904
TA1307000119,4,11,true,5,1,-4,41.96796,-87.65
KA1504000171,4,11,true,4,5,1,41.97161,-87.65016
TA1309000035,4,11,true,5,4,-1,41.97335,-87.66785
KA1504000149,4,11,true,7,1,-6,41.97562,-87.67945
13109,4,11,true,5,6,1,41.97835,-87.65976
KA1504000152,4,11,true,5,7,2,41.98403,-87.65231
520,4,11,true,5,3,-2,42.01597,-87.66859
596,4,11,true,3,6,3,42.04822,-87.68348
15491,4,12,false,5,6,1,41.78096,-87.57624
KA1503000074,4,12,false,2,5,3,41.79174,-87.58395
TA1309000063,4,12,false,3,5,2,41.79325,-87.5878
KA1503000052,4,12,false,5,1,-4,41.79935,-87.60097
KA1503000059,4,12,false,8,3,-5,41.79952,-87.58643
TA1307000048,4,12,false,10,8,-2,41.83855,-87.60821
TA1305000001,4,12,false,5,2,-3,41.85262,-87.6265
15545,4,12,false,8,7,-1,41.85627,-87.61334
13102,4,12,false,4,10,6,41.85762,-87.61942
13029,4,12,false,6,4,-2,41.86531,-87.6179
13431,4,12,false,5,3,-2,41.8661,-87.60728
WL-008,4,12,false,5,2,-3,41.86712,-87.64108
TA1305000002,4,12,false,6,6,0,41.86721,-87.62597
15544,4,12,false,43,51,8,41.86723,-87.61536
SL-005,4,12,false,13,10,-3,41.8679,-87.62304
13285,4,12,false,5,2,-3,41.86928,-87.67372
TA1309000010,4,12,false,4,5,1,41.87074,-87.62574
SL-008,4,12,false,6,1,-5,41.87209,-87.62956
623,4,12,false,5,5,0,41.87272,-87.62399
15541,4,12,false,22,5,-17,41.8758,-87.62086
13158,4,12,false,6,4,-2,41.87764,-87.64957
TA1305000025,4,12,false,10,4,-6,41.87773,-87.63528
TA1309000002,4,12,false,2,8,6,41.87784,-87.62408
TA1305000005,4,12,false,9,6,-3,41.87924,-87.62975
13011,4,12,false,4,7,3,41.87931,-87.63993
TA1309000008,4,12,false,7,5,-2,41.87933,-87.6355
KA1503000015,4,12,false,11,4,-7,41.87948,-87.6257
TA1309000007,4,12,false,4,6,2,41.88022,-87.63526
13300,4,12,false,36,14,-22,41.88097,-87.61675
13008,4,12,false,31,16,-15,41.88105,-87.62408
TA1305000006,4,12,false,11,5,-6,41.88122,-87.6296
13056,4,12,false,2,6,4,41.88168,-87.63951
TA1307000120,4,12,false,1,5,4,41.88188,-87.64879
13341,4,12,false,13,3,-10,41.88208,-87.63985
13036,4,12,false,12,9,-3,41.8821,-87.62513
KA1503000072,4,12,false,1,5,4,41.88317,-87.63693
WL-012,4,12,false,2,8,6,41.88337,-87.6412
13053,4,12,false,7,7,0,41.88365,-87.64863
13001,4,12,false,19,11,-8,41.88397,-87.62459
18062,4,12,false,2,7,5,41.88412,-87.65427
TA1306000010,4,12,false,10,8,-2,41.88419,-87.62961
TA1305000030,4,12,false,7,5,-2,41.88459,-87.63178
15535,4,12,false,8,4,-4,41.8846,-87.64455
TA1305000029,4,12,false,13,7,-6,41.88466,-87.62787
13263,4,12,false,8,12,4,41.88467,-87.61952
TA1306000015,4,12,false,5,3,-2,41.88549,-87.65232
TA1307000111,4,12,false,5,2,-3,41.88582,-87.63548
KA1503000012,4,12,false,7,8,1,41.88599,-87.63089
TA1305000011,4,12,false,8,16,8,41.886,-87.62418
15534,4,12,false,5,6,1,41.88627,-87.61749
TA1308000029,4,12,false,6,4,-2,41.88673,-87.62225
TA1307000131,4,12,false,9,10,1,41.88688,-87.62606
KA1503000064,4,12,false,19,16,-3,41.88697,-87.61281
TA1305000022,4,12,false,8,10,2,41.88817,-87.63656
KA1503000043,4,12,false,2,5,3,41.88918,-87.63851
13050,4,12,false,3,8,5,41.88919,-87.62775
13427,4,12,false,1,8,7,41.89054,-87.62205
13430,4,12,false,8,6,-2,41.89077,-87.63169
TA1306000013,4,12,false,12,9,-3,41.89083,-87.61852
RN-,4,12,false,9,5,-4,41.89102,-87.63546
TA1307000117,4,12,false,10,10,0,41.89144,-87.62675
13033,4,12,false,1,5,4,41.8916,-87.64835
TA1305000003,4,12,false,6,12,6,41.89187,-87.62061
13022,4,12,false,43,86,43,41.89227,-87.61205
TA1306000029,4,12,false,7,6,-1,41.89256,-87.61449
13045,4,12,false,3,5,2,41.89403,-87.62931
13016,4,12,false,6,6,0,41.89431,-87.62277
KA1503000041,4,12,false,4,5,1,41.89452,-87.61798
KP1705001026,4,12,false,7,10,3,41.89483,-87.6323
15530,4,12,false,5,11,6,41.89575,-87.62596
13303,4,12,false,4,7,3,41.89672,-87.63088
13338,4,12,false,6,6,0,41.89697,-87.62173
13034,4,12,false,4,12,8,41.89754,-87.62352
620,4,12,false,1,6,5,41.89817,-87.63754
15529,4,12,false,6,5,-1,41.89858,-87.62206
TA1307000128,4,12,false,4,9,5,41.89896,-87.6299
TA1306000011,4,12,false,6,1,-5,41.89994,-87.63443
13042,4,12,false,18,28,10,41.90097,-87.62377
KA1504000133,4,12,false,12,11,-1,41.90234,-87.62773
TA1307000039,4,12,false,2,8,6,41.90294,-87.63137
KA1504000135,4,12,false,7,11,4,41.90319,-87.63439
13061,4,12,false,6,2,-4,41.90342,-87.66779
TA1308000049,4,12,false,5,5,0,41.90672,-87.6349
13224,4,12,false,2,5,3,41.90706,-87.66725
TA1309000024,4,12,false,6,7,1,41.908,-87.63152
TA1305000041,4,12,false,1,10,9,41.9094,-87.67769
331,4,12,false,7,9,2,41.90965,-87.64812
TA1305000037,4,12,false,5,2,-3,41.91018,-87.67003
13154,4,12,false,2,5,3,41.91054,-87.65312
13058,4,12,false,4,5,1,41.91059,-87.64942
LF-005,4,12,false,4,25,21,41.91172,-87.62681
TA1308000050,4,12,false,10,9,-1,41.91211,-87.6347
TA1306000032,4,12,false,8,3,-5,41.9137,-87.65285
TA1307000166,4,12,false,5,1,-4,41.91386,-87.64877
13179,4,12,false,6,8,2,41.9157,-87.63461
13133,4,12,false,5,7,2,41.91598,-87.67733
15650,4,12,false,5,1,-4,41.91711,-87.71023
13146,4,12,false,9,10,1,41.91831,-87.63629
13059,4,12,false,4,7,3,41.91845,-87.65222
13259,4,12,false,1,6,5,41.91852,-87.69744
13192,4,12,false,5,5,0,41.91995,-87.64884
TA1309000033,4,12,false,6,1,-5,41.92158,-87.65381
13193,4,12,false,4,6,2,41.92182,-87.64412
13084,4,12,false,5,1,-4,41.92268,-87.69715
LP-,4,12,false,11,6,-5,41.92396,-87.63584
TA1307000001,4,12,false,7,4,-3,41.92535,-87.66581
TA1306000016,4,12,false,7,5,-2,41.9256,-87.65371
TA1309000019,4,12,false,6,11,5,41.92586,-87.63897
TA1309000058,4,12,false,5,4,-1,41.92591,-87.64927
TA1308000001,4,12,false,21,23,2,41.92627,-87.63086
13124,4,12,false,6,3,-3,41.92675,-87.63444
TA1309000023,4,12,false,4,6,2,41.9287,-87.65383
TA1308000031,4,12,false,2,5,3,41.92946,-87.68417
TA1305000014,4,12,false,5,8,3,41.92956,-87.64313
TA1307000142,4,12,false,4,5,1,41.93125,-87.64432
TA1307000064,4,12,false,11,5,-6,41.93222,-87.65864
TA1306000014,4,12,false,6,4,-2,41.93242,-87.65271
TA1309000039,4,12,false,16,8,-8,41.93258,-87.63642
TA1307000136,4,12,false,8,7,-1,41.9365,-87.64755
TA1307000041,4,12,false,11,3,-8,41.93669,-87.63683
13137,4,12,false,10,9,-1,41.9376,-87.6441
KA17018068,4,12,false,5,3,-2,41.93935,-87.68327
13277,4,12,false,5,3,-2,41.9401,-87.64546
TA1307000134,4,12,false,5,2,-3,41.94016,-87.65303
TA1309000049,4,12,false,12,7,-5,41.94077,-87.63919
13325,4,12,false,6,1,-5,41.94907,-87.64863
TA1307000127,4,12,false,5,14,9,41.9508,-87.65918
13063,4,12,false,5,2,-3,41.95424,-87.65441
13379,4,12,false,6,2,-4,41.95786,-87.6495
TA1308000012,4,12,false,13,24,11,41.96398,-87.63818
TA1307000140,4,12,false,5,2,-3,41.96643,-87.68865
TA1307000119,4,12,false,6,5,-1,41.96796,-87.65
TA1309000035,4,12,false,4,9,5,41.97335,-87.66785
13109,4,12,false,6,3,-3,41.97835,-87.65976
KA1504000152,4,12,false,8,6,-2,41.98403,-87.65231
15578,4,12,false,5,1,-4,41.98405,-87.66027
KA1503000071,4,12,true,7,3,-4,41.79148,-87.59988
KA1504000076,4,12,true,1,5,4,41.7943,-87.60145
TA1309000037,4,12,true,3,6,3,41.79957,-87.59474
13216,4,12,true,11,9,-2,41.83473,-87.62581
TA1307000139,4,12,true,6,4,-2,41.84205,-87.61698
15545,4,12,true,7,3,-4,41.85627,-87.61334
13135,4,12,true,1,5,4,41.85753,-87.66157
13102,4,12,true,2,5,3,41.85762,-87.61942
13150,4,12,true,5,5,0,41.85783,-87.62455
13163,4,12,true,3,5,2,41.85808,-87.65108
SL-012,4,12,true,5,2,-3,41.86038,-87.62581
TA1306000002,4,12,true,5,6,1,41.86238,-87.65108
TA1307000124,4,12,true,8,5,-3,41.86411,-87.62372
WL-008,4,12,true,3,5,2,41.86712,-87.64108
TA1305000002,4,12,true,10,9,-1,41.86721,-87.62597
SL-005,4,12,true,7,3,-4,41.8679,-87.62304
13139,4,12,true,7,6,-1,41.86893,-87.65913
13285,4,12,true,5,3,-2,41.86928,-87.67372
15550,4,12,true,2,7,5,41.87024,-87.63947
TA1309000010,4,12,true,5,9,4,41.87074,-87.62574
TA1309000064,4,12,true,13,8,-5,41.87127,-87.67369
TA1307000130,4,12,true,10,10,0,41.87178,-87.65103
TA1307000121,4,12,true,7,7,0,41.87184,-87.64664
SL-008,4,12,true,13,9,-4,41.87209,-87.62956
13332,4,12,true,11,19,8,41.87219,-87.6615
623,4,12,true,7,4,-3,41.87272,-87.62399
KA1504000104,4,12,true,7,5,-2,41.87296,-87.66912
TA1305000009,4,12,true,3,5,2,41.87593,-87.63068
TA1305000035,4,12,true,11,7,-4,41.87716,-87.62787
13138,4,12,true,7,5,-2,41.87723,-87.63941
13158,4,12,true,5,11,6,41.87764,-87.64957
13157,4,12,true,9,5,-4,41.87773,-87.6548
TA1305000025,4,12,true,7,4,-3,41.87773,-87.63528
TA1309000002,4,12,true,1,6,5,41.87784,-87.62408
13206,4,12,true,4,6,2,41.87794,-87.66201
TA1309000004,4,12,true,9,6,-3,41.87811,-87.63184
TA1305000005,4,12,true,5,8,3,41.87924,-87.62975
13011,4,12,true,5,11,6,41.87931,-87.63993
TA1309000008,4,12,true,7,11,4,41.87933,-87.6355
KA1503000034,4,12,true,11,3,-8,41.87938,-87.63197
TA1309000007,4,12,true,11,9,-2,41.88022,-87.63526
WL-011,4,12,true,3,6,3,41.88034,-87.64273
13156,4,12,true,6,2,-4,41.88042,-87.65554
13300,4,12,true,10,7,-3,41.88097,-87.61675
13008,4,12,true,6,8,2,41.88105,-87.62408
TA1305000006,4,12,true,9,8,-1,41.88122,-87.6296
13056,4,12,true,8,4,-4,41.88168,-87.63951
TA1307000120,4,12,true,7,15,8,41.88188,-87.64879
13341,4,12,true,4,11,7,41.88208,-87.63985
TA1305000032,4,12,true,8,9,1,41.88218,-87.64109
13006,4,12,true,8,14,6,41.88268,-87.63252
13353,4,12,true,4,5,1,41.88283,-87.6612
13409,4,12,true,1,5,4,41.8831,-87.6511
KA1503000072,4,12,true,4,6,2,41.88317,-87.63693
WL-012,4,12,true,4,9,5,41.88337,-87.6412
13053,4,12,true,7,12,5,41.88365,-87.64863
13001,4,12,true,12,8,-4,41.88397,-87.62459
18062,4,12,true,2,5,3,41.88412,-87.65427
TA1306000010,4,12,true,11,8,-3,41.88419,-87.62961
TA1305000030,4,12,true,12,8,-4,41.88459,-87.63178
15535,4,12,true,2,19,17,41.8846,-87.64455
TA1305000029,4,12,true,7,6,-1,41.88466,-87.62787
13263,4,12,true,10,11,1,41.88467,-87.61952
TA1306000015,4,12,true,12,6,-6,41.88549,-87.65232
13021,4,12,true,16,10,-6,41.88559,-87.64184
TA1307000111,4,12,true,8,10,2,41.88582,-87.63548
TA1305000011,4,12,true,7,9,2,41.886,-87.62418
TA1307000131,4,12,true,4,7,3,41.88688,-87.62606
TA1305000022,4,12,true,10,9,-1,41.88817,-87.63656
TA1306000003,4,12,true,11,12,1,41.88867,-87.64442
KA1503000043,4,12,true,14,24,10,41.88918,-87.63851
13050,4,12,true,11,6,-5,41.88919,-87.62775
TA1307000151,4,12,true,22,18,-4,41.88993,-87.63427
636,4,12,true,9,4,-5,41.88997,-87.63662
KA1503000044,4,12,true,2,6,4,41.89018,-87.6262
13427,4,12,true,3,11,8,41.89054,-87.62205
13430,4,12,true,9,12,3,41.89077,-87.63169
TA1306000013,4,12,true,6,12,6,41.89083,-87.61852
RN-,4,12,true,7,4,-3,41.89102,-87.63546
TA1307000117,4,12,true,10,17,7,41.89144,-87.62675
13033,4,12,true,12,12,0,41.8916,-87.64835
13194,4,12,true,5,5,0,41.8918,-87.65878
TA1305000003,4,12,true,7,13,6,41.89187,-87.62061
13022,4,12,true,13,10,-3,41.89227,-87.61205
TA1306000029,4,12,true,5,10,5,41.89256,-87.61449
13265,4,12,true,8,9,1,41.89383,-87.64172
13045,4,12,true,16,17,1,41.89403,-87.62931
13016,4,12,true,11,14,3,41.89431,-87.62277
KA1503000041,4,12,true,19,18,-1,41.89452,-87.61798
13196,4,12,true,7,3,-4,41.89455,-87.65345
TA1307000062,4,12,true,7,3,-4,41.89466,-87.63839
TA1306000012,4,12,true,11,11,0,41.89475,-87.63438
KP1705001026,4,12,true,9,6,-3,41.89483,-87.6323
637,4,12,true,5,5,0,41.89563,-87.67209
13132,4,12,true,8,6,-2,41.89573,-87.67718
15530,4,12,true,10,7,-3,41.89575,-87.62596
18003,4,12,true,9,11,2,41.89575,-87.62011
13247,4,12,true,5,4,-1,41.89597,-87.66775
TA1305000020,4,12,true,5,2,-3,41.89636,-87.65406
13289,4,12,true,4,7,3,41.89638,-87.661
13303,4,12,true,1,5,4,41.89672,-87.63088
13017,4,12,true,6,8,2,41.89676,-87.6357
13338,4,12,true,6,4,-2,41.89697,-87.62173
TA1307000061,4,12,true,6,5,-1,41.89745,-87.62873
13034,4,12,true,4,7,3,41.89754,-87.62352
TA1306000009,4,12,true,10,7,-3,41.89772,-87.64299
620,4,12,true,6,8,2,41.89817,-87.63754
15529,4,12,true,7,7,0,41.89858,-87.62206
TA1307000128,4,12,true,16,12,-4,41.89896,-87.6299
13248,4,12,true,7,6,-1,41.89964,-87.66788
KA1504000116,4,12,true,3,5,2,41.90023,-87.64299
13042,4,12,true,12,10,-2,41.90097,-87.62377
KA1504000133,4,12,true,10,11,1,41.90234,-87.62773
13241,4,12,true,5,2,-3,41.9029,-87.68731
TA1306000006,4,12,true,5,2,-3,41.90292,-87.63772
TA1307000039,4,12,true,16,12,-4,41.90294,-87.63137
KA1504000135,4,12,true,15,9,-6,41.90319,-87.63439
13061,4,12,true,7,6,-1,41.90342,-87.66779
KA1504000079,4,12,true,7,4,-3,41.9035,-87.64334
TA1308000049,4,12,true,8,9,1,41.90672,-87.6349
KA1504000134,4,12,true,4,8,4,41.90687,-87.6262
13221,4,12,true,5,8,3,41.90765,-87.67254
TA1309000024,4,12,true,9,12,3,41.908,-87.63152
TA1305000041,4,12,true,10,6,-4,41.9094,-87.67769
331,4,12,true,7,4,-3,41.90965,-87.64812
TA1305000037,4,12,true,7,2,-5,41.91018,-87.67003
TA1308000005,4,12,true,3,6,3,41.91042,-87.68238
13258,4,12,true,7,3,-4,41.91043,-87.69718
13154,4,12,true,9,11,2,41.91054,-87.65312
13058,4,12,true,8,9,1,41.91059,-87.64942
TA1307000038,4,12,true,5,9,4,41.91138,-87.63868
LF-005,4,12,true,11,13,2,41.91172,-87.62681
13128,4,12,true,4,5,1,41.91197,-87.63197
TA1308000050,4,12,true,16,12,-4,41.91211,-87.6347
TA1306000032,4,12,true,6,4,-2,41.9137,-87.65285
TA1307000166,4,12,true,6,5,-1,41.91386,-87.64877
18067,4,12,true,7,6,-1,41.9146,-87.66796
13179,4,12,true,16,9,-7,41.9157,-87.63461
13133,4,12,true,5,2,-3,41.91598,-87.67733
TA1309000006,4,12,true,4,6,2,41.91809,-87.64375
TA1307000163,4,12,true,1,5,4,41.91821,-87.65696
13146,4,12,true,14,4,-10,41.91831,-87.63629
13059,4,12,true,6,14,8,41.91845,-87.65222
13192,4,12,true,6,6,0,41.91995,-87.64884
TA1309000030,4,12,true,3,6,3,41.92077,-87.66372
TA1309000033,4,12,true,6,7,1,41.92158,-87.65381
13193,4,12,true,11,5,-6,41.92182,-87.64412
13191,4,12,true,7,5,-2,41.92217,-87.63891
LP-,4,12,true,5,1,-4,41.92396,-87.63584
15648,4,12,true,5,4,-1,41.92464,-87.68931
TA1307000001,4,12,true,8,9,1,41.92535,-87.66581
TA1306000026,4,12,true,11,7,-4,41.92558,-87.65842
TA1306000016,4,12,true,9,6,-3,41.9256,-87.65371
TA1309000019,4,12,true,11,13,2,41.92586,-87.63897
TA1309000058,4,12,true,9,17,8,41.92591,-87.64927
TA1308000001,4,12,true,10,14,4,41.92627,-87.63086
TA1309000059,4,12,true,5,2,-3,41.92889,-87.65898
TA1309000061,4,12,true,7,9,2,41.92915,-87.64909
TA1305000014,4,12,true,9,10,1,41.92956,-87.64313
TA1307000142,4,12,true,19,16,-3,41.93125,-87.64432
13276,4,12,true,4,8,4,41.93132,-87.63874
TA1307000064,4,12,true,7,7,0,41.93222,-87.65864
TA1306000014,4,12,true,3,8,5,41.93242,-87.65271
TA1309000039,4,12,true,9,4,-5,41.93258,-87.63642
TA1309000036,4,12,true,9,7,-2,41.93313,-87.64776
TA1307000006,4,12,true,5,3,-2,41.93571,-87.6636
TA1307000052,4,12,true,9,8,-1,41.93628,-87.65266
TA1307000136,4,12,true,13,8,-5,41.9365,-87.64755
TA1307000041,4,12,true,5,6,1,41.93669,-87.63683
13137,4,12,true,16,8,-8,41.9376,-87.6441
KA17018068,4,12,true,5,2,-3,41.93935,-87.68327
TA1309000042,4,12,true,5,5,0,41.93937,-87.66836
13277,4,12,true,5,7,2,41.9401,-87.64546
TA1307000134,4,12,true,2,7,5,41.94016,-87.65303
TA1309000049,4,12,true,4,5,1,41.94077,-87.63919
13144,4,12,true,1,5,4,41.9434,-87.67964
TA1309000025,4,12,true,6,4,-2,41.94368,-87.64894
13071,4,12,true,8,5,-3,41.94373,-87.66401
13278,4,12,true,6,7,1,41.94553,-87.64644
13235,4,12,true,11,7,-4,41.94814,-87.66396
13325,4,12,true,9,9,0,41.94907,-87.64863
TA1307000150,4,12,true,9,4,-5,41.94945,-87.64646
13319,4,12,true,4,5,1,41.95069,-87.6687
TA1307000127,4,12,true,7,6,-1,41.9508,-87.65918
13323,4,12,true,7,1,-6,41.95282,-87.65
13063,4,12,true,9,2,-7,41.95424,-87.65441
TA1308000022,4,12,true,5,2,-3,41.95438,-87.64805
13379,4,12,true,12,7,-5,41.95786,-87.6495
TA1309000027,4,12,true,7,7,0,41.9585,-87.65499
13389,4,12,true,5,3,-2,41.961,-87.64958
TA1308000012,4,12,true,7,13,6,41.96398,-87.63818
13074,4,12,true,9,12,3,41.96521,-87.6582
TA1307000140,4,12,true,4,5,1,41.96643,-87.68865
TA1309000014,4,12,true,2,5,3,41.96709,-87.66744
TA1307000158,4,12,true,4,8,4,41.9671,-87.67904
TA1309000066,4,12,true,1,10,9,41.9691,-87.67423
KA1504000171,4,12,true,5,5,0,41.97161,-87.65016
TA1309000035,4,12,true,6,3,-3,41.97335,-87.66785
13108,4,12,true,3,5,2,41.97379,-87.65971
KA1504000146,4,12,true,3,7,4,41.978,-87.66805
KA1504000152,4,12,true,12,6,-6,41.98403,-87.65231
15575,4,12,true,5,4,-1,41.98975,-87.66014
523,4,12,true,5,4,-1,42.02089,-87.66505
KA1503000071,4,13,false,6,3,-3,41.79148,-87.59988
KA1503000074,4,13,false,10,1,-9,41.79174,-87.58395
KA1503000007,4,13,false,5,4,-1,41.80242,-87.58689
TA1307000048,4,13,false,13,9,-4,41.83855,-87.60821
15545,4,13,false,7,3,-4,41.85627,-87.61334
SL-012,4,13,false,5,2,-3,41.86038,-87.62581
TA1307000124,4,13,false,5,4,-1,41.86411,-87.62372
TA1309000001,4,13,false,1,5,4,41.86488,-87.64708
13029,4,13,false,2,8,6,41.86531,-87.6179
TA1305000002,4,13,false,11,10,-1,41.86721,-87.62597
15544,4,13,false,57,53,-4,41.86723,-87.61536
SL-005,4,13,false,10,5,-5,41.8679,-87.62304
TA1309000010,4,13,false,5,8,3,41.87074,-87.62574
TA1307000130,4,13,false,5,1,-4,41.87178,-87.65103
SL-008,4,13,false,7,5,-2,41.87209,-87.62956
623,4,13,false,7,7,0,41.87272,-87.62399
15541,4,13,false,15,23,8,41.8758,-87.62086
TA1305000035,4,13,false,15,4,-11,41.87716,-87.62787
TA1305000025,4,13,false,7,7,0,41.87773,-87.63528
TA1309000002,4,13,false,11,6,-5,41.87784,-87.62408
TA1309000004,4,13,false,6,1,-5,41.87811,-87.63184
TA1305000005,4,13,false,4,5,1,41.87924,-87.62975
13011,4,13,false,5,2,-3,41.87931,-87.63993
TA1309000008,4,13,false,7,9,2,41.87933,-87.6355
KA1503000015,4,13,false,2,6,4,41.87948,-87.6257
TA1309000007,4,13,false,8,9,1,41.88022,-87.63526
13156,4,13,false,11,3,-8,41.88042,-87.65554
13300,4,13,false,26,35,9,41.88097,-87.61675
13008,4,13,false,28,35,7,41.88105,-87.62408
TA1305000006,4,13,false,5,6,1,41.88122,-87.6296
TA1307000120,4,13,false,3,7,4,41.88188,-87.64879
13341,4,13,false,6,1,-5,41.88208,-87.63985
13036,4,13,false,20,7,-13,41.8821,-87.62513
13006,4,13,false,1,5,4,41.88268,-87.63252
13353,4,13,false,1,6,5,41.88283,-87.6612
WL-012,4,13,false,6,5,-1,41.88337,-87.6412
13053,4,13,false,10,3,-7,41.88365,-87.64863
13001,4,13,false,21,28,7,41.88397,-87.62459
TA1306000010,4,13,false,7,8,1,41.88419,-87.62961
TA1305000030,4,13,false,8,5,-3,41.88459,-87.63178
15535,4,13,false,2,5,3,41.8846,-87.64455
TA1305000029,4,13,false,8,6,-2,41.88466,-87.62787
13263,4,13,false,11,2,-9,41.88467,-87.61952
13021,4,13,false,6,4,-2,41.88559,-87.64184
TA1307000111,4,13,false,8,2,-6,41.88582,-87.63548
TA1305000011,4,13,false,6,12,6,41.886,-87.62418
TA1307000131,4,13,false,11,11,0,41.88688,-87.62606
KA1503000064,4,13,false,27,8,-19,41.88697,-87.61281
TA1305000022,4,13,false,7,7,0,41.88817,-87.63656
TA1306000003,4,13,false,8,8,0,41.88867,-87.64442
KA1503000043,4,13,false,4,9,5,41.88918,-87.63851
13050,4,13,false,5,8,3,41.88919,-87.62775
TA1307000151,4,13,false,6,6,0,41.88993,-87.63427
13427,4,13,false,5,3,-2,41.89054,-87.62205
13430,4,13,false,6,7,1,41.89077,-87.63169
TA1306000013,4,13,false,2,16,14,41.89083,-87.61852
RN-,4,13,false,9,7,-2,41.89102,-87.63546
TA1307000117,4,13,false,18,17,-1,41.89144,-87.62675
13033,4,13,false,11,8,-3,41.8916,-87.64835
TA1305000003,4,13,false,9,8,-1,41.89187,-87.62061
13022,4,13,false,76,108,32,41.89227,-87.61205
TA1306000029,4,13,false,8,9,1,41.89256,-87.61449
13265,4,13,false,2,8,6,41.89383,-87.64172
13045,4,13,false,8,11,3,41.89403,-87.62931
13016,4,13,false,8,5,-3,41.89431,-87.62277
KA1503000041,4,13,false,5,7,2,41.89452,-87.61798
TA1307000062,4,13,false,6,2,-4,41.89466,-87.63839
TA1306000012,4,13,false,7,7,0,41.89475,-87.63438
15530,4,13,false,8,7,-1,41.89575,-87.62596
18003,4,13,false,8,4,-4,41.89575,-87.62011
13303,4,13,false,5,4,-1,41.89672,-87.63088
TA1307000061,4,13,false,7,4,-3,41.89745,-87.62873
13034,4,13,false,8,10,2,41.89754,-87.62352
620,4,13,false,4,5,1,41.89817,-87.63754
15529,4,13,false,7,17,10,41.89858,-87.62206
TA1307000128,4,13,false,6,8,2,41.89896,-87.6299
13042,4,13,false,27,30,3,41.90097,-87.62377
KA1504000133,4,13,false,7,11,4,41.90234,-87.62773
TA1307000039,4,13,false,7,7,0,41.90294,-87.63137
KA1504000135,4,13,false,6,4,-2,41.90319,-87.63439
13061,4,13,false,10,8,-2,41.90342,-87.66779
KA1504000134,4,13,false,6,2,-4,41.90687,-87.6262
13221,4,13,false,4,9,5,41.90765,-87.67254
TA1309000024,4,13,false,5,9,4,41.908,-87.63152
TA1305000041,4,13,false,7,9,2,41.9094,-87.67769
331,4,13,false,10,6,-4,41.90965,-87.64812
13058,4,13,false,7,4,-3,41.91059,-87.64942
TA1307000038,4,13,false,5,8,3,41.91138,-87.63868
LF-005,4,13,false,26,41,15,41.91172,-87.62681
13128,4,13,false,2,8,6,41.91197,-87.63197
TA1308000050,4,13,false,11,13,2,41.91211,-87.6347
13179,4,13,false,1,10,9,41.9157,-87.63461
13133,4,13,false,2,5,3,41.91598,-87.67733
TA1307000163,4,13,false,5,4,-1,41.91821,-87.65696
13146,4,13,false,13,4,-9,41.91831,-87.63629
13193,4,13,false,4,7,3,41.92182,-87.64412
13191,4,13,false,6,3,-3,41.92217,-87.63891
LP-,4,13,false,11,16,5,41.92396,-87.63584
TA1306000016,4,13,false,7,2,-5,41.9256,-87.65371
TA1309000019,4,13,false,7,5,-2,41.92586,-87.63897
TA1309000058,4,13,false,8,4,-4,41.92591,-87.64927
TA1308000001,4,13,false,16,25,9,41.92627,-87.63086
TA1305000014,4,13,false,5,7,2,41.92956,-87.64313
13085,4,13,false,2,7,5,41.92958,-87.70789
TA1307000142,4,13,false,3,6,3,41.93125,-87.64432
13276,4,13,false,4,5,1,41.93132,-87.63874
13271,4,13,false,6,3,-3,41.93192,-87.67784
TA1306000014,4,13,false,1,10,9,41.93242,-87.65271
TA1309000039,4,13,false,11,10,-1,41.93258,-87.63642
TA1309000036,4,13,false,2,8,6,41.93313,-87.64776
TA1307000052,4,13,false,4,10,6,41.93628,-87.65266
TA1307000041,4,13,false,8,9,1,41.93669,-87.63683
13137,4,13,false,18,5,-13,41.9376,-87.6441
13229,4,13,false,7,5,-2,41.93946,-87.66376
TA1308000019,4,13,false,5,5,0,41.93973,-87.65886
TA1307000134,4,13,false,5,3,-2,41.94016,-87.65303
TA1309000049,4,13,false,11,14,3,41.94077,-87.63919
TA1307000138,4,13,false,5,3,-2,41.94334,-87.67094
TA1309000025,4,13,false,5,11,6,41.94368,-87.64894
13071,4,13,false,8,6,-2,41.94373,-87.66401
632,4,13,false,7,7,0,41.94453,-87.6547
13278,4,13,false,6,3,-3,41.94553,-87.64644
13235,4,13,false,5,3,-2,41.94814,-87.66396
TA1307000126,4,13,false,4,9,5,41.94936,-87.65451
TA1307000150,4,13,false,10,2,-8,41.94945,-87.64646
TA1307000127,4,13,false,3,9,6,41.9508,-87.65918
13323,4,13,false,7,6,-1,41.95282,-87.65
TA1308000022,4,13,false,5,4,-1,41.95438,-87.64805
TA1307000107,4,13,false,6,1,-5,41.96164,-87.65464
TA1308000012,4,13,false,5,6,1,41.96398,-87.63818
639,4,13,false,3,12,9,41.96584,-87.64538
TA1309000014,4,13,false,5,6,1,41.96709,-87.66744
TA1309000066,4,13,false,6,1,-5,41.9691,-87.67423
KA1504000171,4,13,false,5,2,-3,41.97161,-87.65016
KA1504000146,4,13,false,4,6,2,41.978,-87.66805
13109,4,13,false,1,6,5,41.97835,-87.65976
KA1504000152,4,13,false,10,7,-3,41.98403,-87.65231
15571,4,13,false,4,5,1,41.99478,-87.66028
RP-009,4,13,false,9,3,-6,42.00107,-87.66122
KA1504000175,4,13,false,5,3,-2,42.00797,-87.66549
596,4,13,false,6,2,-4,42.04822,-87.68348
605,4,13,false,2,5,3,42.05294,-87.67342
KA1503000071,4,13,true,5,8,3,41.79148,-87.59988
TA1307000129,4,13,true,6,5,-1,41.83104,-87.62683
13216,4,13,true,5,6,1,41.83473,-87.62581
TA1309000055,4,13,true,1,5,4,41.8382,-87.64514
TA1307000153,4,13,true,2,5,3,41.84358,-87.64538
SL-012,4,13,true,5,6,1,41.86038,-87.62581
WL-008,4,13,true,6,7,1,41.86712,-87.64108
TA1305000002,4,13,true,15,10,-5,41.86721,-87.62597
15544,4,13,true,7,9,2,41.86723,-87.61536
KA1706005007,4,13,true,2,5,3,41.86749,-87.63219
SL-005,4,13,true,6,6,0,41.8679,-87.62304
13285,4,13,true,2,7,5,41.86928,-87.67372
13160,4,13,true,6,6,0,41.86947,-87.65548
TA1309000010,4,13,true,5,5,0,41.87074,-87.62574
TA1309000064,4,13,true,7,5,-2,41.87127,-87.67369
TA1307000121,4,13,true,7,6,-1,41.87184,-87.64664
SL-008,4,13,true,7,7,0,41.87209,-87.62956
13332,4,13,true,8,12,4,41.87219,-87.6615
SL-011,4,13,true,3,10,7,41.87256,-87.63356
KA1504000104,4,13,true,9,5,-4,41.87296,-87.66912
13028,4,13,true,5,4,-1,41.87475,-87.64981
TA1305000010,4,13,true,1,7,6,41.87623,-87.62444
TA1305000035,4,13,true,11,10,-1,41.87716,-87.62787
13138,4,13,true,2,5,3,41.87723,-87.63941
13158,4,13,true,12,8,-4,41.87764,-87.64957
TA1305000025,4,13,true,9,7,-2,41.87773,-87.63528
13206,4,13,true,11,2,-9,41.87794,-87.66201
TA1309000004,4,13,true,7,4,-3,41.87811,-87.63184
TA1309000008,4,13,true,8,5,-3,41.87933,-87.6355
KA1503000034,4,13,true,3,5,2,41.87938,-87.63197
KA1503000015,4,13,true,7,3,-4,41.87948,-87.6257
TA1309000007,4,13,true,9,6,-3,41.88022,-87.63526
13300,4,13,true,5,4,-1,41.88097,-87.61675
13008,4,13,true,8,2,-6,41.88105,-87.62408
TA1305000006,4,13,true,9,6,-3,41.88122,-87.6296
TA1307000120,4,13,true,9,13,4,41.88188,-87.64879
13341,4,13,true,2,8,6,41.88208,-87.63985
13036,4,13,true,4,6,2,41.8821,-87.62513
TA1305000032,4,13,true,8,8,0,41.88218,-87.64109
13006,4,13,true,4,5,1,41.88268,-87.63252
13353,4,13,true,3,5,2,41.88283,-87.6612
KA1503000072,4,13,true,7,4,-3,41.88317,-87.63693
WL-012,4,13,true,5,6,1,41.88337,-87.6412
13053,4,13,true,7,9,2,41.88365,-87.64863
13001,4,13,true,10,7,-3,41.88397,-87.62459
18062,4,13,true,6,4,-2,41.88412,-87.65427
TA1306000010,4,13,true,9,9,0,41.88419,-87.62961
TA1305000030,4,13,true,11,11,0,41.88459,-87.63178
15535,4,13,true,6,9,3,41.8846,-87.64455
TA1305000029,4,13,true,6,6,0,41.88466,-87.62787
13263,4,13,true,15,14,-1,41.88467,-87.61952
TA1306000015,4,13,true,7,8,1,41.88549,-87.65232
13021,4,13,true,8,8,0,41.88559,-87.64184
TA1307000111,4,13,true,10,5,-5,41.88582,-87.63548
KA1503000012,4,13,true,7,5,-2,41.88599,-87.63089
TA1305000011,4,13,true,22,12,-10,41.886,-87.62418
15534,4,13,true,3,5,2,41.88627,-87.61749
TA1305000022,4,13,true,11,9,-2,41.88817,-87.63656
TA1306000003,4,13,true,7,7,0,41.88867,-87.64442
KA1503000043,4,13,true,24,14,-10,41.88918,-87.63851
13050,4,13,true,4,5,1,41.88919,-87.62775
TA1307000151,4,13,true,8,8,0,41.88993,-87.63427
636,4,13,true,3,5,2,41.88997,-87.63662
KA1503000044,4,13,true,4,6,2,41.89018,-87.6262
13427,4,13,true,7,7,0,41.89054,-87.62205
13430,4,13,true,10,7,-3,41.89077,-87.63169
TA1306000013,4,13,true,7,11,4,41.89083,-87.61852
RN-,4,13,true,10,12,2,41.89102,-87.63546
TA1307000117,4,13,true,12,14,2,41.89144,-87.62675
13033,4,13,true,2,12,10,41.8916,-87.64835
TA1305000003,4,13,true,10,6,-4,41.89187,-87.62061
13022,4,13,true,12,8,-4,41.89227,-87.61205
TA1306000029,4,13,true,1,8,7,41.89256,-87.61449
13265,4,13,true,7,7,0,41.89383,-87.64172
13045,4,13,true,10,14,4,41.89403,-87.62931
13016,4,13,true,11,10,-1,41.89431,-87.62277
KA1503000041,4,13,true,9,6,-3,41.89452,-87.61798
13196,4,13,true,3,5,2,41.89455,-87.65345
TA1307000062,4,13,true,11,9,-2,41.89466,-87.63839
TA1306000012,4,13,true,12,11,-1,41.89475,-87.63438
KP1705001026,4,13,true,7,5,-2,41.89483,-87.6323
15530,4,13,true,14,10,-4,41.89575,-87.62596
18003,4,13,true,4,5,1,41.89575,-87.62011
13247,4,13,true,2,7,5,41.89597,-87.66775
13289,4,13,true,4,5,1,41.89638,-87.661
13303,4,13,true,5,2,-3,41.89672,-87.63088
13017,4,13,true,7,6,-1,41.89676,-87.6357
13338,4,13,true,3,6,3,41.89697,-87.62173
TA1307000061,4,13,true,6,6,0,41.89745,-87.62873
13034,4,13,true,6,8,2,41.89754,-87.62352
TA1306000009,4,13,true,5,6,1,41.89772,-87.64299
620,4,13,true,7,4,-3,41.89817,-87.63754
TA1307000128,4,13,true,13,12,-1,41.89896,-87.6299
TA1306000011,4,13,true,8,2,-6,41.89994,-87.63443
13042,4,13,true,8,10,2,41.90097,-87.62377
KA1504000133,4,13,true,6,9,3,41.90234,-87.62773
TA1307000039,4,13,true,11,9,-2,41.90294,-87.63137
KA1504000135,4,13,true,10,11,1,41.90319,-87.63439
13061,4,13,true,7,7,0,41.90342,-87.66779
KA1504000079,4,13,true,3,8,5,41.9035,-87.64334
TA1308000049,4,13,true,6,6,0,41.90672,-87.6349
13224,4,13,true,2,5,3,41.90706,-87.66725
13221,4,13,true,5,3,-2,41.90765,-87.67254
TA1309000024,4,13,true,11,8,-3,41.908,-87.63152
331,4,13,true,8,7,-1,41.90965,-87.64812
TA1305000037,4,13,true,5,2,-3,41.91018,-87.67003
13154,4,13,true,7,4,-3,41.91054,-87.65312
13058,4,13,true,4,8,4,41.91059,-87.64942
TA1307000038,4,13,true,6,2,-4,41.91138,-87.63868
LF-005,4,13,true,11,13,2,41.91172,-87.62681
13128,4,13,true,6,1,-5,41.91197,-87.63197
TA1308000050,4,13,true,9,11,2,41.91211,-87.6347
13243,4,13,true,7,5,-2,41.91262,-87.6814
TA1306000032,4,13,true,2,12,10,41.9137,-87.65285
TA1307000166,4,13,true,5,10,5,41.91386,-87.64877
18067,4,13,true,4,5,1,41.9146,-87.66796
TA1306000007,4,13,true,3,5,2,41.91469,-87.64333
13179,4,13,true,8,18,10,41.9157,-87.63461
TA1309000006,4,13,true,4,6,2,41.91809,-87.64375
TA1307000163,4,13,true,5,2,-3,41.91821,-87.65696
13146,4,13,true,6,14,8,41.91831,-87.63629
13059,4,13,true,14,10,-4,41.91845,-87.65222
13192,4,13,true,5,6,1,41.91995,-87.64884
TA1309000030,4,13,true,7,5,-2,41.92077,-87.66372
TA1309000033,4,13,true,6,5,-1,41.92158,-87.65381
13193,4,13,true,11,9,-2,41.92182,-87.64412
13191,4,13,true,5,7,2,41.92217,-87.63891
TA1307000001,4,13,true,3,6,3,41.92535,-87.66581
TA1306000026,4,13,true,7,7,0,41.92558,-87.65842
TA1306000016,4,13,true,5,5,0,41.9256,-87.65371
TA1309000019,4,13,true,7,8,1,41.92586,-87.63897
TA1309000058,4,13,true,9,5,-4,41.92591,-87.64927
TA1308000001,4,13,true,8,10,2,41.92627,-87.63086
TA1309000061,4,13,true,3,6,3,41.92915,-87.64909
TA1305000014,4,13,true,4,8,4,41.92956,-87.64313
TA1307000142,4,13,true,12,14,2,41.93125,-87.64432
TA1306000014,4,13,true,9,5,-4,41.93242,-87.65271
TA1309000039,4,13,true,4,9,5,41.93258,-87.63642
TA1309000036,4,13,true,6,7,1,41.93313,-87.64776
TA1307000006,4,13,true,4,8,4,41.93571,-87.6636
13269,4,13,true,5,4,-1,41.93609,-87.66983
TA1307000052,4,13,true,7,9,2,41.93628,-87.65266
TA1307000136,4,13,true,3,9,6,41.9365,-87.64755
TA1307000041,4,13,true,4,5,1,41.93669,-87.63683
13137,4,13,true,11,16,5,41.9376,-87.6441
TA1309000042,4,13,true,6,4,-2,41.93937,-87.66836
13229,4,13,true,8,2,-6,41.93946,-87.66376
13277,4,13,true,7,1,-6,41.9401,-87.64546
TA1307000134,4,13,true,7,9,2,41.94016,-87.65303
TA1309000049,4,13,true,8,10,2,41.94077,-87.63919
TA1307000138,4,13,true,12,6,-6,41.94334,-87.67094
TA1309000025,4,13,true,3,10,7,41.94368,-87.64894
13071,4,13,true,6,3,-3,41.94373,-87.66401
632,4,13,true,3,6,3,41.94453,-87.6547
13278,4,13,true,8,8,0,41.94553,-87.64644
13235,4,13,true,7,4,-3,41.94814,-87.66396
13253,4,13,true,1,7,6,41.9488,-87.67527
13325,4,13,true,8,7,-1,41.94907,-87.64863
TA1307000126,4,13,true,3,6,3,41.94936,-87.65451
TA1307000150,4,13,true,7,13,6,41.94945,-87.64646
TA1307000127,4,13,true,5,7,2,41.9508,-87.65918
13323,4,13,true,11,9,-2,41.95282,-87.65
TA1308000022,4,13,true,7,8,1,41.95438,-87.64805
13379,4,13,true,6,11,5,41.95786,-87.6495
TA1309000027,4,13,true,6,2,-4,41.9585,-87.65499
13389,4,13,true,5,7,2,41.961,-87.64958
KA1503000022,4,13,true,5,2,-3,41.96158,-87.66609
TA1307000107,4,13,true,7,8,1,41.96164,-87.65464
13074,4,13,true,8,7,-1,41.96521,-87.6582
TA1309000014,4,13,true,3,6,3,41.96709,-87.66744
TA1307000158,4,13,true,6,5,-1,41.9671,-87.67904
TA1309000066,4,13,true,8,10,2,41.9691,-87.67423
KA1504000171,4,13,true,4,5,1,41.97161,-87.65016
13109,4,13,true,6,4,-2,41.97835,-87.65976
KA1504000152,4,13,true,5,10,5,41.98403,-87.65231
15578,4,13,true,4,5,1,41.98405,-87.66027
TA1309000011,4,14,false,6,5,-1,41.78873,-87.60131
KA1503000074,4,14,false,5,3,-2,41.79174,-87.58395
TA1308000009,4,14,false,2,14,12,41.79522,-87.58075
TA1309000037,4,14,false,5,4,-1,41.79957,-87.59474
KA1503000007,4,14,false,5,7,2,41.80242,-87.58689
TA1307000048,4,14,false,4,8,4,41.83855,-87.60821
15545,4,14,false,11,11,0,41.85627,-87.61334
SL-012,4,14,false,8,1,-7,41.86038,-87.62581
13029,4,14,false,14,9,-5,41.86531,-87.6179
13431,4,14,false,9,15,6,41.8661,-87.60728
TA1305000002,4,14,false,7,5,-2,41.86721,-87.62597
15544,4,14,false,46,33,-13,41.86723,-87.61536
SL-005,4,14,false,10,12,2,41.8679,-87.62304
TA1309000010,4,14,false,8,8,0,41.87074,-87.62574
SL-008,4,14,false,3,5,2,41.87209,-87.62956
623,4,14,false,12,6,-6,41.87272,-87.62399
13028,4,14,false,6,1,-5,41.87475,-87.64981
15541,4,14,false,17,7,-10,41.8758,-87.62086
TA1305000010,4,14,false,3,5,2,41.87623,-87.62444
15539,4,14,false,4,5,1,41.87763,-87.64405
TA1305000025,4,14,false,8,1,-7,41.87773,-87.63528
TA1309000002,4,14,false,6,8,2,41.87784,-87.62408
638,4,14,false,7,2,-5,41.87827,-87.64078
KA1503000015,4,14,false,10,5,-5,41.87948,-87.6257
13156,4,14,false,6,8,2,41.88042,-87.65554
13300,4,14,false,43,39,-4,41.88097,-87.61675
13008,4,14,false,40,40,0,41.88105,-87.62408
13056,4,14,false,5,4,-1,41.88168,-87.63951
TA1307000120,4,14,false,8,4,-4,41.88188,-87.64879
13036,4,14,false,8,4,-4,41.8821,-87.62513
TA1305000032,4,14,false,5,4,-1,41.88218,-87.64109
654,4,14,false,6,1,-5,41.88307,-87.65698
13409,4,14,false,3,6,3,41.8831,-87.6511
WL-012,4,14,false,3,6,3,41.88337,-87.6412
13001,4,14,false,10,19,9,41.88397,-87.62459
TA1306000010,4,14,false,4,7,3,41.88419,-87.62961
TA1305000030,4,14,false,11,7,-4,41.88459,-87.63178
TA1305000029,4,14,false,7,14,7,41.88466,-87.62787
13263,4,14,false,5,4,-1,41.88467,-87.61952
TA1306000015,4,14,false,4,7,3,41.88549,-87.65232
KA1503000012,4,14,false,9,8,-1,41.88599,-87.63089
TA1305000011,4,14,false,9,12,3,41.886,-87.62418
TA1308000029,4,14,false,1,5,4,41.88673,-87.62225
TA1307000131,4,14,false,14,15,1,41.88688,-87.62606
KA1503000064,4,14,false,26,28,2,41.88697,-87.61281
TA1306000003,4,14,false,3,5,2,41.88867,-87.64442
KA1503000043,4,14,false,7,4,-3,41.88918,-87.63851
13050,4,14,false,7,2,-5,41.88919,-87.62775
TA1307000151,4,14,false,4,9,5,41.88993,-87.63427
13427,4,14,false,5,3,-2,41.89054,-87.62205
13430,4,14,false,7,10,3,41.89077,-87.63169
TA1306000013,4,14,false,6,14,8,41.89083,-87.61852
TA1307000117,4,14,false,12,10,-2,41.89144,-87.62675
13033,4,14,false,2,7,5,41.8916,-87.64835
TA1305000003,4,14,false,11,9,-2,41.89187,-87.62061
13022,4,14,false,106,85,-21,41.89227,-87.61205
TA1306000029,4,14,false,11,9,-2,41.89256,-87.61449
13045,4,14,false,7,12,5,41.89403,-87.62931
13016,4,14,false,6,11,5,41.89431,-87.62277
KA1503000041,4,14,false,8,7,-1,41.89452,-87.61798
TA1306000012,4,14,false,6,6,0,41.89475,-87.63438
KP1705001026,4,14,false,2,6,4,41.89483,-87.6323
13132,4,14,false,2,5,3,41.89573,-87.67718
15530,4,14,false,11,10,-1,41.89575,-87.62596
TA1305000020,4,14,false,2,5,3,41.89636,-87.65406
13303,4,14,false,7,3,-4,41.89672,-87.63088
13017,4,14,false,6,2,-4,41.89676,-87.6357
TA1307000061,4,14,false,9,3,-6,41.89745,-87.62873
13034,4,14,false,6,16,10,41.89754,-87.62352
15529,4,14,false,8,5,-3,41.89858,-87.62206
TA1307000128,4,14,false,9,12,3,41.89896,-87.6299
TA1306000011,4,14,false,6,1,-5,41.89994,-87.63443
13042,4,14,false,27,24,-3,41.90097,-87.62377
TA1307000070,4,14,false,6,2,-4,41.90133,-87.67742
KA1504000133,4,14,false,2,7,5,41.90234,-87.62773
TA1307000039,4,14,false,5,6,1,41.90294,-87.63137
KA1504000135,4,14,false,3,12,9,41.90319,-87.63439
13061,4,14,false,4,5,1,41.90342,-87.66779
TA1308000049,4,14,false,3,5,2,41.90672,-87.6349
13221,4,14,false,4,5,1,41.90765,-87.67254
TA1309000024,4,14,false,1,6,5,41.908,-87.63152
TA1305000041,4,14,false,4,7,3,41.9094,-87.67769
331,4,14,false,5,8,3,41.90965,-87.64812
TA1305000037,4,14,false,2,6,4,41.91018,-87.67003
TA1308000005,4,14,false,5,1,-4,41.91042,-87.68238
13154,4,14,false,6,3,-3,41.91054,-87.65312
LF-005,4,14,false,23,36,13,41.91172,-87.62681
13128,4,14,false,3,7,4,41.91197,-87.63197
TA1308000050,4,14,false,6,7,1,41.91211,-87.6347
13243,4,14,false,7,1,-6,41.91262,-87.6814
TA1306000032,4,14,false,5,2,-3,41.9137,-87.65285
13179,4,14,false,6,2,-4,41.9157,-87.63461
13146,4,14,false,6,8,2,41.91831,-87.63629
13193,4,14,false,10,5,-5,41.92182,-87.64412
LP-,4,14,false,8,8,0,41.92396,-87.63584
TA1309000019,4,14,false,8,7,-1,41.92586,-87.63897
TA1309000058,4,14,false,6,6,0,41.92591,-87.64927
TA1308000001,4,14,false,23,26,3,41.92627,-87.63086
13124,4,14,false,2,8,6,41.92675,-87.63444
TA1305000014,4,14,false,5,7,2,41.92956,-87.64313
13085,4,14,false,1,5,4,41.92958,-87.70789
TA1307000142,4,14,false,9,5,-4,41.93125,-87.64432
13276,4,14,false,5,5,0,41.93132,-87.63874
TA1309000039,4,14,false,11,13,2,41.93258,-87.63642
13294,4,14,false,5,4,-1,41.9326,-87.66595
TA1307000052,4,14,false,2,5,3,41.93628,-87.65266
TA1307000041,4,14,false,5,6,1,41.93669,-87.63683
13137,4,14,false,11,8,-3,41.9376,-87.6441
TA1309000042,4,14,false,7,5,-2,41.93937,-87.66836
13229,4,14,false,5,2,-3,41.93946,-87.66376
TA1308000019,4,14,false,7,2,-5,41.93973,-87.65886
13277,4,14,false,2,11,9,41.9401,-87.64546
TA1307000134,4,14,false,8,8,0,41.94016,-87.65303
TA1309000049,4,14,false,8,10,2,41.94077,-87.63919
TA1309000025,4,14,false,5,4,-1,41.94368,-87.64894
13235,4,14,false,8,7,-1,41.94814,-87.66396
13325,4,14,false,9,6,-3,41.94907,-87.64863
TA1307000126,4,14,false,3,9,6,41.94936,-87.65451
TA1307000150,4,14,false,6,2,-4,41.94945,-87.64646
TA1307000127,4,14,false,6,3,-3,41.9508,-87.65918
13323,4,14,false,1,7,6,41.95282,-87.65
TA1309000026,4,14,false,4,5,1,41.95601,-87.6802
TA1307000107,4,14,false,4,11,7,41.96164,-87.65464
TA1308000012,4,14,false,16,21,5,41.96398,-87.63818
KA1504000171,4,14,false,2,10,8,41.97161,-87.65016
KA1504000146,4,14,false,2,7,5,41.978,-87.66805
13109,4,14,false,5,4,-1,41.97835,-87.65976
KA1504000152,4,14,false,6,13,7,41.98403,-87.65231
15571,4,14,false,12,3,-9,41.99478,-87.66028
596,4,14,false,2,6,4,42.04822,-87.68348
E008,4,14,false,5,3,-2,42.05049,-87.67782
TA1309000011,4,14,true,5,4,-1,41.78873,-87.60131
KA1503000071,4,14,true,7,2,-5,41.79148,-87.59988
TA1308000009,4,14,true,9,10,1,41.79522,-87.58075
TA1309000037,4,14,true,1,8,7,41.79957,-87.59474
TA1307000129,4,14,true,5,2,-3,41.83104,-87.62683
13216,4,14,true,9,8,-1,41.83473,-87.62581
TA1309000055,4,14,true,10,1,-9,41.8382,-87.64514
TA1307000139,4,14,true,1,6,5,41.84205,-87.61698
15545,4,14,true,5,5,0,41.85627,-87.61334
13102,4,14,true,6,4,-2,41.85762,-87.61942
13150,4,14,true,5,7,2,41.85783,-87.62455
SL-012,4,14,true,3,8,5,41.86038,-87.62581
TA1307000124,4,14,true,6,4,-2,41.86411,-87.62372
TA1305000002,4,14,true,8,8,0,41.86721,-87.62597
KA1706005007,4,14,true,2,6,4,41.86749,-87.63219
SL-005,4,14,true,5,7,2,41.8679,-87.62304
13139,4,14,true,4,10,6,41.86893,-87.65913
13285,4,14,true,8,2,-6,41.86928,-87.67372
15550,4,14,true,6,4,-2,41.87024,-87.63947
TA1309000010,4,14,true,7,7,0,41.87074,-87.62574
TA1309000064,4,14,true,15,2,-13,41.87127,-87.67369
TA1307000130,4,14,true,7,6,-1,41.87178,-87.65103
TA1307000121,4,14,true,9,3,-6,41.87184,-87.64664
SL-008,4,14,true,7,12,5,41.87209,-87.62956
13332,4,14,true,10,9,-1,41.87219,-87.6615
SL-011,4,14,true,10,8,-2,41.87256,-87.63356
KA1504000104,4,14,true,17,4,-13,41.87296,-87.66912
13028,4,14,true,1,6,5,41.87475,-87.64981
624,4,14,true,4,6,2,41.87626,-87.62923
TA1305000035,4,14,true,2,9,7,41.87716,-87.62787
15539,4,14,true,4,8,4,41.87763,-87.64405
13158,4,14,true,1,8,7,41.87764,-87.64957
13157,4,14,true,1,5,4,41.87773,-87.6548
TA1309000004,4,14,true,18,6,-12,41.87811,-87.63184
TA1305000005,4,14,true,7,4,-3,41.87924,-87.62975
TA1309000008,4,14,true,5,3,-2,41.87933,-87.6355
KA1503000015,4,14,true,5,2,-3,41.87948,-87.6257
TA1309000007,4,14,true,7,3,-4,41.88022,-87.63526
WL-011,4,14,true,1,9,8,41.88034,-87.64273
13156,4,14,true,10,8,-2,41.88042,-87.65554
13300,4,14,true,9,4,-5,41.88097,-87.61675
TA1305000006,4,14,true,14,3,-11,41.88122,-87.6296
TA1307000120,4,14,true,7,12,5,41.88188,-87.64879
13341,4,14,true,3,9,6,41.88208,-87.63985
13036,4,14,true,5,6,1,41.8821,-87.62513
TA1305000032,4,14,true,5,6,1,41.88218,-87.64109
13006,4,14,true,6,5,-1,41.88268,-87.63252
WL-012,4,14,true,4,9,5,41.88337,-87.6412
13053,4,14,true,10,7,-3,41.88365,-87.64863
13001,4,14,true,6,4,-2,41.88397,-87.62459
TA1306000010,4,14,true,12,9,-3,41.88419,-87.62961
TA1305000030,4,14,true,9,8,-1,41.88459,-87.63178
15535,4,14,true,7,6,-1,41.8846,-87.64455
TA1305000029,4,14,true,10,6,-4,41.88466,-87.62787
13263,4,14,true,12,9,-3,41.88467,-87.61952
TA1306000015,4,14,true,6,6,0,41.88549,-87.65232
13021,4,14,true,5,4,-1,41.88559,-87.64184
TA1307000111,4,14,true,11,10,-1,41.88582,-87.63548
13073,4,14,true,1,5,4,41.88592,-87.66717
KA1503000012,4,14,true,7,10,3,41.88599,-87.63089
TA1305000011,4,14,true,6,14,8,41.886,-87.62418
15534,4,14,true,9,4,-5,41.88627,-87.61749
KA1503000064,4,14,true,4,5,1,41.88697,-87.61281
TA1305000022,4,14,true,8,5,-3,41.88817,-87.63656
TA1306000003,4,14,true,7,10,3,41.88867,-87.64442
KA1503000043,4,14,true,13,14,1,41.88918,-87.63851
13050,4,14,true,7,9,2,41.88919,-87.62775
TA1307000151,4,14,true,9,3,-6,41.88993,-87.63427
13430,4,14,true,7,8,1,41.89077,-87.63169
TA1306000013,4,14,true,5,6,1,41.89083,-87.61852
RN-,4,14,true,4,6,2,41.89102,-87.63546
TA1307000117,4,14,true,10,1,-9,41.89144,-87.62675
13033,4,14,true,4,6,2,41.8916,-87.64835
13194,4,14,true,2,10,8,41.8918,-87.65878
TA1305000003,4,14,true,6,7,1,41.89187,-87.62061
13022,4,14,true,10,11,1,41.89227,-87.61205
TA1306000029,4,14,true,6,6,0,41.89256,-87.61449
13265,4,14,true,9,7,-2,41.89383,-87.64172
13045,4,14,true,9,11,2,41.89403,-87.62931
13016,4,14,true,16,6,-10,41.89431,-87.62277
KA1503000041,4,14,true,10,4,-6,41.89452,-87.61798
TA1307000062,4,14,true,7,5,-2,41.89466,-87.63839
TA1306000012,4,14,true,7,9,2,41.89475,-87.63438
KP1705001026,4,14,true,6,2,-4,41.89483,-87.6323
15530,4,14,true,14,9,-5,41.89575,-87.62596
18003,4,14,true,6,8,2,41.89575,-87.62011
13247,4,14,true,5,1,-4,41.89597,-87.66775
TA1305000020,4,14,true,7,8,1,41.89636,-87.65406
13289,4,14,true,3,5,2,41.89638,-87.661
13303,4,14,true,5,7,2,41.89672,-87.63088
13034,4,14,true,6,3,-3,41.89754,-87.62352
TA1306000009,4,14,true,7,6,-1,41.89772,-87.64299
620,4,14,true,4,9,5,41.89817,-87.63754
15529,4,14,true,5,6,1,41.89858,-87.62206
TA1307000128,4,14,true,10,7,-3,41.89896,-87.6299
TA1306000011,4,14,true,5,6,1,41.89994,-87.63443
KA1504000116,4,14,true,6,3,-3,41.90023,-87.64299
13042,4,14,true,10,4,-6,41.90097,-87.62377
KA1504000133,4,14,true,3,5,2,41.90234,-87.62773
TA1307000039,4,14,true,13,16,3,41.90294,-87.63137
658,4,14,true,6,4,-2,41.903,-87.6838
TA1305000034,4,14,true,5,3,-2,41.90313,-87.67391
KA1504000135,4,14,true,6,11,5,41.90319,-87.63439
13061,4,14,true,8,5,-3,41.90342,-87.66779
TA1307000115,4,14,true,2,6,4,41.9046,-87.64056
TA1308000049,4,14,true,5,5,0,41.90672,-87.6349
KA1504000134,4,14,true,6,10,4,41.90687,-87.6262
13221,4,14,true,7,4,-3,41.90765,-87.67254
TA1309000024,4,14,true,6,9,3,41.908,-87.63152
331,4,14,true,5,7,2,41.90965,-87.64812
TA1305000037,4,14,true,5,2,-3,41.91018,-87.67003
TA1306000008,4,14,true,2,5,3,41.9102,-87.6435
13154,4,14,true,3,7,4,41.91054,-87.65312
13058,4,14,true,5,8,3,41.91059,-87.64942
LF-005,4,14,true,10,12,2,41.91172,-87.62681
TA1308000050,4,14,true,10,21,11,41.91211,-87.6347
TA1306000032,4,14,true,8,3,-5,41.9137,-87.65285
TA1307000166,4,14,true,5,2,-3,41.91386,-87.64877
13179,4,14,true,6,7,1,41.9157,-87.63461
TA1307000163,4,14,true,5,8,3,41.91821,-87.65696
13146,4,14,true,4,8,4,41.91831,-87.63629
13059,4,14,true,10,6,-4,41.91845,-87.65222
TA1309000033,4,14,true,5,6,1,41.92158,-87.65381
13193,4,14,true,3,10,7,41.92182,-87.64412
13191,4,14,true,4,5,1,41.92217,-87.63891
13084,4,14,true,5,3,-2,41.92268,-87.69715
LP-,4,14,true,4,5,1,41.92396,-87.63584
TA1307000001,4,14,true,5,12,7,41.92535,-87.66581
TA1306000026,4,14,true,2,10,8,41.92558,-87.65842
TA1306000016,4,14,true,5,4,-1,41.9256,-87.65371
TA1309000058,4,14,true,4,9,5,41.92591,-87.64927
TA1308000001,4,14,true,20,17,-3,41.92627,-87.63086
TA1309000023,4,14,true,4,6,2,41.9287,-87.65383
TA1309000061,4,14,true,4,5,1,41.92915,-87.64909
TA1305000014,4,14,true,5,4,-1,41.92956,-87.64313
TA1307000142,4,14,true,7,7,0,41.93125,-87.64432
TA1306000014,4,14,true,7,5,-2,41.93242,-87.65271
TA1309000039,4,14,true,10,6,-4,41.93258,-87.63642
TA1307000006,4,14,true,7,5,-2,41.93571,-87.6636
13269,4,14,true,7,2,-5,41.93609,-87.66983
TA1307000052,4,14,true,9,5,-4,41.93628,-87.65266
TA1307000136,4,14,true,3,5,2,41.9365,-87.64755
13137,4,14,true,9,14,5,41.9376,-87.6441
13229,4,14,true,3,5,2,41.93946,-87.66376
13277,4,14,true,5,5,0,41.9401,-87.64546
TA1307000134,4,14,true,6,2,-4,41.94016,-87.65303
TA1309000049,4,14,true,6,8,2,41.94077,-87.63919
TA1307000138,4,14,true,6,8,2,41.94334,-87.67094
TA1309000025,4,14,true,7,5,-2,41.94368,-87.64894
632,4,14,true,5,5,0,41.94453,-87.6547
13278,4,14,true,2,10,8,41.94553,-87.64644
13235,4,14,true,7,8,1,41.94814,-87.66396
13325,4,14,true,11,9,-2,41.94907,-87.64863
TA1307000150,4,14,true,5,4,-1,41.94945,-87.64646
13323,4,14,true,5,3,-2,41.95282,-87.65
TA1309000043,4,14,true,6,4,-2,41.95417,-87.66434
13063,4,14,true,6,6,0,41.95424,-87.65441
TA1308000022,4,14,true,7,8,1,41.95438,-87.64805
13379,4,14,true,8,7,-1,41.95786,-87.6495
639,4,14,true,5,5,0,41.96584,-87.64538
TA1307000140,4,14,true,4,6,2,41.96643,-87.68865
TA1309000014,4,14,true,5,6,1,41.96709,-87.66744
TA1309000066,4,14,true,8,7,-1,41.9691,-87.67423
KA1504000171,4,14,true,3,7,4,41.97161,-87.65016
KA1504000151,4,14,true,6,2,-4,41.98359,-87.66916
KA1504000152,4,14,true,6,6,0,41.98403,-87.65231
KA1504000175,4,14,true,2,6,4,42.00797,-87.66549
520,4,14,true,2,6,4,42.01597,-87.66859
TA1308000009,4,15,false,10,12,2,41.79522,-87.58075
TA1307000164,4,15,false,6,5,-1,41.79527,-87.59647
KA1503000059,4,15,false,5,5,0,41.79952,-87.58643
TA1309000037,4,15,false,5,4,-1,41.79957,-87.59474
TA1308000035,4,15,false,3,5,2,41.80944,-87.59188
KA1503000004,4,15,false,5,3,-2,41.83127,-87.6088
TA1307000048,4,15,false,5,10,5,41.83855,-87.60821
15546,4,15,false,6,4,-2,41.85416,-87.61916
15545,4,15,false,14,16,2,41.85627,-87.61334
13164,4,15,false,1,5,4,41.85818,-87.65648
SL-012,4,15,false,4,6,2,41.86038,-87.62581
TA1307000124,4,15,false,1,5,4,41.86411,-87.62372
13029,4,15,false,8,2,-6,41.86531,-87.6179
13431,4,15,false,13,7,-6,41.8661,-87.60728
TA1305000002,4,15,false,5,16,11,41.86721,-87.62597
15544,4,15,false,51,25,-26,41.86723,-87.61536
KA1706005007,4,15,false,11,3,-8,41.86749,-87.63219
SL-005,4,15,false,14,22,8,41.8679,-87.62304
TA1309000010,4,15,false,8,7,-1,41.87074,-87.62574
SL-008,4,15,false,4,5,1,41.87209,-87.62956
13332,4,15,false,5,4,-1,41.87219,-87.6615
623,4,15,false,3,8,5,41.87272,-87.62399
SL-007,4,15,false,2,6,4,41.87404,-87.6277
15541,4,15,false,28,28,0,41.8758,-87.62086
TA1305000009,4,15,false,7,3,-4,41.87593,-87.63068
TA1305000025,4,15,false,9,2,-7,41.87773,-87.63528
TA1309000002,4,15,false,4,10,6,41.87784,-87.62408
TA1305000005,4,15,false,5,2,-3,41.87924,-87.62975
TA1309000008,4,15,false,6,3,-3,41.87933,-87.6355
TA1309000007,4,15,false,10,1,-9,41.88022,-87.63526
13156,4,15,false,12,6,-6,41.88042,-87.65554
13300,4,15,false,30,41,11,41.88097,-87.61675
13008,4,15,false,40,54,14,41.88105,-87.62408
TA1305000006,4,15,false,9,4,-5,41.88122,-87.6296
TA1307000120,4,15,false,2,8,6,41.88188,-87.64879
TA1305000032,4,15,false,8,7,-1,41.88218,-87.64109
13409,4,15,false,3,5,2,41.8831,-87.6511
KA1503000072,4,15,false,5,2,-3,41.88317,-87.63693
WL-012,4,15,false,7,6,-1,41.88337,-87.6412
13053,4,15,false,7,7,0,41.88365,-87.64863
13001,4,15,false,28,11,-17,41.88397,-87.62459
TA1306000010,4,15,false,12,5,-7,41.88419,-87.62961
TA1305000030,4,15,false,11,9,-2,41.88459,-87.63178
TA1305000029,4,15,false,8,9,1,41.88466,-87.62787
13263,4,15,false,14,10,-4,41.88467,-87.61952
TA1306000015,4,15,false,10,6,-4,41.88549,-87.65232
13021,4,15,false,8,5,-3,41.88559,-87.64184
TA1307000111,4,15,false,7,5,-2,41.88582,-87.63548
KA1503000012,4,15,false,3,5,2,41.88599,-87.63089
TA1305000011,4,15,false,33,19,-14,41.886,-87.62418
15534,4,15,false,6,6,0,41.88627,-87.61749
TA1307000131,4,15,false,9,17,8,41.88688,-87.62606
KA1503000064,4,15,false,33,16,-17,41.88697,-87.61281
TA1305000022,4,15,false,9,6,-3,41.88817,-87.63656
KA1503000043,4,15,false,8,4,-4,41.88918,-87.63851
13050,4,15,false,12,3,-9,41.88919,-87.62775
TA1307000151,4,15,false,6,1,-5,41.88993,-87.63427
KA1503000044,4,15,false,9,3,-6,41.89018,-87.6262
13427,4,15,false,3,5,2,41.89054,-87.62205
13430,4,15,false,7,9,2,41.89077,-87.63169
TA1306000013,4,15,false,9,15,6,41.89083,-87.61852
RN-,4,15,false,3,6,3,41.89102,-87.63546
TA1307000117,4,15,false,6,11,5,41.89144,-87.62675
13033,4,15,false,10,4,-6,41.8916,-87.64835
13194,4,15,false,6,9,3,41.8918,-87.65878
TA1305000003,4,15,false,11,10,-1,41.89187,-87.62061
13022,4,15,false,87,69,-18,41.89227,-87.61205
TA1306000029,4,15,false,6,8,2,41.89256,-87.61449
13265,4,15,false,6,3,-3,41.89383,-87.64172
13045,4,15,false,10,9,-1,41.89403,-87.62931
13016,4,15,false,10,20,10,41.89431,-87.62277
KA1503000041,4,15,false,10,4,-6,41.89452,-87.61798
TA1307000062,4,15,false,2,5,3,41.89466,-87.63839
TA1306000012,4,15,false,7,9,2,41.89475,-87.63438
KP1705001026,4,15,false,6,4,-2,41.89483,-87.6323
15530,4,15,false,13,6,-7,41.89575,-87.62596
18003,4,15,false,7,3,-4,41.89575,-87.62011
13338,4,15,false,7,3,-4,41.89697,-87.62173
13034,4,15,false,10,16,6,41.89754,-87.62352
TA1306000009,4,15,false,2,7,5,41.89772,-87.64299
15529,4,15,false,7,17,10,41.89858,-87.62206
TA1307000128,4,15,false,3,13,10,41.89896,-87.6299
13042,4,15,false,30,44,14,41.90097,-87.62377
KA1504000133,4,15,false,8,3,-5,41.90234,-87.62773
TA1307000039,4,15,false,8,13,5,41.90294,-87.63137
KA1504000135,4,15,false,9,6,-3,41.90319,-87.63439
13061,4,15,false,6,4,-2,41.90342,-87.66779
KA1504000079,4,15,false,5,5,0,41.9035,-87.64334
TA1308000049,4,15,false,6,4,-2,41.90672,-87.6349
KA1504000134,4,15,false,7,1,-6,41.90687,-87.6262
13221,4,15,false,6,3,-3,41.90765,-87.67254
TA1309000024,4,15,false,5,11,6,41.908,-87.63152
TA1305000041,4,15,false,5,4,-1,41.9094,-87.67769
331,4,15,false,5,8,3,41.90965,-87.64812
TA1305000037,4,15,false,5,6,1,41.91018,-87.67003
13154,4,15,false,3,8,5,41.91054,-87.65312
13058,4,15,false,6,4,-2,41.91059,-87.64942
TA1307000038,4,15,false,5,4,-1,41.91138,-87.63868
LF-005,4,15,false,33,33,0,41.91172,-87.62681
13128,4,15,false,7,7,0,41.91197,-87.63197
TA1308000050,4,15,false,8,8,0,41.91211,-87.6347
TA1306000032,4,15,false,3,8,5,41.9137,-87.65285
13179,4,15,false,8,15,7,41.9157,-87.63461
13146,4,15,false,10,13,3,41.91831,-87.63629
13059,4,15,false,7,4,-3,41.91845,-87.65222
TA1309000030,4,15,false,6,1,-5,41.92077,-87.66372
TA1309000033,4,15,false,6,1,-5,41.92158,-87.65381
13193,4,15,false,1,7,6,41.92182,-87.64412
13191,4,15,false,3,5,2,41.92217,-87.63891
13084,4,15,false,6,11,5,41.92268,-87.69715
LP-,4,15,false,17,4,-13,41.92396,-87.63584
TA1306000026,4,15,false,8,2,-6,41.92558,-87.65842
TA1306000016,4,15,false,5,5,0,41.9256,-87.65371
TA1309000019,4,15,false,8,12,4,41.92586,-87.63897
TA1309000058,4,15,false,3,6,3,41.92591,-87.64927
TA1308000001,4,15,false,35,35,0,41.92627,-87.63086
TA1309000059,4,15,false,6,2,-4,41.92889,-87.65898
TA1309000061,4,15,false,5,1,-4,41.92915,-87.64909
TA1308000031,4,15,false,1,5,4,41.92946,-87.68417
13085,4,15,false,5,2,-3,41.92958,-87.70789
TA1307000142,4,15,false,12,5,-7,41.93125,-87.64432
13276,4,15,false,5,10,5,41.93132,-87.63874
TA1306000014,4,15,false,5,3,-2,41.93242,-87.65271
TA1309000039,4,15,false,14,13,-1,41.93258,-87.63642
TA1309000036,4,15,false,5,4,-1,41.93313,-87.64776
TA1307000041,4,15,false,3,9,6,41.93669,-87.63683
13137,4,15,false,10,18,8,41.9376,-87.6441
13229,4,15,false,4,5,1,41.93946,-87.66376
13277,4,15,false,3,5,2,41.9401,-87.64546
TA1307000134,4,15,false,5,5,0,41.94016,-87.65303
TA1309000049,4,15,false,8,13,5,41.94077,-87.63919
TA1307000138,4,15,false,5,4,-1,41.94334,-87.67094
TA1309000025,4,15,false,5,4,-1,41.94368,-87.64894
632,4,15,false,4,5,1,41.94453,-87.6547
13278,4,15,false,7,4,-3,41.94553,-87.64644
13325,4,15,false,11,3,-8,41.94907,-87.64863
TA1307000126,4,15,false,9,7,-2,41.94936,-87.65451
TA1307000150,4,15,false,6,7,1,41.94945,-87.64646
TA1307000127,4,15,false,6,5,-1,41.9508,-87.65918
13323,4,15,false,7,4,-3,41.95282,-87.65
13063,4,15,false,5,7,2,41.95424,-87.65441
TA1308000022,4,15,false,5,6,1,41.95438,-87.64805
TA1307000107,4,15,false,6,5,-1,41.96164,-87.65464
TA1308000012,4,15,false,17,11,-6,41.96398,-87.63818
13074,4,15,false,6,2,-4,41.96521,-87.6582
639,4,15,false,6,6,0,41.96584,-87.64538
TA1309000014,4,15,false,3,5,2,41.96709,-87.66744
TA1307000119,4,15,false,6,2,-4,41.96796,-87.65
TA1309000035,4,15,false,3,8,5,41.97335,-87.66785
KA1504000146,4,15,false,6,2,-4,41.978,-87.66805
KA1504000152,4,15,false,16,9,-7,41.98403,-87.65231
15571,4,15,false,10,7,-3,41.99478,-87.66028
TA1309000011,4,15,true,9,2,-7,41.78873,-87.60131
KA1503000071,4,15,true,10,1,-9,41.79148,-87.59988
KA1504000076,4,15,true,7,1,-6,41.7943,-87.60145
TA1309000037,4,15,true,4,8,4,41.79957,-87.59474
TA1307000129,4,15,true,6,3,-3,41.83104,-87.62683
13216,4,15,true,11,5,-6,41.83473,-87.62581
TA1307000139,4,15,true,5,4,-1,41.84205,-87.61698
TA1305000001,4,15,true,2,5,3,41.85262,-87.6265
15545,4,15,true,10,11,1,41.85627,-87.61334
13135,4,15,true,5,5,0,41.85753,-87.66157
13163,4,15,true,2,5,3,41.85808,-87.65108
SL-012,4,15,true,4,7,3,41.86038,-87.62581
TA1306000002,4,15,true,3,5,2,41.86238,-87.65108
TA1307000124,4,15,true,6,10,4,41.86411,-87.62372
WL-008,4,15,true,4,6,2,41.86712,-87.64108
TA1305000002,4,15,true,6,8,2,41.86721,-87.62597
15544,4,15,true,6,3,-3,41.86723,-87.61536
KA1706005007,4,15,true,3,6,3,41.86749,-87.63219
SL-005,4,15,true,6,6,0,41.8679,-87.62304
644,4,15,true,2,6,4,41.86859,-87.68625
13139,4,15,true,6,4,-2,41.86893,-87.65913
13285,4,15,true,11,6,-5,41.86928,-87.67372
13160,4,15,true,6,3,-3,41.86947,-87.65548
15550,4,15,true,5,4,-1,41.87024,-87.63947
TA1309000010,4,15,true,4,10,6,41.87074,-87.62574
TA1309000064,4,15,true,14,3,-11,41.87127,-87.67369
TA1307000130,4,15,true,8,3,-5,41.87178,-87.65103
TA1307000121,4,15,true,5,5,0,41.87184,-87.64664
SL-008,4,15,true,10,11,1,41.87209,-87.62956
13332,4,15,true,9,6,-3,41.87219,-87.6615
SL-011,4,15,true,4,5,1,41.87256,-87.63356
KA1504000104,4,15,true,28,2,-26,41.87296,-87.66912
TA1306000025,4,15,true,6,7,1,41.87464,-87.65703
SL-010,4,15,true,4,7,3,41.87501,-87.63309
TA1305000010,4,15,true,5,2,-3,41.87623,-87.62444
TA1305000035,4,15,true,5,5,0,41.87716,-87.62787
15539,4,15,true,1,5,4,41.87763,-87.64405
13158,4,15,true,11,5,-6,41.87764,-87.64957
13157,4,15,true,4,8,4,41.87773,-87.6548
TA1305000025,4,15,true,7,4,-3,41.87773,-87.63528
13206,4,15,true,5,1,-4,41.87794,-87.66201
TA1309000004,4,15,true,21,7,-14,41.87811,-87.63184
638,4,15,true,9,15,6,41.87827,-87.64078
TA1305000005,4,15,true,5,3,-2,41.87924,-87.62975
13011,4,15,true,7,14,7,41.87931,-87.63993
TA1309000008,4,15,true,7,6,-1,41.87933,-87.6355
KA1503000034,4,15,true,7,3,-4,41.87938,-87.63197
TA1309000007,4,15,true,23,7,-16,41.88022,-87.63526
WL-011,4,15,true,7,3,-4,41.88034,-87.64273
13300,4,15,true,3,11,8,41.88097,-87.61675
13008,4,15,true,2,6,4,41.88105,-87.62408
TA1305000006,4,15,true,14,6,-8,41.88122,-87.6296
13056,4,15,true,10,5,-5,41.88168,-87.63951
TA1307000120,4,15,true,12,13,1,41.88188,-87.64879
13341,4,15,true,7,17,10,41.88208,-87.63985
13036,4,15,true,10,5,-5,41.8821,-87.62513
TA1305000032,4,15,true,9,14,5,41.88218,-87.64109
13006,4,15,true,10,2,-8,41.88268,-87.63252
13353,4,15,true,7,8,1,41.88283,-87.6612
KA1503000072,4,15,true,10,3,-7,41.88317,-87.63693
WL-012,4,15,true,12,31,19,41.88337,-87.6412
13053,4,15,true,8,14,6,41.88365,-87.64863
13001,4,15,true,5,8,3,41.88397,-87.62459
18062,4,15,true,5,5,0,41.88412,-87.65427
TA1306000010,4,15,true,11,12,1,41.88419,-87.62961
TA1305000030,4,15,true,4,8,4,41.88459,-87.63178
15535,4,15,true,7,7,0,41.8846,-87.64455
TA1305000029,4,15,true,8,7,-1,41.88466,-87.62787
13263,4,15,true,7,9,2,41.88467,-87.61952
TA1306000015,4,15,true,8,7,-1,41.88549,-87.65232
13021,4,15,true,8,12,4,41.88559,-87.64184
TA1307000111,4,15,true,14,1,-13,41.88582,-87.63548
KA1503000012,4,15,true,14,5,-9,41.88599,-87.63089
TA1305000011,4,15,true,18,5,-13,41.886,-87.62418
15534,4,15,true,8,8,0,41.88627,-87.61749
13197,4,15,true,8,2,-6,41.8866,-87.65816
TA1308000029,4,15,true,12,6,-6,41.88673,-87.62225
KA1503000064,4,15,true,8,11,3,41.88697,-87.61281
TA1305000022,4,15,true,17,8,-9,41.88817,-87.63656
TA1306000003,4,15,true,6,8,2,41.88867,-87.64442
KA1503000043,4,15,true,16,13,-3,41.88918,-87.63851
13050,4,15,true,7,10,3,41.88919,-87.62775
15664,4,15,true,1,5,4,41.8895,-87.68821
TA1307000151,4,15,true,11,7,-4,41.88993,-87.63427
636,4,15,true,11,3,-8,41.88997,-87.63662
KA1503000044,4,15,true,7,4,-3,41.89018,-87.6262
13427,4,15,true,7,4,-3,41.89054,-87.62205
13430,4,15,true,5,7,2,41.89077,-87.63169
TA1306000013,4,15,true,9,12,3,41.89083,-87.61852
RN-,4,15,true,6,5,-1,41.89102,-87.63546
TA1308000006,4,15,true,8,1,-7,41.89128,-87.67686
TA1307000117,4,15,true,10,13,3,41.89144,-87.62675
13033,4,15,true,7,7,0,41.8916,-87.64835
13194,4,15,true,6,1,-5,41.8918,-87.65878
TA1305000003,4,15,true,5,5,0,41.89187,-87.62061
13022,4,15,true,15,11,-4,41.89227,-87.61205
TA1306000029,4,15,true,2,6,4,41.89256,-87.61449
13265,4,15,true,6,13,7,41.89383,-87.64172
13045,4,15,true,17,13,-4,41.89403,-87.62931
13016,4,15,true,32,12,-20,41.89431,-87.62277
KA1503000041,4,15,true,23,5,-18,41.89452,-87.61798
TA1307000062,4,15,true,8,7,-1,41.89466,-87.63839
TA1306000012,4,15,true,8,10,2,41.89475,-87.63438
KP1705001026,4,15,true,3,6,3,41.89483,-87.6323
13132,4,15,true,5,7,2,41.89573,-87.67718
15530,4,15,true,7,7,0,41.89575,-87.62596
18003,4,15,true,16,6,-10,41.89575,-87.62011
TA1305000020,4,15,true,5,8,3,41.89636,-87.65406
13289,4,15,true,7,8,1,41.89638,-87.661
13303,4,15,true,3,7,4,41.89672,-87.63088
13017,4,15,true,11,4,-7,41.89676,-87.6357
13338,4,15,true,20,4,-16,41.89697,-87.62173
TA1307000061,4,15,true,7,5,-2,41.89745,-87.62873
13034,4,15,true,6,1,-5,41.89754,-87.62352
TA1306000009,4,15,true,8,1,-7,41.89772,-87.64299
620,4,15,true,4,9,5,41.89817,-87.63754
15529,4,15,true,12,12,0,41.89858,-87.62206
TA1307000128,4,15,true,9,4,-5,41.89896,-87.6299
TA1306000011,4,15,true,6,4,-2,41.89994,-87.63443
KA1504000116,4,15,true,4,6,2,41.90023,-87.64299
13042,4,15,true,16,3,-13,41.90097,-87.62377
TA1307000070,4,15,true,1,5,4,41.90133,-87.67742
KA1504000133,4,15,true,3,11,8,41.90234,-87.62773
TA1307000039,4,15,true,14,20,6,41.90294,-87.63137
658,4,15,true,5,4,-1,41.903,-87.6838
TA1305000034,4,15,true,5,5,0,41.90313,-87.67391
KA1504000135,4,15,true,13,13,0,41.90319,-87.63439
13136,4,15,true,6,5,-1,41.90326,-87.67845
13061,4,15,true,5,3,-2,41.90342,-87.66779
KA1504000079,4,15,true,4,7,3,41.9035,-87.64334
TA1308000049,4,15,true,4,12,8,41.90672,-87.6349
KA1504000134,4,15,true,7,6,-1,41.90687,-87.6262
TA1309000024,4,15,true,16,15,-1,41.908,-87.63152
TA1305000041,4,15,true,1,9,8,41.9094,-87.67769
331,4,15,true,7,7,0,41.90965,-87.64812
TA1305000037,4,15,true,1,5,4,41.91018,-87.67003
13154,4,15,true,6,9,3,41.91054,-87.65312
TA1307000038,4,15,true,4,7,3,41.91138,-87.63868
LF-005,4,15,true,11,11,0,41.91172,-87.62681
13128,4,15,true,5,1,-4,41.91197,-87.63197
TA1308000050,4,15,true,11,20,9,41.91211,-87.6347
TA1306000032,4,15,true,7,7,0,41.9137,-87.65285
TA1307000166,4,15,true,8,5,-3,41.91386,-87.64877
13179,4,15,true,7,14,7,41.9157,-87.63461
13133,4,15,true,3,5,2,41.91598,-87.67733
13266,4,15,true,2,7,5,41.91774,-87.69142
TA1309000006,4,15,true,5,6,1,41.91809,-87.64375
13146,4,15,true,9,8,-1,41.91831,-87.63629
13059,4,15,true,5,6,1,41.91845,-87.65222
13192,4,15,true,6,7,1,41.91995,-87.64884
TA1309000030,4,15,true,7,5,-2,41.92077,-87.66372
13193,4,15,true,9,14,5,41.92182,-87.64412
13191,4,15,true,3,8,5,41.92217,-87.63891
13084,4,15,true,3,8,5,41.92268,-87.69715
TA1307000001,4,15,true,6,6,0,41.92535,-87.66581
TA1306000026,4,15,true,8,8,0,41.92558,-87.65842
TA1306000016,4,15,true,6,5,-1,41.9256,-87.65371
TA1309000019,4,15,true,10,13,3,41.92586,-87.63897
TA1309000058,4,15,true,8,4,-4,41.92591,-87.64927
TA1308000001,4,15,true,9,9,0,41.92627,-87.63086
13296,4,15,true,7,1,-6,41.92883,-87.66852
TA1309000061,4,15,true,4,5,1,41.92915,-87.64909
TA1305000014,4,15,true,11,10,-1,41.92956,-87.64313
13085,4,15,true,1,7,6,41.92958,-87.70789
TA1307000142,4,15,true,9,11,2,41.93125,-87.64432
13276,4,15,true,5,7,2,41.93132,-87.63874
TA1307000064,4,15,true,5,3,-2,41.93222,-87.65864
TA1306000014,4,15,true,4,11,7,41.93242,-87.65271
TA1309000039,4,15,true,5,6,1,41.93258,-87.63642
TA1309000036,4,15,true,7,5,-2,41.93313,-87.64776
TA1307000006,4,15,true,8,2,-6,41.93571,-87.6636
13269,4,15,true,2,6,4,41.93609,-87.66983
TA1307000052,4,15,true,10,8,-2,41.93628,-87.65266
TA1307000136,4,15,true,9,5,-4,41.9365,-87.64755
TA1307000041,4,15,true,5,14,9,41.93669,-87.63683
13137,4,15,true,14,10,-4,41.9376,-87.6441
TA1309000042,4,15,true,5,4,-1,41.93937,-87.66836
13277,4,15,true,6,9,3,41.9401,-87.64546
TA1307000134,4,15,true,6,8,2,41.94016,-87.65303
TA1309000049,4,15,true,13,11,-2,41.94077,-87.63919
TA1307000138,4,15,true,3,7,4,41.94334,-87.67094
TA1309000025,4,15,true,8,15,7,41.94368,-87.64894
13071,4,15,true,4,6,2,41.94373,-87.66401
632,4,15,true,3,9,6,41.94453,-87.6547
13278,4,15,true,9,15,6,41.94553,-87.64644
13235,4,15,true,7,7,0,41.94814,-87.66396
13325,4,15,true,10,8,-2,41.94907,-87.64863
TA1307000126,4,15,true,7,7,0,41.94936,-87.65451
TA1307000150,4,15,true,10,9,-1,41.94945,-87.64646
TA1307000127,4,15,true,3,6,3,41.9508,-87.65918
13323,4,15,true,11,5,-6,41.95282,-87.65
13063,4,15,true,8,11,3,41.95424,-87.65441
TA1308000022,4,15,true,2,6,4,41.95438,-87.64805
13379,4,15,true,8,7,-1,41.95786,-87.6495
TA1309000027,4,15,true,4,8,4,41.9585,-87.65499
13389,4,15,true,5,3,-2,41.961,-87.64958
KA1503000022,4,15,true,5,1,-4,41.96158,-87.66609
TA1307000107,4,15,true,6,5,-1,41.96164,-87.65464
TA1308000012,4,15,true,12,9,-3,41.96398,-87.63818
13074,4,15,true,8,6,-2,41.96521,-87.6582
TA1307000140,4,15,true,6,1,-5,41.96643,-87.68865
TA1309000014,4,15,true,3,5,2,41.96709,-87.66744
TA1307000158,4,15,true,6,1,-5,41.9671,-87.67904
TA1309000066,4,15,true,7,1,-6,41.9691,-87.67423
KA1504000171,4,15,true,2,6,4,41.97161,-87.65016
TA1309000035,4,15,true,6,2,-4,41.97335,-87.66785
13108,4,15,true,4,6,2,41.97379,-87.65971
KA1504000160,4,15,true,4,5,1,41.97564,-87.70143
KA1504000146,4,15,true,3,6,3,41.978,-87.66805
13109,4,15,true,6,3,-3,41.97835,-87.65976
KA1504000152,4,15,true,10,8,-2,41.98403,-87.65231
596,4,15,true,5,4,-1,42.04822,-87.68348
15491,4,16,false,4,8,4,41.78096,-87.57624
KA1503000071,4,16,false,7,2,-5,41.79148,-87.59988
KA1503000074,4,16,false,7,6,-1,41.79174,-87.58395
KA1504000076,4,16,false,5,4,-1,41.7943,-87.60145
TA1308000009,4,16,false,13,6,-7,41.79522,-87.58075
KA1503000059,4,16,false,2,5,3,41.79952,-87.58643
TA1309000037,4,16,false,3,7,4,41.79957,-87.59474
TA1307000048,4,16,false,16,9,-7,41.83855,-87.60821
15545,4,16,false,5,5,0,41.85627,-87.61334
13150,4,16,false,1,9,8,41.85783,-87.62455
13164,4,16,false,6,4,-2,41.85818,-87.65648
TA1307000124,4,16,false,9,6,-3,41.86411,-87.62372
13029,4,16,false,20,6,-14,41.86531,-87.6179
13431,4,16,false,8,2,-6,41.8661,-87.60728
TA1305000002,4,16,false,14,6,-8,41.86721,-87.62597
15544,4,16,false,53,11,-42,41.86723,-87.61536
KA1706005007,4,16,false,5,3,-2,41.86749,-87.63219
SL-005,4,16,false,18,15,-3,41.8679,-87.62304
13139,4,16,false,1,5,4,41.86893,-87.65913
15550,4,16,false,7,9,2,41.87024,-87.63947
TA1309000010,4,16,false,12,13,1,41.87074,-87.62574
SL-008,4,16,false,10,6,-4,41.87209,-87.62956
SL-011,4,16,false,7,3,-4,41.87256,-87.63356
623,4,16,false,13,19,6,41.87272,-87.62399
KA1504000104,4,16,false,7,1,-6,41.87296,-87.66912
SL-007,4,16,false,3,12,9,41.87404,-87.6277
SL-010,4,16,false,5,2,-3,41.87501,-87.63309
15541,4,16,false,32,14,-18,41.8758,-87.62086
TA1305000010,4,16,false,2,13,11,41.87623,-87.62444
TA1305000035,4,16,false,5,4,-1,41.87716,-87.62787
13138,4,16,false,6,3,-3,41.87723,-87.63941
15539,4,16,false,3,7,4,41.87763,-87.64405
13158,4,16,false,3,5,2,41.87764,-87.64957
13157,4,16,false,7,3,-4,41.87773,-87.6548
TA1305000025,4,16,false,14,3,-11,41.87773,-87.63528
TA1309000002,4,16,false,12,9,-3,41.87784,-87.62408
TA1309000004,4,16,false,8,4,-4,41.87811,-87.63184
638,4,16,false,5,7,2,41.87827,-87.64078
TA1305000005,4,16,false,6,3,-3,41.87924,-87.62975
13011,4,16,false,16,10,-6,41.87931,-87.63993
TA1309000008,4,16,false,2,11,9,41.87933,-87.6355
KA1503000034,4,16,false,5,1,-4,41.87938,-87.63197
KA1503000015,4,16,false,6,10,4,41.87948,-87.6257
TA1309000007,4,16,false,14,3,-11,41.88022,-87.63526
WL-011,4,16,false,10,5,-5,41.88034,-87.64273
13300,4,16,false,57,51,-6,41.88097,-87.61675
13008,4,16,false,21,28,7,41.88105,-87.62408
TA1305000006,4,16,false,12,10,-2,41.88122,-87.6296
13056,4,16,false,7,2,-5,41.88168,-87.63951
TA1307000120,4,16,false,14,19,5,41.88188,-87.64879
13341,4,16,false,14,7,-7,41.88208,-87.63985
13036,4,16,false,6,5,-1,41.8821,-87.62513
TA1305000032,4,16,false,15,7,-8,41.88218,-87.64109
13006,4,16,false,11,3,-8,41.88268,-87.63252
KA1503000072,4,16,false,5,1,-4,41.88317,-87.63693
WL-012,4,16,false,10,6,-4,41.88337,-87.6412
13053,4,16,false,6,9,3,41.88365,-87.64863
13001,4,16,false,9,10,1,41.88397,-87.62459
18062,4,16,false,5,3,-2,41.88412,-87.65427
TA1306000010,4,16,false,4,7,3,41.88419,-87.62961
TA1305000030,4,16,false,12,8,-4,41.88459,-87.63178
15535,4,16,false,9,6,-3,41.8846,-87.64455
TA1305000029,4,16,false,6,7,1,41.88466,-87.62787
13263,4,16,false,12,11,-1,41.88467,-87.61952
TA1306000015,4,16,false,12,9,-3,41.88549,-87.65232
13021,4,16,false,7,8,1,41.88559,-87.64184
TA1307000111,4,16,false,15,5,-10,41.88582,-87.63548
KA1503000012,4,16,false,15,11,-4,41.88599,-87.63089
TA1305000011,4,16,false,8,26,18,41.886,-87.62418
15534,4,16,false,3,5,2,41.88627,-87.61749
13197,4,16,false,6,1,-5,41.8866,-87.65816
TA1308000029,4,16,false,5,9,4,41.88673,-87.62225
TA1307000131,4,16,false,17,19,2,41.88688,-87.62606
KA1503000064,4,16,false,25,27,2,41.88697,-87.61281
TA1305000022,4,16,false,13,6,-7,41.88817,-87.63656
TA1306000003,4,16,false,20,6,-14,41.88867,-87.64442
KA1503000043,4,16,false,9,8,-1,41.88918,-87.63851
13050,4,16,false,10,11,1,41.88919,-87.62775
TA1307000151,4,16,false,8,8,0,41.88993,-87.63427
KA1503000044,4,16,false,5,2,-3,41.89018,-87.6262
13427,4,16,false,15,10,-5,41.89054,-87.62205
13430,4,16,false,9,8,-1,41.89077,-87.63169
TA1306000013,4,16,false,17,11,-6,41.89083,-87.61852
RN-,4,16,false,7,10,3,41.89102,-87.63546
13434,4,16,false,3,5,2,41.89108,-87.66663
TA1308000006,4,16,false,2,7,5,41.89128,-87.67686
TA1307000117,4,16,false,10,14,4,41.89144,-87.62675
13033,4,16,false,13,7,-6,41.8916,-87.64835
13194,4,16,false,4,9,5,41.8918,-87.65878
TA1305000003,4,16,false,5,9,4,41.89187,-87.62061
13022,4,16,false,116,107,-9,41.89227,-87.61205
TA1306000029,4,16,false,15,11,-4,41.89256,-87.61449
13265,4,16,false,8,10,2,41.89383,-87.64172
13045,4,16,false,17,11,-6,41.89403,-87.62931
13016,4,16,false,13,7,-6,41.89431,-87.62277
KA1503000041,4,16,false,11,4,-7,41.89452,-87.61798
TA1307000062,4,16,false,7,2,-5,41.89466,-87.63839
TA1306000012,4,16,false,12,15,3,41.89475,-87.63438
KP1705001026,4,16,false,2,11,9,41.89483,-87.6323
637,4,16,false,2,5,3,41.89563,-87.67209
15530,4,16,false,7,14,7,41.89575,-87.62596
TA1305000020,4,16,false,5,3,-2,41.89636,-87.65406
13303,4,16,false,9,7,-2,41.89672,-87.63088
13017,4,16,false,7,3,-4,41.89676,-87.6357
13338,4,16,false,8,8,0,41.89697,-87.62173
TA1307000061,4,16,false,3,6,3,41.89745,-87.62873
13034,4,16,false,6,3,-3,41.89754,-87.62352
620,4,16,false,12,3,-9,41.89817,-87.63754
15529,4,16,false,17,5,-12,41.89858,-87.62206
TA1307000128,4,16,false,12,14,2,41.89896,-87.6299
13290,4,16,false,4,5,1,41.90069,-87.66259
13042,4,16,false,39,35,-4,41.90097,-87.62377
KA1504000133,4,16,false,13,13,0,41.90234,-87.62773
TA1307000039,4,16,false,19,21,2,41.90294,-87.63137
TA1305000034,4,16,false,3,6,3,41.90313,-87.67391
KA1504000135,4,16,false,23,19,-4,41.90319,-87.63439
13061,4,16,false,11,15,4,41.90342,-87.66779
KA1504000079,4,16,false,2,10,8,41.9035,-87.64334
TA1307000115,4,16,false,4,9,5,41.9046,-87.64056
TA1308000049,4,16,false,8,13,5,41.90672,-87.6349
KA1504000134,4,16,false,7,4,-3,41.90687,-87.6262
13224,4,16,false,5,3,-2,41.90706,-87.66725
13221,4,16,false,10,10,0,41.90765,-87.67254
TA1309000024,4,16,false,10,1,-9,41.908,-87.63152
TA1305000041,4,16,false,6,4,-2,41.9094,-87.67769
331,4,16,false,14,4,-10,41.90965,-87.64812
TA1305000037,4,16,false,5,2,-3,41.91018,-87.67003
13154,4,16,false,4,6,2,41.91054,-87.65312
13058,4,16,false,4,6,2,41.91059,-87.64942
TA1307000038,4,16,false,5,11,6,41.91138,-87.63868
LF-005,4,16,false,36,40,4,41.91172,-87.62681
13128,4,16,false,7,14,7,41.91197,-87.63197
TA1308000050,4,16,false,6,21,15,41.91211,-87.6347
TA1306000032,4,16,false,7,2,-5,41.9137,-87.65285
13068,4,16,false,4,5,1,41.91554,-87.68703
13179,4,16,false,14,17,3,41.9157,-87.63461
13133,4,16,false,7,3,-4,41.91598,-87.67733
TA1305000039,4,16,false,3,6,3,41.9163,-87.66749
TA1307000163,4,16,false,4,6,2,41.91821,-87.65696
13146,4,16,false,10,9,-1,41.91831,-87.63629
13059,4,16,false,15,12,-3,41.91845,-87.65222
13192,4,16,false,7,10,3,41.91995,-87.64884
13288,4,16,false,6,3,-3,41.92008,-87.67788
TA1309000030,4,16,false,6,5,-1,41.92077,-87.66372
TA1309000033,4,16,false,5,7,2,41.92158,-87.65381
13193,4,16,false,9,14,5,41.92182,-87.64412
13191,4,16,false,8,6,-2,41.92217,-87.63891
13084,4,16,false,3,5,2,41.92268,-87.69715
LP-,4,16,false,17,14,-3,41.92396,-87.63584
TA1307000001,4,16,false,10,7,-3,41.92535,-87.66581
TA1306000026,4,16,false,8,5,-3,41.92558,-87.65842
TA1306000016,4,16,false,10,14,4,41.9256,-87.65371
TA1309000019,4,16,false,4,10,6,41.92586,-87.63897
TA1309000058,4,16,false,5,9,4,41.92591,-87.64927
TA1308000001,4,16,false,25,32,7,41.92627,-87.63086
13124,4,16,false,3,5,2,41.92675,-87.63444
TA1307000113,4,16,false,6,3,-3,41.92878,-87.66391
13296,4,16,false,7,6,-1,41.92883,-87.66852
TA1309000059,4,16,false,4,5,1,41.92889,-87.65898
TA1309000061,4,16,false,9,5,-4,41.92915,-87.64909
TA1308000031,4,16,false,6,6,0,41.92946,-87.68417
TA1305000014,4,16,false,13,4,-9,41.92956,-87.64313
TA1307000142,4,16,false,12,13,1,41.93125,-87.64432
13276,4,16,false,19,10,-9,41.93132,-87.63874
TA1306000014,4,16,false,8,5,-3,41.93242,-87.65271
TA1309000039,4,16,false,16,6,-10,41.93258,-87.63642
TA1309000036,4,16,false,4,5,1,41.93313,-87.64776
TA1307000006,4,16,false,6,5,-1,41.93571,-87.6636
TA1307000052,4,16,false,5,10,5,41.93628,-87.65266
TA1307000136,4,16,false,8,7,-1,41.9365,-87.64755
TA1307000041,4,16,false,15,16,1,41.93669,-87.63683
13137,4,16,false,13,11,-2,41.9376,-87.6441
TA1309000042,4,16,false,8,5,-3,41.93937,-87.66836
13229,4,16,false,9,5,-4,41.93946,-87.66376
TA1308000019,4,16,false,6,7,1,41.93973,-87.65886
13277,4,16,false,11,4,-7,41.9401,-87.64546
TA1307000134,4,16,false,8,6,-2,41.94016,-87.65303
TA1309000049,4,16,false,13,16,3,41.94077,-87.63919
TA1307000138,4,16,false,7,3,-4,41.94334,-87.67094
TA1309000025,4,16,false,9,7,-2,41.94368,-87.64894
13071,4,16,false,9,9,0,41.94373,-87.66401
632,4,16,false,14,11,-3,41.94453,-87.6547
13278,4,16,false,8,10,2,41.94553,-87.64644
13235,4,16,false,7,5,-2,41.94814,-87.66396
13325,4,16,false,5,9,4,41.94907,-87.64863
TA1307000126,4,16,false,3,6,3,41.94936,-87.65451
TA1307000150,4,16,false,7,10,3,41.94945,-87.64646
TA1307000127,4,16,false,2,5,3,41.9508,-87.65918
13323,4,16,false,6,6,0,41.95282,-87.65
13063,4,16,false,10,3,-7,41.95424,-87.65441
TA1308000022,4,16,false,6,10,4,41.95438,-87.64805
13379,4,16,false,6,4,-2,41.95786,-87.6495
TA1307000107,4,16,false,5,7,2,41.96164,-87.65464
TA1308000012,4,16,false,19,21,2,41.96398,-87.63818
13074,4,16,false,5,5,0,41.96521,-87.6582
639,4,16,false,5,6,1,41.96584,-87.64538
TA1307000140,4,16,false,3,6,3,41.96643,-87.68865
TA1309000014,4,16,false,8,1,-7,41.96709,-87.66744
TA1307000119,4,16,false,6,2,-4,41.96796,-87.65
TA1309000041,4,16,false,5,4,-1,41.96951,-87.65471
KA1504000171,4,16,false,8,6,-2,41.97161,-87.65016
TA1309000035,4,16,false,5,5,0,41.97335,-87.66785
KA1504000146,4,16,false,4,5,1,41.978,-87.66805
13109,4,16,false,5,7,2,41.97835,-87.65976
KA1504000151,4,16,false,6,8,2,41.98359,-87.66916
KA1504000152,4,16,false,11,9,-2,41.98403,-87.65231
15571,4,16,false,6,8,2,41.99478,-87.66028
RP-009,4,16,false,7,1,-6,42.00107,-87.66122
604,4,16,false,5,2,-3,42.05824,-87.67744
KA1503000014,4,16,true,5,4,-1,41.7851,-87.60108
TA1309000011,4,16,true,6,4,-2,41.78873,-87.60131
KA1503000071,4,16,true,3,8,5,41.79148,-87.59988
TA1308000009,4,16,true,5,8,3,41.79522,-87.58075
TA1309000037,4,16,true,8,4,-4,41.79957,-87.59474
KA1503000068,4,16,true,1,8,7,41.82878,-87.68062
TA1308000045,4,16,true,7,2,-5,41.83062,-87.64129
13216,4,16,true,9,11,2,41.83473,-87.62581
13215,4,16,true,2,5,3,41.83634,-87.6135
TA1309000055,4,16,true,2,9,7,41.8382,-87.64514
TA1308000036,4,16,true,4,6,2,41.83883,-87.62186
TA1307000005,4,16,true,8,4,-4,41.84569,-87.6225
TA1305000001,4,16,true,3,6,3,41.85262,-87.6265
15545,4,16,true,11,8,-3,41.85627,-87.61334
13102,4,16,true,7,9,2,41.85762,-87.61942
13150,4,16,true,11,8,-3,41.85783,-87.62455
13099,4,16,true,1,5,4,41.85784,-87.64627
13163,4,16,true,2,6,4,41.85808,-87.65108
SL-012,4,16,true,12,5,-7,41.86038,-87.62581
TA1306000002,4,16,true,4,11,7,41.86238,-87.65108
TA1307000124,4,16,true,4,13,9,41.86411,-87.62372
TA1309000001,4,16,true,2,9,7,41.86488,-87.64708
WL-008,4,16,true,8,3,-5,41.86712,-87.64108
TA1305000002,4,16,true,10,25,15,41.86721,-87.62597
15544,4,16,true,6,5,-1,41.86723,-87.61536
TA1305000017,4,16,true,5,2,-3,41.86734,-87.64863
KA1706005007,4,16,true,5,6,1,41.86749,-87.63219
SL-005,4,16,true,17,19,2,41.8679,-87.62304
644,4,16,true,7,4,-3,41.86859,-87.68625
13139,4,16,true,1,7,6,41.86893,-87.65913
13285,4,16,true,24,3,-21,41.86928,-87.67372
13160,4,16,true,9,4,-5,41.86947,-87.65548
TA1309000010,4,16,true,7,8,1,41.87074,-87.62574
SL-009,4,16,true,3,5,2,41.87081,-87.63121
TA1309000064,4,16,true,30,5,-25,41.87127,-87.67369
TA1307000130,4,16,true,12,10,-2,41.87178,-87.65103
TA1307000121,4,16,true,9,12,3,41.87184,-87.64664
SL-008,4,16,true,14,17,3,41.87209,-87.62956
13332,4,16,true,21,24,3,41.87219,-87.6615
SL-011,4,16,true,9,13,4,41.87256,-87.63356
KA1504000104,4,16,true,31,1,-30,41.87296,-87.66912
SL-007,4,16,true,3,7,4,41.87404,-87.6277
TA1306000025,4,16,true,8,4,-4,41.87464,-87.65703
15668,4,16,true,5,4,-1,41.87471,-87.68642
13028,4,16,true,10,5,-5,41.87475,-87.64981
13081,4,16,true,7,1,-6,41.87501,-87.67326
SL-010,4,16,true,5,10,5,41.87501,-87.63309
TA1305000009,4,16,true,3,10,7,41.87593,-87.63068
624,4,16,true,1,7,6,41.87626,-87.62923
TA1305000035,4,16,true,9,6,-3,41.87716,-87.62787
13138,4,16,true,13,5,-8,41.87723,-87.63941
15539,4,16,true,10,9,-1,41.87763,-87.64405
13158,4,16,true,11,22,11,41.87764,-87.64957
13157,4,16,true,12,3,-9,41.87773,-87.6548
TA1305000025,4,16,true,21,9,-12,41.87773,-87.63528
TA1309000004,4,16,true,28,10,-18,41.87811,-87.63184
638,4,16,true,27,17,-10,41.87827,-87.64078
TA1305000005,4,16,true,17,8,-9,41.87924,-87.62975
13011,4,16,true,17,37,20,41.87931,-87.63993
TA1309000008,4,16,true,19,2,-17,41.87933,-87.6355
KA1503000015,4,16,true,16,4,-12,41.87948,-87.6257
TA1309000007,4,16,true,47,1,-46,41.88022,-87.63526
WL-011,4,16,true,7,12,5,41.88034,-87.64273
13156,4,16,true,9,16,7,41.88042,-87.65554
13300,4,16,true,10,10,0,41.88097,-87.61675
13008,4,16,true,17,14,-3,41.88105,-87.62408
TA1305000006,4,16,true,36,8,-28,41.88122,-87.6296
13056,4,16,true,15,7,-8,41.88168,-87.63951
TA1307000120,4,16,true,15,19,4,41.88188,-87.64879
13341,4,16,true,17,14,-3,41.88208,-87.63985
13036,4,16,true,11,9,-2,41.8821,-87.62513
TA1305000032,4,16,true,25,27,2,41.88218,-87.64109
13006,4,16,true,12,5,-7,41.88268,-87.63252
13353,4,16,true,5,8,3,41.88283,-87.6612
654,4,16,true,2,5,3,41.88307,-87.65698
13409,4,16,true,11,6,-5,41.8831,-87.6511
KA1503000072,4,16,true,22,3,-19,41.88317,-87.63693
WL-012,4,16,true,19,47,28,41.88337,-87.6412
13053,4,16,true,15,7,-8,41.88365,-87.64863
13001,4,16,true,15,7,-8,41.88397,-87.62459
13155,4,16,true,5,5,0,41.88407,-87.65689
18062,4,16,true,7,8,1,41.88412,-87.65427
TA1306000010,4,16,true,21,10,-11,41.88419,-87.62961
TA1305000030,4,16,true,23,7,-16,41.88459,-87.63178
15535,4,16,true,11,2,-9,41.8846,-87.64455
TA1305000029,4,16,true,7,19,12,41.88466,-87.62787
13263,4,16,true,12,15,3,41.88467,-87.61952
TA1306000015,4,16,true,20,13,-7,41.88549,-87.65232
13021,4,16,true,24,15,-9,41.88559,-87.64184
TA1307000111,4,16,true,23,11,-12,41.88582,-87.63548
KA17018054,4,16,true,6,1,-5,41.88595,-87.67701
KA1503000012,4,16,true,10,9,-1,41.88599,-87.63089
TA1305000011,4,16,true,31,9,-22,41.886,-87.62418
15534,4,16,true,12,14,2,41.88627,-87.61749
13197,4,16,true,10,1,-9,41.8866,-87.65816
TA1308000029,4,16,true,10,11,1,41.88673,-87.62225
TA1307000131,4,16,true,12,6,-6,41.88688,-87.62606
KA1503000064,4,16,true,5,8,3,41.88697,-87.61281
TA1305000022,4,16,true,29,11,-18,41.88817,-87.63656
TA1306000003,4,16,true,15,19,4,41.88867,-87.64442
KA1503000043,4,16,true,32,43,11,41.88918,-87.63851
13050,4,16,true,17,13,-4,41.88919,-87.62775
13432,4,16,true,2,8,6,41.88989,-87.67149
TA1307000151,4,16,true,18,14,-4,41.88993,-87.63427
636,4,16,true,6,2,-4,41.88997,-87.63662
KA1503000044,4,16,true,11,2,-9,41.89018,-87.6262
13427,4,16,true,10,11,1,41.89054,-87.62205
13430,4,16,true,14,18,4,41.89077,-87.63169
TA1306000013,4,16,true,13,11,-2,41.89083,-87.61852
RN-,4,16,true,11,8,-3,41.89102,-87.63546
13434,4,16,true,2,8,6,41.89108,-87.66663
TA1308000006,4,16,true,9,6,-3,41.89128,-87.67686
TA1307000117,4,16,true,23,13,-10,41.89144,-87.62675
13033,4,16,true,12,18,6,41.8916,-87.64835
13194,4,16,true,4,9,5,41.8918,-87.65878
TA1305000003,4,16,true,16,12,-4,41.89187,-87.62061
13022,4,16,true,24,18,-6,41.89227,-87.61205
TA1306000029,4,16,true,16,15,-1,41.89256,-87.61449
13265,4,16,true,18,13,-5,41.89383,-87.64172
13045,4,16,true,17,17,0,41.89403,-87.62931
13016,4,16,true,47,9,-38,41.89431,-87.62277
KA1503000041,4,16,true,35,9,-26,41.89452,-87.61798
13196,4,16,true,5,4,-1,41.89455,-87.65345
TA1307000062,4,16,true,21,7,-14,41.89466,-87.63839
TA1306000012,4,16,true,22,15,-7,41.89475,-87.63438
KP1705001026,4,16,true,9,6,-3,41.89483,-87.6323
18058,4,16,true,1,5,4,41.8955,-87.68201
637,4,16,true,10,7,-3,41.89563,-87.67209
13132,4,16,true,6,12,6,41.89573,-87.67718
15530,4,16,true,15,16,1,41.89575,-87.62596
18003,4,16,true,16,5,-11,41.89575,-87.62011
13247,4,16,true,5,5,0,41.89597,-87.66775
TA1305000020,4,16,true,8,5,-3,41.89636,-87.65406
13289,4,16,true,6,15,9,41.89638,-87.661
13303,4,16,true,16,10,-6,41.89672,-87.63088
13017,4,16,true,12,15,3,41.89676,-87.6357
13338,4,16,true,23,7,-16,41.89697,-87.62173
TA1307000061,4,16,true,5,4,-1,41.89745,-87.62873
13034,4,16,true,11,1,-10,41.89754,-87.62352
TA1306000009,4,16,true,44,10,-34,41.89772,-87.64299
620,4,16,true,10,8,-2,41.89817,-87.63754
KA1504000103,4,16,true,2,7,5,41.89842,-87.68659
15529,4,16,true,17,10,-7,41.89858,-87.62206
TA1307000128,4,16,true,20,22,2,41.89896,-87.6299
TA1306000011,4,16,true,14,7,-7,41.89994,-87.63443
KA1504000116,4,16,true,4,10,6,41.90023,-87.64299
13290,4,16,true,2,7,5,41.90069,-87.66259
13042,4,16,true,26,16,-10,41.90097,-87.62377
TA1307000070,4,16,true,6,8,2,41.90133,-87.67742
KA1504000133,4,16,true,15,17,2,41.90234,-87.62773
13241,4,16,true,2,5,3,41.9029,-87.68731
TA1306000006,4,16,true,4,6,2,41.90292,-87.63772
TA1307000039,4,16,true,20,42,22,41.90294,-87.63137
13256,4,16,true,3,7,4,41.90302,-87.69749
TA1305000034,4,16,true,6,4,-2,41.90313,-87.67391
KA1504000135,4,16,true,18,24,6,41.90319,-87.63439
13061,4,16,true,16,15,-1,41.90342,-87.66779
KA1504000079,4,16,true,16,10,-6,41.9035,-87.64334
TA1307000115,4,16,true,12,7,-5,41.9046,-87.64056
TA1308000049,4,16,true,13,18,5,41.90672,-87.6349
KA1504000134,4,16,true,7,13,6,41.90687,-87.6262
13224,4,16,true,6,12,6,41.90706,-87.66725
TA1307000143,4,16,true,2,6,4,41.90762,-87.63854
13221,4,16,true,6,7,1,41.90765,-87.67254
TA1309000024,4,16,true,6,15,9,41.908,-87.63152
TA1305000041,4,16,true,17,6,-11,41.9094,-87.67769
331,4,16,true,8,15,7,41.90965,-87.64812
TA1305000037,4,16,true,8,14,6,41.91018,-87.67003
13258,4,16,true,2,5,3,41.91043,-87.69718
13154,4,16,true,11,13,2,41.91054,-87.65312
13058,4,16,true,9,9,0,41.91059,-87.64942
TA1307000038,4,16,true,6,8,2,41.91138,-87.63868
LF-005,4,16,true,16,23,7,41.91172,-87.62681
13128,4,16,true,5,12,7,41.91197,-87.63197
TA1308000050,4,16,true,21,20,-1,41.91211,-87.6347
TA1306000032,4,16,true,9,12,3,41.9137,-87.65285
TA1307000166,4,16,true,7,8,1,41.91386,-87.64877
18017,4,16,true,4,7,3,41.91416,-87.71676
18067,4,16,true,10,14,4,41.9146,-87.66796
13068,4,16,true,9,2,-7,41.91554,-87.68703
13179,4,16,true,14,16,2,41.9157,-87.63461
13133,4,16,true,7,8,1,41.91598,-87.67733
TA1305000039,4,16,true,5,4,-1,41.9163,-87.66749
TA1309000006,4,16,true,7,9,2,41.91809,-87.64375
TA1307000163,4,16,true,3,12,9,41.91821,-87.65696
13146,4,16,true,12,15,3,41.91831,-87.63629
13059,4,16,true,11,7,-4,41.91845,-87.65222
13192,4,16,true,7,9,2,41.91995,-87.64884
13288,4,16,true,3,6,3,41.92008,-87.67788
TA1309000030,4,16,true,8,7,-1,41.92077,-87.66372
TA1309000033,4,16,true,7,14,7,41.92158,-87.65381
13193,4,16,true,17,21,4,41.92182,-87.64412
13191,4,16,true,13,9,-4,41.92217,-87.63891
13084,4,16,true,5,6,1,41.92268,-87.69715
TA1307000001,4,16,true,8,2,-6,41.92535,-87.66581
TA1306000026,4,16,true,8,10,2,41.92558,-87.65842
TA1306000016,4,16,true,11,9,-2,41.9256,-87.65371
TA1309000019,4,16,true,8,20,12,41.92586,-87.63897
TA1309000058,4,16,true,8,16,8,41.92591,-87.64927
TA1308000001,4,16,true,18,17,-1,41.92627,-87.63086
TA1309000023,4,16,true,9,4,-5,41.9287,-87.65383
TA1307000113,4,16,true,6,3,-3,41.92878,-87.66391
13296,4,16,true,1,6,5,41.92883,-87.66852
TA1309000059,4,16,true,5,4,-1,41.92889,-87.65898
TA1309000061,4,16,true,10,5,-5,41.92915,-87.64909
TA1305000014,4,16,true,8,22,14,41.92956,-87.64313
13085,4,16,true,10,7,-3,41.92958,-87.70789
TA1307000142,4,16,true,15,8,-7,41.93125,-87.64432
13276,4,16,true,10,12,2,41.93132,-87.63874
13271,4,16,true,1,5,4,41.93192,-87.67784
TA1307000064,4,16,true,6,6,0,41.93222,-87.65864
TA1306000014,4,16,true,6,5,-1,41.93242,-87.65271
TA1309000039,4,16,true,10,19,9,41.93258,-87.63642
13294,4,16,true,11,8,-3,41.9326,-87.66595
TA1309000036,4,16,true,7,8,1,41.93313,-87.64776
13269,4,16,true,2,5,3,41.93609,-87.66983
TA1307000052,4,16,true,11,6,-5,41.93628,-87.65266
TA1307000136,4,16,true,16,11,-5,41.9365,-87.64755
TA1307000041,4,16,true,16,15,-1,41.93669,-87.63683
13137,4,16,true,23,16,-7,41.9376,-87.6441
TA1309000042,4,16,true,1,9,8,41.93937,-87.66836
13229,4,16,true,6,2,-4,41.93946,-87.66376
TA1308000019,4,16,true,12,6,-6,41.93973,-87.65886
13277,4,16,true,5,11,6,41.9401,-87.64546
TA1307000134,4,16,true,10,4,-6,41.94016,-87.65303
TA1309000049,4,16,true,10,10,0,41.94077,-87.63919
TA1307000138,4,16,true,5,4,-1,41.94334,-87.67094
TA1309000025,4,16,true,9,20,11,41.94368,-87.64894
13071,4,16,true,11,15,4,41.94373,-87.66401
632,4,16,true,6,5,-1,41.94453,-87.6547
13278,4,16,true,14,12,-2,41.94553,-87.64644
13235,4,16,true,14,11,-3,41.94814,-87.66396
13253,4,16,true,6,6,0,41.9488,-87.67527
13325,4,16,true,13,14,1,41.94907,-87.64863
TA1307000126,4,16,true,6,6,0,41.94936,-87.65451
TA1307000150,4,16,true,11,11,0,41.94945,-87.64646
13319,4,16,true,5,6,1,41.95069,-87.6687
TA1307000127,4,16,true,6,5,-1,41.9508,-87.65918
13323,4,16,true,6,7,1,41.95282,-87.65
13063,4,16,true,10,6,-4,41.95424,-87.65441
KA1504000158,4,16,true,1,5,4,41.95432,-87.68607
TA1308000022,4,16,true,13,14,1,41.95438,-87.64805
TA1309000026,4,16,true,1,7,6,41.95601,-87.6802
13379,4,16,true,8,5,-3,41.95786,-87.6495
TA1309000027,4,16,true,5,10,5,41.9585,-87.65499
13389,4,16,true,7,4,-3,41.961,-87.64958
TA1307000144,4,16,true,7,1,-6,41.96142,-87.6762
KA1503000022,4,16,true,2,6,4,41.96158,-87.66609
TA1307000107,4,16,true,13,8,-5,41.96164,-87.65464
TA1308000012,4,16,true,11,12,1,41.96398,-87.63818
13074,4,16,true,5,3,-2,41.96521,-87.6582
639,4,16,true,3,5,2,41.96584,-87.64538
TA1309000014,4,16,true,3,6,3,41.96709,-87.66744
TA1307000158,4,16,true,6,5,-1,41.9671,-87.67904
TA1307000119,4,16,true,3,7,4,41.96796,-87.65
TA1309000066,4,16,true,7,7,0,41.9691,-87.67423
KA1504000171,4,16,true,6,2,-4,41.97161,-87.65016
TA1309000035,4,16,true,7,4,-3,41.97335,-87.66785
13108,4,16,true,2,7,5,41.97379,-87.65971
KA1504000146,4,16,true,5,5,0,41.978,-87.66805
13109,4,16,true,5,4,-1,41.97835,-87.65976
KA1504000152,4,16,true,5,11,6,41.98403,-87.65231
15578,4,16,true,8,4,-4,41.98405,-87.66027
15575,4,16,true,6,4,-2,41.98975,-87.66014
15571,4,16,true,4,5,1,41.99478,-87.66028
KA1504000162,4,16,true,5,3,-2,42.00907,-87.67422
520,4,16,true,5,2,-3,42.01597,-87.66859
661,4,16,true,5,5,0,42.05704,-87.68657
KA1503000070,4,17,false,3,7,4,41.78794,-87.58831
TA1309000011,4,17,false,5,1,-4,41.78873,-87.60131
TA1308000009,4,17,false,9,5,-4,41.79522,-87.58075
TA1309000037,4,17,false,5,4,-1,41.79957,-87.59474
15445,4,17,false,1,5,4,41.83453,-87.63183
TA1307000048,4,17,false,2,13,11,41.83855,-87.60821
13075,4,17,false,2,8,6,41.8531,-87.63192
15545,4,17,false,11,18,7,41.85627,-87.61334
13135,4,17,false,2,6,4,41.85753,-87.66157
13150,4,17,false,8,6,-2,41.85783,-87.62455
13163,4,17,false,6,5,-1,41.85808,-87.65108
13164,4,17,false,7,3,-4,41.85818,-87.65648
SL-012,4,17,false,7,4,-3,41.86038,-87.62581
TA1307000124,4,17,false,10,4,-6,41.86411,-87.62372
TA1309000001,4,17,false,6,1,-5,41.86488,-87.64708
13029,4,17,false,16,5,-11,41.86531,-87.6179
13431,4,17,false,9,9,0,41.8661,-87.60728
TA1305000002,4,17,false,21,14,-7,41.86721,-87.62597
15544,4,17,false,22,18,-4,41.86723,-87.61536
SL-005,4,17,false,28,28,0,41.8679,-87.62304
TA1309000010,4,17,false,28,11,-17,41.87074,-87.62574
SL-008,4,17,false,17,15,-2,41.87209,-87.62956
13332,4,17,false,5,5,0,41.87219,-87.6615
SL-011,4,17,false,13,8,-5,41.87256,-87.63356
623,4,17,false,8,11,3,41.87272,-87.62399
13028,4,17,false,3,6,3,41.87475,-87.64981
15541,4,17,false,23,27,4,41.8758,-87.62086
TA1305000010,4,17,false,6,6,0,41.87623,-87.62444
624,4,17,false,5,5,0,41.87626,-87.62923
13158,4,17,false,16,9,-7,41.87764,-87.64957
13157,4,17,false,7,7,0,41.87773,-87.6548
TA1309000002,4,17,false,13,6,-7,41.87784,-87.62408
TA1309000004,4,17,false,6,7,1,41.87811,-87.63184
638,4,17,false,6,6,0,41.87827,-87.64078
TA1305000005,4,17,false,7,3,-4,41.87924,-87.62975
13011,4,17,false,5,7,2,41.87931,-87.63993
TA1309000008,4,17,false,10,6,-4,41.87933,-87.6355
KA1503000015,4,17,false,11,1,-10,41.87948,-87.6257
TA1309000007,4,17,false,17,5,-12,41.88022,-87.63526
WL-011,4,17,false,6,6,0,41.88034,-87.64273
13156,4,17,false,5,4,-1,41.88042,-87.65554
13300,4,17,false,55,48,-7,41.88097,-87.61675
13008,4,17,false,31,42,11,41.88105,-87.62408
TA1305000006,4,17,false,14,7,-7,41.88122,-87.6296
13056,4,17,false,7,4,-3,41.88168,-87.63951
TA1307000120,4,17,false,18,22,4,41.88188,-87.64879
13341,4,17,false,13,15,2,41.88208,-87.63985
13036,4,17,false,6,3,-3,41.8821,-87.62513
TA1305000032,4,17,false,14,13,-1,41.88218,-87.64109
13006,4,17,false,6,3,-3,41.88268,-87.63252
13353,4,17,false,1,5,4,41.88283,-87.6612
13409,4,17,false,5,6,1,41.8831,-87.6511
KA1503000072,4,17,false,9,4,-5,41.88317,-87.63693
WL-012,4,17,false,17,5,-12,41.88337,-87.6412
13053,4,17,false,4,8,4,41.88365,-87.64863
13001,4,17,false,23,13,-10,41.88397,-87.62459
13155,4,17,false,3,5,2,41.88407,-87.65689
18062,4,17,false,1,6,5,41.88412,-87.65427
TA1306000010,4,17,false,11,6,-5,41.88419,-87.62961
TA1305000030,4,17,false,22,6,-16,41.88459,-87.63178
15535,4,17,false,4,10,6,41.8846,-87.64455
TA1305000029,4,17,false,17,14,-3,41.88466,-87.62787
13263,4,17,false,16,11,-5,41.88467,-87.61952
TA1306000015,4,17,false,20,25,5,41.88549,-87.65232
13021,4,17,false,16,12,-4,41.88559,-87.64184
TA1307000111,4,17,false,18,3,-15,41.88582,-87.63548
13073,4,17,false,1,6,5,41.88592,-87.66717
KA1503000012,4,17,false,10,14,4,41.88599,-87.63089
TA1305000011,4,17,false,16,25,9,41.886,-87.62418
15534,4,17,false,5,7,2,41.88627,-87.61749
13197,4,17,false,7,5,-2,41.8866,-87.65816
TA1308000029,4,17,false,5,10,5,41.88673,-87.62225
TA1307000131,4,17,false,8,16,8,41.88688,-87.62606
KA1503000064,4,17,false,42,36,-6,41.88697,-87.61281
TA1305000022,4,17,false,22,8,-14,41.88817,-87.63656
TA1306000003,4,17,false,20,9,-11,41.88867,-87.64442
KA1503000043,4,17,false,23,14,-9,41.88918,-87.63851
13050,4,17,false,20,22,2,41.88919,-87.62775
TA1307000151,4,17,false,16,12,-4,41.88993,-87.63427
636,4,17,false,3,7,4,41.88997,-87.63662
KA1503000044,4,17,false,8,6,-2,41.89018,-87.6262
13427,4,17,false,14,3,-11,41.89054,-87.62205
13430,4,17,false,14,24,10,41.89077,-87.63169
TA1306000013,4,17,false,14,21,7,41.89083,-87.61852
RN-,4,17,false,19,12,-7,41.89102,-87.63546
13434,4,17,false,4,5,1,41.89108,-87.66663
TA1308000006,4,17,false,7,5,-2,41.89128,-87.67686
TA1307000117,4,17,false,25,32,7,41.89144,-87.62675
13033,4,17,false,18,26,8,41.8916,-87.64835
13194,4,17,false,9,7,-2,41.8918,-87.65878
TA1305000003,4,17,false,14,20,6,41.89187,-87.62061
13022,4,17,false,94,137,43,41.89227,-87.61205
TA1306000029,4,17,false,24,18,-6,41.89256,-87.61449
13265,4,17,false,11,15,4,41.89383,-87.64172
13045,4,17,false,17,20,3,41.89403,-87.62931
13016,4,17,false,11,16,5,41.89431,-87.62277
KA1503000041,4,17,false,7,5,-2,41.89452,-87.61798
13196,4,17,false,8,7,-1,41.89455,-87.65345
TA1307000062,4,17,false,9,3,-6,41.89466,-87.63839
TA1306000012,4,17,false,25,25,0,41.89475,-87.63438
KP1705001026,4,17,false,14,11,-3,41.89483,-87.6323
637,4,17,false,2,6,4,41.89563,-87.67209
13132,4,17,false,6,7,1,41.89573,-87.67718
15530,4,17,false,14,20,6,41.89575,-87.62596
13247,4,17,false,4,8,4,41.89597,-87.66775
TA1305000020,4,17,false,4,10,6,41.89636,-87.65406
13289,4,17,false,4,6,2,41.89638,-87.661
13303,4,17,false,11,12,1,41.89672,-87.63088
13017,4,17,false,9,6,-3,41.89676,-87.6357
TA1307000061,4,17,false,7,5,-2,41.89745,-87.62873
TA1306000009,4,17,false,18,5,-13,41.89772,-87.64299
620,4,17,false,2,6,4,41.89817,-87.63754
15529,4,17,false,15,10,-5,41.89858,-87.62206
TA1307000128,4,17,false,20,15,-5,41.89896,-87.6299
657,4,17,false,7,1,-6,41.89918,-87.6722
13248,4,17,false,6,2,-4,41.89964,-87.66788
TA1306000011,4,17,false,6,5,-1,41.89994,-87.63443
KA1504000116,4,17,false,6,3,-3,41.90023,-87.64299
17660,4,17,false,7,6,-1,41.90036,-87.69671
13042,4,17,false,56,66,10,41.90097,-87.62377
TA1307000070,4,17,false,7,6,-1,41.90133,-87.67742
KA1504000133,4,17,false,12,10,-2,41.90234,-87.62773
TA1306000006,4,17,false,3,9,6,41.90292,-87.63772
TA1307000039,4,17,false,26,29,3,41.90294,-87.63137
TA1305000034,4,17,false,12,11,-1,41.90313,-87.67391
KA1504000135,4,17,false,29,32,3,41.90319,-87.63439
13136,4,17,false,2,5,3,41.90326,-87.67845
13061,4,17,false,12,10,-2,41.90342,-87.66779
KA1504000079,4,17,false,12,8,-4,41.9035,-87.64334
TA1307000115,4,17,false,4,7,3,41.9046,-87.64056
TA1308000049,4,17,false,17,17,0,41.90672,-87.6349
KA1504000134,4,17,false,12,23,11,41.90687,-87.6262
13224,4,17,false,12,5,-7,41.90706,-87.66725
TA1307000143,4,17,false,10,2,-8,41.90762,-87.63854
13221,4,17,false,16,13,-3,41.90765,-87.67254
TA1309000024,4,17,false,17,16,-1,41.908,-87.63152
TA1305000041,4,17,false,13,14,1,41.9094,-87.67769
331,4,17,false,17,12,-5,41.90965,-87.64812
TA1305000037,4,17,false,8,7,-1,41.91018,-87.67003
13257,4,17,false,3,7,4,41.91054,-87.68956
13154,4,17,false,2,8,6,41.91054,-87.65312
13058,4,17,false,8,4,-4,41.91059,-87.64942
TA1307000038,4,17,false,12,12,0,41.91138,-87.63868
LF-005,4,17,false,60,93,33,41.91172,-87.62681
13128,4,17,false,3,18,15,41.91197,-87.63197
TA1308000050,4,17,false,26,30,4,41.91211,-87.6347
13243,4,17,false,13,6,-7,41.91262,-87.6814
TA1309000032,4,17,false,5,1,-4,41.91293,-87.66417
TA1306000032,4,17,false,15,4,-11,41.9137,-87.65285
TA1307000166,4,17,false,6,3,-3,41.91386,-87.64877
18067,4,17,false,7,1,-6,41.9146,-87.66796
TA1306000007,4,17,false,6,3,-3,41.91469,-87.64333
13068,4,17,false,10,2,-8,41.91554,-87.68703
13179,4,17,false,17,35,18,41.9157,-87.63461
13133,4,17,false,6,9,3,41.91598,-87.67733
TA1305000039,4,17,false,14,6,-8,41.9163,-87.66749
15651,4,17,false,11,6,-5,41.91752,-87.70181
13266,4,17,false,11,8,-3,41.91774,-87.69142
TA1309000029,4,17,false,5,3,-2,41.9178,-87.68245
TA1309000006,4,17,false,6,7,1,41.91809,-87.64375
TA1307000163,4,17,false,7,6,-1,41.91821,-87.65696
13146,4,17,false,22,22,0,41.91831,-87.63629
13059,4,17,false,20,10,-10,41.91845,-87.65222
13259,4,17,false,4,9,5,41.91852,-87.69744
13192,4,17,false,11,20,9,41.91995,-87.64884
13242,4,17,false,4,6,2,41.92021,-87.69266
TA1309000030,4,17,false,3,12,9,41.92077,-87.66372
TA1309000033,4,17,false,13,15,2,41.92158,-87.65381
13193,4,17,false,22,31,9,41.92182,-87.64412
13191,4,17,false,15,10,-5,41.92217,-87.63891
13084,4,17,false,8,7,-1,41.92268,-87.69715
LP-,4,17,false,12,6,-6,41.92396,-87.63584
TA1307000001,4,17,false,14,8,-6,41.92535,-87.66581
TA1306000026,4,17,false,9,7,-2,41.92558,-87.65842
TA1306000016,4,17,false,15,17,2,41.9256,-87.65371
TA1309000019,4,17,false,28,21,-7,41.92586,-87.63897
TA1309000058,4,17,false,20,14,-6,41.92591,-87.64927
TA1308000001,4,17,false,29,26,-3,41.92627,-87.63086
13124,4,17,false,5,13,8,41.92675,-87.63444
TA1309000023,4,17,false,21,11,-10,41.9287,-87.65383
TA1307000113,4,17,false,11,3,-8,41.92878,-87.66391
13296,4,17,false,11,5,-6,41.92883,-87.66852
TA1309000059,4,17,false,7,1,-6,41.92889,-87.65898
TA1309000061,4,17,false,21,10,-11,41.92915,-87.64909
TA1305000014,4,17,false,17,25,8,41.92956,-87.64313
13085,4,17,false,8,9,1,41.92958,-87.70789
TA1307000142,4,17,false,16,9,-7,41.93125,-87.64432
13276,4,17,false,13,19,6,41.93132,-87.63874
TA1307000064,4,17,false,10,5,-5,41.93222,-87.65864
TA1306000014,4,17,false,13,16,3,41.93242,-87.65271
TA1309000039,4,17,false,20,26,6,41.93258,-87.63642
13294,4,17,false,8,5,-3,41.9326,-87.66595
TA1309000036,4,17,false,6,1,-5,41.93313,-87.64776
TA1307000006,4,17,false,10,5,-5,41.93571,-87.6636
13268,4,17,false,1,10,9,41.93588,-87.67843
13269,4,17,false,1,5,4,41.93609,-87.66983
TA1307000052,4,17,false,19,15,-4,41.93628,-87.65266
TA1307000136,4,17,false,15,11,-4,41.9365,-87.64755
TA1307000041,4,17,false,25,19,-6,41.93669,-87.63683
13137,4,17,false,25,16,-9,41.9376,-87.6441
15642,4,17,false,2,7,5,41.93843,-87.69801
TA1309000042,4,17,false,4,5,1,41.93937,-87.66836
13229,4,17,false,14,13,-1,41.93946,-87.66376
TA1308000019,4,17,false,12,11,-1,41.93973,-87.65886
13277,4,17,false,9,13,4,41.9401,-87.64546
TA1307000134,4,17,false,27,9,-18,41.94016,-87.65303
TA1309000049,4,17,false,7,20,13,41.94077,-87.63919
TA1307000138,4,17,false,7,5,-2,41.94334,-87.67094
TA1309000025,4,17,false,23,11,-12,41.94368,-87.64894
13071,4,17,false,10,8,-2,41.94373,-87.66401
632,4,17,false,9,10,1,41.94453,-87.6547
13278,4,17,false,9,14,5,41.94553,-87.64644
13235,4,17,false,8,3,-5,41.94814,-87.66396
13325,4,17,false,14,8,-6,41.94907,-87.64863
TA1307000126,4,17,false,19,13,-6,41.94936,-87.65451
TA1307000150,4,17,false,17,20,3,41.94945,-87.64646
13319,4,17,false,5,5,0,41.95069,-87.6687
TA1307000127,4,17,false,12,7,-5,41.9508,-87.65918
13323,4,17,false,14,3,-11,41.95282,-87.65
13063,4,17,false,8,14,6,41.95424,-87.65441
TA1308000022,4,17,false,8,6,-2,41.95438,-87.64805
TA1309000026,4,17,false,5,5,0,41.95601,-87.6802
13379,4,17,false,9,8,-1,41.95786,-87.6495
TA1309000027,4,17,false,7,2,-5,41.9585,-87.65499
13389,4,17,false,10,11,1,41.961,-87.64958
KA1503000022,4,17,false,5,1,-4,41.96158,-87.66609
TA1307000107,4,17,false,10,8,-2,41.96164,-87.65464
TA1308000012,4,17,false,22,24,2,41.96398,-87.63818
13074,4,17,false,9,2,-7,41.96521,-87.6582
639,4,17,false,6,5,-1,41.96584,-87.64538
TA1309000014,4,17,false,4,6,2,41.96709,-87.66744
TA1307000119,4,17,false,3,8,5,41.96796,-87.65
TA1309000066,4,17,false,12,8,-4,41.9691,-87.67423
KA1504000171,4,17,false,10,11,1,41.97161,-87.65016
KA1504000146,4,17,false,1,8,7,41.978,-87.66805
KA1504000151,4,17,false,2,5,3,41.98359,-87.66916
KA1504000152,4,17,false,17,9,-8,41.98403,-87.65231
15578,4,17,false,3,6,3,41.98405,-87.66027
15571,4,17,false,6,7,1,41.99478,-87.66028
660,4,17,false,5,1,-4,42.00458,-87.66143
E002,4,17,false,5,5,0,42.03256,-87.67912
596,4,17,false,5,4,-1,42.04822,-87.68348
KA1503000014,4,17,true,5,1,-4,41.7851,-87.60108
TA1309000011,4,17,true,5,1,-4,41.78873,-87.60131
KA1503000071,4,17,true,6,4,-2,41.79148,-87.59988
TA1309000063,4,17,true,5,8,3,41.79325,-87.5878
TA1308000009,4,17,true,7,10,3,41.79522,-87.58075
TA1307000164,4,17,true,6,5,-1,41.79527,-87.59647
TA1309000037,4,17,true,5,10,5,41.79957,-87.59474
KA1503000007,4,17,true,2,5,3,41.80242,-87.58689
13216,4,17,true,14,6,-8,41.83473,-87.62581
13217,4,17,true,2,10,8,41.83488,-87.61792
13215,4,17,true,3,5,2,41.83634,-87.6135
TA1309000055,4,17,true,3,6,3,41.8382,-87.64514
TA1307000048,4,17,true,4,6,2,41.83855,-87.60821
TA1308000036,4,17,true,2,8,6,41.83883,-87.62186
TA1307000139,4,17,true,9,4,-5,41.84205,-87.61698
TA1307000153,4,17,true,4,6,2,41.84358,-87.64538
13075,4,17,true,4,8,4,41.8531,-87.63192
15545,4,17,true,17,18,1,41.85627,-87.61334
SL-006,4,17,true,5,3,-2,41.8568,-87.63387
13135,4,17,true,5,9,4,41.85753,-87.66157
13102,4,17,true,7,18,11,41.85762,-87.61942
13150,4,17,true,7,9,2,41.85783,-87.62455
13099,4,17,true,5,1,-4,41.85784,-87.64627
TA1307000159,4,17,true,2,5,3,41.8579,-87.6687
13163,4,17,true,4,5,1,41.85808,-87.65108
13164,4,17,true,5,6,1,41.85818,-87.65648
SL-012,4,17,true,10,7,-3,41.86038,-87.62581
TA1306000002,4,17,true,6,5,-1,41.86238,-87.65108
TA1307000124,4,17,true,12,16,4,41.86411,-87.62372
TA1309000001,4,17,true,6,8,2,41.86488,-87.64708
13431,4,17,true,2,14,12,41.8661,-87.60728
WL-008,4,17,true,5,9,4,41.86712,-87.64108
TA1305000002,4,17,true,18,17,-1,41.86721,-87.62597
15544,4,17,true,6,6,0,41.86723,-87.61536
KA1706005007,4,17,true,7,9,2,41.86749,-87.63219
SL-005,4,17,true,16,23,7,41.8679,-87.62304
13139,4,17,true,11,4,-7,41.86893,-87.65913
13285,4,17,true,16,1,-15,41.86928,-87.67372
13160,4,17,true,12,14,2,41.86947,-87.65548
15550,4,17,true,2,8,6,41.87024,-87.63947
TA1309000010,4,17,true,17,27,10,41.87074,-87.62574
SL-009,4,17,true,6,8,2,41.87081,-87.63121
TA1309000064,4,17,true,16,6,-10,41.87127,-87.67369
TA1307000130,4,17,true,9,10,1,41.87178,-87.65103
TA1307000121,4,17,true,9,15,6,41.87184,-87.64664
SL-008,4,17,true,16,20,4,41.87209,-87.62956
13332,4,17,true,16,8,-8,41.87219,-87.6615
SL-011,4,17,true,7,15,8,41.87256,-87.63356
623,4,17,true,6,4,-2,41.87272,-87.62399
KA1504000104,4,17,true,18,1,-17,41.87296,-87.66912
SL-007,4,17,true,5,4,-1,41.87404,-87.6277
13028,4,17,true,6,10,4,41.87475,-87.64981
13081,4,17,true,5,1,-4,41.87501,-87.67326
SL-010,4,17,true,12,19,7,41.87501,-87.63309
TA1305000009,4,17,true,9,7,-2,41.87593,-87.63068
624,4,17,true,9,3,-6,41.87626,-87.62923
TA1305000035,4,17,true,16,3,-13,41.87716,-87.62787
13138,4,17,true,21,5,-16,41.87723,-87.63941
15539,4,17,true,10,8,-2,41.87763,-87.64405
13158,4,17,true,13,24,11,41.87764,-87.64957
13157,4,17,true,11,25,14,41.87773,-87.6548
TA1305000025,4,17,true,37,14,-23,41.87773,-87.63528
TA1309000002,4,17,true,9,4,-5,41.87784,-87.62408
13206,4,17,true,9,7,-2,41.87794,-87.66201
TA1309000004,4,17,true,42,5,-37,41.87811,-87.63184
638,4,17,true,22,15,-7,41.87827,-87.64078
TA1305000005,4,17,true,26,6,-20,41.87924,-87.62975
13011,4,17,true,23,32,9,41.87931,-87.63993
TA1309000008,4,17,true,11,3,-8,41.87933,-87.6355
KA1503000034,4,17,true,16,1,-15,41.87938,-87.63197
KA1503000015,4,17,true,12,3,-9,41.87948,-87.6257
TA1309000007,4,17,true,29,3,-26,41.88022,-87.63526
WL-011,4,17,true,13,9,-4,41.88034,-87.64273
13156,4,17,true,11,19,8,41.88042,-87.65554
13300,4,17,true,8,24,16,41.88097,-87.61675
13008,4,17,true,20,10,-10,41.88105,-87.62408
TA1305000006,4,17,true,49,11,-38,41.88122,-87.6296
13056,4,17,true,23,11,-12,41.88168,-87.63951
TA1307000120,4,17,true,18,35,17,41.88188,-87.64879
13341,4,17,true,29,14,-15,41.88208,-87.63985
13036,4,17,true,7,6,-1,41.8821,-87.62513
TA1305000032,4,17,true,41,30,-11,41.88218,-87.64109
13006,4,17,true,20,4,-16,41.88268,-87.63252
13353,4,17,true,4,5,1,41.88283,-87.6612
654,4,17,true,3,8,5,41.88307,-87.65698
13409,4,17,true,9,14,5,41.8831,-87.6511
KA1503000072,4,17,true,25,4,-21,41.88317,-87.63693
WL-012,4,17,true,34,35,1,41.88337,-87.6412
13053,4,17,true,16,19,3,41.88365,-87.64863
13001,4,17,true,23,15,-8,41.88397,-87.62459
13155,4,17,true,12,8,-4,41.88407,-87.65689
18062,4,17,true,11,5,-6,41.88412,-87.65427
TA1306000010,4,17,true,52,14,-38,41.88419,-87.62961
TA1305000030,4,17,true,56,8,-48,41.88459,-87.63178
15535,4,17,true,15,14,-1,41.8846,-87.64455
TA1305000029,4,17,true,23,11,-12,41.88466,-87.62787
13263,4,17,true,24,17,-7,41.88467,-87.61952
TA1306000015,4,17,true,19,26,7,41.88549,-87.65232
13021,4,17,true,34,25,-9,41.88559,-87.64184
TA1307000111,4,17,true,34,10,-24,41.88582,-87.63548
13073,4,17,true,5,2,-3,41.88592,-87.66717
KA1503000012,4,17,true,25,8,-17,41.88599,-87.63089
TA1305000011,4,17,true,41,14,-27,41.886,-87.62418
15534,4,17,true,13,12,-1,41.88627,-87.61749
13197,4,17,true,11,7,-4,41.8866,-87.65816
TA1308000029,4,17,true,13,7,-6,41.88673,-87.62225
TA1307000131,4,17,true,16,8,-8,41.88688,-87.62606
KA1503000064,4,17,true,11,19,8,41.88697,-87.61281
TA1305000022,4,17,true,44,19,-25,41.88817,-87.63656
TA1306000003,4,17,true,26,27,1,41.88867,-87.64442
KA1503000043,4,17,true,49,47,-2,41.88918,-87.63851
13050,4,17,true,35,15,-20,41.88919,-87.62775
15664,4,17,true,3,8,5,41.8895,-87.68821
13432,4,17,true,8,3,-5,41.88989,-87.67149
TA1307000151,4,17,true,55,31,-24,41.88993,-87.63427
636,4,17,true,9,9,0,41.88997,-87.63662
KA1503000044,4,17,true,7,10,3,41.89018,-87.6262
13427,4,17,true,16,11,-5,41.89054,-87.62205
13430,4,17,true,17,23,6,41.89077,-87.63169
TA1306000013,4,17,true,22,23,1,41.89083,-87.61852
RN-,4,17,true,18,15,-3,41.89102,-87.63546
13434,4,17,true,3,6,3,41.89108,-87.66663
TA1308000006,4,17,true,9,6,-3,41.89128,-87.67686
TA1307000117,4,17,true,33,37,4,41.89144,-87.62675
13033,4,17,true,19,20,1,41.8916,-87.64835
13194,4,17,true,9,8,-1,41.8918,-87.65878
TA1305000003,4,17,true,25,22,-3,41.89187,-87.62061
13022,4,17,true,22,20,-2,41.89227,-87.61205
TA1306000029,4,17,true,23,23,0,41.89256,-87.61449
13265,4,17,true,24,30,6,41.89383,-87.64172
13045,4,17,true,34,41,7,41.89403,-87.62931
13016,4,17,true,52,10,-42,41.89431,-87.62277
KA1503000041,4,17,true,30,17,-13,41.89452,-87.61798
13196,4,17,true,12,19,7,41.89455,-87.65345
TA1307000062,4,17,true,17,10,-7,41.89466,-87.63839
TA1306000012,4,17,true,41,33,-8,41.89475,-87.63438
KP1705001026,4,17,true,13,17,4,41.89483,-87.6323
637,4,17,true,9,11,2,41.89563,-87.67209
13132,4,17,true,10,14,4,41.89573,-87.67718
15530,4,17,true,21,19,-2,41.89575,-87.62596
18003,4,17,true,13,6,-7,41.89575,-87.62011
13247,4,17,true,7,14,7,41.89597,-87.66775
TA1305000020,4,17,true,12,19,7,41.89636,-87.65406
13289,4,17,true,5,14,9,41.89638,-87.661
13303,4,17,true,15,14,-1,41.89672,-87.63088
13017,4,17,true,23,14,-9,41.89676,-87.6357
13338,4,17,true,7,6,-1,41.89697,-87.62173
TA1307000061,4,17,true,9,7,-2,41.89745,-87.62873
13034,4,17,true,22,7,-15,41.89754,-87.62352
TA1306000009,4,17,true,39,16,-23,41.89772,-87.64299
620,4,17,true,15,9,-6,41.89817,-87.63754
KA1504000103,4,17,true,4,7,3,41.89842,-87.68659
15529,4,17,true,28,20,-8,41.89858,-87.62206
TA1307000128,4,17,true,23,29,6,41.89896,-87.6299
657,4,17,true,3,6,3,41.89918,-87.6722
13248,4,17,true,3,16,13,41.89964,-87.66788
TA1306000011,4,17,true,11,13,2,41.89994,-87.63443
KA1504000116,4,17,true,12,15,3,41.90023,-87.64299
17660,4,17,true,10,3,-7,41.90036,-87.69671
13290,4,17,true,13,10,-3,41.90069,-87.66259
13042,4,17,true,33,27,-6,41.90097,-87.62377
TA1307000070,4,17,true,9,11,2,41.90133,-87.67742
KA1504000133,4,17,true,13,24,11,41.90234,-87.62773
13241,4,17,true,8,3,-5,41.9029,-87.68731
TA1306000006,4,17,true,7,12,5,41.90292,-87.63772
TA1307000039,4,17,true,44,66,22,41.90294,-87.63137
658,4,17,true,8,4,-4,41.903,-87.6838
13256,4,17,true,5,6,1,41.90302,-87.69749
TA1305000034,4,17,true,10,6,-4,41.90313,-87.67391
KA1504000135,4,17,true,34,51,17,41.90319,-87.63439
13136,4,17,true,11,11,0,41.90326,-87.67845
13061,4,17,true,28,22,-6,41.90342,-87.66779
KA1504000079,4,17,true,8,16,8,41.9035,-87.64334
TA1307000115,4,17,true,11,10,-1,41.9046,-87.64056
TA1308000049,4,17,true,10,37,27,41.90672,-87.6349
KA1504000134,4,17,true,9,17,8,41.90687,-87.6262
13224,4,17,true,17,15,-2,41.90706,-87.66725
TA1307000143,4,17,true,6,8,2,41.90762,-87.63854
13221,4,17,true,16,15,-1,41.90765,-87.67254
13245,4,17,true,5,6,1,41.90777,-87.68586
TA1309000024,4,17,true,19,35,16,41.908,-87.63152
TA1305000041,4,17,true,17,19,2,41.9094,-87.67769
331,4,17,true,17,22,5,41.90965,-87.64812
TA1305000037,4,17,true,13,13,0,41.91018,-87.67003
TA1306000008,4,17,true,8,9,1,41.9102,-87.6435
TA1308000005,4,17,true,6,6,0,41.91042,-87.68238
13154,4,17,true,14,19,5,41.91054,-87.65312
13058,4,17,true,8,13,5,41.91059,-87.64942
TA1307000038,4,17,true,20,22,2,41.91138,-87.63868
LF-005,4,17,true,33,62,29,41.91172,-87.62681
13128,4,17,true,8,16,8,41.91197,-87.63197
TA1308000050,4,17,true,39,44,5,41.91211,-87.6347
13243,4,17,true,12,20,8,41.91262,-87.6814
TA1309000032,4,17,true,7,5,-2,41.91293,-87.66417
TA1306000032,4,17,true,17,21,4,41.9137,-87.65285
TA1307000166,4,17,true,13,14,1,41.91386,-87.64877
15655,4,17,true,7,9,2,41.91401,-87.70514
18017,4,17,true,2,5,3,41.91416,-87.71676
18067,4,17,true,16,16,0,41.9146,-87.66796
13068,4,17,true,5,11,6,41.91554,-87.68703
13179,4,17,true,30,30,0,41.9157,-87.63461
13133,4,17,true,7,13,6,41.91598,-87.67733
TA1305000039,4,17,true,9,8,-1,41.9163,-87.66749
15650,4,17,true,2,5,3,41.91711,-87.71023
15651,4,17,true,6,4,-2,41.91752,-87.70181
13266,4,17,true,3,7,4,41.91774,-87.69142
TA1309000029,4,17,true,2,5,3,41.9178,-87.68245
TA1309000006,4,17,true,12,13,1,41.91809,-87.64375
TA1307000163,4,17,true,14,17,3,41.91821,-87.65696
13146,4,17,true,25,39,14,41.91831,-87.63629
13059,4,17,true,19,29,10,41.91845,-87.65222
13192,4,17,true,18,25,7,41.91995,-87.64884
13288,4,17,true,7,9,2,41.92008,-87.67788
13242,4,17,true,3,8,5,41.92021,-87.69266
TA1309000030,4,17,true,7,12,5,41.92077,-87.66372
13292,4,17,true,1,8,7,41.92152,-87.70733
TA1309000033,4,17,true,14,15,1,41.92158,-87.65381
13193,4,17,true,24,30,6,41.92182,-87.64412
13191,4,17,true,12,12,0,41.92217,-87.63891
13084,4,17,true,8,9,1,41.92268,-87.69715
LP-,4,17,true,9,11,2,41.92396,-87.63584
15648,4,17,true,5,4,-1,41.92464,-87.68931
TA1307000001,4,17,true,12,15,3,41.92535,-87.66581
TA1306000026,4,17,true,23,20,-3,41.92558,-87.65842
TA1306000016,4,17,true,21,20,-1,41.9256,-87.65371
TA1309000019,4,17,true,24,16,-8,41.92586,-87.63897
TA1309000058,4,17,true,23,31,8,41.92591,-87.64927
TA1308000001,4,17,true,41,41,0,41.92627,-87.63086
15646,4,17,true,5,8,3,41.92668,-87.6977
TA1309000023,4,17,true,11,16,5,41.9287,-87.65383
TA1307000113,4,17,true,6,12,6,41.92878,-87.66391
13296,4,17,true,6,3,-3,41.92883,-87.66852
TA1309000059,4,17,true,6,6,0,41.92889,-87.65898
TA1309000061,4,17,true,14,25,11,41.92915,-87.64909
TA1305000014,4,17,true,22,20,-2,41.92956,-87.64313
13085,4,17,true,6,3,-3,41.92958,-87.70789
TA1307000142,4,17,true,15,17,2,41.93125,-87.64432
13276,4,17,true,17,19,2,41.93132,-87.63874
13271,4,17,true,8,8,0,41.93192,-87.67784
TA1307000064,4,17,true,31,14,-17,41.93222,-87.65864
TA1306000014,4,17,true,21,13,-8,41.93242,-87.65271
TA1309000039,4,17,true,25,29,4,41.93258,-87.63642
13294,4,17,true,7,8,1,41.9326,-87.66595
TA1309000036,4,17,true,19,20,1,41.93313,-87.64776
TA1307000006,4,17,true,8,11,3,41.93571,-87.6636
13268,4,17,true,5,9,4,41.93588,-87.67843
13269,4,17,true,4,16,12,41.93609,-87.66983
TA1307000052,4,17,true,29,18,-11,41.93628,-87.65266
TA1307000136,4,17,true,18,17,-1,41.9365,-87.64755
TA1307000041,4,17,true,20,28,8,41.93669,-87.63683
13137,4,17,true,21,34,13,41.9376,-87.6441
15642,4,17,true,5,1,-4,41.93843,-87.69801
TA1309000042,4,17,true,8,9,1,41.93937,-87.66836
13229,4,17,true,9,7,-2,41.93946,-87.66376
TA1308000019,4,17,true,19,13,-6,41.93973,-87.65886
13277,4,17,true,17,9,-8,41.9401,-87.64546
TA1307000134,4,17,true,19,14,-5,41.94016,-87.65303
TA1309000049,4,17,true,21,16,-5,41.94077,-87.63919
TA1307000138,4,17,true,15,14,-1,41.94334,-87.67094
TA1309000025,4,17,true,21,20,-1,41.94368,-87.64894
13071,4,17,true,21,17,-4,41.94373,-87.66401
632,4,17,true,9,10,1,41.94453,-87.6547
13278,4,17,true,19,17,-2,41.94553,-87.64644
KA1504000143,4,17,true,7,9,2,41.94664,-87.68337
13235,4,17,true,10,15,5,41.94814,-87.66396
13253,4,17,true,2,6,4,41.9488,-87.67527
13325,4,17,true,15,19,4,41.94907,-87.64863
TA1307000126,4,17,true,6,9,3,41.94936,-87.65451
TA1307000150,4,17,true,18,31,13,41.94945,-87.64646
13319,4,17,true,13,13,0,41.95069,-87.6687
TA1307000127,4,17,true,6,10,4,41.9508,-87.65918
13323,4,17,true,12,3,-9,41.95282,-87.65
13063,4,17,true,11,11,0,41.95424,-87.65441
KA1504000158,4,17,true,2,5,3,41.95432,-87.68607
TA1308000022,4,17,true,20,7,-13,41.95438,-87.64805
TA1307000149,4,17,true,19,7,-12,41.95467,-87.67392
TA1309000026,4,17,true,7,1,-6,41.95601,-87.6802
TA1308000047,4,17,true,5,2,-3,41.95709,-87.6642
13379,4,17,true,13,13,0,41.95786,-87.6495
TA1309000018,4,17,true,5,1,-4,41.95791,-87.67357
TA1309000027,4,17,true,12,6,-6,41.9585,-87.65499
13389,4,17,true,13,12,-1,41.961,-87.64958
TA1307000144,4,17,true,8,4,-4,41.96142,-87.6762
KA1503000022,4,17,true,5,7,2,41.96158,-87.66609
TA1307000107,4,17,true,12,17,5,41.96164,-87.65464
TA1308000012,4,17,true,10,13,3,41.96398,-87.63818
13074,4,17,true,7,6,-1,41.96521,-87.6582
639,4,17,true,16,18,2,41.96584,-87.64538
TA1307000140,4,17,true,3,10,7,41.96643,-87.68865
TA1309000014,4,17,true,5,10,5,41.96709,-87.66744
TA1307000158,4,17,true,8,4,-4,41.9671,-87.67904
TA1307000119,4,17,true,11,4,-7,41.96796,-87.65
TA1308000021,4,17,true,4,8,4,41.96883,-87.65765
TA1309000066,4,17,true,13,7,-6,41.9691,-87.67423
TA1309000041,4,17,true,7,7,0,41.96951,-87.65471
KA1504000171,4,17,true,11,11,0,41.97161,-87.65016
TA1309000035,4,17,true,10,12,2,41.97335,-87.66785
13108,4,17,true,11,6,-5,41.97379,-87.65971
KA1504000078,4,17,true,2,5,3,41.97491,-87.69258
KA1504000146,4,17,true,6,5,-1,41.978,-87.66805
13109,4,17,true,7,11,4,41.97835,-87.65976
KA1504000152,4,17,true,18,13,-5,41.98403,-87.65231
15578,4,17,true,6,2,-4,41.98405,-87.66027
15575,4,17,true,11,3,-8,41.98975,-87.66014
15571,4,17,true,7,5,-2,41.99478,-87.66028
KA1504000175,4,17,true,1,5,4,42.00797,-87.66549
E002,4,17,true,4,7,3,42.03256,-87.67912
596,4,17,true,7,2,-5,42.04822,-87.68348
15491,4,18,false,5,3,-2,41.78096,-87.57624
KA1503000014,4,18,false,6,5,-1,41.7851,-87.60108
TA1309000063,4,18,false,1,5,4,41.79325,-87.5878
TA1308000009,4,18,false,9,13,4,41.79522,-87.58075
KA1503000059,4,18,false,7,6,-1,41.79952,-87.58643
TA1309000037,4,18,false,6,5,-1,41.79957,-87.59474
13398,4,18,false,6,6,0,41.80256,-87.59035
KA1503000065,4,18,false,7,3,-4,41.81409,-87.59701
TA1308000045,4,18,false,2,7,5,41.83062,-87.64129
KA1503000004,4,18,false,2,7,5,41.83127,-87.6088
15445,4,18,false,1,8,7,41.83453,-87.63183
TA1307000048,4,18,false,7,12,5,41.83855,-87.60821
15545,4,18,false,14,14,0,41.85627,-87.61334
13135,4,18,false,2,5,3,41.85753,-87.66157
13102,4,18,false,6,5,-1,41.85762,-87.61942
13150,4,18,false,3,6,3,41.85783,-87.62455
13099,4,18,false,5,4,-1,41.85784,-87.64627
13164,4,18,false,7,2,-5,41.85818,-87.65648
SL-012,4,18,false,7,9,2,41.86038,-87.62581
TA1307000124,4,18,false,16,10,-6,41.86411,-87.62372
TA1309000001,4,18,false,2,7,5,41.86488,-87.64708
13354,4,18,false,1,6,5,41.86524,-87.66651
13431,4,18,false,6,6,0,41.8661,-87.60728
TA1305000002,4,18,false,11,14,3,41.86721,-87.62597
15544,4,18,false,6,11,5,41.86723,-87.61536
KA1706005007,4,18,false,6,8,2,41.86749,-87.63219
SL-005,4,18,false,32,25,-7,41.8679,-87.62304
13139,4,18,false,7,1,-6,41.86893,-87.65913
13160,4,18,false,2,5,3,41.86947,-87.65548
TA1309000010,4,18,false,22,11,-11,41.87074,-87.62574
TA1307000130,4,18,false,4,5,1,41.87178,-87.65103
SL-008,4,18,false,14,12,-2,41.87209,-87.62956
SL-011,4,18,false,6,8,2,41.87256,-87.63356
623,4,18,false,22,16,-6,41.87272,-87.62399
SL-007,4,18,false,8,7,-1,41.87404,-87.6277
SL-010,4,18,false,7,1,-6,41.87501,-87.63309
15541,4,18,false,25,23,-2,41.8758,-87.62086
TA1305000010,4,18,false,4,6,2,41.87623,-87.62444
624,4,18,false,3,5,2,41.87626,-87.62923
15539,4,18,false,10,4,-6,41.87763,-87.64405
13158,4,18,false,15,9,-6,41.87764,-87.64957
13157,4,18,false,11,10,-1,41.87773,-87.6548
TA1305000025,4,18,false,7,5,-2,41.87773,-87.63528
TA1309000002,4,18,false,7,5,-2,41.87784,-87.62408
TA1309000004,4,18,false,1,5,4,41.87811,-87.63184
638,4,18,false,6,12,6,41.87827,-87.64078
13011,4,18,false,15,6,-9,41.87931,-87.63993
TA1309000008,4,18,false,4,11,7,41.87933,-87.6355
KA1503000015,4,18,false,5,5,0,41.87948,-87.6257
WL-011,4,18,false,8,7,-1,41.88034,-87.64273
13156,4,18,false,6,11,5,41.88042,-87.65554
13300,4,18,false,58,58,0,41.88097,-87.61675
13008,4,18,false,40,31,-9,41.88105,-87.62408
TA1305000006,4,18,false,5,5,0,41.88122,-87.6296
TA1307000120,4,18,false,28,17,-11,41.88188,-87.64879
13036,4,18,false,7,9,2,41.8821,-87.62513
TA1305000032,4,18,false,19,5,-14,41.88218,-87.64109
13353,4,18,false,6,4,-2,41.88283,-87.6612
13409,4,18,false,7,9,2,41.8831,-87.6511
WL-012,4,18,false,9,9,0,41.88337,-87.6412
13053,4,18,false,11,12,1,41.88365,-87.64863
13001,4,18,false,18,10,-8,41.88397,-87.62459
18062,4,18,false,3,7,4,41.88412,-87.65427
TA1306000010,4,18,false,11,13,2,41.88419,-87.62961
TA1305000030,4,18,false,9,4,-5,41.88459,-87.63178
15535,4,18,false,11,7,-4,41.8846,-87.64455
TA1305000029,4,18,false,10,11,1,41.88466,-87.62787
13263,4,18,false,20,20,0,41.88467,-87.61952
TA1306000015,4,18,false,20,22,2,41.88549,-87.65232
13021,4,18,false,15,8,-7,41.88559,-87.64184
TA1307000111,4,18,false,7,8,1,41.88582,-87.63548
KA17018054,4,18,false,3,5,2,41.88595,-87.67701
KA1503000012,4,18,false,12,11,-1,41.88599,-87.63089
TA1305000011,4,18,false,13,18,5,41.886,-87.62418
15534,4,18,false,8,4,-4,41.88627,-87.61749
13197,4,18,false,7,5,-2,41.8866,-87.65816
TA1308000029,4,18,false,3,7,4,41.88673,-87.62225
TA1307000131,4,18,false,10,13,3,41.88688,-87.62606
KA1503000064,4,18,false,28,34,6,41.88697,-87.61281
TA1305000022,4,18,false,17,3,-14,41.88817,-87.63656
TA1306000003,4,18,false,9,7,-2,41.88867,-87.64442
KA1503000043,4,18,false,24,17,-7,41.88918,-87.63851
13050,4,18,false,7,12,5,41.88919,-87.62775
13432,4,18,false,6,2,-4,41.88989,-87.67149
TA1307000151,4,18,false,22,15,-7,41.88993,-87.63427
636,4,18,false,5,5,0,41.88997,-87.63662
KA1503000044,4,18,false,4,6,2,41.89018,-87.6262
13427,4,18,false,16,12,-4,41.89054,-87.62205
13430,4,18,false,31,24,-7,41.89077,-87.63169
TA1306000013,4,18,false,34,22,-12,41.89083,-87.61852
RN-,4,18,false,6,9,3,41.89102,-87.63546
13434,4,18,false,9,3,-6,41.89108,-87.66663
TA1308000006,4,18,false,2,6,4,41.89128,-87.67686
TA1307000117,4,18,false,27,30,3,41.89144,-87.62675
13033,4,18,false,15,17,2,41.8916,-87.64835
13194,4,18,false,8,6,-2,41.8918,-87.65878
TA1305000003,4,18,false,16,12,-4,41.89187,-87.62061
13022,4,18,false,95,117,22,41.89227,-87.61205
TA1306000029,4,18,false,19,25,6,41.89256,-87.61449
13265,4,18,false,16,8,-8,41.89383,-87.64172
13045,4,18,false,27,21,-6,41.89403,-87.62931
13016,4,18,false,19,8,-11,41.89431,-87.62277
KA1503000041,4,18,false,7,5,-2,41.89452,-87.61798
13196,4,18,false,3,11,8,41.89455,-87.65345
TA1307000062,4,18,false,2,7,5,41.89466,-87.63839
TA1306000012,4,18,false,23,21,-2,41.89475,-87.63438
KP1705001026,4,18,false,10,13,3,41.89483,-87.6323
13132,4,18,false,7,5,-2,41.89573,-87.67718
15530,4,18,false,21,9,-12,41.89575,-87.62596
13247,4,18,false,7,3,-4,41.89597,-87.66775
TA1305000020,4,18,false,15,4,-11,41.89636,-87.65406
13289,4,18,false,6,5,-1,41.89638,-87.661
13303,4,18,false,4,7,3,41.89672,-87.63088
13017,4,18,false,11,3,-8,41.89676,-87.6357
13338,4,18,false,7,7,0,41.89697,-87.62173
13034,4,18,false,4,7,3,41.89754,-87.62352
TA1306000009,4,18,false,7,3,-4,41.89772,-87.64299
620,4,18,false,5,8,3,41.89817,-87.63754
15529,4,18,false,17,17,0,41.89858,-87.62206
TA1307000128,4,18,false,28,20,-8,41.89896,-87.6299
13248,4,18,false,8,2,-6,41.89964,-87.66788
TA1306000011,4,18,false,11,8,-3,41.89994,-87.63443
KA1504000116,4,18,false,7,9,2,41.90023,-87.64299
17660,4,18,false,1,6,5,41.90036,-87.69671
13290,4,18,false,7,5,-2,41.90069,-87.66259
13042,4,18,false,46,69,23,41.90097,-87.62377
TA1307000070,4,18,false,11,4,-7,41.90133,-87.67742
KA1504000133,4,18,false,12,7,-5,41.90234,-87.62773
13241,4,18,false,7,7,0,41.9029,-87.68731
TA1306000006,4,18,false,6,4,-2,41.90292,-87.63772
TA1307000039,4,18,false,26,45,19,41.90294,-87.63137
TA1305000034,4,18,false,6,15,9,41.90313,-87.67391
KA1504000135,4,18,false,38,39,1,41.90319,-87.63439
13136,4,18,false,4,8,4,41.90326,-87.67845
13061,4,18,false,15,13,-2,41.90342,-87.66779
KA1504000079,4,18,false,10,3,-7,41.9035,-87.64334
TA1307000115,4,18,false,1,5,4,41.9046,-87.64056
TA1308000049,4,18,false,31,35,4,41.90672,-87.6349
KA1504000134,4,18,false,9,26,17,41.90687,-87.6262
13224,4,18,false,10,9,-1,41.90706,-87.66725
TA1307000143,4,18,false,3,5,2,41.90762,-87.63854
13221,4,18,false,22,21,-1,41.90765,-87.67254
TA1309000024,4,18,false,24,30,6,41.908,-87.63152
TA1305000041,4,18,false,16,24,8,41.9094,-87.67769
331,4,18,false,19,21,2,41.90965,-87.64812
15653,4,18,false,5,1,-4,41.90979,-87.7053
TA1305000037,4,18,false,12,5,-7,41.91018,-87.67003
TA1306000008,4,18,false,9,6,-3,41.9102,-87.6435
TA1308000005,4,18,false,8,6,-2,41.91042,-87.68238
13154,4,18,false,18,9,-9,41.91054,-87.65312
13058,4,18,false,9,9,0,41.91059,-87.64942
TA1307000038,4,18,false,15,33,18,41.91138,-87.63868
LF-005,4,18,false,48,168,120,41.91172,-87.62681
13128,4,18,false,9,12,3,41.91197,-87.63197
TA1308000050,4,18,false,41,32,-9,41.91211,-87.6347
13243,4,18,false,11,10,-1,41.91262,-87.6814
TA1309000032,4,18,false,1,5,4,41.91293,-87.66417
TA1306000032,4,18,false,8,7,-1,41.9137,-87.65285
TA1307000166,4,18,false,8,10,2,41.91386,-87.64877
18067,4,18,false,12,6,-6,41.9146,-87.66796
TA1306000007,4,18,false,3,6,3,41.91469,-87.64333
13068,4,18,false,3,6,3,41.91554,-87.68703
13179,4,18,false,31,29,-2,41.9157,-87.63461
13133,4,18,false,13,25,12,41.91598,-87.67733
TA1305000039,4,18,false,6,4,-2,41.9163,-87.66749
15651,4,18,false,4,7,3,41.91752,-87.70181
TA1309000029,4,18,false,3,5,2,41.9178,-87.68245
TA1309000006,4,18,false,10,8,-2,41.91809,-87.64375
TA1307000163,4,18,false,5,5,0,41.91821,-87.65696
13146,4,18,false,28,56,28,41.91831,-87.63629
13059,4,18,false,18,17,-1,41.91845,-87.65222
13192,4,18,false,11,13,2,41.91995,-87.64884
13288,4,18,false,9,7,-2,41.92008,-87.67788
13242,4,18,false,2,10,8,41.92021,-87.69266
TA1309000030,4,18,false,9,9,0,41.92077,-87.66372
TA1309000033,4,18,false,11,16,5,41.92158,-87.65381
13193,4,18,false,32,34,2,41.92182,-87.64412
13191,4,18,false,16,16,0,41.92217,-87.63891
13084,4,18,false,10,10,0,41.92268,-87.69715
LP-,4,18,false,6,17,11,41.92396,-87.63584
KA1504000090,4,18,false,2,5,3,41.92483,-87.7145
TA1307000001,4,18,false,9,13,4,41.92535,-87.66581
TA1306000026,4,18,false,13,7,-6,41.92558,-87.65842
TA1306000016,4,18,false,24,13,-11,41.9256,-87.65371
TA1309000019,4,18,false,23,24,1,41.92586,-87.63897
TA1309000058,4,18,false,24,14,-10,41.92591,-87.64927
TA1308000001,4,18,false,30,41,11,41.92627,-87.63086
15646,4,18,false,7,5,-2,41.92668,-87.6977
13124,4,18,false,10,17,7,41.92675,-87.63444
TA1309000023,4,18,false,21,13,-8,41.9287,-87.65383
TA1307000113,4,18,false,14,23,9,41.92878,-87.66391
13296,4,18,false,8,9,1,41.92883,-87.66852
TA1309000061,4,18,false,18,18,0,41.92915,-87.64909
TA1308000031,4,18,false,1,7,6,41.92946,-87.68417
TA1305000014,4,18,false,15,14,-1,41.92956,-87.64313
13085,4,18,false,8,9,1,41.92958,-87.70789
15643,4,18,false,5,1,-4,41.93057,-87.7238
TA1307000142,4,18,false,17,16,-1,41.93125,-87.64432
13276,4,18,false,22,14,-8,41.93132,-87.63874
13271,4,18,false,5,8,3,41.93192,-87.67784
TA1307000064,4,18,false,17,14,-3,41.93222,-87.65864
TA1306000014,4,18,false,23,10,-13,41.93242,-87.65271
TA1309000039,4,18,false,26,22,-4,41.93258,-87.63642
13294,4,18,false,6,8,2,41.9326,-87.66595
TA1309000036,4,18,false,22,7,-15,41.93313,-87.64776
TA1307000006,4,18,false,7,8,1,41.93571,-87.6636
13268,4,18,false,4,9,5,41.93588,-87.67843
13269,4,18,false,5,7,2,41.93609,-87.66983
TA1307000052,4,18,false,21,6,-15,41.93628,-87.65266
TA1307000136,4,18,false,14,8,-6,41.9365,-87.64755
TA1307000041,4,18,false,24,23,-1,41.93669,-87.63683
13137,4,18,false,28,23,-5,41.9376,-87.6441
15642,4,18,false,4,10,6,41.93843,-87.69801
KA17018068,4,18,false,2,5,3,41.93935,-87.68327
TA1309000042,4,18,false,3,13,10,41.93937,-87.66836
13229,4,18,false,11,11,0,41.93946,-87.66376
TA1308000019,4,18,false,22,21,-1,41.93973,-87.65886
13277,4,18,false,16,5,-11,41.9401,-87.64546
TA1307000134,4,18,false,15,11,-4,41.94016,-87.65303
13143,4,18,false,6,3,-3,41.94059,-87.67853
TA1309000049,4,18,false,36,29,-7,41.94077,-87.63919
TA1307000138,4,18,false,7,4,-3,41.94334,-87.67094
13144,4,18,false,7,6,-1,41.9434,-87.67964
TA1309000025,4,18,false,15,12,-3,41.94368,-87.64894
13071,4,18,false,24,10,-14,41.94373,-87.66401
632,4,18,false,16,19,3,41.94453,-87.6547
13278,4,18,false,10,8,-2,41.94553,-87.64644
13235,4,18,false,18,9,-9,41.94814,-87.66396
13325,4,18,false,14,10,-4,41.94907,-87.64863
TA1307000126,4,18,false,15,19,4,41.94936,-87.65451
TA1307000150,4,18,false,29,19,-10,41.94945,-87.64646
13319,4,18,false,6,5,-1,41.95069,-87.6687
TA1307000127,4,18,false,10,15,5,41.9508,-87.65918
13323,4,18,false,8,6,-2,41.95282,-87.65
13063,4,18,false,7,4,-3,41.95424,-87.65441
KA1504000158,4,18,false,4,7,3,41.95432,-87.68607
TA1308000022,4,18,false,13,5,-8,41.95438,-87.64805
TA1307000149,4,18,false,9,2,-7,41.95467,-87.67392
TA1309000026,4,18,false,6,6,0,41.95601,-87.6802
13379,4,18,false,6,7,1,41.95786,-87.6495
TA1309000027,4,18,false,9,5,-4,41.9585,-87.65499
13389,4,18,false,12,6,-6,41.961,-87.64958
TA1307000107,4,18,false,7,6,-1,41.96164,-87.65464
TA1308000012,4,18,false,13,26,13,41.96398,-87.63818
639,4,18,false,2,6,4,41.96584,-87.64538
TA1307000140,4,18,false,1,7,6,41.96643,-87.68865
TA1309000014,4,18,false,10,5,-5,41.96709,-87.66744
TA1307000119,4,18,false,9,11,2,41.96796,-87.65
TA1308000021,4,18,false,8,2,-6,41.96883,-87.65765
TA1309000066,4,18,false,7,5,-2,41.9691,-87.67423
KA1504000171,4,18,false,8,8,0,41.97161,-87.65016
TA1309000035,4,18,false,14,4,-10,41.97335,-87.66785
13108,4,18,false,7,2,-5,41.97379,-87.65971
13109,4,18,false,7,6,-1,41.97835,-87.65976
655,4,18,false,1,7,6,41.97987,-87.68194
KA1504000152,4,18,false,13,14,1,41.98403,-87.65231
15578,4,18,false,6,2,-4,41.98405,-87.66027
15571,4,18,false,8,8,0,41.99478,-87.66028
RP-001,4,18,false,5,5,0,42.00179,-87.68883
596,4,18,false,3,5,2,42.04822,-87.68348
KA1503000014,4,18,true,11,7,-4,41.7851,-87.60108
KA1503000071,4,18,true,10,1,-9,41.79148,-87.59988
TA1309000063,4,18,true,6,4,-2,41.79325,-87.5878
KA1504000076,4,18,true,7,4,-3,41.7943,-87.60145
TA1308000009,4,18,true,10,13,3,41.79522,-87.58075
TA1307000164,4,18,true,4,6,2,41.79527,-87.59647
KA1503000052,4,18,true,5,3,-2,41.79935,-87.60097
TA1309000037,4,18,true,4,8,4,41.79957,-87.59474
KA1503000007,4,18,true,10,6,-4,41.80242,-87.58689
13398,4,18,true,8,9,1,41.80256,-87.59035
15445,4,18,true,3,5,2,41.83453,-87.63183
13216,4,18,true,12,3,-9,41.83473,-87.62581
13217,4,18,true,7,8,1,41.83488,-87.61792
13215,4,18,true,6,9,3,41.83634,-87.6135
TA1309000055,4,18,true,5,5,0,41.8382,-87.64514
KA1503000038,4,18,true,6,4,-2,41.83845,-87.6354
TA1307000048,4,18,true,6,5,-1,41.83855,-87.60821
TA1308000036,4,18,true,8,7,-1,41.83883,-87.62186
TA1307000139,4,18,true,9,7,-2,41.84205,-87.61698
15546,4,18,true,2,10,8,41.85416,-87.61916
15545,4,18,true,31,30,-1,41.85627,-87.61334
13135,4,18,true,3,6,3,41.85753,-87.66157
13102,4,18,true,12,7,-5,41.85762,-87.61942
13150,4,18,true,6,11,5,41.85783,-87.62455
13164,4,18,true,5,7,2,41.85818,-87.65648
SL-012,4,18,true,8,14,6,41.86038,-87.62581
13304,4,18,true,8,4,-4,41.86126,-87.65659
TA1306000002,4,18,true,10,9,-1,41.86238,-87.65108
TA1307000124,4,18,true,11,20,9,41.86411,-87.62372
TA1309000001,4,18,true,6,7,1,41.86488,-87.64708
13354,4,18,true,5,2,-3,41.86524,-87.66651
13431,4,18,true,12,9,-3,41.8661,-87.60728
TA1305000002,4,18,true,23,23,0,41.86721,-87.62597
15544,4,18,true,9,7,-2,41.86723,-87.61536
KA1706005007,4,18,true,7,11,4,41.86749,-87.63219
SL-005,4,18,true,18,18,0,41.8679,-87.62304
644,4,18,true,2,5,3,41.86859,-87.68625
13139,4,18,true,9,5,-4,41.86893,-87.65913
13160,4,18,true,6,8,2,41.86947,-87.65548
15550,4,18,true,5,5,0,41.87024,-87.63947
TA1309000010,4,18,true,15,16,1,41.87074,-87.62574
SL-009,4,18,true,4,5,1,41.87081,-87.63121
TA1309000064,4,18,true,8,5,-3,41.87127,-87.67369
TA1307000130,4,18,true,10,10,0,41.87178,-87.65103
TA1307000121,4,18,true,18,19,1,41.87184,-87.64664
SL-008,4,18,true,18,24,6,41.87209,-87.62956
13332,4,18,true,22,17,-5,41.87219,-87.6615
SL-011,4,18,true,14,5,-9,41.87256,-87.63356
623,4,18,true,5,4,-1,41.87272,-87.62399
KA1504000104,4,18,true,6,3,-3,41.87296,-87.66912
13028,4,18,true,15,10,-5,41.87475,-87.64981
SL-010,4,18,true,5,8,3,41.87501,-87.63309
15541,4,18,true,6,6,0,41.8758,-87.62086
TA1305000009,4,18,true,5,3,-2,41.87593,-87.63068
624,4,18,true,5,5,0,41.87626,-87.62923
13138,4,18,true,8,2,-6,41.87723,-87.63941
15539,4,18,true,16,17,1,41.87763,-87.64405
13158,4,18,true,11,14,3,41.87764,-87.64957
13157,4,18,true,11,16,5,41.87773,-87.6548
TA1305000025,4,18,true,19,6,-13,41.87773,-87.63528
13206,4,18,true,11,9,-2,41.87794,-87.66201
TA1309000004,4,18,true,8,1,-7,41.87811,-87.63184
638,4,18,true,15,12,-3,41.87827,-87.64078
TA1305000005,4,18,true,8,5,-3,41.87924,-87.62975
13011,4,18,true,26,9,-17,41.87931,-87.63993
TA1309000008,4,18,true,8,1,-7,41.87933,-87.6355
KA1503000034,4,18,true,5,1,-4,41.87938,-87.63197
KA1503000015,4,18,true,13,3,-10,41.87948,-87.6257
TA1309000007,4,18,true,19,5,-14,41.88022,-87.63526
WL-011,4,18,true,13,10,-3,41.88034,-87.64273
13156,4,18,true,6,9,3,41.88042,-87.65554
13300,4,18,true,29,29,0,41.88097,-87.61675
13008,4,18,true,13,7,-6,41.88105,-87.62408
TA1305000006,4,18,true,12,9,-3,41.88122,-87.6296
13056,4,18,true,22,7,-15,41.88168,-87.63951
TA1307000120,4,18,true,34,33,-1,41.88188,-87.64879
13341,4,18,true,20,11,-9,41.88208,-87.63985
13036,4,18,true,5,4,-1,41.8821,-87.62513
TA1305000032,4,18,true,30,29,-1,41.88218,-87.64109
13353,4,18,true,12,9,-3,41.88283,-87.6612
654,4,18,true,2,6,4,41.88307,-87.65698
13409,4,18,true,16,11,-5,41.8831,-87.6511
WL-012,4,18,true,16,15,-1,41.88337,-87.6412
13053,4,18,true,11,6,-5,41.88365,-87.64863
13001,4,18,true,18,8,-10,41.88397,-87.62459
13155,4,18,true,6,8,2,41.88407,-87.65689
18062,4,18,true,7,4,-3,41.88412,-87.65427
TA1306000010,4,18,true,34,13,-21,41.88419,-87.62961
TA1305000030,4,18,true,27,6,-21,41.88459,-87.63178
15535,4,18,true,17,17,0,41.8846,-87.64455
TA1305000029,4,18,true,23,15,-8,41.88466,-87.62787
13263,4,18,true,18,34,16,41.88467,-87.61952
TA1306000015,4,18,true,13,27,14,41.88549,-87.65232
13021,4,18,true,20,11,-9,41.88559,-87.64184
TA1307000111,4,18,true,10,10,0,41.88582,-87.63548
13073,4,18,true,9,4,-5,41.88592,-87.66717
KA17018054,4,18,true,2,7,5,41.88595,-87.67701
KA1503000012,4,18,true,16,14,-2,41.88599,-87.63089
TA1305000011,4,18,true,18,15,-3,41.886,-87.62418
15534,4,18,true,12,15,3,41.88627,-87.61749
13197,4,18,true,9,9,0,41.8866,-87.65816
TA1308000029,4,18,true,8,5,-3,41.88673,-87.62225
TA1307000131,4,18,true,12,12,0,41.88688,-87.62606
KA1503000064,4,18,true,18,15,-3,41.88697,-87.61281
TA1305000022,4,18,true,20,17,-3,41.88817,-87.63656
TA1306000003,4,18,true,22,16,-6,41.88867,-87.64442
KA1503000043,4,18,true,41,37,-4,41.88918,-87.63851
13050,4,18,true,28,16,-12,41.88919,-87.62775
13432,4,18,true,8,4,-4,41.88989,-87.67149
TA1307000151,4,18,true,34,25,-9,41.88993,-87.63427
636,4,18,true,11,8,-3,41.88997,-87.63662
KA1503000044,4,18,true,8,9,1,41.89018,-87.6262
13427,4,18,true,8,9,1,41.89054,-87.62205
13430,4,18,true,31,21,-10,41.89077,-87.63169
TA1306000013,4,18,true,17,30,13,41.89083,-87.61852
RN-,4,18,true,21,22,1,41.89102,-87.63546
13434,4,18,true,1,6,5,41.89108,-87.66663
TA1307000117,4,18,true,29,23,-6,41.89144,-87.62675
13033,4,18,true,18,21,3,41.8916,-87.64835
13194,4,18,true,8,22,14,41.8918,-87.65878
TA1305000003,4,18,true,16,16,0,41.89187,-87.62061
13022,4,18,true,34,33,-1,41.89227,-87.61205
TA1306000029,4,18,true,14,25,11,41.89256,-87.61449
13265,4,18,true,18,21,3,41.89383,-87.64172
13045,4,18,true,40,19,-21,41.89403,-87.62931
13016,4,18,true,46,5,-41,41.89431,-87.62277
KA1503000041,4,18,true,13,16,3,41.89452,-87.61798
13196,4,18,true,11,13,2,41.89455,-87.65345
TA1307000062,4,18,true,12,12,0,41.89466,-87.63839
TA1306000012,4,18,true,32,35,3,41.89475,-87.63438
KP1705001026,4,18,true,14,15,1,41.89483,-87.6323
18058,4,18,true,3,6,3,41.8955,-87.68201
637,4,18,true,9,8,-1,41.89563,-87.67209
13132,4,18,true,6,10,4,41.89573,-87.67718
15530,4,18,true,23,19,-4,41.89575,-87.62596
13247,4,18,true,7,8,1,41.89597,-87.66775
TA1305000020,4,18,true,14,11,-3,41.89636,-87.65406
13289,4,18,true,12,9,-3,41.89638,-87.661
13303,4,18,true,13,13,0,41.89672,-87.63088
13017,4,18,true,12,15,3,41.89676,-87.6357
13338,4,18,true,13,11,-2,41.89697,-87.62173
TA1307000061,4,18,true,12,19,7,41.89745,-87.62873
13034,4,18,true,17,9,-8,41.89754,-87.62352
TA1306000009,4,18,true,24,14,-10,41.89772,-87.64299
620,4,18,true,12,9,-3,41.89817,-87.63754
KA1504000103,4,18,true,7,6,-1,41.89842,-87.68659
15529,4,18,true,23,34,11,41.89858,-87.62206
TA1307000128,4,18,true,24,32,8,41.89896,-87.6299
657,4,18,true,6,5,-1,41.89918,-87.6722
KA1504000117,4,18,true,5,2,-3,41.89936,-87.64848
13248,4,18,true,7,14,7,41.89964,-87.66788
TA1306000011,4,18,true,9,12,3,41.89994,-87.63443
KA1504000116,4,18,true,15,15,0,41.90023,-87.64299
13290,4,18,true,9,10,1,41.90069,-87.66259
13042,4,18,true,36,28,-8,41.90097,-87.62377
TA1307000070,4,18,true,5,10,5,41.90133,-87.67742
KA1504000133,4,18,true,16,18,2,41.90234,-87.62773
TA1306000006,4,18,true,2,7,5,41.90292,-87.63772
TA1307000039,4,18,true,40,46,6,41.90294,-87.63137
658,4,18,true,4,5,1,41.903,-87.6838
TA1305000034,4,18,true,9,12,3,41.90313,-87.67391
KA1504000135,4,18,true,42,56,14,41.90319,-87.63439
13136,4,18,true,10,17,7,41.90326,-87.67845
13061,4,18,true,25,22,-3,41.90342,-87.66779
KA1504000079,4,18,true,13,16,3,41.9035,-87.64334
TA1307000115,4,18,true,6,16,10,41.9046,-87.64056
TA1308000049,4,18,true,23,39,16,41.90672,-87.6349
KA1504000134,4,18,true,20,19,-1,41.90687,-87.6262
13224,4,18,true,8,10,2,41.90706,-87.66725
TA1307000143,4,18,true,2,11,9,41.90762,-87.63854
13221,4,18,true,19,12,-7,41.90765,-87.67254
13245,4,18,true,4,5,1,41.90777,-87.68586
TA1309000024,4,18,true,17,28,11,41.908,-87.63152
TA1305000041,4,18,true,21,5,-16,41.9094,-87.67769
331,4,18,true,14,27,13,41.90965,-87.64812
TA1305000037,4,18,true,8,9,1,41.91018,-87.67003
TA1306000008,4,18,true,9,19,10,41.9102,-87.6435
TA1308000005,4,18,true,4,7,3,41.91042,-87.68238
13257,4,18,true,3,5,2,41.91054,-87.68956
13154,4,18,true,15,13,-2,41.91054,-87.65312
13058,4,18,true,14,9,-5,41.91059,-87.64942
TA1307000038,4,18,true,24,33,9,41.91138,-87.63868
LF-005,4,18,true,40,109,69,41.91172,-87.62681
13128,4,18,true,10,10,0,41.91197,-87.63197
TA1308000050,4,18,true,30,38,8,41.91211,-87.6347
13243,4,18,true,12,17,5,41.91262,-87.6814
TA1306000032,4,18,true,21,17,-4,41.9137,-87.65285
TA1307000166,4,18,true,11,10,-1,41.91386,-87.64877
15655,4,18,true,3,8,5,41.91401,-87.70514
18067,4,18,true,6,9,3,41.9146,-87.66796
TA1306000007,4,18,true,3,7,4,41.91469,-87.64333
13068,4,18,true,10,8,-2,41.91554,-87.68703
13179,4,18,true,22,40,18,41.9157,-87.63461
13133,4,18,true,17,32,15,41.91598,-87.67733
TA1305000039,4,18,true,6,3,-3,41.9163,-87.66749
15650,4,18,true,4,8,4,41.91711,-87.71023
15651,4,18,true,4,11,7,41.91752,-87.70181
13266,4,18,true,2,6,4,41.91774,-87.69142
TA1309000029,4,18,true,5,4,-1,41.9178,-87.68245
TA1309000006,4,18,true,15,17,2,41.91809,-87.64375
TA1307000163,4,18,true,12,12,0,41.91821,-87.65696
13146,4,18,true,22,44,22,41.91831,-87.63629
13059,4,18,true,29,22,-7,41.91845,-87.65222
13259,4,18,true,5,1,-4,41.91852,-87.69744
13192,4,18,true,16,17,1,41.91995,-87.64884
13288,4,18,true,9,5,-4,41.92008,-87.67788
TA1309000030,4,18,true,9,16,7,41.92077,-87.66372
TA1309000033,4,18,true,10,15,5,41.92158,-87.65381
13193,4,18,true,39,29,-10,41.92182,-87.64412
13191,4,18,true,7,18,11,41.92217,-87.63891
13084,4,18,true,4,11,7,41.92268,-87.69715
LP-,4,18,true,12,11,-1,41.92396,-87.63584
KA1504000140,4,18,true,6,4,-2,41.92409,-87.67646
15648,4,18,true,2,5,3,41.92464,-87.68931
TA1307000001,4,18,true,9,15,6,41.92535,-87.66581
TA1306000026,4,18,true,12,16,4,41.92558,-87.65842
TA1306000016,4,18,true,13,25,12,41.9256,-87.65371
TA1309000019,4,18,true,27,23,-4,41.92586,-87.63897
TA1309000058,4,18,true,25,30,5,41.92591,-87.64927
TA1308000001,4,18,true,22,26,4,41.92627,-87.63086
15646,4,18,true,2,6,4,41.92668,-87.6977
13124,4,18,true,7,15,8,41.92675,-87.63444
TA1309000023,4,18,true,21,20,-1,41.9287,-87.65383
TA1307000113,4,18,true,9,13,4,41.92878,-87.66391
TA1309000061,4,18,true,14,19,5,41.92915,-87.64909
TA1308000031,4,18,true,2,10,8,41.92946,-87.68417
TA1305000014,4,18,true,23,18,-5,41.92956,-87.64313
13085,4,18,true,4,7,3,41.92958,-87.70789
TA1307000142,4,18,true,17,17,0,41.93125,-87.64432
13276,4,18,true,16,29,13,41.93132,-87.63874
13271,4,18,true,9,5,-4,41.93192,-87.67784
TA1307000064,4,18,true,13,23,10,41.93222,-87.65864
TA1306000014,4,18,true,21,14,-7,41.93242,-87.65271
TA1309000039,4,18,true,26,40,14,41.93258,-87.63642
13294,4,18,true,12,10,-2,41.9326,-87.66595
TA1309000036,4,18,true,18,14,-4,41.93313,-87.64776
TA1307000006,4,18,true,17,12,-5,41.93571,-87.6636
13268,4,18,true,7,11,4,41.93588,-87.67843
13269,4,18,true,12,9,-3,41.93609,-87.66983
TA1307000052,4,18,true,15,11,-4,41.93628,-87.65266
TA1307000136,4,18,true,18,19,1,41.9365,-87.64755
TA1307000041,4,18,true,31,31,0,41.93669,-87.63683
13137,4,18,true,28,28,0,41.9376,-87.6441
15642,4,18,true,3,6,3,41.93843,-87.69801
TA1309000042,4,18,true,13,10,-3,41.93937,-87.66836
13229,4,18,true,4,8,4,41.93946,-87.66376
TA1308000019,4,18,true,12,18,6,41.93973,-87.65886
13277,4,18,true,20,20,0,41.9401,-87.64546
TA1307000134,4,18,true,20,20,0,41.94016,-87.65303
13143,4,18,true,3,8,5,41.94059,-87.67853
TA1309000049,4,18,true,36,27,-9,41.94077,-87.63919
TA1307000138,4,18,true,16,11,-5,41.94334,-87.67094
13144,4,18,true,3,7,4,41.9434,-87.67964
TA1309000025,4,18,true,14,22,8,41.94368,-87.64894
13071,4,18,true,23,17,-6,41.94373,-87.66401
632,4,18,true,10,12,2,41.94453,-87.6547
13278,4,18,true,26,13,-13,41.94553,-87.64644
13235,4,18,true,22,17,-5,41.94814,-87.66396
13253,4,18,true,5,5,0,41.9488,-87.67527
13325,4,18,true,17,23,6,41.94907,-87.64863
TA1307000126,4,18,true,10,12,2,41.94936,-87.65451
TA1307000150,4,18,true,26,28,2,41.94945,-87.64646
13319,4,18,true,8,4,-4,41.95069,-87.6687
TA1307000127,4,18,true,18,16,-2,41.9508,-87.65918
13323,4,18,true,11,13,2,41.95282,-87.65
TA1309000043,4,18,true,5,9,4,41.95417,-87.66434
13063,4,18,true,15,6,-9,41.95424,-87.65441
TA1308000022,4,18,true,14,11,-3,41.95438,-87.64805
TA1307000149,4,18,true,8,5,-3,41.95467,-87.67392
TA1309000026,4,18,true,7,11,4,41.95601,-87.6802
TA1308000047,4,18,true,3,7,4,41.95709,-87.6642
13379,4,18,true,12,21,9,41.95786,-87.6495
TA1309000018,4,18,true,7,4,-3,41.95791,-87.67357
TA1309000027,4,18,true,3,10,7,41.9585,-87.65499
13389,4,18,true,13,19,6,41.961,-87.64958
15622,4,18,true,2,6,4,41.96108,-87.69544
TA1307000144,4,18,true,8,11,3,41.96142,-87.6762
TA1309000021,4,18,true,1,6,5,41.9615,-87.6714
KA1503000022,4,18,true,4,8,4,41.96158,-87.66609
TA1307000107,4,18,true,19,14,-5,41.96164,-87.65464
TA1309000012,4,18,true,8,5,-3,41.96325,-87.67928
TA1308000012,4,18,true,17,37,20,41.96398,-87.63818
13074,4,18,true,7,12,5,41.96521,-87.6582
639,4,18,true,9,12,3,41.96584,-87.64538
KA1504000127,4,18,true,4,6,2,41.96587,-87.70083
TA1307000140,4,18,true,5,10,5,41.96643,-87.68865
TA1309000014,4,18,true,12,6,-6,41.96709,-87.66744
TA1307000158,4,18,true,5,6,1,41.9671,-87.67904
TA1307000119,4,18,true,6,11,5,41.96796,-87.65
TA1309000015,4,18,true,3,6,3,41.96889,-87.68401
TA1309000066,4,18,true,16,11,-5,41.9691,-87.67423
TA1309000041,4,18,true,7,8,1,41.96951,-87.65471
KA1504000171,4,18,true,14,8,-6,41.97161,-87.65016
TA1309000035,4,18,true,5,15,10,41.97335,-87.66785
13108,4,18,true,7,9,2,41.97379,-87.65971
KA1504000149,4,18,true,2,7,5,41.97562,-87.67945
KA1504000146,4,18,true,11,4,-7,41.978,-87.66805
13109,4,18,true,10,12,2,41.97835,-87.65976
KA1504000151,4,18,true,7,4,-3,41.98359,-87.66916
KA1504000152,4,18,true,21,13,-8,41.98403,-87.65231
15578,4,18,true,6,7,1,41.98405,-87.66027
15575,4,18,true,9,10,1,41.98975,-87.66014
15571,4,18,true,9,7,-2,41.99478,-87.66028
RP-009,4,18,true,4,5,1,42.00107,-87.66122
660,4,18,true,5,7,2,42.00458,-87.66143
E002,4,18,true,5,3,-2,42.03256,-87.67912
596,4,18,true,6,3,-3,42.04822,-87.68348
604,4,18,true,6,1,-5,42.05824,-87.67744
KA1503000029,4,19,false,5,2,-3,41.77364,-87.56747
15491,4,19,false,3,9,6,41.78096,-87.57624
KA1503000014,4,19,false,9,4,-5,41.7851,-87.60108
TA1309000063,4,19,false,6,2,-4,41.79325,-87.5878
TA1308000009,4,19,false,19,18,-1,41.79522,-87.58075
TA1307000164,4,19,false,1,6,5,41.79527,-87.59647
KA1503000059,4,19,false,7,4,-3,41.79952,-87.58643
TA1309000037,4,19,false,5,5,0,41.79957,-87.59474
13398,4,19,false,6,3,-3,41.80256,-87.59035
TA1307000048,4,19,false,11,8,-3,41.83855,-87.60821
TA1308000026,4,19,false,2,6,4,41.85008,-87.63214
TA1305000004,4,19,false,5,4,-1,41.8514,-87.61884
13075,4,19,false,13,12,-1,41.8531,-87.63192
15546,4,19,false,7,4,-3,41.85416,-87.61916
13331,4,19,false,2,5,3,41.85515,-87.65414
15545,4,19,false,4,6,2,41.85627,-87.61334
SL-013,4,19,false,5,6,1,41.85659,-87.62755
13135,4,19,false,6,2,-4,41.85753,-87.66157
13102,4,19,false,5,6,1,41.85762,-87.61942
13150,4,19,false,3,6,3,41.85783,-87.62455
13099,4,19,false,5,3,-2,41.85784,-87.64627
13164,4,19,false,2,5,3,41.85818,-87.65648
SL-012,4,19,false,5,3,-2,41.86038,-87.62581
TA1306000002,4,19,false,1,5,4,41.86238,-87.65108
TA1307000124,4,19,false,14,9,-5,41.86411,-87.62372
13431,4,19,false,12,12,0,41.8661,-87.60728
TA1305000002,4,19,false,10,14,4,41.86721,-87.62597
15544,4,19,false,9,5,-4,41.86723,-87.61536
KA1706005007,4,19,false,10,5,-5,41.86749,-87.63219
SL-005,4,19,false,30,17,-13,41.8679,-87.62304
TA1309000010,4,19,false,8,11,3,41.87074,-87.62574
TA1307000130,4,19,false,7,2,-5,41.87178,-87.65103
SL-008,4,19,false,9,7,-2,41.87209,-87.62956
13332,4,19,false,6,1,-5,41.87219,-87.6615
SL-011,4,19,false,3,8,5,41.87256,-87.63356
623,4,19,false,16,14,-2,41.87272,-87.62399
SL-007,4,19,false,8,9,1,41.87404,-87.6277
15541,4,19,false,24,36,12,41.8758,-87.62086
624,4,19,false,9,6,-3,41.87626,-87.62923
15539,4,19,false,3,5,2,41.87763,-87.64405
13158,4,19,false,3,5,2,41.87764,-87.64957
13157,4,19,false,7,6,-1,41.87773,-87.6548
TA1305000025,4,19,false,6,2,-4,41.87773,-87.63528
TA1309000002,4,19,false,9,5,-4,41.87784,-87.62408
638,4,19,false,6,2,-4,41.87827,-87.64078
13011,4,19,false,7,9,2,41.87931,-87.63993
TA1309000008,4,19,false,5,7,2,41.87933,-87.6355
KA1503000015,4,19,false,3,5,2,41.87948,-87.6257
TA1309000007,4,19,false,6,5,-1,41.88022,-87.63526
WL-011,4,19,false,5,4,-1,41.88034,-87.64273
13156,4,19,false,8,7,-1,41.88042,-87.65554
13300,4,19,false,44,51,7,41.88097,-87.61675
13008,4,19,false,39,46,7,41.88105,-87.62408
TA1305000006,4,19,false,6,3,-3,41.88122,-87.6296
TA1307000120,4,19,false,17,22,5,41.88188,-87.64879
13036,4,19,false,5,3,-2,41.8821,-87.62513
TA1305000032,4,19,false,11,7,-4,41.88218,-87.64109
13006,4,19,false,3,5,2,41.88268,-87.63252
13353,4,19,false,6,6,0,41.88283,-87.6612
13409,4,19,false,5,4,-1,41.8831,-87.6511
WL-012,4,19,false,11,5,-6,41.88337,-87.6412
13053,4,19,false,7,11,4,41.88365,-87.64863
13001,4,19,false,16,2,-14,41.88397,-87.62459
18062,4,19,false,4,6,2,41.88412,-87.65427
TA1306000010,4,19,false,13,5,-8,41.88419,-87.62961
TA1305000030,4,19,false,5,7,2,41.88459,-87.63178
15535,4,19,false,10,13,3,41.8846,-87.64455
TA1305000029,4,19,false,10,17,7,41.88466,-87.62787
13263,4,19,false,32,14,-18,41.88467,-87.61952
TA1306000015,4,19,false,6,15,9,41.88549,-87.65232
13021,4,19,false,9,5,-4,41.88559,-87.64184
KA1503000012,4,19,false,13,11,-2,41.88599,-87.63089
TA1305000011,4,19,false,23,15,-8,41.886,-87.62418
TA1308000029,4,19,false,9,6,-3,41.88673,-87.62225
TA1307000131,4,19,false,19,14,-5,41.88688,-87.62606
KA1503000064,4,19,false,28,27,-1,41.88697,-87.61281
TA1305000022,4,19,false,14,5,-9,41.88817,-87.63656
TA1306000003,4,19,false,18,13,-5,41.88867,-87.64442
KA1503000043,4,19,false,9,8,-1,41.88918,-87.63851
13050,4,19,false,18,20,2,41.88919,-87.62775
TA1307000151,4,19,false,8,14,6,41.88993,-87.63427
KA1503000044,4,19,false,4,7,3,41.89018,-87.6262
13427,4,19,false,5,11,6,41.89054,-87.62205
13430,4,19,false,25,22,-3,41.89077,-87.63169
TA1306000013,4,19,false,27,24,-3,41.89083,-87.61852
RN-,4,19,false,13,9,-4,41.89102,-87.63546
13434,4,19,false,5,4,-1,41.89108,-87.66663
TA1308000006,4,19,false,4,5,1,41.89128,-87.67686
TA1307000117,4,19,false,19,15,-4,41.89144,-87.62675
13033,4,19,false,18,9,-9,41.8916,-87.64835
13194,4,19,false,5,2,-3,41.8918,-87.65878
TA1305000003,4,19,false,25,26,1,41.89187,-87.62061
13022,4,19,false,91,100,9,41.89227,-87.61205
TA1306000029,4,19,false,22,20,-2,41.89256,-87.61449
13265,4,19,false,10,8,-2,41.89383,-87.64172
13045,4,19,false,14,11,-3,41.89403,-87.62931
13016,4,19,false,18,12,-6,41.89431,-87.62277
KA1503000041,4,19,false,5,2,-3,41.89452,-87.61798
13196,4,19,false,11,7,-4,41.89455,-87.65345
TA1307000062,4,19,false,4,7,3,41.89466,-87.63839
TA1306000012,4,19,false,19,13,-6,41.89475,-87.63438
KP1705001026,4,19,false,7,8,1,41.89483,-87.6323
637,4,19,false,6,8,2,41.89563,-87.67209
13132,4,19,false,5,9,4,41.89573,-87.67718
15530,4,19,false,5,7,2,41.89575,-87.62596
13247,4,19,false,4,6,2,41.89597,-87.66775
13289,4,19,false,5,6,1,41.89638,-87.661
13303,4,19,false,11,17,6,41.89672,-87.63088
13017,4,19,false,14,7,-7,41.89676,-87.6357
13338,4,19,false,9,7,-2,41.89697,-87.62173
TA1307000061,4,19,false,5,1,-4,41.89745,-87.62873
13034,4,19,false,12,11,-1,41.89754,-87.62352
TA1306000009,4,19,false,5,3,-2,41.89772,-87.64299
620,4,19,false,3,5,2,41.89817,-87.63754
KA1504000103,4,19,false,5,6,1,41.89842,-87.68659
15529,4,19,false,16,21,5,41.89858,-87.62206
TA1307000128,4,19,false,21,18,-3,41.89896,-87.6299
13248,4,19,false,5,8,3,41.89964,-87.66788
TA1306000011,4,19,false,3,11,8,41.89994,-87.63443
17660,4,19,false,5,5,0,41.90036,-87.69671
13290,4,19,false,8,6,-2,41.90069,-87.66259
13042,4,19,false,52,39,-13,41.90097,-87.62377
TA1307000070,4,19,false,5,3,-2,41.90133,-87.67742
KA1504000133,4,19,false,16,13,-3,41.90234,-87.62773
13241,4,19,false,1,5,4,41.9029,-87.68731
TA1306000006,4,19,false,2,9,7,41.90292,-87.63772
TA1307000039,4,19,false,36,23,-13,41.90294,-87.63137
658,4,19,false,5,3,-2,41.903,-87.6838
TA1305000034,4,19,false,4,6,2,41.90313,-87.67391
KA1504000135,4,19,false,41,43,2,41.90319,-87.63439
13136,4,19,false,9,9,0,41.90326,-87.67845
13061,4,19,false,6,15,9,41.90342,-87.66779
KA1504000079,4,19,false,3,6,3,41.9035,-87.64334
TA1308000049,4,19,false,32,31,-1,41.90672,-87.6349
KA1504000134,4,19,false,9,10,1,41.90687,-87.6262
13224,4,19,false,9,8,-1,41.90706,-87.66725
TA1307000143,4,19,false,4,16,12,41.90762,-87.63854
13221,4,19,false,10,14,4,41.90765,-87.67254
TA1309000024,4,19,false,20,18,-2,41.908,-87.63152
TA1305000041,4,19,false,13,13,0,41.9094,-87.67769
331,4,19,false,14,6,-8,41.90965,-87.64812
15653,4,19,false,2,6,4,41.90979,-87.7053
TA1305000037,4,19,false,8,7,-1,41.91018,-87.67003
TA1306000008,4,19,false,6,10,4,41.9102,-87.6435
TA1308000005,4,19,false,5,4,-1,41.91042,-87.68238
13258,4,19,false,1,5,4,41.91043,-87.69718
13257,4,19,false,6,4,-2,41.91054,-87.68956
13154,4,19,false,5,4,-1,41.91054,-87.65312
13058,4,19,false,10,16,6,41.91059,-87.64942
TA1307000038,4,19,false,15,14,-1,41.91138,-87.63868
LF-005,4,19,false,59,161,102,41.91172,-87.62681
13128,4,19,false,6,7,1,41.91197,-87.63197
TA1308000050,4,19,false,23,36,13,41.91211,-87.6347
13243,4,19,false,5,1,-4,41.91262,-87.6814
TA1306000032,4,19,false,8,10,2,41.9137,-87.65285
TA1307000166,4,19,false,6,5,-1,41.91386,-87.64877
18067,4,19,false,9,6,-3,41.9146,-87.66796
13068,4,19,false,5,3,-2,41.91554,-87.68703
13179,4,19,false,33,28,-5,41.9157,-87.63461
13133,4,19,false,6,10,4,41.91598,-87.67733
TA1305000039,4,19,false,6,1,-5,41.9163,-87.66749
15651,4,19,false,3,5,2,41.91752,-87.70181
TA1309000006,4,19,false,10,15,5,41.91809,-87.64375
TA1307000163,4,19,false,7,8,1,41.91821,-87.65696
13146,4,19,false,27,28,1,41.91831,-87.63629
13059,4,19,false,3,12,9,41.91845,-87.65222
13259,4,19,false,4,6,2,41.91852,-87.69744
13192,4,19,false,11,11,0,41.91995,-87.64884
TA1309000030,4,19,false,9,16,7,41.92077,-87.66372
TA1309000033,4,19,false,12,14,2,41.92158,-87.65381
13193,4,19,false,23,30,7,41.92182,-87.64412
13191,4,19,false,7,20,13,41.92217,-87.63891
13084,4,19,false,5,6,1,41.92268,-87.69715
LP-,4,19,false,19,27,8,41.92396,-87.63584
TA1307000001,4,19,false,14,12,-2,41.92535,-87.66581
TA1306000026,4,19,false,6,3,-3,41.92558,-87.65842
TA1306000016,4,19,false,20,7,-13,41.9256,-87.65371
TA1309000019,4,19,false,24,31,7,41.92586,-87.63897
TA1309000058,4,19,false,16,22,6,41.92591,-87.64927
TA1308000001,4,19,false,56,41,-15,41.92627,-87.63086
13124,4,19,false,5,12,7,41.92675,-87.63444
TA1309000023,4,19,false,11,17,6,41.9287,-87.65383
TA1307000113,4,19,false,8,15,7,41.92878,-87.66391
13296,4,19,false,5,6,1,41.92883,-87.66852
TA1309000061,4,19,false,13,19,6,41.92915,-87.64909
TA1308000031,4,19,false,2,6,4,41.92946,-87.68417
TA1305000014,4,19,false,16,20,4,41.92956,-87.64313
13085,4,19,false,4,10,6,41.92958,-87.70789
TA1307000142,4,19,false,17,11,-6,41.93125,-87.64432
13276,4,19,false,10,19,9,41.93132,-87.63874
TA1307000064,4,19,false,12,7,-5,41.93222,-87.65864
TA1306000014,4,19,false,15,19,4,41.93242,-87.65271
TA1309000039,4,19,false,28,21,-7,41.93258,-87.63642
TA1309000036,4,19,false,14,11,-3,41.93313,-87.64776
TA1307000006,4,19,false,6,7,1,41.93571,-87.6636
TA1307000052,4,19,false,15,12,-3,41.93628,-87.65266
TA1307000136,4,19,false,13,14,1,41.9365,-87.64755
TA1307000041,4,19,false,15,25,10,41.93669,-87.63683
13137,4,19,false,16,19,3,41.9376,-87.6441
15642,4,19,false,1,7,6,41.93843,-87.69801
KA17018068,4,19,false,5,1,-4,41.93935,-87.68327
TA1309000042,4,19,false,11,20,9,41.93937,-87.66836
13229,4,19,false,9,9,0,41.93946,-87.66376
TA1308000019,4,19,false,8,11,3,41.93973,-87.65886
13277,4,19,false,16,15,-1,41.9401,-87.64546
TA1307000134,4,19,false,20,24,4,41.94016,-87.65303
TA1309000049,4,19,false,22,27,5,41.94077,-87.63919
TA1307000138,4,19,false,5,8,3,41.94334,-87.67094
TA1309000025,4,19,false,25,27,2,41.94368,-87.64894
13071,4,19,false,7,14,7,41.94373,-87.66401
632,4,19,false,10,21,11,41.94453,-87.6547
13278,4,19,false,10,14,4,41.94553,-87.64644
13235,4,19,false,7,8,1,41.94814,-87.66396
13253,4,19,false,5,1,-4,41.9488,-87.67527
13325,4,19,false,10,7,-3,41.94907,-87.64863
TA1307000126,4,19,false,12,17,5,41.94936,-87.65451
TA1307000150,4,19,false,17,8,-9,41.94945,-87.64646
TA1307000127,4,19,false,8,10,2,41.9508,-87.65918
13323,4,19,false,8,9,1,41.95282,-87.65
TA1309000043,4,19,false,5,7,2,41.95417,-87.66434
13063,4,19,false,9,3,-6,41.95424,-87.65441
TA1308000022,4,19,false,5,13,8,41.95438,-87.64805
TA1307000149,4,19,false,3,9,6,41.95467,-87.67392
13379,4,19,false,8,12,4,41.95786,-87.6495
TA1309000027,4,19,false,5,6,1,41.9585,-87.65499
13389,4,19,false,7,7,0,41.961,-87.64958
TA1307000107,4,19,false,14,8,-6,41.96164,-87.65464
TA1308000012,4,19,false,33,17,-16,41.96398,-87.63818
13074,4,19,false,7,6,-1,41.96521,-87.6582
639,4,19,false,17,10,-7,41.96584,-87.64538
TA1309000014,4,19,false,4,10,6,41.96709,-87.66744
TA1309000066,4,19,false,6,9,3,41.9691,-87.67423
TA1309000041,4,19,false,5,4,-1,41.96951,-87.65471
KA1504000171,4,19,false,9,13,4,41.97161,-87.65016
TA1309000035,4,19,false,9,8,-1,41.97335,-87.66785
KA1504000146,4,19,false,7,5,-2,41.978,-87.66805
13109,4,19,false,4,7,3,41.97835,-87.65976
KA1504000151,4,19,false,5,2,-3,41.98359,-87.66916
KA1504000152,4,19,false,12,14,2,41.98403,-87.65231
15575,4,19,false,2,7,5,41.98975,-87.66014
15571,4,19,false,4,8,4,41.99478,-87.66028
KA1504000175,4,19,false,1,5,4,42.00797,-87.66549
KA1504000159,4,19,false,4,5,1,42.01059,-87.66241
KA1503000014,4,19,true,5,6,1,41.7851,-87.60108
KA1503000071,4,19,true,6,5,-1,41.79148,-87.59988
TA1309000063,4,19,true,1,5,4,41.79325,-87.5878
TA1308000009,4,19,true,6,9,3,41.79522,-87.58075
TA1307000164,4,19,true,4,7,3,41.79527,-87.59647
TA1309000037,4,19,true,11,6,-5,41.79957,-87.59474
KA1503000007,4,19,true,7,10,3,41.80242,-87.58689
TA1307000129,4,19,true,3,6,3,41.83104,-87.62683
13216,4,19,true,2,5,3,41.83473,-87.62581
13217,4,19,true,8,1,-7,41.83488,-87.61792
13215,4,19,true,10,4,-6,41.83634,-87.6135
TA1308000046,4,19,true,5,3,-2,41.83779,-87.65115
TA1309000055,4,19,true,5,7,2,41.8382,-87.64514
TA1307000048,4,19,true,8,7,-1,41.83855,-87.60821
TA1308000036,4,19,true,6,1,-5,41.83883,-87.62186
TA1307000139,4,19,true,10,16,6,41.84205,-87.61698
TA1307000005,4,19,true,3,9,6,41.84569,-87.6225
13075,4,19,true,1,7,6,41.8531,-87.63192
13089,4,19,true,8,4,-4,41.85497,-87.67567
15545,4,19,true,17,10,-7,41.85627,-87.61334
SL-013,4,19,true,5,3,-2,41.85659,-87.62755
SL-006,4,19,true,3,5,2,41.8568,-87.63387
13135,4,19,true,6,10,4,41.85753,-87.66157
13102,4,19,true,7,12,5,41.85762,-87.61942
13150,4,19,true,4,5,1,41.85783,-87.62455
13163,4,19,true,3,5,2,41.85808,-87.65108
13164,4,19,true,3,7,4,41.85818,-87.65648
SL-012,4,19,true,10,10,0,41.86038,-87.62581
TA1306000002,4,19,true,6,9,3,41.86238,-87.65108
TA1307000124,4,19,true,9,16,7,41.86411,-87.62372
TA1309000001,4,19,true,8,5,-3,41.86488,-87.64708
13431,4,19,true,15,9,-6,41.8661,-87.60728
WL-008,4,19,true,7,8,1,41.86712,-87.64108
TA1305000002,4,19,true,23,22,-1,41.86721,-87.62597
KA1706005007,4,19,true,10,7,-3,41.86749,-87.63219
SL-005,4,19,true,18,32,14,41.8679,-87.62304
644,4,19,true,5,12,7,41.86859,-87.68625
13139,4,19,true,11,12,1,41.86893,-87.65913
13160,4,19,true,11,13,2,41.86947,-87.65548
15550,4,19,true,7,6,-1,41.87024,-87.63947
TA1309000010,4,19,true,5,10,5,41.87074,-87.62574
SL-009,4,19,true,6,4,-2,41.87081,-87.63121
TA1309000064,4,19,true,5,4,-1,41.87127,-87.67369
TA1307000130,4,19,true,12,13,1,41.87178,-87.65103
TA1307000121,4,19,true,25,8,-17,41.87184,-87.64664
SL-008,4,19,true,19,22,3,41.87209,-87.62956
13332,4,19,true,11,15,4,41.87219,-87.6615
SL-011,4,19,true,2,8,6,41.87256,-87.63356
KA1504000104,4,19,true,6,2,-4,41.87296,-87.66912
TA1306000025,4,19,true,2,5,3,41.87464,-87.65703
13028,4,19,true,6,7,1,41.87475,-87.64981
SL-010,4,19,true,4,5,1,41.87501,-87.63309
15541,4,19,true,7,5,-2,41.8758,-87.62086
TA1305000009,4,19,true,5,3,-2,41.87593,-87.63068
624,4,19,true,9,7,-2,41.87626,-87.62923
13138,4,19,true,5,1,-4,41.87723,-87.63941
15539,4,19,true,6,8,2,41.87763,-87.64405
13158,4,19,true,8,5,-3,41.87764,-87.64957
13157,4,19,true,10,12,2,41.87773,-87.6548
TA1305000025,4,19,true,17,9,-8,41.87773,-87.63528
TA1309000002,4,19,true,4,9,5,41.87784,-87.62408
13206,4,19,true,7,12,5,41.87794,-87.66201
638,4,19,true,11,7,-4,41.87827,-87.64078
TA1305000005,4,19,true,5,1,-4,41.87924,-87.62975
13011,4,19,true,10,1,-9,41.87931,-87.63993
WL-011,4,19,true,7,6,-1,41.88034,-87.64273
13156,4,19,true,5,7,2,41.88042,-87.65554
13300,4,19,true,24,18,-6,41.88097,-87.61675
13008,4,19,true,20,9,-11,41.88105,-87.62408
TA1305000006,4,19,true,10,8,-2,41.88122,-87.6296
13056,4,19,true,7,1,-6,41.88168,-87.63951
TA1307000120,4,19,true,26,29,3,41.88188,-87.64879
13341,4,19,true,13,1,-12,41.88208,-87.63985
13036,4,19,true,6,4,-2,41.8821,-87.62513
TA1305000032,4,19,true,19,15,-4,41.88218,-87.64109
13006,4,19,true,2,5,3,41.88268,-87.63252
13353,4,19,true,7,10,3,41.88283,-87.6612
13409,4,19,true,6,8,2,41.8831,-87.6511
WL-012,4,19,true,13,8,-5,41.88337,-87.6412
13053,4,19,true,26,18,-8,41.88365,-87.64863
13001,4,19,true,9,3,-6,41.88397,-87.62459
13155,4,19,true,6,3,-3,41.88407,-87.65689
18062,4,19,true,5,9,4,41.88412,-87.65427
TA1306000010,4,19,true,22,8,-14,41.88419,-87.62961
TA1305000030,4,19,true,7,2,-5,41.88459,-87.63178
15535,4,19,true,14,9,-5,41.8846,-87.64455
TA1305000029,4,19,true,13,6,-7,41.88466,-87.62787
13263,4,19,true,14,12,-2,41.88467,-87.61952
TA1306000015,4,19,true,23,17,-6,41.88549,-87.65232
13021,4,19,true,13,9,-4,41.88559,-87.64184
TA1307000111,4,19,true,7,2,-5,41.88582,-87.63548
13073,4,19,true,1,8,7,41.88592,-87.66717
KA17018054,4,19,true,1,7,6,41.88595,-87.67701
KA1503000012,4,19,true,15,5,-10,41.88599,-87.63089
TA1305000011,4,19,true,13,15,2,41.886,-87.62418
15534,4,19,true,8,6,-2,41.88627,-87.61749
TA1308000029,4,19,true,6,10,4,41.88673,-87.62225
TA1307000131,4,19,true,13,6,-7,41.88688,-87.62606
KA1503000064,4,19,true,9,8,-1,41.88697,-87.61281
TA1305000022,4,19,true,17,21,4,41.88817,-87.63656
TA1306000003,4,19,true,20,32,12,41.88867,-87.64442
KA1503000043,4,19,true,31,14,-17,41.88918,-87.63851
13050,4,19,true,10,15,5,41.88919,-87.62775
TA1307000151,4,19,true,25,18,-7,41.88993,-87.63427
636,4,19,true,5,2,-3,41.88997,-87.63662
KA1503000044,4,19,true,4,5,1,41.89018,-87.6262
13427,4,19,true,6,4,-2,41.89054,-87.62205
13430,4,19,true,18,20,2,41.89077,-87.63169
TA1306000013,4,19,true,14,19,5,41.89083,-87.61852
RN-,4,19,true,13,10,-3,41.89102,-87.63546
TA1307000117,4,19,true,20,15,-5,41.89144,-87.62675
13033,4,19,true,18,16,-2,41.8916,-87.64835
13194,4,19,true,10,9,-1,41.8918,-87.65878
TA1305000003,4,19,true,18,25,7,41.89187,-87.62061
13022,4,19,true,31,23,-8,41.89227,-87.61205
TA1306000029,4,19,true,12,19,7,41.89256,-87.61449
13265,4,19,true,21,22,1,41.89383,-87.64172
13045,4,19,true,19,20,1,41.89403,-87.62931
13016,4,19,true,22,9,-13,41.89431,-87.62277
KA1503000041,4,19,true,14,5,-9,41.89452,-87.61798
13196,4,19,true,8,13,5,41.89455,-87.65345
TA1307000062,4,19,true,10,13,3,41.89466,-87.63839
TA1306000012,4,19,true,22,31,9,41.89475,-87.63438
KP1705001026,4,19,true,14,12,-2,41.89483,-87.6323
637,4,19,true,3,12,9,41.89563,-87.67209
13132,4,19,true,5,6,1,41.89573,-87.67718
15530,4,19,true,15,13,-2,41.89575,-87.62596
13247,4,19,true,7,6,-1,41.89597,-87.66775
TA1305000020,4,19,true,6,9,3,41.89636,-87.65406
13289,4,19,true,9,18,9,41.89638,-87.661
13303,4,19,true,9,8,-1,41.89672,-87.63088
13017,4,19,true,6,5,-1,41.89676,-87.6357
13338,4,19,true,7,2,-5,41.89697,-87.62173
TA1307000061,4,19,true,9,5,-4,41.89745,-87.62873
13034,4,19,true,11,3,-8,41.89754,-87.62352
TA1306000009,4,19,true,12,10,-2,41.89772,-87.64299
620,4,19,true,6,6,0,41.89817,-87.63754
15529,4,19,true,26,16,-10,41.89858,-87.62206
TA1307000128,4,19,true,17,24,7,41.89896,-87.6299
13248,4,19,true,2,5,3,41.89964,-87.66788
TA1306000011,4,19,true,9,7,-2,41.89994,-87.63443
KA1504000116,4,19,true,8,8,0,41.90023,-87.64299
17660,4,19,true,3,6,3,41.90036,-87.69671
13290,4,19,true,3,10,7,41.90069,-87.66259
13042,4,19,true,31,28,-3,41.90097,-87.62377
TA1307000070,4,19,true,3,8,5,41.90133,-87.67742
KA1504000133,4,19,true,25,24,-1,41.90234,-87.62773
13241,4,19,true,3,6,3,41.9029,-87.68731
TA1306000006,4,19,true,5,9,4,41.90292,-87.63772
TA1307000039,4,19,true,48,48,0,41.90294,-87.63137
658,4,19,true,4,8,4,41.903,-87.6838
13256,4,19,true,2,5,3,41.90302,-87.69749
TA1305000034,4,19,true,9,8,-1,41.90313,-87.67391
KA1504000135,4,19,true,33,54,21,41.90319,-87.63439
13136,4,19,true,10,17,7,41.90326,-87.67845
13061,4,19,true,18,22,4,41.90342,-87.66779
KA1504000079,4,19,true,14,15,1,41.9035,-87.64334
TA1307000115,4,19,true,8,8,0,41.9046,-87.64056
TA1308000049,4,19,true,19,27,8,41.90672,-87.6349
KA1504000134,4,19,true,12,14,2,41.90687,-87.6262
13224,4,19,true,8,6,-2,41.90706,-87.66725
TA1307000143,4,19,true,4,12,8,41.90762,-87.63854
13221,4,19,true,13,8,-5,41.90765,-87.67254
13245,4,19,true,5,4,-1,41.90777,-87.68586
TA1309000024,4,19,true,11,17,6,41.908,-87.63152
TA1305000041,4,19,true,15,14,-1,41.9094,-87.67769
331,4,19,true,23,21,-2,41.90965,-87.64812
TA1305000037,4,19,true,6,7,1,41.91018,-87.67003
TA1306000008,4,19,true,8,14,6,41.9102,-87.6435
TA1308000005,4,19,true,5,4,-1,41.91042,-87.68238
13154,4,19,true,13,10,-3,41.91054,-87.65312
13058,4,19,true,8,9,1,41.91059,-87.64942
TA1307000038,4,19,true,5,16,11,41.91138,-87.63868
LF-005,4,19,true,56,120,64,41.91172,-87.62681
TA1308000050,4,19,true,31,23,-8,41.91211,-87.6347
13243,4,19,true,7,11,4,41.91262,-87.6814
TA1306000032,4,19,true,11,6,-5,41.9137,-87.65285
TA1307000166,4,19,true,13,9,-4,41.91386,-87.64877
18067,4,19,true,6,3,-3,41.9146,-87.66796
TA1306000007,4,19,true,7,9,2,41.91469,-87.64333
13068,4,19,true,4,8,4,41.91554,-87.68703
13179,4,19,true,22,26,4,41.9157,-87.63461
13133,4,19,true,22,12,-10,41.91598,-87.67733
TA1305000039,4,19,true,6,4,-2,41.9163,-87.66749
15651,4,19,true,8,2,-6,41.91752,-87.70181
13266,4,19,true,3,5,2,41.91774,-87.69142
TA1309000029,4,19,true,9,4,-5,41.9178,-87.68245
TA1309000006,4,19,true,11,16,5,41.91809,-87.64375
TA1307000163,4,19,true,17,8,-9,41.91821,-87.65696
13146,4,19,true,18,26,8,41.91831,-87.63629
13059,4,19,true,18,25,7,41.91845,-87.65222
13192,4,19,true,17,17,0,41.91995,-87.64884
13288,4,19,true,3,8,5,41.92008,-87.67788
13242,4,19,true,3,5,2,41.92021,-87.69266
TA1309000030,4,19,true,10,9,-1,41.92077,-87.66372
TA1309000033,4,19,true,18,11,-7,41.92158,-87.65381
13193,4,19,true,16,24,8,41.92182,-87.64412
13191,4,19,true,12,17,5,41.92217,-87.63891
13084,4,19,true,5,4,-1,41.92268,-87.69715
LP-,4,19,true,2,23,21,41.92396,-87.63584
TA1307000001,4,19,true,12,7,-5,41.92535,-87.66581
TA1306000026,4,19,true,12,7,-5,41.92558,-87.65842
TA1306000016,4,19,true,12,8,-4,41.9256,-87.65371
TA1309000019,4,19,true,24,26,2,41.92586,-87.63897
TA1309000058,4,19,true,26,23,-3,41.92591,-87.64927
TA1308000001,4,19,true,27,36,9,41.92627,-87.63086
15646,4,19,true,2,6,4,41.92668,-87.6977
TA1309000023,4,19,true,13,18,5,41.9287,-87.65383
TA1307000113,4,19,true,11,11,0,41.92878,-87.66391
13296,4,19,true,1,5,4,41.92883,-87.66852
TA1309000059,4,19,true,2,11,9,41.92889,-87.65898
TA1309000061,4,19,true,20,22,2,41.92915,-87.64909
TA1305000014,4,19,true,18,19,1,41.92956,-87.64313
13085,4,19,true,6,11,5,41.92958,-87.70789
TA1307000142,4,19,true,17,25,8,41.93125,-87.64432
13276,4,19,true,18,17,-1,41.93132,-87.63874
13271,4,19,true,1,9,8,41.93192,-87.67784
TA1307000064,4,19,true,17,13,-4,41.93222,-87.65864
TA1306000014,4,19,true,15,22,7,41.93242,-87.65271
TA1309000039,4,19,true,23,27,4,41.93258,-87.63642
13294,4,19,true,6,6,0,41.9326,-87.66595
TA1309000036,4,19,true,22,21,-1,41.93313,-87.64776
TA1307000006,4,19,true,8,8,0,41.93571,-87.6636
13268,4,19,true,4,5,1,41.93588,-87.67843
TA1307000052,4,19,true,7,12,5,41.93628,-87.65266
TA1307000136,4,19,true,6,17,11,41.9365,-87.64755
TA1307000041,4,19,true,16,20,4,41.93669,-87.63683
13137,4,19,true,26,29,3,41.9376,-87.6441
TA1309000042,4,19,true,8,6,-2,41.93937,-87.66836
TA1308000019,4,19,true,6,12,6,41.93973,-87.65886
13277,4,19,true,11,19,8,41.9401,-87.64546
TA1307000134,4,19,true,18,25,7,41.94016,-87.65303
TA1309000049,4,19,true,17,19,2,41.94077,-87.63919
TA1307000138,4,19,true,7,5,-2,41.94334,-87.67094
TA1309000025,4,19,true,13,20,7,41.94368,-87.64894
13071,4,19,true,14,19,5,41.94373,-87.66401
632,4,19,true,12,11,-1,41.94453,-87.6547
13278,4,19,true,11,22,11,41.94553,-87.64644
15632,4,19,true,2,5,3,41.94664,-87.69463
13235,4,19,true,16,17,1,41.94814,-87.66396
13325,4,19,true,15,17,2,41.94907,-87.64863
TA1307000126,4,19,true,14,14,0,41.94936,-87.65451
TA1307000150,4,19,true,23,21,-2,41.94945,-87.64646
13319,4,19,true,3,6,3,41.95069,-87.6687
TA1307000127,4,19,true,10,11,1,41.9508,-87.65918
13323,4,19,true,12,14,2,41.95282,-87.65
13063,4,19,true,10,5,-5,41.95424,-87.65441
TA1308000022,4,19,true,6,8,2,41.95438,-87.64805
TA1309000026,4,19,true,11,5,-6,41.95601,-87.6802
TA1308000047,4,19,true,5,5,0,41.95709,-87.6642
13379,4,19,true,8,20,12,41.95786,-87.6495
TA1309000018,4,19,true,3,5,2,41.95791,-87.67357
TA1309000027,4,19,true,3,11,8,41.9585,-87.65499
13389,4,19,true,8,17,9,41.961,-87.64958
TA1307000144,4,19,true,5,5,0,41.96142,-87.6762
KA1503000022,4,19,true,6,6,0,41.96158,-87.66609
TA1307000107,4,19,true,13,13,0,41.96164,-87.65464
TA1307000156,4,19,true,8,10,2,41.96301,-87.68479
TA1308000012,4,19,true,21,14,-7,41.96398,-87.63818
13074,4,19,true,10,6,-4,41.96521,-87.6582
639,4,19,true,19,8,-11,41.96584,-87.64538
TA1307000140,4,19,true,5,6,1,41.96643,-87.68865
TA1309000014,4,19,true,6,12,6,41.96709,-87.66744
TA1307000158,4,19,true,5,3,-2,41.9671,-87.67904
TA1307000119,4,19,true,5,3,-2,41.96796,-87.65
TA1308000021,4,19,true,3,6,3,41.96883,-87.65765
TA1309000066,4,19,true,9,6,-3,41.9691,-87.67423
TA1309000041,4,19,true,6,5,-1,41.96951,-87.65471
KA1504000171,4,19,true,8,11,3,41.97161,-87.65016
TA1309000035,4,19,true,5,11,6,41.97335,-87.66785
13108,4,19,true,5,6,1,41.97379,-87.65971
KA1504000160,4,19,true,7,2,-5,41.97564,-87.70143
KA1504000146,4,19,true,4,7,3,41.978,-87.66805
13109,4,19,true,8,10,2,41.97835,-87.65976
KA1504000152,4,19,true,10,8,-2,41.98403,-87.65231
15575,4,19,true,7,9,2,41.98975,-87.66014
15571,4,19,true,3,6,3,41.99478,-87.66028
RP-009,4,19,true,1,5,4,42.00107,-87.66122
660,4,19,true,3,9,6,42.00458,-87.66143
KA1504000175,4,19,true,7,2,-5,42.00797,-87.66549
KA1503000029,4,20,false,7,3,-4,41.77364,-87.56747
KA1503000014,4,20,false,2,6,4,41.7851,-87.60108
TA1308000009,4,20,false,10,8,-2,41.79522,-87.58075
TA1307000164,4,20,false,3,8,5,41.79527,-87.59647
KA1503000059,4,20,false,1,5,4,41.79952,-87.58643
TA1309000037,4,20,false,5,6,1,41.79957,-87.59474
KA1503000007,4,20,false,8,6,-2,41.80242,-87.58689
13398,4,20,false,4,7,3,41.80256,-87.59035
13216,4,20,false,1,6,5,41.83473,-87.62581
TA1307000048,4,20,false,10,17,7,41.83855,-87.60821
TA1307000139,4,20,false,7,1,-6,41.84205,-87.61698
13075,4,20,false,12,10,-2,41.8531,-87.63192
15546,4,20,false,3,5,2,41.85416,-87.61916
13102,4,20,false,4,5,1,41.85762,-87.61942
13150,4,20,false,5,5,0,41.85783,-87.62455
13164,4,20,false,1,6,5,41.85818,-87.65648
SL-012,4,20,false,6,3,-3,41.86038,-87.62581
TA1307000124,4,20,false,10,9,-1,41.86411,-87.62372
13431,4,20,false,15,10,-5,41.8661,-87.60728
TA1305000002,4,20,false,11,15,4,41.86721,-87.62597
15544,4,20,false,16,12,-4,41.86723,-87.61536
KA1706005007,4,20,false,5,5,0,41.86749,-87.63219
SL-005,4,20,false,23,27,4,41.8679,-87.62304
TA1309000010,4,20,false,12,9,-3,41.87074,-87.62574
SL-008,4,20,false,12,20,8,41.87209,-87.62956
SL-011,4,20,false,2,11,9,41.87256,-87.63356
623,4,20,false,17,29,12,41.87272,-87.62399
SL-007,4,20,false,6,6,0,41.87404,-87.6277
TA1306000025,4,20,false,2,5,3,41.87464,-87.65703
15541,4,20,false,30,40,10,41.8758,-87.62086
TA1305000010,4,20,false,4,10,6,41.87623,-87.62444
13158,4,20,false,4,10,6,41.87764,-87.64957
13157,4,20,false,9,4,-5,41.87773,-87.6548
TA1305000025,4,20,false,9,2,-7,41.87773,-87.63528
TA1309000002,4,20,false,6,6,0,41.87784,-87.62408
13206,4,20,false,6,1,-5,41.87794,-87.66201
638,4,20,false,5,4,-1,41.87827,-87.64078
13011,4,20,false,3,7,4,41.87931,-87.63993
WL-011,4,20,false,1,7,6,41.88034,-87.64273
13300,4,20,false,49,36,-13,41.88097,-87.61675
13008,4,20,false,51,42,-9,41.88105,-87.62408
13056,4,20,false,2,9,7,41.88168,-87.63951
TA1307000120,4,20,false,7,14,7,41.88188,-87.64879
13036,4,20,false,7,4,-3,41.8821,-87.62513
TA1305000032,4,20,false,3,10,7,41.88218,-87.64109
654,4,20,false,5,2,-3,41.88307,-87.65698
13409,4,20,false,6,4,-2,41.8831,-87.6511
WL-012,4,20,false,8,4,-4,41.88337,-87.6412
13053,4,20,false,16,11,-5,41.88365,-87.64863
13001,4,20,false,5,6,1,41.88397,-87.62459
TA1305000030,4,20,false,13,6,-7,41.88459,-87.63178
TA1305000029,4,20,false,6,15,9,41.88466,-87.62787
13263,4,20,false,20,11,-9,41.88467,-87.61952
TA1306000015,4,20,false,11,10,-1,41.88549,-87.65232
13021,4,20,false,2,7,5,41.88559,-87.64184
TA1307000111,4,20,false,2,5,3,41.88582,-87.63548
KA1503000012,4,20,false,4,9,5,41.88599,-87.63089
TA1305000011,4,20,false,17,19,2,41.886,-87.62418
15534,4,20,false,4,12,8,41.88627,-87.61749
TA1308000029,4,20,false,4,7,3,41.88673,-87.62225
TA1307000131,4,20,false,4,9,5,41.88688,-87.62606
KA1503000064,4,20,false,32,8,-24,41.88697,-87.61281
TA1305000022,4,20,false,7,8,1,41.88817,-87.63656
TA1306000003,4,20,false,7,11,4,41.88867,-87.64442
KA1503000043,4,20,false,3,10,7,41.88918,-87.63851
13050,4,20,false,15,23,8,41.88919,-87.62775
TA1307000151,4,20,false,11,14,3,41.88993,-87.63427
13427,4,20,false,6,4,-2,41.89054,-87.62205
13430,4,20,false,14,12,-2,41.89077,-87.63169
TA1306000013,4,20,false,23,16,-7,41.89083,-87.61852
RN-,4,20,false,10,12,2,41.89102,-87.63546
TA1307000117,4,20,false,21,18,-3,41.89144,-87.62675
13033,4,20,false,8,6,-2,41.8916,-87.64835
TA1305000003,4,20,false,8,10,2,41.89187,-87.62061
13022,4,20,false,101,101,0,41.89227,-87.61205
TA1306000029,4,20,false,12,15,3,41.89256,-87.61449
13265,4,20,false,6,9,3,41.89383,-87.64172
13045,4,20,false,22,17,-5,41.89403,-87.62931
KA1503000041,4,20,false,6,9,3,41.89452,-87.61798
13196,4,20,false,8,5,-3,41.89455,-87.65345
TA1307000062,4,20,false,3,5,2,41.89466,-87.63839
TA1306000012,4,20,false,12,20,8,41.89475,-87.63438
KP1705001026,4,20,false,9,8,-1,41.89483,-87.6323
13132,4,20,false,2,6,4,41.89573,-87.67718
15530,4,20,false,13,9,-4,41.89575,-87.62596
TA1305000020,4,20,false,3,7,4,41.89636,-87.65406
13289,4,20,false,5,2,-3,41.89638,-87.661
13303,4,20,false,12,10,-2,41.89672,-87.63088
TA1307000061,4,20,false,1,7,6,41.89745,-87.62873
13034,4,20,false,17,11,-6,41.89754,-87.62352
620,4,20,false,5,3,-2,41.89817,-87.63754
15529,4,20,false,13,6,-7,41.89858,-87.62206
TA1307000128,4,20,false,11,11,0,41.89896,-87.6299
TA1306000011,4,20,false,6,12,6,41.89994,-87.63443
13042,4,20,false,32,25,-7,41.90097,-87.62377
TA1307000070,4,20,false,3,5,2,41.90133,-87.67742
KA1504000133,4,20,false,18,22,4,41.90234,-87.62773
13241,4,20,false,1,5,4,41.9029,-87.68731
TA1306000006,4,20,false,5,1,-4,41.90292,-87.63772
TA1307000039,4,20,false,20,33,13,41.90294,-87.63137
TA1305000034,4,20,false,3,8,5,41.90313,-87.67391
KA1504000135,4,20,false,19,26,7,41.90319,-87.63439
13136,4,20,false,6,7,1,41.90326,-87.67845
13061,4,20,false,7,7,0,41.90342,-87.66779
KA1504000079,4,20,false,6,5,-1,41.9035,-87.64334
TA1308000049,4,20,false,20,17,-3,41.90672,-87.6349
KA1504000134,4,20,false,3,8,5,41.90687,-87.6262
13224,4,20,false,4,12,8,41.90706,-87.66725
13221,4,20,false,10,10,0,41.90765,-87.67254
TA1309000024,4,20,false,8,14,6,41.908,-87.63152
TA1305000041,4,20,false,17,13,-4,41.9094,-87.67769
331,4,20,false,12,9,-3,41.90965,-87.64812
TA1305000037,4,20,false,2,5,3,41.91018,-87.67003
TA1306000008,4,20,false,2,6,4,41.9102,-87.6435
TA1308000005,4,20,false,1,7,6,41.91042,-87.68238
13154,4,20,false,6,2,-4,41.91054,-87.65312
13058,4,20,false,5,5,0,41.91059,-87.64942
TA1307000038,4,20,false,14,10,-4,41.91138,-87.63868
LF-005,4,20,false,117,88,-29,41.91172,-87.62681
13128,4,20,false,9,9,0,41.91197,-87.63197
TA1308000050,4,20,false,31,22,-9,41.91211,-87.6347
13243,4,20,false,7,11,4,41.91262,-87.6814
TA1307000166,4,20,false,4,8,4,41.91386,-87.64877
18017,4,20,false,6,3,-3,41.91416,-87.71676
18067,4,20,false,2,9,7,41.9146,-87.66796
TA1306000007,4,20,false,3,5,2,41.91469,-87.64333
13179,4,20,false,28,31,3,41.9157,-87.63461
13133,4,20,false,8,1,-7,41.91598,-87.67733
15651,4,20,false,2,12,10,41.91752,-87.70181
TA1309000006,4,20,false,3,13,10,41.91809,-87.64375
13146,4,20,false,13,13,0,41.91831,-87.63629
13059,4,20,false,12,13,1,41.91845,-87.65222
13192,4,20,false,7,12,5,41.91995,-87.64884
TA1309000030,4,20,false,10,5,-5,41.92077,-87.66372
TA1309000033,4,20,false,14,11,-3,41.92158,-87.65381
13193,4,20,false,31,31,0,41.92182,-87.64412
13191,4,20,false,6,6,0,41.92217,-87.63891
13084,4,20,false,7,7,0,41.92268,-87.69715
TA1307000001,4,20,false,5,10,5,41.92535,-87.66581
TA1306000026,4,20,false,4,9,5,41.92558,-87.65842
TA1306000016,4,20,false,12,9,-3,41.9256,-87.65371
TA1309000019,4,20,false,26,25,-1,41.92586,-87.63897
TA1309000058,4,20,false,14,13,-1,41.92591,-87.64927
TA1308000001,4,20,false,41,34,-7,41.92627,-87.63086
13124,4,20,false,16,12,-4,41.92675,-87.63444
TA1309000023,4,20,false,12,17,5,41.9287,-87.65383
TA1307000113,4,20,false,5,10,5,41.92878,-87.66391
13296,4,20,false,3,6,3,41.92883,-87.66852
TA1309000059,4,20,false,4,10,6,41.92889,-87.65898
TA1309000061,4,20,false,12,10,-2,41.92915,-87.64909
TA1308000031,4,20,false,2,5,3,41.92946,-87.68417
TA1305000014,4,20,false,12,13,1,41.92956,-87.64313
13085,4,20,false,3,6,3,41.92958,-87.70789
TA1307000142,4,20,false,14,16,2,41.93125,-87.64432
13276,4,20,false,11,19,8,41.93132,-87.63874
TA1307000064,4,20,false,9,1,-8,41.93222,-87.65864
TA1306000014,4,20,false,11,10,-1,41.93242,-87.65271
TA1309000039,4,20,false,20,14,-6,41.93258,-87.63642
TA1309000036,4,20,false,6,11,5,41.93313,-87.64776
TA1307000006,4,20,false,3,9,6,41.93571,-87.6636
TA1307000052,4,20,false,11,16,5,41.93628,-87.65266
TA1307000136,4,20,false,19,11,-8,41.9365,-87.64755
TA1307000041,4,20,false,20,17,-3,41.93669,-87.63683
13137,4,20,false,13,17,4,41.9376,-87.6441
TA1309000042,4,20,false,9,2,-7,41.93937,-87.66836
13229,4,20,false,10,10,0,41.93946,-87.66376
TA1308000019,4,20,false,9,14,5,41.93973,-87.65886
13277,4,20,false,7,15,8,41.9401,-87.64546
TA1307000134,4,20,false,9,16,7,41.94016,-87.65303
TA1309000049,4,20,false,9,14,5,41.94077,-87.63919
TA1307000138,4,20,false,1,6,5,41.94334,-87.67094
TA1309000025,4,20,false,17,10,-7,41.94368,-87.64894
13071,4,20,false,8,11,3,41.94373,-87.66401
632,4,20,false,12,16,4,41.94453,-87.6547
13278,4,20,false,10,8,-2,41.94553,-87.64644
13253,4,20,false,5,2,-3,41.9488,-87.67527
13325,4,20,false,8,11,3,41.94907,-87.64863
TA1307000126,4,20,false,11,9,-2,41.94936,-87.65451
TA1307000150,4,20,false,7,6,-1,41.94945,-87.64646
13319,4,20,false,5,6,1,41.95069,-87.6687
TA1307000127,4,20,false,16,13,-3,41.9508,-87.65918
13323,4,20,false,6,12,6,41.95282,-87.65
13063,4,20,false,9,5,-4,41.95424,-87.65441
TA1308000022,4,20,false,6,9,3,41.95438,-87.64805
13379,4,20,false,6,6,0,41.95786,-87.6495
TA1309000027,4,20,false,5,8,3,41.9585,-87.65499
13389,4,20,false,2,10,8,41.961,-87.64958
TA1307000144,4,20,false,3,5,2,41.96142,-87.6762
TA1307000107,4,20,false,8,13,5,41.96164,-87.65464
TA1308000012,4,20,false,38,18,-20,41.96398,-87.63818
13074,4,20,false,3,9,6,41.96521,-87.6582
639,4,20,false,1,7,6,41.96584,-87.64538
TA1309000014,4,20,false,6,8,2,41.96709,-87.66744
TA1307000119,4,20,false,8,5,-3,41.96796,-87.65
TA1309000066,4,20,false,7,2,-5,41.9691,-87.67423
KA1504000171,4,20,false,9,10,1,41.97161,-87.65016
13109,4,20,false,7,3,-4,41.97835,-87.65976
KA1504000152,4,20,false,3,10,7,41.98403,-87.65231
15575,4,20,false,8,3,-5,41.98975,-87.66014
15571,4,20,false,6,6,0,41.99478,-87.66028
RP-009,4,20,false,3,8,5,42.00107,-87.66122
KA1503000014,4,20,true,4,6,2,41.7851,-87.60108
KA1503000071,4,20,true,5,2,-3,41.79148,-87.59988
TA1307000164,4,20,true,6,2,-4,41.79527,-87.59647
TA1309000037,4,20,true,5,9,4,41.79957,-87.59474
KA1503000007,4,20,true,2,7,5,41.80242,-87.58689
13216,4,20,true,9,7,-2,41.83473,-87.62581
13217,4,20,true,6,12,6,41.83488,-87.61792
13215,4,20,true,4,5,1,41.83634,-87.6135
TA1307000048,4,20,true,8,12,4,41.83855,-87.60821
TA1307000139,4,20,true,11,10,-1,41.84205,-87.61698
13075,4,20,true,3,5,2,41.8531,-87.63192
15545,4,20,true,19,19,0,41.85627,-87.61334
13135,4,20,true,5,6,1,41.85753,-87.66157
13102,4,20,true,4,12,8,41.85762,-87.61942
13164,4,20,true,2,7,5,41.85818,-87.65648
TA1307000124,4,20,true,1,7,6,41.86411,-87.62372
13354,4,20,true,5,1,-4,41.86524,-87.66651
13431,4,20,true,12,13,1,41.8661,-87.60728
WL-008,4,20,true,5,6,1,41.86712,-87.64108
TA1305000002,4,20,true,20,16,-4,41.86721,-87.62597
KA1706005007,4,20,true,9,6,-3,41.86749,-87.63219
SL-005,4,20,true,9,21,12,41.8679,-87.62304
644,4,20,true,2,10,8,41.86859,-87.68625
13139,4,20,true,3,12,9,41.86893,-87.65913
13160,4,20,true,4,6,2,41.86947,-87.65548
15550,4,20,true,8,2,-6,41.87024,-87.63947
TA1309000010,4,20,true,15,15,0,41.87074,-87.62574
TA1307000130,4,20,true,6,4,-2,41.87178,-87.65103
TA1307000121,4,20,true,8,2,-6,41.87184,-87.64664
SL-008,4,20,true,9,8,-1,41.87209,-87.62956
13332,4,20,true,6,18,12,41.87219,-87.6615
SL-011,4,20,true,6,1,-5,41.87256,-87.63356
SL-007,4,20,true,7,2,-5,41.87404,-87.6277
TA1306000025,4,20,true,6,9,3,41.87464,-87.65703
15668,4,20,true,1,5,4,41.87471,-87.68642
13028,4,20,true,3,5,2,41.87475,-87.64981
15541,4,20,true,11,8,-3,41.8758,-87.62086
624,4,20,true,4,5,1,41.87626,-87.62923
15539,4,20,true,4,7,3,41.87763,-87.64405
13158,4,20,true,7,13,6,41.87764,-87.64957
13157,4,20,true,9,14,5,41.87773,-87.6548
TA1305000025,4,20,true,5,10,5,41.87773,-87.63528
13206,4,20,true,6,6,0,41.87794,-87.66201
KA1503000015,4,20,true,9,6,-3,41.87948,-87.6257
15667,4,20,true,16,4,-12,41.8798,-87.68609
WL-011,4,20,true,4,6,2,41.88034,-87.64273
13300,4,20,true,15,12,-3,41.88097,-87.61675
13008,4,20,true,23,7,-16,41.88105,-87.62408
TA1305000006,4,20,true,4,5,1,41.88122,-87.6296
13056,4,20,true,8,3,-5,41.88168,-87.63951
TA1307000120,4,20,true,10,9,-1,41.88188,-87.64879
13036,4,20,true,5,4,-1,41.8821,-87.62513
TA1305000032,4,20,true,10,11,1,41.88218,-87.64109
13006,4,20,true,5,4,-1,41.88268,-87.63252
13053,4,20,true,13,10,-3,41.88365,-87.64863
13001,4,20,true,5,2,-3,41.88397,-87.62459
18062,4,20,true,5,3,-2,41.88412,-87.65427
TA1306000010,4,20,true,11,6,-5,41.88419,-87.62961
TA1305000030,4,20,true,5,5,0,41.88459,-87.63178
15535,4,20,true,14,10,-4,41.8846,-87.64455
TA1305000029,4,20,true,10,8,-2,41.88466,-87.62787
13263,4,20,true,11,10,-1,41.88467,-87.61952
TA1306000015,4,20,true,17,4,-13,41.88549,-87.65232
13021,4,20,true,8,6,-2,41.88559,-87.64184
TA1307000111,4,20,true,5,5,0,41.88582,-87.63548
13073,4,20,true,5,4,-1,41.88592,-87.66717
KA1503000012,4,20,true,7,4,-3,41.88599,-87.63089
TA1305000011,4,20,true,5,2,-3,41.886,-87.62418
15534,4,20,true,2,13,11,41.88627,-87.61749
TA1308000029,4,20,true,5,4,-1,41.88673,-87.62225
KA1503000064,4,20,true,12,10,-2,41.88697,-87.61281
TA1305000022,4,20,true,10,8,-2,41.88817,-87.63656
TA1306000003,4,20,true,14,20,6,41.88867,-87.64442
KA1503000043,4,20,true,15,15,0,41.88918,-87.63851
13050,4,20,true,7,9,2,41.88919,-87.62775
TA1307000151,4,20,true,19,14,-5,41.88993,-87.63427
13427,4,20,true,5,3,-2,41.89054,-87.62205
13430,4,20,true,11,14,3,41.89077,-87.63169
TA1306000013,4,20,true,18,12,-6,41.89083,-87.61852
RN-,4,20,true,13,12,-1,41.89102,-87.63546
TA1307000117,4,20,true,16,21,5,41.89144,-87.62675
13033,4,20,true,15,6,-9,41.8916,-87.64835
13194,4,20,true,6,8,2,41.8918,-87.65878
TA1305000003,4,20,true,10,11,1,41.89187,-87.62061
643,4,20,true,2,5,3,41.89203,-87.68939
13022,4,20,true,26,35,9,41.89227,-87.61205
TA1306000029,4,20,true,12,10,-2,41.89256,-87.61449
13265,4,20,true,17,17,0,41.89383,-87.64172
13045,4,20,true,9,20,11,41.89403,-87.62931
13016,4,20,true,11,5,-6,41.89431,-87.62277
KA1503000041,4,20,true,10,9,-1,41.89452,-87.61798
TA1307000062,4,20,true,12,14,2,41.89466,-87.63839
TA1306000012,4,20,true,18,28,10,41.89475,-87.63438
KP1705001026,4,20,true,10,11,1,41.89483,-87.6323
637,4,20,true,1,7,6,41.89563,-87.67209
15530,4,20,true,11,6,-5,41.89575,-87.62596
TA1305000020,4,20,true,2,12,10,41.89636,-87.65406
13289,4,20,true,9,10,1,41.89638,-87.661
13303,4,20,true,3,12,9,41.89672,-87.63088
13017,4,20,true,5,5,0,41.89676,-87.6357
TA1307000061,4,20,true,5,5,0,41.89745,-87.62873
TA1306000009,4,20,true,7,1,-6,41.89772,-87.64299
15529,4,20,true,12,13,1,41.89858,-87.62206
TA1307000128,4,20,true,9,16,7,41.89896,-87.6299
657,4,20,true,2,5,3,41.89918,-87.6722
13248,4,20,true,4,13,9,41.89964,-87.66788
TA1306000011,4,20,true,7,17,10,41.89994,-87.63443
KA1504000116,4,20,true,5,3,-2,41.90023,-87.64299
13290,4,20,true,6,7,1,41.90069,-87.66259
13042,4,20,true,33,11,-22,41.90097,-87.62377
KA1504000133,4,20,true,12,9,-3,41.90234,-87.62773
13241,4,20,true,1,5,4,41.9029,-87.68731
TA1307000039,4,20,true,19,26,7,41.90294,-87.63137
TA1305000034,4,20,true,2,6,4,41.90313,-87.67391
KA1504000135,4,20,true,20,18,-2,41.90319,-87.63439
13136,4,20,true,5,11,6,41.90326,-87.67845
13061,4,20,true,10,13,3,41.90342,-87.66779
KA1504000079,4,20,true,15,9,-6,41.9035,-87.64334
TA1308000049,4,20,true,11,16,5,41.90672,-87.6349
KA1504000134,4,20,true,10,8,-2,41.90687,-87.6262
13224,4,20,true,4,6,2,41.90706,-87.66725
13221,4,20,true,7,10,3,41.90765,-87.67254
TA1309000024,4,20,true,9,10,1,41.908,-87.63152
TA1305000041,4,20,true,8,18,10,41.9094,-87.67769
331,4,20,true,20,3,-17,41.90965,-87.64812
TA1306000008,4,20,true,1,10,9,41.9102,-87.6435
13154,4,20,true,5,6,1,41.91054,-87.65312
13058,4,20,true,6,2,-4,41.91059,-87.64942
TA1307000038,4,20,true,6,6,0,41.91138,-87.63868
LF-005,4,20,true,70,49,-21,41.91172,-87.62681
13128,4,20,true,10,11,1,41.91197,-87.63197
TA1308000050,4,20,true,25,23,-2,41.91211,-87.6347
13243,4,20,true,4,5,1,41.91262,-87.6814
TA1309000032,4,20,true,5,1,-4,41.91293,-87.66417
TA1306000032,4,20,true,9,8,-1,41.9137,-87.65285
TA1307000166,4,20,true,9,11,2,41.91386,-87.64877
TA1306000007,4,20,true,1,10,9,41.91469,-87.64333
13068,4,20,true,4,5,1,41.91554,-87.68703
13179,4,20,true,20,20,0,41.9157,-87.63461
13266,4,20,true,3,5,2,41.91774,-87.69142
TA1309000029,4,20,true,2,5,3,41.9178,-87.68245
TA1309000006,4,20,true,10,12,2,41.91809,-87.64375
TA1307000163,4,20,true,8,6,-2,41.91821,-87.65696
13146,4,20,true,16,16,0,41.91831,-87.63629
13059,4,20,true,11,13,2,41.91845,-87.65222
13192,4,20,true,7,16,9,41.91995,-87.64884
13242,4,20,true,3,6,3,41.92021,-87.69266
TA1309000030,4,20,true,7,1,-6,41.92077,-87.66372
TA1309000033,4,20,true,18,8,-10,41.92158,-87.65381
13193,4,20,true,20,26,6,41.92182,-87.64412
13191,4,20,true,8,18,10,41.92217,-87.63891
13084,4,20,true,6,6,0,41.92268,-87.69715
LP-,4,20,true,6,9,3,41.92396,-87.63584
TA1307000001,4,20,true,5,8,3,41.92535,-87.66581
TA1306000026,4,20,true,5,9,4,41.92558,-87.65842
TA1306000016,4,20,true,13,4,-9,41.9256,-87.65371
TA1309000019,4,20,true,11,34,23,41.92586,-87.63897
TA1309000058,4,20,true,11,12,1,41.92591,-87.64927
TA1308000001,4,20,true,37,25,-12,41.92627,-87.63086
TA1309000023,4,20,true,11,14,3,41.9287,-87.65383
TA1307000113,4,20,true,3,9,6,41.92878,-87.66391
13296,4,20,true,3,5,2,41.92883,-87.66852
TA1309000059,4,20,true,1,5,4,41.92889,-87.65898
TA1309000061,4,20,true,11,11,0,41.92915,-87.64909
TA1305000014,4,20,true,11,10,-1,41.92956,-87.64313
TA1307000142,4,20,true,12,18,6,41.93125,-87.64432
13276,4,20,true,13,13,0,41.93132,-87.63874
TA1307000064,4,20,true,4,8,4,41.93222,-87.65864
TA1306000014,4,20,true,7,9,2,41.93242,-87.65271
TA1309000039,4,20,true,17,16,-1,41.93258,-87.63642
13294,4,20,true,6,6,0,41.9326,-87.66595
TA1309000036,4,20,true,10,17,7,41.93313,-87.64776
TA1307000006,4,20,true,4,8,4,41.93571,-87.6636
13268,4,20,true,9,9,0,41.93588,-87.67843
TA1307000052,4,20,true,13,7,-6,41.93628,-87.65266
TA1307000136,4,20,true,10,17,7,41.9365,-87.64755
TA1307000041,4,20,true,13,16,3,41.93669,-87.63683
13137,4,20,true,20,22,2,41.9376,-87.6441
15642,4,20,true,1,5,4,41.93843,-87.69801
KA17018068,4,20,true,5,2,-3,41.93935,-87.68327
TA1309000042,4,20,true,6,6,0,41.93937,-87.66836
TA1308000019,4,20,true,10,11,1,41.93973,-87.65886
13277,4,20,true,3,10,7,41.9401,-87.64546
TA1307000134,4,20,true,17,14,-3,41.94016,-87.65303
TA1309000049,4,20,true,13,11,-2,41.94077,-87.63919
15634,4,20,true,2,5,3,41.94304,-87.68729
TA1307000138,4,20,true,6,7,1,41.94334,-87.67094
TA1309000025,4,20,true,7,18,11,41.94368,-87.64894
13071,4,20,true,14,18,4,41.94373,-87.66401
632,4,20,true,10,9,-1,41.94453,-87.6547
13278,4,20,true,10,21,11,41.94553,-87.64644
13235,4,20,true,14,20,6,41.94814,-87.66396
13325,4,20,true,9,12,3,41.94907,-87.64863
TA1307000126,4,20,true,12,8,-4,41.94936,-87.65451
TA1307000150,4,20,true,13,11,-2,41.94945,-87.64646
TA1307000127,4,20,true,9,13,4,41.9508,-87.65918
13323,4,20,true,2,5,3,41.95282,-87.65
13063,4,20,true,7,11,4,41.95424,-87.65441
TA1308000022,4,20,true,4,12,8,41.95438,-87.64805
TA1307000149,4,20,true,3,7,4,41.95467,-87.67392
13379,4,20,true,5,13,8,41.95786,-87.6495
13389,4,20,true,10,10,0,41.961,-87.64958
TA1307000107,4,20,true,8,14,6,41.96164,-87.65464
TA1308000012,4,20,true,40,16,-24,41.96398,-87.63818
13074,4,20,true,7,6,-1,41.96521,-87.6582
639,4,20,true,14,8,-6,41.96584,-87.64538
TA1307000119,4,20,true,5,3,-2,41.96796,-87.65
TA1308000021,4,20,true,4,6,2,41.96883,-87.65765
TA1309000066,4,20,true,3,12,9,41.9691,-87.67423
TA1309000041,4,20,true,5,4,-1,41.96951,-87.65471
KA1504000171,4,20,true,7,6,-1,41.97161,-87.65016
TA1309000035,4,20,true,9,3,-6,41.97335,-87.66785
13108,4,20,true,5,9,4,41.97379,-87.65971
KA1504000146,4,20,true,6,6,0,41.978,-87.66805
13109,4,20,true,5,4,-1,41.97835,-87.65976
KA1504000152,4,20,true,9,14,5,41.98403,-87.65231
15578,4,20,true,1,5,4,41.98405,-87.66027
15575,4,20,true,3,6,3,41.98975,-87.66014
15571,4,20,true,2,7,5,41.99478,-87.66028
596,4,20,true,7,4,-3,42.04822,-87.68348
TA1308000009,4,21,false,4,5,1,41.79522,-87.58075
KA1503000052,4,21,false,5,3,-2,41.79935,-87.60097
KA1503000007,4,21,false,7,3,-4,41.80242,-87.58689
TA1308000035,4,21,false,8,3,-5,41.80944,-87.59188
TA1307000048,4,21,false,10,7,-3,41.83855,-87.60821
TA1308000036,4,21,false,5,5,0,41.83883,-87.62186
13075,4,21,false,8,8,0,41.8531,-87.63192
13135,4,21,false,1,5,4,41.85753,-87.66157
13150,4,21,false,6,7,1,41.85783,-87.62455
13164,4,21,false,5,3,-2,41.85818,-87.65648
TA1307000124,4,21,false,3,10,7,41.86411,-87.62372
13431,4,21,false,4,10,6,41.8661,-87.60728
TA1305000002,4,21,false,18,16,-2,41.86721,-87.62597
15544,4,21,false,1,20,19,41.86723,-87.61536
SL-005,4,21,false,16,35,19,41.8679,-87.62304
TA1309000010,4,21,false,4,16,12,41.87074,-87.62574
SL-009,4,21,false,2,5,3,41.87081,-87.63121
SL-008,4,21,false,3,16,13,41.87209,-87.62956
SL-011,4,21,false,1,10,9,41.87256,-87.63356
623,4,21,false,20,17,-3,41.87272,-87.62399
15541,4,21,false,29,15,-14,41.8758,-87.62086
TA1305000010,4,21,false,4,6,2,41.87623,-87.62444
TA1305000035,4,21,false,3,5,2,41.87716,-87.62787
13158,4,21,false,2,11,9,41.87764,-87.64957
13157,4,21,false,2,5,3,41.87773,-87.6548
TA1309000002,4,21,false,8,6,-2,41.87784,-87.62408
638,4,21,false,1,5,4,41.87827,-87.64078
13300,4,21,false,22,21,-1,41.88097,-87.61675
13008,4,21,false,15,20,5,41.88105,-87.62408
13341,4,21,false,2,9,7,41.88208,-87.63985
13036,4,21,false,8,5,-3,41.8821,-87.62513
TA1305000032,4,21,false,3,8,5,41.88218,-87.64109
13409,4,21,false,5,2,-3,41.8831,-87.6511
WL-012,4,21,false,1,5,4,41.88337,-87.6412
13053,4,21,false,9,13,4,41.88365,-87.64863
13001,4,21,false,6,17,11,41.88397,-87.62459
TA1305000030,4,21,false,6,11,5,41.88459,-87.63178
15535,4,21,false,11,4,-7,41.8846,-87.64455
TA1305000029,4,21,false,9,10,1,41.88466,-87.62787
13263,4,21,false,7,13,6,41.88467,-87.61952
TA1306000015,4,21,false,9,6,-3,41.88549,-87.65232
13021,4,21,false,9,10,1,41.88559,-87.64184
13073,4,21,false,5,3,-2,41.88592,-87.66717
KA1503000012,4,21,false,2,6,4,41.88599,-87.63089
TA1305000011,4,21,false,15,10,-5,41.886,-87.62418
15534,4,21,false,6,13,7,41.88627,-87.61749
TA1308000029,4,21,false,4,5,1,41.88673,-87.62225
TA1307000131,4,21,false,6,13,7,41.88688,-87.62606
KA1503000064,4,21,false,12,8,-4,41.88697,-87.61281
TA1305000022,4,21,false,5,2,-3,41.88817,-87.63656
TA1306000003,4,21,false,11,13,2,41.88867,-87.64442
KA1503000043,4,21,false,12,7,-5,41.88918,-87.63851
13050,4,21,false,15,13,-2,41.88919,-87.62775
TA1307000151,4,21,false,9,6,-3,41.88993,-87.63427
13430,4,21,false,24,16,-8,41.89077,-87.63169
TA1306000013,4,21,false,16,18,2,41.89083,-87.61852
RN-,4,21,false,5,7,2,41.89102,-87.63546
13434,4,21,false,5,7,2,41.89108,-87.66663
TA1307000117,4,21,false,7,20,13,41.89144,-87.62675
13033,4,21,false,5,4,-1,41.8916,-87.64835
13194,4,21,false,1,6,5,41.8918,-87.65878
TA1305000003,4,21,false,20,17,-3,41.89187,-87.62061
13022,4,21,false,85,45,-40,41.89227,-87.61205
TA1306000029,4,21,false,10,11,1,41.89256,-87.61449
13045,4,21,false,12,15,3,41.89403,-87.62931
13016,4,21,false,1,7,6,41.89431,-87.62277
KA1503000041,4,21,false,1,11,10,41.89452,-87.61798
13196,4,21,false,2,8,6,41.89455,-87.65345
TA1306000012,4,21,false,9,18,9,41.89475,-87.63438
KP1705001026,4,21,false,3,12,9,41.89483,-87.6323
15530,4,21,false,9,10,1,41.89575,-87.62596
13247,4,21,false,5,1,-4,41.89597,-87.66775
TA1305000020,4,21,false,5,2,-3,41.89636,-87.65406
13303,4,21,false,5,8,3,41.89672,-87.63088
13017,4,21,false,9,4,-5,41.89676,-87.6357
13338,4,21,false,3,8,5,41.89697,-87.62173
TA1307000061,4,21,false,7,3,-4,41.89745,-87.62873
620,4,21,false,1,8,7,41.89817,-87.63754
KA1504000103,4,21,false,4,5,1,41.89842,-87.68659
15529,4,21,false,8,11,3,41.89858,-87.62206
TA1307000128,4,21,false,5,9,4,41.89896,-87.6299
TA1306000011,4,21,false,6,6,0,41.89994,-87.63443
13042,4,21,false,20,19,-1,41.90097,-87.62377
KA1504000133,4,21,false,9,6,-3,41.90234,-87.62773
TA1307000039,4,21,false,27,19,-8,41.90294,-87.63137
TA1305000034,4,21,false,4,5,1,41.90313,-87.67391
KA1504000135,4,21,false,27,13,-14,41.90319,-87.63439
13136,4,21,false,3,5,2,41.90326,-87.67845
13061,4,21,false,7,5,-2,41.90342,-87.66779
KA1504000079,4,21,false,2,5,3,41.9035,-87.64334
TA1307000115,4,21,false,6,4,-2,41.9046,-87.64056
TA1308000049,4,21,false,28,26,-2,41.90672,-87.6349
KA1504000134,4,21,false,5,8,3,41.90687,-87.6262
13224,4,21,false,7,3,-4,41.90706,-87.66725
TA1309000024,4,21,false,11,9,-2,41.908,-87.63152
TA1305000041,4,21,false,14,6,-8,41.9094,-87.67769
331,4,21,false,10,6,-4,41.90965,-87.64812
TA1305000037,4,21,false,2,5,3,41.91018,-87.67003
TA1308000005,4,21,false,4,5,1,41.91042,-87.68238
13058,4,21,false,9,4,-5,41.91059,-87.64942
TA1307000038,4,21,false,6,6,0,41.91138,-87.63868
LF-005,4,21,false,52,40,-12,41.91172,-87.62681
13128,4,21,false,26,6,-20,41.91197,-87.63197
TA1308000050,4,21,false,41,34,-7,41.91211,-87.6347
13243,4,21,false,12,3,-9,41.91262,-87.6814
TA1306000007,4,21,false,3,8,5,41.91469,-87.64333
13068,4,21,false,5,4,-1,41.91554,-87.68703
13179,4,21,false,35,20,-15,41.9157,-87.63461
13146,4,21,false,22,24,2,41.91831,-87.63629
13059,4,21,false,7,7,0,41.91845,-87.65222
13192,4,21,false,10,4,-6,41.91995,-87.64884
13288,4,21,false,3,5,2,41.92008,-87.67788
13242,4,21,false,5,1,-4,41.92021,-87.69266
TA1309000033,4,21,false,11,11,0,41.92158,-87.65381
13193,4,21,false,16,24,8,41.92182,-87.64412
13084,4,21,false,6,4,-2,41.92268,-87.69715
LP-,4,21,false,9,6,-3,41.92396,-87.63584
TA1307000001,4,21,false,3,5,2,41.92535,-87.66581
TA1306000026,4,21,false,4,13,9,41.92558,-87.65842
TA1306000016,4,21,false,11,7,-4,41.9256,-87.65371
TA1309000019,4,21,false,15,8,-7,41.92586,-87.63897
TA1309000058,4,21,false,12,15,3,41.92591,-87.64927
TA1308000001,4,21,false,31,16,-15,41.92627,-87.63086
13124,4,21,false,12,17,5,41.92675,-87.63444
TA1309000023,4,21,false,14,22,8,41.9287,-87.65383
TA1307000113,4,21,false,29,15,-14,41.92878,-87.66391
13296,4,21,false,5,5,0,41.92883,-87.66852
TA1309000059,4,21,false,2,8,6,41.92889,-87.65898
TA1309000061,4,21,false,15,22,7,41.92915,-87.64909
TA1305000014,4,21,false,13,9,-4,41.92956,-87.64313
TA1307000142,4,21,false,6,13,7,41.93125,-87.64432
13276,4,21,false,11,13,2,41.93132,-87.63874
TA1306000014,4,21,false,11,13,2,41.93242,-87.65271
TA1309000039,4,21,false,3,15,12,41.93258,-87.63642
TA1309000036,4,21,false,5,4,-1,41.93313,-87.64776
TA1307000006,4,21,false,4,5,1,41.93571,-87.6636
13268,4,21,false,1,6,5,41.93588,-87.67843
TA1307000052,4,21,false,13,10,-3,41.93628,-87.65266
TA1307000136,4,21,false,1,10,9,41.9365,-87.64755
TA1307000041,4,21,false,3,11,8,41.93669,-87.63683
13137,4,21,false,5,14,9,41.9376,-87.6441
TA1309000042,4,21,false,5,5,0,41.93937,-87.66836
TA1308000019,4,21,false,11,13,2,41.93973,-87.65886
13277,4,21,false,2,11,9,41.9401,-87.64546
TA1307000134,4,21,false,4,17,13,41.94016,-87.65303
TA1309000049,4,21,false,8,5,-3,41.94077,-87.63919
TA1307000138,4,21,false,5,6,1,41.94334,-87.67094
13144,4,21,false,6,1,-5,41.9434,-87.67964
TA1309000025,4,21,false,14,19,5,41.94368,-87.64894
13071,4,21,false,10,11,1,41.94373,-87.66401
632,4,21,false,11,18,7,41.94453,-87.6547
13278,4,21,false,7,27,20,41.94553,-87.64644
13235,4,21,false,3,13,10,41.94814,-87.66396
13325,4,21,false,11,12,1,41.94907,-87.64863
TA1307000126,4,21,false,4,16,12,41.94936,-87.65451
TA1307000150,4,21,false,7,4,-3,41.94945,-87.64646
TA1307000127,4,21,false,11,6,-5,41.9508,-87.65918
13323,4,21,false,5,9,4,41.95282,-87.65
TA1309000043,4,21,false,5,1,-4,41.95417,-87.66434
13063,4,21,false,3,6,3,41.95424,-87.65441
TA1308000022,4,21,false,1,8,7,41.95438,-87.64805
13379,4,21,false,7,1,-6,41.95786,-87.6495
TA1309000027,4,21,false,4,5,1,41.9585,-87.65499
KA1503000022,4,21,false,3,5,2,41.96158,-87.66609
TA1307000107,4,21,false,3,13,10,41.96164,-87.65464
TA1308000012,4,21,false,10,14,4,41.96398,-87.63818
13074,4,21,false,1,7,6,41.96521,-87.6582
639,4,21,false,4,5,1,41.96584,-87.64538
KA1504000171,4,21,false,5,6,1,41.97161,-87.65016
13109,4,21,false,6,2,-4,41.97835,-87.65976
KA1504000152,4,21,false,6,5,-1,41.98403,-87.65231
RP-005,4,21,false,1,5,4,42.0086,-87.69047
KA1503000052,4,21,true,1,5,4,41.79935,-87.60097
13215,4,21,true,1,5,4,41.83634,-87.6135
TA1309000055,4,21,true,4,5,1,41.8382,-87.64514
TA1307000048,4,21,true,7,6,-1,41.83855,-87.60821
TA1307000139,4,21,true,4,17,13,41.84205,-87.61698
13075,4,21,true,6,1,-5,41.8531,-87.63192
13135,4,21,true,1,5,4,41.85753,-87.66157
13150,4,21,true,3,5,2,41.85783,-87.62455
13164,4,21,true,6,9,3,41.85818,-87.65648
TA1306000002,4,21,true,1,5,4,41.86238,-87.65108
13431,4,21,true,9,6,-3,41.8661,-87.60728
TA1305000002,4,21,true,9,16,7,41.86721,-87.62597
SL-005,4,21,true,1,14,13,41.8679,-87.62304
13139,4,21,true,1,12,11,41.86893,-87.65913
TA1309000010,4,21,true,6,10,4,41.87074,-87.62574
SL-009,4,21,true,2,7,5,41.87081,-87.63121
TA1307000130,4,21,true,2,7,5,41.87178,-87.65103
SL-008,4,21,true,5,4,-1,41.87209,-87.62956
13332,4,21,true,8,10,2,41.87219,-87.6615
SL-011,4,21,true,5,5,0,41.87256,-87.63356
SL-010,4,21,true,1,6,5,41.87501,-87.63309
15539,4,21,true,3,6,3,41.87763,-87.64405
13158,4,21,true,5,5,0,41.87764,-87.64957
13157,4,21,true,4,8,4,41.87773,-87.6548
TA1305000025,4,21,true,4,6,2,41.87773,-87.63528
13011,4,21,true,5,3,-2,41.87931,-87.63993
TA1309000008,4,21,true,5,5,0,41.87933,-87.6355
13156,4,21,true,9,8,-1,41.88042,-87.65554
13300,4,21,true,3,5,2,41.88097,-87.61675
13008,4,21,true,19,4,-15,41.88105,-87.62408
TA1305000006,4,21,true,7,2,-5,41.88122,-87.6296
TA1307000120,4,21,true,9,9,0,41.88188,-87.64879
13341,4,21,true,5,1,-4,41.88208,-87.63985
TA1305000032,4,21,true,12,8,-4,41.88218,-87.64109
13353,4,21,true,6,3,-3,41.88283,-87.6612
13409,4,21,true,9,6,-3,41.8831,-87.6511
WL-012,4,21,true,5,2,-3,41.88337,-87.6412
13053,4,21,true,10,7,-3,41.88365,-87.64863
13001,4,21,true,6,5,-1,41.88397,-87.62459
13155,4,21,true,5,4,-1,41.88407,-87.65689
18062,4,21,true,5,1,-4,41.88412,-87.65427
TA1306000010,4,21,true,5,5,0,41.88419,-87.62961
TA1305000030,4,21,true,6,1,-5,41.88459,-87.63178
15535,4,21,true,2,7,5,41.8846,-87.64455
TA1305000029,4,21,true,8,1,-7,41.88466,-87.62787
13263,4,21,true,3,7,4,41.88467,-87.61952
TA1306000015,4,21,true,11,4,-7,41.88549,-87.65232
KA1503000012,4,21,true,8,5,-3,41.88599,-87.63089
TA1305000011,4,21,true,5,9,4,41.886,-87.62418
15534,4,21,true,2,6,4,41.88627,-87.61749
TA1308000029,4,21,true,5,7,2,41.88673,-87.62225
TA1305000022,4,21,true,8,13,5,41.88817,-87.63656
TA1306000003,4,21,true,15,15,0,41.88867,-87.64442
KA1503000043,4,21,true,16,19,3,41.88918,-87.63851
13050,4,21,true,18,7,-11,41.88919,-87.62775
TA1307000151,4,21,true,15,4,-11,41.88993,-87.63427
13427,4,21,true,4,5,1,41.89054,-87.62205
13430,4,21,true,19,7,-12,41.89077,-87.63169
TA1306000013,4,21,true,8,8,0,41.89083,-87.61852
RN-,4,21,true,7,8,1,41.89102,-87.63546
TA1307000117,4,21,true,9,2,-7,41.89144,-87.62675
13033,4,21,true,10,8,-2,41.8916,-87.64835
13194,4,21,true,6,4,-2,41.8918,-87.65878
TA1305000003,4,21,true,8,7,-1,41.89187,-87.62061
13022,4,21,true,21,7,-14,41.89227,-87.61205
TA1306000029,4,21,true,5,3,-2,41.89256,-87.61449
13265,4,21,true,4,13,9,41.89383,-87.64172
13045,4,21,true,15,13,-2,41.89403,-87.62931
KA1503000041,4,21,true,5,6,1,41.89452,-87.61798
13196,4,21,true,4,6,2,41.89455,-87.65345
TA1306000012,4,21,true,17,21,4,41.89475,-87.63438
KP1705001026,4,21,true,7,8,1,41.89483,-87.6323
15530,4,21,true,12,6,-6,41.89575,-87.62596
TA1305000020,4,21,true,6,6,0,41.89636,-87.65406
13289,4,21,true,9,4,-5,41.89638,-87.661
13303,4,21,true,5,6,1,41.89672,-87.63088
13017,4,21,true,8,2,-6,41.89676,-87.6357
13338,4,21,true,1,5,4,41.89697,-87.62173
TA1307000061,4,21,true,2,5,3,41.89745,-87.62873
TA1306000009,4,21,true,6,7,1,41.89772,-87.64299
620,4,21,true,5,10,5,41.89817,-87.63754
TA1307000128,4,21,true,12,12,0,41.89896,-87.6299
657,4,21,true,4,5,1,41.89918,-87.6722
13248,4,21,true,6,2,-4,41.89964,-87.66788
TA1306000011,4,21,true,6,6,0,41.89994,-87.63443
13290,4,21,true,2,14,12,41.90069,-87.66259
13042,4,21,true,10,9,-1,41.90097,-87.62377
KA1504000133,4,21,true,7,7,0,41.90234,-87.62773
TA1307000039,4,21,true,35,24,-11,41.90294,-87.63137
TA1305000034,4,21,true,10,2,-8,41.90313,-87.67391
KA1504000135,4,21,true,23,20,-3,41.90319,-87.63439
13136,4,21,true,1,5,4,41.90326,-87.67845
13061,4,21,true,4,13,9,41.90342,-87.66779
KA1504000079,4,21,true,3,8,5,41.9035,-87.64334
TA1307000115,4,21,true,5,3,-2,41.9046,-87.64056
TA1308000049,4,21,true,29,14,-15,41.90672,-87.6349
KA1504000134,4,21,true,6,4,-2,41.90687,-87.6262
13221,4,21,true,2,6,4,41.90765,-87.67254
TA1309000024,4,21,true,11,8,-3,41.908,-87.63152
TA1305000041,4,21,true,6,9,3,41.9094,-87.67769
331,4,21,true,16,9,-7,41.90965,-87.64812
TA1306000008,4,21,true,8,5,-3,41.9102,-87.6435
13154,4,21,true,5,2,-3,41.91054,-87.65312
TA1307000038,4,21,true,8,3,-5,41.91138,-87.63868
LF-005,4,21,true,36,18,-18,41.91172,-87.62681
13128,4,21,true,11,4,-7,41.91197,-87.63197
TA1308000050,4,21,true,42,24,-18,41.91211,-87.6347
13243,4,21,true,6,3,-3,41.91262,-87.6814
TA1306000032,4,21,true,6,11,5,41.9137,-87.65285
TA1307000166,4,21,true,4,8,4,41.91386,-87.64877
13179,4,21,true,27,15,-12,41.9157,-87.63461
13133,4,21,true,5,5,0,41.91598,-87.67733
13266,4,21,true,5,2,-3,41.91774,-87.69142
TA1309000006,4,21,true,5,9,4,41.91809,-87.64375
TA1307000163,4,21,true,4,6,2,41.91821,-87.65696
13146,4,21,true,14,12,-2,41.91831,-87.63629
13059,4,21,true,10,16,6,41.91845,-87.65222
13259,4,21,true,2,6,4,41.91852,-87.69744
13192,4,21,true,3,6,3,41.91995,-87.64884
TA1309000030,4,21,true,5,3,-2,41.92077,-87.66372
TA1309000033,4,21,true,7,8,1,41.92158,-87.65381
13193,4,21,true,15,17,2,41.92182,-87.64412
13191,4,21,true,3,7,4,41.92217,-87.63891
LP-,4,21,true,7,5,-2,41.92396,-87.63584
TA1306000026,4,21,true,3,7,4,41.92558,-87.65842
TA1309000019,4,21,true,5,8,3,41.92586,-87.63897
TA1309000058,4,21,true,15,28,13,41.92591,-87.64927
TA1308000001,4,21,true,13,10,-3,41.92627,-87.63086
TA1309000023,4,21,true,10,10,0,41.9287,-87.65383
TA1307000113,4,21,true,5,2,-3,41.92878,-87.66391
TA1309000059,4,21,true,2,6,4,41.92889,-87.65898
TA1309000061,4,21,true,8,13,5,41.92915,-87.64909
TA1308000031,4,21,true,8,2,-6,41.92946,-87.68417
TA1305000014,4,21,true,3,20,17,41.92956,-87.64313
13085,4,21,true,4,8,4,41.92958,-87.70789
TA1307000142,4,21,true,5,14,9,41.93125,-87.64432
13276,4,21,true,8,12,4,41.93132,-87.63874
TA1306000014,4,21,true,7,11,4,41.93242,-87.65271
TA1309000039,4,21,true,13,15,2,41.93258,-87.63642
TA1309000036,4,21,true,2,6,4,41.93313,-87.64776
TA1307000006,4,21,true,6,5,-1,41.93571,-87.6636
13268,4,21,true,7,6,-1,41.93588,-87.67843
TA1307000052,4,21,true,9,11,2,41.93628,-87.65266
TA1307000136,4,21,true,9,13,4,41.9365,-87.64755
TA1307000041,4,21,true,13,6,-7,41.93669,-87.63683
13137,4,21,true,5,11,6,41.9376,-87.6441
TA1309000042,4,21,true,5,5,0,41.93937,-87.66836
13229,4,21,true,8,8,0,41.93946,-87.66376
13277,4,21,true,7,8,1,41.9401,-87.64546
TA1307000134,4,21,true,6,14,8,41.94016,-87.65303
TA1309000049,4,21,true,3,10,7,41.94077,-87.63919
TA1307000138,4,21,true,7,2,-5,41.94334,-87.67094
TA1309000025,4,21,true,12,14,2,41.94368,-87.64894
13071,4,21,true,2,8,6,41.94373,-87.66401
632,4,21,true,12,13,1,41.94453,-87.6547
13278,4,21,true,4,17,13,41.94553,-87.64644
13235,4,21,true,8,8,0,41.94814,-87.66396
13325,4,21,true,8,13,5,41.94907,-87.64863
TA1307000126,4,21,true,6,6,0,41.94936,-87.65451
TA1307000150,4,21,true,4,9,5,41.94945,-87.64646
TA1307000127,4,21,true,6,7,1,41.9508,-87.65918
13063,4,21,true,7,5,-2,41.95424,-87.65441
TA1308000022,4,21,true,6,5,-1,41.95438,-87.64805
TA1309000027,4,21,true,3,5,2,41.9585,-87.65499
13389,4,21,true,6,13,7,41.961,-87.64958
TA1309000021,4,21,true,5,2,-3,41.9615,-87.6714
13074,4,21,true,5,2,-3,41.96521,-87.6582
639,4,21,true,6,1,-5,41.96584,-87.64538
TA1309000014,4,21,true,3,5,2,41.96709,-87.66744
TA1307000158,4,21,true,1,8,7,41.9671,-87.67904
KA1504000080,4,21,true,1,5,4,41.96887,-87.69609
TA1309000066,4,21,true,7,1,-6,41.9691,-87.67423
TA1309000035,4,21,true,4,9,5,41.97335,-87.66785
13108,4,21,true,6,1,-5,41.97379,-87.65971
KA1504000146,4,21,true,8,3,-5,41.978,-87.66805
KA1504000152,4,21,true,4,7,3,41.98403,-87.65231
KA1503000014,4,22,false,1,5,4,41.7851,-87.60108
TA1308000009,4,22,false,5,2,-3,41.79522,-87.58075
TA1309000037,4,22,false,2,8,6,41.79957,-87.59474
KA1503000007,4,22,false,2,7,5,41.80242,-87.58689
KA1503000009,4,22,false,5,2,-3,41.80932,-87.63346
TA1307000129,4,22,false,5,3,-2,41.83104,-87.62683
KA1503000004,4,22,false,5,5,0,41.83127,-87.6088
13216,4,22,false,9,1,-8,41.83473,-87.62581
TA1307000048,4,22,false,15,5,-10,41.83855,-87.60821
13075,4,22,false,9,2,-7,41.8531,-87.63192
13150,4,22,false,9,9,0,41.85783,-87.62455
TA1307000124,4,22,false,2,8,6,41.86411,-87.62372
13431,4,22,false,3,5,2,41.8661,-87.60728
TA1305000002,4,22,false,7,23,16,41.86721,-87.62597
SL-005,4,22,false,29,25,-4,41.8679,-87.62304
13160,4,22,false,2,5,3,41.86947,-87.65548
TA1309000010,4,22,false,13,7,-6,41.87074,-87.62574
623,4,22,false,14,18,4,41.87272,-87.62399
SL-007,4,22,false,9,9,0,41.87404,-87.6277
15668,4,22,false,1,6,5,41.87471,-87.68642
15541,4,22,false,9,24,15,41.8758,-87.62086
TA1305000010,4,22,false,8,10,2,41.87623,-87.62444
13158,4,22,false,8,4,-4,41.87764,-87.64957
TA1305000025,4,22,false,2,6,4,41.87773,-87.63528
638,4,22,false,1,11,10,41.87827,-87.64078
13300,4,22,false,8,8,0,41.88097,-87.61675
13008,4,22,false,21,12,-9,41.88105,-87.62408
TA1305000006,4,22,false,5,6,1,41.88122,-87.6296
TA1307000120,4,22,false,5,5,0,41.88188,-87.64879
TA1305000032,4,22,false,1,9,8,41.88218,-87.64109
13006,4,22,false,1,5,4,41.88268,-87.63252
13053,4,22,false,16,11,-5,41.88365,-87.64863
13001,4,22,false,6,3,-3,41.88397,-87.62459
13155,4,22,false,5,3,-2,41.88407,-87.65689
TA1305000030,4,22,false,9,12,3,41.88459,-87.63178
15535,4,22,false,10,10,0,41.8846,-87.64455
TA1305000029,4,22,false,6,10,4,41.88466,-87.62787
13263,4,22,false,8,13,5,41.88467,-87.61952
TA1306000015,4,22,false,14,4,-10,41.88549,-87.65232
13021,4,22,false,4,8,4,41.88559,-87.64184
TA1307000111,4,22,false,5,15,10,41.88582,-87.63548
KA1503000012,4,22,false,12,15,3,41.88599,-87.63089
TA1305000011,4,22,false,18,16,-2,41.886,-87.62418
15534,4,22,false,4,6,2,41.88627,-87.61749
TA1307000131,4,22,false,6,8,2,41.88688,-87.62606
TA1306000003,4,22,false,5,6,1,41.88867,-87.64442
KA1503000043,4,22,false,8,9,1,41.88918,-87.63851
13050,4,22,false,24,5,-19,41.88919,-87.62775
TA1307000151,4,22,false,9,14,5,41.88993,-87.63427
KA1503000044,4,22,false,2,7,5,41.89018,-87.6262
13430,4,22,false,11,17,6,41.89077,-87.63169
TA1306000013,4,22,false,21,12,-9,41.89083,-87.61852
RN-,4,22,false,6,4,-2,41.89102,-87.63546
TA1307000117,4,22,false,20,17,-3,41.89144,-87.62675
13033,4,22,false,6,12,6,41.8916,-87.64835
13194,4,22,false,2,5,3,41.8918,-87.65878
TA1305000003,4,22,false,12,12,0,41.89187,-87.62061
13022,4,22,false,31,9,-22,41.89227,-87.61205
TA1306000029,4,22,false,13,4,-9,41.89256,-87.61449
13265,4,22,false,1,9,8,41.89383,-87.64172
13045,4,22,false,21,15,-6,41.89403,-87.62931
13016,4,22,false,1,17,16,41.89431,-87.62277
KA1503000041,4,22,false,12,8,-4,41.89452,-87.61798
13196,4,22,false,1,7,6,41.89455,-87.65345
TA1306000012,4,22,false,11,13,2,41.89475,-87.63438
KP1705001026,4,22,false,10,4,-6,41.89483,-87.6323
13132,4,22,false,2,5,3,41.89573,-87.67718
13247,4,22,false,9,6,-3,41.89597,-87.66775
13289,4,22,false,5,3,-2,41.89638,-87.661
13303,4,22,false,13,8,-5,41.89672,-87.63088
13017,4,22,false,2,15,13,41.89676,-87.6357
TA1307000061,4,22,false,7,3,-4,41.89745,-87.62873
15529,4,22,false,7,12,5,41.89858,-87.62206
TA1307000128,4,22,false,4,7,3,41.89896,-87.6299
657,4,22,false,2,5,3,41.89918,-87.6722
13042,4,22,false,12,25,13,41.90097,-87.62377
KA1504000133,4,22,false,4,7,3,41.90234,-87.62773
TA1307000039,4,22,false,31,22,-9,41.90294,-87.63137
TA1305000034,4,22,false,4,5,1,41.90313,-87.67391
KA1504000135,4,22,false,38,31,-7,41.90319,-87.63439
13136,4,22,false,5,4,-1,41.90326,-87.67845
13061,4,22,false,10,10,0,41.90342,-87.66779
TA1308000049,4,22,false,37,17,-20,41.90672,-87.6349
KA1504000134,4,22,false,7,3,-4,41.90687,-87.6262
13224,4,22,false,4,7,3,41.90706,-87.66725
13221,4,22,false,10,4,-6,41.90765,-87.67254
TA1309000024,4,22,false,8,9,1,41.908,-87.63152
TA1305000041,4,22,false,18,15,-3,41.9094,-87.67769
331,4,22,false,6,4,-2,41.90965,-87.64812
TA1305000037,4,22,false,5,6,1,41.91018,-87.67003
TA1308000005,4,22,false,3,10,7,41.91042,-87.68238
13058,4,22,false,12,3,-9,41.91059,-87.64942
TA1307000038,4,22,false,17,6,-11,41.91138,-87.63868
LF-005,4,22,false,22,4,-18,41.91172,-87.62681
13128,4,22,false,11,3,-8,41.91197,-87.63197
TA1308000050,4,22,false,34,18,-16,41.91211,-87.6347
13243,4,22,false,3,5,2,41.91262,-87.6814
TA1306000032,4,22,false,6,10,4,41.9137,-87.65285
TA1307000166,4,22,false,5,4,-1,41.91386,-87.64877
13179,4,22,false,32,15,-17,41.9157,-87.63461
13133,4,22,false,9,11,2,41.91598,-87.67733
TA1309000006,4,22,false,5,3,-2,41.91809,-87.64375
TA1307000163,4,22,false,1,5,4,41.91821,-87.65696
13146,4,22,false,27,14,-13,41.91831,-87.63629
13059,4,22,false,15,6,-9,41.91845,-87.65222
13192,4,22,false,11,7,-4,41.91995,-87.64884
TA1309000030,4,22,false,8,1,-7,41.92077,-87.66372
TA1309000033,4,22,false,7,21,14,41.92158,-87.65381
13193,4,22,false,17,18,1,41.92182,-87.64412
13084,4,22,false,10,6,-4,41.92268,-87.69715
TA1307000001,4,22,false,11,13,2,41.92535,-87.66581
TA1306000026,4,22,false,5,2,-3,41.92558,-87.65842
TA1306000016,4,22,false,9,1,-8,41.9256,-87.65371
TA1309000019,4,22,false,7,6,-1,41.92586,-87.63897
TA1309000058,4,22,false,9,14,5,41.92591,-87.64927
TA1308000001,4,22,false,9,27,18,41.92627,-87.63086
13124,4,22,false,6,8,2,41.92675,-87.63444
TA1309000023,4,22,false,13,7,-6,41.9287,-87.65383
13296,4,22,false,4,5,1,41.92883,-87.66852
TA1309000059,4,22,false,1,5,4,41.92889,-87.65898
TA1309000061,4,22,false,12,9,-3,41.92915,-87.64909
TA1308000031,4,22,false,5,3,-2,41.92946,-87.68417
TA1305000014,4,22,false,5,10,5,41.92956,-87.64313
TA1307000142,4,22,false,4,16,12,41.93125,-87.64432
TA1307000064,4,22,false,4,10,6,41.93222,-87.65864
TA1306000014,4,22,false,4,12,8,41.93242,-87.65271
TA1309000039,4,22,false,8,7,-1,41.93258,-87.63642
13294,4,22,false,2,5,3,41.9326,-87.66595
TA1309000036,4,22,false,2,7,5,41.93313,-87.64776
TA1307000006,4,22,false,6,9,3,41.93571,-87.6636
13268,4,22,false,6,4,-2,41.93588,-87.67843
TA1307000052,4,22,false,4,22,18,41.93628,-87.65266
TA1307000136,4,22,false,2,6,4,41.9365,-87.64755
TA1307000041,4,22,false,3,8,5,41.93669,-87.63683
13137,4,22,false,11,15,4,41.9376,-87.6441
TA1309000042,4,22,false,8,5,-3,41.93937,-87.66836
13229,4,22,false,2,8,6,41.93946,-87.66376
TA1308000019,4,22,false,7,11,4,41.93973,-87.65886
13277,4,22,false,9,8,-1,41.9401,-87.64546
TA1307000134,4,22,false,14,20,6,41.94016,-87.65303
TA1309000049,4,22,false,7,15,8,41.94077,-87.63919
TA1309000025,4,22,false,20,18,-2,41.94368,-87.64894
13071,4,22,false,7,9,2,41.94373,-87.66401
632,4,22,false,15,15,0,41.94453,-87.6547
13278,4,22,false,9,3,-6,41.94553,-87.64644
13235,4,22,false,11,5,-6,41.94814,-87.66396
TA1307000126,4,22,false,10,18,8,41.94936,-87.65451
TA1307000150,4,22,false,2,11,9,41.94945,-87.64646
TA1307000127,4,22,false,5,4,-1,41.9508,-87.65918
13323,4,22,false,3,7,4,41.95282,-87.65
13063,4,22,false,4,8,4,41.95424,-87.65441
TA1308000022,4,22,false,5,9,4,41.95438,-87.64805
13379,4,22,false,2,6,4,41.95786,-87.6495
TA1309000027,4,22,false,2,5,3,41.9585,-87.65499
13389,4,22,false,1,7,6,41.961,-87.64958
TA1307000107,4,22,false,3,5,2,41.96164,-87.65464
TA1308000012,4,22,false,6,2,-4,41.96398,-87.63818
13074,4,22,false,2,8,6,41.96521,-87.6582
KA1504000149,4,22,false,5,3,-2,41.97562,-87.67945
13109,4,22,false,1,7,6,41.97835,-87.65976
KA1503000007,4,22,true,2,5,3,41.80242,-87.58689
13216,4,22,true,7,6,-1,41.83473,-87.62581
13215,4,22,true,1,5,4,41.83634,-87.6135
KA1503000038,4,22,true,3,5,2,41.83845,-87.6354
13150,4,22,true,3,5,2,41.85783,-87.62455
SL-012,4,22,true,3,5,2,41.86038,-87.62581
TA1307000124,4,22,true,3,5,2,41.86411,-87.62372
TA1305000002,4,22,true,5,6,1,41.86721,-87.62597
SL-005,4,22,true,7,5,-2,41.8679,-87.62304
TA1309000010,4,22,true,6,8,2,41.87074,-87.62574
SL-009,4,22,true,2,5,3,41.87081,-87.63121
TA1307000130,4,22,true,1,8,7,41.87178,-87.65103
13332,4,22,true,2,11,9,41.87219,-87.6615
623,4,22,true,6,2,-4,41.87272,-87.62399
SL-010,4,22,true,1,5,4,41.87501,-87.63309
13158,4,22,true,8,4,-4,41.87764,-87.64957
13206,4,22,true,5,5,0,41.87794,-87.66201
TA1307000120,4,22,true,11,8,-3,41.88188,-87.64879
TA1305000032,4,22,true,6,6,0,41.88218,-87.64109
13053,4,22,true,13,4,-9,41.88365,-87.64863
13001,4,22,true,5,4,-1,41.88397,-87.62459
18062,4,22,true,5,3,-2,41.88412,-87.65427
TA1306000010,4,22,true,4,5,1,41.88419,-87.62961
15535,4,22,true,9,6,-3,41.8846,-87.64455
13263,4,22,true,4,7,3,41.88467,-87.61952
TA1306000015,4,22,true,12,4,-8,41.88549,-87.65232
13021,4,22,true,7,3,-4,41.88559,-87.64184
KA1503000012,4,22,true,5,3,-2,41.88599,-87.63089
TA1305000011,4,22,true,6,2,-4,41.886,-87.62418
TA1305000022,4,22,true,9,6,-3,41.88817,-87.63656
TA1306000003,4,22,true,13,15,2,41.88867,-87.64442
KA1503000043,4,22,true,9,10,1,41.88918,-87.63851
13050,4,22,true,12,6,-6,41.88919,-87.62775
TA1307000151,4,22,true,9,6,-3,41.88993,-87.63427
636,4,22,true,4,7,3,41.88997,-87.63662
KA1503000044,4,22,true,2,5,3,41.89018,-87.6262
13430,4,22,true,19,7,-12,41.89077,-87.63169
TA1306000013,4,22,true,9,7,-2,41.89083,-87.61852
RN-,4,22,true,5,6,1,41.89102,-87.63546
TA1307000117,4,22,true,14,5,-9,41.89144,-87.62675
13033,4,22,true,6,10,4,41.8916,-87.64835
TA1305000003,4,22,true,4,8,4,41.89187,-87.62061
13022,4,22,true,8,2,-6,41.89227,-87.61205
TA1306000029,4,22,true,8,5,-3,41.89256,-87.61449
13265,4,22,true,3,14,11,41.89383,-87.64172
13045,4,22,true,9,14,5,41.89403,-87.62931
13016,4,22,true,4,5,1,41.89431,-87.62277
KA1503000041,4,22,true,7,10,3,41.89452,-87.61798
TA1307000062,4,22,true,3,7,4,41.89466,-87.63839
TA1306000012,4,22,true,12,11,-1,41.89475,-87.63438
KP1705001026,4,22,true,9,4,-5,41.89483,-87.6323
15530,4,22,true,5,8,3,41.89575,-87.62596
13289,4,22,true,2,6,4,41.89638,-87.661
13303,4,22,true,7,5,-2,41.89672,-87.63088
13017,4,22,true,3,5,2,41.89676,-87.6357
TA1307000061,4,22,true,1,8,7,41.89745,-87.62873
TA1306000009,4,22,true,1,9,8,41.89772,-87.64299
15529,4,22,true,6,5,-1,41.89858,-87.62206
TA1307000128,4,22,true,9,7,-2,41.89896,-87.6299
13248,4,22,true,1,9,8,41.89964,-87.66788
TA1306000011,4,22,true,3,6,3,41.89994,-87.63443
13290,4,22,true,1,5,4,41.90069,-87.66259
13042,4,22,true,4,6,2,41.90097,-87.62377
KA1504000133,4,22,true,8,7,-1,41.90234,-87.62773
TA1307000039,4,22,true,26,26,0,41.90294,-87.63137
KA1504000135,4,22,true,23,17,-6,41.90319,-87.63439
13136,4,22,true,7,4,-3,41.90326,-87.67845
13061,4,22,true,6,10,4,41.90342,-87.66779
KA1504000079,4,22,true,3,8,5,41.9035,-87.64334
TA1307000115,4,22,true,5,5,0,41.9046,-87.64056
TA1308000049,4,22,true,33,12,-21,41.90672,-87.6349
KA1504000134,4,22,true,6,7,1,41.90687,-87.6262
13224,4,22,true,4,6,2,41.90706,-87.66725
13221,4,22,true,4,8,4,41.90765,-87.67254
TA1309000024,4,22,true,13,13,0,41.908,-87.63152
TA1305000041,4,22,true,8,9,1,41.9094,-87.67769
331,4,22,true,12,6,-6,41.90965,-87.64812
TA1305000037,4,22,true,5,3,-2,41.91018,-87.67003
13058,4,22,true,7,3,-4,41.91059,-87.64942
TA1307000038,4,22,true,12,10,-2,41.91138,-87.63868
LF-005,4,22,true,19,11,-8,41.91172,-87.62681
13128,4,22,true,5,2,-3,41.91197,-87.63197
TA1308000050,4,22,true,14,15,1,41.91211,-87.6347
13243,4,22,true,1,8,7,41.91262,-87.6814
TA1306000032,4,22,true,4,5,1,41.9137,-87.65285
TA1307000166,4,22,true,4,5,1,41.91386,-87.64877
13068,4,22,true,1,6,5,41.91554,-87.68703
13179,4,22,true,23,11,-12,41.9157,-87.63461
13133,4,22,true,11,4,-7,41.91598,-87.67733
TA1309000006,4,22,true,5,8,3,41.91809,-87.64375
TA1307000163,4,22,true,8,10,2,41.91821,-87.65696
13146,4,22,true,22,18,-4,41.91831,-87.63629
13059,4,22,true,8,12,4,41.91845,-87.65222
13192,4,22,true,15,8,-7,41.91995,-87.64884
TA1309000033,4,22,true,8,6,-2,41.92158,-87.65381
13193,4,22,true,13,9,-4,41.92182,-87.64412
13191,4,22,true,4,5,1,41.92217,-87.63891
13084,4,22,true,5,7,2,41.92268,-87.69715
LP-,4,22,true,2,5,3,41.92396,-87.63584
TA1307000001,4,22,true,3,5,2,41.92535,-87.66581
TA1306000026,4,22,true,2,13,11,41.92558,-87.65842
TA1309000019,4,22,true,8,7,-1,41.92586,-87.63897
TA1309000058,4,22,true,17,7,-10,41.92591,-87.64927
TA1308000001,4,22,true,12,4,-8,41.92627,-87.63086
TA1309000023,4,22,true,6,4,-2,41.9287,-87.65383
TA1307000113,4,22,true,5,9,4,41.92878,-87.66391
13296,4,22,true,5,1,-4,41.92883,-87.66852
TA1309000061,4,22,true,6,5,-1,41.92915,-87.64909
TA1305000014,4,22,true,7,12,5,41.92956,-87.64313
13085,4,22,true,6,6,0,41.92958,-87.70789
TA1307000142,4,22,true,2,11,9,41.93125,-87.64432
13276,4,22,true,3,5,2,41.93132,-87.63874
TA1307000064,4,22,true,3,16,13,41.93222,-87.65864
TA1306000014,4,22,true,6,4,-2,41.93242,-87.65271
TA1309000039,4,22,true,6,14,8,41.93258,-87.63642
13294,4,22,true,2,6,4,41.9326,-87.66595
TA1309000036,4,22,true,7,3,-4,41.93313,-87.64776
TA1307000006,4,22,true,3,11,8,41.93571,-87.6636
TA1307000052,4,22,true,6,11,5,41.93628,-87.65266
TA1307000136,4,22,true,7,1,-6,41.9365,-87.64755
TA1307000041,4,22,true,1,6,5,41.93669,-87.63683
13137,4,22,true,7,9,2,41.9376,-87.6441
TA1309000042,4,22,true,4,5,1,41.93937,-87.66836
13229,4,22,true,1,6,5,41.93946,-87.66376
TA1308000019,4,22,true,4,7,3,41.93973,-87.65886
TA1307000134,4,22,true,4,15,11,41.94016,-87.65303
TA1309000049,4,22,true,1,11,10,41.94077,-87.63919
TA1307000138,4,22,true,5,2,-3,41.94334,-87.67094
TA1309000025,4,22,true,15,6,-9,41.94368,-87.64894
13071,4,22,true,4,5,1,41.94373,-87.66401
632,4,22,true,7,9,2,41.94453,-87.6547
13278,4,22,true,3,11,8,41.94553,-87.64644
13235,4,22,true,8,5,-3,41.94814,-87.66396
13325,4,22,true,7,7,0,41.94907,-87.64863
TA1307000126,4,22,true,9,7,-2,41.94936,-87.65451
TA1307000150,4,22,true,3,12,9,41.94945,-87.64646
TA1307000127,4,22,true,7,8,1,41.9508,-87.65918
13323,4,22,true,6,6,0,41.95282,-87.65
13063,4,22,true,5,3,-2,41.95424,-87.65441
TA1308000022,4,22,true,1,7,6,41.95438,-87.64805
TA1309000027,4,22,true,3,8,5,41.9585,-87.65499
TA1309000014,4,22,true,1,7,6,41.96709,-87.66744
TA1307000158,4,22,true,1,8,7,41.9671,-87.67904
TA1309000035,4,22,true,7,4,-3,41.97335,-87.66785
13108,4,22,true,2,5,3,41.97379,-87.65971
KA1504000146,4,22,true,6,3,-3,41.978,-87.66805
KA1504000151,4,22,true,8,2,-6,41.98359,-87.66916
KA1504000152,4,22,true,3,7,4,41.98403,-87.65231
TA1308000009,4,23,false,1,7,6,41.79522,-87.58075
KA1503000004,4,23,false,2,5,3,41.83127,-87.6088
SL-012,4,23,false,2,10,8,41.86038,-87.62581
WL-008,4,23,false,1,7,6,41.86712,-87.64108
TA1305000002,4,23,false,17,13,-4,41.86721,-87.62597
SL-005,4,23,false,10,20,10,41.8679,-87.62304
TA1309000010,4,23,false,1,23,22,41.87074,-87.62574
SL-008,4,23,false,4,5,1,41.87209,-87.62956
623,4,23,false,14,25,11,41.87272,-87.62399
SL-007,4,23,false,9,6,-3,41.87404,-87.6277
15541,4,23,false,24,23,-1,41.8758,-87.62086
TA1305000010,4,23,false,16,17,1,41.87623,-87.62444
624,4,23,false,1,5,4,41.87626,-87.62923
13300,4,23,false,8,3,-5,41.88097,-87.61675
13008,4,23,false,17,18,1,41.88105,-87.62408
TA1307000120,4,23,false,6,8,2,41.88188,-87.64879
13036,4,23,false,7,6,-1,41.8821,-87.62513
13353,4,23,false,5,3,-2,41.88283,-87.6612
13409,4,23,false,7,1,-6,41.8831,-87.6511
13001,4,23,false,7,7,0,41.88397,-87.62459
18062,4,23,false,5,1,-4,41.88412,-87.65427
TA1305000030,4,23,false,10,2,-8,41.88459,-87.63178
15535,4,23,false,10,10,0,41.8846,-87.64455
TA1305000029,4,23,false,6,11,5,41.88466,-87.62787
13263,4,23,false,20,15,-5,41.88467,-87.61952
TA1306000015,4,23,false,18,2,-16,41.88549,-87.65232
KA1503000012,4,23,false,6,10,4,41.88599,-87.63089
TA1305000011,4,23,false,10,8,-2,41.886,-87.62418
TA1308000029,4,23,false,11,9,-2,41.88673,-87.62225
TA1307000131,4,23,false,15,10,-5,41.88688,-87.62606
KA1503000064,4,23,false,5,2,-3,41.88697,-87.61281
TA1306000003,4,23,false,14,10,-4,41.88867,-87.64442
KA1503000043,4,23,false,4,8,4,41.88918,-87.63851
13050,4,23,false,6,7,1,41.88919,-87.62775
TA1307000151,4,23,false,4,5,1,41.88993,-87.63427
13430,4,23,false,13,6,-7,41.89077,-87.63169
TA1306000013,4,23,false,10,10,0,41.89083,-87.61852
RN-,4,23,false,7,5,-2,41.89102,-87.63546
TA1307000117,4,23,false,15,14,-1,41.89144,-87.62675
13033,4,23,false,7,3,-4,41.8916,-87.64835
TA1305000003,4,23,false,7,11,4,41.89187,-87.62061
13022,4,23,false,8,6,-2,41.89227,-87.61205
TA1306000029,4,23,false,14,12,-2,41.89256,-87.61449
13045,4,23,false,8,10,2,41.89403,-87.62931
KA1503000041,4,23,false,2,9,7,41.89452,-87.61798
13196,4,23,false,5,1,-4,41.89455,-87.65345
TA1307000062,4,23,false,7,1,-6,41.89466,-87.63839
TA1306000012,4,23,false,12,12,0,41.89475,-87.63438
KP1705001026,4,23,false,4,6,2,41.89483,-87.6323
13247,4,23,false,1,8,7,41.89597,-87.66775
13289,4,23,false,2,7,5,41.89638,-87.661
13303,4,23,false,6,8,2,41.89672,-87.63088
TA1307000061,4,23,false,16,4,-12,41.89745,-87.62873
620,4,23,false,6,7,1,41.89817,-87.63754
TA1307000128,4,23,false,10,7,-3,41.89896,-87.6299
TA1306000011,4,23,false,8,1,-7,41.89994,-87.63443
13290,4,23,false,4,5,1,41.90069,-87.66259
13042,4,23,false,13,18,5,41.90097,-87.62377
TA1307000070,4,23,false,5,12,7,41.90133,-87.67742
KA1504000133,4,23,false,10,5,-5,41.90234,-87.62773
TA1307000039,4,23,false,19,17,-2,41.90294,-87.63137
TA1305000034,4,23,false,6,4,-2,41.90313,-87.67391
KA1504000135,4,23,false,23,7,-16,41.90319,-87.63439
13136,4,23,false,6,4,-2,41.90326,-87.67845
13061,4,23,false,10,10,0,41.90342,-87.66779
TA1308000049,4,23,false,13,11,-2,41.90672,-87.6349
KA1504000134,4,23,false,3,5,2,41.90687,-87.6262
TA1307000143,4,23,false,4,5,1,41.90762,-87.63854
13221,4,23,false,5,2,-3,41.90765,-87.67254
TA1309000024,4,23,false,9,6,-3,41.908,-87.63152
TA1305000041,4,23,false,8,9,1,41.9094,-87.67769
331,4,23,false,7,4,-3,41.90965,-87.64812
13257,4,23,false,3,13,10,41.91054,-87.68956
TA1307000038,4,23,false,12,6,-6,41.91138,-87.63868
LF-005,4,23,false,2,7,5,41.91172,-87.62681
TA1308000050,4,23,false,29,23,-6,41.91211,-87.6347
TA1307000166,4,23,false,4,6,2,41.91386,-87.64877
13179,4,23,false,13,9,-4,41.9157,-87.63461
TA1309000006,4,23,false,6,4,-2,41.91809,-87.64375
13146,4,23,false,27,8,-19,41.91831,-87.63629
13059,4,23,false,9,15,6,41.91845,-87.65222
13192,4,23,false,8,8,0,41.91995,-87.64884
TA1309000033,4,23,false,9,6,-3,41.92158,-87.65381
13193,4,23,false,22,17,-5,41.92182,-87.64412
LP-,4,23,false,2,5,3,41.92396,-87.63584
TA1307000001,4,23,false,3,5,2,41.92535,-87.66581
TA1306000026,4,23,false,4,5,1,41.92558,-87.65842
TA1306000016,4,23,false,5,5,0,41.9256,-87.65371
TA1309000019,4,23,false,6,9,3,41.92586,-87.63897
TA1309000058,4,23,false,17,9,-8,41.92591,-87.64927
TA1308000001,4,23,false,6,12,6,41.92627,-87.63086
TA1309000023,4,23,false,9,8,-1,41.9287,-87.65383
TA1307000113,4,23,false,17,5,-12,41.92878,-87.66391
TA1309000061,4,23,false,9,5,-4,41.92915,-87.64909
TA1307000142,4,23,false,4,13,9,41.93125,-87.64432
TA1307000064,4,23,false,6,5,-1,41.93222,-87.65864
TA1306000014,4,23,false,5,14,9,41.93242,-87.65271
TA1309000039,4,23,false,5,12,7,41.93258,-87.63642
13294,4,23,false,2,6,4,41.9326,-87.66595
TA1307000006,4,23,false,5,10,5,41.93571,-87.6636
TA1307000052,4,23,false,4,5,1,41.93628,-87.65266
TA1307000136,4,23,false,4,5,1,41.9365,-87.64755
13137,4,23,false,5,9,4,41.9376,-87.6441
TA1309000042,4,23,false,2,7,5,41.93937,-87.66836
TA1308000019,4,23,false,4,6,2,41.93973,-87.65886
TA1307000134,4,23,false,6,7,1,41.94016,-87.65303
TA1309000049,4,23,false,2,8,6,41.94077,-87.63919
13144,4,23,false,1,5,4,41.9434,-87.67964
TA1309000025,4,23,false,15,9,-6,41.94368,-87.64894
13071,4,23,false,1,7,6,41.94373,-87.66401
632,4,23,false,12,15,3,41.94453,-87.6547
13278,4,23,false,3,7,4,41.94553,-87.64644
13235,4,23,false,6,9,3,41.94814,-87.66396
13325,4,23,false,1,7,6,41.94907,-87.64863
TA1307000126,4,23,false,4,8,4,41.94936,-87.65451
13323,4,23,false,2,9,7,41.95282,-87.65
13063,4,23,false,2,7,5,41.95424,-87.65441
TA1307000107,4,23,false,3,5,2,41.96164,-87.65464
TA1307000140,4,23,false,1,5,4,41.96643,-87.68865
TA1309000041,4,23,false,1,5,4,41.96951,-87.65471
KA1504000149,4,23,false,2,6,4,41.97562,-87.67945
KA1503000014,4,23,true,6,4,-2,41.7851,-87.60108
KA1504000076,4,23,true,6,2,-4,41.7943,-87.60145
SL-005,4,23,true,3,6,3,41.8679,-87.62304
13332,4,23,true,1,5,4,41.87219,-87.6615
13300,4,23,true,5,1,-4,41.88097,-87.61675
TA1305000032,4,23,true,1,8,7,41.88218,-87.64109
13409,4,23,true,8,3,-5,41.8831,-87.6511
13053,4,23,true,7,8,1,41.88365,-87.64863
TA1305000029,4,23,true,4,6,2,41.88466,-87.62787
KA1503000012,4,23,true,8,3,-5,41.88599,-87.63089
TA1308000029,4,23,true,8,4,-4,41.88673,-87.62225
TA1306000003,4,23,true,11,12,1,41.88867,-87.64442
KA1503000043,4,23,true,4,9,5,41.88918,-87.63851
13050,4,23,true,4,6,2,41.88919,-87.62775
TA1307000151,4,23,true,12,9,-3,41.88993,-87.63427
636,4,23,true,5,3,-2,41.88997,-87.63662
13430,4,23,true,13,6,-7,41.89077,-87.63169
RN-,4,23,true,8,2,-6,41.89102,-87.63546
TA1307000117,4,23,true,2,5,3,41.89144,-87.62675
13033,4,23,true,6,7,1,41.8916,-87.64835
13045,4,23,true,6,5,-1,41.89403,-87.62931
KA1503000041,4,23,true,3,10,7,41.89452,-87.61798
TA1307000062,4,23,true,6,3,-3,41.89466,-87.63839
TA1306000012,4,23,true,5,13,8,41.89475,-87.63438
13303,4,23,true,6,3,-3,41.89672,-87.63088
13017,4,23,true,5,3,-2,41.89676,-87.6357
TA1307000061,4,23,true,6,1,-5,41.89745,-87.62873
620,4,23,true,6,6,0,41.89817,-87.63754
TA1307000128,4,23,true,2,5,3,41.89896,-87.6299
TA1306000011,4,23,true,5,5,0,41.89994,-87.63443
KA1504000133,4,23,true,2,5,3,41.90234,-87.62773
TA1307000039,4,23,true,10,11,1,41.90294,-87.63137
KA1504000135,4,23,true,21,9,-12,41.90319,-87.63439
13136,4,23,true,5,3,-2,41.90326,-87.67845
13061,4,23,true,8,6,-2,41.90342,-87.66779
TA1308000049,4,23,true,11,9,-2,41.90672,-87.6349
13224,4,23,true,2,7,5,41.90706,-87.66725
TA1307000143,4,23,true,5,5,0,41.90762,-87.63854
13221,4,23,true,2,7,5,41.90765,-87.67254
TA1309000024,4,23,true,12,9,-3,41.908,-87.63152
331,4,23,true,4,6,2,41.90965,-87.64812
TA1307000038,4,23,true,16,6,-10,41.91138,-87.63868
TA1308000050,4,23,true,14,15,1,41.91211,-87.6347
TA1307000166,4,23,true,10,4,-6,41.91386,-87.64877
13179,4,23,true,7,3,-4,41.9157,-87.63461
13133,4,23,true,4,9,5,41.91598,-87.67733
TA1309000006,4,23,true,4,9,5,41.91809,-87.64375
13146,4,23,true,12,7,-5,41.91831,-87.63629
13059,4,23,true,10,5,-5,41.91845,-87.65222
13192,4,23,true,7,5,-2,41.91995,-87.64884
13193,4,23,true,11,7,-4,41.92182,-87.64412
13084,4,23,true,8,4,-4,41.92268,-87.69715
TA1306000026,4,23,true,8,4,-4,41.92558,-87.65842
TA1306000016,4,23,true,5,8,3,41.9256,-87.65371
TA1309000058,4,23,true,15,8,-7,41.92591,-87.64927
TA1309000023,4,23,true,5,6,1,41.9287,-87.65383
TA1307000113,4,23,true,1,6,5,41.92878,-87.66391
TA1305000014,4,23,true,5,3,-2,41.92956,-87.64313
13271,4,23,true,2,6,4,41.93192,-87.67784
TA1306000014,4,23,true,2,6,4,41.93242,-87.65271
TA1309000039,4,23,true,3,10,7,41.93258,-87.63642
13294,4,23,true,3,5,2,41.9326,-87.66595
TA1309000036,4,23,true,1,5,4,41.93313,-87.64776
TA1307000052,4,23,true,2,10,8,41.93628,-87.65266
TA1307000136,4,23,true,3,5,2,41.9365,-87.64755
13137,4,23,true,1,6,5,41.9376,-87.6441
TA1309000042,4,23,true,1,6,5,41.93937,-87.66836
TA1308000019,4,23,true,4,5,1,41.93973,-87.65886
TA1307000134,4,23,true,5,4,-1,41.94016,-87.65303
TA1309000025,4,23,true,6,9,3,41.94368,-87.64894
13071,4,23,true,3,8,5,41.94373,-87.66401
632,4,23,true,7,7,0,41.94453,-87.6547
13235,4,23,true,3,11,8,41.94814,-87.66396
13325,4,23,true,3,6,3,41.94907,-87.64863
TA1307000126,4,23,true,6,4,-2,41.94936,-87.65451
TA1307000150,4,23,true,1,10,9,41.94945,-87.64646
TA1307000127,4,23,true,6,4,-2,41.9508,-87.65918
13323,4,23,true,5,11,6,41.95282,-87.65
13063,4,23,true,9,3,-6,41.95424,-87.65441
13389,4,23,true,1,5,4,41.961,-87.64958
13074,4,23,true,2,7,5,41.96521,-87.6582
TA1308000009,5,0,false,5,6,1,41.79522,-87.58075
TA1305000001,5,0,false,1,5,4,41.85262,-87.6265
13075,5,0,false,5,5,0,41.8531,-87.63192
13164,5,0,false,7,5,-2,41.85818,-87.65648
TA1307000124,5,0,false,2,5,3,41.86411,-87.62372
TA1305000002,5,0,false,5,14,9,41.86721,-87.62597
SL-005,5,0,false,5,10,5,41.8679,-87.62304
TA1309000010,5,0,false,8,12,4,41.87074,-87.62574
SL-011,5,0,false,6,3,-3,41.87256,-87.63356
623,5,0,false,17,13,-4,41.87272,-87.62399
SL-007,5,0,false,7,9,2,41.87404,-87.6277
15541,5,0,false,16,5,-11,41.8758,-87.62086
TA1309000002,5,0,false,4,6,2,41.87784,-87.62408
KA1503000015,5,0,false,14,16,2,41.87948,-87.6257
13008,5,0,false,18,19,1,41.88105,-87.62408
TA1307000120,5,0,false,3,6,3,41.88188,-87.64879
13001,5,0,false,4,8,4,41.88397,-87.62459
15535,5,0,false,8,9,1,41.8846,-87.64455
TA1305000029,5,0,false,4,5,1,41.88466,-87.62787
13263,5,0,false,4,7,3,41.88467,-87.61952
TA1306000015,5,0,false,10,1,-9,41.88549,-87.65232
TA1307000111,5,0,false,6,1,-5,41.88582,-87.63548
TA1305000011,5,0,false,5,14,9,41.886,-87.62418
TA1307000131,5,0,false,10,20,10,41.88688,-87.62606
TA1305000022,5,0,false,5,3,-2,41.88817,-87.63656
TA1306000003,5,0,false,8,1,-7,41.88867,-87.64442
KA1503000043,5,0,false,8,3,-5,41.88918,-87.63851
13050,5,0,false,3,12,9,41.88919,-87.62775
TA1307000151,5,0,false,6,11,5,41.88993,-87.63427
13430,5,0,false,3,6,3,41.89077,-87.63169
TA1306000013,5,0,false,7,12,5,41.89083,-87.61852
RN-,5,0,false,2,6,4,41.89102,-87.63546
TA1307000117,5,0,false,12,10,-2,41.89144,-87.62675
TA1305000003,5,0,false,5,10,5,41.89187,-87.62061
13022,5,0,false,6,13,7,41.89227,-87.61205
13045,5,0,false,2,12,10,41.89403,-87.62931
13016,5,0,false,5,5,0,41.89431,-87.62277
TA1306000012,5,0,false,8,2,-6,41.89475,-87.63438
15530,5,0,false,2,5,3,41.89575,-87.62596
TA1307000061,5,0,false,6,4,-2,41.89745,-87.62873
13042,5,0,false,5,15,10,41.90097,-87.62377
TA1307000039,5,0,false,15,5,-10,41.90294,-87.63137
KA1504000135,5,0,false,12,6,-6,41.90319,-87.63439
13061,5,0,false,8,6,-2,41.90342,-87.66779
TA1308000049,5,0,false,8,1,-7,41.90672,-87.6349
TA1307000038,5,0,false,3,9,6,41.91138,-87.63868
TA1308000050,5,0,false,6,10,4,41.91211,-87.6347
13133,5,0,false,1,8,7,41.91598,-87.67733
13146,5,0,false,8,10,2,41.91831,-87.63629
13059,5,0,false,2,5,3,41.91845,-87.65222
13192,5,0,false,9,3,-6,41.91995,-87.64884
TA1309000033,5,0,false,5,5,0,41.92158,-87.65381
13193,5,0,false,18,10,-8,41.92182,-87.64412
LP-,5,0,false,7,8,1,41.92396,-87.63584
TA1306000026,5,0,false,1,5,4,41.92558,-87.65842
TA1309000019,5,0,false,7,3,-4,41.92586,-87.63897
TA1309000058,5,0,false,12,8,-4,41.92591,-87.64927
15646,5,0,false,6,1,-5,41.92668,-87.6977
TA1309000023,5,0,false,9,6,-3,41.9287,-87.65383
TA1309000061,5,0,false,4,5,1,41.92915,-87.64909
13276,5,0,false,5,4,-1,41.93132,-87.63874
TA1306000014,5,0,false,4,11,7,41.93242,-87.65271
TA1307000052,5,0,false,2,5,3,41.93628,-87.65266
TA1307000136,5,0,false,6,4,-2,41.9365,-87.64755
13277,5,0,false,2,5,3,41.9401,-87.64546
TA1309000025,5,0,false,9,10,1,41.94368,-87.64894
632,5,0,false,11,1,-10,41.94453,-87.6547
TA1307000126,5,0,false,5,2,-3,41.94936,-87.65451
RP-009,5,0,false,6,3,-3,42.00107,-87.66122
TA1307000120,5,0,true,5,3,-2,41.88188,-87.64879
TA1305000032,5,0,true,3,6,3,41.88218,-87.64109
TA1306000015,5,0,true,10,2,-8,41.88549,-87.65232
TA1306000003,5,0,true,5,3,-2,41.88867,-87.64442
TA1306000013,5,0,true,1,5,4,41.89083,-87.61852
TA1307000117,5,0,true,5,7,2,41.89144,-87.62675
13045,5,0,true,8,5,-3,41.89403,-87.62931
15530,5,0,true,4,5,1,41.89575,-87.62596
TA1307000039,5,0,true,12,9,-3,41.90294,-87.63137
KA1504000135,5,0,true,6,6,0,41.90319,-87.63439
13061,5,0,true,3,5,2,41.90342,-87.66779
TA1308000049,5,0,true,2,7,5,41.90672,-87.6349
TA1305000041,5,0,true,5,2,-3,41.9094,-87.67769
TA1305000037,5,0,true,1,5,4,41.91018,-87.67003
TA1307000038,5,0,true,4,6,2,41.91138,-87.63868
TA1308000050,5,0,true,9,8,-1,41.91211,-87.6347
13133,5,0,true,4,5,1,41.91598,-87.67733
13146,5,0,true,9,4,-5,41.91831,-87.63629
13059,5,0,true,1,6,5,41.91845,-87.65222
13193,5,0,true,12,7,-5,41.92182,-87.64412
TA1309000058,5,0,true,7,5,-2,41.92591,-87.64927
TA1309000023,5,0,true,2,5,3,41.9287,-87.65383
TA1309000061,5,0,true,5,5,0,41.92915,-87.64909
TA1307000064,5,0,true,2,7,5,41.93222,-87.65864
TA1307000136,5,0,true,7,2,-5,41.9365,-87.64755
TA1307000134,5,0,true,7,8,1,41.94016,-87.65303
TA1309000025,5,0,true,12,9,-3,41.94368,-87.64894
13071,5,0,true,4,5,1,41.94373,-87.66401
632,5,0,true,7,2,-5,41.94453,-87.6547
13325,5,0,true,3,5,2,41.94907,-87.64863
TA1307000126,5,0,true,7,3,-4,41.94936,-87.65451
13323,5,0,true,4,7,3,41.95282,-87.65
TA1305000002,5,1,false,6,5,-1,41.86721,-87.62597
15544,5,1,false,5,6,1,41.86723,-87.61536
SL-005,5,1,false,8,4,-4,41.8679,-87.62304
SL-007,5,1,false,1,5,4,41.87404,-87.6277
TA1305000010,5,1,false,7,2,-5,41.87623,-87.62444
KA1503000015,5,1,false,3,16,13,41.87948,-87.6257
13008,5,1,false,5,12,7,41.88105,-87.62408
TA1307000120,5,1,false,1,5,4,41.88188,-87.64879
13001,5,1,false,5,2,-3,41.88397,-87.62459
TA1305000029,5,1,false,7,6,-1,41.88466,-87.62787
TA1307000131,5,1,false,12,6,-6,41.88688,-87.62606
KA1503000043,5,1,false,5,7,2,41.88918,-87.63851
13430,5,1,false,5,9,4,41.89077,-87.63169
TA1305000003,5,1,false,6,6,0,41.89187,-87.62061
13022,5,1,false,2,5,3,41.89227,-87.61205
TA1306000029,5,1,false,6,1,-5,41.89256,-87.61449
13045,5,1,false,5,9,4,41.89403,-87.62931
13303,5,1,false,1,7,6,41.89672,-87.63088
13042,5,1,false,7,6,-1,41.90097,-87.62377
TA1307000070,5,1,false,7,2,-5,41.90133,-87.67742
TA1307000039,5,1,false,5,6,1,41.90294,-87.63137
TA1308000049,5,1,false,5,3,-2,41.90672,-87.6349
13221,5,1,false,8,3,-5,41.90765,-87.67254
TA1307000166,5,1,false,5,2,-3,41.91386,-87.64877
13192,5,1,false,9,3,-6,41.91995,-87.64884
TA1309000033,5,1,false,7,6,-1,41.92158,-87.65381
13193,5,1,false,8,1,-7,41.92182,-87.64412
TA1309000058,5,1,false,6,9,3,41.92591,-87.64927
TA1309000023,5,1,false,5,1,-4,41.9287,-87.65383
13276,5,1,false,3,6,3,41.93132,-87.63874
TA1306000014,5,1,false,2,5,3,41.93242,-87.65271
TA1309000036,5,1,false,5,2,-3,41.93313,-87.64776
TA1309000025,5,1,false,3,11,8,41.94368,-87.64894
632,5,1,false,7,9,2,41.94453,-87.6547
13235,5,1,false,2,8,6,41.94814,-87.66396
TA1307000039,5,1,true,4,5,1,41.90294,-87.63137
TA1307000038,5,1,true,5,3,-2,41.91138,-87.63868
TA1309000006,5,1,true,5,1,-4,41.91809,-87.64375
13192,5,1,true,5,2,-3,41.91995,-87.64884
13193,5,1,true,7,6,-1,41.92182,-87.64412
TA1309000061,5,1,true,2,5,3,41.92915,-87.64909
TA1305000014,5,1,true,2,7,5,41.92956,-87.64313
TA1309000025,5,1,true,12,5,-7,41.94368,-87.64894
15541,5,2,false,8,3,-5,41.8758,-87.62086
TA1305000010,5,2,false,2,7,5,41.87623,-87.62444
KA1503000015,5,2,false,6,5,-1,41.87948,-87.6257
13008,5,2,false,13,3,-10,41.88105,-87.62408
TA1305000032,5,2,false,5,8,3,41.88218,-87.64109
13001,5,2,false,2,6,4,41.88397,-87.62459
TA1305000011,5,2,false,5,1,-4,41.886,-87.62418
13430,5,2,false,2,9,7,41.89077,-87.63169
KP1705001026,5,2,false,2,9,7,41.89483,-87.6323
13042,5,2,false,6,6,0,41.90097,-87.62377
TA1306000014,5,2,false,2,7,5,41.93242,-87.65271
TA1307000134,5,2,false,8,1,-7,41.94016,-87.65303
TA1309000025,5,2,false,11,2,-9,41.94368,-87.64894
KA1504000134,5,2,true,5,1,-4,41.90687,-87.6262
TA1309000010,5,3,false,4,6,2,41.87074,-87.62574
13008,5,3,false,4,11,7,41.88105,-87.62408
13022,5,3,false,7,4,-3,41.89227,-87.61205
TA1307000039,5,3,false,9,1,-8,41.90294,-87.63137
13323,5,3,false,6,2,-4,41.95282,-87.65
SL-008,5,5,true,4,5,1,41.87209,-87.62956
TA1305000006,5,5,true,2,5,3,41.88122,-87.6296
13263,5,5,true,5,1,-4,41.88467,-87.61952
KA1503000043,5,5,true,2,7,5,41.88918,-87.63851
13016,5,5,true,2,14,12,41.89431,-87.62277
13132,5,5,true,6,1,-5,41.89573,-87.67718
620,5,5,true,5,2,-3,41.89817,-87.63754
TA1307000039,5,5,true,11,6,-5,41.90294,-87.63137
TA1309000061,5,5,true,6,1,-5,41.92915,-87.64909
13045,5,6,false,3,7,4,41.89403,-87.62931
13338,5,6,false,1,5,4,41.89697,-87.62173
TA1306000009,5,6,false,2,6,4,41.89772,-87.64299
TA1307000039,5,6,false,8,1,-7,41.90294,-87.63137
13193,5,6,false,5,1,-4,41.92182,-87.64412
TA1308000001,5,6,false,5,1,-4,41.92627,-87.63086
13150,5,6,true,5,1,-4,41.85783,-87.62455
TA1307000124,5,6,true,7,1,-6,41.86411,-87.62372
TA1305000002,5,6,true,5,1,-4,41.86721,-87.62597
SL-005,5,6,true,7,4,-3,41.8679,-87.62304
TA1305000035,5,6,true,1,5,4,41.87716,-87.62787
TA1309000004,5,6,true,5,21,16,41.87811,-87.63184
638,5,6,true,9,15,6,41.87827,-87.64078
13011,5,6,true,5,4,-1,41.87931,-87.63993
13156,5,6,true,10,3,-7,41.88042,-87.65554
TA1305000006,5,6,true,1,15,14,41.88122,-87.6296
13056,5,6,true,4,5,1,41.88168,-87.63951
TA1307000120,5,6,true,3,9,6,41.88188,-87.64879
13341,5,6,true,9,5,-4,41.88208,-87.63985
TA1305000032,5,6,true,9,14,5,41.88218,-87.64109
13006,5,6,true,2,6,4,41.88268,-87.63252
WL-012,5,6,true,15,2,-13,41.88337,-87.6412
13001,5,6,true,10,11,1,41.88397,-87.62459
13263,5,6,true,13,5,-8,41.88467,-87.61952
13021,5,6,true,9,2,-7,41.88559,-87.64184
TA1307000111,5,6,true,3,8,5,41.88582,-87.63548
TA1305000011,5,6,true,9,6,-3,41.886,-87.62418
TA1308000029,5,6,true,2,7,5,41.88673,-87.62225
TA1305000022,5,6,true,5,6,1,41.88817,-87.63656
TA1306000003,5,6,true,11,8,-3,41.88867,-87.64442
KA1503000043,5,6,true,15,16,1,41.88918,-87.63851
636,5,6,true,5,4,-1,41.88997,-87.63662
TA1307000117,5,6,true,5,7,2,41.89144,-87.62675
13033,5,6,true,6,4,-2,41.8916,-87.64835
13194,5,6,true,6,2,-4,41.8918,-87.65878
TA1305000003,5,6,true,6,1,-5,41.89187,-87.62061
13022,5,6,true,5,5,0,41.89227,-87.61205
13265,5,6,true,20,2,-18,41.89383,-87.64172
13045,5,6,true,10,17,7,41.89403,-87.62931
KA1503000041,5,6,true,5,16,11,41.89452,-87.61798
TA1307000062,5,6,true,4,9,5,41.89466,-87.63839
TA1306000012,5,6,true,10,12,2,41.89475,-87.63438
KP1705001026,5,6,true,8,1,-7,41.89483,-87.6323
15530,5,6,true,1,9,8,41.89575,-87.62596
13289,5,6,true,7,3,-4,41.89638,-87.661
13303,5,6,true,9,5,-4,41.89672,-87.63088
13017,5,6,true,6,4,-2,41.89676,-87.6357
13338,5,6,true,7,15,8,41.89697,-87.62173
13034,5,6,true,3,11,8,41.89754,-87.62352
TA1306000009,5,6,true,2,8,6,41.89772,-87.64299
15529,5,6,true,6,8,2,41.89858,-87.62206
TA1307000128,5,6,true,5,1,-4,41.89896,-87.6299
TA1307000039,5,6,true,12,9,-3,41.90294,-87.63137
13061,5,6,true,6,3,-3,41.90342,-87.66779
KA1504000134,5,6,true,9,1,-8,41.90687,-87.6262
TA1309000024,5,6,true,10,4,-6,41.908,-87.63152
TA1305000041,5,6,true,5,4,-1,41.9094,-87.67769
TA1308000050,5,6,true,12,9,-3,41.91211,-87.6347
13179,5,6,true,5,7,2,41.9157,-87.63461
13146,5,6,true,8,2,-6,41.91831,-87.63629
13059,5,6,true,5,1,-4,41.91845,-87.65222
TA1309000033,5,6,true,6,5,-1,41.92158,-87.65381
13193,5,6,true,5,2,-3,41.92182,-87.64412
TA1306000016,5,6,true,1,9,8,41.9256,-87.65371
TA1309000061,5,6,true,10,4,-6,41.92915,-87.64909
TA1305000014,5,6,true,6,1,-5,41.92956,-87.64313
13277,5,6,true,5,1,-4,41.9401,-87.64546
TA1307000134,5,6,true,5,5,0,41.94016,-87.65303
TA1309000025,5,6,true,2,5,3,41.94368,-87.64894
13071,5,6,true,6,1,-5,41.94373,-87.66401
13278,5,6,true,5,3,-2,41.94553,-87.64644
13325,5,6,true,5,4,-1,41.94907,-87.64863
13379,5,6,true,4,5,1,41.95786,-87.6495
15544,5,7,false,5,1,-4,41.86723,-87.61536
TA1309000010,5,7,false,7,1,-6,41.87074,-87.62574
TA1309000004,5,7,false,1,5,4,41.87811,-87.63184
TA1305000006,5,7,false,1,8,7,41.88122,-87.6296
TA1307000120,5,7,false,8,3,-5,41.88188,-87.64879
13001,5,7,false,3,5,2,41.88397,-87.62459
TA1305000030,5,7,false,1,6,5,41.88459,-87.63178
TA1307000131,5,7,false,6,1,-5,41.88688,-87.62606
TA1306000003,5,7,false,5,2,-3,41.88867,-87.64442
KA1503000043,5,7,false,8,3,-5,41.88918,-87.63851
TA1306000013,5,7,false,5,1,-4,41.89083,-87.61852
TA1307000117,5,7,false,5,2,-3,41.89144,-87.62675
13022,5,7,false,8,5,-3,41.89227,-87.61205
TA1306000029,5,7,false,5,4,-1,41.89256,-87.61449
13045,5,7,false,6,4,-2,41.89403,-87.62931
13016,5,7,false,1,5,4,41.89431,-87.62277
TA1306000012,5,7,false,4,6,2,41.89475,-87.63438
13303,5,7,false,5,2,-3,41.89672,-87.63088
TA1307000128,5,7,false,8,2,-6,41.89896,-87.6299
13042,5,7,false,10,5,-5,41.90097,-87.62377
TA1307000039,5,7,false,11,1,-10,41.90294,-87.63137
TA1308000050,5,7,false,7,12,5,41.91211,-87.6347
TA1307000163,5,7,false,8,1,-7,41.91821,-87.65696
13146,5,7,false,5,7,2,41.91831,-87.63629
TA1309000030,5,7,false,2,5,3,41.92077,-87.66372
TA1307000064,5,7,false,7,1,-6,41.93222,-87.65864
TA1307000052,5,7,false,6,1,-5,41.93628,-87.65266
15545,5,7,true,5,3,-2,41.85627,-87.61334
13135,5,7,true,5,2,-3,41.85753,-87.66157
SL-012,5,7,true,6,3,-3,41.86038,-87.62581
TA1307000124,5,7,true,5,3,-2,41.86411,-87.62372
TA1305000002,5,7,true,17,3,-14,41.86721,-87.62597
SL-005,5,7,true,9,3,-6,41.8679,-87.62304
13285,5,7,true,1,8,7,41.86928,-87.67372
TA1309000010,5,7,true,8,1,-7,41.87074,-87.62574
TA1309000064,5,7,true,2,24,22,41.87127,-87.67369
TA1307000121,5,7,true,4,5,1,41.87184,-87.64664
SL-008,5,7,true,12,3,-9,41.87209,-87.62956
13332,5,7,true,5,3,-2,41.87219,-87.6615
SL-011,5,7,true,7,4,-3,41.87256,-87.63356
623,5,7,true,5,4,-1,41.87272,-87.62399
KA1504000104,5,7,true,3,16,13,41.87296,-87.66912
SL-007,5,7,true,5,3,-2,41.87404,-87.6277
SL-010,5,7,true,10,2,-8,41.87501,-87.63309
TA1305000009,5,7,true,5,3,-2,41.87593,-87.63068
TA1305000035,5,7,true,3,5,2,41.87716,-87.62787
13138,5,7,true,5,11,6,41.87723,-87.63941
15539,5,7,true,7,3,-4,41.87763,-87.64405
13158,5,7,true,16,4,-12,41.87764,-87.64957
13157,5,7,true,10,4,-6,41.87773,-87.6548
TA1305000025,5,7,true,5,12,7,41.87773,-87.63528
TA1309000004,5,7,true,4,33,29,41.87811,-87.63184
638,5,7,true,8,16,8,41.87827,-87.64078
TA1305000005,5,7,true,1,9,8,41.87924,-87.62975
13011,5,7,true,12,5,-7,41.87931,-87.63993
TA1309000008,5,7,true,5,23,18,41.87933,-87.6355
KA1503000034,5,7,true,1,8,7,41.87938,-87.63197
KA1503000015,5,7,true,1,11,10,41.87948,-87.6257
TA1309000007,5,7,true,1,26,25,41.88022,-87.63526
13156,5,7,true,13,1,-12,41.88042,-87.65554
13300,5,7,true,4,6,2,41.88097,-87.61675
13008,5,7,true,5,4,-1,41.88105,-87.62408
TA1305000006,5,7,true,3,13,10,41.88122,-87.6296
13056,5,7,true,10,16,6,41.88168,-87.63951
TA1307000120,5,7,true,7,9,2,41.88188,-87.64879
13341,5,7,true,11,11,0,41.88208,-87.63985
TA1305000032,5,7,true,16,17,1,41.88218,-87.64109
13006,5,7,true,3,10,7,41.88268,-87.63252
13353,5,7,true,5,9,4,41.88283,-87.6612
KA1503000072,5,7,true,3,8,5,41.88317,-87.63693
WL-012,5,7,true,12,8,-4,41.88337,-87.6412
13053,5,7,true,7,4,-3,41.88365,-87.64863
13001,5,7,true,1,12,11,41.88397,-87.62459
13155,5,7,true,1,8,7,41.88407,-87.65689
18062,5,7,true,8,8,0,41.88412,-87.65427
TA1306000010,5,7,true,3,16,13,41.88419,-87.62961
TA1305000030,5,7,true,4,8,4,41.88459,-87.63178
TA1305000029,5,7,true,5,7,2,41.88466,-87.62787
13263,5,7,true,17,9,-8,41.88467,-87.61952
TA1306000015,5,7,true,4,6,2,41.88549,-87.65232
13021,5,7,true,7,14,7,41.88559,-87.64184
TA1307000111,5,7,true,11,11,0,41.88582,-87.63548
KA1503000012,5,7,true,5,2,-3,41.88599,-87.63089
TA1305000011,5,7,true,4,21,17,41.886,-87.62418
15534,5,7,true,6,1,-5,41.88627,-87.61749
13197,5,7,true,4,6,2,41.8866,-87.65816
TA1308000029,5,7,true,6,6,0,41.88673,-87.62225
TA1307000131,5,7,true,5,7,2,41.88688,-87.62606
TA1305000022,5,7,true,15,9,-6,41.88817,-87.63656
TA1306000003,5,7,true,19,2,-17,41.88867,-87.64442
KA1503000043,5,7,true,20,23,3,41.88918,-87.63851
13050,5,7,true,4,6,2,41.88919,-87.62775
15664,5,7,true,7,1,-6,41.8895,-87.68821
TA1307000151,5,7,true,10,19,9,41.88993,-87.63427
636,5,7,true,5,4,-1,41.88997,-87.63662
13427,5,7,true,10,2,-8,41.89054,-87.62205
13430,5,7,true,3,5,2,41.89077,-87.63169
TA1306000013,5,7,true,8,3,-5,41.89083,-87.61852
RN-,5,7,true,9,2,-7,41.89102,-87.63546
TA1308000006,5,7,true,5,4,-1,41.89128,-87.67686
TA1307000117,5,7,true,11,11,0,41.89144,-87.62675
13033,5,7,true,10,4,-6,41.8916,-87.64835
13194,5,7,true,5,5,0,41.8918,-87.65878
TA1305000003,5,7,true,3,6,3,41.89187,-87.62061
13022,5,7,true,6,8,2,41.89227,-87.61205
TA1306000029,5,7,true,4,7,3,41.89256,-87.61449
13045,5,7,true,19,21,2,41.89403,-87.62931
13016,5,7,true,9,36,27,41.89431,-87.62277
KA1503000041,5,7,true,4,27,23,41.89452,-87.61798
TA1307000062,5,7,true,8,9,1,41.89466,-87.63839
TA1306000012,5,7,true,17,8,-9,41.89475,-87.63438
KP1705001026,5,7,true,8,7,-1,41.89483,-87.6323
13132,5,7,true,7,3,-4,41.89573,-87.67718
15530,5,7,true,4,19,15,41.89575,-87.62596
18003,5,7,true,4,8,4,41.89575,-87.62011
TA1305000020,5,7,true,6,6,0,41.89636,-87.65406
13289,5,7,true,10,1,-9,41.89638,-87.661
13017,5,7,true,8,8,0,41.89676,-87.6357
13338,5,7,true,11,8,-3,41.89697,-87.62173
13034,5,7,true,4,9,5,41.89754,-87.62352
TA1306000009,5,7,true,13,26,13,41.89772,-87.64299
15529,5,7,true,3,6,3,41.89858,-87.62206
TA1307000128,5,7,true,23,5,-18,41.89896,-87.6299
657,5,7,true,5,1,-4,41.89918,-87.6722
13248,5,7,true,9,2,-7,41.89964,-87.66788
KA1504000116,5,7,true,5,2,-3,41.90023,-87.64299
13290,5,7,true,7,3,-4,41.90069,-87.66259
13042,5,7,true,10,5,-5,41.90097,-87.62377
TA1307000070,5,7,true,6,2,-4,41.90133,-87.67742
KA1504000133,5,7,true,10,6,-4,41.90234,-87.62773
TA1306000006,5,7,true,11,4,-7,41.90292,-87.63772
TA1307000039,5,7,true,30,20,-10,41.90294,-87.63137
TA1305000034,5,7,true,2,7,5,41.90313,-87.67391
KA1504000135,5,7,true,7,7,0,41.90319,-87.63439
13061,5,7,true,8,8,0,41.90342,-87.66779
KA1504000079,5,7,true,6,5,-1,41.9035,-87.64334
TA1307000115,5,7,true,5,3,-2,41.9046,-87.64056
TA1308000049,5,7,true,6,2,-4,41.90672,-87.6349
13224,5,7,true,5,6,1,41.90706,-87.66725
TA1307000143,5,7,true,11,2,-9,41.90762,-87.63854
13221,5,7,true,8,5,-3,41.90765,-87.67254
TA1309000024,5,7,true,15,3,-12,41.908,-87.63152
TA1305000041,5,7,true,2,12,10,41.9094,-87.67769
TA1305000037,5,7,true,1,7,6,41.91018,-87.67003
TA1306000008,5,7,true,8,1,-7,41.9102,-87.6435
13058,5,7,true,1,5,4,41.91059,-87.64942
TA1307000038,5,7,true,5,2,-3,41.91138,-87.63868
TA1308000050,5,7,true,20,19,-1,41.91211,-87.6347
13179,5,7,true,6,1,-5,41.9157,-87.63461
TA1305000039,5,7,true,2,5,3,41.9163,-87.66749
TA1307000163,5,7,true,4,8,4,41.91821,-87.65696
13146,5,7,true,12,2,-10,41.91831,-87.63629
13059,5,7,true,9,9,0,41.91845,-87.65222
13193,5,7,true,12,8,-4,41.92182,-87.64412
13191,5,7,true,8,3,-5,41.92217,-87.63891
TA1306000016,5,7,true,2,10,8,41.9256,-87.65371
TA1309000019,5,7,true,12,3,-9,41.92586,-87.63897
TA1309000058,5,7,true,7,4,-3,41.92591,-87.64927
TA1308000001,5,7,true,5,4,-1,41.92627,-87.63086
TA1309000061,5,7,true,6,3,-3,41.92915,-87.64909
TA1305000014,5,7,true,11,9,-2,41.92956,-87.64313
TA1307000142,5,7,true,7,5,-2,41.93125,-87.64432
TA1307000064,5,7,true,5,10,5,41.93222,-87.65864
TA1306000014,5,7,true,13,4,-9,41.93242,-87.65271
TA1309000039,5,7,true,11,8,-3,41.93258,-87.63642
13294,5,7,true,6,5,-1,41.9326,-87.66595
TA1309000036,5,7,true,5,3,-2,41.93313,-87.64776
TA1307000006,5,7,true,10,5,-5,41.93571,-87.6636
13268,5,7,true,6,3,-3,41.93588,-87.67843
TA1307000052,5,7,true,9,8,-1,41.93628,-87.65266
TA1307000136,5,7,true,7,7,0,41.9365,-87.64755
TA1307000041,5,7,true,6,1,-5,41.93669,-87.63683
13137,5,7,true,5,2,-3,41.9376,-87.6441
TA1309000042,5,7,true,5,8,3,41.93937,-87.66836
TA1308000019,5,7,true,7,2,-5,41.93973,-87.65886
13277,5,7,true,4,6,2,41.9401,-87.64546
TA1307000134,5,7,true,3,7,4,41.94016,-87.65303
TA1309000049,5,7,true,7,1,-6,41.94077,-87.63919
TA1307000138,5,7,true,6,3,-3,41.94334,-87.67094
13071,5,7,true,1,7,6,41.94373,-87.66401
632,5,7,true,6,2,-4,41.94453,-87.6547
13278,5,7,true,11,4,-7,41.94553,-87.64644
13235,5,7,true,8,5,-3,41.94814,-87.66396
13325,5,7,true,6,2,-4,41.94907,-87.64863
TA1307000126,5,7,true,5,2,-3,41.94936,-87.65451
TA1307000150,5,7,true,7,5,-2,41.94945,-87.64646
13323,5,7,true,3,5,2,41.95282,-87.65
13063,5,7,true,5,5,0,41.95424,-87.65441
TA1308000022,5,7,true,4,5,1,41.95438,-87.64805
TA1307000149,5,7,true,1,6,5,41.95467,-87.67392
13379,5,7,true,9,1,-8,41.95786,-87.6495
639,5,7,true,2,7,5,41.96584,-87.64538
TA1307000158,5,7,true,4,7,3,41.9671,-87.67904
13108,5,7,true,5,3,-2,41.97379,-87.65971
KA1503000014,5,8,false,8,1,-7,41.7851,-87.60108
15544,5,8,false,1,9,8,41.86723,-87.61536
SL-005,5,8,false,12,2,-10,41.8679,-87.62304
TA1309000010,5,8,false,6,1,-5,41.87074,-87.62574
623,5,8,false,8,1,-7,41.87272,-87.62399
TA1305000025,5,8,false,3,5,2,41.87773,-87.63528
13011,5,8,false,8,4,-4,41.87931,-87.63993
TA1309000007,5,8,false,1,5,4,41.88022,-87.63526
13008,5,8,false,4,7,3,41.88105,-87.62408
KA1503000072,5,8,false,2,5,3,41.88317,-87.63693
WL-012,5,8,false,2,5,3,41.88337,-87.6412
13001,5,8,false,9,5,-4,41.88397,-87.62459
18062,5,8,false,5,6,1,41.88412,-87.65427
TA1306000010,5,8,false,5,5,0,41.88419,-87.62961
TA1306000015,5,8,false,1,6,5,41.88549,-87.65232
13021,5,8,false,5,3,-2,41.88559,-87.64184
TA1307000111,5,8,false,2,9,7,41.88582,-87.63548
TA1305000011,5,8,false,11,6,-5,41.886,-87.62418
15534,5,8,false,5,4,-1,41.88627,-87.61749
TA1307000131,5,8,false,6,4,-2,41.88688,-87.62606
KA1503000064,5,8,false,3,5,2,41.88697,-87.61281
KA1503000043,5,8,false,5,6,1,41.88918,-87.63851
13050,5,8,false,11,5,-6,41.88919,-87.62775
TA1307000151,5,8,false,5,2,-3,41.88993,-87.63427
636,5,8,false,2,8,6,41.88997,-87.63662
13427,5,8,false,5,3,-2,41.89054,-87.62205
TA1306000013,5,8,false,5,7,2,41.89083,-87.61852
RN-,5,8,false,2,10,8,41.89102,-87.63546
TA1305000003,5,8,false,7,7,0,41.89187,-87.62061
13022,5,8,false,10,8,-2,41.89227,-87.61205
TA1306000029,5,8,false,6,1,-5,41.89256,-87.61449
13045,5,8,false,6,7,1,41.89403,-87.62931
KA1503000041,5,8,false,7,3,-4,41.89452,-87.61798
13196,5,8,false,6,2,-4,41.89455,-87.65345
TA1306000012,5,8,false,12,3,-9,41.89475,-87.63438
TA1306000009,5,8,false,3,6,3,41.89772,-87.64299
15529,5,8,false,5,1,-4,41.89858,-87.62206
13042,5,8,false,7,11,4,41.90097,-87.62377
KA1504000133,5,8,false,5,1,-4,41.90234,-87.62773
TA1307000039,5,8,false,6,7,1,41.90294,-87.63137
KA1504000135,5,8,false,6,6,0,41.90319,-87.63439
13136,5,8,false,3,5,2,41.90326,-87.67845
KA1504000134,5,8,false,9,2,-7,41.90687,-87.6262
TA1307000038,5,8,false,5,2,-3,41.91138,-87.63868
TA1308000050,5,8,false,5,6,1,41.91211,-87.6347
13146,5,8,false,7,3,-4,41.91831,-87.63629
13193,5,8,false,7,2,-5,41.92182,-87.64412
13191,5,8,false,5,2,-3,41.92217,-87.63891
LP-,5,8,false,10,2,-8,41.92396,-87.63584
TA1306000026,5,8,false,1,9,8,41.92558,-87.65842
TA1309000049,5,8,false,5,6,1,41.94077,-87.63919
TA1307000129,5,8,true,1,9,8,41.83104,-87.62683
TA1307000153,5,8,true,6,1,-5,41.84358,-87.64538
TA1307000005,5,8,true,3,6,3,41.84569,-87.6225
13135,5,8,true,6,2,-4,41.85753,-87.66157
13150,5,8,true,7,3,-4,41.85783,-87.62455
SL-012,5,8,true,7,3,-4,41.86038,-87.62581
TA1307000124,5,8,true,5,8,3,41.86411,-87.62372
TA1305000002,5,8,true,10,7,-3,41.86721,-87.62597
15544,5,8,true,6,4,-2,41.86723,-87.61536
TA1305000017,5,8,true,1,7,6,41.86734,-87.64863
SL-005,5,8,true,20,6,-14,41.8679,-87.62304
13285,5,8,true,2,8,6,41.86928,-87.67372
TA1309000010,5,8,true,8,3,-5,41.87074,-87.62574
SL-009,5,8,true,7,3,-4,41.87081,-87.63121
TA1309000064,5,8,true,3,10,7,41.87127,-87.67369
TA1307000130,5,8,true,6,4,-2,41.87178,-87.65103
TA1307000121,5,8,true,2,9,7,41.87184,-87.64664
SL-008,5,8,true,13,3,-10,41.87209,-87.62956
13332,5,8,true,13,3,-10,41.87219,-87.6615
SL-011,5,8,true,17,7,-10,41.87256,-87.63356
KA1504000104,5,8,true,2,21,19,41.87296,-87.66912
SL-007,5,8,true,10,1,-9,41.87404,-87.6277
13326,5,8,true,1,5,4,41.87425,-87.63958
13028,5,8,true,1,6,5,41.87475,-87.64981
SL-010,5,8,true,10,2,-8,41.87501,-87.63309
TA1305000009,5,8,true,8,4,-4,41.87593,-87.63068
TA1305000010,5,8,true,6,1,-5,41.87623,-87.62444
624,5,8,true,6,5,-1,41.87626,-87.62923
13158,5,8,true,13,9,-4,41.87764,-87.64957
13157,5,8,true,6,6,0,41.87773,-87.6548
TA1305000025,5,8,true,9,19,10,41.87773,-87.63528
TA1309000002,5,8,true,1,6,5,41.87784,-87.62408
TA1309000004,5,8,true,1,15,14,41.87811,-87.63184
638,5,8,true,8,18,10,41.87827,-87.64078
TA1305000005,5,8,true,3,15,12,41.87924,-87.62975
13011,5,8,true,17,13,-4,41.87931,-87.63993
TA1309000008,5,8,true,6,8,2,41.87933,-87.6355
KA1503000015,5,8,true,6,11,5,41.87948,-87.6257
TA1309000007,5,8,true,3,26,23,41.88022,-87.63526
WL-011,5,8,true,8,3,-5,41.88034,-87.64273
13156,5,8,true,7,4,-3,41.88042,-87.65554
13300,5,8,true,10,7,-3,41.88097,-87.61675
13008,5,8,true,1,8,7,41.88105,-87.62408
TA1305000006,5,8,true,3,36,33,41.88122,-87.6296
13056,5,8,true,10,6,-4,41.88168,-87.63951
TA1307000120,5,8,true,16,6,-10,41.88188,-87.64879
13341,5,8,true,6,9,3,41.88208,-87.63985
13036,5,8,true,5,9,4,41.8821,-87.62513
TA1305000032,5,8,true,17,7,-10,41.88218,-87.64109
13006,5,8,true,3,11,8,41.88268,-87.63252
13353,5,8,true,13,6,-7,41.88283,-87.6612
13409,5,8,true,9,4,-5,41.8831,-87.6511
KA1503000072,5,8,true,4,22,18,41.88317,-87.63693
WL-012,5,8,true,19,19,0,41.88337,-87.6412
13053,5,8,true,5,7,2,41.88365,-87.64863
13001,5,8,true,7,19,12,41.88397,-87.62459
18062,5,8,true,5,8,3,41.88412,-87.65427
TA1306000010,5,8,true,5,22,17,41.88419,-87.62961
TA1305000030,5,8,true,5,36,31,41.88459,-87.63178
15535,5,8,true,5,7,2,41.8846,-87.64455
TA1305000029,5,8,true,5,5,0,41.88466,-87.62787
13263,5,8,true,11,11,0,41.88467,-87.61952
TA1306000015,5,8,true,6,14,8,41.88549,-87.65232
13021,5,8,true,6,18,12,41.88559,-87.64184
TA1307000111,5,8,true,6,21,15,41.88582,-87.63548
KA1503000012,5,8,true,7,18,11,41.88599,-87.63089
TA1305000011,5,8,true,7,23,16,41.886,-87.62418
15534,5,8,true,20,4,-16,41.88627,-87.61749
13197,5,8,true,1,7,6,41.8866,-87.65816
KA1503000064,5,8,true,1,9,8,41.88697,-87.61281
TA1305000022,5,8,true,7,20,13,41.88817,-87.63656
TA1306000003,5,8,true,16,6,-10,41.88867,-87.64442
KA1503000043,5,8,true,26,26,0,41.88918,-87.63851
13050,5,8,true,8,22,14,41.88919,-87.62775
13432,5,8,true,2,6,4,41.88989,-87.67149
TA1307000151,5,8,true,15,24,9,41.88993,-87.63427
636,5,8,true,11,12,1,41.88997,-87.63662
KA1503000044,5,8,true,6,18,12,41.89018,-87.6262
13427,5,8,true,10,7,-3,41.89054,-87.62205
13430,5,8,true,6,15,9,41.89077,-87.63169
TA1306000013,5,8,true,7,3,-4,41.89083,-87.61852
RN-,5,8,true,5,4,-1,41.89102,-87.63546
TA1308000006,5,8,true,3,5,2,41.89128,-87.67686
TA1307000117,5,8,true,11,9,-2,41.89144,-87.62675
13033,5,8,true,9,6,-3,41.8916,-87.64835
13194,5,8,true,7,4,-3,41.8918,-87.65878
TA1305000003,5,8,true,11,5,-6,41.89187,-87.62061
13022,5,8,true,11,7,-4,41.89227,-87.61205
TA1306000029,5,8,true,3,7,4,41.89256,-87.61449
13265,5,8,true,7,8,1,41.89383,-87.64172
13045,5,8,true,16,18,2,41.89403,-87.62931
13016,5,8,true,9,32,23,41.89431,-87.62277
KA1503000041,5,8,true,7,19,12,41.89452,-87.61798
13196,5,8,true,6,6,0,41.89455,-87.65345
TA1307000062,5,8,true,6,12,6,41.89466,-87.63839
TA1306000012,5,8,true,20,10,-10,41.89475,-87.63438
KP1705001026,5,8,true,6,1,-5,41.89483,-87.6323
15530,5,8,true,11,16,5,41.89575,-87.62596
18003,5,8,true,5,6,1,41.89575,-87.62011
13289,5,8,true,5,3,-2,41.89638,-87.661
13303,5,8,true,5,3,-2,41.89672,-87.63088
13017,5,8,true,12,9,-3,41.89676,-87.6357
13338,5,8,true,7,14,7,41.89697,-87.62173
TA1307000061,5,8,true,10,6,-4,41.89745,-87.62873
13034,5,8,true,1,9,8,41.89754,-87.62352
TA1306000009,5,8,true,5,26,21,41.89772,-87.64299
KA1504000103,5,8,true,7,7,0,41.89842,-87.68659
15529,5,8,true,9,11,2,41.89858,-87.62206
TA1307000128,5,8,true,9,8,-1,41.89896,-87.6299
657,5,8,true,7,1,-6,41.89918,-87.6722
TA1306000011,5,8,true,15,2,-13,41.89994,-87.63443
13290,5,8,true,9,2,-7,41.90069,-87.66259
13042,5,8,true,5,9,4,41.90097,-87.62377
TA1307000070,5,8,true,5,2,-3,41.90133,-87.67742
TA1306000006,5,8,true,6,1,-5,41.90292,-87.63772
TA1307000039,5,8,true,30,14,-16,41.90294,-87.63137
658,5,8,true,2,6,4,41.903,-87.6838
TA1305000034,5,8,true,11,3,-8,41.90313,-87.67391
KA1504000135,5,8,true,13,12,-1,41.90319,-87.63439
13136,5,8,true,7,1,-6,41.90326,-87.67845
13061,5,8,true,11,13,2,41.90342,-87.66779
KA1504000079,5,8,true,6,3,-3,41.9035,-87.64334
TA1308000049,5,8,true,6,6,0,41.90672,-87.6349
KA1504000134,5,8,true,7,1,-6,41.90687,-87.6262
13224,5,8,true,5,1,-4,41.90706,-87.66725
13221,5,8,true,6,7,1,41.90765,-87.67254
TA1309000024,5,8,true,7,8,1,41.908,-87.63152
TA1305000041,5,8,true,6,5,-1,41.9094,-87.67769
TA1305000037,5,8,true,6,4,-2,41.91018,-87.67003
TA1306000008,5,8,true,7,4,-3,41.9102,-87.6435
13154,5,8,true,10,9,-1,41.91054,-87.65312
13058,5,8,true,8,3,-5,41.91059,-87.64942
TA1307000038,5,8,true,9,7,-2,41.91138,-87.63868
LF-005,5,8,true,10,3,-7,41.91172,-87.62681
TA1308000050,5,8,true,18,12,-6,41.91211,-87.6347
18067,5,8,true,5,3,-2,41.9146,-87.66796
TA1306000007,5,8,true,9,3,-6,41.91469,-87.64333
13068,5,8,true,4,6,2,41.91554,-87.68703
13179,5,8,true,6,9,3,41.9157,-87.63461
TA1305000039,5,8,true,1,5,4,41.9163,-87.66749
TA1309000006,5,8,true,7,4,-3,41.91809,-87.64375
TA1307000163,5,8,true,11,6,-5,41.91821,-87.65696
13146,5,8,true,17,14,-3,41.91831,-87.63629
13059,5,8,true,7,4,-3,41.91845,-87.65222
13192,5,8,true,9,9,0,41.91995,-87.64884
TA1309000030,5,8,true,5,5,0,41.92077,-87.66372
13292,5,8,true,6,1,-5,41.92152,-87.70733
TA1309000033,5,8,true,4,6,2,41.92158,-87.65381
13193,5,8,true,14,16,2,41.92182,-87.64412
13191,5,8,true,16,6,-10,41.92217,-87.63891
LP-,5,8,true,9,3,-6,41.92396,-87.63584
TA1306000026,5,8,true,3,5,2,41.92558,-87.65842
TA1309000019,5,8,true,11,4,-7,41.92586,-87.63897
TA1309000058,5,8,true,12,10,-2,41.92591,-87.64927
TA1308000001,5,8,true,9,4,-5,41.92627,-87.63086
TA1309000023,5,8,true,10,4,-6,41.9287,-87.65383
TA1309000059,5,8,true,7,3,-4,41.92889,-87.65898
TA1309000061,5,8,true,10,12,2,41.92915,-87.64909
TA1305000014,5,8,true,9,6,-3,41.92956,-87.64313
TA1307000142,5,8,true,6,5,-1,41.93125,-87.64432
13276,5,8,true,12,5,-7,41.93132,-87.63874
TA1307000064,5,8,true,12,9,-3,41.93222,-87.65864
TA1306000014,5,8,true,6,11,5,41.93242,-87.65271
TA1309000039,5,8,true,10,5,-5,41.93258,-87.63642
TA1309000036,5,8,true,6,9,3,41.93313,-87.64776
TA1307000052,5,8,true,6,7,1,41.93628,-87.65266
TA1307000136,5,8,true,8,11,3,41.9365,-87.64755
TA1307000041,5,8,true,8,6,-2,41.93669,-87.63683
13137,5,8,true,11,6,-5,41.9376,-87.6441
TA1309000042,5,8,true,7,2,-5,41.93937,-87.66836
13229,5,8,true,9,4,-5,41.93946,-87.66376
TA1308000019,5,8,true,5,1,-4,41.93973,-87.65886
13277,5,8,true,9,3,-6,41.9401,-87.64546
TA1307000134,5,8,true,6,3,-3,41.94016,-87.65303
TA1309000049,5,8,true,9,7,-2,41.94077,-87.63919
TA1309000025,5,8,true,6,2,-4,41.94368,-87.64894
13071,5,8,true,5,6,1,41.94373,-87.66401
632,5,8,true,6,4,-2,41.94453,-87.6547
13278,5,8,true,6,4,-2,41.94553,-87.64644
13235,5,8,true,4,9,5,41.94814,-87.66396
TA1307000126,5,8,true,1,8,7,41.94936,-87.65451
TA1307000150,5,8,true,6,2,-4,41.94945,-87.64646
13319,5,8,true,5,3,-2,41.95069,-87.6687
TA1307000127,5,8,true,8,5,-3,41.9508,-87.65918
13063,5,8,true,3,6,3,41.95424,-87.65441
TA1307000149,5,8,true,1,11,10,41.95467,-87.67392
TA1309000026,5,8,true,1,5,4,41.95601,-87.6802
13379,5,8,true,11,3,-8,41.95786,-87.6495
13389,5,8,true,3,6,3,41.961,-87.64958
TA1307000107,5,8,true,6,1,-5,41.96164,-87.65464
639,5,8,true,3,6,3,41.96584,-87.64538
KA1504000127,5,8,true,6,1,-5,41.96587,-87.70083
TA1309000014,5,8,true,5,5,0,41.96709,-87.66744
TA1307000158,5,8,true,6,4,-2,41.9671,-87.67904
TA1309000066,5,8,true,6,1,-5,41.9691,-87.67423
15575,5,8,true,6,2,-4,41.98975,-87.66014
15571,5,8,true,8,3,-5,41.99478,-87.66028
KA1504000076,5,9,false,1,5,4,41.7943,-87.60145
KA1503000059,5,9,false,9,2,-7,41.79952,-87.58643
KA1503000007,5,9,false,6,3,-3,41.80242,-87.58689
TA1307000048,5,9,false,5,3,-2,41.83855,-87.60821
13029,5,9,false,1,6,5,41.86531,-87.6179
WL-008,5,9,false,8,3,-5,41.86712,-87.64108
15544,5,9,false,8,9,1,41.86723,-87.61536
SL-005,5,9,false,10,1,-9,41.8679,-87.62304
TA1309000010,5,9,false,4,5,1,41.87074,-87.62574
SL-011,5,9,false,6,4,-2,41.87256,-87.63356
623,5,9,false,16,6,-10,41.87272,-87.62399
15541,5,9,false,3,11,8,41.8758,-87.62086
TA1305000010,5,9,false,1,5,4,41.87623,-87.62444
TA1305000025,5,9,false,2,7,5,41.87773,-87.63528
KA1503000015,5,9,false,6,1,-5,41.87948,-87.6257
13300,5,9,false,10,11,1,41.88097,-87.61675
13008,5,9,false,12,6,-6,41.88105,-87.62408
TA1305000006,5,9,false,11,7,-4,41.88122,-87.6296
TA1307000120,5,9,false,4,5,1,41.88188,-87.64879
TA1305000032,5,9,false,7,3,-4,41.88218,-87.64109
13006,5,9,false,5,3,-2,41.88268,-87.63252
WL-012,5,9,false,7,2,-5,41.88337,-87.6412
13053,5,9,false,1,5,4,41.88365,-87.64863
TA1305000030,5,9,false,7,2,-5,41.88459,-87.63178
TA1307000111,5,9,false,3,6,3,41.88582,-87.63548
KA1503000012,5,9,false,6,4,-2,41.88599,-87.63089
TA1305000011,5,9,false,2,14,12,41.886,-87.62418
15534,5,9,false,7,3,-4,41.88627,-87.61749
TA1307000131,5,9,false,9,5,-4,41.88688,-87.62606
KA1503000064,5,9,false,8,6,-2,41.88697,-87.61281
13050,5,9,false,5,9,4,41.88919,-87.62775
TA1307000151,5,9,false,4,11,7,41.88993,-87.63427
636,5,9,false,5,1,-4,41.88997,-87.63662
13430,5,9,false,7,1,-6,41.89077,-87.63169
RN-,5,9,false,5,2,-3,41.89102,-87.63546
TA1307000117,5,9,false,5,4,-1,41.89144,-87.62675
TA1305000003,5,9,false,8,3,-5,41.89187,-87.62061
13022,5,9,false,11,10,-1,41.89227,-87.61205
TA1306000029,5,9,false,5,6,1,41.89256,-87.61449
13045,5,9,false,7,10,3,41.89403,-87.62931
13016,5,9,false,7,6,-1,41.89431,-87.62277
KA1503000041,5,9,false,6,2,-4,41.89452,-87.61798
TA1306000012,5,9,false,9,3,-6,41.89475,-87.63438
13017,5,9,false,6,4,-2,41.89676,-87.6357
13034,5,9,false,1,5,4,41.89754,-87.62352
15529,5,9,false,5,3,-2,41.89858,-87.62206
TA1307000128,5,9,false,7,5,-2,41.89896,-87.6299
13042,5,9,false,14,14,0,41.90097,-87.62377
KA1504000133,5,9,false,3,7,4,41.90234,-87.62773
TA1307000039,5,9,false,10,10,0,41.90294,-87.63137
KA1504000135,5,9,false,6,4,-2,41.90319,-87.63439
TA1308000049,5,9,false,1,5,4,41.90672,-87.6349
TA1305000041,5,9,false,2,6,4,41.9094,-87.67769
331,5,9,false,7,6,-1,41.90965,-87.64812
LF-005,5,9,false,5,5,0,41.91172,-87.62681
13128,5,9,false,6,3,-3,41.91197,-87.63197
TA1308000050,5,9,false,4,9,5,41.91211,-87.6347
TA1305000039,5,9,false,5,1,-4,41.9163,-87.66749
TA1309000006,5,9,false,9,4,-5,41.91809,-87.64375
13146,5,9,false,7,1,-6,41.91831,-87.63629
TA1309000019,5,9,false,5,2,-3,41.92586,-87.63897
TA1307000142,5,9,false,8,5,-3,41.93125,-87.64432
TA1309000039,5,9,false,3,5,2,41.93258,-87.63642
TA1307000136,5,9,false,6,5,-1,41.9365,-87.64755
TA1307000041,5,9,false,6,3,-3,41.93669,-87.63683
13137,5,9,false,4,6,2,41.9376,-87.6441
15642,5,9,false,6,5,-1,41.93843,-87.69801
TA1309000049,5,9,false,5,1,-4,41.94077,-87.63919
13278,5,9,false,13,1,-12,41.94553,-87.64644
13235,5,9,false,1,8,7,41.94814,-87.66396
TA1307000126,5,9,false,4,5,1,41.94936,-87.65451
TA1307000150,5,9,false,7,2,-5,41.94945,-87.64646
TA1307000127,5,9,false,4,5,1,41.9508,-87.65918
13323,5,9,false,8,3,-5,41.95282,-87.65
KA1503000071,5,9,true,3,11,8,41.79148,-87.59988
TA1309000037,5,9,true,8,2,-6,41.79957,-87.59474
KA1503000007,5,9,true,6,1,-5,41.80242,-87.58689
13216,5,9,true,2,5,3,41.83473,-87.62581
13215,5,9,true,5,1,-4,41.83634,-87.6135
TA1308000036,5,9,true,7,1,-6,41.83883,-87.62186
15545,5,9,true,5,3,-2,41.85627,-87.61334
13102,5,9,true,8,1,-7,41.85762,-87.61942
13150,5,9,true,7,4,-3,41.85783,-87.62455
SL-012,5,9,true,5,2,-3,41.86038,-87.62581
WL-008,5,9,true,6,1,-5,41.86712,-87.64108
TA1305000002,5,9,true,6,3,-3,41.86721,-87.62597
SL-005,5,9,true,19,7,-12,41.8679,-87.62304
13285,5,9,true,1,7,6,41.86928,-87.67372
TA1309000010,5,9,true,16,9,-7,41.87074,-87.62574
TA1309000064,5,9,true,3,7,4,41.87127,-87.67369
TA1307000130,5,9,true,1,5,4,41.87178,-87.65103
13332,5,9,true,10,6,-4,41.87219,-87.6615
SL-011,5,9,true,5,1,-4,41.87256,-87.63356
KA1504000104,5,9,true,3,6,3,41.87296,-87.66912
TA1305000035,5,9,true,1,5,4,41.87716,-87.62787
13158,5,9,true,5,6,1,41.87764,-87.64957
13157,5,9,true,6,2,-4,41.87773,-87.6548
TA1305000025,5,9,true,2,14,12,41.87773,-87.63528
TA1309000004,5,9,true,8,6,-2,41.87811,-87.63184
638,5,9,true,4,5,1,41.87827,-87.64078
TA1305000005,5,9,true,1,19,18,41.87924,-87.62975
TA1309000008,5,9,true,3,6,3,41.87933,-87.6355
KA1503000015,5,9,true,3,8,5,41.87948,-87.6257
TA1309000007,5,9,true,2,16,14,41.88022,-87.63526
13156,5,9,true,5,3,-2,41.88042,-87.65554
13008,5,9,true,1,5,4,41.88105,-87.62408
TA1305000006,5,9,true,5,19,14,41.88122,-87.6296
TA1307000120,5,9,true,10,10,0,41.88188,-87.64879
13341,5,9,true,1,7,6,41.88208,-87.63985
13036,5,9,true,5,6,1,41.8821,-87.62513
TA1305000032,5,9,true,7,8,1,41.88218,-87.64109
KA1503000072,5,9,true,3,8,5,41.88317,-87.63693
WL-012,5,9,true,8,11,3,41.88337,-87.6412
13053,5,9,true,5,8,3,41.88365,-87.64863
13001,5,9,true,4,6,2,41.88397,-87.62459
TA1306000010,5,9,true,3,14,11,41.88419,-87.62961
TA1305000030,5,9,true,2,21,19,41.88459,-87.63178
15535,5,9,true,2,6,4,41.8846,-87.64455
TA1305000029,5,9,true,4,11,7,41.88466,-87.62787
13263,5,9,true,6,3,-3,41.88467,-87.61952
TA1306000015,5,9,true,5,14,9,41.88549,-87.65232
13021,5,9,true,6,12,6,41.88559,-87.64184
TA1307000111,5,9,true,5,6,1,41.88582,-87.63548
KA1503000012,5,9,true,9,8,-1,41.88599,-87.63089
TA1305000011,5,9,true,6,12,6,41.886,-87.62418
15534,5,9,true,5,6,1,41.88627,-87.61749
TA1308000029,5,9,true,3,7,4,41.88673,-87.62225
TA1307000131,5,9,true,1,5,4,41.88688,-87.62606
TA1305000022,5,9,true,15,10,-5,41.88817,-87.63656
TA1306000003,5,9,true,6,7,1,41.88867,-87.64442
KA1503000043,5,9,true,18,14,-4,41.88918,-87.63851
13050,5,9,true,9,8,-1,41.88919,-87.62775
TA1307000151,5,9,true,9,12,3,41.88993,-87.63427
13427,5,9,true,5,3,-2,41.89054,-87.62205
13430,5,9,true,6,8,2,41.89077,-87.63169
TA1306000013,5,9,true,8,2,-6,41.89083,-87.61852
RN-,5,9,true,1,9,8,41.89102,-87.63546
TA1307000117,5,9,true,3,14,11,41.89144,-87.62675
13033,5,9,true,7,4,-3,41.8916,-87.64835
13194,5,9,true,3,7,4,41.8918,-87.65878
TA1305000003,5,9,true,9,5,-4,41.89187,-87.62061
13022,5,9,true,2,5,3,41.89227,-87.61205
TA1306000029,5,9,true,7,3,-4,41.89256,-87.61449
13265,5,9,true,8,8,0,41.89383,-87.64172
13045,5,9,true,7,14,7,41.89403,-87.62931
13016,5,9,true,10,16,6,41.89431,-87.62277
KA1503000041,5,9,true,10,16,6,41.89452,-87.61798
13196,5,9,true,10,1,-9,41.89455,-87.65345
TA1307000062,5,9,true,8,2,-6,41.89466,-87.63839
TA1306000012,5,9,true,4,9,5,41.89475,-87.63438
TA1305000020,5,9,true,4,6,2,41.89636,-87.65406
13017,5,9,true,8,9,1,41.89676,-87.6357
TA1307000061,5,9,true,7,2,-5,41.89745,-87.62873
TA1306000009,5,9,true,5,15,10,41.89772,-87.64299
620,5,9,true,5,5,0,41.89817,-87.63754
15529,5,9,true,8,13,5,41.89858,-87.62206
TA1307000128,5,9,true,5,9,4,41.89896,-87.6299
TA1306000011,5,9,true,5,3,-2,41.89994,-87.63443
13042,5,9,true,7,15,8,41.90097,-87.62377
KA1504000133,5,9,true,4,6,2,41.90234,-87.62773
TA1307000039,5,9,true,12,10,-2,41.90294,-87.63137
KA1504000135,5,9,true,12,13,1,41.90319,-87.63439
13061,5,9,true,7,6,-1,41.90342,-87.66779
KA1504000079,5,9,true,6,3,-3,41.9035,-87.64334
TA1308000049,5,9,true,7,5,-2,41.90672,-87.6349
13221,5,9,true,7,3,-4,41.90765,-87.67254
TA1306000008,5,9,true,5,1,-4,41.9102,-87.6435
13154,5,9,true,2,7,5,41.91054,-87.65312
13058,5,9,true,6,6,0,41.91059,-87.64942
TA1308000050,5,9,true,15,14,-1,41.91211,-87.6347
13179,5,9,true,5,6,1,41.9157,-87.63461
TA1309000006,5,9,true,4,7,3,41.91809,-87.64375
13146,5,9,true,9,2,-7,41.91831,-87.63629
13059,5,9,true,3,6,3,41.91845,-87.65222
13192,5,9,true,5,5,0,41.91995,-87.64884
13288,5,9,true,5,1,-4,41.92008,-87.67788
TA1309000030,5,9,true,5,5,0,41.92077,-87.66372
TA1309000033,5,9,true,5,7,2,41.92158,-87.65381
13193,5,9,true,5,6,1,41.92182,-87.64412
13191,5,9,true,6,5,-1,41.92217,-87.63891
TA1306000026,5,9,true,5,6,1,41.92558,-87.65842
TA1306000016,5,9,true,7,2,-5,41.9256,-87.65371
TA1309000019,5,9,true,7,5,-2,41.92586,-87.63897
TA1309000058,5,9,true,3,5,2,41.92591,-87.64927
TA1308000001,5,9,true,7,5,-2,41.92627,-87.63086
TA1309000059,5,9,true,5,4,-1,41.92889,-87.65898
TA1309000061,5,9,true,1,7,6,41.92915,-87.64909
TA1305000014,5,9,true,5,7,2,41.92956,-87.64313
13085,5,9,true,1,5,4,41.92958,-87.70789
13276,5,9,true,6,5,-1,41.93132,-87.63874
TA1307000064,5,9,true,7,3,-4,41.93222,-87.65864
TA1309000039,5,9,true,6,4,-2,41.93258,-87.63642
TA1307000006,5,9,true,7,4,-3,41.93571,-87.6636
TA1307000052,5,9,true,6,7,1,41.93628,-87.65266
TA1307000041,5,9,true,12,6,-6,41.93669,-87.63683
13229,5,9,true,6,3,-3,41.93946,-87.66376
TA1308000019,5,9,true,4,6,2,41.93973,-87.65886
13277,5,9,true,5,1,-4,41.9401,-87.64546
TA1307000134,5,9,true,4,7,3,41.94016,-87.65303
TA1309000049,5,9,true,5,5,0,41.94077,-87.63919
TA1307000138,5,9,true,4,5,1,41.94334,-87.67094
13278,5,9,true,6,4,-2,41.94553,-87.64644
13235,5,9,true,8,6,-2,41.94814,-87.66396
13325,5,9,true,7,8,1,41.94907,-87.64863
TA1307000126,5,9,true,4,7,3,41.94936,-87.65451
TA1307000150,5,9,true,5,1,-4,41.94945,-87.64646
13319,5,9,true,4,5,1,41.95069,-87.6687
TA1307000127,5,9,true,9,7,-2,41.9508,-87.65918
13323,5,9,true,6,1,-5,41.95282,-87.65
13063,5,9,true,6,10,4,41.95424,-87.65441
13389,5,9,true,6,2,-4,41.961,-87.64958
TA1307000144,5,9,true,5,4,-1,41.96142,-87.6762
TA1307000107,5,9,true,5,3,-2,41.96164,-87.65464
TA1307000158,5,9,true,4,6,2,41.9671,-87.67904
TA1307000119,5,9,true,2,6,4,41.96796,-87.65
13108,5,9,true,2,5,3,41.97379,-87.65971
KA1504000160,5,9,true,3,5,2,41.97564,-87.70143
KA1504000146,5,9,true,6,2,-4,41.978,-87.66805
KA1504000152,5,9,true,7,2,-5,41.98403,-87.65231
15575,5,9,true,7,1,-6,41.98975,-87.66014
15571,5,9,true,6,1,-5,41.99478,-87.66028
604,5,9,true,1,8,7,42.05824,-87.67744
15491,5,10,false,3,5,2,41.78096,-87.57624
KA1503000071,5,10,false,5,2,-3,41.79148,-87.59988
KA1503000074,5,10,false,1,8,7,41.79174,-87.58395
TA1308000009,5,10,false,2,6,4,41.79522,-87.58075
13029,5,10,false,4,6,2,41.86531,-87.6179
13431,5,10,false,4,6,2,41.8661,-87.60728
TA1305000002,5,10,false,6,7,1,41.86721,-87.62597
15544,5,10,false,10,22,12,41.86723,-87.61536
SL-005,5,10,false,9,9,0,41.8679,-87.62304
TA1309000010,5,10,false,8,3,-5,41.87074,-87.62574
SL-008,5,10,false,6,1,-5,41.87209,-87.62956
623,5,10,false,10,9,-1,41.87272,-87.62399
15541,5,10,false,18,8,-10,41.8758,-87.62086
13157,5,10,false,5,4,-1,41.87773,-87.6548
TA1305000025,5,10,false,6,3,-3,41.87773,-87.63528
TA1309000002,5,10,false,5,3,-2,41.87784,-87.62408
TA1309000008,5,10,false,11,1,-10,41.87933,-87.6355
KA1503000015,5,10,false,4,7,3,41.87948,-87.6257
TA1309000007,5,10,false,5,2,-3,41.88022,-87.63526
WL-011,5,10,false,5,4,-1,41.88034,-87.64273
13300,5,10,false,14,14,0,41.88097,-87.61675
13008,5,10,false,18,24,6,41.88105,-87.62408
13036,5,10,false,6,6,0,41.8821,-87.62513
WL-012,5,10,false,9,3,-6,41.88337,-87.6412
13053,5,10,false,8,5,-3,41.88365,-87.64863
13001,5,10,false,13,3,-10,41.88397,-87.62459
18062,5,10,false,5,4,-1,41.88412,-87.65427
TA1306000010,5,10,false,8,5,-3,41.88419,-87.62961
15535,5,10,false,2,6,4,41.8846,-87.64455
13263,5,10,false,10,5,-5,41.88467,-87.61952
TA1306000015,5,10,false,5,5,0,41.88549,-87.65232
TA1307000111,5,10,false,3,6,3,41.88582,-87.63548
TA1305000011,5,10,false,15,8,-7,41.886,-87.62418
15534,5,10,false,12,3,-9,41.88627,-87.61749
TA1308000029,5,10,false,7,3,-4,41.88673,-87.62225
TA1307000131,5,10,false,18,14,-4,41.88688,-87.62606
KA1503000064,5,10,false,6,7,1,41.88697,-87.61281
TA1306000003,5,10,false,5,2,-3,41.88867,-87.64442
KA1503000043,5,10,false,2,9,7,41.88918,-87.63851
13050,5,10,false,11,11,0,41.88919,-87.62775
13427,5,10,false,11,7,-4,41.89054,-87.62205
TA1306000013,5,10,false,6,9,3,41.89083,-87.61852
TA1307000117,5,10,false,9,8,-1,41.89144,-87.62675
TA1305000003,5,10,false,5,4,-1,41.89187,-87.62061
13022,5,10,false,27,40,13,41.89227,-87.61205
13045,5,10,false,10,12,2,41.89403,-87.62931
TA1307000062,5,10,false,7,5,-2,41.89466,-87.63839
TA1306000012,5,10,false,6,3,-3,41.89475,-87.63438
15530,5,10,false,6,5,-1,41.89575,-87.62596
13017,5,10,false,9,4,-5,41.89676,-87.6357
TA1307000061,5,10,false,4,8,4,41.89745,-87.62873
13034,5,10,false,1,5,4,41.89754,-87.62352
15529,5,10,false,8,6,-2,41.89858,-87.62206
13042,5,10,false,34,16,-18,41.90097,-87.62377
KA1504000133,5,10,false,6,5,-1,41.90234,-87.62773
13241,5,10,false,6,1,-5,41.9029,-87.68731
TA1307000039,5,10,false,11,14,3,41.90294,-87.63137
KA1504000135,5,10,false,6,10,4,41.90319,-87.63439
TA1308000049,5,10,false,4,5,1,41.90672,-87.6349
KA1504000134,5,10,false,7,1,-6,41.90687,-87.6262
TA1305000041,5,10,false,5,7,2,41.9094,-87.67769
331,5,10,false,3,8,5,41.90965,-87.64812
13058,5,10,false,4,5,1,41.91059,-87.64942
LF-005,5,10,false,10,7,-3,41.91172,-87.62681
13128,5,10,false,3,5,2,41.91197,-87.63197
TA1308000050,5,10,false,5,10,5,41.91211,-87.6347
13179,5,10,false,11,7,-4,41.9157,-87.63461
TA1307000163,5,10,false,6,4,-2,41.91821,-87.65696
13146,5,10,false,6,10,4,41.91831,-87.63629
13059,5,10,false,2,8,6,41.91845,-87.65222
LP-,5,10,false,4,6,2,41.92396,-87.63584
TA1309000019,5,10,false,8,2,-6,41.92586,-87.63897
TA1309000058,5,10,false,7,5,-2,41.92591,-87.64927
TA1308000001,5,10,false,12,11,-1,41.92627,-87.63086
TA1307000142,5,10,false,13,2,-11,41.93125,-87.64432
13276,5,10,false,11,2,-9,41.93132,-87.63874
TA1309000039,5,10,false,6,7,1,41.93258,-87.63642
TA1307000006,5,10,false,3,5,2,41.93571,-87.6636
TA1307000041,5,10,false,12,5,-7,41.93669,-87.63683
13137,5,10,false,9,8,-1,41.9376,-87.6441
TA1308000019,5,10,false,5,2,-3,41.93973,-87.65886
TA1309000049,5,10,false,8,2,-6,41.94077,-87.63919
632,5,10,false,9,8,-1,41.94453,-87.6547
13278,5,10,false,6,1,-5,41.94553,-87.64644
13235,5,10,false,5,1,-4,41.94814,-87.66396
13325,5,10,false,8,7,-1,41.94907,-87.64863
TA1307000127,5,10,false,5,5,0,41.9508,-87.65918
TA1308000012,5,10,false,1,6,5,41.96398,-87.63818
TA1307000119,5,10,false,5,2,-3,41.96796,-87.65
RP-009,5,10,false,5,2,-3,42.00107,-87.66122
KA1503000071,5,10,true,8,12,4,41.79148,-87.59988
13216,5,10,true,1,5,4,41.83473,-87.62581
15545,5,10,true,8,7,-1,41.85627,-87.61334
13150,5,10,true,10,3,-7,41.85783,-87.62455
TA1305000002,5,10,true,13,14,1,41.86721,-87.62597
SL-005,5,10,true,5,3,-2,41.8679,-87.62304
13285,5,10,true,2,10,8,41.86928,-87.67372
13160,5,10,true,6,2,-4,41.86947,-87.65548
TA1309000010,5,10,true,5,8,3,41.87074,-87.62574
TA1309000064,5,10,true,3,11,8,41.87127,-87.67369
TA1307000130,5,10,true,3,6,3,41.87178,-87.65103
TA1307000121,5,10,true,2,8,6,41.87184,-87.64664
SL-008,5,10,true,4,5,1,41.87209,-87.62956
13332,5,10,true,7,3,-4,41.87219,-87.6615
624,5,10,true,2,11,9,41.87626,-87.62923
13158,5,10,true,7,7,0,41.87764,-87.64957
13157,5,10,true,5,4,-1,41.87773,-87.6548
TA1305000025,5,10,true,3,10,7,41.87773,-87.63528
KA1503000034,5,10,true,3,5,2,41.87938,-87.63197
TA1309000007,5,10,true,1,5,4,41.88022,-87.63526
13008,5,10,true,3,9,6,41.88105,-87.62408
TA1305000006,5,10,true,5,9,4,41.88122,-87.6296
TA1307000120,5,10,true,5,3,-2,41.88188,-87.64879
TA1305000032,5,10,true,6,5,-1,41.88218,-87.64109
13006,5,10,true,3,5,2,41.88268,-87.63252
13409,5,10,true,5,7,2,41.8831,-87.6511
KA1503000072,5,10,true,2,5,3,41.88317,-87.63693
WL-012,5,10,true,3,11,8,41.88337,-87.6412
13001,5,10,true,5,12,7,41.88397,-87.62459
TA1306000010,5,10,true,7,8,1,41.88419,-87.62961
TA1305000030,5,10,true,4,10,6,41.88459,-87.63178
TA1305000029,5,10,true,7,6,-1,41.88466,-87.62787
13263,5,10,true,6,5,-1,41.88467,-87.61952
TA1306000015,5,10,true,3,10,7,41.88549,-87.65232
13021,5,10,true,11,7,-4,41.88559,-87.64184
TA1307000111,5,10,true,7,7,0,41.88582,-87.63548
KA1503000012,5,10,true,10,3,-7,41.88599,-87.63089
TA1305000011,5,10,true,7,4,-3,41.886,-87.62418
15534,5,10,true,7,6,-1,41.88627,-87.61749
KA1503000064,5,10,true,4,7,3,41.88697,-87.61281
TA1305000022,5,10,true,12,4,-8,41.88817,-87.63656
TA1306000003,5,10,true,9,7,-2,41.88867,-87.64442
KA1503000043,5,10,true,8,15,7,41.88918,-87.63851
13432,5,10,true,6,1,-5,41.88989,-87.67149
TA1307000151,5,10,true,9,8,-1,41.88993,-87.63427
636,5,10,true,3,6,3,41.88997,-87.63662
13427,5,10,true,7,5,-2,41.89054,-87.62205
13430,5,10,true,2,10,8,41.89077,-87.63169
TA1306000013,5,10,true,4,5,1,41.89083,-87.61852
RN-,5,10,true,9,7,-2,41.89102,-87.63546
TA1307000117,5,10,true,9,6,-3,41.89144,-87.62675
13033,5,10,true,6,4,-2,41.8916,-87.64835
13194,5,10,true,5,1,-4,41.8918,-87.65878
TA1305000003,5,10,true,5,3,-2,41.89187,-87.62061
13022,5,10,true,5,10,5,41.89227,-87.61205
TA1306000029,5,10,true,5,5,0,41.89256,-87.61449
13045,5,10,true,6,10,4,41.89403,-87.62931
13016,5,10,true,4,5,1,41.89431,-87.62277
KA1503000041,5,10,true,6,7,1,41.89452,-87.61798
13196,5,10,true,2,5,3,41.89455,-87.65345
TA1306000012,5,10,true,6,11,5,41.89475,-87.63438
13132,5,10,true,1,5,4,41.89573,-87.67718
15530,5,10,true,6,12,6,41.89575,-87.62596
13303,5,10,true,1,9,8,41.89672,-87.63088
13017,5,10,true,6,4,-2,41.89676,-87.6357
13338,5,10,true,2,7,5,41.89697,-87.62173
TA1307000061,5,10,true,1,5,4,41.89745,-87.62873
TA1306000009,5,10,true,7,6,-1,41.89772,-87.64299
KA1504000103,5,10,true,5,2,-3,41.89842,-87.68659
15529,5,10,true,10,13,3,41.89858,-87.62206
TA1307000128,5,10,true,7,10,3,41.89896,-87.6299
13290,5,10,true,5,2,-3,41.90069,-87.66259
13042,5,10,true,8,14,6,41.90097,-87.62377
KA1504000133,5,10,true,7,7,0,41.90234,-87.62773
TA1307000039,5,10,true,14,2,-12,41.90294,-87.63137
TA1305000034,5,10,true,5,4,-1,41.90313,-87.67391
KA1504000135,5,10,true,9,7,-2,41.90319,-87.63439
TA1308000049,5,10,true,7,4,-3,41.90672,-87.6349
13221,5,10,true,4,7,3,41.90765,-87.67254
TA1309000024,5,10,true,7,7,0,41.908,-87.63152
TA1305000041,5,10,true,6,2,-4,41.9094,-87.67769
331,5,10,true,6,5,-1,41.90965,-87.64812
TA1305000037,5,10,true,7,3,-4,41.91018,-87.67003
LF-005,5,10,true,6,2,-4,41.91172,-87.62681
TA1308000050,5,10,true,7,7,0,41.91211,-87.6347
13243,5,10,true,4,5,1,41.91262,-87.6814
TA1306000032,5,10,true,5,1,-4,41.9137,-87.65285
13179,5,10,true,6,4,-2,41.9157,-87.63461
13146,5,10,true,8,5,-3,41.91831,-87.63629
13192,5,10,true,4,6,2,41.91995,-87.64884
13193,5,10,true,3,8,5,41.92182,-87.64412
TA1306000026,5,10,true,7,4,-3,41.92558,-87.65842
TA1309000058,5,10,true,7,4,-3,41.92591,-87.64927
TA1308000001,5,10,true,8,5,-3,41.92627,-87.63086
TA1309000023,5,10,true,5,3,-2,41.9287,-87.65383
TA1307000142,5,10,true,7,6,-1,41.93125,-87.64432
13276,5,10,true,8,6,-2,41.93132,-87.63874
TA1307000064,5,10,true,2,5,3,41.93222,-87.65864
TA1306000014,5,10,true,5,3,-2,41.93242,-87.65271
TA1307000006,5,10,true,5,1,-4,41.93571,-87.6636
TA1307000136,5,10,true,4,7,3,41.9365,-87.64755
TA1307000041,5,10,true,6,7,1,41.93669,-87.63683
13137,5,10,true,8,5,-3,41.9376,-87.6441
TA1308000019,5,10,true,5,4,-1,41.93973,-87.65886
TA1307000134,5,10,true,5,2,-3,41.94016,-87.65303
TA1307000138,5,10,true,6,4,-2,41.94334,-87.67094
TA1309000025,5,10,true,1,8,7,41.94368,-87.64894
13278,5,10,true,7,2,-5,41.94553,-87.64644
13235,5,10,true,7,10,3,41.94814,-87.66396
TA1307000126,5,10,true,5,1,-4,41.94936,-87.65451
TA1307000150,5,10,true,3,5,2,41.94945,-87.64646
13323,5,10,true,8,3,-5,41.95282,-87.65
TA1308000022,5,10,true,5,4,-1,41.95438,-87.64805
TA1308000012,5,10,true,5,6,1,41.96398,-87.63818
13074,5,10,true,3,7,4,41.96521,-87.6582
TA1309000014,5,10,true,12,4,-8,41.96709,-87.66744
TA1307000158,5,10,true,6,1,-5,41.9671,-87.67904
TA1307000119,5,10,true,5,1,-4,41.96796,-87.65
KA1504000146,5,10,true,3,12,9,41.978,-87.66805
13109,5,10,true,6,1,-5,41.97835,-87.65976
KA1504000152,5,10,true,6,8,2,41.98403,-87.65231
KA1503000071,5,11,false,7,2,-5,41.79148,-87.59988
KA1503000074,5,11,false,1,7,6,41.79174,-87.58395
TA1308000009,5,11,false,3,7,4,41.79522,-87.58075
KA1503000004,5,11,false,5,1,-4,41.83127,-87.6088
15545,5,11,false,3,6,3,41.85627,-87.61334
TA1307000159,5,11,false,5,1,-4,41.8579,-87.6687
13029,5,11,false,6,4,-2,41.86531,-87.6179
WL-008,5,11,false,2,6,4,41.86712,-87.64108
TA1305000002,5,11,false,10,2,-8,41.86721,-87.62597
15544,5,11,false,12,31,19,41.86723,-87.61536
TA1305000017,5,11,false,5,1,-4,41.86734,-87.64863
SL-005,5,11,false,13,7,-6,41.8679,-87.62304
13160,5,11,false,5,1,-4,41.86947,-87.65548
TA1309000010,5,11,false,12,3,-9,41.87074,-87.62574
SL-008,5,11,false,6,4,-2,41.87209,-87.62956
13332,5,11,false,5,2,-3,41.87219,-87.6615
623,5,11,false,14,12,-2,41.87272,-87.62399
15541,5,11,false,13,15,2,41.8758,-87.62086
TA1305000010,5,11,false,2,5,3,41.87623,-87.62444
624,5,11,false,6,1,-5,41.87626,-87.62923
13158,5,11,false,2,5,3,41.87764,-87.64957
13157,5,11,false,5,3,-2,41.87773,-87.6548
TA1305000025,5,11,false,10,2,-8,41.87773,-87.63528
TA1309000002,5,11,false,9,13,4,41.87784,-87.62408
638,5,11,false,6,1,-5,41.87827,-87.64078
TA1305000005,5,11,false,6,6,0,41.87924,-87.62975
TA1309000008,5,11,false,7,5,-2,41.87933,-87.6355
13300,5,11,false,32,17,-15,41.88097,-87.61675
13008,5,11,false,29,41,12,41.88105,-87.62408
TA1305000006,5,11,false,13,10,-3,41.88122,-87.6296
13056,5,11,false,14,6,-8,41.88168,-87.63951
TA1307000120,5,11,false,15,5,-10,41.88188,-87.64879
13036,5,11,false,5,1,-4,41.8821,-87.62513
WL-012,5,11,false,9,3,-6,41.88337,-87.6412
13053,5,11,false,4,7,3,41.88365,-87.64863
13001,5,11,false,14,6,-8,41.88397,-87.62459
TA1306000010,5,11,false,5,4,-1,41.88419,-87.62961
TA1305000030,5,11,false,2,6,4,41.88459,-87.63178
15535,5,11,false,5,2,-3,41.8846,-87.64455
TA1305000029,5,11,false,9,4,-5,41.88466,-87.62787
13263,5,11,false,10,9,-1,41.88467,-87.61952
TA1306000015,5,11,false,3,11,8,41.88549,-87.65232
KA1503000012,5,11,false,5,5,0,41.88599,-87.63089
TA1305000011,5,11,false,20,6,-14,41.886,-87.62418
15534,5,11,false,2,9,7,41.88627,-87.61749
TA1308000029,5,11,false,6,8,2,41.88673,-87.62225
TA1307000131,5,11,false,11,18,7,41.88688,-87.62606
KA1503000064,5,11,false,15,18,3,41.88697,-87.61281
TA1305000022,5,11,false,5,2,-3,41.88817,-87.63656
TA1306000003,5,11,false,4,5,1,41.88867,-87.64442
KA1503000043,5,11,false,6,10,4,41.88918,-87.63851
13050,5,11,false,9,7,-2,41.88919,-87.62775
TA1307000151,5,11,false,7,6,-1,41.88993,-87.63427
636,5,11,false,6,5,-1,41.88997,-87.63662
13427,5,11,false,6,4,-2,41.89054,-87.62205
13430,5,11,false,7,5,-2,41.89077,-87.63169
TA1306000013,5,11,false,4,8,4,41.89083,-87.61852
RN-,5,11,false,5,4,-1,41.89102,-87.63546
TA1307000117,5,11,false,16,8,-8,41.89144,-87.62675
13033,5,11,false,6,6,0,41.8916,-87.64835
TA1305000003,5,11,false,12,12,0,41.89187,-87.62061
13022,5,11,false,41,82,41,41.89227,-87.61205
TA1306000029,5,11,false,13,14,1,41.89256,-87.61449
13045,5,11,false,10,11,1,41.89403,-87.62931
13016,5,11,false,9,7,-2,41.89431,-87.62277
KA1503000041,5,11,false,7,1,-6,41.89452,-87.61798
13196,5,11,false,5,2,-3,41.89455,-87.65345
TA1307000062,5,11,false,3,5,2,41.89466,-87.63839
TA1306000012,5,11,false,14,9,-5,41.89475,-87.63438
KP1705001026,5,11,false,2,9,7,41.89483,-87.6323
18058,5,11,false,5,1,-4,41.8955,-87.68201
13132,5,11,false,6,4,-2,41.89573,-87.67718
15530,5,11,false,10,6,-4,41.89575,-87.62596
13289,5,11,false,6,1,-5,41.89638,-87.661
13017,5,11,false,3,5,2,41.89676,-87.6357
13338,5,11,false,16,3,-13,41.89697,-87.62173
TA1307000061,5,11,false,5,1,-4,41.89745,-87.62873
13034,5,11,false,9,9,0,41.89754,-87.62352
TA1306000009,5,11,false,5,1,-4,41.89772,-87.64299
15529,5,11,false,11,6,-5,41.89858,-87.62206
TA1307000128,5,11,false,5,7,2,41.89896,-87.6299
13042,5,11,false,26,26,0,41.90097,-87.62377
KA1504000133,5,11,false,8,13,5,41.90234,-87.62773
TA1307000039,5,11,false,17,12,-5,41.90294,-87.63137
TA1305000034,5,11,false,5,1,-4,41.90313,-87.67391
KA1504000135,5,11,false,14,9,-5,41.90319,-87.63439
13061,5,11,false,6,7,1,41.90342,-87.66779
TA1308000049,5,11,false,11,3,-8,41.90672,-87.6349
KA1504000134,5,11,false,6,2,-4,41.90687,-87.6262
TA1309000024,5,11,false,5,3,-2,41.908,-87.63152
TA1305000041,5,11,false,1,7,6,41.9094,-87.67769
331,5,11,false,3,5,2,41.90965,-87.64812
TA1305000037,5,11,false,6,5,-1,41.91018,-87.67003
13154,5,11,false,6,2,-4,41.91054,-87.65312
13058,5,11,false,6,5,-1,41.91059,-87.64942
LF-005,5,11,false,18,17,-1,41.91172,-87.62681
13128,5,11,false,6,5,-1,41.91197,-87.63197
TA1308000050,5,11,false,15,12,-3,41.91211,-87.6347
TA1306000032,5,11,false,5,3,-2,41.9137,-87.65285
TA1306000007,5,11,false,5,1,-4,41.91469,-87.64333
13179,5,11,false,3,6,3,41.9157,-87.63461
TA1309000006,5,11,false,5,1,-4,41.91809,-87.64375
13146,5,11,false,16,15,-1,41.91831,-87.63629
13059,5,11,false,4,6,2,41.91845,-87.65222
TA1309000033,5,11,false,8,3,-5,41.92158,-87.65381
13193,5,11,false,9,9,0,41.92182,-87.64412
LP-,5,11,false,14,8,-6,41.92396,-87.63584
TA1306000016,5,11,false,5,1,-4,41.9256,-87.65371
TA1309000019,5,11,false,12,5,-7,41.92586,-87.63897
TA1309000058,5,11,false,4,9,5,41.92591,-87.64927
TA1308000001,5,11,false,17,14,-3,41.92627,-87.63086
TA1309000023,5,11,false,5,1,-4,41.9287,-87.65383
TA1309000061,5,11,false,1,6,5,41.92915,-87.64909
TA1307000142,5,11,false,8,6,-2,41.93125,-87.64432
TA1307000064,5,11,false,10,5,-5,41.93222,-87.65864
TA1306000014,5,11,false,4,6,2,41.93242,-87.65271
TA1309000039,5,11,false,13,4,-9,41.93258,-87.63642
TA1309000036,5,11,false,7,4,-3,41.93313,-87.64776
TA1307000006,5,11,false,7,3,-4,41.93571,-87.6636
TA1307000136,5,11,false,4,8,4,41.9365,-87.64755
TA1307000041,5,11,false,2,5,3,41.93669,-87.63683
13137,5,11,false,18,11,-7,41.9376,-87.6441
13229,5,11,false,2,5,3,41.93946,-87.66376
13277,5,11,false,5,4,-1,41.9401,-87.64546
TA1307000134,5,11,false,7,15,8,41.94016,-87.65303
TA1309000049,5,11,false,11,4,-7,41.94077,-87.63919
13144,5,11,false,5,3,-2,41.9434,-87.67964
TA1309000025,5,11,false,10,3,-7,41.94368,-87.64894
13071,5,11,false,5,2,-3,41.94373,-87.66401
632,5,11,false,9,12,3,41.94453,-87.6547
13235,5,11,false,6,4,-2,41.94814,-87.66396
TA1307000126,5,11,false,1,15,14,41.94936,-87.65451
TA1307000150,5,11,false,7,6,-1,41.94945,-87.64646
13319,5,11,false,2,6,4,41.95069,-87.6687
TA1307000127,5,11,false,5,13,8,41.9508,-87.65918
13063,5,11,false,5,2,-3,41.95424,-87.65441
TA1308000022,5,11,false,3,5,2,41.95438,-87.64805
KA1504000146,5,11,false,3,5,2,41.978,-87.66805
E007,5,11,false,5,1,-4,42.06431,-87.68615
KA1503000071,5,11,true,3,9,6,41.79148,-87.59988
13216,5,11,true,1,6,5,41.83473,-87.62581
TA1307000139,5,11,true,10,3,-7,41.84205,-87.61698
15545,5,11,true,8,7,-1,41.85627,-87.61334
SL-012,5,11,true,5,1,-4,41.86038,-87.62581
TA1307000124,5,11,true,4,7,3,41.86411,-87.62372
WL-008,5,11,true,3,9,6,41.86712,-87.64108
TA1305000002,5,11,true,9,8,-1,41.86721,-87.62597
15544,5,11,true,3,9,6,41.86723,-87.61536
SL-005,5,11,true,7,5,-2,41.8679,-87.62304
TA1307000130,5,11,true,3,5,2,41.87178,-87.65103
TA1307000121,5,11,true,3,7,4,41.87184,-87.64664
SL-008,5,11,true,12,16,4,41.87209,-87.62956
13332,5,11,true,10,8,-2,41.87219,-87.6615
SL-011,5,11,true,6,1,-5,41.87256,-87.63356
KA1504000104,5,11,true,8,4,-4,41.87296,-87.66912
TA1305000035,5,11,true,3,6,3,41.87716,-87.62787
15539,5,11,true,6,2,-4,41.87763,-87.64405
13158,5,11,true,7,4,-3,41.87764,-87.64957
13157,5,11,true,8,10,2,41.87773,-87.6548
TA1305000025,5,11,true,6,4,-2,41.87773,-87.63528
TA1309000004,5,11,true,7,9,2,41.87811,-87.63184
TA1309000007,5,11,true,12,5,-7,41.88022,-87.63526
13300,5,11,true,5,10,5,41.88097,-87.61675
13008,5,11,true,6,8,2,41.88105,-87.62408
TA1305000006,5,11,true,12,11,-1,41.88122,-87.6296
TA1307000120,5,11,true,6,11,5,41.88188,-87.64879
TA1305000032,5,11,true,9,10,1,41.88218,-87.64109
13006,5,11,true,9,8,-1,41.88268,-87.63252
13353,5,11,true,6,4,-2,41.88283,-87.6612
KA1503000072,5,11,true,5,2,-3,41.88317,-87.63693
13053,5,11,true,13,17,4,41.88365,-87.64863
13001,5,11,true,4,8,4,41.88397,-87.62459
18062,5,11,true,4,8,4,41.88412,-87.65427
TA1306000010,5,11,true,3,6,3,41.88419,-87.62961
TA1305000030,5,11,true,11,7,-4,41.88459,-87.63178
15535,5,11,true,5,7,2,41.8846,-87.64455
TA1305000029,5,11,true,10,6,-4,41.88466,-87.62787
13263,5,11,true,11,7,-4,41.88467,-87.61952
TA1306000015,5,11,true,7,7,0,41.88549,-87.65232
TA1307000111,5,11,true,7,9,2,41.88582,-87.63548
TA1305000011,5,11,true,8,8,0,41.886,-87.62418
15534,5,11,true,5,1,-4,41.88627,-87.61749
TA1308000029,5,11,true,5,3,-2,41.88673,-87.62225
TA1307000131,5,11,true,4,5,1,41.88688,-87.62606
KA1503000064,5,11,true,3,6,3,41.88697,-87.61281
TA1306000003,5,11,true,10,8,-2,41.88867,-87.64442
KA1503000043,5,11,true,12,21,9,41.88918,-87.63851
13050,5,11,true,7,5,-2,41.88919,-87.62775
TA1307000151,5,11,true,10,13,3,41.88993,-87.63427
636,5,11,true,9,5,-4,41.88997,-87.63662
KA1503000044,5,11,true,5,2,-3,41.89018,-87.6262
13430,5,11,true,4,5,1,41.89077,-87.63169
TA1306000013,5,11,true,8,3,-5,41.89083,-87.61852
RN-,5,11,true,7,4,-3,41.89102,-87.63546
TA1307000117,5,11,true,10,13,3,41.89144,-87.62675
13033,5,11,true,3,8,5,41.8916,-87.64835
13194,5,11,true,5,4,-1,41.8918,-87.65878
TA1305000003,5,11,true,8,7,-1,41.89187,-87.62061
13022,5,11,true,11,9,-2,41.89227,-87.61205
TA1306000029,5,11,true,6,5,-1,41.89256,-87.61449
13265,5,11,true,13,11,-2,41.89383,-87.64172
13045,5,11,true,9,8,-1,41.89403,-87.62931
13016,5,11,true,12,9,-3,41.89431,-87.62277
KA1503000041,5,11,true,6,5,-1,41.89452,-87.61798
TA1307000062,5,11,true,8,1,-7,41.89466,-87.63839
TA1306000012,5,11,true,16,17,1,41.89475,-87.63438
KP1705001026,5,11,true,12,6,-6,41.89483,-87.6323
13132,5,11,true,4,5,1,41.89573,-87.67718
15530,5,11,true,9,10,1,41.89575,-87.62596
18003,5,11,true,7,5,-2,41.89575,-87.62011
13303,5,11,true,7,5,-2,41.89672,-87.63088
13017,5,11,true,11,9,-2,41.89676,-87.6357
13338,5,11,true,13,8,-5,41.89697,-87.62173
TA1307000061,5,11,true,5,1,-4,41.89745,-87.62873
13034,5,11,true,4,9,5,41.89754,-87.62352
TA1306000009,5,11,true,4,7,3,41.89772,-87.64299
620,5,11,true,5,6,1,41.89817,-87.63754
15529,5,11,true,2,7,5,41.89858,-87.62206
TA1307000128,5,11,true,7,4,-3,41.89896,-87.6299
TA1306000011,5,11,true,7,3,-4,41.89994,-87.63443
13290,5,11,true,6,3,-3,41.90069,-87.66259
13042,5,11,true,6,11,5,41.90097,-87.62377
KA1504000133,5,11,true,8,7,-1,41.90234,-87.62773
TA1307000039,5,11,true,13,9,-4,41.90294,-87.63137
KA1504000135,5,11,true,10,14,4,41.90319,-87.63439
13061,5,11,true,3,6,3,41.90342,-87.66779
TA1307000115,5,11,true,5,5,0,41.9046,-87.64056
TA1308000049,5,11,true,6,10,4,41.90672,-87.6349
13224,5,11,true,6,3,-3,41.90706,-87.66725
13221,5,11,true,5,6,1,41.90765,-87.67254
TA1309000024,5,11,true,10,7,-3,41.908,-87.63152
TA1305000041,5,11,true,7,3,-4,41.9094,-87.67769
331,5,11,true,5,13,8,41.90965,-87.64812
TA1305000037,5,11,true,7,7,0,41.91018,-87.67003
TA1306000008,5,11,true,5,2,-3,41.9102,-87.6435
13154,5,11,true,7,8,1,41.91054,-87.65312
13058,5,11,true,8,6,-2,41.91059,-87.64942
LF-005,5,11,true,8,8,0,41.91172,-87.62681
13128,5,11,true,6,1,-5,41.91197,-87.63197
TA1308000050,5,11,true,15,15,0,41.91211,-87.6347
13243,5,11,true,7,2,-5,41.91262,-87.6814
TA1306000032,5,11,true,6,4,-2,41.9137,-87.65285
13179,5,11,true,5,5,0,41.9157,-87.63461
13133,5,11,true,7,4,-3,41.91598,-87.67733
TA1309000006,5,11,true,8,5,-3,41.91809,-87.64375
TA1307000163,5,11,true,1,8,7,41.91821,-87.65696
13146,5,11,true,19,10,-9,41.91831,-87.63629
13059,5,11,true,10,8,-2,41.91845,-87.65222
13192,5,11,true,8,7,-1,41.91995,-87.64884
13288,5,11,true,2,6,4,41.92008,-87.67788
TA1309000033,5,11,true,6,11,5,41.92158,-87.65381
13193,5,11,true,8,10,2,41.92182,-87.64412
13191,5,11,true,5,6,1,41.92217,-87.63891
LP-,5,11,true,5,2,-3,41.92396,-87.63584
TA1307000001,5,11,true,5,5,0,41.92535,-87.66581
TA1306000026,5,11,true,5,6,1,41.92558,-87.65842
TA1306000016,5,11,true,5,6,1,41.9256,-87.65371
TA1309000019,5,11,true,13,11,-2,41.92586,-87.63897
TA1309000058,5,11,true,4,8,4,41.92591,-87.64927
TA1308000001,5,11,true,10,12,2,41.92627,-87.63086
TA1309000023,5,11,true,6,4,-2,41.9287,-87.65383
TA1307000113,5,11,true,1,6,5,41.92878,-87.66391
13296,5,11,true,7,4,-3,41.92883,-87.66852
TA1309000061,5,11,true,5,7,2,41.92915,-87.64909
TA1305000014,5,11,true,9,6,-3,41.92956,-87.64313
TA1307000142,5,11,true,8,9,1,41.93125,-87.64432
13276,5,11,true,9,11,2,41.93132,-87.63874
TA1307000064,5,11,true,6,4,-2,41.93222,-87.65864
TA1306000014,5,11,true,7,4,-3,41.93242,-87.65271
TA1309000039,5,11,true,6,7,1,41.93258,-87.63642
TA1309000036,5,11,true,11,4,-7,41.93313,-87.64776
13269,5,11,true,5,4,-1,41.93609,-87.66983
TA1307000052,5,11,true,6,2,-4,41.93628,-87.65266
TA1307000136,5,11,true,11,5,-6,41.9365,-87.64755
TA1307000041,5,11,true,3,6,3,41.93669,-87.63683
13137,5,11,true,8,10,2,41.9376,-87.6441
TA1309000042,5,11,true,1,6,5,41.93937,-87.66836
13229,5,11,true,5,1,-4,41.93946,-87.66376
13277,5,11,true,5,2,-3,41.9401,-87.64546
TA1307000134,5,11,true,6,7,1,41.94016,-87.65303
TA1307000138,5,11,true,5,8,3,41.94334,-87.67094
13071,5,11,true,7,3,-4,41.94373,-87.66401
632,5,11,true,4,10,6,41.94453,-87.6547
13278,5,11,true,8,6,-2,41.94553,-87.64644
13235,5,11,true,8,7,-1,41.94814,-87.66396
13325,5,11,true,5,13,8,41.94907,-87.64863
TA1307000126,5,11,true,9,10,1,41.94936,-87.65451
TA1307000150,5,11,true,8,13,5,41.94945,-87.64646
13319,5,11,true,5,1,-4,41.95069,-87.6687
TA1307000127,5,11,true,4,7,3,41.9508,-87.65918
13323,5,11,true,4,5,1,41.95282,-87.65
13063,5,11,true,3,5,2,41.95424,-87.65441
13379,5,11,true,10,3,-7,41.95786,-87.6495
TA1307000107,5,11,true,5,3,-2,41.96164,-87.65464
TA1308000012,5,11,true,6,7,1,41.96398,-87.63818
13074,5,11,true,7,8,1,41.96521,-87.6582
TA1307000140,5,11,true,5,3,-2,41.96643,-87.68865
TA1309000014,5,11,true,7,4,-3,41.96709,-87.66744
TA1309000066,5,11,true,1,7,6,41.9691,-87.67423
13108,5,11,true,5,5,0,41.97379,-87.65971
KA1504000146,5,11,true,3,6,3,41.978,-87.66805
15571,5,11,true,3,9,6,41.99478,-87.66028
KA1503000071,5,12,false,5,2,-3,41.79148,-87.59988
TA1309000063,5,12,false,6,3,-3,41.79325,-87.5878
TA1308000009,5,12,false,5,7,2,41.79522,-87.58075
TA1307000164,5,12,false,8,6,-2,41.79527,-87.59647
KA1503000059,5,12,false,5,5,0,41.79952,-87.58643
TA1309000037,5,12,false,10,4,-6,41.79957,-87.59474
KA1503000007,5,12,false,7,5,-2,41.80242,-87.58689
TA1309000053,5,12,false,5,5,0,41.80985,-87.60675
13075,5,12,false,5,1,-4,41.8531,-87.63192
15545,5,12,false,7,7,0,41.85627,-87.61334
TA1307000124,5,12,false,8,4,-4,41.86411,-87.62372
13029,5,12,false,15,9,-6,41.86531,-87.6179
13431,5,12,false,7,2,-5,41.8661,-87.60728
WL-008,5,12,false,3,5,2,41.86712,-87.64108
15544,5,12,false,29,24,-5,41.86723,-87.61536
SL-005,5,12,false,19,17,-2,41.8679,-87.62304
TA1309000010,5,12,false,10,4,-6,41.87074,-87.62574
SL-008,5,12,false,6,3,-3,41.87209,-87.62956
623,5,12,false,9,12,3,41.87272,-87.62399
KA1504000104,5,12,false,5,2,-3,41.87296,-87.66912
15541,5,12,false,11,15,4,41.8758,-87.62086
TA1305000035,5,12,false,14,2,-12,41.87716,-87.62787
13158,5,12,false,9,3,-6,41.87764,-87.64957
13157,5,12,false,9,2,-7,41.87773,-87.6548
TA1305000025,5,12,false,7,8,1,41.87773,-87.63528
TA1309000002,5,12,false,5,7,2,41.87784,-87.62408
TA1309000004,5,12,false,7,2,-5,41.87811,-87.63184
638,5,12,false,1,5,4,41.87827,-87.64078
TA1305000005,5,12,false,6,6,0,41.87924,-87.62975
13011,5,12,false,7,2,-5,41.87931,-87.63993
KA1503000034,5,12,false,2,5,3,41.87938,-87.63197
KA1503000015,5,12,false,14,4,-10,41.87948,-87.6257
13156,5,12,false,6,2,-4,41.88042,-87.65554
13300,5,12,false,57,33,-24,41.88097,-87.61675
13008,5,12,false,45,25,-20,41.88105,-87.62408
TA1305000006,5,12,false,16,7,-9,41.88122,-87.6296
13134,5,12,false,5,1,-4,41.88138,-87.67493
TA1307000120,5,12,false,6,10,4,41.88188,-87.64879
13036,5,12,false,3,5,2,41.8821,-87.62513
TA1305000032,5,12,false,7,8,1,41.88218,-87.64109
13409,5,12,false,2,8,6,41.8831,-87.6511
13053,5,12,false,6,15,9,41.88365,-87.64863
13001,5,12,false,14,13,-1,41.88397,-87.62459
TA1306000010,5,12,false,4,5,1,41.88419,-87.62961
TA1305000030,5,12,false,13,8,-5,41.88459,-87.63178
15535,5,12,false,3,9,6,41.8846,-87.64455
TA1305000029,5,12,false,7,9,2,41.88466,-87.62787
13263,5,12,false,17,14,-3,41.88467,-87.61952
TA1306000015,5,12,false,8,17,9,41.88549,-87.65232
TA1307000111,5,12,false,1,5,4,41.88582,-87.63548
KA17018054,5,12,false,1,5,4,41.88595,-87.67701
TA1305000011,5,12,false,22,14,-8,41.886,-87.62418
TA1307000131,5,12,false,16,16,0,41.88688,-87.62606
KA1503000064,5,12,false,25,16,-9,41.88697,-87.61281
TA1306000003,5,12,false,9,7,-2,41.88867,-87.64442
KA1503000043,5,12,false,13,8,-5,41.88918,-87.63851
13050,5,12,false,15,12,-3,41.88919,-87.62775
TA1307000151,5,12,false,19,17,-2,41.88993,-87.63427
KA1503000044,5,12,false,6,6,0,41.89018,-87.6262
13427,5,12,false,3,8,5,41.89054,-87.62205
13430,5,12,false,14,12,-2,41.89077,-87.63169
TA1306000013,5,12,false,12,14,2,41.89083,-87.61852
RN-,5,12,false,7,4,-3,41.89102,-87.63546
TA1307000117,5,12,false,6,17,11,41.89144,-87.62675
13033,5,12,false,8,5,-3,41.8916,-87.64835
13194,5,12,false,6,4,-2,41.8918,-87.65878
TA1305000003,5,12,false,8,14,6,41.89187,-87.62061
13022,5,12,false,81,103,22,41.89227,-87.61205
TA1306000029,5,12,false,9,7,-2,41.89256,-87.61449
13265,5,12,false,5,2,-3,41.89383,-87.64172
13045,5,12,false,16,12,-4,41.89403,-87.62931
13016,5,12,false,9,6,-3,41.89431,-87.62277
KA1503000041,5,12,false,10,4,-6,41.89452,-87.61798
13196,5,12,false,6,1,-5,41.89455,-87.65345
TA1307000062,5,12,false,7,7,0,41.89466,-87.63839
TA1306000012,5,12,false,16,13,-3,41.89475,-87.63438
KP1705001026,5,12,false,4,7,3,41.89483,-87.6323
13132,5,12,false,3,5,2,41.89573,-87.67718
15530,5,12,false,11,8,-3,41.89575,-87.62596
13247,5,12,false,5,4,-1,41.89597,-87.66775
13338,5,12,false,12,7,-5,41.89697,-87.62173
TA1307000061,5,12,false,21,2,-19,41.89745,-87.62873
13034,5,12,false,19,20,1,41.89754,-87.62352
TA1306000009,5,12,false,5,4,-1,41.89772,-87.64299
620,5,12,false,6,3,-3,41.89817,-87.63754
15529,5,12,false,15,4,-11,41.89858,-87.62206
TA1307000128,5,12,false,14,6,-8,41.89896,-87.6299
13248,5,12,false,5,1,-4,41.89964,-87.66788
TA1306000011,5,12,false,5,2,-3,41.89994,-87.63443
13042,5,12,false,39,42,3,41.90097,-87.62377
KA1504000133,5,12,false,15,4,-11,41.90234,-87.62773
TA1307000039,5,12,false,15,8,-7,41.90294,-87.63137
TA1305000034,5,12,false,7,3,-4,41.90313,-87.67391
KA1504000135,5,12,false,9,14,5,41.90319,-87.63439
13136,5,12,false,2,5,3,41.90326,-87.67845
13061,5,12,false,11,6,-5,41.90342,-87.66779
TA1307000115,5,12,false,2,6,4,41.9046,-87.64056
TA1308000049,5,12,false,8,10,2,41.90672,-87.6349
KA1504000134,5,12,false,4,7,3,41.90687,-87.6262
13221,5,12,false,6,6,0,41.90765,-87.67254
TA1309000024,5,12,false,10,5,-5,41.908,-87.63152
TA1305000041,5,12,false,6,2,-4,41.9094,-87.67769
331,5,12,false,10,9,-1,41.90965,-87.64812
TA1305000037,5,12,false,9,7,-2,41.91018,-87.67003
13154,5,12,false,5,9,4,41.91054,-87.65312
13058,5,12,false,7,1,-6,41.91059,-87.64942
TA1307000038,5,12,false,7,9,2,41.91138,-87.63868
LF-005,5,12,false,20,43,23,41.91172,-87.62681
13128,5,12,false,3,9,6,41.91197,-87.63197
TA1308000050,5,12,false,16,22,6,41.91211,-87.6347
13243,5,12,false,6,2,-4,41.91262,-87.6814
TA1306000032,5,12,false,9,2,-7,41.9137,-87.65285
15655,5,12,false,7,1,-6,41.91401,-87.70514
13179,5,12,false,13,14,1,41.9157,-87.63461
13133,5,12,false,14,1,-13,41.91598,-87.67733
TA1305000039,5,12,false,4,6,2,41.9163,-87.66749
TA1309000006,5,12,false,7,3,-4,41.91809,-87.64375
13146,5,12,false,19,16,-3,41.91831,-87.63629
13059,5,12,false,5,3,-2,41.91845,-87.65222
13192,5,12,false,6,3,-3,41.91995,-87.64884
13193,5,12,false,15,9,-6,41.92182,-87.64412
13084,5,12,false,4,10,6,41.92268,-87.69715
LP-,5,12,false,14,15,1,41.92396,-87.63584
TA1307000001,5,12,false,8,7,-1,41.92535,-87.66581
TA1306000016,5,12,false,10,9,-1,41.9256,-87.65371
TA1309000019,5,12,false,10,5,-5,41.92586,-87.63897
TA1309000058,5,12,false,10,8,-2,41.92591,-87.64927
TA1308000001,5,12,false,9,39,30,41.92627,-87.63086
13124,5,12,false,7,1,-6,41.92675,-87.63444
TA1307000113,5,12,false,5,2,-3,41.92878,-87.66391
TA1309000061,5,12,false,5,2,-3,41.92915,-87.64909
TA1305000014,5,12,false,7,7,0,41.92956,-87.64313
13085,5,12,false,5,6,1,41.92958,-87.70789
TA1307000142,5,12,false,7,7,0,41.93125,-87.64432
13276,5,12,false,10,4,-6,41.93132,-87.63874
TA1307000064,5,12,false,6,5,-1,41.93222,-87.65864
TA1306000014,5,12,false,13,2,-11,41.93242,-87.65271
TA1309000039,5,12,false,13,12,-1,41.93258,-87.63642
TA1309000036,5,12,false,2,7,5,41.93313,-87.64776
TA1307000136,5,12,false,12,5,-7,41.9365,-87.64755
TA1307000041,5,12,false,12,11,-1,41.93669,-87.63683
13137,5,12,false,10,15,5,41.9376,-87.6441
TA1309000042,5,12,false,5,2,-3,41.93937,-87.66836
13229,5,12,false,7,4,-3,41.93946,-87.66376
13277,5,12,false,15,9,-6,41.9401,-87.64546
TA1307000134,5,12,false,7,8,1,41.94016,-87.65303
TA1309000049,5,12,false,7,3,-4,41.94077,-87.63919
TA1309000025,5,12,false,2,6,4,41.94368,-87.64894
13071,5,12,false,3,8,5,41.94373,-87.66401
632,5,12,false,7,8,1,41.94453,-87.6547
13278,5,12,false,7,5,-2,41.94553,-87.64644
13235,5,12,false,7,10,3,41.94814,-87.66396
13325,5,12,false,5,4,-1,41.94907,-87.64863
TA1307000126,5,12,false,2,30,28,41.94936,-87.65451
TA1307000150,5,12,false,11,5,-6,41.94945,-87.64646
TA1307000127,5,12,false,9,14,5,41.9508,-87.65918
13063,5,12,false,2,7,5,41.95424,-87.65441
TA1308000022,5,12,false,6,5,-1,41.95438,-87.64805
TA1309000027,5,12,false,8,2,-6,41.9585,-87.65499
13389,5,12,false,5,2,-3,41.961,-87.64958
TA1307000107,5,12,false,7,3,-4,41.96164,-87.65464
TA1308000012,5,12,false,17,14,-3,41.96398,-87.63818
13074,5,12,false,2,6,4,41.96521,-87.6582
KA1504000152,5,12,false,4,15,11,41.98403,-87.65231
15575,5,12,false,1,5,4,41.98975,-87.66014
15571,5,12,false,9,5,-4,41.99478,-87.66028
RP-009,5,12,false,7,2,-5,42.00107,-87.66122
605,5,12,false,5,1,-4,42.05294,-87.67342
661,5,12,false,7,3,-4,42.05704,-87.68657
604,5,12,false,4,6,2,42.05824,-87.67744
TA1309000011,5,12,true,4,5,1,41.78873,-87.60131
KA1503000071,5,12,true,5,6,1,41.79148,-87.59988
TA1309000063,5,12,true,4,6,2,41.79325,-87.5878
TA1308000045,5,12,true,6,2,-4,41.83062,-87.64129
15545,5,12,true,9,9,0,41.85627,-87.61334
13102,5,12,true,2,6,4,41.85762,-87.61942
13150,5,12,true,5,6,1,41.85783,-87.62455
TA1307000124,5,12,true,8,8,0,41.86411,-87.62372
WL-008,5,12,true,5,6,1,41.86712,-87.64108
TA1305000002,5,12,true,8,7,-1,41.86721,-87.62597
15544,5,12,true,5,2,-3,41.86723,-87.61536
SL-005,5,12,true,4,6,2,41.8679,-87.62304
13139,5,12,true,5,5,0,41.86893,-87.65913
13160,5,12,true,8,9,1,41.86947,-87.65548
15550,5,12,true,3,8,5,41.87024,-87.63947
TA1309000010,5,12,true,2,8,6,41.87074,-87.62574
TA1307000130,5,12,true,8,7,-1,41.87178,-87.65103
TA1307000121,5,12,true,9,7,-2,41.87184,-87.64664
SL-008,5,12,true,9,13,4,41.87209,-87.62956
13332,5,12,true,13,9,-4,41.87219,-87.6615
623,5,12,true,9,5,-4,41.87272,-87.62399
KA1504000104,5,12,true,8,8,0,41.87296,-87.66912
TA1306000025,5,12,true,6,2,-4,41.87464,-87.65703
15541,5,12,true,5,2,-3,41.8758,-87.62086
TA1305000035,5,12,true,5,8,3,41.87716,-87.62787
13138,5,12,true,5,4,-1,41.87723,-87.63941
15539,5,12,true,7,5,-2,41.87763,-87.64405
13158,5,12,true,11,9,-2,41.87764,-87.64957
13157,5,12,true,7,8,1,41.87773,-87.6548
TA1305000025,5,12,true,12,18,6,41.87773,-87.63528
TA1309000004,5,12,true,5,5,0,41.87811,-87.63184
13011,5,12,true,3,11,8,41.87931,-87.63993
TA1309000008,5,12,true,5,1,-4,41.87933,-87.6355
KA1503000034,5,12,true,5,2,-3,41.87938,-87.63197
TA1309000007,5,12,true,11,4,-7,41.88022,-87.63526
WL-011,5,12,true,6,4,-2,41.88034,-87.64273
13300,5,12,true,5,11,6,41.88097,-87.61675
13008,5,12,true,4,9,5,41.88105,-87.62408
TA1305000006,5,12,true,7,4,-3,41.88122,-87.6296
TA1307000120,5,12,true,14,16,2,41.88188,-87.64879
13341,5,12,true,10,6,-4,41.88208,-87.63985
13036,5,12,true,5,3,-2,41.8821,-87.62513
TA1305000032,5,12,true,15,10,-5,41.88218,-87.64109
13006,5,12,true,7,8,1,41.88268,-87.63252
KA1503000072,5,12,true,8,2,-6,41.88317,-87.63693
WL-012,5,12,true,5,3,-2,41.88337,-87.6412
13053,5,12,true,17,14,-3,41.88365,-87.64863
TA1306000010,5,12,true,12,10,-2,41.88419,-87.62961
TA1305000030,5,12,true,12,10,-2,41.88459,-87.63178
15535,5,12,true,12,6,-6,41.8846,-87.64455
TA1305000029,5,12,true,5,5,0,41.88466,-87.62787
13263,5,12,true,11,5,-6,41.88467,-87.61952
TA1306000015,5,12,true,5,8,3,41.88549,-87.65232
13021,5,12,true,11,14,3,41.88559,-87.64184
TA1307000111,5,12,true,7,12,5,41.88582,-87.63548
KA1503000012,5,12,true,3,5,2,41.88599,-87.63089
TA1305000011,5,12,true,6,4,-2,41.886,-87.62418
15534,5,12,true,4,5,1,41.88627,-87.61749
TA1308000029,5,12,true,1,5,4,41.88673,-87.62225
TA1307000131,5,12,true,7,5,-2,41.88688,-87.62606
TA1305000022,5,12,true,10,9,-1,41.88817,-87.63656
TA1306000003,5,12,true,4,9,5,41.88867,-87.64442
KA1503000043,5,12,true,13,15,2,41.88918,-87.63851
13050,5,12,true,1,5,4,41.88919,-87.62775
TA1307000151,5,12,true,6,12,6,41.88993,-87.63427
636,5,12,true,6,9,3,41.88997,-87.63662
13427,5,12,true,7,3,-4,41.89054,-87.62205
13430,5,12,true,14,13,-1,41.89077,-87.63169
TA1306000013,5,12,true,6,9,3,41.89083,-87.61852
TA1307000117,5,12,true,9,13,4,41.89144,-87.62675
13033,5,12,true,6,12,6,41.8916,-87.64835
13194,5,12,true,11,8,-3,41.8918,-87.65878
TA1305000003,5,12,true,7,4,-3,41.89187,-87.62061
13022,5,12,true,9,10,1,41.89227,-87.61205
TA1306000029,5,12,true,5,4,-1,41.89256,-87.61449
13265,5,12,true,11,12,1,41.89383,-87.64172
13045,5,12,true,14,10,-4,41.89403,-87.62931
13016,5,12,true,8,6,-2,41.89431,-87.62277
KA1503000041,5,12,true,11,8,-3,41.89452,-87.61798
13196,5,12,true,6,4,-2,41.89455,-87.65345
TA1307000062,5,12,true,14,5,-9,41.89466,-87.63839
TA1306000012,5,12,true,12,10,-2,41.89475,-87.63438
KP1705001026,5,12,true,4,6,2,41.89483,-87.6323
13132,5,12,true,2,8,6,41.89573,-87.67718
15530,5,12,true,9,9,0,41.89575,-87.62596
18003,5,12,true,8,5,-3,41.89575,-87.62011
13247,5,12,true,5,6,1,41.89597,-87.66775
TA1305000020,5,12,true,6,2,-4,41.89636,-87.65406
13017,5,12,true,4,7,3,41.89676,-87.6357
13338,5,12,true,8,5,-3,41.89697,-87.62173
TA1307000061,5,12,true,10,3,-7,41.89745,-87.62873
TA1306000009,5,12,true,9,5,-4,41.89772,-87.64299
620,5,12,true,8,10,2,41.89817,-87.63754
KA1504000103,5,12,true,7,3,-4,41.89842,-87.68659
15529,5,12,true,9,2,-7,41.89858,-87.62206
TA1307000128,5,12,true,8,11,3,41.89896,-87.6299
13248,5,12,true,6,4,-2,41.89964,-87.66788
TA1306000011,5,12,true,3,7,4,41.89994,-87.63443
13042,5,12,true,11,13,2,41.90097,-87.62377
KA1504000133,5,12,true,8,6,-2,41.90234,-87.62773
TA1307000039,5,12,true,16,17,1,41.90294,-87.63137
TA1305000034,5,12,true,4,6,2,41.90313,-87.67391
KA1504000135,5,12,true,13,15,2,41.90319,-87.63439
13061,5,12,true,14,11,-3,41.90342,-87.66779
KA1504000079,5,12,true,14,10,-4,41.9035,-87.64334
TA1307000115,5,12,true,9,6,-3,41.9046,-87.64056
TA1308000049,5,12,true,12,10,-2,41.90672,-87.6349
KA1504000134,5,12,true,6,3,-3,41.90687,-87.6262
13221,5,12,true,5,4,-1,41.90765,-87.67254
TA1309000024,5,12,true,10,7,-3,41.908,-87.63152
TA1305000041,5,12,true,6,7,1,41.9094,-87.67769
331,5,12,true,10,4,-6,41.90965,-87.64812
TA1305000037,5,12,true,5,6,1,41.91018,-87.67003
TA1306000008,5,12,true,6,2,-4,41.9102,-87.6435
TA1308000005,5,12,true,6,4,-2,41.91042,-87.68238
13154,5,12,true,11,8,-3,41.91054,-87.65312
13058,5,12,true,6,10,4,41.91059,-87.64942
TA1307000038,5,12,true,4,7,3,41.91138,-87.63868
LF-005,5,12,true,14,15,1,41.91172,-87.62681
13128,5,12,true,4,5,1,41.91197,-87.63197
TA1308000050,5,12,true,22,12,-10,41.91211,-87.6347
13243,5,12,true,2,6,4,41.91262,-87.6814
TA1306000032,5,12,true,12,6,-6,41.9137,-87.65285
TA1307000166,5,12,true,7,8,1,41.91386,-87.64877
18067,5,12,true,5,4,-1,41.9146,-87.66796
13068,5,12,true,5,2,-3,41.91554,-87.68703
13179,5,12,true,13,10,-3,41.9157,-87.63461
TA1309000006,5,12,true,4,5,1,41.91809,-87.64375
TA1307000163,5,12,true,5,4,-1,41.91821,-87.65696
13146,5,12,true,10,12,2,41.91831,-87.63629
13059,5,12,true,7,6,-1,41.91845,-87.65222
13192,5,12,true,10,8,-2,41.91995,-87.64884
TA1309000030,5,12,true,3,5,2,41.92077,-87.66372
TA1309000033,5,12,true,5,10,5,41.92158,-87.65381
13193,5,12,true,9,8,-1,41.92182,-87.64412
LP-,5,12,true,3,8,5,41.92396,-87.63584
TA1307000001,5,12,true,2,8,6,41.92535,-87.66581
TA1306000026,5,12,true,10,4,-6,41.92558,-87.65842
TA1306000016,5,12,true,9,5,-4,41.9256,-87.65371
TA1309000019,5,12,true,8,8,0,41.92586,-87.63897
TA1309000058,5,12,true,9,10,1,41.92591,-87.64927
TA1308000001,5,12,true,18,15,-3,41.92627,-87.63086
TA1309000023,5,12,true,10,6,-4,41.9287,-87.65383
TA1309000061,5,12,true,7,8,1,41.92915,-87.64909
TA1305000014,5,12,true,8,9,1,41.92956,-87.64313
TA1307000142,5,12,true,10,4,-6,41.93125,-87.64432
13276,5,12,true,11,10,-1,41.93132,-87.63874
TA1307000064,5,12,true,6,5,-1,41.93222,-87.65864
TA1306000014,5,12,true,5,10,5,41.93242,-87.65271
TA1309000039,5,12,true,7,4,-3,41.93258,-87.63642
TA1309000036,5,12,true,5,5,0,41.93313,-87.64776
TA1307000006,5,12,true,6,6,0,41.93571,-87.6636
TA1307000052,5,12,true,8,6,-2,41.93628,-87.65266
TA1307000136,5,12,true,14,6,-8,41.9365,-87.64755
TA1307000041,5,12,true,7,4,-3,41.93669,-87.63683
13137,5,12,true,11,8,-3,41.9376,-87.6441
TA1309000042,5,12,true,11,6,-5,41.93937,-87.66836
13229,5,12,true,3,5,2,41.93946,-87.66376
TA1308000019,5,12,true,3,6,3,41.93973,-87.65886
13277,5,12,true,5,5,0,41.9401,-87.64546
TA1307000134,5,12,true,7,10,3,41.94016,-87.65303
TA1309000049,5,12,true,3,7,4,41.94077,-87.63919
TA1307000138,5,12,true,4,5,1,41.94334,-87.67094
TA1309000025,5,12,true,6,7,1,41.94368,-87.64894
632,5,12,true,5,5,0,41.94453,-87.6547
13278,5,12,true,9,5,-4,41.94553,-87.64644
13235,5,12,true,5,12,7,41.94814,-87.66396
13325,5,12,true,7,11,4,41.94907,-87.64863
TA1307000126,5,12,true,6,18,12,41.94936,-87.65451
TA1307000150,5,12,true,8,5,-3,41.94945,-87.64646
TA1307000127,5,12,true,7,13,6,41.9508,-87.65918
13323,5,12,true,5,3,-2,41.95282,-87.65
13063,5,12,true,4,7,3,41.95424,-87.65441
TA1309000026,5,12,true,6,4,-2,41.95601,-87.6802
13379,5,12,true,11,2,-9,41.95786,-87.6495
TA1309000027,5,12,true,11,4,-7,41.9585,-87.65499
13389,5,12,true,5,10,5,41.961,-87.64958
TA1307000107,5,12,true,11,8,-3,41.96164,-87.65464
TA1308000012,5,12,true,4,6,2,41.96398,-87.63818
13074,5,12,true,7,3,-4,41.96521,-87.6582
639,5,12,true,9,3,-6,41.96584,-87.64538
TA1307000140,5,12,true,6,4,-2,41.96643,-87.68865
TA1309000014,5,12,true,6,7,1,41.96709,-87.66744
TA1309000041,5,12,true,7,2,-5,41.96951,-87.65471
KA1504000171,5,12,true,3,5,2,41.97161,-87.65016
TA1309000035,5,12,true,11,6,-5,41.97335,-87.66785
13109,5,12,true,5,3,-2,41.97835,-87.65976
KA1504000152,5,12,true,11,9,-2,41.98403,-87.65231
15578,5,12,true,5,5,0,41.98405,-87.66027
15575,5,12,true,5,5,0,41.98975,-87.66014
596,5,12,true,5,3,-2,42.04822,-87.68348
KA1503000014,5,13,false,4,5,1,41.7851,-87.60108
KA1503000071,5,13,false,5,4,-1,41.79148,-87.59988
KA1503000074,5,13,false,5,2,-3,41.79174,-87.58395
TA1308000009,5,13,false,8,6,-2,41.79522,-87.58075
TA1307000164,5,13,false,8,2,-6,41.79527,-87.59647
KA1503000059,5,13,false,6,7,1,41.79952,-87.58643
TA1309000037,5,13,false,6,6,0,41.79957,-87.59474
TA1307000048,5,13,false,6,10,4,41.83855,-87.60821
13075,5,13,false,9,12,3,41.8531,-87.63192
15545,5,13,false,5,6,1,41.85627,-87.61334
13102,5,13,false,5,5,0,41.85762,-87.61942
13150,5,13,false,5,1,-4,41.85783,-87.62455
TA1307000124,5,13,false,13,2,-11,41.86411,-87.62372
13029,5,13,false,9,7,-2,41.86531,-87.6179
13431,5,13,false,9,8,-1,41.8661,-87.60728
TA1305000002,5,13,false,15,10,-5,41.86721,-87.62597
15544,5,13,false,50,55,5,41.86723,-87.61536
KA1706005007,5,13,false,2,7,5,41.86749,-87.63219
SL-005,5,13,false,16,10,-6,41.8679,-87.62304
TA1309000010,5,13,false,6,10,4,41.87074,-87.62574
SL-009,5,13,false,6,3,-3,41.87081,-87.63121
SL-008,5,13,false,10,7,-3,41.87209,-87.62956
SL-011,5,13,false,3,8,5,41.87256,-87.63356
623,5,13,false,23,21,-2,41.87272,-87.62399
KA1504000104,5,13,false,1,5,4,41.87296,-87.66912
SL-010,5,13,false,7,6,-1,41.87501,-87.63309
15541,5,13,false,29,5,-24,41.8758,-87.62086
TA1305000010,5,13,false,12,5,-7,41.87623,-87.62444
TA1305000035,5,13,false,13,4,-9,41.87716,-87.62787
TA1305000025,5,13,false,20,4,-16,41.87773,-87.63528
TA1309000002,5,13,false,19,12,-7,41.87784,-87.62408
TA1305000005,5,13,false,6,4,-2,41.87924,-87.62975
13011,5,13,false,2,6,4,41.87931,-87.63993
TA1309000008,5,13,false,7,7,0,41.87933,-87.6355
KA1503000034,5,13,false,5,2,-3,41.87938,-87.63197
KA1503000015,5,13,false,5,3,-2,41.87948,-87.6257
TA1309000007,5,13,false,5,9,4,41.88022,-87.63526
13156,5,13,false,7,1,-6,41.88042,-87.65554
13300,5,13,false,54,58,4,41.88097,-87.61675
13008,5,13,false,51,49,-2,41.88105,-87.62408
TA1305000006,5,13,false,9,8,-1,41.88122,-87.6296
13056,5,13,false,12,3,-9,41.88168,-87.63951
TA1307000120,5,13,false,12,6,-6,41.88188,-87.64879
13341,5,13,false,5,2,-3,41.88208,-87.63985
13036,5,13,false,5,8,3,41.8821,-87.62513
TA1305000032,5,13,false,7,8,1,41.88218,-87.64109
13006,5,13,false,1,7,6,41.88268,-87.63252
13409,5,13,false,9,4,-5,41.8831,-87.6511
KA1503000072,5,13,false,5,3,-2,41.88317,-87.63693
WL-012,5,13,false,5,8,3,41.88337,-87.6412
13053,5,13,false,16,17,1,41.88365,-87.64863
13001,5,13,false,16,12,-4,41.88397,-87.62459
TA1306000010,5,13,false,9,6,-3,41.88419,-87.62961
TA1305000030,5,13,false,4,9,5,41.88459,-87.63178
15535,5,13,false,7,9,2,41.8846,-87.64455
TA1305000029,5,13,false,16,5,-11,41.88466,-87.62787
13263,5,13,false,15,13,-2,41.88467,-87.61952
TA1306000015,5,13,false,6,8,2,41.88549,-87.65232
13021,5,13,false,5,4,-1,41.88559,-87.64184
TA1307000111,5,13,false,11,8,-3,41.88582,-87.63548
13073,5,13,false,1,7,6,41.88592,-87.66717
KA1503000012,5,13,false,11,4,-7,41.88599,-87.63089
TA1305000011,5,13,false,15,13,-2,41.886,-87.62418
15534,5,13,false,11,11,0,41.88627,-87.61749
TA1308000029,5,13,false,1,7,6,41.88673,-87.62225
TA1307000131,5,13,false,17,19,2,41.88688,-87.62606
KA1503000064,5,13,false,30,22,-8,41.88697,-87.61281
TA1305000022,5,13,false,7,2,-5,41.88817,-87.63656
TA1306000003,5,13,false,9,9,0,41.88867,-87.64442
KA1503000043,5,13,false,8,12,4,41.88918,-87.63851
13050,5,13,false,18,8,-10,41.88919,-87.62775
TA1307000151,5,13,false,12,10,-2,41.88993,-87.63427
636,5,13,false,7,2,-5,41.88997,-87.63662
KA1503000044,5,13,false,11,8,-3,41.89018,-87.6262
13427,5,13,false,10,9,-1,41.89054,-87.62205
13430,5,13,false,6,6,0,41.89077,-87.63169
TA1306000013,5,13,false,17,19,2,41.89083,-87.61852
RN-,5,13,false,10,5,-5,41.89102,-87.63546
13434,5,13,false,1,8,7,41.89108,-87.66663
TA1308000006,5,13,false,5,3,-2,41.89128,-87.67686
TA1307000117,5,13,false,18,23,5,41.89144,-87.62675
13033,5,13,false,3,6,3,41.8916,-87.64835
TA1305000003,5,13,false,17,17,0,41.89187,-87.62061
13022,5,13,false,121,147,26,41.89227,-87.61205
TA1306000029,5,13,false,9,18,9,41.89256,-87.61449
13265,5,13,false,10,5,-5,41.89383,-87.64172
13045,5,13,false,21,18,-3,41.89403,-87.62931
13016,5,13,false,13,9,-4,41.89431,-87.62277
KA1503000041,5,13,false,7,18,11,41.89452,-87.61798
TA1307000062,5,13,false,9,4,-5,41.89466,-87.63839
TA1306000012,5,13,false,14,10,-4,41.89475,-87.63438
KP1705001026,5,13,false,7,7,0,41.89483,-87.6323
13132,5,13,false,9,6,-3,41.89573,-87.67718
15530,5,13,false,12,15,3,41.89575,-87.62596
18003,5,13,false,4,7,3,41.89575,-87.62011
13247,5,13,false,6,2,-4,41.89597,-87.66775
TA1305000020,5,13,false,6,2,-4,41.89636,-87.65406
13289,5,13,false,8,6,-2,41.89638,-87.661
13303,5,13,false,6,8,2,41.89672,-87.63088
13017,5,13,false,5,4,-1,41.89676,-87.6357
13338,5,13,false,11,3,-8,41.89697,-87.62173
TA1307000061,5,13,false,11,3,-8,41.89745,-87.62873
13034,5,13,false,25,11,-14,41.89754,-87.62352
620,5,13,false,8,5,-3,41.89817,-87.63754
15529,5,13,false,6,14,8,41.89858,-87.62206
TA1307000128,5,13,false,4,17,13,41.89896,-87.6299
TA1306000011,5,13,false,5,1,-4,41.89994,-87.63443
KA1504000116,5,13,false,5,1,-4,41.90023,-87.64299
13042,5,13,false,46,44,-2,41.90097,-87.62377
KA1504000133,5,13,false,12,18,6,41.90234,-87.62773
TA1307000039,5,13,false,11,16,5,41.90294,-87.63137
KA1504000135,5,13,false,19,12,-7,41.90319,-87.63439
13136,5,13,false,3,8,5,41.90326,-87.67845
13061,5,13,false,8,7,-1,41.90342,-87.66779
KA1504000079,5,13,false,9,4,-5,41.9035,-87.64334
TA1308000049,5,13,false,12,21,9,41.90672,-87.6349
KA1504000134,5,13,false,4,10,6,41.90687,-87.6262
13224,5,13,false,1,7,6,41.90706,-87.66725
13221,5,13,false,12,8,-4,41.90765,-87.67254
TA1309000024,5,13,false,11,11,0,41.908,-87.63152
TA1305000041,5,13,false,7,5,-2,41.9094,-87.67769
331,5,13,false,9,3,-6,41.90965,-87.64812
TA1306000008,5,13,false,5,7,2,41.9102,-87.6435
13154,5,13,false,9,7,-2,41.91054,-87.65312
13058,5,13,false,5,10,5,41.91059,-87.64942
TA1307000038,5,13,false,10,4,-6,41.91138,-87.63868
LF-005,5,13,false,27,45,18,41.91172,-87.62681
13128,5,13,false,7,9,2,41.91197,-87.63197
TA1308000050,5,13,false,12,20,8,41.91211,-87.6347
13243,5,13,false,11,6,-5,41.91262,-87.6814
TA1307000166,5,13,false,6,3,-3,41.91386,-87.64877
13179,5,13,false,12,20,8,41.9157,-87.63461
13133,5,13,false,4,7,3,41.91598,-87.67733
TA1305000039,5,13,false,12,7,-5,41.9163,-87.66749
TA1309000006,5,13,false,5,5,0,41.91809,-87.64375
TA1307000163,5,13,false,6,4,-2,41.91821,-87.65696
13146,5,13,false,20,24,4,41.91831,-87.63629
13059,5,13,false,6,6,0,41.91845,-87.65222
13192,5,13,false,9,7,-2,41.91995,-87.64884
TA1309000030,5,13,false,5,4,-1,41.92077,-87.66372
TA1309000033,5,13,false,9,6,-3,41.92158,-87.65381
13193,5,13,false,11,6,-5,41.92182,-87.64412
13191,5,13,false,10,3,-7,41.92217,-87.63891
LP-,5,13,false,21,25,4,41.92396,-87.63584
TA1307000001,5,13,false,4,5,1,41.92535,-87.66581
TA1309000019,5,13,false,12,7,-5,41.92586,-87.63897
TA1309000058,5,13,false,16,12,-4,41.92591,-87.64927
TA1308000001,5,13,false,17,44,27,41.92627,-87.63086
13124,5,13,false,2,8,6,41.92675,-87.63444
TA1309000023,5,13,false,4,5,1,41.9287,-87.65383
TA1309000061,5,13,false,8,5,-3,41.92915,-87.64909
TA1305000014,5,13,false,11,7,-4,41.92956,-87.64313
13085,5,13,false,8,6,-2,41.92958,-87.70789
TA1307000142,5,13,false,14,11,-3,41.93125,-87.64432
13276,5,13,false,5,6,1,41.93132,-87.63874
13271,5,13,false,6,3,-3,41.93192,-87.67784
TA1307000064,5,13,false,10,7,-3,41.93222,-87.65864
TA1306000014,5,13,false,11,6,-5,41.93242,-87.65271
TA1309000039,5,13,false,6,11,5,41.93258,-87.63642
TA1309000036,5,13,false,3,6,3,41.93313,-87.64776
TA1307000136,5,13,false,6,2,-4,41.9365,-87.64755
TA1307000041,5,13,false,14,13,-1,41.93669,-87.63683
13137,5,13,false,16,13,-3,41.9376,-87.6441
TA1309000042,5,13,false,4,5,1,41.93937,-87.66836
13277,5,13,false,10,10,0,41.9401,-87.64546
TA1307000134,5,13,false,12,12,0,41.94016,-87.65303
TA1309000049,5,13,false,10,15,5,41.94077,-87.63919
TA1307000138,5,13,false,7,3,-4,41.94334,-87.67094
TA1309000025,5,13,false,10,10,0,41.94368,-87.64894
13071,5,13,false,5,4,-1,41.94373,-87.66401
632,5,13,false,10,15,5,41.94453,-87.6547
13278,5,13,false,9,4,-5,41.94553,-87.64644
13235,5,13,false,9,9,0,41.94814,-87.66396
TA1307000126,5,13,false,5,42,37,41.94936,-87.65451
TA1307000150,5,13,false,9,7,-2,41.94945,-87.64646
13319,5,13,false,3,8,5,41.95069,-87.6687
TA1307000127,5,13,false,9,8,-1,41.9508,-87.65918
13063,5,13,false,11,7,-4,41.95424,-87.65441
TA1308000022,5,13,false,7,6,-1,41.95438,-87.64805
13379,5,13,false,6,2,-4,41.95786,-87.6495
TA1309000027,5,13,false,1,8,7,41.9585,-87.65499
13389,5,13,false,4,5,1,41.961,-87.64958
TA1307000107,5,13,false,7,6,-1,41.96164,-87.65464
TA1308000012,5,13,false,16,21,5,41.96398,-87.63818
13074,5,13,false,6,8,2,41.96521,-87.6582
639,5,13,false,2,5,3,41.96584,-87.64538
TA1309000014,5,13,false,9,5,-4,41.96709,-87.66744
TA1307000158,5,13,false,6,2,-4,41.9671,-87.67904
TA1307000119,5,13,false,5,1,-4,41.96796,-87.65
TA1309000066,5,13,false,11,4,-7,41.9691,-87.67423
KA1504000171,5,13,false,5,2,-3,41.97161,-87.65016
TA1309000035,5,13,false,7,3,-4,41.97335,-87.66785
KA1504000152,5,13,false,10,4,-6,41.98403,-87.65231
15578,5,13,false,5,7,2,41.98405,-87.66027
15571,5,13,false,3,6,3,41.99478,-87.66028
RP-009,5,13,false,2,8,6,42.00107,-87.66122
E008,5,13,false,2,7,5,42.05049,-87.67782
604,5,13,false,6,2,-4,42.05824,-87.67744
TA1309000011,5,13,true,6,6,0,41.78873,-87.60131
KA1503000071,5,13,true,8,4,-4,41.79148,-87.59988
TA1308000009,5,13,true,9,9,0,41.79522,-87.58075
KA1503000059,5,13,true,5,1,-4,41.79952,-87.58643
TA1307000129,5,13,true,5,8,3,41.83104,-87.62683
13216,5,13,true,6,7,1,41.83473,-87.62581
TA1309000055,5,13,true,8,5,-3,41.8382,-87.64514
KA1503000038,5,13,true,4,8,4,41.83845,-87.6354
TA1307000139,5,13,true,6,2,-4,41.84205,-87.61698
15545,5,13,true,6,5,-1,41.85627,-87.61334
13135,5,13,true,4,6,2,41.85753,-87.66157
13102,5,13,true,9,7,-2,41.85762,-87.61942
SL-012,5,13,true,6,6,0,41.86038,-87.62581
TA1307000124,5,13,true,13,6,-7,41.86411,-87.62372
TA1309000001,5,13,true,5,7,2,41.86488,-87.64708
TA1305000002,5,13,true,8,11,3,41.86721,-87.62597
15544,5,13,true,6,8,2,41.86723,-87.61536
SL-005,5,13,true,8,5,-3,41.8679,-87.62304
13139,5,13,true,3,7,4,41.86893,-87.65913
13285,5,13,true,6,3,-3,41.86928,-87.67372
13160,5,13,true,3,8,5,41.86947,-87.65548
15550,5,13,true,5,1,-4,41.87024,-87.63947
TA1309000010,5,13,true,3,9,6,41.87074,-87.62574
TA1309000064,5,13,true,10,5,-5,41.87127,-87.67369
TA1307000130,5,13,true,6,9,3,41.87178,-87.65103
TA1307000121,5,13,true,6,6,0,41.87184,-87.64664
SL-008,5,13,true,13,6,-7,41.87209,-87.62956
13332,5,13,true,7,16,9,41.87219,-87.6615
SL-011,5,13,true,3,8,5,41.87256,-87.63356
623,5,13,true,7,7,0,41.87272,-87.62399
KA1504000104,5,13,true,15,5,-10,41.87296,-87.66912
SL-007,5,13,true,3,6,3,41.87404,-87.6277
13028,5,13,true,4,6,2,41.87475,-87.64981
TA1305000035,5,13,true,14,14,0,41.87716,-87.62787
15539,5,13,true,5,1,-4,41.87763,-87.64405
13158,5,13,true,6,13,7,41.87764,-87.64957
13157,5,13,true,7,11,4,41.87773,-87.6548
TA1305000025,5,13,true,10,17,7,41.87773,-87.63528
TA1309000004,5,13,true,15,2,-13,41.87811,-87.63184
638,5,13,true,10,5,-5,41.87827,-87.64078
TA1305000005,5,13,true,8,5,-3,41.87924,-87.62975
TA1309000008,5,13,true,6,2,-4,41.87933,-87.6355
TA1309000007,5,13,true,6,7,1,41.88022,-87.63526
WL-011,5,13,true,6,2,-4,41.88034,-87.64273
13300,5,13,true,6,5,-1,41.88097,-87.61675
13008,5,13,true,6,6,0,41.88105,-87.62408
TA1305000006,5,13,true,17,9,-8,41.88122,-87.6296
TA1307000120,5,13,true,8,15,7,41.88188,-87.64879
13341,5,13,true,4,5,1,41.88208,-87.63985
13036,5,13,true,4,8,4,41.8821,-87.62513
TA1305000032,5,13,true,9,10,1,41.88218,-87.64109
13006,5,13,true,10,5,-5,41.88268,-87.63252
13409,5,13,true,7,5,-2,41.8831,-87.6511
KA1503000072,5,13,true,10,3,-7,41.88317,-87.63693
WL-012,5,13,true,4,5,1,41.88337,-87.6412
13053,5,13,true,14,17,3,41.88365,-87.64863
13001,5,13,true,4,7,3,41.88397,-87.62459
18062,5,13,true,6,2,-4,41.88412,-87.65427
TA1306000010,5,13,true,8,10,2,41.88419,-87.62961
TA1305000030,5,13,true,9,11,2,41.88459,-87.63178
15535,5,13,true,7,15,8,41.8846,-87.64455
TA1305000029,5,13,true,9,7,-2,41.88466,-87.62787
13263,5,13,true,10,6,-4,41.88467,-87.61952
TA1306000015,5,13,true,7,7,0,41.88549,-87.65232
13021,5,13,true,8,11,3,41.88559,-87.64184
TA1307000111,5,13,true,12,5,-7,41.88582,-87.63548
KA1503000012,5,13,true,5,4,-1,41.88599,-87.63089
TA1305000011,5,13,true,8,4,-4,41.886,-87.62418
15534,5,13,true,3,8,5,41.88627,-87.61749
TA1307000131,5,13,true,5,4,-1,41.88688,-87.62606
KA1503000064,5,13,true,10,10,0,41.88697,-87.61281
TA1305000022,5,13,true,9,6,-3,41.88817,-87.63656
TA1306000003,5,13,true,10,8,-2,41.88867,-87.64442
KA1503000043,5,13,true,20,22,2,41.88918,-87.63851
13050,5,13,true,9,8,-1,41.88919,-87.62775
TA1307000151,5,13,true,19,6,-13,41.88993,-87.63427
636,5,13,true,3,10,7,41.88997,-87.63662
13427,5,13,true,7,5,-2,41.89054,-87.62205
TA1306000013,5,13,true,6,19,13,41.89083,-87.61852
RN-,5,13,true,10,10,0,41.89102,-87.63546
TA1308000006,5,13,true,6,7,1,41.89128,-87.67686
TA1307000117,5,13,true,10,11,1,41.89144,-87.62675
13033,5,13,true,7,16,9,41.8916,-87.64835
13194,5,13,true,6,3,-3,41.8918,-87.65878
TA1305000003,5,13,true,10,11,1,41.89187,-87.62061
13022,5,13,true,13,16,3,41.89227,-87.61205
TA1306000029,5,13,true,6,10,4,41.89256,-87.61449
13265,5,13,true,11,8,-3,41.89383,-87.64172
13045,5,13,true,22,10,-12,41.89403,-87.62931
13016,5,13,true,10,15,5,41.89431,-87.62277
KA1503000041,5,13,true,6,12,6,41.89452,-87.61798
TA1307000062,5,13,true,12,4,-8,41.89466,-87.63839
TA1306000012,5,13,true,19,15,-4,41.89475,-87.63438
KP1705001026,5,13,true,8,11,3,41.89483,-87.6323
18058,5,13,true,2,5,3,41.8955,-87.68201
637,5,13,true,3,5,2,41.89563,-87.67209
13132,5,13,true,8,9,1,41.89573,-87.67718
15530,5,13,true,13,8,-5,41.89575,-87.62596
18003,5,13,true,8,5,-3,41.89575,-87.62011
13247,5,13,true,4,5,1,41.89597,-87.66775
13289,5,13,true,5,3,-2,41.89638,-87.661
13303,5,13,true,12,12,0,41.89672,-87.63088
13017,5,13,true,9,4,-5,41.89676,-87.6357
13338,5,13,true,7,5,-2,41.89697,-87.62173
TA1307000061,5,13,true,5,11,6,41.89745,-87.62873
13034,5,13,true,3,5,2,41.89754,-87.62352
TA1306000009,5,13,true,7,9,2,41.89772,-87.64299
620,5,13,true,9,8,-1,41.89817,-87.63754
15529,5,13,true,14,17,3,41.89858,-87.62206
TA1307000128,5,13,true,11,8,-3,41.89896,-87.6299
657,5,13,true,8,3,-5,41.89918,-87.6722
KA1504000116,5,13,true,5,4,-1,41.90023,-87.64299
13042,5,13,true,14,19,5,41.90097,-87.62377
KA1504000133,5,13,true,4,12,8,41.90234,-87.62773
TA1307000039,5,13,true,21,17,-4,41.90294,-87.63137
TA1305000034,5,13,true,9,4,-5,41.90313,-87.67391
KA1504000135,5,13,true,10,17,7,41.90319,-87.63439
13136,5,13,true,6,3,-3,41.90326,-87.67845
13061,5,13,true,6,6,0,41.90342,-87.66779
KA1504000079,5,13,true,5,9,4,41.9035,-87.64334
TA1307000115,5,13,true,8,7,-1,41.9046,-87.64056
TA1308000049,5,13,true,11,12,1,41.90672,-87.6349
KA1504000134,5,13,true,4,6,2,41.90687,-87.6262
13221,5,13,true,9,9,0,41.90765,-87.67254
TA1309000024,5,13,true,4,6,2,41.908,-87.63152
TA1305000041,5,13,true,7,11,4,41.9094,-87.67769
331,5,13,true,11,7,-4,41.90965,-87.64812
TA1305000037,5,13,true,6,5,-1,41.91018,-87.67003
TA1308000005,5,13,true,6,5,-1,41.91042,-87.68238
13257,5,13,true,5,1,-4,41.91054,-87.68956
13154,5,13,true,8,13,5,41.91054,-87.65312
13058,5,13,true,8,5,-3,41.91059,-87.64942
TA1307000038,5,13,true,6,6,0,41.91138,-87.63868
LF-005,5,13,true,10,15,5,41.91172,-87.62681
13128,5,13,true,3,6,3,41.91197,-87.63197
TA1308000050,5,13,true,16,20,4,41.91211,-87.6347
13243,5,13,true,5,3,-2,41.91262,-87.6814
TA1306000032,5,13,true,7,8,1,41.9137,-87.65285
TA1307000166,5,13,true,3,14,11,41.91386,-87.64877
18067,5,13,true,4,5,1,41.9146,-87.66796
13179,5,13,true,9,4,-5,41.9157,-87.63461
13133,5,13,true,5,4,-1,41.91598,-87.67733
15650,5,13,true,2,9,7,41.91711,-87.71023
15651,5,13,true,6,2,-4,41.91752,-87.70181
TA1307000163,5,13,true,8,5,-3,41.91821,-87.65696
13146,5,13,true,13,13,0,41.91831,-87.63629
13059,5,13,true,7,6,-1,41.91845,-87.65222
13192,5,13,true,10,10,0,41.91995,-87.64884
TA1309000030,5,13,true,5,6,1,41.92077,-87.66372
TA1309000033,5,13,true,11,4,-7,41.92158,-87.65381
13193,5,13,true,10,10,0,41.92182,-87.64412
13191,5,13,true,9,4,-5,41.92217,-87.63891
LP-,5,13,true,10,1,-9,41.92396,-87.63584
TA1307000001,5,13,true,8,7,-1,41.92535,-87.66581
TA1306000026,5,13,true,15,7,-8,41.92558,-87.65842
TA1306000016,5,13,true,4,13,9,41.9256,-87.65371
TA1309000019,5,13,true,8,14,6,41.92586,-87.63897
TA1309000058,5,13,true,14,9,-5,41.92591,-87.64927
TA1308000001,5,13,true,21,18,-3,41.92627,-87.63086
TA1309000023,5,13,true,5,8,3,41.9287,-87.65383
TA1307000113,5,13,true,2,6,4,41.92878,-87.66391
TA1309000059,5,13,true,3,6,3,41.92889,-87.65898
TA1309000061,5,13,true,4,11,7,41.92915,-87.64909
TA1305000014,5,13,true,13,12,-1,41.92956,-87.64313
13085,5,13,true,5,4,-1,41.92958,-87.70789
TA1307000142,5,13,true,13,11,-2,41.93125,-87.64432
13276,5,13,true,8,10,2,41.93132,-87.63874
TA1307000064,5,13,true,9,6,-3,41.93222,-87.65864
TA1306000014,5,13,true,9,9,0,41.93242,-87.65271
TA1309000039,5,13,true,4,8,4,41.93258,-87.63642
TA1309000036,5,13,true,6,2,-4,41.93313,-87.64776
TA1307000006,5,13,true,3,6,3,41.93571,-87.6636
TA1307000052,5,13,true,5,10,5,41.93628,-87.65266
TA1307000136,5,13,true,11,15,4,41.9365,-87.64755
TA1307000041,5,13,true,10,9,-1,41.93669,-87.63683
13137,5,13,true,20,12,-8,41.9376,-87.6441
13229,5,13,true,8,12,4,41.93946,-87.66376
TA1308000019,5,13,true,6,7,1,41.93973,-87.65886
13277,5,13,true,7,5,-2,41.9401,-87.64546
TA1307000134,5,13,true,17,9,-8,41.94016,-87.65303
TA1309000049,5,13,true,8,17,9,41.94077,-87.63919
TA1307000138,5,13,true,6,6,0,41.94334,-87.67094
TA1309000025,5,13,true,9,9,0,41.94368,-87.64894
13071,5,13,true,2,10,8,41.94373,-87.66401
632,5,13,true,11,9,-2,41.94453,-87.6547
13278,5,13,true,10,18,8,41.94553,-87.64644
13235,5,13,true,9,15,6,41.94814,-87.66396
13325,5,13,true,17,9,-8,41.94907,-87.64863
TA1307000126,5,13,true,8,24,16,41.94936,-87.65451
TA1307000150,5,13,true,7,6,-1,41.94945,-87.64646
TA1307000127,5,13,true,5,9,4,41.9508,-87.65918
13323,5,13,true,7,7,0,41.95282,-87.65
TA1309000043,5,13,true,3,6,3,41.95417,-87.66434
13063,5,13,true,5,6,1,41.95424,-87.65441
TA1308000022,5,13,true,12,6,-6,41.95438,-87.64805
TA1307000149,5,13,true,5,3,-2,41.95467,-87.67392
TA1309000026,5,13,true,5,4,-1,41.95601,-87.6802
13379,5,13,true,6,11,5,41.95786,-87.6495
TA1309000027,5,13,true,7,8,1,41.9585,-87.65499
TA1307000144,5,13,true,1,7,6,41.96142,-87.6762
KA1503000022,5,13,true,4,5,1,41.96158,-87.66609
TA1307000107,5,13,true,9,13,4,41.96164,-87.65464
TA1307000156,5,13,true,7,3,-4,41.96301,-87.68479
TA1308000012,5,13,true,7,12,5,41.96398,-87.63818
13074,5,13,true,4,7,3,41.96521,-87.6582
639,5,13,true,8,11,3,41.96584,-87.64538
TA1307000140,5,13,true,1,5,4,41.96643,-87.68865
TA1307000158,5,13,true,5,4,-1,41.9671,-87.67904
TA1307000119,5,13,true,5,2,-3,41.96796,-87.65
TA1308000021,5,13,true,4,5,1,41.96883,-87.65765
TA1309000066,5,13,true,6,1,-5,41.9691,-87.67423
KA1504000171,5,13,true,5,3,-2,41.97161,-87.65016
TA1309000035,5,13,true,4,5,1,41.97335,-87.66785
KA1504000146,5,13,true,5,8,3,41.978,-87.66805
13109,5,13,true,6,4,-2,41.97835,-87.65976
KA1504000152,5,13,true,8,9,1,41.98403,-87.65231
15578,5,13,true,6,4,-2,41.98405,-87.66027
15575,5,13,true,5,3,-2,41.98975,-87.66014
15571,5,13,true,7,3,-4,41.99478,-87.66028
RP-009,5,13,true,5,3,-2,42.00107,-87.66122
604,5,13,true,4,7,3,42.05824,-87.67744
15491,5,14,false,3,5,2,41.78096,-87.57624
KA1503000014,5,14,false,5,1,-4,41.7851,-87.60108
KA1503000071,5,14,false,5,5,0,41.79148,-87.59988
KA1503000074,5,14,false,12,4,-8,41.79174,-87.58395
TA1308000009,5,14,false,10,6,-4,41.79522,-87.58075
KA1503000059,5,14,false,6,4,-2,41.79952,-87.58643
TA1309000037,5,14,false,2,9,7,41.79957,-87.59474
KA1503000004,5,14,false,2,5,3,41.83127,-87.6088
TA1307000048,5,14,false,9,4,-5,41.83855,-87.60821
13075,5,14,false,6,6,0,41.8531,-87.63192
15545,5,14,false,2,6,4,41.85627,-87.61334
13164,5,14,false,6,3,-3,41.85818,-87.65648
SL-012,5,14,false,3,5,2,41.86038,-87.62581
TA1307000124,5,14,false,9,11,2,41.86411,-87.62372
13029,5,14,false,10,15,5,41.86531,-87.6179
13431,5,14,false,16,11,-5,41.8661,-87.60728
TA1305000002,5,14,false,5,5,0,41.86721,-87.62597
15544,5,14,false,80,47,-33,41.86723,-87.61536
KA1706005007,5,14,false,5,4,-1,41.86749,-87.63219
SL-005,5,14,false,15,20,5,41.8679,-87.62304
13160,5,14,false,2,7,5,41.86947,-87.65548
TA1309000010,5,14,false,7,8,1,41.87074,-87.62574
TA1309000064,5,14,false,5,2,-3,41.87127,-87.67369
SL-008,5,14,false,18,18,0,41.87209,-87.62956
SL-011,5,14,false,9,9,0,41.87256,-87.63356
623,5,14,false,11,19,8,41.87272,-87.62399
SL-007,5,14,false,5,9,4,41.87404,-87.6277
15541,5,14,false,34,25,-9,41.8758,-87.62086
624,5,14,false,3,7,4,41.87626,-87.62923
13138,5,14,false,6,1,-5,41.87723,-87.63941
13157,5,14,false,4,9,5,41.87773,-87.6548
TA1305000025,5,14,false,15,15,0,41.87773,-87.63528
TA1309000002,5,14,false,5,21,16,41.87784,-87.62408
TA1309000004,5,14,false,8,2,-6,41.87811,-87.63184
638,5,14,false,2,5,3,41.87827,-87.64078
TA1305000005,5,14,false,9,3,-6,41.87924,-87.62975
13011,5,14,false,3,6,3,41.87931,-87.63993
TA1309000008,5,14,false,7,9,2,41.87933,-87.6355
KA1503000015,5,14,false,7,3,-4,41.87948,-87.6257
TA1309000007,5,14,false,10,12,2,41.88022,-87.63526
WL-011,5,14,false,1,5,4,41.88034,-87.64273
13156,5,14,false,9,4,-5,41.88042,-87.65554
13300,5,14,false,65,61,-4,41.88097,-87.61675
13008,5,14,false,46,61,15,41.88105,-87.62408
TA1305000006,5,14,false,6,6,0,41.88122,-87.6296
13056,5,14,false,13,3,-10,41.88168,-87.63951
TA1307000120,5,14,false,6,10,4,41.88188,-87.64879
13341,5,14,false,15,7,-8,41.88208,-87.63985
13036,5,14,false,16,3,-13,41.8821,-87.62513
TA1305000032,5,14,false,5,5,0,41.88218,-87.64109
13353,5,14,false,2,5,3,41.88283,-87.6612
13409,5,14,false,11,15,4,41.8831,-87.6511
KA1503000072,5,14,false,7,1,-6,41.88317,-87.63693
WL-012,5,14,false,8,2,-6,41.88337,-87.6412
13053,5,14,false,7,16,9,41.88365,-87.64863
13001,5,14,false,32,37,5,41.88397,-87.62459
18062,5,14,false,8,5,-3,41.88412,-87.65427
TA1306000010,5,14,false,2,8,6,41.88419,-87.62961
TA1305000030,5,14,false,5,2,-3,41.88459,-87.63178
15535,5,14,false,8,8,0,41.8846,-87.64455
TA1305000029,5,14,false,18,18,0,41.88466,-87.62787
13263,5,14,false,11,9,-2,41.88467,-87.61952
TA1306000015,5,14,false,10,15,5,41.88549,-87.65232
13021,5,14,false,7,1,-6,41.88559,-87.64184
TA1307000111,5,14,false,8,4,-4,41.88582,-87.63548
KA1503000012,5,14,false,7,9,2,41.88599,-87.63089
TA1305000011,5,14,false,19,15,-4,41.886,-87.62418
15534,5,14,false,5,8,3,41.88627,-87.61749
TA1307000131,5,14,false,16,13,-3,41.88688,-87.62606
KA1503000064,5,14,false,26,42,16,41.88697,-87.61281
TA1305000022,5,14,false,9,4,-5,41.88817,-87.63656
TA1306000003,5,14,false,11,10,-1,41.88867,-87.64442
KA1503000043,5,14,false,11,8,-3,41.88918,-87.63851
13050,5,14,false,18,12,-6,41.88919,-87.62775
13432,5,14,false,1,6,5,41.88989,-87.67149
TA1307000151,5,14,false,8,4,-4,41.88993,-87.63427
636,5,14,false,6,5,-1,41.88997,-87.63662
13427,5,14,false,7,6,-1,41.89054,-87.62205
13430,5,14,false,12,11,-1,41.89077,-87.63169
TA1306000013,5,14,false,30,25,-5,41.89083,-87.61852
TA1307000117,5,14,false,26,21,-5,41.89144,-87.62675
13033,5,14,false,7,5,-2,41.8916,-87.64835
13194,5,14,false,8,3,-5,41.8918,-87.65878
TA1305000003,5,14,false,17,17,0,41.89187,-87.62061
13022,5,14,false,163,127,-36,41.89227,-87.61205
TA1306000029,5,14,false,11,19,8,41.89256,-87.61449
13265,5,14,false,10,10,0,41.89383,-87.64172
13045,5,14,false,17,17,0,41.89403,-87.62931
13016,5,14,false,9,12,3,41.89431,-87.62277
KA1503000041,5,14,false,10,5,-5,41.89452,-87.61798
13196,5,14,false,5,7,2,41.89455,-87.65345
TA1306000012,5,14,false,15,17,2,41.89475,-87.63438
KP1705001026,5,14,false,11,1,-10,41.89483,-87.6323
637,5,14,false,5,1,-4,41.89563,-87.67209
13132,5,14,false,7,10,3,41.89573,-87.67718
15530,5,14,false,10,10,0,41.89575,-87.62596
18003,5,14,false,7,2,-5,41.89575,-87.62011
13247,5,14,false,5,4,-1,41.89597,-87.66775
TA1305000020,5,14,false,2,6,4,41.89636,-87.65406
13289,5,14,false,6,10,4,41.89638,-87.661
13303,5,14,false,5,6,1,41.89672,-87.63088
13017,5,14,false,6,5,-1,41.89676,-87.6357
13338,5,14,false,5,9,4,41.89697,-87.62173
TA1307000061,5,14,false,5,4,-1,41.89745,-87.62873
13034,5,14,false,17,17,0,41.89754,-87.62352
620,5,14,false,5,9,4,41.89817,-87.63754
15529,5,14,false,5,16,11,41.89858,-87.62206
TA1307000128,5,14,false,7,7,0,41.89896,-87.6299
13290,5,14,false,10,3,-7,41.90069,-87.66259
13042,5,14,false,29,54,25,41.90097,-87.62377
TA1307000070,5,14,false,2,6,4,41.90133,-87.67742
KA1504000133,5,14,false,16,13,-3,41.90234,-87.62773
TA1307000039,5,14,false,12,26,14,41.90294,-87.63137
TA1305000034,5,14,false,8,3,-5,41.90313,-87.67391
KA1504000135,5,14,false,15,15,0,41.90319,-87.63439
13136,5,14,false,1,7,6,41.90326,-87.67845
13061,5,14,false,7,7,0,41.90342,-87.66779
KA1504000079,5,14,false,6,4,-2,41.9035,-87.64334
TA1308000049,5,14,false,19,16,-3,41.90672,-87.6349
KA1504000134,5,14,false,9,19,10,41.90687,-87.6262
13224,5,14,false,5,5,0,41.90706,-87.66725
13221,5,14,false,6,6,0,41.90765,-87.67254
TA1309000024,5,14,false,12,13,1,41.908,-87.63152
TA1305000041,5,14,false,9,7,-2,41.9094,-87.67769
331,5,14,false,9,11,2,41.90965,-87.64812
TA1306000008,5,14,false,5,4,-1,41.9102,-87.6435
TA1308000005,5,14,false,5,1,-4,41.91042,-87.68238
13154,5,14,false,8,10,2,41.91054,-87.65312
13058,5,14,false,4,5,1,41.91059,-87.64942
TA1307000038,5,14,false,4,5,1,41.91138,-87.63868
LF-005,5,14,false,54,67,13,41.91172,-87.62681
13128,5,14,false,15,13,-2,41.91197,-87.63197
TA1308000050,5,14,false,15,28,13,41.91211,-87.6347
13243,5,14,false,8,6,-2,41.91262,-87.6814
TA1306000032,5,14,false,6,5,-1,41.9137,-87.65285
TA1307000166,5,14,false,8,6,-2,41.91386,-87.64877
18067,5,14,false,8,5,-3,41.9146,-87.66796
TA1306000007,5,14,false,7,4,-3,41.91469,-87.64333
13179,5,14,false,11,37,26,41.9157,-87.63461
13133,5,14,false,6,2,-4,41.91598,-87.67733
TA1305000039,5,14,false,8,6,-2,41.9163,-87.66749
TA1309000006,5,14,false,5,6,1,41.91809,-87.64375
TA1307000163,5,14,false,5,6,1,41.91821,-87.65696
13146,5,14,false,21,8,-13,41.91831,-87.63629
13059,5,14,false,10,18,8,41.91845,-87.65222
13259,5,14,false,2,8,6,41.91852,-87.69744
13192,5,14,false,8,9,1,41.91995,-87.64884
TA1309000030,5,14,false,15,3,-12,41.92077,-87.66372
TA1309000033,5,14,false,13,9,-4,41.92158,-87.65381
13193,5,14,false,14,10,-4,41.92182,-87.64412
13191,5,14,false,7,5,-2,41.92217,-87.63891
13084,5,14,false,4,5,1,41.92268,-87.69715
LP-,5,14,false,23,25,2,41.92396,-87.63584
TA1307000001,5,14,false,7,7,0,41.92535,-87.66581
TA1306000026,5,14,false,10,2,-8,41.92558,-87.65842
TA1306000016,5,14,false,6,6,0,41.9256,-87.65371
TA1309000019,5,14,false,11,16,5,41.92586,-87.63897
TA1309000058,5,14,false,20,10,-10,41.92591,-87.64927
TA1308000001,5,14,false,49,34,-15,41.92627,-87.63086
13124,5,14,false,9,9,0,41.92675,-87.63444
TA1309000023,5,14,false,11,3,-8,41.9287,-87.65383
TA1307000113,5,14,false,7,4,-3,41.92878,-87.66391
TA1309000061,5,14,false,5,5,0,41.92915,-87.64909
TA1308000031,5,14,false,3,6,3,41.92946,-87.68417
TA1305000014,5,14,false,8,7,-1,41.92956,-87.64313
13085,5,14,false,7,11,4,41.92958,-87.70789
TA1307000142,5,14,false,12,8,-4,41.93125,-87.64432
13276,5,14,false,9,23,14,41.93132,-87.63874
15645,5,14,false,6,2,-4,41.93191,-87.70121
TA1307000064,5,14,false,7,11,4,41.93222,-87.65864
TA1306000014,5,14,false,6,7,1,41.93242,-87.65271
TA1309000039,5,14,false,16,16,0,41.93258,-87.63642
13294,5,14,false,6,2,-4,41.9326,-87.66595
TA1309000036,5,14,false,7,4,-3,41.93313,-87.64776
TA1307000052,5,14,false,6,2,-4,41.93628,-87.65266
TA1307000136,5,14,false,15,6,-9,41.9365,-87.64755
TA1307000041,5,14,false,18,10,-8,41.93669,-87.63683
13137,5,14,false,11,11,0,41.9376,-87.6441
TA1309000042,5,14,false,6,4,-2,41.93937,-87.66836
KA150400009X,5,14,false,5,3,-2,41.9394,-87.71159
TA1308000019,5,14,false,5,5,0,41.93973,-87.65886
13277,5,14,false,10,5,-5,41.9401,-87.64546
TA1307000134,5,14,false,7,18,11,41.94016,-87.65303
TA1309000049,5,14,false,22,11,-11,41.94077,-87.63919
TA1307000138,5,14,false,9,4,-5,41.94334,-87.67094
TA1309000025,5,14,false,5,8,3,41.94368,-87.64894
13071,5,14,false,13,10,-3,41.94373,-87.66401
632,5,14,false,5,14,9,41.94453,-87.6547
13278,5,14,false,7,11,4,41.94553,-87.64644
13235,5,14,false,4,5,1,41.94814,-87.66396
13325,5,14,false,1,6,5,41.94907,-87.64863
TA1307000126,5,14,false,2,15,13,41.94936,-87.65451
TA1307000150,5,14,false,9,7,-2,41.94945,-87.64646
TA1307000127,5,14,false,12,14,2,41.9508,-87.65918
13063,5,14,false,9,3,-6,41.95424,-87.65441
TA1308000022,5,14,false,6,5,-1,41.95438,-87.64805
TA1307000107,5,14,false,13,6,-7,41.96164,-87.65464
TA1308000012,5,14,false,18,25,7,41.96398,-87.63818
13074,5,14,false,2,7,5,41.96521,-87.6582
639,5,14,false,2,9,7,41.96584,-87.64538
TA1309000014,5,14,false,7,3,-4,41.96709,-87.66744
TA1307000119,5,14,false,7,1,-6,41.96796,-87.65
TA1309000066,5,14,false,5,2,-3,41.9691,-87.67423
KA1504000171,5,14,false,3,8,5,41.97161,-87.65016
KA1504000152,5,14,false,5,15,10,41.98403,-87.65231
RP-009,5,14,false,5,1,-4,42.00107,-87.66122
KA1504000162,5,14,false,2,5,3,42.00907,-87.67422
KA1504000159,5,14,false,5,1,-4,42.01059,-87.66241
661,5,14,false,5,1,-4,42.05704,-87.68657
TA1309000011,5,14,true,5,8,3,41.78873,-87.60131
KA1503000071,5,14,true,8,8,0,41.79148,-87.59988
TA1309000063,5,14,true,3,6,3,41.79325,-87.5878
TA1308000009,5,14,true,12,8,-4,41.79522,-87.58075
TA1307000164,5,14,true,2,7,5,41.79527,-87.59647
TA1309000037,5,14,true,6,5,-1,41.79957,-87.59474
KA1503000007,5,14,true,3,8,5,41.80242,-87.58689
13216,5,14,true,5,7,2,41.83473,-87.62581
13217,5,14,true,3,5,2,41.83488,-87.61792
TA1307000048,5,14,true,4,5,1,41.83855,-87.60821
TA1308000036,5,14,true,3,5,2,41.83883,-87.62186
13075,5,14,true,2,7,5,41.8531,-87.63192
15545,5,14,true,11,11,0,41.85627,-87.61334
13150,5,14,true,8,5,-3,41.85783,-87.62455
TA1307000044,5,14,true,4,8,4,41.85794,-87.64083
SL-012,5,14,true,6,5,-1,41.86038,-87.62581
TA1307000124,5,14,true,9,3,-6,41.86411,-87.62372
13431,5,14,true,1,6,5,41.8661,-87.60728
WL-008,5,14,true,9,5,-4,41.86712,-87.64108
TA1305000002,5,14,true,6,11,5,41.86721,-87.62597
15544,5,14,true,5,7,2,41.86723,-87.61536
SL-005,5,14,true,9,12,3,41.8679,-87.62304
13139,5,14,true,3,8,5,41.86893,-87.65913
13285,5,14,true,8,5,-3,41.86928,-87.67372
13160,5,14,true,2,5,3,41.86947,-87.65548
TA1309000010,5,14,true,11,11,0,41.87074,-87.62574
SL-009,5,14,true,6,2,-4,41.87081,-87.63121
TA1309000064,5,14,true,11,3,-8,41.87127,-87.67369
TA1307000130,5,14,true,4,6,2,41.87178,-87.65103
TA1307000121,5,14,true,11,4,-7,41.87184,-87.64664
SL-008,5,14,true,6,5,-1,41.87209,-87.62956
13332,5,14,true,16,14,-2,41.87219,-87.6615
SL-011,5,14,true,5,3,-2,41.87256,-87.63356
KA1504000104,5,14,true,14,1,-13,41.87296,-87.66912
SL-007,5,14,true,7,2,-5,41.87404,-87.6277
13028,5,14,true,8,2,-6,41.87475,-87.64981
SL-010,5,14,true,2,5,3,41.87501,-87.63309
624,5,14,true,5,1,-4,41.87626,-87.62923
TA1305000035,5,14,true,2,7,5,41.87716,-87.62787
13138,5,14,true,6,5,-1,41.87723,-87.63941
15539,5,14,true,3,5,2,41.87763,-87.64405
13158,5,14,true,8,7,-1,41.87764,-87.64957
13157,5,14,true,8,8,0,41.87773,-87.6548
TA1305000025,5,14,true,14,5,-9,41.87773,-87.63528
TA1309000004,5,14,true,17,5,-12,41.87811,-87.63184
638,5,14,true,3,9,6,41.87827,-87.64078
TA1305000005,5,14,true,6,4,-2,41.87924,-87.62975
13011,5,14,true,7,7,0,41.87931,-87.63993
TA1309000008,5,14,true,8,5,-3,41.87933,-87.6355
TA1309000007,5,14,true,11,4,-7,41.88022,-87.63526
13156,5,14,true,4,5,1,41.88042,-87.65554
13300,5,14,true,14,17,3,41.88097,-87.61675
13008,5,14,true,8,7,-1,41.88105,-87.62408
TA1305000006,5,14,true,15,7,-8,41.88122,-87.6296
13056,5,14,true,5,5,0,41.88168,-87.63951
TA1307000120,5,14,true,19,10,-9,41.88188,-87.64879
13341,5,14,true,2,9,7,41.88208,-87.63985
13036,5,14,true,6,4,-2,41.8821,-87.62513
TA1305000032,5,14,true,13,11,-2,41.88218,-87.64109
13006,5,14,true,10,4,-6,41.88268,-87.63252
WL-012,5,14,true,5,16,11,41.88337,-87.6412
13053,5,14,true,12,13,1,41.88365,-87.64863
13001,5,14,true,10,13,3,41.88397,-87.62459
TA1306000010,5,14,true,9,14,5,41.88419,-87.62961
TA1305000030,5,14,true,13,10,-3,41.88459,-87.63178
15535,5,14,true,8,5,-3,41.8846,-87.64455
TA1305000029,5,14,true,11,9,-2,41.88466,-87.62787
13263,5,14,true,10,4,-6,41.88467,-87.61952
TA1306000015,5,14,true,10,11,1,41.88549,-87.65232
13021,5,14,true,7,6,-1,41.88559,-87.64184
TA1307000111,5,14,true,14,5,-9,41.88582,-87.63548
KA1503000012,5,14,true,6,10,4,41.88599,-87.63089
13197,5,14,true,4,5,1,41.8866,-87.65816
TA1308000029,5,14,true,7,8,1,41.88673,-87.62225
TA1307000131,5,14,true,9,8,-1,41.88688,-87.62606
KA1503000064,5,14,true,10,11,1,41.88697,-87.61281
TA1305000022,5,14,true,13,10,-3,41.88817,-87.63656
TA1306000003,5,14,true,10,7,-3,41.88867,-87.64442
KA1503000043,5,14,true,22,20,-2,41.88918,-87.63851
13050,5,14,true,4,8,4,41.88919,-87.62775
TA1307000151,5,14,true,11,14,3,41.88993,-87.63427
636,5,14,true,5,4,-1,41.88997,-87.63662
KA1503000044,5,14,true,5,4,-1,41.89018,-87.6262
13427,5,14,true,6,6,0,41.89054,-87.62205
13430,5,14,true,4,12,8,41.89077,-87.63169
TA1306000013,5,14,true,13,8,-5,41.89083,-87.61852
RN-,5,14,true,3,5,2,41.89102,-87.63546
TA1307000117,5,14,true,12,10,-2,41.89144,-87.62675
13033,5,14,true,10,5,-5,41.8916,-87.64835
13194,5,14,true,9,8,-1,41.8918,-87.65878
TA1305000003,5,14,true,10,9,-1,41.89187,-87.62061
13022,5,14,true,15,12,-3,41.89227,-87.61205
TA1306000029,5,14,true,5,2,-3,41.89256,-87.61449
13265,5,14,true,7,7,0,41.89383,-87.64172
13045,5,14,true,14,14,0,41.89403,-87.62931
13016,5,14,true,19,8,-11,41.89431,-87.62277
KA1503000041,5,14,true,11,7,-4,41.89452,-87.61798
TA1307000062,5,14,true,12,7,-5,41.89466,-87.63839
TA1306000012,5,14,true,13,20,7,41.89475,-87.63438
KP1705001026,5,14,true,5,4,-1,41.89483,-87.6323
15530,5,14,true,13,8,-5,41.89575,-87.62596
18003,5,14,true,7,3,-4,41.89575,-87.62011
13247,5,14,true,4,8,4,41.89597,-87.66775
TA1305000020,5,14,true,4,9,5,41.89636,-87.65406
13289,5,14,true,1,6,5,41.89638,-87.661
13303,5,14,true,10,11,1,41.89672,-87.63088
13017,5,14,true,16,12,-4,41.89676,-87.6357
13338,5,14,true,5,6,1,41.89697,-87.62173
TA1307000061,5,14,true,4,6,2,41.89745,-87.62873
13034,5,14,true,7,9,2,41.89754,-87.62352
TA1306000009,5,14,true,17,10,-7,41.89772,-87.64299
620,5,14,true,7,10,3,41.89817,-87.63754
15529,5,14,true,8,7,-1,41.89858,-87.62206
TA1307000128,5,14,true,9,11,2,41.89896,-87.6299
KA1504000117,5,14,true,2,5,3,41.89936,-87.64848
KA1504000116,5,14,true,9,5,-4,41.90023,-87.64299
13290,5,14,true,6,3,-3,41.90069,-87.66259
13042,5,14,true,21,7,-14,41.90097,-87.62377
KA1504000133,5,14,true,13,9,-4,41.90234,-87.62773
TA1307000039,5,14,true,17,31,14,41.90294,-87.63137
TA1305000034,5,14,true,3,6,3,41.90313,-87.67391
KA1504000135,5,14,true,17,16,-1,41.90319,-87.63439
13136,5,14,true,6,5,-1,41.90326,-87.67845
13061,5,14,true,14,9,-5,41.90342,-87.66779
KA1504000079,5,14,true,9,7,-2,41.9035,-87.64334
TA1307000115,5,14,true,3,8,5,41.9046,-87.64056
TA1308000049,5,14,true,5,9,4,41.90672,-87.6349
KA1504000134,5,14,true,6,7,1,41.90687,-87.6262
13224,5,14,true,11,4,-7,41.90706,-87.66725
13221,5,14,true,5,4,-1,41.90765,-87.67254
TA1309000024,5,14,true,12,11,-1,41.908,-87.63152
TA1305000041,5,14,true,8,12,4,41.9094,-87.67769
331,5,14,true,9,13,4,41.90965,-87.64812
13258,5,14,true,1,7,6,41.91043,-87.69718
13154,5,14,true,12,7,-5,41.91054,-87.65312
13058,5,14,true,4,5,1,41.91059,-87.64942
TA1307000038,5,14,true,7,6,-1,41.91138,-87.63868
LF-005,5,14,true,17,16,-1,41.91172,-87.62681
13128,5,14,true,4,5,1,41.91197,-87.63197
TA1308000050,5,14,true,13,25,12,41.91211,-87.6347
13243,5,14,true,9,10,1,41.91262,-87.6814
TA1306000032,5,14,true,7,9,2,41.9137,-87.65285
TA1307000166,5,14,true,12,10,-2,41.91386,-87.64877
18017,5,14,true,5,4,-1,41.91416,-87.71676
18067,5,14,true,9,7,-2,41.9146,-87.66796
13179,5,14,true,11,9,-2,41.9157,-87.63461
TA1305000039,5,14,true,6,5,-1,41.9163,-87.66749
13266,5,14,true,5,2,-3,41.91774,-87.69142
TA1309000006,5,14,true,5,3,-2,41.91809,-87.64375
TA1307000163,5,14,true,9,10,1,41.91821,-87.65696
13146,5,14,true,15,17,2,41.91831,-87.63629
13059,5,14,true,11,9,-2,41.91845,-87.65222
13192,5,14,true,9,10,1,41.91995,-87.64884
13288,5,14,true,1,7,6,41.92008,-87.67788
TA1309000030,5,14,true,6,7,1,41.92077,-87.66372
TA1309000033,5,14,true,8,8,0,41.92158,-87.65381
13193,5,14,true,6,10,4,41.92182,-87.64412
13191,5,14,true,8,6,-2,41.92217,-87.63891
LP-,5,14,true,5,5,0,41.92396,-87.63584
TA1307000001,5,14,true,5,6,1,41.92535,-87.66581
TA1306000026,5,14,true,5,8,3,41.92558,-87.65842
TA1306000016,5,14,true,13,5,-8,41.9256,-87.65371
TA1309000019,5,14,true,13,17,4,41.92586,-87.63897
TA1309000058,5,14,true,8,10,2,41.92591,-87.64927
TA1308000001,5,14,true,27,22,-5,41.92627,-87.63086
TA1309000023,5,14,true,5,7,2,41.9287,-87.65383
TA1307000113,5,14,true,2,5,3,41.92878,-87.66391
TA1309000059,5,14,true,4,5,1,41.92889,-87.65898
TA1309000061,5,14,true,4,7,3,41.92915,-87.64909
TA1305000014,5,14,true,12,12,0,41.92956,-87.64313
TA1307000142,5,14,true,16,15,-1,41.93125,-87.64432
13276,5,14,true,11,9,-2,41.93132,-87.63874
TA1307000064,5,14,true,8,3,-5,41.93222,-87.65864
TA1306000014,5,14,true,14,5,-9,41.93242,-87.65271
TA1309000039,5,14,true,12,7,-5,41.93258,-87.63642
13294,5,14,true,5,1,-4,41.9326,-87.66595
TA1309000036,5,14,true,6,4,-2,41.93313,-87.64776
TA1307000006,5,14,true,3,6,3,41.93571,-87.6636
TA1307000052,5,14,true,4,5,1,41.93628,-87.65266
TA1307000136,5,14,true,10,15,5,41.9365,-87.64755
TA1307000041,5,14,true,10,10,0,41.93669,-87.63683
13137,5,14,true,21,21,0,41.9376,-87.6441
TA1308000019,5,14,true,5,8,3,41.93973,-87.65886
13277,5,14,true,8,5,-3,41.9401,-87.64546
TA1307000134,5,14,true,15,18,3,41.94016,-87.65303
TA1309000049,5,14,true,4,7,3,41.94077,-87.63919
TA1309000025,5,14,true,3,8,5,41.94368,-87.64894
13071,5,14,true,9,8,-1,41.94373,-87.66401
632,5,14,true,5,11,6,41.94453,-87.6547
13278,5,14,true,13,11,-2,41.94553,-87.64644
13235,5,14,true,13,8,-5,41.94814,-87.66396
13325,5,14,true,12,16,4,41.94907,-87.64863
TA1307000126,5,14,true,4,9,5,41.94936,-87.65451
TA1307000150,5,14,true,11,9,-2,41.94945,-87.64646
TA1307000127,5,14,true,11,4,-7,41.9508,-87.65918
13323,5,14,true,11,5,-6,41.95282,-87.65
TA1309000043,5,14,true,3,8,5,41.95417,-87.66434
13063,5,14,true,6,5,-1,41.95424,-87.65441
TA1308000022,5,14,true,9,5,-4,41.95438,-87.64805
TA1307000149,5,14,true,5,3,-2,41.95467,-87.67392
13379,5,14,true,4,11,7,41.95786,-87.6495
TA1309000027,5,14,true,6,1,-5,41.9585,-87.65499
13389,5,14,true,5,1,-4,41.961,-87.64958
TA1307000144,5,14,true,5,3,-2,41.96142,-87.6762
TA1307000107,5,14,true,8,12,4,41.96164,-87.65464
TA1307000156,5,14,true,5,6,1,41.96301,-87.68479
TA1308000012,5,14,true,8,17,9,41.96398,-87.63818
13074,5,14,true,7,3,-4,41.96521,-87.6582
639,5,14,true,9,7,-2,41.96584,-87.64538
TA1307000140,5,14,true,11,6,-5,41.96643,-87.68865
TA1309000014,5,14,true,4,5,1,41.96709,-87.66744
TA1307000158,5,14,true,4,6,2,41.9671,-87.67904
TA1307000119,5,14,true,5,5,0,41.96796,-87.65
TA1309000066,5,14,true,1,5,4,41.9691,-87.67423
KA1504000171,5,14,true,4,5,1,41.97161,-87.65016
TA1309000035,5,14,true,7,5,-2,41.97335,-87.66785
13108,5,14,true,6,7,1,41.97379,-87.65971
KA1504000149,5,14,true,10,5,-5,41.97562,-87.67945
KA1504000146,5,14,true,4,5,1,41.978,-87.66805
KA1504000151,5,14,true,5,5,0,41.98359,-87.66916
KA1504000152,5,14,true,10,15,5,41.98403,-87.65231
15578,5,14,true,1,5,4,41.98405,-87.66027
KA1503000029,5,15,false,7,2,-5,41.77364,-87.56747
TA1309000011,5,15,false,6,2,-4,41.78873,-87.60131
KA1503000071,5,15,false,8,2,-6,41.79148,-87.59988
KA1503000074,5,15,false,9,11,2,41.79174,-87.58395
TA1309000063,5,15,false,8,1,-7,41.79325,-87.5878
TA1308000009,5,15,false,9,10,1,41.79522,-87.58075
TA1307000164,5,15,false,5,3,-2,41.79527,-87.59647
KA1503000059,5,15,false,3,7,4,41.79952,-87.58643
TA1309000037,5,15,false,4,7,3,41.79957,-87.59474
TA1307000048,5,15,false,13,12,-1,41.83855,-87.60821
TA1308000036,5,15,false,2,5,3,41.83883,-87.62186
13075,5,15,false,6,10,4,41.8531,-87.63192
15545,5,15,false,7,15,8,41.85627,-87.61334
SL-013,5,15,false,8,5,-3,41.85659,-87.62755
13102,5,15,false,2,5,3,41.85762,-87.61942
13150,5,15,false,4,5,1,41.85783,-87.62455
SL-012,5,15,false,2,5,3,41.86038,-87.62581
TA1307000124,5,15,false,10,5,-5,41.86411,-87.62372
TA1309000001,5,15,false,5,1,-4,41.86488,-87.64708
13029,5,15,false,21,9,-12,41.86531,-87.6179
13431,5,15,false,9,11,2,41.8661,-87.60728
WL-008,5,15,false,3,6,3,41.86712,-87.64108
TA1305000002,5,15,false,16,23,7,41.86721,-87.62597
15544,5,15,false,55,36,-19,41.86723,-87.61536
KA1706005007,5,15,false,7,5,-2,41.86749,-87.63219
SL-005,5,15,false,26,37,11,41.8679,-87.62304
13285,5,15,false,5,1,-4,41.86928,-87.67372
13160,5,15,false,6,4,-2,41.86947,-87.65548
15550,5,15,false,5,2,-3,41.87024,-87.63947
TA1309000010,5,15,false,6,10,4,41.87074,-87.62574
SL-009,5,15,false,1,9,8,41.87081,-87.63121
TA1309000064,5,15,false,6,2,-4,41.87127,-87.67369
TA1307000121,5,15,false,5,2,-3,41.87184,-87.64664
SL-008,5,15,false,2,7,5,41.87209,-87.62956
SL-011,5,15,false,9,12,3,41.87256,-87.63356
623,5,15,false,12,16,4,41.87272,-87.62399
KA1504000104,5,15,false,6,1,-5,41.87296,-87.66912
SL-007,5,15,false,7,15,8,41.87404,-87.6277
SL-010,5,15,false,5,3,-2,41.87501,-87.63309
15541,5,15,false,23,17,-6,41.8758,-87.62086
TA1305000010,5,15,false,8,5,-3,41.87623,-87.62444
TA1305000035,5,15,false,4,9,5,41.87716,-87.62787
13158,5,15,false,3,6,3,41.87764,-87.64957
13157,5,15,false,4,5,1,41.87773,-87.6548
TA1305000025,5,15,false,20,8,-12,41.87773,-87.63528
TA1309000002,5,15,false,18,11,-7,41.87784,-87.62408
13206,5,15,false,4,5,1,41.87794,-87.66201
TA1309000004,5,15,false,7,3,-4,41.87811,-87.63184
13011,5,15,false,11,4,-7,41.87931,-87.63993
TA1309000008,5,15,false,10,3,-7,41.87933,-87.6355
KA1503000034,5,15,false,7,7,0,41.87938,-87.63197
KA1503000015,5,15,false,3,5,2,41.87948,-87.6257
TA1309000007,5,15,false,10,2,-8,41.88022,-87.63526
13156,5,15,false,6,2,-4,41.88042,-87.65554
13300,5,15,false,61,60,-1,41.88097,-87.61675
13008,5,15,false,55,46,-9,41.88105,-87.62408
TA1305000006,5,15,false,23,6,-17,41.88122,-87.6296
13056,5,15,false,7,6,-1,41.88168,-87.63951
TA1307000120,5,15,false,14,21,7,41.88188,-87.64879
13341,5,15,false,7,3,-4,41.88208,-87.63985
13036,5,15,false,9,7,-2,41.8821,-87.62513
TA1305000032,5,15,false,19,8,-11,41.88218,-87.64109
13353,5,15,false,4,9,5,41.88283,-87.6612
13409,5,15,false,6,9,3,41.8831,-87.6511
WL-012,5,15,false,5,7,2,41.88337,-87.6412
13053,5,15,false,24,12,-12,41.88365,-87.64863
13001,5,15,false,20,20,0,41.88397,-87.62459
13155,5,15,false,3,5,2,41.88407,-87.65689
18062,5,15,false,7,6,-1,41.88412,-87.65427
TA1306000010,5,15,false,7,8,1,41.88419,-87.62961
TA1305000030,5,15,false,6,7,1,41.88459,-87.63178
15535,5,15,false,7,8,1,41.8846,-87.64455
TA1305000029,5,15,false,8,17,9,41.88466,-87.62787
13263,5,15,false,17,7,-10,41.88467,-87.61952
TA1306000015,5,15,false,11,12,1,41.88549,-87.65232
13021,5,15,false,5,3,-2,41.88559,-87.64184
TA1307000111,5,15,false,11,4,-7,41.88582,-87.63548
13073,5,15,false,1,6,5,41.88592,-87.66717
KA1503000012,5,15,false,12,10,-2,41.88599,-87.63089
TA1305000011,5,15,false,21,26,5,41.886,-87.62418
15534,5,15,false,8,5,-3,41.88627,-87.61749
TA1308000029,5,15,false,7,5,-2,41.88673,-87.62225
TA1307000131,5,15,false,12,26,14,41.88688,-87.62606
KA1503000064,5,15,false,36,30,-6,41.88697,-87.61281
TA1305000022,5,15,false,5,4,-1,41.88817,-87.63656
TA1306000003,5,15,false,15,11,-4,41.88867,-87.64442
KA1503000043,5,15,false,11,12,1,41.88918,-87.63851
13050,5,15,false,28,11,-17,41.88919,-87.62775
TA1307000151,5,15,false,14,11,-3,41.88993,-87.63427
636,5,15,false,8,8,0,41.88997,-87.63662
KA1503000044,5,15,false,9,10,1,41.89018,-87.6262
13427,5,15,false,8,8,0,41.89054,-87.62205
13430,5,15,false,17,20,3,41.89077,-87.63169
TA1306000013,5,15,false,17,23,6,41.89083,-87.61852
RN-,5,15,false,5,5,0,41.89102,-87.63546
TA1307000117,5,15,false,15,23,8,41.89144,-87.62675
13033,5,15,false,5,7,2,41.8916,-87.64835
13194,5,15,false,8,4,-4,41.8918,-87.65878
TA1305000003,5,15,false,15,16,1,41.89187,-87.62061
13022,5,15,false,183,172,-11,41.89227,-87.61205
TA1306000029,5,15,false,13,20,7,41.89256,-87.61449
13265,5,15,false,6,15,9,41.89383,-87.64172
13045,5,15,false,26,20,-6,41.89403,-87.62931
13016,5,15,false,14,13,-1,41.89431,-87.62277
KA1503000041,5,15,false,10,6,-4,41.89452,-87.61798
TA1307000062,5,15,false,6,3,-3,41.89466,-87.63839
TA1306000012,5,15,false,15,14,-1,41.89475,-87.63438
KP1705001026,5,15,false,7,10,3,41.89483,-87.6323
637,5,15,false,1,7,6,41.89563,-87.67209
13132,5,15,false,5,6,1,41.89573,-87.67718
15530,5,15,false,8,16,8,41.89575,-87.62596
18003,5,15,false,1,7,6,41.89575,-87.62011
TA1305000020,5,15,false,2,5,3,41.89636,-87.65406
13289,5,15,false,5,4,-1,41.89638,-87.661
13303,5,15,false,8,6,-2,41.89672,-87.63088
13017,5,15,false,4,7,3,41.89676,-87.6357
13338,5,15,false,4,9,5,41.89697,-87.62173
TA1307000061,5,15,false,6,16,10,41.89745,-87.62873
13034,5,15,false,8,9,1,41.89754,-87.62352
TA1306000009,5,15,false,3,5,2,41.89772,-87.64299
620,5,15,false,4,8,4,41.89817,-87.63754
KA1504000103,5,15,false,5,3,-2,41.89842,-87.68659
15529,5,15,false,16,15,-1,41.89858,-87.62206
TA1307000128,5,15,false,16,11,-5,41.89896,-87.6299
TA1306000011,5,15,false,8,5,-3,41.89994,-87.63443
17660,5,15,false,5,3,-2,41.90036,-87.69671
13042,5,15,false,72,61,-11,41.90097,-87.62377
KA1504000133,5,15,false,15,27,12,41.90234,-87.62773
TA1307000039,5,15,false,25,28,3,41.90294,-87.63137
TA1305000034,5,15,false,8,6,-2,41.90313,-87.67391
KA1504000135,5,15,false,24,24,0,41.90319,-87.63439
13136,5,15,false,10,2,-8,41.90326,-87.67845
13061,5,15,false,8,9,1,41.90342,-87.66779
KA1504000079,5,15,false,11,10,-1,41.9035,-87.64334
TA1308000049,5,15,false,17,20,3,41.90672,-87.6349
KA1504000134,5,15,false,19,11,-8,41.90687,-87.6262
13224,5,15,false,5,2,-3,41.90706,-87.66725
13221,5,15,false,8,11,3,41.90765,-87.67254
TA1309000024,5,15,false,13,14,1,41.908,-87.63152
TA1305000041,5,15,false,1,9,8,41.9094,-87.67769
331,5,15,false,18,4,-14,41.90965,-87.64812
TA1305000037,5,15,false,7,4,-3,41.91018,-87.67003
TA1308000005,5,15,false,3,5,2,41.91042,-87.68238
13154,5,15,false,10,3,-7,41.91054,-87.65312
13058,5,15,false,9,7,-2,41.91059,-87.64942
TA1307000038,5,15,false,9,11,2,41.91138,-87.63868
LF-005,5,15,false,53,42,-11,41.91172,-87.62681
13128,5,15,false,6,9,3,41.91197,-87.63197
TA1308000050,5,15,false,21,24,3,41.91211,-87.6347
13243,5,15,false,15,3,-12,41.91262,-87.6814
TA1306000032,5,15,false,5,19,14,41.9137,-87.65285
TA1307000166,5,15,false,7,9,2,41.91386,-87.64877
18067,5,15,false,6,5,-1,41.9146,-87.66796
13179,5,15,false,17,18,1,41.9157,-87.63461
13133,5,15,false,11,3,-8,41.91598,-87.67733
TA1305000039,5,15,false,13,9,-4,41.9163,-87.66749
TA1309000006,5,15,false,4,5,1,41.91809,-87.64375
13146,5,15,false,11,13,2,41.91831,-87.63629
13059,5,15,false,9,11,2,41.91845,-87.65222
13192,5,15,false,6,8,2,41.91995,-87.64884
TA1309000030,5,15,false,9,8,-1,41.92077,-87.66372
TA1309000033,5,15,false,9,11,2,41.92158,-87.65381
13193,5,15,false,15,17,2,41.92182,-87.64412
13191,5,15,false,3,8,5,41.92217,-87.63891
13084,5,15,false,5,12,7,41.92268,-87.69715
LP-,5,15,false,32,15,-17,41.92396,-87.63584
TA1306000026,5,15,false,7,6,-1,41.92558,-87.65842
TA1306000016,5,15,false,4,5,1,41.9256,-87.65371
TA1309000019,5,15,false,9,14,5,41.92586,-87.63897
TA1309000058,5,15,false,18,14,-4,41.92591,-87.64927
TA1308000001,5,15,false,42,57,15,41.92627,-87.63086
13124,5,15,false,6,5,-1,41.92675,-87.63444
TA1309000023,5,15,false,9,7,-2,41.9287,-87.65383
TA1307000113,5,15,false,8,4,-4,41.92878,-87.66391
TA1309000061,5,15,false,6,14,8,41.92915,-87.64909
TA1305000014,5,15,false,13,11,-2,41.92956,-87.64313
TA1307000142,5,15,false,10,11,1,41.93125,-87.64432
13276,5,15,false,13,8,-5,41.93132,-87.63874
13271,5,15,false,5,5,0,41.93192,-87.67784
TA1307000064,5,15,false,5,16,11,41.93222,-87.65864
TA1306000014,5,15,false,16,10,-6,41.93242,-87.65271
TA1309000039,5,15,false,10,8,-2,41.93258,-87.63642
13294,5,15,false,6,4,-2,41.9326,-87.66595
TA1309000036,5,15,false,4,8,4,41.93313,-87.64776
TA1307000006,5,15,false,5,7,2,41.93571,-87.6636
TA1307000052,5,15,false,5,3,-2,41.93628,-87.65266
TA1307000136,5,15,false,6,13,7,41.9365,-87.64755
TA1307000041,5,15,false,13,16,3,41.93669,-87.63683
13137,5,15,false,16,11,-5,41.9376,-87.6441
TA1309000042,5,15,false,6,2,-4,41.93937,-87.66836
13229,5,15,false,7,7,0,41.93946,-87.66376
TA1308000019,5,15,false,7,5,-2,41.93973,-87.65886
13277,5,15,false,3,13,10,41.9401,-87.64546
TA1307000134,5,15,false,13,11,-2,41.94016,-87.65303
TA1309000049,5,15,false,13,9,-4,41.94077,-87.63919
TA1307000138,5,15,false,8,2,-6,41.94334,-87.67094
13144,5,15,false,5,4,-1,41.9434,-87.67964
TA1309000025,5,15,false,10,12,2,41.94368,-87.64894
13071,5,15,false,7,10,3,41.94373,-87.66401
632,5,15,false,7,8,1,41.94453,-87.6547
13278,5,15,false,4,15,11,41.94553,-87.64644
13235,5,15,false,6,5,-1,41.94814,-87.66396
13325,5,15,false,6,4,-2,41.94907,-87.64863
TA1307000126,5,15,false,9,14,5,41.94936,-87.65451
TA1307000150,5,15,false,10,14,4,41.94945,-87.64646
TA1307000127,5,15,false,7,18,11,41.9508,-87.65918
13323,5,15,false,4,5,1,41.95282,-87.65
13063,5,15,false,9,6,-3,41.95424,-87.65441
TA1309000027,5,15,false,6,1,-5,41.9585,-87.65499
13389,5,15,false,8,1,-7,41.961,-87.64958
TA1307000107,5,15,false,6,2,-4,41.96164,-87.65464
TA1308000012,5,15,false,18,19,1,41.96398,-87.63818
639,5,15,false,10,7,-3,41.96584,-87.64538
TA1309000014,5,15,false,5,14,9,41.96709,-87.66744
TA1309000066,5,15,false,7,4,-3,41.9691,-87.67423
KA1504000171,5,15,false,2,6,4,41.97161,-87.65016
KA1504000151,5,15,false,1,5,4,41.98359,-87.66916
KA1504000152,5,15,false,11,15,4,41.98403,-87.65231
15571,5,15,false,9,4,-5,41.99478,-87.66028
596,5,15,false,4,9,5,42.04822,-87.68348
E006,5,15,false,9,3,-6,42.06367,-87.69871
KA1503000014,5,15,true,6,4,-2,41.7851,-87.60108
TA1309000011,5,15,true,7,2,-5,41.78873,-87.60131
KA1503000071,5,15,true,9,11,2,41.79148,-87.59988
KA1504000076,5,15,true,4,6,2,41.7943,-87.60145
TA1308000009,5,15,true,7,8,1,41.79522,-87.58075
TA1309000037,5,15,true,4,10,6,41.79957,-87.59474
KA1503000007,5,15,true,9,4,-5,41.80242,-87.58689
KA1503000004,5,15,true,3,5,2,41.83127,-87.6088
13216,5,15,true,8,5,-3,41.83473,-87.62581
13217,5,15,true,6,4,-2,41.83488,-87.61792
TA1307000048,5,15,true,5,6,1,41.83855,-87.60821
15545,5,15,true,9,10,1,41.85627,-87.61334
SL-006,5,15,true,5,1,-4,41.8568,-87.63387
13135,5,15,true,9,5,-4,41.85753,-87.66157
13102,5,15,true,9,9,0,41.85762,-87.61942
13150,5,15,true,8,9,1,41.85783,-87.62455
SL-012,5,15,true,4,5,1,41.86038,-87.62581
TA1307000124,5,15,true,8,12,4,41.86411,-87.62372
13431,5,15,true,4,5,1,41.8661,-87.60728
TA1305000002,5,15,true,10,13,3,41.86721,-87.62597
15544,5,15,true,7,14,7,41.86723,-87.61536
SL-005,5,15,true,9,10,1,41.8679,-87.62304
13139,5,15,true,5,1,-4,41.86893,-87.65913
13285,5,15,true,5,4,-1,41.86928,-87.67372
13160,5,15,true,6,2,-4,41.86947,-87.65548
TA1309000010,5,15,true,18,16,-2,41.87074,-87.62574
TA1309000064,5,15,true,10,3,-7,41.87127,-87.67369
TA1307000130,5,15,true,11,1,-10,41.87178,-87.65103
TA1307000121,5,15,true,8,5,-3,41.87184,-87.64664
SL-008,5,15,true,16,14,-2,41.87209,-87.62956
13332,5,15,true,8,9,1,41.87219,-87.6615
SL-011,5,15,true,10,6,-4,41.87256,-87.63356
KA1504000104,5,15,true,30,3,-27,41.87296,-87.66912
15668,5,15,true,6,3,-3,41.87471,-87.68642
13028,5,15,true,6,8,2,41.87475,-87.64981
13037,5,15,true,6,1,-5,41.87588,-87.64078
TA1305000009,5,15,true,3,5,2,41.87593,-87.63068
TA1305000035,5,15,true,6,2,-4,41.87716,-87.62787
15539,5,15,true,9,5,-4,41.87763,-87.64405
13158,5,15,true,11,6,-5,41.87764,-87.64957
13157,5,15,true,5,6,1,41.87773,-87.6548
TA1305000025,5,15,true,10,11,1,41.87773,-87.63528
13206,5,15,true,8,6,-2,41.87794,-87.66201
TA1309000004,5,15,true,22,10,-12,41.87811,-87.63184
638,5,15,true,15,16,1,41.87827,-87.64078
TA1305000005,5,15,true,10,5,-5,41.87924,-87.62975
13011,5,15,true,10,16,6,41.87931,-87.63993
TA1309000008,5,15,true,7,5,-2,41.87933,-87.6355
KA1503000034,5,15,true,9,3,-6,41.87938,-87.63197
KA1503000015,5,15,true,9,8,-1,41.87948,-87.6257
TA1309000007,5,15,true,15,5,-10,41.88022,-87.63526
13156,5,15,true,9,10,1,41.88042,-87.65554
13300,5,15,true,15,20,5,41.88097,-87.61675
13008,5,15,true,7,9,2,41.88105,-87.62408
TA1305000006,5,15,true,24,8,-16,41.88122,-87.6296
13056,5,15,true,4,6,2,41.88168,-87.63951
TA1307000120,5,15,true,11,26,15,41.88188,-87.64879
13341,5,15,true,4,9,5,41.88208,-87.63985
TA1305000032,5,15,true,13,12,-1,41.88218,-87.64109
13006,5,15,true,10,9,-1,41.88268,-87.63252
13353,5,15,true,3,9,6,41.88283,-87.6612
13409,5,15,true,14,10,-4,41.8831,-87.6511
KA1503000072,5,15,true,8,6,-2,41.88317,-87.63693
WL-012,5,15,true,12,30,18,41.88337,-87.6412
13053,5,15,true,5,8,3,41.88365,-87.64863
13001,5,15,true,10,7,-3,41.88397,-87.62459
18062,5,15,true,8,5,-3,41.88412,-87.65427
TA1306000010,5,15,true,13,13,0,41.88419,-87.62961
TA1305000030,5,15,true,15,8,-7,41.88459,-87.63178
15535,5,15,true,9,8,-1,41.8846,-87.64455
TA1305000029,5,15,true,12,7,-5,41.88466,-87.62787
13263,5,15,true,14,11,-3,41.88467,-87.61952
TA1306000015,5,15,true,9,10,1,41.88549,-87.65232
13021,5,15,true,10,7,-3,41.88559,-87.64184
TA1307000111,5,15,true,19,6,-13,41.88582,-87.63548
13073,5,15,true,6,3,-3,41.88592,-87.66717
KA1503000012,5,15,true,7,13,6,41.88599,-87.63089
TA1305000011,5,15,true,14,15,1,41.886,-87.62418
15534,5,15,true,12,7,-5,41.88627,-87.61749
13197,5,15,true,5,3,-2,41.8866,-87.65816
TA1308000029,5,15,true,6,3,-3,41.88673,-87.62225
TA1307000131,5,15,true,10,3,-7,41.88688,-87.62606
KA1503000064,5,15,true,10,15,5,41.88697,-87.61281
TA1305000022,5,15,true,26,10,-16,41.88817,-87.63656
TA1306000003,5,15,true,17,7,-10,41.88867,-87.64442
KA1503000043,5,15,true,26,25,-1,41.88918,-87.63851
13050,5,15,true,14,18,4,41.88919,-87.62775
TA1307000151,5,15,true,9,16,7,41.88993,-87.63427
636,5,15,true,8,7,-1,41.88997,-87.63662
KA1503000044,5,15,true,6,7,1,41.89018,-87.6262
13427,5,15,true,6,7,1,41.89054,-87.62205
13430,5,15,true,12,18,6,41.89077,-87.63169
TA1306000013,5,15,true,5,14,9,41.89083,-87.61852
RN-,5,15,true,8,8,0,41.89102,-87.63546
TA1307000117,5,15,true,13,13,0,41.89144,-87.62675
13033,5,15,true,11,8,-3,41.8916,-87.64835
TA1305000003,5,15,true,12,11,-1,41.89187,-87.62061
13022,5,15,true,14,14,0,41.89227,-87.61205
TA1306000029,5,15,true,6,11,5,41.89256,-87.61449
13265,5,15,true,13,16,3,41.89383,-87.64172
13045,5,15,true,17,13,-4,41.89403,-87.62931
13016,5,15,true,34,10,-24,41.89431,-87.62277
KA1503000041,5,15,true,14,8,-6,41.89452,-87.61798
13196,5,15,true,5,4,-1,41.89455,-87.65345
TA1307000062,5,15,true,10,6,-4,41.89466,-87.63839
TA1306000012,5,15,true,14,15,1,41.89475,-87.63438
KP1705001026,5,15,true,3,5,2,41.89483,-87.6323
637,5,15,true,8,4,-4,41.89563,-87.67209
13132,5,15,true,9,7,-2,41.89573,-87.67718
15530,5,15,true,14,11,-3,41.89575,-87.62596
18003,5,15,true,12,3,-9,41.89575,-87.62011
13247,5,15,true,8,4,-4,41.89597,-87.66775
TA1305000020,5,15,true,9,8,-1,41.89636,-87.65406
13289,5,15,true,4,6,2,41.89638,-87.661
13303,5,15,true,7,8,1,41.89672,-87.63088
13017,5,15,true,9,10,1,41.89676,-87.6357
13338,5,15,true,14,10,-4,41.89697,-87.62173
TA1307000061,5,15,true,6,10,4,41.89745,-87.62873
13034,5,15,true,6,4,-2,41.89754,-87.62352
TA1306000009,5,15,true,19,7,-12,41.89772,-87.64299
620,5,15,true,7,4,-3,41.89817,-87.63754
15529,5,15,true,18,9,-9,41.89858,-87.62206
TA1307000128,5,15,true,19,27,8,41.89896,-87.6299
657,5,15,true,5,2,-3,41.89918,-87.6722
13248,5,15,true,3,8,5,41.89964,-87.66788
TA1306000011,5,15,true,6,7,1,41.89994,-87.63443
KA1504000116,5,15,true,6,4,-2,41.90023,-87.64299
13290,5,15,true,5,4,-1,41.90069,-87.66259
13042,5,15,true,11,16,5,41.90097,-87.62377
TA1307000070,5,15,true,2,6,4,41.90133,-87.67742
KA1504000133,5,15,true,12,4,-8,41.90234,-87.62773
13241,5,15,true,5,2,-3,41.9029,-87.68731
TA1307000039,5,15,true,19,19,0,41.90294,-87.63137
TA1305000034,5,15,true,7,9,2,41.90313,-87.67391
KA1504000135,5,15,true,29,21,-8,41.90319,-87.63439
13061,5,15,true,6,9,3,41.90342,-87.66779
KA1504000079,5,15,true,14,8,-6,41.9035,-87.64334
TA1307000115,5,15,true,6,9,3,41.9046,-87.64056
TA1308000049,5,15,true,13,19,6,41.90672,-87.6349
KA1504000134,5,15,true,4,13,9,41.90687,-87.6262
13224,5,15,true,5,8,3,41.90706,-87.66725
13221,5,15,true,3,13,10,41.90765,-87.67254
TA1309000024,5,15,true,13,10,-3,41.908,-87.63152
TA1305000041,5,15,true,6,14,8,41.9094,-87.67769
331,5,15,true,18,14,-4,41.90965,-87.64812
TA1305000037,5,15,true,6,6,0,41.91018,-87.67003
TA1306000008,5,15,true,6,1,-5,41.9102,-87.6435
13258,5,15,true,5,1,-4,41.91043,-87.69718
13154,5,15,true,6,10,4,41.91054,-87.65312
13058,5,15,true,14,12,-2,41.91059,-87.64942
TA1307000038,5,15,true,11,9,-2,41.91138,-87.63868
LF-005,5,15,true,22,21,-1,41.91172,-87.62681
13128,5,15,true,11,9,-2,41.91197,-87.63197
TA1308000050,5,15,true,25,28,3,41.91211,-87.6347
13243,5,15,true,6,5,-1,41.91262,-87.6814
TA1306000032,5,15,true,11,8,-3,41.9137,-87.65285
TA1307000166,5,15,true,12,11,-1,41.91386,-87.64877
18067,5,15,true,8,6,-2,41.9146,-87.66796
13179,5,15,true,23,14,-9,41.9157,-87.63461
13133,5,15,true,6,7,1,41.91598,-87.67733
TA1309000006,5,15,true,8,4,-4,41.91809,-87.64375
TA1307000163,5,15,true,10,16,6,41.91821,-87.65696
13146,5,15,true,11,16,5,41.91831,-87.63629
13059,5,15,true,15,11,-4,41.91845,-87.65222
13192,5,15,true,10,12,2,41.91995,-87.64884
TA1309000030,5,15,true,2,5,3,41.92077,-87.66372
TA1309000033,5,15,true,9,9,0,41.92158,-87.65381
13193,5,15,true,9,15,6,41.92182,-87.64412
13191,5,15,true,5,12,7,41.92217,-87.63891
13084,5,15,true,5,5,0,41.92268,-87.69715
LP-,5,15,true,7,2,-5,41.92396,-87.63584
TA1307000001,5,15,true,9,6,-3,41.92535,-87.66581
TA1306000026,5,15,true,8,4,-4,41.92558,-87.65842
TA1306000016,5,15,true,10,5,-5,41.9256,-87.65371
TA1309000019,5,15,true,17,5,-12,41.92586,-87.63897
TA1309000058,5,15,true,20,19,-1,41.92591,-87.64927
TA1308000001,5,15,true,22,22,0,41.92627,-87.63086
15646,5,15,true,7,4,-3,41.92668,-87.6977
13124,5,15,true,2,5,3,41.92675,-87.63444
TA1309000023,5,15,true,6,12,6,41.9287,-87.65383
TA1307000113,5,15,true,3,5,2,41.92878,-87.66391
TA1309000061,5,15,true,9,4,-5,41.92915,-87.64909
TA1305000014,5,15,true,16,16,0,41.92956,-87.64313
TA1307000142,5,15,true,9,12,3,41.93125,-87.64432
13276,5,15,true,13,13,0,41.93132,-87.63874
13271,5,15,true,4,6,2,41.93192,-87.67784
TA1307000064,5,15,true,5,9,4,41.93222,-87.65864
TA1306000014,5,15,true,7,7,0,41.93242,-87.65271
TA1309000039,5,15,true,12,14,2,41.93258,-87.63642
13294,5,15,true,8,10,2,41.9326,-87.66595
TA1309000036,5,15,true,6,10,4,41.93313,-87.64776
13269,5,15,true,2,6,4,41.93609,-87.66983
TA1307000052,5,15,true,9,12,3,41.93628,-87.65266
TA1307000136,5,15,true,11,14,3,41.9365,-87.64755
TA1307000041,5,15,true,15,13,-2,41.93669,-87.63683
13137,5,15,true,18,12,-6,41.9376,-87.6441
TA1309000042,5,15,true,11,9,-2,41.93937,-87.66836
13229,5,15,true,5,3,-2,41.93946,-87.66376
TA1308000019,5,15,true,6,6,0,41.93973,-87.65886
13277,5,15,true,6,19,13,41.9401,-87.64546
TA1307000134,5,15,true,11,13,2,41.94016,-87.65303
TA1309000049,5,15,true,8,3,-5,41.94077,-87.63919
TA1307000138,5,15,true,11,10,-1,41.94334,-87.67094
13144,5,15,true,4,6,2,41.9434,-87.67964
TA1309000025,5,15,true,13,17,4,41.94368,-87.64894
13071,5,15,true,18,14,-4,41.94373,-87.66401
632,5,15,true,9,8,-1,41.94453,-87.6547
13278,5,15,true,16,9,-7,41.94553,-87.64644
13235,5,15,true,14,10,-4,41.94814,-87.66396
13325,5,15,true,11,14,3,41.94907,-87.64863
TA1307000126,5,15,true,8,14,6,41.94936,-87.65451
TA1307000150,5,15,true,11,20,9,41.94945,-87.64646
13319,5,15,true,6,4,-2,41.95069,-87.6687
TA1307000127,5,15,true,8,7,-1,41.9508,-87.65918
13323,5,15,true,8,5,-3,41.95282,-87.65
TA1309000043,5,15,true,6,9,3,41.95417,-87.66434
13063,5,15,true,9,15,6,41.95424,-87.65441
TA1308000022,5,15,true,5,9,4,41.95438,-87.64805
TA1307000149,5,15,true,5,4,-1,41.95467,-87.67392
13379,5,15,true,14,12,-2,41.95786,-87.6495
TA1309000018,5,15,true,5,9,4,41.95791,-87.67357
TA1309000027,5,15,true,3,6,3,41.9585,-87.65499
13389,5,15,true,5,7,2,41.961,-87.64958
KA1504000097,5,15,true,5,1,-4,41.96116,-87.71658
TA1307000144,5,15,true,5,1,-4,41.96142,-87.6762
KA1503000022,5,15,true,9,2,-7,41.96158,-87.66609
TA1307000107,5,15,true,8,6,-2,41.96164,-87.65464
TA1308000012,5,15,true,8,9,1,41.96398,-87.63818
13074,5,15,true,11,7,-4,41.96521,-87.6582
639,5,15,true,5,6,1,41.96584,-87.64538
TA1307000140,5,15,true,3,6,3,41.96643,-87.68865
TA1309000014,5,15,true,7,7,0,41.96709,-87.66744
TA1307000158,5,15,true,4,6,2,41.9671,-87.67904
TA1309000066,5,15,true,6,5,-1,41.9691,-87.67423
TA1309000041,5,15,true,4,7,3,41.96951,-87.65471
KA1504000171,5,15,true,2,5,3,41.97161,-87.65016
TA1309000035,5,15,true,5,6,1,41.97335,-87.66785
13108,5,15,true,5,10,5,41.97379,-87.65971
KA1504000149,5,15,true,6,3,-3,41.97562,-87.67945
KA1504000146,5,15,true,2,7,5,41.978,-87.66805
13109,5,15,true,3,6,3,41.97835,-87.65976
KA1504000152,5,15,true,11,10,-1,41.98403,-87.65231
15578,5,15,true,3,5,2,41.98405,-87.66027
KA1503000029,5,16,false,3,5,2,41.77364,-87.56747
15491,5,16,false,16,3,-13,41.78096,-87.57624
KA1503000014,5,16,false,5,3,-2,41.7851,-87.60108
TA1309000011,5,16,false,8,6,-2,41.78873,-87.60131
KA1503000074,5,16,false,14,4,-10,41.79174,-87.58395
TA1309000063,5,16,false,6,5,-1,41.79325,-87.5878
KA1504000076,5,16,false,5,4,-1,41.7943,-87.60145
TA1308000009,5,16,false,14,13,-1,41.79522,-87.58075
TA1307000164,5,16,false,5,3,-2,41.79527,-87.59647
KA1503000052,5,16,false,7,4,-3,41.79935,-87.60097
KA1503000059,5,16,false,4,8,4,41.79952,-87.58643
TA1309000037,5,16,false,6,12,6,41.79957,-87.59474
KA1503000007,5,16,false,2,5,3,41.80242,-87.58689
13398,5,16,false,3,6,3,41.80256,-87.59035
KA1503000004,5,16,false,4,5,1,41.83127,-87.6088
TA1307000048,5,16,false,9,4,-5,41.83855,-87.60821
TA1307000005,5,16,false,5,1,-4,41.84569,-87.6225
TA1305000004,5,16,false,5,2,-3,41.8514,-87.61884
13075,5,16,false,2,6,4,41.8531,-87.63192
15545,5,16,false,5,8,3,41.85627,-87.61334
13102,5,16,false,5,2,-3,41.85762,-87.61942
13150,5,16,false,2,6,4,41.85783,-87.62455
13164,5,16,false,6,2,-4,41.85818,-87.65648
13304,5,16,false,5,5,0,41.86126,-87.65659
TA1307000124,5,16,false,9,13,4,41.86411,-87.62372
TA1309000001,5,16,false,6,5,-1,41.86488,-87.64708
13029,5,16,false,10,4,-6,41.86531,-87.6179
13431,5,16,false,10,15,5,41.8661,-87.60728
WL-008,5,16,false,3,5,2,41.86712,-87.64108
TA1305000002,5,16,false,10,17,7,41.86721,-87.62597
15544,5,16,false,47,28,-19,41.86723,-87.61536
KA1706005007,5,16,false,4,6,2,41.86749,-87.63219
SL-005,5,16,false,39,15,-24,41.8679,-87.62304
13139,5,16,false,7,3,-4,41.86893,-87.65913
13160,5,16,false,6,2,-4,41.86947,-87.65548
TA1309000010,5,16,false,16,9,-7,41.87074,-87.62574
SL-009,5,16,false,8,5,-3,41.87081,-87.63121
TA1307000121,5,16,false,5,2,-3,41.87184,-87.64664
SL-008,5,16,false,13,13,0,41.87209,-87.62956
13332,5,16,false,8,5,-3,41.87219,-87.6615
SL-011,5,16,false,9,13,4,41.87256,-87.63356
623,5,16,false,16,15,-1,41.87272,-87.62399
SL-007,5,16,false,6,8,2,41.87404,-87.6277
SL-010,5,16,false,9,8,-1,41.87501,-87.63309
15541,5,16,false,40,23,-17,41.8758,-87.62086
TA1305000010,5,16,false,1,5,4,41.87623,-87.62444
TA1305000035,5,16,false,6,3,-3,41.87716,-87.62787
15539,5,16,false,7,3,-4,41.87763,-87.64405
13158,5,16,false,6,13,7,41.87764,-87.64957
13157,5,16,false,7,9,2,41.87773,-87.6548
TA1305000025,5,16,false,14,8,-6,41.87773,-87.63528
TA1309000002,5,16,false,15,10,-5,41.87784,-87.62408
TA1309000004,5,16,false,10,5,-5,41.87811,-87.63184
638,5,16,false,5,8,3,41.87827,-87.64078
13011,5,16,false,12,11,-1,41.87931,-87.63993
TA1309000008,5,16,false,8,4,-4,41.87933,-87.6355
TA1309000007,5,16,false,16,9,-7,41.88022,-87.63526
13156,5,16,false,6,12,6,41.88042,-87.65554
13300,5,16,false,83,95,12,41.88097,-87.61675
13008,5,16,false,47,60,13,41.88105,-87.62408
TA1305000006,5,16,false,13,15,2,41.88122,-87.6296
13056,5,16,false,7,11,4,41.88168,-87.63951
TA1307000120,5,16,false,21,24,3,41.88188,-87.64879
13341,5,16,false,14,9,-5,41.88208,-87.63985
13036,5,16,false,4,9,5,41.8821,-87.62513
TA1305000032,5,16,false,20,14,-6,41.88218,-87.64109
13409,5,16,false,5,8,3,41.8831,-87.6511
KA1503000072,5,16,false,6,2,-4,41.88317,-87.63693
WL-012,5,16,false,12,11,-1,41.88337,-87.6412
13053,5,16,false,15,16,1,41.88365,-87.64863
13001,5,16,false,18,8,-10,41.88397,-87.62459
18062,5,16,false,6,7,1,41.88412,-87.65427
TA1306000010,5,16,false,10,3,-7,41.88419,-87.62961
TA1305000030,5,16,false,16,3,-13,41.88459,-87.63178
15535,5,16,false,11,10,-1,41.8846,-87.64455
TA1305000029,5,16,false,13,12,-1,41.88466,-87.62787
13263,5,16,false,35,8,-27,41.88467,-87.61952
TA1306000015,5,16,false,8,15,7,41.88549,-87.65232
13021,5,16,false,9,17,8,41.88559,-87.64184
TA1307000111,5,16,false,9,2,-7,41.88582,-87.63548
13073,5,16,false,12,3,-9,41.88592,-87.66717
KA17018054,5,16,false,8,3,-5,41.88595,-87.67701
KA1503000012,5,16,false,17,6,-11,41.88599,-87.63089
TA1305000011,5,16,false,33,22,-11,41.886,-87.62418
15534,5,16,false,6,9,3,41.88627,-87.61749
13197,5,16,false,7,4,-3,41.8866,-87.65816
TA1308000029,5,16,false,6,8,2,41.88673,-87.62225
TA1307000131,5,16,false,8,15,7,41.88688,-87.62606
KA1503000064,5,16,false,18,34,16,41.88697,-87.61281
TA1305000022,5,16,false,7,11,4,41.88817,-87.63656
TA1306000003,5,16,false,5,2,-3,41.88867,-87.64442
KA1503000043,5,16,false,21,19,-2,41.88918,-87.63851
13050,5,16,false,13,15,2,41.88919,-87.62775
TA1307000151,5,16,false,24,12,-12,41.88993,-87.63427
636,5,16,false,1,9,8,41.88997,-87.63662
KA1503000044,5,16,false,9,10,1,41.89018,-87.6262
13427,5,16,false,12,18,6,41.89054,-87.62205
13430,5,16,false,18,26,8,41.89077,-87.63169
TA1306000013,5,16,false,27,31,4,41.89083,-87.61852
RN-,5,16,false,11,17,6,41.89102,-87.63546
13434,5,16,false,7,6,-1,41.89108,-87.66663
TA1308000006,5,16,false,7,5,-2,41.89128,-87.67686
TA1307000117,5,16,false,19,42,23,41.89144,-87.62675
13033,5,16,false,14,13,-1,41.8916,-87.64835
13194,5,16,false,3,5,2,41.8918,-87.65878
TA1305000003,5,16,false,27,34,7,41.89187,-87.62061
13022,5,16,false,175,194,19,41.89227,-87.61205
TA1306000029,5,16,false,23,16,-7,41.89256,-87.61449
13265,5,16,false,12,4,-8,41.89383,-87.64172
13045,5,16,false,28,15,-13,41.89403,-87.62931
13016,5,16,false,13,10,-3,41.89431,-87.62277
KA1503000041,5,16,false,19,15,-4,41.89452,-87.61798
13196,5,16,false,5,1,-4,41.89455,-87.65345
TA1307000062,5,16,false,6,7,1,41.89466,-87.63839
TA1306000012,5,16,false,17,28,11,41.89475,-87.63438
KP1705001026,5,16,false,7,7,0,41.89483,-87.6323
18058,5,16,false,5,4,-1,41.8955,-87.68201
637,5,16,false,7,10,3,41.89563,-87.67209
13132,5,16,false,10,9,-1,41.89573,-87.67718
15530,5,16,false,16,20,4,41.89575,-87.62596
18003,5,16,false,5,7,2,41.89575,-87.62011
13247,5,16,false,6,3,-3,41.89597,-87.66775
TA1305000020,5,16,false,9,13,4,41.89636,-87.65406
13289,5,16,false,9,6,-3,41.89638,-87.661
13303,5,16,false,6,13,7,41.89672,-87.63088
13017,5,16,false,13,10,-3,41.89676,-87.6357
13338,5,16,false,9,13,4,41.89697,-87.62173
TA1307000061,5,16,false,9,16,7,41.89745,-87.62873
13034,5,16,false,17,12,-5,41.89754,-87.62352
TA1306000009,5,16,false,13,3,-10,41.89772,-87.64299
620,5,16,false,4,5,1,41.89817,-87.63754
KA1504000103,5,16,false,5,5,0,41.89842,-87.68659
15529,5,16,false,16,8,-8,41.89858,-87.62206
TA1307000128,5,16,false,21,15,-6,41.89896,-87.6299
657,5,16,false,6,3,-3,41.89918,-87.6722
TA1306000011,5,16,false,7,2,-5,41.89994,-87.63443
KA1504000116,5,16,false,8,2,-6,41.90023,-87.64299
13290,5,16,false,6,7,1,41.90069,-87.66259
13042,5,16,false,76,46,-30,41.90097,-87.62377
KA1504000133,5,16,false,10,18,8,41.90234,-87.62773
13241,5,16,false,7,1,-6,41.9029,-87.68731
TA1306000006,5,16,false,5,1,-4,41.90292,-87.63772
TA1307000039,5,16,false,26,33,7,41.90294,-87.63137
TA1305000034,5,16,false,10,6,-4,41.90313,-87.67391
KA1504000135,5,16,false,25,28,3,41.90319,-87.63439
13136,5,16,false,5,9,4,41.90326,-87.67845
13061,5,16,false,12,9,-3,41.90342,-87.66779
KA1504000079,5,16,false,10,9,-1,41.9035,-87.64334
TA1308000049,5,16,false,23,24,1,41.90672,-87.6349
KA1504000134,5,16,false,13,13,0,41.90687,-87.6262
13224,5,16,false,10,4,-6,41.90706,-87.66725
13221,5,16,false,15,10,-5,41.90765,-87.67254
TA1309000024,5,16,false,16,16,0,41.908,-87.63152
TA1305000041,5,16,false,11,19,8,41.9094,-87.67769
331,5,16,false,14,11,-3,41.90965,-87.64812
TA1305000037,5,16,false,8,13,5,41.91018,-87.67003
TA1306000008,5,16,false,8,6,-2,41.9102,-87.6435
13258,5,16,false,2,6,4,41.91043,-87.69718
13257,5,16,false,6,3,-3,41.91054,-87.68956
13154,5,16,false,12,7,-5,41.91054,-87.65312
13058,5,16,false,8,6,-2,41.91059,-87.64942
TA1307000038,5,16,false,11,10,-1,41.91138,-87.63868
LF-005,5,16,false,63,70,7,41.91172,-87.62681
13128,5,16,false,6,7,1,41.91197,-87.63197
TA1308000050,5,16,false,25,29,4,41.91211,-87.6347
13243,5,16,false,9,11,2,41.91262,-87.6814
TA1306000032,5,16,false,11,16,5,41.9137,-87.65285
TA1307000166,5,16,false,6,7,1,41.91386,-87.64877
15655,5,16,false,6,1,-5,41.91401,-87.70514
18067,5,16,false,5,2,-3,41.9146,-87.66796
13179,5,16,false,42,25,-17,41.9157,-87.63461
13133,5,16,false,18,7,-11,41.91598,-87.67733
TA1305000039,5,16,false,11,10,-1,41.9163,-87.66749
15651,5,16,false,14,10,-4,41.91752,-87.70181
TA1309000006,5,16,false,6,3,-3,41.91809,-87.64375
TA1307000163,5,16,false,8,11,3,41.91821,-87.65696
13146,5,16,false,23,34,11,41.91831,-87.63629
13059,5,16,false,13,14,1,41.91845,-87.65222
13259,5,16,false,6,1,-5,41.91852,-87.69744
13192,5,16,false,13,14,1,41.91995,-87.64884
13288,5,16,false,5,8,3,41.92008,-87.67788
TA1309000030,5,16,false,10,12,2,41.92077,-87.66372
TA1309000033,5,16,false,13,15,2,41.92158,-87.65381
13193,5,16,false,14,20,6,41.92182,-87.64412
13191,5,16,false,8,10,2,41.92217,-87.63891
13084,5,16,false,7,5,-2,41.92268,-87.69715
LP-,5,16,false,21,4,-17,41.92396,-87.63584
KA1504000140,5,16,false,6,3,-3,41.92409,-87.67646
KA1504000090,5,16,false,4,6,2,41.92483,-87.7145
TA1307000001,5,16,false,8,3,-5,41.92535,-87.66581
TA1306000026,5,16,false,5,9,4,41.92558,-87.65842
TA1306000016,5,16,false,13,9,-4,41.9256,-87.65371
TA1309000019,5,16,false,15,26,11,41.92586,-87.63897
TA1309000058,5,16,false,13,29,16,41.92591,-87.64927
TA1308000001,5,16,false,51,34,-17,41.92627,-87.63086
15646,5,16,false,5,2,-3,41.92668,-87.6977
13124,5,16,false,8,11,3,41.92675,-87.63444
TA1309000023,5,16,false,6,8,2,41.9287,-87.65383
TA1307000113,5,16,false,13,7,-6,41.92878,-87.66391
13296,5,16,false,8,9,1,41.92883,-87.66852
TA1309000059,5,16,false,5,8,3,41.92889,-87.65898
TA1309000061,5,16,false,8,12,4,41.92915,-87.64909
TA1308000031,5,16,false,5,6,1,41.92946,-87.68417
TA1305000014,5,16,false,23,18,-5,41.92956,-87.64313
13085,5,16,false,7,8,1,41.92958,-87.70789
TA1307000142,5,16,false,14,18,4,41.93125,-87.64432
13276,5,16,false,15,18,3,41.93132,-87.63874
TA1307000064,5,16,false,14,8,-6,41.93222,-87.65864
TA1306000014,5,16,false,10,25,15,41.93242,-87.65271
TA1309000039,5,16,false,17,21,4,41.93258,-87.63642
13294,5,16,false,8,8,0,41.9326,-87.66595
TA1309000036,5,16,false,10,5,-5,41.93313,-87.64776
TA1307000006,5,16,false,5,10,5,41.93571,-87.6636
13268,5,16,false,4,6,2,41.93588,-87.67843
TA1307000052,5,16,false,12,11,-1,41.93628,-87.65266
TA1307000136,5,16,false,10,23,13,41.9365,-87.64755
TA1307000041,5,16,false,7,22,15,41.93669,-87.63683
13137,5,16,false,12,28,16,41.9376,-87.6441
15642,5,16,false,1,5,4,41.93843,-87.69801
TA1309000042,5,16,false,6,3,-3,41.93937,-87.66836
13229,5,16,false,3,5,2,41.93946,-87.66376
TA1308000019,5,16,false,11,8,-3,41.93973,-87.65886
13277,5,16,false,13,11,-2,41.9401,-87.64546
TA1307000134,5,16,false,17,14,-3,41.94016,-87.65303
13143,5,16,false,5,3,-2,41.94059,-87.67853
TA1309000049,5,16,false,14,15,1,41.94077,-87.63919
TA1307000138,5,16,false,10,7,-3,41.94334,-87.67094
13144,5,16,false,7,1,-6,41.9434,-87.67964
TA1309000025,5,16,false,12,16,4,41.94368,-87.64894
13071,5,16,false,21,13,-8,41.94373,-87.66401
632,5,16,false,36,19,-17,41.94453,-87.6547
13278,5,16,false,18,13,-5,41.94553,-87.64644
13235,5,16,false,12,10,-2,41.94814,-87.66396
13325,5,16,false,17,16,-1,41.94907,-87.64863
TA1307000126,5,16,false,45,24,-21,41.94936,-87.65451
TA1307000150,5,16,false,19,13,-6,41.94945,-87.64646
13319,5,16,false,12,8,-4,41.95069,-87.6687
TA1307000127,5,16,false,24,20,-4,41.9508,-87.65918
13323,5,16,false,8,10,2,41.95282,-87.65
TA1309000043,5,16,false,4,6,2,41.95417,-87.66434
13063,5,16,false,9,19,10,41.95424,-87.65441
KA1504000158,5,16,false,5,6,1,41.95432,-87.68607
TA1308000022,5,16,false,8,7,-1,41.95438,-87.64805
TA1307000149,5,16,false,5,4,-1,41.95467,-87.67392
13379,5,16,false,8,5,-3,41.95786,-87.6495
TA1309000018,5,16,false,1,5,4,41.95791,-87.67357
TA1309000027,5,16,false,5,5,0,41.9585,-87.65499
13389,5,16,false,10,7,-3,41.961,-87.64958
TA1307000107,5,16,false,6,12,6,41.96164,-87.65464
TA1308000012,5,16,false,34,11,-23,41.96398,-87.63818
639,5,16,false,17,8,-9,41.96584,-87.64538
TA1309000014,5,16,false,6,9,3,41.96709,-87.66744
TA1307000119,5,16,false,11,9,-2,41.96796,-87.65
TA1309000066,5,16,false,7,4,-3,41.9691,-87.67423
KA1504000171,5,16,false,6,3,-3,41.97161,-87.65016
TA1309000035,5,16,false,7,5,-2,41.97335,-87.66785
13108,5,16,false,5,7,2,41.97379,-87.65971
KA1504000149,5,16,false,1,8,7,41.97562,-87.67945
KA1504000146,5,16,false,4,5,1,41.978,-87.66805
KA1504000151,5,16,false,3,5,2,41.98359,-87.66916
KA1504000152,5,16,false,16,14,-2,41.98403,-87.65231
15578,5,16,false,5,3,-2,41.98405,-87.66027
15575,5,16,false,2,8,6,41.98975,-87.66014
RP-009,5,16,false,2,8,6,42.00107,-87.66122
660,5,16,false,2,6,4,42.00458,-87.66143
596,5,16,false,5,4,-1,42.04822,-87.68348
E006,5,16,false,1,5,4,42.06367,-87.69871
KA1503000014,5,16,true,8,9,1,41.7851,-87.60108
TA1309000011,5,16,true,7,4,-3,41.78873,-87.60131
KA1503000071,5,16,true,6,5,-1,41.79148,-87.59988
KA1504000076,5,16,true,7,3,-4,41.7943,-87.60145
TA1308000009,5,16,true,12,18,6,41.79522,-87.58075
TA1307000164,5,16,true,6,4,-2,41.79527,-87.59647
KA1503000052,5,16,true,2,6,4,41.79935,-87.60097
KA1503000059,5,16,true,1,7,6,41.79952,-87.58643
TA1309000037,5,16,true,9,3,-6,41.79957,-87.59474
KA1503000007,5,16,true,7,6,-1,41.80242,-87.58689
13398,5,16,true,5,3,-2,41.80256,-87.59035
13216,5,16,true,7,7,0,41.83473,-87.62581
13217,5,16,true,4,9,5,41.83488,-87.61792
TA1309000055,5,16,true,5,6,1,41.8382,-87.64514
TA1307000048,5,16,true,4,10,6,41.83855,-87.60821
TA1307000139,5,16,true,13,5,-8,41.84205,-87.61698
TA1305000001,5,16,true,2,5,3,41.85262,-87.6265
13075,5,16,true,3,6,3,41.8531,-87.63192
15545,5,16,true,19,15,-4,41.85627,-87.61334
13102,5,16,true,9,11,2,41.85762,-87.61942
13150,5,16,true,4,6,2,41.85783,-87.62455
TA1307000159,5,16,true,2,8,6,41.8579,-87.6687
13164,5,16,true,5,8,3,41.85818,-87.65648
SL-012,5,16,true,9,8,-1,41.86038,-87.62581
TA1306000002,5,16,true,8,5,-3,41.86238,-87.65108
TA1307000124,5,16,true,9,9,0,41.86411,-87.62372
13431,5,16,true,8,9,1,41.8661,-87.60728
WL-008,5,16,true,7,6,-1,41.86712,-87.64108
TA1305000002,5,16,true,18,22,4,41.86721,-87.62597
TA1305000017,5,16,true,4,5,1,41.86734,-87.64863
KA1706005007,5,16,true,4,8,4,41.86749,-87.63219
SL-005,5,16,true,19,18,-1,41.8679,-87.62304
644,5,16,true,6,2,-4,41.86859,-87.68625
13139,5,16,true,5,4,-1,41.86893,-87.65913
13285,5,16,true,21,6,-15,41.86928,-87.67372
13160,5,16,true,4,7,3,41.86947,-87.65548
15550,5,16,true,2,5,3,41.87024,-87.63947
TA1309000010,5,16,true,10,6,-4,41.87074,-87.62574
SL-009,5,16,true,7,3,-4,41.87081,-87.63121
TA1309000064,5,16,true,30,4,-26,41.87127,-87.67369
TA1307000130,5,16,true,2,5,3,41.87178,-87.65103
TA1307000121,5,16,true,4,5,1,41.87184,-87.64664
SL-008,5,16,true,24,19,-5,41.87209,-87.62956
13332,5,16,true,16,11,-5,41.87219,-87.6615
SL-011,5,16,true,6,14,8,41.87256,-87.63356
623,5,16,true,7,4,-3,41.87272,-87.62399
KA1504000104,5,16,true,21,3,-18,41.87296,-87.66912
SL-007,5,16,true,5,6,1,41.87404,-87.6277
SL-010,5,16,true,7,12,5,41.87501,-87.63309
TA1305000009,5,16,true,9,6,-3,41.87593,-87.63068
624,5,16,true,9,7,-2,41.87626,-87.62923
TA1305000035,5,16,true,9,4,-5,41.87716,-87.62787
13138,5,16,true,5,7,2,41.87723,-87.63941
15539,5,16,true,11,2,-9,41.87763,-87.64405
13158,5,16,true,19,25,6,41.87764,-87.64957
13157,5,16,true,14,10,-4,41.87773,-87.6548
TA1305000025,5,16,true,18,10,-8,41.87773,-87.63528
TA1309000002,5,16,true,5,5,0,41.87784,-87.62408
13206,5,16,true,9,5,-4,41.87794,-87.66201
TA1309000004,5,16,true,27,8,-19,41.87811,-87.63184
638,5,16,true,19,10,-9,41.87827,-87.64078
TA1305000005,5,16,true,10,3,-7,41.87924,-87.62975
13011,5,16,true,16,29,13,41.87931,-87.63993
KA1503000034,5,16,true,12,2,-10,41.87938,-87.63197
KA1503000015,5,16,true,15,7,-8,41.87948,-87.6257
TA1309000007,5,16,true,43,3,-40,41.88022,-87.63526
WL-011,5,16,true,9,4,-5,41.88034,-87.64273
13156,5,16,true,6,12,6,41.88042,-87.65554
13300,5,16,true,11,8,-3,41.88097,-87.61675
13008,5,16,true,9,8,-1,41.88105,-87.62408
TA1305000006,5,16,true,35,13,-22,41.88122,-87.6296
13056,5,16,true,15,8,-7,41.88168,-87.63951
TA1307000120,5,16,true,18,25,7,41.88188,-87.64879
13341,5,16,true,15,8,-7,41.88208,-87.63985
TA1305000032,5,16,true,20,39,19,41.88218,-87.64109
13006,5,16,true,11,9,-2,41.88268,-87.63252
13353,5,16,true,9,10,1,41.88283,-87.6612
13409,5,16,true,10,9,-1,41.8831,-87.6511
KA1503000072,5,16,true,7,10,3,41.88317,-87.63693
WL-012,5,16,true,22,37,15,41.88337,-87.6412
13053,5,16,true,17,17,0,41.88365,-87.64863
13001,5,16,true,13,14,1,41.88397,-87.62459
18062,5,16,true,6,14,8,41.88412,-87.65427
TA1306000010,5,16,true,33,11,-22,41.88419,-87.62961
TA1305000030,5,16,true,24,11,-13,41.88459,-87.63178
15535,5,16,true,16,13,-3,41.8846,-87.64455
TA1305000029,5,16,true,15,15,0,41.88466,-87.62787
13263,5,16,true,24,18,-6,41.88467,-87.61952
TA1306000015,5,16,true,20,17,-3,41.88549,-87.65232
13021,5,16,true,19,17,-2,41.88559,-87.64184
TA1307000111,5,16,true,21,8,-13,41.88582,-87.63548
KA1503000012,5,16,true,22,10,-12,41.88599,-87.63089
TA1305000011,5,16,true,23,14,-9,41.886,-87.62418
15534,5,16,true,8,12,4,41.88627,-87.61749
13197,5,16,true,4,7,3,41.8866,-87.65816
TA1308000029,5,16,true,7,2,-5,41.88673,-87.62225
TA1307000131,5,16,true,15,7,-8,41.88688,-87.62606
KA1503000064,5,16,true,15,21,6,41.88697,-87.61281
TA1305000022,5,16,true,16,9,-7,41.88817,-87.63656
TA1306000003,5,16,true,20,20,0,41.88867,-87.64442
KA1503000043,5,16,true,26,27,1,41.88918,-87.63851
13050,5,16,true,21,8,-13,41.88919,-87.62775
15664,5,16,true,3,8,5,41.8895,-87.68821
13432,5,16,true,10,4,-6,41.88989,-87.67149
TA1307000151,5,16,true,24,23,-1,41.88993,-87.63427
636,5,16,true,7,9,2,41.88997,-87.63662
KA1503000044,5,16,true,15,9,-6,41.89018,-87.6262
13427,5,16,true,13,12,-1,41.89054,-87.62205
13430,5,16,true,19,13,-6,41.89077,-87.63169
TA1306000013,5,16,true,15,19,4,41.89083,-87.61852
RN-,5,16,true,17,14,-3,41.89102,-87.63546
TA1308000006,5,16,true,6,4,-2,41.89128,-87.67686
TA1307000117,5,16,true,28,22,-6,41.89144,-87.62675
13033,5,16,true,19,22,3,41.8916,-87.64835
13194,5,16,true,8,11,3,41.8918,-87.65878
TA1305000003,5,16,true,13,9,-4,41.89187,-87.62061
13022,5,16,true,22,17,-5,41.89227,-87.61205
TA1306000029,5,16,true,12,11,-1,41.89256,-87.61449
13265,5,16,true,20,18,-2,41.89383,-87.64172
13045,5,16,true,16,27,11,41.89403,-87.62931
13016,5,16,true,38,11,-27,41.89431,-87.62277
KA1503000041,5,16,true,29,12,-17,41.89452,-87.61798
13196,5,16,true,8,3,-5,41.89455,-87.65345
TA1307000062,5,16,true,9,10,1,41.89466,-87.63839
TA1306000012,5,16,true,31,41,10,41.89475,-87.63438
KP1705001026,5,16,true,7,11,4,41.89483,-87.6323
637,5,16,true,9,5,-4,41.89563,-87.67209
13132,5,16,true,9,14,5,41.89573,-87.67718
15530,5,16,true,16,8,-8,41.89575,-87.62596
18003,5,16,true,8,4,-4,41.89575,-87.62011
13247,5,16,true,8,12,4,41.89597,-87.66775
TA1305000020,5,16,true,6,13,7,41.89636,-87.65406
13289,5,16,true,11,11,0,41.89638,-87.661
13303,5,16,true,11,13,2,41.89672,-87.63088
13017,5,16,true,23,15,-8,41.89676,-87.6357
13338,5,16,true,16,8,-8,41.89697,-87.62173
TA1307000061,5,16,true,11,4,-7,41.89745,-87.62873
13034,5,16,true,10,9,-1,41.89754,-87.62352
TA1306000009,5,16,true,30,14,-16,41.89772,-87.64299
620,5,16,true,17,10,-7,41.89817,-87.63754
KA1504000103,5,16,true,4,5,1,41.89842,-87.68659
15529,5,16,true,17,17,0,41.89858,-87.62206
TA1307000128,5,16,true,21,21,0,41.89896,-87.6299
657,5,16,true,1,5,4,41.89918,-87.6722
13248,5,16,true,3,7,4,41.89964,-87.66788
TA1306000011,5,16,true,10,9,-1,41.89994,-87.63443
KA1504000116,5,16,true,13,11,-2,41.90023,-87.64299
17660,5,16,true,6,3,-3,41.90036,-87.69671
13290,5,16,true,4,10,6,41.90069,-87.66259
13042,5,16,true,14,14,0,41.90097,-87.62377
KA1504000133,5,16,true,20,10,-10,41.90234,-87.62773
TA1306000006,5,16,true,3,6,3,41.90292,-87.63772
TA1307000039,5,16,true,29,38,9,41.90294,-87.63137
TA1305000034,5,16,true,11,10,-1,41.90313,-87.67391
KA1504000135,5,16,true,16,39,23,41.90319,-87.63439
13136,5,16,true,5,9,4,41.90326,-87.67845
13061,5,16,true,9,13,4,41.90342,-87.66779
KA1504000079,5,16,true,17,14,-3,41.9035,-87.64334
TA1307000115,5,16,true,10,15,5,41.9046,-87.64056
TA1308000049,5,16,true,30,20,-10,41.90672,-87.6349
KA1504000134,5,16,true,10,9,-1,41.90687,-87.6262
13224,5,16,true,13,8,-5,41.90706,-87.66725
13221,5,16,true,10,12,2,41.90765,-87.67254
TA1309000024,5,16,true,15,25,10,41.908,-87.63152
TA1305000041,5,16,true,14,8,-6,41.9094,-87.67769
331,5,16,true,17,16,-1,41.90965,-87.64812
TA1305000037,5,16,true,5,9,4,41.91018,-87.67003
TA1306000008,5,16,true,6,7,1,41.9102,-87.6435
13258,5,16,true,3,6,3,41.91043,-87.69718
13154,5,16,true,8,15,7,41.91054,-87.65312
13058,5,16,true,9,5,-4,41.91059,-87.64942
TA1307000038,5,16,true,10,11,1,41.91138,-87.63868
LF-005,5,16,true,26,20,-6,41.91172,-87.62681
13128,5,16,true,11,10,-1,41.91197,-87.63197
TA1308000050,5,16,true,37,51,14,41.91211,-87.6347
13243,5,16,true,4,11,7,41.91262,-87.6814
TA1306000032,5,16,true,14,8,-6,41.9137,-87.65285
TA1307000166,5,16,true,8,13,5,41.91386,-87.64877
18067,5,16,true,4,5,1,41.9146,-87.66796
TA1306000007,5,16,true,7,6,-1,41.91469,-87.64333
13179,5,16,true,16,23,7,41.9157,-87.63461
13133,5,16,true,6,10,4,41.91598,-87.67733
TA1305000039,5,16,true,7,10,3,41.9163,-87.66749
15651,5,16,true,5,9,4,41.91752,-87.70181
TA1309000029,5,16,true,6,6,0,41.9178,-87.68245
TA1309000006,5,16,true,8,15,7,41.91809,-87.64375
TA1307000163,5,16,true,10,5,-5,41.91821,-87.65696
13146,5,16,true,21,16,-5,41.91831,-87.63629
13059,5,16,true,19,17,-2,41.91845,-87.65222
13192,5,16,true,7,21,14,41.91995,-87.64884
TA1309000030,5,16,true,6,7,1,41.92077,-87.66372
13292,5,16,true,5,1,-4,41.92152,-87.70733
TA1309000033,5,16,true,17,20,3,41.92158,-87.65381
13193,5,16,true,18,22,4,41.92182,-87.64412
13191,5,16,true,19,15,-4,41.92217,-87.63891
13084,5,16,true,7,6,-1,41.92268,-87.69715
LP-,5,16,true,7,9,2,41.92396,-87.63584
KA1504000140,5,16,true,6,1,-5,41.92409,-87.67646
15648,5,16,true,5,4,-1,41.92464,-87.68931
TA1307000001,5,16,true,12,8,-4,41.92535,-87.66581
TA1306000026,5,16,true,11,4,-7,41.92558,-87.65842
TA1306000016,5,16,true,16,8,-8,41.9256,-87.65371
TA1309000019,5,16,true,18,22,4,41.92586,-87.63897
TA1309000058,5,16,true,18,21,3,41.92591,-87.64927
TA1308000001,5,16,true,14,19,5,41.92627,-87.63086
15646,5,16,true,5,2,-3,41.92668,-87.6977
13124,5,16,true,7,5,-2,41.92675,-87.63444
TA1309000023,5,16,true,9,11,2,41.9287,-87.65383
TA1307000113,5,16,true,9,11,2,41.92878,-87.66391
13296,5,16,true,7,7,0,41.92883,-87.66852
TA1309000059,5,16,true,7,6,-1,41.92889,-87.65898
TA1309000061,5,16,true,14,11,-3,41.92915,-87.64909
TA1305000014,5,16,true,8,16,8,41.92956,-87.64313
TA1307000142,5,16,true,16,21,5,41.93125,-87.64432
13276,5,16,true,10,14,4,41.93132,-87.63874
TA1307000064,5,16,true,14,6,-8,41.93222,-87.65864
TA1306000014,5,16,true,12,18,6,41.93242,-87.65271
TA1309000039,5,16,true,12,19,7,41.93258,-87.63642
13294,5,16,true,8,8,0,41.9326,-87.66595
TA1309000036,5,16,true,10,12,2,41.93313,-87.64776
TA1307000006,5,16,true,8,10,2,41.93571,-87.6636
13269,5,16,true,6,4,-2,41.93609,-87.66983
TA1307000052,5,16,true,7,9,2,41.93628,-87.65266
TA1307000136,5,16,true,14,17,3,41.9365,-87.64755
TA1307000041,5,16,true,16,15,-1,41.93669,-87.63683
13137,5,16,true,19,24,5,41.9376,-87.6441
TA1309000042,5,16,true,8,16,8,41.93937,-87.66836
13229,5,16,true,8,5,-3,41.93946,-87.66376
TA1308000019,5,16,true,11,12,1,41.93973,-87.65886
13277,5,16,true,14,13,-1,41.9401,-87.64546
TA1307000134,5,16,true,15,15,0,41.94016,-87.65303
TA1309000049,5,16,true,12,13,1,41.94077,-87.63919
15634,5,16,true,6,3,-3,41.94304,-87.68729
TA1307000138,5,16,true,7,11,4,41.94334,-87.67094
13144,5,16,true,1,7,6,41.9434,-87.67964
TA1309000025,5,16,true,22,19,-3,41.94368,-87.64894
13071,5,16,true,17,16,-1,41.94373,-87.66401
632,5,16,true,14,13,-1,41.94453,-87.6547
13278,5,16,true,15,20,5,41.94553,-87.64644
15632,5,16,true,5,1,-4,41.94664,-87.69463
13235,5,16,true,25,15,-10,41.94814,-87.66396
13325,5,16,true,19,18,-1,41.94907,-87.64863
TA1307000126,5,16,true,11,21,10,41.94936,-87.65451
TA1307000150,5,16,true,19,19,0,41.94945,-87.64646
13319,5,16,true,6,7,1,41.95069,-87.6687
TA1307000127,5,16,true,18,11,-7,41.9508,-87.65918
13323,5,16,true,13,11,-2,41.95282,-87.65
TA1309000043,5,16,true,7,4,-3,41.95417,-87.66434
13063,5,16,true,13,15,2,41.95424,-87.65441
KA1504000158,5,16,true,2,6,4,41.95432,-87.68607
TA1308000022,5,16,true,13,11,-2,41.95438,-87.64805
TA1307000149,5,16,true,9,5,-4,41.95467,-87.67392
TA1309000026,5,16,true,8,4,-4,41.95601,-87.6802
TA1308000047,5,16,true,8,4,-4,41.95709,-87.6642
13379,5,16,true,10,10,0,41.95786,-87.6495
TA1309000018,5,16,true,5,3,-2,41.95791,-87.67357
TA1309000027,5,16,true,10,8,-2,41.9585,-87.65499
13389,5,16,true,9,9,0,41.961,-87.64958
TA1307000144,5,16,true,5,2,-3,41.96142,-87.6762
KA1503000022,5,16,true,5,7,2,41.96158,-87.66609
TA1307000107,5,16,true,13,14,1,41.96164,-87.65464
TA1308000012,5,16,true,9,14,5,41.96398,-87.63818
13074,5,16,true,6,6,0,41.96521,-87.6582
639,5,16,true,8,8,0,41.96584,-87.64538
TA1307000140,5,16,true,4,5,1,41.96643,-87.68865
TA1309000014,5,16,true,9,10,1,41.96709,-87.66744
TA1307000158,5,16,true,3,5,2,41.9671,-87.67904
TA1307000119,5,16,true,6,3,-3,41.96796,-87.65
TA1308000021,5,16,true,6,7,1,41.96883,-87.65765
TA1309000015,5,16,true,5,2,-3,41.96889,-87.68401
TA1309000066,5,16,true,10,8,-2,41.9691,-87.67423
TA1309000041,5,16,true,8,5,-3,41.96951,-87.65471
KA1504000171,5,16,true,7,10,3,41.97161,-87.65016
TA1309000035,5,16,true,7,7,0,41.97335,-87.66785
13108,5,16,true,5,7,2,41.97379,-87.65971
KA1504000146,5,16,true,7,9,2,41.978,-87.66805
13109,5,16,true,6,7,1,41.97835,-87.65976
KA1504000151,5,16,true,5,5,0,41.98359,-87.66916
KA1504000152,5,16,true,6,8,2,41.98403,-87.65231
15578,5,16,true,7,5,-2,41.98405,-87.66027
15575,5,16,true,6,3,-3,41.98975,-87.66014
15571,5,16,true,3,7,4,41.99478,-87.66028
604,5,16,true,5,2,-3,42.05824,-87.67744
15491,5,17,false,3,10,7,41.78096,-87.57624
KA1503000074,5,17,false,9,2,-7,41.79174,-87.58395
TA1308000009,5,17,false,15,19,4,41.79522,-87.58075
KA1503000059,5,17,false,15,8,-7,41.79952,-87.58643
TA1309000037,5,17,false,7,4,-3,41.79957,-87.59474
KA1503000007,5,17,false,9,1,-8,41.80242,-87.58689
13217,5,17,false,5,2,-3,41.83488,-87.61792
13215,5,17,false,6,2,-4,41.83634,-87.6135
TA1307000048,5,17,false,6,8,2,41.83855,-87.60821
TA1307000005,5,17,false,1,5,4,41.84569,-87.6225
TA1305000004,5,17,false,5,1,-4,41.8514,-87.61884
13075,5,17,false,5,4,-1,41.8531,-87.63192
15545,5,17,false,10,13,3,41.85627,-87.61334
SL-006,5,17,false,4,12,8,41.8568,-87.63387
13102,5,17,false,6,2,-4,41.85762,-87.61942
13150,5,17,false,9,10,1,41.85783,-87.62455
TA1307000159,5,17,false,1,5,4,41.8579,-87.6687
13163,5,17,false,10,2,-8,41.85808,-87.65108
SL-012,5,17,false,10,2,-8,41.86038,-87.62581
TA1307000124,5,17,false,11,6,-5,41.86411,-87.62372
TA1309000001,5,17,false,8,14,6,41.86488,-87.64708
13029,5,17,false,13,11,-2,41.86531,-87.6179
13431,5,17,false,31,27,-4,41.8661,-87.60728
WL-008,5,17,false,2,5,3,41.86712,-87.64108
TA1305000002,5,17,false,17,15,-2,41.86721,-87.62597
15544,5,17,false,15,20,5,41.86723,-87.61536
SL-005,5,17,false,34,34,0,41.8679,-87.62304
13139,5,17,false,5,1,-4,41.86893,-87.65913
13160,5,17,false,3,11,8,41.86947,-87.65548
TA1309000010,5,17,false,15,6,-9,41.87074,-87.62574
SL-009,5,17,false,5,11,6,41.87081,-87.63121
SL-008,5,17,false,21,14,-7,41.87209,-87.62956
SL-011,5,17,false,21,10,-11,41.87256,-87.63356
623,5,17,false,19,27,8,41.87272,-87.62399
KA1504000104,5,17,false,5,1,-4,41.87296,-87.66912
SL-007,5,17,false,9,5,-4,41.87404,-87.6277
SL-010,5,17,false,7,6,-1,41.87501,-87.63309
15541,5,17,false,25,20,-5,41.8758,-87.62086
TA1305000010,5,17,false,5,3,-2,41.87623,-87.62444
624,5,17,false,5,5,0,41.87626,-87.62923
13138,5,17,false,2,6,4,41.87723,-87.63941
15539,5,17,false,5,6,1,41.87763,-87.64405
13158,5,17,false,19,8,-11,41.87764,-87.64957
13157,5,17,false,9,6,-3,41.87773,-87.6548
TA1305000025,5,17,false,19,9,-10,41.87773,-87.63528
TA1309000002,5,17,false,9,5,-4,41.87784,-87.62408
TA1309000004,5,17,false,14,8,-6,41.87811,-87.63184
638,5,17,false,4,8,4,41.87827,-87.64078
TA1305000005,5,17,false,6,8,2,41.87924,-87.62975
13011,5,17,false,20,10,-10,41.87931,-87.63993
TA1309000008,5,17,false,7,9,2,41.87933,-87.6355
KA1503000015,5,17,false,5,6,1,41.87948,-87.6257
TA1309000007,5,17,false,14,6,-8,41.88022,-87.63526
WL-011,5,17,false,3,6,3,41.88034,-87.64273
13156,5,17,false,20,23,3,41.88042,-87.65554
13300,5,17,false,59,71,12,41.88097,-87.61675
13008,5,17,false,90,54,-36,41.88105,-87.62408
TA1305000006,5,17,false,14,11,-3,41.88122,-87.6296
13056,5,17,false,12,2,-10,41.88168,-87.63951
TA1307000120,5,17,false,24,29,5,41.88188,-87.64879
13341,5,17,false,12,9,-3,41.88208,-87.63985
13036,5,17,false,6,5,-1,41.8821,-87.62513
TA1305000032,5,17,false,24,8,-16,41.88218,-87.64109
13006,5,17,false,4,5,1,41.88268,-87.63252
13353,5,17,false,10,7,-3,41.88283,-87.6612
13409,5,17,false,2,10,8,41.8831,-87.6511
WL-012,5,17,false,13,20,7,41.88337,-87.6412
13053,5,17,false,19,22,3,41.88365,-87.64863
13001,5,17,false,26,9,-17,41.88397,-87.62459
18062,5,17,false,8,11,3,41.88412,-87.65427
TA1306000010,5,17,false,14,13,-1,41.88419,-87.62961
TA1305000030,5,17,false,16,8,-8,41.88459,-87.63178
15535,5,17,false,13,14,1,41.8846,-87.64455
TA1305000029,5,17,false,20,33,13,41.88466,-87.62787
13263,5,17,false,29,14,-15,41.88467,-87.61952
TA1306000015,5,17,false,21,24,3,41.88549,-87.65232
13021,5,17,false,9,15,6,41.88559,-87.64184
TA1307000111,5,17,false,6,7,1,41.88582,-87.63548
13073,5,17,false,6,1,-5,41.88592,-87.66717
KA1503000012,5,17,false,17,29,12,41.88599,-87.63089
TA1305000011,5,17,false,24,30,6,41.886,-87.62418
15534,5,17,false,13,11,-2,41.88627,-87.61749
13197,5,17,false,4,11,7,41.8866,-87.65816
TA1308000029,5,17,false,7,6,-1,41.88673,-87.62225
TA1307000131,5,17,false,20,33,13,41.88688,-87.62606
KA1503000064,5,17,false,51,37,-14,41.88697,-87.61281
TA1305000022,5,17,false,11,2,-9,41.88817,-87.63656
TA1306000003,5,17,false,12,26,14,41.88867,-87.64442
KA1503000043,5,17,false,33,19,-14,41.88918,-87.63851
13050,5,17,false,18,33,15,41.88919,-87.62775
TA1307000151,5,17,false,23,14,-9,41.88993,-87.63427
636,5,17,false,6,8,2,41.88997,-87.63662
KA1503000044,5,17,false,10,17,7,41.89018,-87.6262
13427,5,17,false,22,13,-9,41.89054,-87.62205
13430,5,17,false,15,30,15,41.89077,-87.63169
TA1306000013,5,17,false,37,36,-1,41.89083,-87.61852
RN-,5,17,false,19,20,1,41.89102,-87.63546
13434,5,17,false,7,14,7,41.89108,-87.66663
TA1308000006,5,17,false,6,8,2,41.89128,-87.67686
TA1307000117,5,17,false,51,46,-5,41.89144,-87.62675
13033,5,17,false,15,24,9,41.8916,-87.64835
13194,5,17,false,8,15,7,41.8918,-87.65878
TA1305000003,5,17,false,28,29,1,41.89187,-87.62061
13022,5,17,false,176,154,-22,41.89227,-87.61205
TA1306000029,5,17,false,28,19,-9,41.89256,-87.61449
13265,5,17,false,14,10,-4,41.89383,-87.64172
13045,5,17,false,22,24,2,41.89403,-87.62931
13016,5,17,false,9,9,0,41.89431,-87.62277
KA1503000041,5,17,false,14,5,-9,41.89452,-87.61798
13196,5,17,false,6,8,2,41.89455,-87.65345
TA1307000062,5,17,false,5,4,-1,41.89466,-87.63839
TA1306000012,5,17,false,35,20,-15,41.89475,-87.63438
KP1705001026,5,17,false,13,10,-3,41.89483,-87.6323
637,5,17,false,17,8,-9,41.89563,-87.67209
13132,5,17,false,13,16,3,41.89573,-87.67718
15530,5,17,false,18,19,1,41.89575,-87.62596
18003,5,17,false,4,6,2,41.89575,-87.62011
13247,5,17,false,5,11,6,41.89597,-87.66775
TA1305000020,5,17,false,20,7,-13,41.89636,-87.65406
13289,5,17,false,6,11,5,41.89638,-87.661
13303,5,17,false,18,15,-3,41.89672,-87.63088
13017,5,17,false,16,11,-5,41.89676,-87.6357
13338,5,17,false,5,5,0,41.89697,-87.62173
TA1307000061,5,17,false,26,11,-15,41.89745,-87.62873
13034,5,17,false,9,22,13,41.89754,-87.62352
TA1306000009,5,17,false,12,7,-5,41.89772,-87.64299
620,5,17,false,15,5,-10,41.89817,-87.63754
KA1504000103,5,17,false,5,5,0,41.89842,-87.68659
15529,5,17,false,6,7,1,41.89858,-87.62206
TA1307000128,5,17,false,25,17,-8,41.89896,-87.6299
13248,5,17,false,4,6,2,41.89964,-87.66788
TA1306000011,5,17,false,12,2,-10,41.89994,-87.63443
KA1504000116,5,17,false,9,10,1,41.90023,-87.64299
17660,5,17,false,5,5,0,41.90036,-87.69671
13290,5,17,false,5,10,5,41.90069,-87.66259
13042,5,17,false,51,67,16,41.90097,-87.62377
TA1307000070,5,17,false,5,1,-4,41.90133,-87.67742
KA1504000133,5,17,false,26,16,-10,41.90234,-87.62773
TA1307000039,5,17,false,43,37,-6,41.90294,-87.63137
TA1305000034,5,17,false,6,13,7,41.90313,-87.67391
KA1504000135,5,17,false,40,35,-5,41.90319,-87.63439
13136,5,17,false,8,12,4,41.90326,-87.67845
13061,5,17,false,16,17,1,41.90342,-87.66779
KA1504000079,5,17,false,15,12,-3,41.9035,-87.64334
TA1307000115,5,17,false,5,2,-3,41.9046,-87.64056
TA1308000049,5,17,false,27,30,3,41.90672,-87.6349
KA1504000134,5,17,false,18,15,-3,41.90687,-87.6262
13224,5,17,false,7,4,-3,41.90706,-87.66725
TA1307000143,5,17,false,9,5,-4,41.90762,-87.63854
13221,5,17,false,19,13,-6,41.90765,-87.67254
TA1309000024,5,17,false,36,26,-10,41.908,-87.63152
TA1305000041,5,17,false,11,17,6,41.9094,-87.67769
15652,5,17,false,6,2,-4,41.90965,-87.71664
331,5,17,false,14,13,-1,41.90965,-87.64812
TA1305000037,5,17,false,12,15,3,41.91018,-87.67003
TA1306000008,5,17,false,5,4,-1,41.9102,-87.6435
TA1308000005,5,17,false,9,9,0,41.91042,-87.68238
13257,5,17,false,10,6,-4,41.91054,-87.68956
13154,5,17,false,10,13,3,41.91054,-87.65312
13058,5,17,false,18,14,-4,41.91059,-87.64942
TA1307000038,5,17,false,21,21,0,41.91138,-87.63868
LF-005,5,17,false,67,85,18,41.91172,-87.62681
13128,5,17,false,14,15,1,41.91197,-87.63197
TA1308000050,5,17,false,40,37,-3,41.91211,-87.6347
13243,5,17,false,14,19,5,41.91262,-87.6814
TA1306000032,5,17,false,15,15,0,41.9137,-87.65285
TA1307000166,5,17,false,9,4,-5,41.91386,-87.64877
18017,5,17,false,4,6,2,41.91416,-87.71676
18067,5,17,false,8,8,0,41.9146,-87.66796
13068,5,17,false,12,8,-4,41.91554,-87.68703
13179,5,17,false,33,47,14,41.9157,-87.63461
13133,5,17,false,10,18,8,41.91598,-87.67733
TA1305000039,5,17,false,12,12,0,41.9163,-87.66749
15651,5,17,false,10,10,0,41.91752,-87.70181
13266,5,17,false,8,3,-5,41.91774,-87.69142
TA1309000029,5,17,false,7,12,5,41.9178,-87.68245
TA1309000006,5,17,false,15,9,-6,41.91809,-87.64375
TA1307000163,5,17,false,6,10,4,41.91821,-87.65696
13146,5,17,false,42,32,-10,41.91831,-87.63629
13059,5,17,false,23,9,-14,41.91845,-87.65222
13192,5,17,false,21,18,-3,41.91995,-87.64884
13288,5,17,false,10,4,-6,41.92008,-87.67788
13242,5,17,false,9,3,-6,41.92021,-87.69266
TA1309000030,5,17,false,11,20,9,41.92077,-87.66372
13292,5,17,false,6,1,-5,41.92152,-87.70733
TA1309000033,5,17,false,20,31,11,41.92158,-87.65381
13193,5,17,false,31,24,-7,41.92182,-87.64412
13191,5,17,false,12,12,0,41.92217,-87.63891
13084,5,17,false,5,14,9,41.92268,-87.69715
LP-,5,17,false,27,20,-7,41.92396,-87.63584
KA1504000140,5,17,false,3,6,3,41.92409,-87.67646
TA1307000001,5,17,false,13,18,5,41.92535,-87.66581
TA1306000026,5,17,false,7,9,2,41.92558,-87.65842
TA1306000016,5,17,false,12,11,-1,41.9256,-87.65371
TA1309000019,5,17,false,30,27,-3,41.92586,-87.63897
TA1309000058,5,17,false,28,36,8,41.92591,-87.64927
TA1308000001,5,17,false,40,52,12,41.92627,-87.63086
15646,5,17,false,3,9,6,41.92668,-87.6977
13124,5,17,false,13,4,-9,41.92675,-87.63444
TA1309000023,5,17,false,20,14,-6,41.9287,-87.65383
TA1307000113,5,17,false,28,23,-5,41.92878,-87.66391
13296,5,17,false,11,7,-4,41.92883,-87.66852
TA1309000059,5,17,false,12,5,-7,41.92889,-87.65898
TA1309000061,5,17,false,26,14,-12,41.92915,-87.64909
TA1308000031,5,17,false,5,2,-3,41.92946,-87.68417
TA1305000014,5,17,false,30,27,-3,41.92956,-87.64313
13085,5,17,false,9,9,0,41.92958,-87.70789
TA1307000142,5,17,false,36,19,-17,41.93125,-87.64432
13276,5,17,false,25,18,-7,41.93132,-87.63874
15645,5,17,false,6,3,-3,41.93191,-87.70121
13271,5,17,false,5,1,-4,41.93192,-87.67784
TA1307000064,5,17,false,13,7,-6,41.93222,-87.65864
TA1306000014,5,17,false,24,14,-10,41.93242,-87.65271
TA1309000039,5,17,false,39,34,-5,41.93258,-87.63642
13294,5,17,false,10,5,-5,41.9326,-87.66595
TA1309000036,5,17,false,6,15,9,41.93313,-87.64776
TA1307000006,5,17,false,11,13,2,41.93571,-87.6636
13268,5,17,false,6,8,2,41.93588,-87.67843
13269,5,17,false,3,6,3,41.93609,-87.66983
TA1307000052,5,17,false,17,18,1,41.93628,-87.65266
TA1307000136,5,17,false,20,12,-8,41.9365,-87.64755
TA1307000041,5,17,false,30,23,-7,41.93669,-87.63683
13137,5,17,false,35,32,-3,41.9376,-87.6441
15642,5,17,false,2,6,4,41.93843,-87.69801
TA1309000042,5,17,false,10,13,3,41.93937,-87.66836
13229,5,17,false,23,20,-3,41.93946,-87.66376
TA1308000019,5,17,false,12,23,11,41.93973,-87.65886
13277,5,17,false,13,11,-2,41.9401,-87.64546
TA1307000134,5,17,false,31,21,-10,41.94016,-87.65303
13143,5,17,false,9,2,-7,41.94059,-87.67853
TA1309000049,5,17,false,38,23,-15,41.94077,-87.63919
15634,5,17,false,1,5,4,41.94304,-87.68729
TA1307000138,5,17,false,9,9,0,41.94334,-87.67094
13144,5,17,false,7,7,0,41.9434,-87.67964
TA1309000025,5,17,false,24,16,-8,41.94368,-87.64894
13071,5,17,false,22,14,-8,41.94373,-87.66401
632,5,17,false,30,34,4,41.94453,-87.6547
13278,5,17,false,13,24,11,41.94553,-87.64644
13235,5,17,false,17,17,0,41.94814,-87.66396
13253,5,17,false,6,7,1,41.9488,-87.67527
13325,5,17,false,16,17,1,41.94907,-87.64863
TA1307000126,5,17,false,25,64,39,41.94936,-87.65451
TA1307000150,5,17,false,21,22,1,41.94945,-87.64646
13319,5,17,false,4,6,2,41.95069,-87.6687
TA1307000127,5,17,false,13,13,0,41.9508,-87.65918
13323,5,17,false,9,13,4,41.95282,-87.65
TA1309000043,5,17,false,12,4,-8,41.95417,-87.66434
13063,5,17,false,10,22,12,41.95424,-87.65441
TA1308000022,5,17,false,15,10,-5,41.95438,-87.64805
TA1307000149,5,17,false,3,9,6,41.95467,-87.67392
13379,5,17,false,6,5,-1,41.95786,-87.6495
TA1309000027,5,17,false,10,5,-5,41.9585,-87.65499
13389,5,17,false,5,9,4,41.961,-87.64958
KA1503000022,5,17,false,5,3,-2,41.96158,-87.66609
TA1307000107,5,17,false,9,14,5,41.96164,-87.65464
TA1307000156,5,17,false,3,7,4,41.96301,-87.68479
TA1308000012,5,17,false,28,37,9,41.96398,-87.63818
13074,5,17,false,6,4,-2,41.96521,-87.6582
639,5,17,false,21,6,-15,41.96584,-87.64538
TA1307000140,5,17,false,2,9,7,41.96643,-87.68865
TA1309000014,5,17,false,3,14,11,41.96709,-87.66744
TA1308000021,5,17,false,9,8,-1,41.96883,-87.65765
TA1309000066,5,17,false,5,10,5,41.9691,-87.67423
KA1504000171,5,17,false,16,7,-9,41.97161,-87.65016
TA1309000035,5,17,false,9,11,2,41.97335,-87.66785
13108,5,17,false,5,7,2,41.97379,-87.65971
KA1504000146,5,17,false,8,3,-5,41.978,-87.66805
13109,5,17,false,7,12,5,41.97835,-87.65976
KA1504000152,5,17,false,21,11,-10,41.98403,-87.65231
15575,5,17,false,4,10,6,41.98975,-87.66014
15571,5,17,false,1,16,15,41.99478,-87.66028
RP-009,5,17,false,5,1,-4,42.00107,-87.66122
E008,5,17,false,1,6,5,42.05049,-87.67782
604,5,17,false,5,1,-4,42.05824,-87.67744
KA1503000014,5,17,true,12,13,1,41.7851,-87.60108
KA1503000070,5,17,true,6,3,-3,41.78794,-87.58831
TA1309000011,5,17,true,8,2,-6,41.78873,-87.60131
KA1503000071,5,17,true,7,6,-1,41.79148,-87.59988
TA1309000063,5,17,true,6,8,2,41.79325,-87.5878
KA1504000076,5,17,true,5,8,3,41.7943,-87.60145
TA1308000009,5,17,true,8,5,-3,41.79522,-87.58075
TA1307000164,5,17,true,3,10,7,41.79527,-87.59647
KA1503000052,5,17,true,8,5,-3,41.79935,-87.60097
TA1309000037,5,17,true,10,12,2,41.79957,-87.59474
KA1503000007,5,17,true,5,3,-2,41.80242,-87.58689
TA1307000129,5,17,true,5,1,-4,41.83104,-87.62683
15445,5,17,true,5,5,0,41.83453,-87.63183
13216,5,17,true,10,3,-7,41.83473,-87.62581
13217,5,17,true,8,12,4,41.83488,-87.61792
13215,5,17,true,10,4,-6,41.83634,-87.6135
TA1309000055,5,17,true,7,8,1,41.8382,-87.64514
TA1307000048,5,17,true,5,5,0,41.83855,-87.60821
TA1308000036,5,17,true,3,6,3,41.83883,-87.62186
TA1307000139,5,17,true,6,8,2,41.84205,-87.61698
TA1307000153,5,17,true,2,6,4,41.84358,-87.64538
13075,5,17,true,8,7,-1,41.8531,-87.63192
15545,5,17,true,16,16,0,41.85627,-87.61334
SL-013,5,17,true,8,3,-5,41.85659,-87.62755
13102,5,17,true,5,17,12,41.85762,-87.61942
13150,5,17,true,10,11,1,41.85783,-87.62455
TA1307000159,5,17,true,4,8,4,41.8579,-87.6687
TA1307000044,5,17,true,5,2,-3,41.85794,-87.64083
13163,5,17,true,2,5,3,41.85808,-87.65108
13164,5,17,true,6,8,2,41.85818,-87.65648
SL-012,5,17,true,8,8,0,41.86038,-87.62581
TA1306000002,5,17,true,4,7,3,41.86238,-87.65108
TA1307000124,5,17,true,10,20,10,41.86411,-87.62372
TA1309000001,5,17,true,7,6,-1,41.86488,-87.64708
13431,5,17,true,9,7,-2,41.8661,-87.60728
WL-008,5,17,true,5,4,-1,41.86712,-87.64108
TA1305000002,5,17,true,25,24,-1,41.86721,-87.62597
15544,5,17,true,9,7,-2,41.86723,-87.61536
TA1305000017,5,17,true,8,1,-7,41.86734,-87.64863
KA1706005007,5,17,true,8,11,3,41.86749,-87.63219
SL-005,5,17,true,13,22,9,41.8679,-87.62304
644,5,17,true,7,3,-4,41.86859,-87.68625
13139,5,17,true,4,6,2,41.86893,-87.65913
13285,5,17,true,11,3,-8,41.86928,-87.67372
13160,5,17,true,26,19,-7,41.86947,-87.65548
15550,5,17,true,4,9,5,41.87024,-87.63947
TA1309000010,5,17,true,9,16,7,41.87074,-87.62574
SL-009,5,17,true,6,6,0,41.87081,-87.63121
TA1309000064,5,17,true,18,14,-4,41.87127,-87.67369
TA1307000130,5,17,true,15,9,-6,41.87178,-87.65103
TA1307000121,5,17,true,9,14,5,41.87184,-87.64664
SL-008,5,17,true,21,23,2,41.87209,-87.62956
13332,5,17,true,13,19,6,41.87219,-87.6615
SL-011,5,17,true,15,10,-5,41.87256,-87.63356
623,5,17,true,10,2,-8,41.87272,-87.62399
KA1504000104,5,17,true,6,4,-2,41.87296,-87.66912
SL-007,5,17,true,7,7,0,41.87404,-87.6277
13326,5,17,true,5,2,-3,41.87425,-87.63958
TA1306000025,5,17,true,9,3,-6,41.87464,-87.65703
13028,5,17,true,8,4,-4,41.87475,-87.64981
13081,5,17,true,7,1,-6,41.87501,-87.67326
SL-010,5,17,true,11,14,3,41.87501,-87.63309
15541,5,17,true,5,3,-2,41.8758,-87.62086
13037,5,17,true,5,3,-2,41.87588,-87.64078
TA1305000009,5,17,true,7,8,1,41.87593,-87.63068
624,5,17,true,11,6,-5,41.87626,-87.62923
TA1305000035,5,17,true,12,2,-10,41.87716,-87.62787
13138,5,17,true,5,3,-2,41.87723,-87.63941
15539,5,17,true,11,10,-1,41.87763,-87.64405
13158,5,17,true,22,31,9,41.87764,-87.64957
13157,5,17,true,9,14,5,41.87773,-87.6548
TA1305000025,5,17,true,17,7,-10,41.87773,-87.63528
TA1309000002,5,17,true,9,1,-8,41.87784,-87.62408
13206,5,17,true,11,3,-8,41.87794,-87.66201
TA1309000004,5,17,true,16,5,-11,41.87811,-87.63184
638,5,17,true,20,11,-9,41.87827,-87.64078
TA1305000005,5,17,true,25,5,-20,41.87924,-87.62975
13011,5,17,true,21,17,-4,41.87931,-87.63993
TA1309000008,5,17,true,18,8,-10,41.87933,-87.6355
KA1503000034,5,17,true,12,1,-11,41.87938,-87.63197
KA1503000015,5,17,true,11,6,-5,41.87948,-87.6257
TA1309000007,5,17,true,20,3,-17,41.88022,-87.63526
WL-011,5,17,true,14,7,-7,41.88034,-87.64273
13156,5,17,true,5,11,6,41.88042,-87.65554
13300,5,17,true,18,22,4,41.88097,-87.61675
13008,5,17,true,11,9,-2,41.88105,-87.62408
TA1305000006,5,17,true,24,5,-19,41.88122,-87.6296
13056,5,17,true,19,8,-11,41.88168,-87.63951
TA1307000120,5,17,true,27,34,7,41.88188,-87.64879
13341,5,17,true,13,14,1,41.88208,-87.63985
13036,5,17,true,7,4,-3,41.8821,-87.62513
TA1305000032,5,17,true,30,16,-14,41.88218,-87.64109
13006,5,17,true,8,5,-3,41.88268,-87.63252
13353,5,17,true,6,13,7,41.88283,-87.6612
13409,5,17,true,11,11,0,41.8831,-87.6511
KA1503000072,5,17,true,11,6,-5,41.88317,-87.63693
WL-012,5,17,true,33,23,-10,41.88337,-87.6412
13053,5,17,true,15,19,4,41.88365,-87.64863
13001,5,17,true,11,9,-2,41.88397,-87.62459
13155,5,17,true,7,3,-4,41.88407,-87.65689
18062,5,17,true,8,13,5,41.88412,-87.65427
TA1306000010,5,17,true,25,17,-8,41.88419,-87.62961
TA1305000030,5,17,true,21,5,-16,41.88459,-87.63178
15535,5,17,true,14,16,2,41.8846,-87.64455
TA1305000029,5,17,true,21,18,-3,41.88466,-87.62787
13263,5,17,true,21,22,1,41.88467,-87.61952
TA1306000015,5,17,true,18,22,4,41.88549,-87.65232
13021,5,17,true,24,20,-4,41.88559,-87.64184
TA1307000111,5,17,true,13,9,-4,41.88582,-87.63548
13073,5,17,true,13,5,-8,41.88592,-87.66717
KA17018054,5,17,true,3,7,4,41.88595,-87.67701
KA1503000012,5,17,true,24,16,-8,41.88599,-87.63089
TA1305000011,5,17,true,22,12,-10,41.886,-87.62418
15534,5,17,true,17,18,1,41.88627,-87.61749
13197,5,17,true,3,5,2,41.8866,-87.65816
TA1308000029,5,17,true,11,8,-3,41.88673,-87.62225
TA1307000131,5,17,true,14,5,-9,41.88688,-87.62606
KA1503000064,5,17,true,19,23,4,41.88697,-87.61281
TA1305000022,5,17,true,19,12,-7,41.88817,-87.63656
TA1306000003,5,17,true,29,30,1,41.88867,-87.64442
KA1503000043,5,17,true,38,28,-10,41.88918,-87.63851
13050,5,17,true,22,24,2,41.88919,-87.62775
13432,5,17,true,5,4,-1,41.88989,-87.67149
TA1307000151,5,17,true,25,31,6,41.88993,-87.63427
636,5,17,true,11,8,-3,41.88997,-87.63662
KA1503000044,5,17,true,5,10,5,41.89018,-87.6262
13427,5,17,true,17,7,-10,41.89054,-87.62205
13430,5,17,true,23,39,16,41.89077,-87.63169
TA1306000013,5,17,true,19,21,2,41.89083,-87.61852
RN-,5,17,true,19,20,1,41.89102,-87.63546
13434,5,17,true,7,10,3,41.89108,-87.66663
TA1308000006,5,17,true,5,6,1,41.89128,-87.67686
TA1307000117,5,17,true,39,29,-10,41.89144,-87.62675
13033,5,17,true,12,16,4,41.8916,-87.64835
13194,5,17,true,4,10,6,41.8918,-87.65878
TA1305000003,5,17,true,21,18,-3,41.89187,-87.62061
13022,5,17,true,34,34,0,41.89227,-87.61205
TA1306000029,5,17,true,30,21,-9,41.89256,-87.61449
13265,5,17,true,24,15,-9,41.89383,-87.64172
13045,5,17,true,35,25,-10,41.89403,-87.62931
13016,5,17,true,30,5,-25,41.89431,-87.62277
KA1503000041,5,17,true,27,9,-18,41.89452,-87.61798
13196,5,17,true,8,8,0,41.89455,-87.65345
TA1307000062,5,17,true,9,7,-2,41.89466,-87.63839
TA1306000012,5,17,true,46,29,-17,41.89475,-87.63438
KP1705001026,5,17,true,12,14,2,41.89483,-87.6323
18058,5,17,true,8,7,-1,41.8955,-87.68201
637,5,17,true,8,7,-1,41.89563,-87.67209
13132,5,17,true,6,8,2,41.89573,-87.67718
15530,5,17,true,12,18,6,41.89575,-87.62596
18003,5,17,true,14,2,-12,41.89575,-87.62011
13247,5,17,true,9,10,1,41.89597,-87.66775
TA1305000020,5,17,true,10,10,0,41.89636,-87.65406
13289,5,17,true,13,11,-2,41.89638,-87.661
13303,5,17,true,17,17,0,41.89672,-87.63088
13017,5,17,true,19,18,-1,41.89676,-87.6357
13338,5,17,true,17,5,-12,41.89697,-87.62173
TA1307000061,5,17,true,17,12,-5,41.89745,-87.62873
13034,5,17,true,12,8,-4,41.89754,-87.62352
TA1306000009,5,17,true,33,11,-22,41.89772,-87.64299
620,5,17,true,16,13,-3,41.89817,-87.63754
KA1504000103,5,17,true,6,5,-1,41.89842,-87.68659
15529,5,17,true,14,7,-7,41.89858,-87.62206
TA1307000128,5,17,true,29,35,6,41.89896,-87.6299
657,5,17,true,6,9,3,41.89918,-87.6722
KA1504000117,5,17,true,6,4,-2,41.89936,-87.64848
13248,5,17,true,9,14,5,41.89964,-87.66788
TA1306000011,5,17,true,5,6,1,41.89994,-87.63443
KA1504000116,5,17,true,9,7,-2,41.90023,-87.64299
17660,5,17,true,6,4,-2,41.90036,-87.69671
13290,5,17,true,11,9,-2,41.90069,-87.66259
13042,5,17,true,36,17,-19,41.90097,-87.62377
TA1307000070,5,17,true,6,8,2,41.90133,-87.67742
KA1504000133,5,17,true,13,17,4,41.90234,-87.62773
13241,5,17,true,6,3,-3,41.9029,-87.68731
TA1307000039,5,17,true,44,42,-2,41.90294,-87.63137
TA1305000034,5,17,true,12,21,9,41.90313,-87.67391
KA1504000135,5,17,true,36,45,9,41.90319,-87.63439
13136,5,17,true,13,21,8,41.90326,-87.67845
13061,5,17,true,27,29,2,41.90342,-87.66779
KA1504000079,5,17,true,10,14,4,41.9035,-87.64334
TA1307000115,5,17,true,9,9,0,41.9046,-87.64056
TA1308000049,5,17,true,16,34,18,41.90672,-87.6349
KA1504000134,5,17,true,12,14,2,41.90687,-87.6262
13224,5,17,true,12,9,-3,41.90706,-87.66725
TA1307000143,5,17,true,4,11,7,41.90762,-87.63854
13221,5,17,true,14,19,5,41.90765,-87.67254
TA1309000024,5,17,true,22,32,10,41.908,-87.63152
TA1305000041,5,17,true,14,17,3,41.9094,-87.67769
331,5,17,true,11,25,14,41.90965,-87.64812
TA1305000037,5,17,true,10,16,6,41.91018,-87.67003
TA1306000008,5,17,true,9,16,7,41.9102,-87.6435
TA1308000005,5,17,true,5,9,4,41.91042,-87.68238
13257,5,17,true,4,5,1,41.91054,-87.68956
13154,5,17,true,14,13,-1,41.91054,-87.65312
13058,5,17,true,9,11,2,41.91059,-87.64942
TA1307000038,5,17,true,14,14,0,41.91138,-87.63868
LF-005,5,17,true,20,48,28,41.91172,-87.62681
13128,5,17,true,7,10,3,41.91197,-87.63197
TA1308000050,5,17,true,34,45,11,41.91211,-87.6347
13243,5,17,true,18,7,-11,41.91262,-87.6814
TA1306000032,5,17,true,16,11,-5,41.9137,-87.65285
TA1307000166,5,17,true,12,9,-3,41.91386,-87.64877
15655,5,17,true,3,11,8,41.91401,-87.70514
18067,5,17,true,3,14,11,41.9146,-87.66796
TA1306000007,5,17,true,9,8,-1,41.91469,-87.64333
13068,5,17,true,4,8,4,41.91554,-87.68703
13179,5,17,true,35,46,11,41.9157,-87.63461
13133,5,17,true,4,10,6,41.91598,-87.67733
TA1305000039,5,17,true,13,15,2,41.9163,-87.66749
15650,5,17,true,4,5,1,41.91711,-87.71023
15651,5,17,true,8,7,-1,41.91752,-87.70181
13266,5,17,true,8,11,3,41.91774,-87.69142
TA1309000029,5,17,true,8,3,-5,41.9178,-87.68245
TA1309000006,5,17,true,12,14,2,41.91809,-87.64375
TA1307000163,5,17,true,15,6,-9,41.91821,-87.65696
13146,5,17,true,29,32,3,41.91831,-87.63629
13059,5,17,true,24,27,3,41.91845,-87.65222
13192,5,17,true,13,17,4,41.91995,-87.64884
13288,5,17,true,6,7,1,41.92008,-87.67788
13242,5,17,true,6,5,-1,41.92021,-87.69266
TA1309000030,5,17,true,12,14,2,41.92077,-87.66372
13292,5,17,true,4,6,2,41.92152,-87.70733
TA1309000033,5,17,true,15,20,5,41.92158,-87.65381
13193,5,17,true,28,33,5,41.92182,-87.64412
13191,5,17,true,10,14,4,41.92217,-87.63891
13084,5,17,true,3,13,10,41.92268,-87.69715
LP-,5,17,true,8,9,1,41.92396,-87.63584
KA1504000140,5,17,true,6,5,-1,41.92409,-87.67646
15648,5,17,true,2,6,4,41.92464,-87.68931
TA1307000001,5,17,true,14,13,-1,41.92535,-87.66581
TA1306000026,5,17,true,11,9,-2,41.92558,-87.65842
TA1306000016,5,17,true,20,13,-7,41.9256,-87.65371
TA1309000019,5,17,true,21,25,4,41.92586,-87.63897
TA1309000058,5,17,true,26,25,-1,41.92591,-87.64927
TA1308000001,5,17,true,34,32,-2,41.92627,-87.63086
13124,5,17,true,2,7,5,41.92675,-87.63444
TA1309000023,5,17,true,19,19,0,41.9287,-87.65383
TA1307000113,5,17,true,17,15,-2,41.92878,-87.66391
13296,5,17,true,9,7,-2,41.92883,-87.66852
TA1309000059,5,17,true,11,10,-1,41.92889,-87.65898
TA1309000061,5,17,true,20,22,2,41.92915,-87.64909
TA1305000014,5,17,true,16,21,5,41.92956,-87.64313
13085,5,17,true,8,9,1,41.92958,-87.70789
TA1307000142,5,17,true,20,24,4,41.93125,-87.64432
13276,5,17,true,14,14,0,41.93132,-87.63874
13271,5,17,true,4,10,6,41.93192,-87.67784
TA1307000064,5,17,true,23,22,-1,41.93222,-87.65864
TA1306000014,5,17,true,24,24,0,41.93242,-87.65271
TA1309000039,5,17,true,17,31,14,41.93258,-87.63642
13294,5,17,true,7,7,0,41.9326,-87.66595
TA1309000036,5,17,true,18,14,-4,41.93313,-87.64776
TA1307000006,5,17,true,11,9,-2,41.93571,-87.6636
13268,5,17,true,4,7,3,41.93588,-87.67843
13269,5,17,true,9,11,2,41.93609,-87.66983
TA1307000052,5,17,true,11,14,3,41.93628,-87.65266
TA1307000136,5,17,true,26,26,0,41.9365,-87.64755
TA1307000041,5,17,true,17,12,-5,41.93669,-87.63683
13137,5,17,true,31,25,-6,41.9376,-87.6441
TA1309000042,5,17,true,10,9,-1,41.93937,-87.66836
13229,5,17,true,3,12,9,41.93946,-87.66376
TA1308000019,5,17,true,20,11,-9,41.93973,-87.65886
13277,5,17,true,12,11,-1,41.9401,-87.64546
TA1307000134,5,17,true,35,17,-18,41.94016,-87.65303
13143,5,17,true,6,5,-1,41.94059,-87.67853
TA1309000049,5,17,true,20,32,12,41.94077,-87.63919
TA1307000138,5,17,true,11,19,8,41.94334,-87.67094
13144,5,17,true,9,7,-2,41.9434,-87.67964
TA1309000025,5,17,true,15,23,8,41.94368,-87.64894
13071,5,17,true,18,15,-3,41.94373,-87.66401
632,5,17,true,16,23,7,41.94453,-87.6547
13278,5,17,true,31,27,-4,41.94553,-87.64644
TA1309000050,5,17,true,2,5,3,41.94618,-87.67331
13235,5,17,true,21,15,-6,41.94814,-87.66396
13253,5,17,true,5,9,4,41.9488,-87.67527
13325,5,17,true,24,28,4,41.94907,-87.64863
TA1307000126,5,17,true,12,30,18,41.94936,-87.65451
TA1307000150,5,17,true,21,22,1,41.94945,-87.64646
13319,5,17,true,14,6,-8,41.95069,-87.6687
TA1307000127,5,17,true,13,14,1,41.9508,-87.65918
13323,5,17,true,18,15,-3,41.95282,-87.65
TA1309000043,5,17,true,4,5,1,41.95417,-87.66434
13063,5,17,true,15,14,-1,41.95424,-87.65441
TA1308000022,5,17,true,17,17,0,41.95438,-87.64805
TA1307000149,5,17,true,8,5,-3,41.95467,-87.67392
13379,5,17,true,12,16,4,41.95786,-87.6495
TA1309000018,5,17,true,3,5,2,41.95791,-87.67357
TA1309000027,5,17,true,4,10,6,41.9585,-87.65499
13389,5,17,true,12,8,-4,41.961,-87.64958
KA1503000022,5,17,true,13,7,-6,41.96158,-87.66609
TA1307000107,5,17,true,17,10,-7,41.96164,-87.65464
TA1307000156,5,17,true,8,4,-4,41.96301,-87.68479
TA1309000012,5,17,true,5,5,0,41.96325,-87.67928
TA1308000012,5,17,true,22,23,1,41.96398,-87.63818
13074,5,17,true,21,11,-10,41.96521,-87.6582
639,5,17,true,12,12,0,41.96584,-87.64538
KA1504000093,5,17,true,5,6,1,41.96587,-87.69365
TA1309000014,5,17,true,4,6,2,41.96709,-87.66744
TA1307000158,5,17,true,8,2,-6,41.9671,-87.67904
TA1307000119,5,17,true,3,5,2,41.96796,-87.65
TA1308000021,5,17,true,11,7,-4,41.96883,-87.65765
KA1504000080,5,17,true,3,5,2,41.96887,-87.69609
TA1309000015,5,17,true,1,5,4,41.96889,-87.68401
TA1309000066,5,17,true,12,12,0,41.9691,-87.67423
TA1309000041,5,17,true,5,6,1,41.96951,-87.65471
KA1504000171,5,17,true,13,6,-7,41.97161,-87.65016
TA1309000035,5,17,true,4,12,8,41.97335,-87.66785
13108,5,17,true,8,5,-3,41.97379,-87.65971
KA1504000078,5,17,true,2,5,3,41.97491,-87.69258
KA1504000146,5,17,true,10,8,-2,41.978,-87.66805
13109,5,17,true,8,11,3,41.97835,-87.65976
KA1504000147,5,17,true,5,1,-4,41.97976,-87.67754
KA1504000151,5,17,true,3,9,6,41.98359,-87.66916
KA1504000152,5,17,true,9,12,3,41.98403,-87.65231
15578,5,17,true,9,11,2,41.98405,-87.66027
15575,5,17,true,8,11,3,41.98975,-87.66014
15571,5,17,true,7,6,-1,41.99478,-87.66028
660,5,17,true,6,3,-3,42.00458,-87.66143
RP-005,5,17,true,4,6,2,42.0086,-87.69047
520,5,17,true,6,1,-5,42.01597,-87.66859
E002,5,17,true,2,5,3,42.03256,-87.67912
596,5,17,true,8,5,-3,42.04822,-87.68348
604,5,17,true,9,2,-7,42.05824,-87.67744
KA1503000002,5,18,false,1,6,5,41.76641,-87.5657
15491,5,18,false,3,9,6,41.78096,-87.57624
KA1503000014,5,18,false,8,8,0,41.7851,-87.60108
KA1503000071,5,18,false,4,5,1,41.79148,-87.59988
KA1503000074,5,18,false,2,7,5,41.79174,-87.58395
TA1309000063,5,18,false,3,5,2,41.79325,-87.5878
KA1504000076,5,18,false,5,2,-3,41.7943,-87.60145
TA1308000009,5,18,false,29,17,-12,41.79522,-87.58075
TA1307000164,5,18,false,6,11,5,41.79527,-87.59647
KA1503000052,5,18,false,5,5,0,41.79935,-87.60097
KA1503000059,5,18,false,4,8,4,41.79952,-87.58643
TA1309000037,5,18,false,12,5,-7,41.79957,-87.59474
KA1503000007,5,18,false,7,7,0,41.80242,-87.58689
TA1308000038,5,18,false,8,3,-5,41.82298,-87.6071
15445,5,18,false,1,5,4,41.83453,-87.63183
13215,5,18,false,2,7,5,41.83634,-87.6135
TA1307000048,5,18,false,11,15,4,41.83855,-87.60821
TA1305000004,5,18,false,1,7,6,41.8514,-87.61884
TA1305000001,5,18,false,3,5,2,41.85262,-87.6265
13075,5,18,false,4,13,9,41.8531,-87.63192
15546,5,18,false,1,6,5,41.85416,-87.61916
15545,5,18,false,12,7,-5,41.85627,-87.61334
SL-006,5,18,false,6,7,1,41.8568,-87.63387
13135,5,18,false,1,6,5,41.85753,-87.66157
13102,5,18,false,11,2,-9,41.85762,-87.61942
13150,5,18,false,12,4,-8,41.85783,-87.62455
13164,5,18,false,14,4,-10,41.85818,-87.65648
TA1307000124,5,18,false,5,14,9,41.86411,-87.62372
13431,5,18,false,20,16,-4,41.8661,-87.60728
WL-008,5,18,false,2,6,4,41.86712,-87.64108
TA1305000002,5,18,false,24,18,-6,41.86721,-87.62597
15544,5,18,false,21,18,-3,41.86723,-87.61536
SL-005,5,18,false,39,24,-15,41.8679,-87.62304
13139,5,18,false,6,6,0,41.86893,-87.65913
13160,5,18,false,7,7,0,41.86947,-87.65548
TA1309000010,5,18,false,17,18,1,41.87074,-87.62574
SL-009,5,18,false,5,3,-2,41.87081,-87.63121
SL-008,5,18,false,13,24,11,41.87209,-87.62956
13332,5,18,false,6,5,-1,41.87219,-87.6615
SL-011,5,18,false,10,12,2,41.87256,-87.63356
623,5,18,false,22,12,-10,41.87272,-87.62399
SL-007,5,18,false,12,5,-7,41.87404,-87.6277
13028,5,18,false,7,2,-5,41.87475,-87.64981
SL-010,5,18,false,7,3,-4,41.87501,-87.63309
15541,5,18,false,24,25,1,41.8758,-87.62086
TA1305000009,5,18,false,5,4,-1,41.87593,-87.63068
TA1305000010,5,18,false,6,1,-5,41.87623,-87.62444
624,5,18,false,9,4,-5,41.87626,-87.62923
TA1305000035,5,18,false,5,5,0,41.87716,-87.62787
15539,5,18,false,5,3,-2,41.87763,-87.64405
13158,5,18,false,13,14,1,41.87764,-87.64957
13157,5,18,false,3,5,2,41.87773,-87.6548
TA1305000025,5,18,false,8,3,-5,41.87773,-87.63528
TA1309000002,5,18,false,8,10,2,41.87784,-87.62408
13206,5,18,false,5,7,2,41.87794,-87.66201
TA1309000004,5,18,false,9,1,-8,41.87811,-87.63184
638,5,18,false,6,9,3,41.87827,-87.64078
TA1305000005,5,18,false,2,6,4,41.87924,-87.62975
13011,5,18,false,9,4,-5,41.87931,-87.63993
TA1309000008,5,18,false,4,10,6,41.87933,-87.6355
KA1503000015,5,18,false,11,7,-4,41.87948,-87.6257
WL-011,5,18,false,7,6,-1,41.88034,-87.64273
13156,5,18,false,18,12,-6,41.88042,-87.65554
13300,5,18,false,53,47,-6,41.88097,-87.61675
13008,5,18,false,53,51,-2,41.88105,-87.62408
TA1305000006,5,18,false,5,4,-1,41.88122,-87.6296
TA1307000120,5,18,false,15,29,14,41.88188,-87.64879
13341,5,18,false,12,13,1,41.88208,-87.63985
13036,5,18,false,7,5,-2,41.8821,-87.62513
TA1305000032,5,18,false,13,4,-9,41.88218,-87.64109
13006,5,18,false,7,3,-4,41.88268,-87.63252
654,5,18,false,1,6,5,41.88307,-87.65698
13409,5,18,false,4,5,1,41.8831,-87.6511
WL-012,5,18,false,7,17,10,41.88337,-87.6412
13053,5,18,false,11,19,8,41.88365,-87.64863
13001,5,18,false,27,14,-13,41.88397,-87.62459
13155,5,18,false,2,7,5,41.88407,-87.65689
18062,5,18,false,18,13,-5,41.88412,-87.65427
TA1306000010,5,18,false,10,6,-4,41.88419,-87.62961
TA1305000030,5,18,false,14,4,-10,41.88459,-87.63178
15535,5,18,false,12,23,11,41.8846,-87.64455
TA1305000029,5,18,false,21,22,1,41.88466,-87.62787
13263,5,18,false,14,8,-6,41.88467,-87.61952
TA1306000015,5,18,false,18,25,7,41.88549,-87.65232
13021,5,18,false,7,6,-1,41.88559,-87.64184
KA1503000012,5,18,false,22,6,-16,41.88599,-87.63089
TA1305000011,5,18,false,15,13,-2,41.886,-87.62418
15534,5,18,false,6,10,4,41.88627,-87.61749
TA1308000029,5,18,false,2,14,12,41.88673,-87.62225
TA1307000131,5,18,false,18,26,8,41.88688,-87.62606
KA1503000064,5,18,false,45,33,-12,41.88697,-87.61281
TA1305000022,5,18,false,8,6,-2,41.88817,-87.63656
TA1306000003,5,18,false,13,23,10,41.88867,-87.64442
KA1503000043,5,18,false,15,15,0,41.88918,-87.63851
13050,5,18,false,17,21,4,41.88919,-87.62775
13432,5,18,false,1,5,4,41.88989,-87.67149
TA1307000151,5,18,false,22,31,9,41.88993,-87.63427
636,5,18,false,7,12,5,41.88997,-87.63662
KA1503000044,5,18,false,12,9,-3,41.89018,-87.6262
13427,5,18,false,14,11,-3,41.89054,-87.62205
13430,5,18,false,32,26,-6,41.89077,-87.63169
TA1306000013,5,18,false,35,37,2,41.89083,-87.61852
RN-,5,18,false,18,11,-7,41.89102,-87.63546
13434,5,18,false,8,6,-2,41.89108,-87.66663
TA1308000006,5,18,false,5,8,3,41.89128,-87.67686
TA1307000117,5,18,false,59,50,-9,41.89144,-87.62675
13033,5,18,false,23,17,-6,41.8916,-87.64835
13194,5,18,false,16,16,0,41.8918,-87.65878
TA1305000003,5,18,false,21,23,2,41.89187,-87.62061
13022,5,18,false,135,177,42,41.89227,-87.61205
TA1306000029,5,18,false,10,15,5,41.89256,-87.61449
13265,5,18,false,6,11,5,41.89383,-87.64172
13045,5,18,false,23,26,3,41.89403,-87.62931
13016,5,18,false,7,15,8,41.89431,-87.62277
KA1503000041,5,18,false,9,11,2,41.89452,-87.61798
13196,5,18,false,11,7,-4,41.89455,-87.65345
TA1307000062,5,18,false,16,8,-8,41.89466,-87.63839
TA1306000012,5,18,false,22,19,-3,41.89475,-87.63438
KP1705001026,5,18,false,12,26,14,41.89483,-87.6323
18058,5,18,false,3,8,5,41.8955,-87.68201
637,5,18,false,6,3,-3,41.89563,-87.67209
13132,5,18,false,7,2,-5,41.89573,-87.67718
15530,5,18,false,18,21,3,41.89575,-87.62596
13247,5,18,false,6,11,5,41.89597,-87.66775
TA1305000020,5,18,false,15,12,-3,41.89636,-87.65406
13303,5,18,false,13,9,-4,41.89672,-87.63088
13017,5,18,false,8,8,0,41.89676,-87.6357
13338,5,18,false,14,17,3,41.89697,-87.62173
TA1307000061,5,18,false,10,12,2,41.89745,-87.62873
13034,5,18,false,15,17,2,41.89754,-87.62352
TA1306000009,5,18,false,6,5,-1,41.89772,-87.64299
620,5,18,false,9,4,-5,41.89817,-87.63754
KA1504000103,5,18,false,7,4,-3,41.89842,-87.68659
15529,5,18,false,15,26,11,41.89858,-87.62206
TA1307000128,5,18,false,24,29,5,41.89896,-87.6299
657,5,18,false,5,10,5,41.89918,-87.6722
TA1306000011,5,18,false,4,5,1,41.89994,-87.63443
KA1504000116,5,18,false,8,4,-4,41.90023,-87.64299
17660,5,18,false,3,6,3,41.90036,-87.69671
13290,5,18,false,7,6,-1,41.90069,-87.66259
13042,5,18,false,57,74,17,41.90097,-87.62377
TA1307000070,5,18,false,8,8,0,41.90133,-87.67742
KA1504000133,5,18,false,14,21,7,41.90234,-87.62773
13241,5,18,false,4,6,2,41.9029,-87.68731
TA1306000006,5,18,false,10,6,-4,41.90292,-87.63772
TA1307000039,5,18,false,45,36,-9,41.90294,-87.63137
13256,5,18,false,10,8,-2,41.90302,-87.69749
TA1305000034,5,18,false,14,18,4,41.90313,-87.67391
KA1504000135,5,18,false,40,35,-5,41.90319,-87.63439
13136,5,18,false,17,12,-5,41.90326,-87.67845
13061,5,18,false,25,22,-3,41.90342,-87.66779
KA1504000079,5,18,false,11,8,-3,41.9035,-87.64334
TA1307000115,5,18,false,5,2,-3,41.9046,-87.64056
TA1308000049,5,18,false,34,41,7,41.90672,-87.6349
KA1504000134,5,18,false,14,20,6,41.90687,-87.6262
13224,5,18,false,8,14,6,41.90706,-87.66725
TA1307000143,5,18,false,8,6,-2,41.90762,-87.63854
13221,5,18,false,14,23,9,41.90765,-87.67254
TA1309000024,5,18,false,23,25,2,41.908,-87.63152
TA1305000041,5,18,false,32,18,-14,41.9094,-87.67769
331,5,18,false,10,5,-5,41.90965,-87.64812
15653,5,18,false,5,2,-3,41.90979,-87.7053
TA1305000037,5,18,false,20,11,-9,41.91018,-87.67003
TA1306000008,5,18,false,8,4,-4,41.9102,-87.6435
TA1308000005,5,18,false,5,10,5,41.91042,-87.68238
13257,5,18,false,10,6,-4,41.91054,-87.68956
13154,5,18,false,12,6,-6,41.91054,-87.65312
13058,5,18,false,13,10,-3,41.91059,-87.64942
TA1307000038,5,18,false,20,26,6,41.91138,-87.63868
LF-005,5,18,false,68,133,65,41.91172,-87.62681
13128,5,18,false,9,21,12,41.91197,-87.63197
TA1308000050,5,18,false,34,56,22,41.91211,-87.6347
13243,5,18,false,7,11,4,41.91262,-87.6814
TA1309000032,5,18,false,6,3,-3,41.91293,-87.66417
TA1306000032,5,18,false,16,18,2,41.9137,-87.65285
TA1307000166,5,18,false,8,7,-1,41.91386,-87.64877
15655,5,18,false,5,3,-2,41.91401,-87.70514
18067,5,18,false,8,6,-2,41.9146,-87.66796
TA1306000007,5,18,false,5,4,-1,41.91469,-87.64333
13068,5,18,false,12,12,0,41.91554,-87.68703
13179,5,18,false,36,39,3,41.9157,-87.63461
13133,5,18,false,6,9,3,41.91598,-87.67733
TA1305000039,5,18,false,6,3,-3,41.9163,-87.66749
15651,5,18,false,12,10,-2,41.91752,-87.70181
13266,5,18,false,3,10,7,41.91774,-87.69142
TA1309000006,5,18,false,10,15,5,41.91809,-87.64375
TA1307000163,5,18,false,9,8,-1,41.91821,-87.65696
13146,5,18,false,25,34,9,41.91831,-87.63629
13059,5,18,false,23,20,-3,41.91845,-87.65222
13259,5,18,false,4,7,3,41.91852,-87.69744
13192,5,18,false,16,11,-5,41.91995,-87.64884
13288,5,18,false,4,5,1,41.92008,-87.67788
13242,5,18,false,1,9,8,41.92021,-87.69266
TA1309000030,5,18,false,16,21,5,41.92077,-87.66372
13292,5,18,false,2,9,7,41.92152,-87.70733
TA1309000033,5,18,false,23,16,-7,41.92158,-87.65381
13193,5,18,false,32,42,10,41.92182,-87.64412
13191,5,18,false,16,12,-4,41.92217,-87.63891
13084,5,18,false,8,6,-2,41.92268,-87.69715
LP-,5,18,false,13,17,4,41.92396,-87.63584
15648,5,18,false,4,9,5,41.92464,-87.68931
TA1307000001,5,18,false,15,7,-8,41.92535,-87.66581
TA1306000026,5,18,false,9,10,1,41.92558,-87.65842
TA1306000016,5,18,false,14,20,6,41.9256,-87.65371
TA1309000019,5,18,false,25,31,6,41.92586,-87.63897
TA1309000058,5,18,false,34,29,-5,41.92591,-87.64927
TA1308000001,5,18,false,48,53,5,41.92627,-87.63086
15646,5,18,false,3,10,7,41.92668,-87.6977
13124,5,18,false,9,8,-1,41.92675,-87.63444
TA1309000023,5,18,false,20,23,3,41.9287,-87.65383
TA1307000113,5,18,false,18,19,1,41.92878,-87.66391
13296,5,18,false,7,8,1,41.92883,-87.66852
TA1309000059,5,18,false,6,2,-4,41.92889,-87.65898
TA1309000061,5,18,false,28,22,-6,41.92915,-87.64909
TA1308000031,5,18,false,6,6,0,41.92946,-87.68417
TA1305000014,5,18,false,33,28,-5,41.92956,-87.64313
13085,5,18,false,2,13,11,41.92958,-87.70789
TA1307000142,5,18,false,23,20,-3,41.93125,-87.64432
13276,5,18,false,23,19,-4,41.93132,-87.63874
13271,5,18,false,8,4,-4,41.93192,-87.67784
TA1307000064,5,18,false,10,12,2,41.93222,-87.65864
TA1306000014,5,18,false,29,13,-16,41.93242,-87.65271
TA1309000039,5,18,false,24,21,-3,41.93258,-87.63642
13294,5,18,false,9,3,-6,41.9326,-87.66595
TA1309000036,5,18,false,14,17,3,41.93313,-87.64776
TA1307000006,5,18,false,7,14,7,41.93571,-87.6636
13268,5,18,false,10,3,-7,41.93588,-87.67843
TA1307000052,5,18,false,13,17,4,41.93628,-87.65266
TA1307000136,5,18,false,33,21,-12,41.9365,-87.64755
TA1307000041,5,18,false,22,29,7,41.93669,-87.63683
13137,5,18,false,25,22,-3,41.9376,-87.6441
15642,5,18,false,5,3,-2,41.93843,-87.69801
KA17018068,5,18,false,6,2,-4,41.93935,-87.68327
TA1309000042,5,18,false,7,8,1,41.93937,-87.66836
13229,5,18,false,18,12,-6,41.93946,-87.66376
TA1308000019,5,18,false,18,9,-9,41.93973,-87.65886
13277,5,18,false,17,7,-10,41.9401,-87.64546
TA1307000134,5,18,false,21,20,-1,41.94016,-87.65303
13143,5,18,false,5,4,-1,41.94059,-87.67853
TA1309000049,5,18,false,21,25,4,41.94077,-87.63919
TA1307000138,5,18,false,16,16,0,41.94334,-87.67094
13144,5,18,false,9,8,-1,41.9434,-87.67964
TA1309000025,5,18,false,24,23,-1,41.94368,-87.64894
13071,5,18,false,18,13,-5,41.94373,-87.66401
632,5,18,false,21,23,2,41.94453,-87.6547
13278,5,18,false,12,16,4,41.94553,-87.64644
TA1309000050,5,18,false,2,6,4,41.94618,-87.67331
15632,5,18,false,2,7,5,41.94664,-87.69463
13235,5,18,false,19,19,0,41.94814,-87.66396
13325,5,18,false,22,16,-6,41.94907,-87.64863
TA1307000126,5,18,false,14,69,55,41.94936,-87.65451
TA1307000150,5,18,false,26,9,-17,41.94945,-87.64646
13319,5,18,false,3,15,12,41.95069,-87.6687
TA1307000127,5,18,false,17,19,2,41.9508,-87.65918
13323,5,18,false,17,10,-7,41.95282,-87.65
TA1309000043,5,18,false,6,4,-2,41.95417,-87.66434
13063,5,18,false,18,10,-8,41.95424,-87.65441
KA1504000158,5,18,false,5,2,-3,41.95432,-87.68607
TA1308000022,5,18,false,7,15,8,41.95438,-87.64805
TA1307000149,5,18,false,9,1,-8,41.95467,-87.67392
TA1309000026,5,18,false,3,5,2,41.95601,-87.6802
13249,5,18,false,7,2,-5,41.95606,-87.66885
13379,5,18,false,10,5,-5,41.95786,-87.6495
TA1309000027,5,18,false,7,4,-3,41.9585,-87.65499
13389,5,18,false,12,5,-7,41.961,-87.64958
TA1307000144,5,18,false,2,5,3,41.96142,-87.6762
KA1503000022,5,18,false,4,8,4,41.96158,-87.66609
TA1307000107,5,18,false,6,5,-1,41.96164,-87.65464
TA1308000012,5,18,false,19,34,15,41.96398,-87.63818
13074,5,18,false,6,11,5,41.96521,-87.6582
639,5,18,false,16,23,7,41.96584,-87.64538
TA1309000014,5,18,false,6,4,-2,41.96709,-87.66744
TA1307000158,5,18,false,8,5,-3,41.9671,-87.67904
TA1307000119,5,18,false,5,5,0,41.96796,-87.65
15615,5,18,false,5,1,-4,41.96835,-87.71183
TA1308000021,5,18,false,14,4,-10,41.96883,-87.65765
TA1309000066,5,18,false,8,2,-6,41.9691,-87.67423
KA1504000171,5,18,false,10,14,4,41.97161,-87.65016
TA1309000035,5,18,false,9,11,2,41.97335,-87.66785
13108,5,18,false,6,9,3,41.97379,-87.65971
KA1504000160,5,18,false,3,5,2,41.97564,-87.70143
KA1504000146,5,18,false,15,10,-5,41.978,-87.66805
13109,5,18,false,6,2,-4,41.97835,-87.65976
KA1504000151,5,18,false,5,8,3,41.98359,-87.66916
KA1504000152,5,18,false,28,16,-12,41.98403,-87.65231
15575,5,18,false,2,6,4,41.98975,-87.66014
15571,5,18,false,2,5,3,41.99478,-87.66028
RP-009,5,18,false,1,7,6,42.00107,-87.66122
596,5,18,false,2,5,3,42.04822,-87.68348
605,5,18,false,5,2,-3,42.05294,-87.67342
KA1503000014,5,18,true,6,3,-3,41.7851,-87.60108
KA1503000071,5,18,true,7,6,-1,41.79148,-87.59988
TA1309000063,5,18,true,6,4,-2,41.79325,-87.5878
KA1504000076,5,18,true,7,2,-5,41.7943,-87.60145
TA1308000009,5,18,true,12,15,3,41.79522,-87.58075
TA1307000164,5,18,true,9,6,-3,41.79527,-87.59647
TA1309000037,5,18,true,5,10,5,41.79957,-87.59474
KA1503000007,5,18,true,5,11,6,41.80242,-87.58689
KA1503000069,5,18,true,2,5,3,41.80579,-87.59247
15445,5,18,true,7,8,1,41.83453,-87.63183
13216,5,18,true,9,8,-1,41.83473,-87.62581
13217,5,18,true,5,4,-1,41.83488,-87.61792
13215,5,18,true,5,6,1,41.83634,-87.6135
TA1308000046,5,18,true,1,6,5,41.83779,-87.65115
TA1309000055,5,18,true,7,8,1,41.8382,-87.64514
KA1503000038,5,18,true,5,5,0,41.83845,-87.6354
TA1307000048,5,18,true,11,11,0,41.83855,-87.60821
TA1308000036,5,18,true,7,11,4,41.83883,-87.62186
TA1307000139,5,18,true,8,16,8,41.84205,-87.61698
13075,5,18,true,5,5,0,41.8531,-87.63192
13162,5,18,true,2,6,4,41.85378,-87.64659
15546,5,18,true,2,5,3,41.85416,-87.61916
13307,5,18,true,1,5,4,41.85489,-87.66359
15545,5,18,true,14,20,6,41.85627,-87.61334
SL-013,5,18,true,2,10,8,41.85659,-87.62755
SL-006,5,18,true,4,5,1,41.8568,-87.63387
13135,5,18,true,6,2,-4,41.85753,-87.66157
13102,5,18,true,9,14,5,41.85762,-87.61942
13150,5,18,true,11,10,-1,41.85783,-87.62455
TA1307000159,5,18,true,1,8,7,41.8579,-87.6687
13163,5,18,true,5,3,-2,41.85808,-87.65108
13164,5,18,true,4,7,3,41.85818,-87.65648
SL-012,5,18,true,14,12,-2,41.86038,-87.62581
TA1306000002,5,18,true,5,8,3,41.86238,-87.65108
TA1307000124,5,18,true,14,16,2,41.86411,-87.62372
TA1309000001,5,18,true,6,5,-1,41.86488,-87.64708
13354,5,18,true,5,6,1,41.86524,-87.66651
13431,5,18,true,10,12,2,41.8661,-87.60728
KA1504000101,5,18,true,2,7,5,41.86651,-87.68466
TA1305000002,5,18,true,16,23,7,41.86721,-87.62597
15544,5,18,true,5,4,-1,41.86723,-87.61536
TA1305000017,5,18,true,1,6,5,41.86734,-87.64863
KA1706005007,5,18,true,19,9,-10,41.86749,-87.63219
SL-005,5,18,true,12,22,10,41.8679,-87.62304
644,5,18,true,11,7,-4,41.86859,-87.68625
13139,5,18,true,13,7,-6,41.86893,-87.65913
13160,5,18,true,18,18,0,41.86947,-87.65548
15550,5,18,true,4,6,2,41.87024,-87.63947
TA1309000010,5,18,true,11,19,8,41.87074,-87.62574
SL-009,5,18,true,7,7,0,41.87081,-87.63121
TA1309000064,5,18,true,18,9,-9,41.87127,-87.67369
TA1307000130,5,18,true,11,11,0,41.87178,-87.65103
TA1307000121,5,18,true,16,15,-1,41.87184,-87.64664
SL-008,5,18,true,18,20,2,41.87209,-87.62956
13332,5,18,true,29,32,3,41.87219,-87.6615
SL-011,5,18,true,8,7,-1,41.87256,-87.63356
623,5,18,true,6,10,4,41.87272,-87.62399
KA1504000104,5,18,true,2,6,4,41.87296,-87.66912
SL-007,5,18,true,2,9,7,41.87404,-87.6277
13028,5,18,true,5,4,-1,41.87475,-87.64981
SL-010,5,18,true,6,3,-3,41.87501,-87.63309
13037,5,18,true,5,1,-4,41.87588,-87.64078
624,5,18,true,7,7,0,41.87626,-87.62923
13138,5,18,true,5,3,-2,41.87723,-87.63941
15539,5,18,true,9,9,0,41.87763,-87.64405
13158,5,18,true,17,17,0,41.87764,-87.64957
13157,5,18,true,12,6,-6,41.87773,-87.6548
TA1305000025,5,18,true,13,8,-5,41.87773,-87.63528
13206,5,18,true,3,7,4,41.87794,-87.66201
TA1309000004,5,18,true,6,3,-3,41.87811,-87.63184
638,5,18,true,14,9,-5,41.87827,-87.64078
13011,5,18,true,14,11,-3,41.87931,-87.63993
KA1503000015,5,18,true,20,3,-17,41.87948,-87.6257
15667,5,18,true,8,6,-2,41.8798,-87.68609
TA1309000007,5,18,true,5,1,-4,41.88022,-87.63526
WL-011,5,18,true,10,11,1,41.88034,-87.64273
13156,5,18,true,10,16,6,41.88042,-87.65554
13300,5,18,true,19,15,-4,41.88097,-87.61675
13008,5,18,true,11,6,-5,41.88105,-87.62408
TA1305000006,5,18,true,11,7,-4,41.88122,-87.6296
13056,5,18,true,8,2,-6,41.88168,-87.63951
TA1307000120,5,18,true,31,22,-9,41.88188,-87.64879
13341,5,18,true,23,11,-12,41.88208,-87.63985
13036,5,18,true,7,3,-4,41.8821,-87.62513
TA1305000032,5,18,true,16,19,3,41.88218,-87.64109
13353,5,18,true,11,10,-1,41.88283,-87.6612
654,5,18,true,2,6,4,41.88307,-87.65698
13409,5,18,true,8,9,1,41.8831,-87.6511
KA1503000072,5,18,true,7,7,0,41.88317,-87.63693
WL-012,5,18,true,17,14,-3,41.88337,-87.6412
13053,5,18,true,19,9,-10,41.88365,-87.64863
13001,5,18,true,15,9,-6,41.88397,-87.62459
13155,5,18,true,5,7,2,41.88407,-87.65689
18062,5,18,true,12,11,-1,41.88412,-87.65427
TA1306000010,5,18,true,18,7,-11,41.88419,-87.62961
TA1305000030,5,18,true,13,7,-6,41.88459,-87.63178
15535,5,18,true,9,26,17,41.8846,-87.64455
TA1305000029,5,18,true,18,15,-3,41.88466,-87.62787
13263,5,18,true,19,26,7,41.88467,-87.61952
TA1306000015,5,18,true,12,12,0,41.88549,-87.65232
13021,5,18,true,12,15,3,41.88559,-87.64184
TA1307000111,5,18,true,6,3,-3,41.88582,-87.63548
KA17018054,5,18,true,5,4,-1,41.88595,-87.67701
KA1503000012,5,18,true,7,7,0,41.88599,-87.63089
TA1305000011,5,18,true,12,8,-4,41.886,-87.62418
15534,5,18,true,12,15,3,41.88627,-87.61749
TA1308000029,5,18,true,7,6,-1,41.88673,-87.62225
TA1307000131,5,18,true,13,5,-8,41.88688,-87.62606
KA1503000064,5,18,true,14,12,-2,41.88697,-87.61281
TA1305000022,5,18,true,11,13,2,41.88817,-87.63656
TA1306000003,5,18,true,35,27,-8,41.88867,-87.64442
KA1503000043,5,18,true,35,23,-12,41.88918,-87.63851
13050,5,18,true,18,13,-5,41.88919,-87.62775
TA1307000151,5,18,true,21,20,-1,41.88993,-87.63427
636,5,18,true,14,5,-9,41.88997,-87.63662
KA1503000044,5,18,true,7,6,-1,41.89018,-87.6262
13427,5,18,true,4,11,7,41.89054,-87.62205
13430,5,18,true,18,20,2,41.89077,-87.63169
TA1306000013,5,18,true,22,19,-3,41.89083,-87.61852
RN-,5,18,true,14,12,-2,41.89102,-87.63546
13434,5,18,true,3,7,4,41.89108,-87.66663
TA1308000006,5,18,true,2,5,3,41.89128,-87.67686
TA1307000117,5,18,true,24,35,11,41.89144,-87.62675
13033,5,18,true,20,30,10,41.8916,-87.64835
13194,5,18,true,8,12,4,41.8918,-87.65878
TA1305000003,5,18,true,26,22,-4,41.89187,-87.62061
13022,5,18,true,37,29,-8,41.89227,-87.61205
TA1306000029,5,18,true,20,17,-3,41.89256,-87.61449
13265,5,18,true,12,13,1,41.89383,-87.64172
13045,5,18,true,28,33,5,41.89403,-87.62931
13016,5,18,true,26,16,-10,41.89431,-87.62277
KA1503000041,5,18,true,21,12,-9,41.89452,-87.61798
13196,5,18,true,6,12,6,41.89455,-87.65345
TA1307000062,5,18,true,8,13,5,41.89466,-87.63839
TA1306000012,5,18,true,29,33,4,41.89475,-87.63438
KP1705001026,5,18,true,15,9,-6,41.89483,-87.6323
18058,5,18,true,1,5,4,41.8955,-87.68201
637,5,18,true,2,12,10,41.89563,-87.67209
13132,5,18,true,11,13,2,41.89573,-87.67718
15530,5,18,true,18,12,-6,41.89575,-87.62596
18003,5,18,true,5,3,-2,41.89575,-87.62011
13247,5,18,true,9,13,4,41.89597,-87.66775
TA1305000020,5,18,true,7,11,4,41.89636,-87.65406
13289,5,18,true,7,7,0,41.89638,-87.661
13303,5,18,true,15,15,0,41.89672,-87.63088
13017,5,18,true,11,7,-4,41.89676,-87.6357
13338,5,18,true,11,12,1,41.89697,-87.62173
TA1307000061,5,18,true,10,9,-1,41.89745,-87.62873
13034,5,18,true,17,5,-12,41.89754,-87.62352
TA1306000009,5,18,true,19,9,-10,41.89772,-87.64299
620,5,18,true,5,5,0,41.89817,-87.63754
KA1504000103,5,18,true,10,9,-1,41.89842,-87.68659
15529,5,18,true,14,12,-2,41.89858,-87.62206
TA1307000128,5,18,true,29,36,7,41.89896,-87.6299
657,5,18,true,4,5,1,41.89918,-87.6722
13248,5,18,true,12,7,-5,41.89964,-87.66788
TA1306000011,5,18,true,7,6,-1,41.89994,-87.63443
KA1504000116,5,18,true,12,12,0,41.90023,-87.64299
17660,5,18,true,3,6,3,41.90036,-87.69671
13290,5,18,true,5,7,2,41.90069,-87.66259
13042,5,18,true,31,31,0,41.90097,-87.62377
TA1307000070,5,18,true,7,11,4,41.90133,-87.67742
KA1504000133,5,18,true,18,22,4,41.90234,-87.62773
13241,5,18,true,2,6,4,41.9029,-87.68731
TA1307000039,5,18,true,36,41,5,41.90294,-87.63137
658,5,18,true,4,6,2,41.903,-87.6838
13256,5,18,true,6,6,0,41.90302,-87.69749
TA1305000034,5,18,true,13,15,2,41.90313,-87.67391
KA1504000135,5,18,true,31,48,17,41.90319,-87.63439
13136,5,18,true,10,6,-4,41.90326,-87.67845
13061,5,18,true,25,34,9,41.90342,-87.66779
KA1504000079,5,18,true,6,5,-1,41.9035,-87.64334
TA1308000049,5,18,true,28,26,-2,41.90672,-87.6349
KA1504000134,5,18,true,9,13,4,41.90687,-87.6262
13224,5,18,true,8,8,0,41.90706,-87.66725
TA1307000143,5,18,true,5,5,0,41.90762,-87.63854
13221,5,18,true,14,21,7,41.90765,-87.67254
TA1309000024,5,18,true,18,23,5,41.908,-87.63152
TA1305000041,5,18,true,16,10,-6,41.9094,-87.67769
331,5,18,true,17,20,3,41.90965,-87.64812
TA1305000037,5,18,true,13,14,1,41.91018,-87.67003
TA1306000008,5,18,true,2,11,9,41.9102,-87.6435
TA1308000005,5,18,true,10,6,-4,41.91042,-87.68238
13154,5,18,true,18,18,0,41.91054,-87.65312
13058,5,18,true,12,22,10,41.91059,-87.64942
TA1307000038,5,18,true,19,22,3,41.91138,-87.63868
LF-005,5,18,true,24,74,50,41.91172,-87.62681
13128,5,18,true,11,13,2,41.91197,-87.63197
TA1308000050,5,18,true,39,42,3,41.91211,-87.6347
13243,5,18,true,10,10,0,41.91262,-87.6814
TA1309000032,5,18,true,3,5,2,41.91293,-87.66417
TA1306000032,5,18,true,10,14,4,41.9137,-87.65285
TA1307000166,5,18,true,4,10,6,41.91386,-87.64877
18067,5,18,true,8,6,-2,41.9146,-87.66796
TA1306000007,5,18,true,7,9,2,41.91469,-87.64333
13068,5,18,true,7,11,4,41.91554,-87.68703
13179,5,18,true,39,42,3,41.9157,-87.63461
13133,5,18,true,10,3,-7,41.91598,-87.67733
TA1305000039,5,18,true,9,9,0,41.9163,-87.66749
15651,5,18,true,2,5,3,41.91752,-87.70181
13266,5,18,true,5,9,4,41.91774,-87.69142
TA1309000006,5,18,true,8,10,2,41.91809,-87.64375
TA1307000163,5,18,true,13,12,-1,41.91821,-87.65696
13146,5,18,true,26,23,-3,41.91831,-87.63629
13059,5,18,true,28,24,-4,41.91845,-87.65222
13192,5,18,true,10,9,-1,41.91995,-87.64884
13288,5,18,true,8,5,-3,41.92008,-87.67788
13242,5,18,true,3,10,7,41.92021,-87.69266
TA1309000030,5,18,true,15,12,-3,41.92077,-87.66372
TA1309000033,5,18,true,20,9,-11,41.92158,-87.65381
13193,5,18,true,24,23,-1,41.92182,-87.64412
13191,5,18,true,15,11,-4,41.92217,-87.63891
13084,5,18,true,11,9,-2,41.92268,-87.69715
LP-,5,18,true,12,10,-2,41.92396,-87.63584
15648,5,18,true,2,6,4,41.92464,-87.68931
TA1307000001,5,18,true,8,7,-1,41.92535,-87.66581
TA1306000026,5,18,true,8,12,4,41.92558,-87.65842
TA1306000016,5,18,true,19,20,1,41.9256,-87.65371
TA1309000019,5,18,true,16,19,3,41.92586,-87.63897
TA1309000058,5,18,true,24,22,-2,41.92591,-87.64927
TA1308000001,5,18,true,29,26,-3,41.92627,-87.63086
13124,5,18,true,6,6,0,41.92675,-87.63444
TA1309000023,5,18,true,16,19,3,41.9287,-87.65383
TA1307000113,5,18,true,14,15,1,41.92878,-87.66391
13296,5,18,true,7,8,1,41.92883,-87.66852
TA1309000059,5,18,true,5,7,2,41.92889,-87.65898
TA1309000061,5,18,true,18,18,0,41.92915,-87.64909
TA1308000031,5,18,true,6,7,1,41.92946,-87.68417
TA1305000014,5,18,true,13,22,9,41.92956,-87.64313
13085,5,18,true,9,7,-2,41.92958,-87.70789
TA1307000142,5,18,true,29,28,-1,41.93125,-87.64432
13276,5,18,true,24,13,-11,41.93132,-87.63874
13271,5,18,true,10,5,-5,41.93192,-87.67784
TA1307000064,5,18,true,11,20,9,41.93222,-87.65864
TA1306000014,5,18,true,20,16,-4,41.93242,-87.65271
TA1309000039,5,18,true,34,25,-9,41.93258,-87.63642
13294,5,18,true,4,8,4,41.9326,-87.66595
TA1309000036,5,18,true,19,20,1,41.93313,-87.64776
TA1307000006,5,18,true,14,10,-4,41.93571,-87.6636
13268,5,18,true,5,5,0,41.93588,-87.67843
13269,5,18,true,6,10,4,41.93609,-87.66983
TA1307000052,5,18,true,16,24,8,41.93628,-87.65266
TA1307000136,5,18,true,14,25,11,41.9365,-87.64755
TA1307000041,5,18,true,23,30,7,41.93669,-87.63683
13137,5,18,true,21,31,10,41.9376,-87.6441
15642,5,18,true,1,7,6,41.93843,-87.69801
KA17018068,5,18,true,5,6,1,41.93935,-87.68327
TA1309000042,5,18,true,13,6,-7,41.93937,-87.66836
13229,5,18,true,9,9,0,41.93946,-87.66376
TA1308000019,5,18,true,16,14,-2,41.93973,-87.65886
13277,5,18,true,14,16,2,41.9401,-87.64546
TA1307000134,5,18,true,26,22,-4,41.94016,-87.65303
TA1309000049,5,18,true,25,26,1,41.94077,-87.63919
TA1307000138,5,18,true,23,9,-14,41.94334,-87.67094
13144,5,18,true,5,7,2,41.9434,-87.67964
TA1309000025,5,18,true,18,17,-1,41.94368,-87.64894
13071,5,18,true,12,22,10,41.94373,-87.66401
632,5,18,true,18,19,1,41.94453,-87.6547
13278,5,18,true,21,18,-3,41.94553,-87.64644
TA1309000050,5,18,true,1,5,4,41.94618,-87.67331
13235,5,18,true,14,25,11,41.94814,-87.66396
13253,5,18,true,9,1,-8,41.9488,-87.67527
13325,5,18,true,11,21,10,41.94907,-87.64863
TA1307000126,5,18,true,13,26,13,41.94936,-87.65451
TA1307000150,5,18,true,15,19,4,41.94945,-87.64646
13319,5,18,true,9,11,2,41.95069,-87.6687
TA1307000127,5,18,true,15,13,-2,41.9508,-87.65918
13323,5,18,true,9,18,9,41.95282,-87.65
TA1309000043,5,18,true,7,5,-2,41.95417,-87.66434
13063,5,18,true,15,7,-8,41.95424,-87.65441
KA1504000158,5,18,true,5,6,1,41.95432,-87.68607
TA1308000022,5,18,true,11,4,-7,41.95438,-87.64805
TA1307000149,5,18,true,7,6,-1,41.95467,-87.67392
TA1309000026,5,18,true,4,11,7,41.95601,-87.6802
13249,5,18,true,5,2,-3,41.95606,-87.66885
TA1308000047,5,18,true,2,5,3,41.95709,-87.6642
13379,5,18,true,12,16,4,41.95786,-87.6495
TA1309000027,5,18,true,9,8,-1,41.9585,-87.65499
13389,5,18,true,14,7,-7,41.961,-87.64958
15622,5,18,true,1,6,5,41.96108,-87.69544
TA1307000144,5,18,true,4,5,1,41.96142,-87.6762
TA1309000021,5,18,true,4,5,1,41.9615,-87.6714
15623,5,18,true,5,4,-1,41.96154,-87.69117
KA1503000022,5,18,true,6,6,0,41.96158,-87.66609
TA1307000107,5,18,true,10,14,4,41.96164,-87.65464
TA1307000156,5,18,true,4,5,1,41.96301,-87.68479
TA1308000012,5,18,true,19,26,7,41.96398,-87.63818
13074,5,18,true,16,9,-7,41.96521,-87.6582
639,5,18,true,14,18,4,41.96584,-87.64538
KA1504000093,5,18,true,4,7,3,41.96587,-87.69365
TA1307000140,5,18,true,7,6,-1,41.96643,-87.68865
TA1309000014,5,18,true,7,8,1,41.96709,-87.66744
TA1307000158,5,18,true,7,7,0,41.9671,-87.67904
TA1307000119,5,18,true,5,4,-1,41.96796,-87.65
TA1309000015,5,18,true,7,8,1,41.96889,-87.68401
TA1309000066,5,18,true,18,9,-9,41.9691,-87.67423
TA1309000041,5,18,true,8,10,2,41.96951,-87.65471
KA1504000171,5,18,true,4,5,1,41.97161,-87.65016
TA1309000035,5,18,true,14,13,-1,41.97335,-87.66785
13108,5,18,true,8,14,6,41.97379,-87.65971
KA1504000078,5,18,true,3,6,3,41.97491,-87.69258
KA1504000146,5,18,true,6,13,7,41.978,-87.66805
13109,5,18,true,12,7,-5,41.97835,-87.65976
KA1504000151,5,18,true,6,9,3,41.98359,-87.66916
KA1504000152,5,18,true,24,23,-1,41.98403,-87.65231
15578,5,18,true,4,6,2,41.98405,-87.66027
15575,5,18,true,6,8,2,41.98975,-87.66014
15571,5,18,true,10,11,1,41.99478,-87.66028
RP-009,5,18,true,2,5,3,42.00107,-87.66122
660,5,18,true,2,7,5,42.00458,-87.66143
KA1504000175,5,18,true,4,6,2,42.00797,-87.66549
E002,5,18,true,3,5,2,42.03256,-87.67912
596,5,18,true,6,1,-5,42.04822,-87.68348
605,5,18,true,5,3,-2,42.05294,-87.67342
661,5,18,true,1,5,4,42.05704,-87.68657
604,5,18,true,8,1,-7,42.05824,-87.67744
KA1503000014,5,19,false,5,8,3,41.7851,-87.60108
KA1503000071,5,19,false,2,5,3,41.79148,-87.59988
TA1309000063,5,19,false,2,7,5,41.79325,-87.5878
TA1308000009,5,19,false,12,16,4,41.79522,-87.58075
TA1307000164,5,19,false,7,3,-4,41.79527,-87.59647
KA1503000052,5,19,false,3,5,2,41.79935,-87.60097
KA1503000059,5,19,false,5,9,4,41.79952,-87.58643
TA1309000037,5,19,false,9,14,5,41.79957,-87.59474
TA1307000129,5,19,false,2,7,5,41.83104,-87.62683
KA1503000004,5,19,false,6,8,2,41.83127,-87.6088
13215,5,19,false,9,6,-3,41.83634,-87.6135
TA1308000046,5,19,false,3,5,2,41.83779,-87.65115
TA1307000048,5,19,false,14,15,1,41.83855,-87.60821
TA1308000026,5,19,false,8,4,-4,41.85008,-87.63214
TA1305000001,5,19,false,2,6,4,41.85262,-87.6265
13075,5,19,false,7,3,-4,41.8531,-87.63192
15545,5,19,false,9,3,-6,41.85627,-87.61334
SL-013,5,19,false,12,3,-9,41.85659,-87.62755
SL-006,5,19,false,8,4,-4,41.8568,-87.63387
13102,5,19,false,6,8,2,41.85762,-87.61942
SL-012,5,19,false,8,12,4,41.86038,-87.62581
TA1307000124,5,19,false,13,8,-5,41.86411,-87.62372
TA1309000001,5,19,false,1,11,10,41.86488,-87.64708
13431,5,19,false,14,15,1,41.8661,-87.60728
TA1305000002,5,19,false,13,19,6,41.86721,-87.62597
15544,5,19,false,11,24,13,41.86723,-87.61536
SL-005,5,19,false,24,32,8,41.8679,-87.62304
13139,5,19,false,3,5,2,41.86893,-87.65913
TA1309000010,5,19,false,17,11,-6,41.87074,-87.62574
TA1307000130,5,19,false,9,7,-2,41.87178,-87.65103
SL-008,5,19,false,9,13,4,41.87209,-87.62956
SL-011,5,19,false,18,12,-6,41.87256,-87.63356
623,5,19,false,21,15,-6,41.87272,-87.62399
SL-007,5,19,false,6,8,2,41.87404,-87.6277
SL-010,5,19,false,7,7,0,41.87501,-87.63309
15541,5,19,false,29,30,1,41.8758,-87.62086
TA1305000009,5,19,false,8,1,-7,41.87593,-87.63068
624,5,19,false,6,1,-5,41.87626,-87.62923
TA1305000035,5,19,false,7,5,-2,41.87716,-87.62787
13158,5,19,false,5,14,9,41.87764,-87.64957
TA1305000025,5,19,false,5,9,4,41.87773,-87.63528
TA1309000002,5,19,false,10,8,-2,41.87784,-87.62408
TA1305000005,5,19,false,5,5,0,41.87924,-87.62975
13011,5,19,false,6,2,-4,41.87931,-87.63993
TA1309000008,5,19,false,6,3,-3,41.87933,-87.6355
KA1503000015,5,19,false,1,7,6,41.87948,-87.6257
TA1309000007,5,19,false,5,10,5,41.88022,-87.63526
WL-011,5,19,false,4,5,1,41.88034,-87.64273
13156,5,19,false,14,10,-4,41.88042,-87.65554
13300,5,19,false,53,45,-8,41.88097,-87.61675
13008,5,19,false,33,50,17,41.88105,-87.62408
TA1305000006,5,19,false,5,4,-1,41.88122,-87.6296
TA1307000120,5,19,false,14,13,-1,41.88188,-87.64879
13341,5,19,false,5,6,1,41.88208,-87.63985
13036,5,19,false,5,6,1,41.8821,-87.62513
TA1305000032,5,19,false,9,8,-1,41.88218,-87.64109
13353,5,19,false,4,10,6,41.88283,-87.6612
654,5,19,false,6,11,5,41.88307,-87.65698
13409,5,19,false,9,8,-1,41.8831,-87.6511
WL-012,5,19,false,9,8,-1,41.88337,-87.6412
13053,5,19,false,11,18,7,41.88365,-87.64863
13001,5,19,false,18,13,-5,41.88397,-87.62459
13155,5,19,false,2,9,7,41.88407,-87.65689
18062,5,19,false,9,8,-1,41.88412,-87.65427
TA1306000010,5,19,false,9,13,4,41.88419,-87.62961
TA1305000030,5,19,false,16,5,-11,41.88459,-87.63178
15535,5,19,false,16,17,1,41.8846,-87.64455
TA1305000029,5,19,false,12,14,2,41.88466,-87.62787
13263,5,19,false,29,19,-10,41.88467,-87.61952
TA1306000015,5,19,false,7,13,6,41.88549,-87.65232
13021,5,19,false,15,8,-7,41.88559,-87.64184
TA1307000111,5,19,false,6,15,9,41.88582,-87.63548
KA1503000012,5,19,false,9,8,-1,41.88599,-87.63089
TA1305000011,5,19,false,22,20,-2,41.886,-87.62418
15534,5,19,false,7,12,5,41.88627,-87.61749
TA1308000029,5,19,false,12,8,-4,41.88673,-87.62225
TA1307000131,5,19,false,13,20,7,41.88688,-87.62606
KA1503000064,5,19,false,14,9,-5,41.88697,-87.61281
TA1305000022,5,19,false,8,10,2,41.88817,-87.63656
TA1306000003,5,19,false,17,13,-4,41.88867,-87.64442
KA1503000043,5,19,false,13,9,-4,41.88918,-87.63851
13050,5,19,false,22,18,-4,41.88919,-87.62775
13432,5,19,false,2,5,3,41.88989,-87.67149
TA1307000151,5,19,false,30,22,-8,41.88993,-87.63427
636,5,19,false,10,3,-7,41.88997,-87.63662
KA1503000044,5,19,false,8,8,0,41.89018,-87.6262
13427,5,19,false,15,10,-5,41.89054,-87.62205
13430,5,19,false,17,26,9,41.89077,-87.63169
TA1306000013,5,19,false,28,33,5,41.89083,-87.61852
RN-,5,19,false,14,7,-7,41.89102,-87.63546
13434,5,19,false,9,9,0,41.89108,-87.66663
TA1308000006,5,19,false,5,3,-2,41.89128,-87.67686
TA1307000117,5,19,false,32,38,6,41.89144,-87.62675
13033,5,19,false,19,20,1,41.8916,-87.64835
13194,5,19,false,5,7,2,41.8918,-87.65878
TA1305000003,5,19,false,24,39,15,41.89187,-87.62061
13022,5,19,false,153,146,-7,41.89227,-87.61205
TA1306000029,5,19,false,29,34,5,41.89256,-87.61449
13265,5,19,false,11,7,-4,41.89383,-87.64172
13045,5,19,false,14,12,-2,41.89403,-87.62931
13016,5,19,false,12,7,-5,41.89431,-87.62277
KA1503000041,5,19,false,7,7,0,41.89452,-87.61798
13196,5,19,false,5,8,3,41.89455,-87.65345
TA1307000062,5,19,false,6,8,2,41.89466,-87.63839
TA1306000012,5,19,false,11,21,10,41.89475,-87.63438
KP1705001026,5,19,false,15,9,-6,41.89483,-87.6323
18058,5,19,false,9,3,-6,41.8955,-87.68201
637,5,19,false,2,9,7,41.89563,-87.67209
13132,5,19,false,7,10,3,41.89573,-87.67718
15530,5,19,false,9,10,1,41.89575,-87.62596
13247,5,19,false,6,8,2,41.89597,-87.66775
TA1305000020,5,19,false,6,5,-1,41.89636,-87.65406
13289,5,19,false,8,6,-2,41.89638,-87.661
13303,5,19,false,12,19,7,41.89672,-87.63088
13017,5,19,false,3,5,2,41.89676,-87.6357
TA1307000061,5,19,false,10,1,-9,41.89745,-87.62873
13034,5,19,false,16,12,-4,41.89754,-87.62352
TA1306000009,5,19,false,11,3,-8,41.89772,-87.64299
620,5,19,false,4,6,2,41.89817,-87.63754
KA1504000103,5,19,false,3,6,3,41.89842,-87.68659
15529,5,19,false,11,12,1,41.89858,-87.62206
TA1307000128,5,19,false,14,6,-8,41.89896,-87.6299
657,5,19,false,3,8,5,41.89918,-87.6722
TA1306000011,5,19,false,6,8,2,41.89994,-87.63443
13290,5,19,false,4,11,7,41.90069,-87.66259
13042,5,19,false,46,46,0,41.90097,-87.62377
KA1504000133,5,19,false,21,21,0,41.90234,-87.62773
13241,5,19,false,3,7,4,41.9029,-87.68731
TA1307000039,5,19,false,32,33,1,41.90294,-87.63137
TA1305000034,5,19,false,9,16,7,41.90313,-87.67391
KA1504000135,5,19,false,34,33,-1,41.90319,-87.63439
13136,5,19,false,7,12,5,41.90326,-87.67845
13061,5,19,false,19,22,3,41.90342,-87.66779
KA1504000079,5,19,false,7,13,6,41.9035,-87.64334
TA1307000115,5,19,false,5,4,-1,41.9046,-87.64056
TA1308000049,5,19,false,20,27,7,41.90672,-87.6349
KA1504000134,5,19,false,17,9,-8,41.90687,-87.6262
13224,5,19,false,3,12,9,41.90706,-87.66725
TA1307000143,5,19,false,5,6,1,41.90762,-87.63854
13221,5,19,false,22,12,-10,41.90765,-87.67254
TA1309000024,5,19,false,16,18,2,41.908,-87.63152
TA1305000041,5,19,false,26,38,12,41.9094,-87.67769
331,5,19,false,15,11,-4,41.90965,-87.64812
TA1305000037,5,19,false,8,23,15,41.91018,-87.67003
TA1306000008,5,19,false,4,9,5,41.9102,-87.6435
TA1308000005,5,19,false,1,9,8,41.91042,-87.68238
13258,5,19,false,6,3,-3,41.91043,-87.69718
13257,5,19,false,5,8,3,41.91054,-87.68956
13154,5,19,false,6,3,-3,41.91054,-87.65312
13058,5,19,false,11,11,0,41.91059,-87.64942
TA1307000038,5,19,false,21,29,8,41.91138,-87.63868
LF-005,5,19,false,75,96,21,41.91172,-87.62681
13128,5,19,false,11,10,-1,41.91197,-87.63197
TA1308000050,5,19,false,38,47,9,41.91211,-87.6347
13243,5,19,false,14,19,5,41.91262,-87.6814
TA1306000032,5,19,false,7,3,-4,41.9137,-87.65285
TA1307000166,5,19,false,10,12,2,41.91386,-87.64877
18017,5,19,false,4,5,1,41.91416,-87.71676
18067,5,19,false,21,5,-16,41.9146,-87.66796
13068,5,19,false,6,15,9,41.91554,-87.68703
13179,5,19,false,24,30,6,41.9157,-87.63461
13133,5,19,false,5,6,1,41.91598,-87.67733
TA1305000039,5,19,false,8,3,-5,41.9163,-87.66749
15650,5,19,false,2,5,3,41.91711,-87.71023
15651,5,19,false,11,6,-5,41.91752,-87.70181
TA1309000029,5,19,false,5,3,-2,41.9178,-87.68245
TA1309000006,5,19,false,3,9,6,41.91809,-87.64375
TA1307000163,5,19,false,15,8,-7,41.91821,-87.65696
13146,5,19,false,21,36,15,41.91831,-87.63629
13059,5,19,false,14,15,1,41.91845,-87.65222
13259,5,19,false,3,7,4,41.91852,-87.69744
13192,5,19,false,9,21,12,41.91995,-87.64884
13288,5,19,false,2,6,4,41.92008,-87.67788
13242,5,19,false,3,9,6,41.92021,-87.69266
TA1309000030,5,19,false,6,1,-5,41.92077,-87.66372
13292,5,19,false,7,4,-3,41.92152,-87.70733
TA1309000033,5,19,false,11,15,4,41.92158,-87.65381
13193,5,19,false,39,40,1,41.92182,-87.64412
13191,5,19,false,11,12,1,41.92217,-87.63891
13084,5,19,false,13,15,2,41.92268,-87.69715
LP-,5,19,false,8,12,4,41.92396,-87.63584
KA1504000140,5,19,false,6,2,-4,41.92409,-87.67646
KA1504000090,5,19,false,8,6,-2,41.92483,-87.7145
TA1307000001,5,19,false,14,14,0,41.92535,-87.66581
TA1306000026,5,19,false,14,8,-6,41.92558,-87.65842
TA1306000016,5,19,false,22,9,-13,41.9256,-87.65371
TA1309000019,5,19,false,22,20,-2,41.92586,-87.63897
TA1309000058,5,19,false,25,23,-2,41.92591,-87.64927
TA1308000001,5,19,false,47,52,5,41.92627,-87.63086
15646,5,19,false,2,8,6,41.92668,-87.6977
13124,5,19,false,10,2,-8,41.92675,-87.63444
TA1309000023,5,19,false,23,23,0,41.9287,-87.65383
TA1307000113,5,19,false,11,16,5,41.92878,-87.66391
13296,5,19,false,5,3,-2,41.92883,-87.66852
TA1309000059,5,19,false,6,4,-2,41.92889,-87.65898
TA1309000061,5,19,false,13,24,11,41.92915,-87.64909
TA1305000014,5,19,false,17,20,3,41.92956,-87.64313
13085,5,19,false,3,13,10,41.92958,-87.70789
TA1307000142,5,19,false,18,24,6,41.93125,-87.64432
13276,5,19,false,11,21,10,41.93132,-87.63874
TA1307000064,5,19,false,14,13,-1,41.93222,-87.65864
TA1306000014,5,19,false,19,16,-3,41.93242,-87.65271
TA1309000039,5,19,false,28,23,-5,41.93258,-87.63642
13294,5,19,false,7,7,0,41.9326,-87.66595
TA1309000036,5,19,false,9,20,11,41.93313,-87.64776
TA1307000006,5,19,false,19,18,-1,41.93571,-87.6636
13268,5,19,false,7,1,-6,41.93588,-87.67843
TA1307000052,5,19,false,18,14,-4,41.93628,-87.65266
TA1307000136,5,19,false,17,17,0,41.9365,-87.64755
TA1307000041,5,19,false,25,15,-10,41.93669,-87.63683
13137,5,19,false,13,23,10,41.9376,-87.6441
TA1309000042,5,19,false,9,14,5,41.93937,-87.66836
13229,5,19,false,13,10,-3,41.93946,-87.66376
TA1308000019,5,19,false,11,20,9,41.93973,-87.65886
13277,5,19,false,16,17,1,41.9401,-87.64546
TA1307000134,5,19,false,8,18,10,41.94016,-87.65303
13143,5,19,false,6,2,-4,41.94059,-87.67853
TA1309000049,5,19,false,24,29,5,41.94077,-87.63919
TA1307000138,5,19,false,4,5,1,41.94334,-87.67094
13144,5,19,false,5,7,2,41.9434,-87.67964
TA1309000025,5,19,false,16,20,4,41.94368,-87.64894
13071,5,19,false,8,14,6,41.94373,-87.66401
632,5,19,false,26,28,2,41.94453,-87.6547
13278,5,19,false,12,13,1,41.94553,-87.64644
TA1309000050,5,19,false,5,3,-2,41.94618,-87.67331
15632,5,19,false,5,3,-2,41.94664,-87.69463
13235,5,19,false,18,16,-2,41.94814,-87.66396
13253,5,19,false,6,3,-3,41.9488,-87.67527
13325,5,19,false,15,16,1,41.94907,-87.64863
TA1307000126,5,19,false,27,45,18,41.94936,-87.65451
TA1307000150,5,19,false,13,17,4,41.94945,-87.64646
13319,5,19,false,11,6,-5,41.95069,-87.6687
TA1307000127,5,19,false,11,13,2,41.9508,-87.65918
13323,5,19,false,6,9,3,41.95282,-87.65
TA1309000043,5,19,false,5,3,-2,41.95417,-87.66434
13063,5,19,false,9,6,-3,41.95424,-87.65441
TA1308000022,5,19,false,6,7,1,41.95438,-87.64805
TA1307000149,5,19,false,5,7,2,41.95467,-87.67392
TA1309000026,5,19,false,4,7,3,41.95601,-87.6802
13379,5,19,false,11,7,-4,41.95786,-87.6495
13389,5,19,false,9,12,3,41.961,-87.64958
KA1503000022,5,19,false,7,5,-2,41.96158,-87.66609
TA1307000107,5,19,false,6,8,2,41.96164,-87.65464
TA1307000156,5,19,false,8,4,-4,41.96301,-87.68479
TA1308000012,5,19,false,32,18,-14,41.96398,-87.63818
13074,5,19,false,4,7,3,41.96521,-87.6582
639,5,19,false,7,16,9,41.96584,-87.64538
TA1309000014,5,19,false,4,9,5,41.96709,-87.66744
TA1308000021,5,19,false,5,15,10,41.96883,-87.65765
TA1309000066,5,19,false,8,6,-2,41.9691,-87.67423
TA1309000041,5,19,false,6,8,2,41.96951,-87.65471
KA1504000171,5,19,false,2,8,6,41.97161,-87.65016
TA1309000035,5,19,false,13,10,-3,41.97335,-87.66785
13108,5,19,false,11,3,-8,41.97379,-87.65971
KA1504000146,5,19,false,3,5,2,41.978,-87.66805
13109,5,19,false,12,4,-8,41.97835,-87.65976
KA1504000151,5,19,false,6,7,1,41.98359,-87.66916
KA1504000152,5,19,false,18,15,-3,41.98403,-87.65231
15578,5,19,false,2,5,3,41.98405,-87.66027
15575,5,19,false,7,5,-2,41.98975,-87.66014
RP-009,5,19,false,2,9,7,42.00107,-87.66122
RP-001,5,19,false,4,6,2,42.00179,-87.68883
596,5,19,false,8,10,2,42.04822,-87.68348
E008,5,19,false,3,7,4,42.05049,-87.67782
604,5,19,false,8,3,-5,42.05824,-87.67744
KA1503000014,5,19,true,6,10,4,41.7851,-87.60108
TA1308000009,5,19,true,14,12,-2,41.79522,-87.58075
TA1307000164,5,19,true,12,3,-9,41.79527,-87.59647
KA1503000052,5,19,true,4,6,2,41.79935,-87.60097
TA1309000037,5,19,true,9,11,2,41.79957,-87.59474
13398,5,19,true,3,6,3,41.80256,-87.59035
13216,5,19,true,6,4,-2,41.83473,-87.62581
13217,5,19,true,7,11,4,41.83488,-87.61792
13215,5,19,true,9,7,-2,41.83634,-87.6135
TA1309000055,5,19,true,7,5,-2,41.8382,-87.64514
KA1503000038,5,19,true,6,5,-1,41.83845,-87.6354
TA1307000048,5,19,true,2,8,6,41.83855,-87.60821
TA1307000139,5,19,true,16,5,-11,41.84205,-87.61698
13075,5,19,true,6,5,-1,41.8531,-87.63192
15545,5,19,true,28,21,-7,41.85627,-87.61334
SL-006,5,19,true,2,6,4,41.8568,-87.63387
13102,5,19,true,1,7,6,41.85762,-87.61942
13150,5,19,true,4,7,3,41.85783,-87.62455
SL-012,5,19,true,3,5,2,41.86038,-87.62581
TA1306000002,5,19,true,2,10,8,41.86238,-87.65108
TA1307000124,5,19,true,15,3,-12,41.86411,-87.62372
13354,5,19,true,10,2,-8,41.86524,-87.66651
13431,5,19,true,13,15,2,41.8661,-87.60728
WL-008,5,19,true,14,5,-9,41.86712,-87.64108
TA1305000002,5,19,true,24,21,-3,41.86721,-87.62597
15544,5,19,true,4,12,8,41.86723,-87.61536
SL-005,5,19,true,15,19,4,41.8679,-87.62304
644,5,19,true,7,5,-2,41.86859,-87.68625
13139,5,19,true,16,8,-8,41.86893,-87.65913
13285,5,19,true,6,2,-4,41.86928,-87.67372
13160,5,19,true,11,11,0,41.86947,-87.65548
15550,5,19,true,5,3,-2,41.87024,-87.63947
TA1309000010,5,19,true,12,8,-4,41.87074,-87.62574
TA1307000130,5,19,true,11,11,0,41.87178,-87.65103
TA1307000121,5,19,true,9,3,-6,41.87184,-87.64664
SL-008,5,19,true,11,15,4,41.87209,-87.62956
13332,5,19,true,18,21,3,41.87219,-87.6615
SL-011,5,19,true,8,11,3,41.87256,-87.63356
623,5,19,true,5,8,3,41.87272,-87.62399
TA1306000025,5,19,true,6,7,1,41.87464,-87.65703
13028,5,19,true,9,3,-6,41.87475,-87.64981
SL-010,5,19,true,4,6,2,41.87501,-87.63309
15541,5,19,true,5,8,3,41.8758,-87.62086
13037,5,19,true,3,5,2,41.87588,-87.64078
TA1305000035,5,19,true,5,4,-1,41.87716,-87.62787
15539,5,19,true,2,10,8,41.87763,-87.64405
13158,5,19,true,11,15,4,41.87764,-87.64957
13157,5,19,true,9,8,-1,41.87773,-87.6548
TA1305000025,5,19,true,4,13,9,41.87773,-87.63528
13206,5,19,true,6,7,1,41.87794,-87.66201
TA1305000005,5,19,true,7,2,-5,41.87924,-87.62975
13011,5,19,true,8,2,-6,41.87931,-87.63993
TA1309000007,5,19,true,7,1,-6,41.88022,-87.63526
WL-011,5,19,true,7,12,5,41.88034,-87.64273
13156,5,19,true,5,6,1,41.88042,-87.65554
13300,5,19,true,17,19,2,41.88097,-87.61675
13008,5,19,true,8,8,0,41.88105,-87.62408
TA1305000006,5,19,true,7,10,3,41.88122,-87.6296
TA1307000120,5,19,true,13,18,5,41.88188,-87.64879
13341,5,19,true,12,6,-6,41.88208,-87.63985
TA1305000032,5,19,true,17,4,-13,41.88218,-87.64109
13353,5,19,true,6,7,1,41.88283,-87.6612
13409,5,19,true,2,11,9,41.8831,-87.6511
WL-012,5,19,true,17,8,-9,41.88337,-87.6412
13053,5,19,true,9,10,1,41.88365,-87.64863
13001,5,19,true,10,11,1,41.88397,-87.62459
13155,5,19,true,2,6,4,41.88407,-87.65689
18062,5,19,true,4,7,3,41.88412,-87.65427
TA1306000010,5,19,true,22,13,-9,41.88419,-87.62961
TA1305000030,5,19,true,14,3,-11,41.88459,-87.63178
15535,5,19,true,13,15,2,41.8846,-87.64455
TA1305000029,5,19,true,18,7,-11,41.88466,-87.62787
13263,5,19,true,25,17,-8,41.88467,-87.61952
TA1306000015,5,19,true,7,5,-2,41.88549,-87.65232
13021,5,19,true,12,9,-3,41.88559,-87.64184
TA1307000111,5,19,true,9,9,0,41.88582,-87.63548
13073,5,19,true,7,2,-5,41.88592,-87.66717
KA1503000012,5,19,true,8,9,1,41.88599,-87.63089
TA1305000011,5,19,true,14,8,-6,41.886,-87.62418
15534,5,19,true,8,4,-4,41.88627,-87.61749
TA1308000029,5,19,true,7,3,-4,41.88673,-87.62225
TA1307000131,5,19,true,9,9,0,41.88688,-87.62606
KA1503000064,5,19,true,10,13,3,41.88697,-87.61281
TA1305000022,5,19,true,19,18,-1,41.88817,-87.63656
TA1306000003,5,19,true,26,16,-10,41.88867,-87.64442
KA1503000043,5,19,true,15,17,2,41.88918,-87.63851
13050,5,19,true,12,13,1,41.88919,-87.62775
TA1307000151,5,19,true,18,12,-6,41.88993,-87.63427
636,5,19,true,8,6,-2,41.88997,-87.63662
13427,5,19,true,11,6,-5,41.89054,-87.62205
13430,5,19,true,21,19,-2,41.89077,-87.63169
TA1306000013,5,19,true,15,21,6,41.89083,-87.61852
RN-,5,19,true,8,10,2,41.89102,-87.63546
13434,5,19,true,4,5,1,41.89108,-87.66663
TA1308000006,5,19,true,3,5,2,41.89128,-87.67686
TA1307000117,5,19,true,14,16,2,41.89144,-87.62675
13033,5,19,true,8,14,6,41.8916,-87.64835
13194,5,19,true,6,8,2,41.8918,-87.65878
TA1305000003,5,19,true,14,17,3,41.89187,-87.62061
13022,5,19,true,36,44,8,41.89227,-87.61205
TA1306000029,5,19,true,13,14,1,41.89256,-87.61449
13265,5,19,true,20,23,3,41.89383,-87.64172
13045,5,19,true,12,11,-1,41.89403,-87.62931
13016,5,19,true,20,10,-10,41.89431,-87.62277
KA1503000041,5,19,true,16,11,-5,41.89452,-87.61798
13196,5,19,true,3,5,2,41.89455,-87.65345
TA1307000062,5,19,true,8,7,-1,41.89466,-87.63839
TA1306000012,5,19,true,17,19,2,41.89475,-87.63438
KP1705001026,5,19,true,15,14,-1,41.89483,-87.6323
18058,5,19,true,2,6,4,41.8955,-87.68201
637,5,19,true,7,12,5,41.89563,-87.67209
13132,5,19,true,2,11,9,41.89573,-87.67718
15530,5,19,true,14,13,-1,41.89575,-87.62596
TA1305000020,5,19,true,8,5,-3,41.89636,-87.65406
13289,5,19,true,9,12,3,41.89638,-87.661
13303,5,19,true,11,13,2,41.89672,-87.63088
13017,5,19,true,4,9,5,41.89676,-87.6357
13338,5,19,true,9,5,-4,41.89697,-87.62173
13034,5,19,true,8,2,-6,41.89754,-87.62352
TA1306000009,5,19,true,19,13,-6,41.89772,-87.64299
620,5,19,true,9,7,-2,41.89817,-87.63754
KA1504000103,5,19,true,7,9,2,41.89842,-87.68659
15529,5,19,true,21,10,-11,41.89858,-87.62206
TA1307000128,5,19,true,17,15,-2,41.89896,-87.6299
13248,5,19,true,3,7,4,41.89964,-87.66788
TA1306000011,5,19,true,9,9,0,41.89994,-87.63443
KA1504000116,5,19,true,6,5,-1,41.90023,-87.64299
17660,5,19,true,2,6,4,41.90036,-87.69671
13290,5,19,true,7,11,4,41.90069,-87.66259
13042,5,19,true,25,28,3,41.90097,-87.62377
KA1504000133,5,19,true,17,10,-7,41.90234,-87.62773
13241,5,19,true,5,7,2,41.9029,-87.68731
TA1306000006,5,19,true,5,3,-2,41.90292,-87.63772
TA1307000039,5,19,true,47,25,-22,41.90294,-87.63137
658,5,19,true,2,9,7,41.903,-87.6838
TA1305000034,5,19,true,6,10,4,41.90313,-87.67391
KA1504000135,5,19,true,35,46,11,41.90319,-87.63439
13136,5,19,true,10,10,0,41.90326,-87.67845
13061,5,19,true,22,21,-1,41.90342,-87.66779
KA1504000079,5,19,true,6,8,2,41.9035,-87.64334
TA1307000115,5,19,true,5,11,6,41.9046,-87.64056
TA1308000049,5,19,true,24,28,4,41.90672,-87.6349
KA1504000134,5,19,true,14,9,-5,41.90687,-87.6262
13224,5,19,true,8,13,5,41.90706,-87.66725
13221,5,19,true,8,8,0,41.90765,-87.67254
TA1309000024,5,19,true,12,18,6,41.908,-87.63152
TA1305000041,5,19,true,18,15,-3,41.9094,-87.67769
331,5,19,true,16,13,-3,41.90965,-87.64812
TA1305000037,5,19,true,13,13,0,41.91018,-87.67003
TA1306000008,5,19,true,6,7,1,41.9102,-87.6435
TA1308000005,5,19,true,10,3,-7,41.91042,-87.68238
13258,5,19,true,5,2,-3,41.91043,-87.69718
13154,5,19,true,8,6,-2,41.91054,-87.65312
13058,5,19,true,11,12,1,41.91059,-87.64942
TA1307000038,5,19,true,7,13,6,41.91138,-87.63868
LF-005,5,19,true,48,57,9,41.91172,-87.62681
13128,5,19,true,6,11,5,41.91197,-87.63197
TA1308000050,5,19,true,29,28,-1,41.91211,-87.6347
13243,5,19,true,17,13,-4,41.91262,-87.6814
TA1309000032,5,19,true,1,6,5,41.91293,-87.66417
TA1306000032,5,19,true,10,14,4,41.9137,-87.65285
TA1307000166,5,19,true,9,6,-3,41.91386,-87.64877
15655,5,19,true,2,5,3,41.91401,-87.70514
13068,5,19,true,4,8,4,41.91554,-87.68703
13179,5,19,true,25,36,11,41.9157,-87.63461
13133,5,19,true,7,7,0,41.91598,-87.67733
TA1305000039,5,19,true,6,3,-3,41.9163,-87.66749
15650,5,19,true,4,6,2,41.91711,-87.71023
15651,5,19,true,1,6,5,41.91752,-87.70181
TA1309000029,5,19,true,1,8,7,41.9178,-87.68245
TA1309000006,5,19,true,6,8,2,41.91809,-87.64375
TA1307000163,5,19,true,10,21,11,41.91821,-87.65696
13146,5,19,true,28,28,0,41.91831,-87.63629
13059,5,19,true,6,19,13,41.91845,-87.65222
13192,5,19,true,10,14,4,41.91995,-87.64884
13288,5,19,true,6,5,-1,41.92008,-87.67788
13242,5,19,true,3,8,5,41.92021,-87.69266
TA1309000030,5,19,true,12,6,-6,41.92077,-87.66372
TA1309000033,5,19,true,12,13,1,41.92158,-87.65381
13193,5,19,true,25,22,-3,41.92182,-87.64412
13191,5,19,true,1,13,12,41.92217,-87.63891
13084,5,19,true,12,11,-1,41.92268,-87.69715
LP-,5,19,true,3,9,6,41.92396,-87.63584
TA1307000001,5,19,true,10,10,0,41.92535,-87.66581
TA1306000026,5,19,true,17,29,12,41.92558,-87.65842
TA1306000016,5,19,true,7,10,3,41.9256,-87.65371
TA1309000019,5,19,true,19,19,0,41.92586,-87.63897
TA1309000058,5,19,true,18,15,-3,41.92591,-87.64927
TA1308000001,5,19,true,36,26,-10,41.92627,-87.63086
15646,5,19,true,5,4,-1,41.92668,-87.6977
TA1309000023,5,19,true,15,11,-4,41.9287,-87.65383
TA1307000113,5,19,true,10,13,3,41.92878,-87.66391
TA1309000059,5,19,true,4,10,6,41.92889,-87.65898
TA1309000061,5,19,true,11,22,11,41.92915,-87.64909
TA1305000014,5,19,true,20,21,1,41.92956,-87.64313
13085,5,19,true,5,7,2,41.92958,-87.70789
TA1307000142,5,19,true,29,23,-6,41.93125,-87.64432
13276,5,19,true,11,9,-2,41.93132,-87.63874
13271,5,19,true,4,8,4,41.93192,-87.67784
TA1307000064,5,19,true,13,19,6,41.93222,-87.65864
TA1306000014,5,19,true,21,19,-2,41.93242,-87.65271
TA1309000039,5,19,true,19,22,3,41.93258,-87.63642
13294,5,19,true,5,5,0,41.9326,-87.66595
TA1309000036,5,19,true,24,15,-9,41.93313,-87.64776
TA1307000006,5,19,true,21,12,-9,41.93571,-87.6636
TA1307000052,5,19,true,17,12,-5,41.93628,-87.65266
TA1307000136,5,19,true,15,16,1,41.9365,-87.64755
TA1307000041,5,19,true,21,19,-2,41.93669,-87.63683
13137,5,19,true,31,28,-3,41.9376,-87.6441
15642,5,19,true,2,5,3,41.93843,-87.69801
TA1309000042,5,19,true,11,2,-9,41.93937,-87.66836
13229,5,19,true,15,10,-5,41.93946,-87.66376
TA1308000019,5,19,true,16,12,-4,41.93973,-87.65886
13277,5,19,true,11,13,2,41.9401,-87.64546
TA1307000134,5,19,true,12,22,10,41.94016,-87.65303
13143,5,19,true,2,5,3,41.94059,-87.67853
TA1309000049,5,19,true,17,18,1,41.94077,-87.63919
TA1307000138,5,19,true,8,8,0,41.94334,-87.67094
13144,5,19,true,2,8,6,41.9434,-87.67964
TA1309000025,5,19,true,17,18,1,41.94368,-87.64894
13071,5,19,true,15,13,-2,41.94373,-87.66401
632,5,19,true,20,20,0,41.94453,-87.6547
13278,5,19,true,7,21,14,41.94553,-87.64644
13235,5,19,true,15,17,2,41.94814,-87.66396
13325,5,19,true,13,16,3,41.94907,-87.64863
TA1307000126,5,19,true,7,23,16,41.94936,-87.65451
TA1307000150,5,19,true,23,21,-2,41.94945,-87.64646
13319,5,19,true,2,7,5,41.95069,-87.6687
TA1307000127,5,19,true,8,8,0,41.9508,-87.65918
13323,5,19,true,8,9,1,41.95282,-87.65
TA1309000043,5,19,true,5,5,0,41.95417,-87.66434
13063,5,19,true,14,8,-6,41.95424,-87.65441
TA1308000022,5,19,true,5,17,12,41.95438,-87.64805
TA1307000149,5,19,true,8,7,-1,41.95467,-87.67392
TA1309000026,5,19,true,3,9,6,41.95601,-87.6802
13379,5,19,true,14,17,3,41.95786,-87.6495
TA1309000027,5,19,true,4,7,3,41.9585,-87.65499
13389,5,19,true,4,7,3,41.961,-87.64958
TA1307000144,5,19,true,3,5,2,41.96142,-87.6762
KA1503000022,5,19,true,2,8,6,41.96158,-87.66609
TA1307000107,5,19,true,21,14,-7,41.96164,-87.65464
TA1307000156,5,19,true,2,7,5,41.96301,-87.68479
TA1308000012,5,19,true,30,20,-10,41.96398,-87.63818
13074,5,19,true,9,5,-4,41.96521,-87.6582
639,5,19,true,10,7,-3,41.96584,-87.64538
TA1309000014,5,19,true,5,8,3,41.96709,-87.66744
TA1307000158,5,19,true,8,1,-7,41.9671,-87.67904
TA1309000015,5,19,true,5,4,-1,41.96889,-87.68401
TA1309000066,5,19,true,10,5,-5,41.9691,-87.67423
TA1309000041,5,19,true,2,7,5,41.96951,-87.65471
KA1504000171,5,19,true,4,7,3,41.97161,-87.65016
TA1309000035,5,19,true,5,11,6,41.97335,-87.66785
13108,5,19,true,8,10,2,41.97379,-87.65971
KA1504000149,5,19,true,2,5,3,41.97562,-87.67945
KA1504000146,5,19,true,6,7,1,41.978,-87.66805
13109,5,19,true,3,6,3,41.97835,-87.65976
655,5,19,true,6,7,1,41.97987,-87.68194
KA1504000151,5,19,true,7,8,1,41.98359,-87.66916
KA1504000152,5,19,true,19,21,2,41.98403,-87.65231
15578,5,19,true,6,6,0,41.98405,-87.66027
15575,5,19,true,3,7,4,41.98975,-87.66014
RP-009,5,19,true,4,6,2,42.00107,-87.66122
660,5,19,true,2,5,3,42.00458,-87.66143
KA1504000162,5,19,true,5,2,-3,42.00907,-87.67422
KA1503000014,5,20,false,1,6,5,41.7851,-87.60108
TA1308000009,5,20,false,20,19,-1,41.79522,-87.58075
TA1307000164,5,20,false,3,5,2,41.79527,-87.59647
KA1503000052,5,20,false,4,5,1,41.79935,-87.60097
TA1309000037,5,20,false,12,7,-5,41.79957,-87.59474
KA1503000007,5,20,false,7,4,-3,41.80242,-87.58689
13398,5,20,false,7,2,-5,41.80256,-87.59035
TA1308000043,5,20,false,6,3,-3,41.83066,-87.64715
TA1307000129,5,20,false,2,7,5,41.83104,-87.62683
TA1307000048,5,20,false,14,6,-8,41.83855,-87.60821
TA1308000026,5,20,false,2,7,5,41.85008,-87.63214
TA1305000001,5,20,false,4,5,1,41.85262,-87.6265
13075,5,20,false,8,2,-6,41.8531,-87.63192
15545,5,20,false,8,12,4,41.85627,-87.61334
SL-006,5,20,false,5,3,-2,41.8568,-87.63387
13102,5,20,false,4,5,1,41.85762,-87.61942
13150,5,20,false,8,8,0,41.85783,-87.62455
13099,5,20,false,1,6,5,41.85784,-87.64627
TA1307000124,5,20,false,6,10,4,41.86411,-87.62372
13431,5,20,false,22,21,-1,41.8661,-87.60728
TA1305000002,5,20,false,15,13,-2,41.86721,-87.62597
15544,5,20,false,25,10,-15,41.86723,-87.61536
KA1706005007,5,20,false,8,3,-5,41.86749,-87.63219
SL-005,5,20,false,29,27,-2,41.8679,-87.62304
13160,5,20,false,11,7,-4,41.86947,-87.65548
TA1309000010,5,20,false,11,10,-1,41.87074,-87.62574
SL-008,5,20,false,8,9,1,41.87209,-87.62956
SL-011,5,20,false,6,8,2,41.87256,-87.63356
623,5,20,false,15,13,-2,41.87272,-87.62399
SL-007,5,20,false,5,3,-2,41.87404,-87.6277
15541,5,20,false,20,21,1,41.8758,-87.62086
TA1305000009,5,20,false,10,2,-8,41.87593,-87.63068
TA1305000035,5,20,false,4,6,2,41.87716,-87.62787
13158,5,20,false,13,10,-3,41.87764,-87.64957
13157,5,20,false,7,7,0,41.87773,-87.6548
TA1305000025,5,20,false,8,5,-3,41.87773,-87.63528
TA1309000002,5,20,false,11,8,-3,41.87784,-87.62408
13011,5,20,false,6,4,-2,41.87931,-87.63993
13156,5,20,false,7,9,2,41.88042,-87.65554
13300,5,20,false,54,58,4,41.88097,-87.61675
13008,5,20,false,47,49,2,41.88105,-87.62408
TA1305000006,5,20,false,4,11,7,41.88122,-87.6296
TA1307000120,5,20,false,3,11,8,41.88188,-87.64879
13341,5,20,false,4,11,7,41.88208,-87.63985
TA1305000032,5,20,false,13,14,1,41.88218,-87.64109
13353,5,20,false,6,2,-4,41.88283,-87.6612
13409,5,20,false,3,8,5,41.8831,-87.6511
WL-012,5,20,false,7,2,-5,41.88337,-87.6412
13053,5,20,false,14,11,-3,41.88365,-87.64863
13001,5,20,false,14,14,0,41.88397,-87.62459
TA1305000030,5,20,false,10,4,-6,41.88459,-87.63178
15535,5,20,false,9,15,6,41.8846,-87.64455
TA1305000029,5,20,false,12,16,4,41.88466,-87.62787
13263,5,20,false,23,30,7,41.88467,-87.61952
TA1306000015,5,20,false,21,12,-9,41.88549,-87.65232
13021,5,20,false,10,6,-4,41.88559,-87.64184
TA1307000111,5,20,false,5,9,4,41.88582,-87.63548
KA1503000012,5,20,false,8,8,0,41.88599,-87.63089
TA1305000011,5,20,false,14,30,16,41.886,-87.62418
15534,5,20,false,8,4,-4,41.88627,-87.61749
TA1308000029,5,20,false,6,6,0,41.88673,-87.62225
TA1307000131,5,20,false,19,23,4,41.88688,-87.62606
KA1503000064,5,20,false,32,28,-4,41.88697,-87.61281
TA1306000003,5,20,false,9,10,1,41.88867,-87.64442
KA1503000043,5,20,false,9,10,1,41.88918,-87.63851
13050,5,20,false,21,23,2,41.88919,-87.62775
TA1307000151,5,20,false,13,17,4,41.88993,-87.63427
KA1503000044,5,20,false,2,5,3,41.89018,-87.6262
13427,5,20,false,12,9,-3,41.89054,-87.62205
13430,5,20,false,10,20,10,41.89077,-87.63169
TA1306000013,5,20,false,31,18,-13,41.89083,-87.61852
RN-,5,20,false,2,8,6,41.89102,-87.63546
13434,5,20,false,2,5,3,41.89108,-87.66663
TA1307000117,5,20,false,19,26,7,41.89144,-87.62675
13033,5,20,false,13,10,-3,41.8916,-87.64835
13194,5,20,false,8,5,-3,41.8918,-87.65878
TA1305000003,5,20,false,12,17,5,41.89187,-87.62061
13022,5,20,false,89,108,19,41.89227,-87.61205
TA1306000029,5,20,false,37,31,-6,41.89256,-87.61449
13265,5,20,false,3,7,4,41.89383,-87.64172
13045,5,20,false,12,12,0,41.89403,-87.62931
13016,5,20,false,12,17,5,41.89431,-87.62277
KA1503000041,5,20,false,12,8,-4,41.89452,-87.61798
13196,5,20,false,6,6,0,41.89455,-87.65345
TA1307000062,5,20,false,13,6,-7,41.89466,-87.63839
TA1306000012,5,20,false,13,9,-4,41.89475,-87.63438
KP1705001026,5,20,false,9,11,2,41.89483,-87.6323
18058,5,20,false,8,6,-2,41.8955,-87.68201
637,5,20,false,1,5,4,41.89563,-87.67209
15530,5,20,false,13,9,-4,41.89575,-87.62596
13247,5,20,false,6,3,-3,41.89597,-87.66775
TA1305000020,5,20,false,5,14,9,41.89636,-87.65406
13289,5,20,false,2,7,5,41.89638,-87.661
13303,5,20,false,8,11,3,41.89672,-87.63088
13017,5,20,false,9,3,-6,41.89676,-87.6357
13338,5,20,false,3,6,3,41.89697,-87.62173
TA1307000061,5,20,false,2,6,4,41.89745,-87.62873
13034,5,20,false,7,8,1,41.89754,-87.62352
TA1306000009,5,20,false,5,2,-3,41.89772,-87.64299
15529,5,20,false,5,5,0,41.89858,-87.62206
TA1307000128,5,20,false,8,11,3,41.89896,-87.6299
657,5,20,false,1,5,4,41.89918,-87.6722
13248,5,20,false,6,4,-2,41.89964,-87.66788
TA1306000011,5,20,false,8,8,0,41.89994,-87.63443
13042,5,20,false,43,53,10,41.90097,-87.62377
KA1504000133,5,20,false,7,13,6,41.90234,-87.62773
TA1306000006,5,20,false,5,1,-4,41.90292,-87.63772
TA1307000039,5,20,false,27,26,-1,41.90294,-87.63137
TA1305000034,5,20,false,7,11,4,41.90313,-87.67391
KA1504000135,5,20,false,24,29,5,41.90319,-87.63439
13136,5,20,false,6,10,4,41.90326,-87.67845
13061,5,20,false,11,14,3,41.90342,-87.66779
KA1504000079,5,20,false,8,7,-1,41.9035,-87.64334
TA1307000115,5,20,false,8,9,1,41.9046,-87.64056
TA1308000049,5,20,false,12,26,14,41.90672,-87.6349
KA1504000134,5,20,false,8,11,3,41.90687,-87.6262
13224,5,20,false,9,11,2,41.90706,-87.66725
TA1307000143,5,20,false,5,8,3,41.90762,-87.63854
13221,5,20,false,10,22,12,41.90765,-87.67254
TA1309000024,5,20,false,17,15,-2,41.908,-87.63152
TA1305000041,5,20,false,17,9,-8,41.9094,-87.67769
331,5,20,false,9,4,-5,41.90965,-87.64812
TA1305000037,5,20,false,14,8,-6,41.91018,-87.67003
TA1306000008,5,20,false,7,4,-3,41.9102,-87.6435
TA1308000005,5,20,false,7,11,4,41.91042,-87.68238
13258,5,20,false,5,3,-2,41.91043,-87.69718
13257,5,20,false,9,9,0,41.91054,-87.68956
13058,5,20,false,12,3,-9,41.91059,-87.64942
TA1307000038,5,20,false,7,13,6,41.91138,-87.63868
LF-005,5,20,false,67,33,-34,41.91172,-87.62681
13128,5,20,false,16,11,-5,41.91197,-87.63197
TA1308000050,5,20,false,23,23,0,41.91211,-87.6347
13243,5,20,false,10,7,-3,41.91262,-87.6814
TA1306000032,5,20,false,9,8,-1,41.9137,-87.65285
TA1307000166,5,20,false,5,12,7,41.91386,-87.64877
TA1306000007,5,20,false,2,8,6,41.91469,-87.64333
13068,5,20,false,4,12,8,41.91554,-87.68703
13179,5,20,false,34,30,-4,41.9157,-87.63461
13133,5,20,false,4,6,2,41.91598,-87.67733
15651,5,20,false,2,11,9,41.91752,-87.70181
13266,5,20,false,6,2,-4,41.91774,-87.69142
TA1307000163,5,20,false,3,6,3,41.91821,-87.65696
13146,5,20,false,20,18,-2,41.91831,-87.63629
13059,5,20,false,12,5,-7,41.91845,-87.65222
13192,5,20,false,16,11,-5,41.91995,-87.64884
13288,5,20,false,2,5,3,41.92008,-87.67788
13242,5,20,false,2,7,5,41.92021,-87.69266
TA1309000030,5,20,false,9,1,-8,41.92077,-87.66372
13292,5,20,false,5,4,-1,41.92152,-87.70733
TA1309000033,5,20,false,8,8,0,41.92158,-87.65381
13193,5,20,false,20,25,5,41.92182,-87.64412
13191,5,20,false,6,3,-3,41.92217,-87.63891
13084,5,20,false,10,13,3,41.92268,-87.69715
LP-,5,20,false,9,6,-3,41.92396,-87.63584
TA1307000001,5,20,false,6,13,7,41.92535,-87.66581
TA1306000026,5,20,false,7,9,2,41.92558,-87.65842
TA1306000016,5,20,false,5,4,-1,41.9256,-87.65371
TA1309000019,5,20,false,20,23,3,41.92586,-87.63897
TA1309000058,5,20,false,8,19,11,41.92591,-87.64927
TA1308000001,5,20,false,52,41,-11,41.92627,-87.63086
13124,5,20,false,19,12,-7,41.92675,-87.63444
TA1309000023,5,20,false,13,8,-5,41.9287,-87.65383
TA1307000113,5,20,false,10,26,16,41.92878,-87.66391
TA1309000061,5,20,false,10,7,-3,41.92915,-87.64909
TA1305000014,5,20,false,16,18,2,41.92956,-87.64313
13085,5,20,false,4,8,4,41.92958,-87.70789
TA1307000142,5,20,false,13,18,5,41.93125,-87.64432
13276,5,20,false,20,17,-3,41.93132,-87.63874
13271,5,20,false,2,5,3,41.93192,-87.67784
TA1307000064,5,20,false,7,7,0,41.93222,-87.65864
TA1306000014,5,20,false,15,28,13,41.93242,-87.65271
TA1309000039,5,20,false,26,19,-7,41.93258,-87.63642
TA1309000036,5,20,false,9,10,1,41.93313,-87.64776
TA1307000006,5,20,false,3,12,9,41.93571,-87.6636
13269,5,20,false,6,3,-3,41.93609,-87.66983
TA1307000052,5,20,false,8,11,3,41.93628,-87.65266
TA1307000136,5,20,false,9,13,4,41.9365,-87.64755
TA1307000041,5,20,false,26,20,-6,41.93669,-87.63683
13137,5,20,false,12,19,7,41.9376,-87.6441
15642,5,20,false,1,6,5,41.93843,-87.69801
13229,5,20,false,10,14,4,41.93946,-87.66376
TA1308000019,5,20,false,10,16,6,41.93973,-87.65886
13277,5,20,false,4,9,5,41.9401,-87.64546
TA1307000134,5,20,false,11,31,20,41.94016,-87.65303
13143,5,20,false,8,1,-7,41.94059,-87.67853
TA1309000049,5,20,false,29,21,-8,41.94077,-87.63919
TA1307000138,5,20,false,6,6,0,41.94334,-87.67094
13144,5,20,false,7,4,-3,41.9434,-87.67964
TA1309000025,5,20,false,14,18,4,41.94368,-87.64894
13071,5,20,false,7,9,2,41.94373,-87.66401
632,5,20,false,10,15,5,41.94453,-87.6547
13278,5,20,false,9,10,1,41.94553,-87.64644
13235,5,20,false,16,7,-9,41.94814,-87.66396
13325,5,20,false,5,8,3,41.94907,-87.64863
TA1307000126,5,20,false,9,28,19,41.94936,-87.65451
TA1307000150,5,20,false,4,10,6,41.94945,-87.64646
13319,5,20,false,6,5,-1,41.95069,-87.6687
TA1307000127,5,20,false,14,12,-2,41.9508,-87.65918
13323,5,20,false,3,10,7,41.95282,-87.65
TA1309000043,5,20,false,4,7,3,41.95417,-87.66434
13063,5,20,false,4,13,9,41.95424,-87.65441
TA1308000022,5,20,false,14,12,-2,41.95438,-87.64805
TA1309000026,5,20,false,2,5,3,41.95601,-87.6802
13379,5,20,false,2,12,10,41.95786,-87.6495
TA1307000107,5,20,false,9,7,-2,41.96164,-87.65464
TA1308000012,5,20,false,39,12,-27,41.96398,-87.63818
13074,5,20,false,2,8,6,41.96521,-87.6582
639,5,20,false,9,2,-7,41.96584,-87.64538
TA1308000021,5,20,false,3,7,4,41.96883,-87.65765
TA1309000015,5,20,false,2,5,3,41.96889,-87.68401
TA1309000066,5,20,false,2,7,5,41.9691,-87.67423
TA1309000041,5,20,false,1,5,4,41.96951,-87.65471
KA1504000171,5,20,false,4,8,4,41.97161,-87.65016
TA1309000035,5,20,false,12,8,-4,41.97335,-87.66785
13108,5,20,false,5,4,-1,41.97379,-87.65971
13109,5,20,false,2,9,7,41.97835,-87.65976
KA1504000151,5,20,false,3,6,3,41.98359,-87.66916
KA1504000152,5,20,false,18,10,-8,41.98403,-87.65231
15575,5,20,false,4,6,2,41.98975,-87.66014
15571,5,20,false,6,4,-2,41.99478,-87.66028
KA1503000014,5,20,true,4,9,5,41.7851,-87.60108
TA1309000063,5,20,true,5,5,0,41.79325,-87.5878
TA1308000009,5,20,true,6,11,5,41.79522,-87.58075
TA1307000164,5,20,true,5,5,0,41.79527,-87.59647
KA1503000052,5,20,true,1,8,7,41.79935,-87.60097
TA1309000037,5,20,true,8,6,-2,41.79957,-87.59474
15445,5,20,true,3,5,2,41.83453,-87.63183
13216,5,20,true,3,6,3,41.83473,-87.62581
13217,5,20,true,8,6,-2,41.83488,-87.61792
13215,5,20,true,2,7,5,41.83634,-87.6135
TA1309000055,5,20,true,6,7,1,41.8382,-87.64514
TA1307000048,5,20,true,12,9,-3,41.83855,-87.60821
TA1307000139,5,20,true,4,17,13,41.84205,-87.61698
13075,5,20,true,8,4,-4,41.8531,-87.63192
15545,5,20,true,13,9,-4,41.85627,-87.61334
13102,5,20,true,2,6,4,41.85762,-87.61942
13150,5,20,true,9,8,-1,41.85783,-87.62455
TA1307000124,5,20,true,11,14,3,41.86411,-87.62372
TA1309000001,5,20,true,1,7,6,41.86488,-87.64708
13431,5,20,true,23,24,1,41.8661,-87.60728
TA1305000002,5,20,true,19,19,0,41.86721,-87.62597
15544,5,20,true,19,18,-1,41.86723,-87.61536
TA1305000017,5,20,true,5,3,-2,41.86734,-87.64863
SL-005,5,20,true,6,13,7,41.8679,-87.62304
13160,5,20,true,3,8,5,41.86947,-87.65548
TA1309000010,5,20,true,8,12,4,41.87074,-87.62574
TA1309000064,5,20,true,4,5,1,41.87127,-87.67369
TA1307000130,5,20,true,2,6,4,41.87178,-87.65103
TA1307000121,5,20,true,7,1,-6,41.87184,-87.64664
SL-008,5,20,true,4,7,3,41.87209,-87.62956
13332,5,20,true,18,12,-6,41.87219,-87.6615
623,5,20,true,1,8,7,41.87272,-87.62399
TA1306000025,5,20,true,5,2,-3,41.87464,-87.65703
13028,5,20,true,9,8,-1,41.87475,-87.64981
SL-010,5,20,true,2,5,3,41.87501,-87.63309
15541,5,20,true,2,5,3,41.8758,-87.62086
15539,5,20,true,6,2,-4,41.87763,-87.64405
13158,5,20,true,9,7,-2,41.87764,-87.64957
13157,5,20,true,14,14,0,41.87773,-87.6548
15667,5,20,true,1,5,4,41.8798,-87.68609
WL-011,5,20,true,6,13,7,41.88034,-87.64273
13156,5,20,true,8,11,3,41.88042,-87.65554
13300,5,20,true,25,34,9,41.88097,-87.61675
13008,5,20,true,15,6,-9,41.88105,-87.62408
TA1307000120,5,20,true,16,3,-13,41.88188,-87.64879
13036,5,20,true,5,4,-1,41.8821,-87.62513
TA1305000032,5,20,true,10,14,4,41.88218,-87.64109
13409,5,20,true,7,4,-3,41.8831,-87.6511
WL-012,5,20,true,8,7,-1,41.88337,-87.6412
13053,5,20,true,18,14,-4,41.88365,-87.64863
18062,5,20,true,4,5,1,41.88412,-87.65427
TA1306000010,5,20,true,10,2,-8,41.88419,-87.62961
TA1305000030,5,20,true,7,3,-4,41.88459,-87.63178
15535,5,20,true,8,9,1,41.8846,-87.64455
TA1305000029,5,20,true,8,2,-6,41.88466,-87.62787
13263,5,20,true,10,11,1,41.88467,-87.61952
TA1306000015,5,20,true,5,9,4,41.88549,-87.65232
13021,5,20,true,1,5,4,41.88559,-87.64184
TA1307000111,5,20,true,7,5,-2,41.88582,-87.63548
KA17018054,5,20,true,6,3,-3,41.88595,-87.67701
TA1305000011,5,20,true,5,10,5,41.886,-87.62418
15534,5,20,true,5,7,2,41.88627,-87.61749
TA1308000029,5,20,true,5,12,7,41.88673,-87.62225
TA1307000131,5,20,true,12,6,-6,41.88688,-87.62606
KA1503000064,5,20,true,7,8,1,41.88697,-87.61281
TA1305000022,5,20,true,8,3,-5,41.88817,-87.63656
TA1306000003,5,20,true,9,18,9,41.88867,-87.64442
KA1503000043,5,20,true,12,17,5,41.88918,-87.63851
13050,5,20,true,5,5,0,41.88919,-87.62775
TA1307000151,5,20,true,16,15,-1,41.88993,-87.63427
13427,5,20,true,8,4,-4,41.89054,-87.62205
13430,5,20,true,6,13,7,41.89077,-87.63169
TA1306000013,5,20,true,9,9,0,41.89083,-87.61852
13434,5,20,true,2,5,3,41.89108,-87.66663
TA1307000117,5,20,true,19,12,-7,41.89144,-87.62675
13033,5,20,true,14,17,3,41.8916,-87.64835
13194,5,20,true,4,6,2,41.8918,-87.65878
TA1305000003,5,20,true,7,4,-3,41.89187,-87.62061
13022,5,20,true,19,9,-10,41.89227,-87.61205
TA1306000029,5,20,true,10,11,1,41.89256,-87.61449
13265,5,20,true,12,17,5,41.89383,-87.64172
13045,5,20,true,19,30,11,41.89403,-87.62931
13016,5,20,true,7,8,1,41.89431,-87.62277
KA1503000041,5,20,true,7,8,1,41.89452,-87.61798
13196,5,20,true,5,3,-2,41.89455,-87.65345
TA1307000062,5,20,true,7,6,-1,41.89466,-87.63839
TA1306000012,5,20,true,15,12,-3,41.89475,-87.63438
KP1705001026,5,20,true,5,6,1,41.89483,-87.6323
13132,5,20,true,7,5,-2,41.89573,-87.67718
15530,5,20,true,10,10,0,41.89575,-87.62596
18003,5,20,true,5,1,-4,41.89575,-87.62011
13289,5,20,true,6,6,0,41.89638,-87.661
13303,5,20,true,13,13,0,41.89672,-87.63088
13017,5,20,true,6,5,-1,41.89676,-87.6357
13338,5,20,true,8,7,-1,41.89697,-87.62173
TA1307000061,5,20,true,6,8,2,41.89745,-87.62873
13034,5,20,true,6,4,-2,41.89754,-87.62352
620,5,20,true,1,7,6,41.89817,-87.63754
15529,5,20,true,5,12,7,41.89858,-87.62206
TA1307000128,5,20,true,11,7,-4,41.89896,-87.6299
657,5,20,true,1,5,4,41.89918,-87.6722
TA1306000011,5,20,true,5,5,0,41.89994,-87.63443
13290,5,20,true,5,9,4,41.90069,-87.66259
13042,5,20,true,17,13,-4,41.90097,-87.62377
KA1504000133,5,20,true,7,5,-2,41.90234,-87.62773
TA1307000039,5,20,true,27,23,-4,41.90294,-87.63137
TA1305000034,5,20,true,8,12,4,41.90313,-87.67391
KA1504000135,5,20,true,21,21,0,41.90319,-87.63439
13136,5,20,true,5,7,2,41.90326,-87.67845
13061,5,20,true,9,9,0,41.90342,-87.66779
KA1504000079,5,20,true,7,6,-1,41.9035,-87.64334
TA1307000115,5,20,true,6,6,0,41.9046,-87.64056
TA1308000049,5,20,true,21,12,-9,41.90672,-87.6349
KA1504000134,5,20,true,6,13,7,41.90687,-87.6262
13224,5,20,true,11,11,0,41.90706,-87.66725
TA1307000143,5,20,true,3,7,4,41.90762,-87.63854
13221,5,20,true,13,13,0,41.90765,-87.67254
TA1309000024,5,20,true,9,19,10,41.908,-87.63152
TA1305000041,5,20,true,8,12,4,41.9094,-87.67769
331,5,20,true,10,6,-4,41.90965,-87.64812
TA1305000037,5,20,true,5,6,1,41.91018,-87.67003
TA1306000008,5,20,true,2,5,3,41.9102,-87.6435
13257,5,20,true,1,6,5,41.91054,-87.68956
13154,5,20,true,6,3,-3,41.91054,-87.65312
13058,5,20,true,15,3,-12,41.91059,-87.64942
TA1307000038,5,20,true,3,11,8,41.91138,-87.63868
LF-005,5,20,true,45,14,-31,41.91172,-87.62681
13128,5,20,true,5,4,-1,41.91197,-87.63197
TA1308000050,5,20,true,21,16,-5,41.91211,-87.6347
13243,5,20,true,3,13,10,41.91262,-87.6814
TA1306000032,5,20,true,8,5,-3,41.9137,-87.65285
TA1307000166,5,20,true,5,11,6,41.91386,-87.64877
TA1306000007,5,20,true,5,5,0,41.91469,-87.64333
13068,5,20,true,7,6,-1,41.91554,-87.68703
13179,5,20,true,20,20,0,41.9157,-87.63461
13133,5,20,true,5,3,-2,41.91598,-87.67733
TA1307000163,5,20,true,9,6,-3,41.91821,-87.65696
13146,5,20,true,12,14,2,41.91831,-87.63629
13059,5,20,true,9,16,7,41.91845,-87.65222
13192,5,20,true,5,15,10,41.91995,-87.64884
13288,5,20,true,5,6,1,41.92008,-87.67788
TA1309000030,5,20,true,5,6,1,41.92077,-87.66372
TA1309000033,5,20,true,8,19,11,41.92158,-87.65381
13193,5,20,true,16,14,-2,41.92182,-87.64412
13191,5,20,true,2,5,3,41.92217,-87.63891
13084,5,20,true,2,6,4,41.92268,-87.69715
LP-,5,20,true,4,5,1,41.92396,-87.63584
TA1307000001,5,20,true,1,9,8,41.92535,-87.66581
TA1306000026,5,20,true,13,11,-2,41.92558,-87.65842
TA1306000016,5,20,true,7,5,-2,41.9256,-87.65371
TA1309000019,5,20,true,12,12,0,41.92586,-87.63897
TA1309000058,5,20,true,14,17,3,41.92591,-87.64927
TA1308000001,5,20,true,20,19,-1,41.92627,-87.63086
TA1307000113,5,20,true,7,10,3,41.92878,-87.66391
TA1309000061,5,20,true,12,13,1,41.92915,-87.64909
TA1305000014,5,20,true,9,11,2,41.92956,-87.64313
13085,5,20,true,1,10,9,41.92958,-87.70789
TA1307000142,5,20,true,16,12,-4,41.93125,-87.64432
13276,5,20,true,9,9,0,41.93132,-87.63874
13271,5,20,true,6,3,-3,41.93192,-87.67784
TA1307000064,5,20,true,9,11,2,41.93222,-87.65864
TA1306000014,5,20,true,17,22,5,41.93242,-87.65271
TA1309000039,5,20,true,18,14,-4,41.93258,-87.63642
TA1309000036,5,20,true,15,11,-4,41.93313,-87.64776
TA1307000006,5,20,true,6,10,4,41.93571,-87.6636
TA1307000052,5,20,true,6,8,2,41.93628,-87.65266
TA1307000136,5,20,true,9,13,4,41.9365,-87.64755
TA1307000041,5,20,true,21,22,1,41.93669,-87.63683
13137,5,20,true,22,24,2,41.9376,-87.6441
13229,5,20,true,9,9,0,41.93946,-87.66376
TA1308000019,5,20,true,4,9,5,41.93973,-87.65886
13277,5,20,true,3,8,5,41.9401,-87.64546
TA1307000134,5,20,true,15,15,0,41.94016,-87.65303
TA1309000049,5,20,true,15,13,-2,41.94077,-87.63919
TA1307000138,5,20,true,6,5,-1,41.94334,-87.67094
TA1309000025,5,20,true,7,9,2,41.94368,-87.64894
13071,5,20,true,5,13,8,41.94373,-87.66401
632,5,20,true,6,9,3,41.94453,-87.6547
13278,5,20,true,9,14,5,41.94553,-87.64644
13235,5,20,true,10,16,6,41.94814,-87.66396
13253,5,20,true,1,7,6,41.9488,-87.67527
13325,5,20,true,13,14,1,41.94907,-87.64863
TA1307000126,5,20,true,7,10,3,41.94936,-87.65451
TA1307000150,5,20,true,13,15,2,41.94945,-87.64646
13319,5,20,true,3,7,4,41.95069,-87.6687
TA1307000127,5,20,true,7,14,7,41.9508,-87.65918
13323,5,20,true,4,7,3,41.95282,-87.65
13063,5,20,true,4,7,3,41.95424,-87.65441
TA1308000022,5,20,true,5,11,6,41.95438,-87.64805
TA1307000149,5,20,true,5,3,-2,41.95467,-87.67392
TA1309000026,5,20,true,4,6,2,41.95601,-87.6802
13379,5,20,true,13,15,2,41.95786,-87.6495
TA1309000027,5,20,true,6,5,-1,41.9585,-87.65499
13389,5,20,true,5,5,0,41.961,-87.64958
15621,5,20,true,5,7,2,41.96103,-87.70586
TA1307000144,5,20,true,5,5,0,41.96142,-87.6762
TA1307000107,5,20,true,9,13,4,41.96164,-87.65464
TA1307000156,5,20,true,5,4,-1,41.96301,-87.68479
TA1308000012,5,20,true,29,15,-14,41.96398,-87.63818
13074,5,20,true,3,7,4,41.96521,-87.6582
639,5,20,true,9,7,-2,41.96584,-87.64538
TA1309000014,5,20,true,7,12,5,41.96709,-87.66744
TA1307000158,5,20,true,2,6,4,41.9671,-87.67904
TA1307000119,5,20,true,5,2,-3,41.96796,-87.65
TA1309000066,5,20,true,9,7,-2,41.9691,-87.67423
KA1504000171,5,20,true,3,10,7,41.97161,-87.65016
TA1309000035,5,20,true,7,8,1,41.97335,-87.66785
13108,5,20,true,10,8,-2,41.97379,-87.65971
KA1504000146,5,20,true,7,5,-2,41.978,-87.66805
13109,5,20,true,2,6,4,41.97835,-87.65976
KA1504000152,5,20,true,12,12,0,41.98403,-87.65231
15578,5,20,true,8,3,-5,41.98405,-87.66027
KA1504000148,5,20,true,4,7,3,41.99086,-87.66971
15571,5,20,true,7,7,0,41.99478,-87.66028
KA1504000175,5,20,true,2,5,3,42.00797,-87.66549
15491,5,21,false,11,6,-5,41.78096,-87.57624
KA1503000014,5,21,false,6,2,-4,41.7851,-87.60108
TA1309000063,5,21,false,4,5,1,41.79325,-87.5878
TA1308000009,5,21,false,11,14,3,41.79522,-87.58075
KA1503000059,5,21,false,5,9,4,41.79952,-87.58643
TA1309000037,5,21,false,5,10,5,41.79957,-87.59474
13398,5,21,false,5,9,4,41.80256,-87.59035
TA1309000055,5,21,false,5,2,-3,41.8382,-87.64514
TA1307000048,5,21,false,6,11,5,41.83855,-87.60821
TA1305000004,5,21,false,4,6,2,41.8514,-87.61884
13075,5,21,false,20,4,-16,41.8531,-87.63192
SL-006,5,21,false,5,1,-4,41.8568,-87.63387
13150,5,21,false,2,10,8,41.85783,-87.62455
13164,5,21,false,12,2,-10,41.85818,-87.65648
SL-012,5,21,false,2,6,4,41.86038,-87.62581
TA1307000124,5,21,false,4,12,8,41.86411,-87.62372
TA1309000001,5,21,false,8,9,1,41.86488,-87.64708
13431,5,21,false,21,15,-6,41.8661,-87.60728
TA1305000002,5,21,false,12,16,4,41.86721,-87.62597
15544,5,21,false,7,3,-4,41.86723,-87.61536
SL-005,5,21,false,18,23,5,41.8679,-87.62304
13160,5,21,false,1,9,8,41.86947,-87.65548
15550,5,21,false,4,5,1,41.87024,-87.63947
TA1309000010,5,21,false,17,24,7,41.87074,-87.62574
SL-009,5,21,false,1,6,5,41.87081,-87.63121
SL-008,5,21,false,13,10,-3,41.87209,-87.62956
SL-011,5,21,false,3,7,4,41.87256,-87.63356
623,5,21,false,20,20,0,41.87272,-87.62399
SL-007,5,21,false,24,3,-21,41.87404,-87.6277
13028,5,21,false,8,4,-4,41.87475,-87.64981
15541,5,21,false,26,31,5,41.8758,-87.62086
TA1305000009,5,21,false,8,5,-3,41.87593,-87.63068
TA1305000010,5,21,false,6,5,-1,41.87623,-87.62444
TA1305000035,5,21,false,14,6,-8,41.87716,-87.62787
13157,5,21,false,10,9,-1,41.87773,-87.6548
TA1305000025,5,21,false,11,3,-8,41.87773,-87.63528
TA1309000002,5,21,false,11,9,-2,41.87784,-87.62408
TA1309000004,5,21,false,2,5,3,41.87811,-87.63184
13011,5,21,false,4,5,1,41.87931,-87.63993
WL-011,5,21,false,4,6,2,41.88034,-87.64273
13300,5,21,false,38,50,12,41.88097,-87.61675
13008,5,21,false,44,47,3,41.88105,-87.62408
TA1305000006,5,21,false,2,5,3,41.88122,-87.6296
TA1307000120,5,21,false,11,8,-3,41.88188,-87.64879
13036,5,21,false,6,6,0,41.8821,-87.62513
TA1305000032,5,21,false,6,11,5,41.88218,-87.64109
WL-012,5,21,false,5,1,-4,41.88337,-87.6412
13053,5,21,false,17,13,-4,41.88365,-87.64863
13001,5,21,false,9,4,-5,41.88397,-87.62459
TA1305000030,5,21,false,8,5,-3,41.88459,-87.63178
15535,5,21,false,11,10,-1,41.8846,-87.64455
TA1305000029,5,21,false,10,13,3,41.88466,-87.62787
13263,5,21,false,26,14,-12,41.88467,-87.61952
TA1306000015,5,21,false,17,14,-3,41.88549,-87.65232
13021,5,21,false,5,7,2,41.88559,-87.64184
TA1307000111,5,21,false,8,13,5,41.88582,-87.63548
KA17018054,5,21,false,6,2,-4,41.88595,-87.67701
KA1503000012,5,21,false,7,7,0,41.88599,-87.63089
TA1305000011,5,21,false,35,32,-3,41.886,-87.62418
15534,5,21,false,7,6,-1,41.88627,-87.61749
TA1308000029,5,21,false,5,13,8,41.88673,-87.62225
TA1307000131,5,21,false,22,11,-11,41.88688,-87.62606
KA1503000064,5,21,false,18,12,-6,41.88697,-87.61281
TA1305000022,5,21,false,7,7,0,41.88817,-87.63656
TA1306000003,5,21,false,17,14,-3,41.88867,-87.64442
KA1503000043,5,21,false,4,6,2,41.88918,-87.63851
13050,5,21,false,9,24,15,41.88919,-87.62775
13432,5,21,false,8,3,-5,41.88989,-87.67149
TA1307000151,5,21,false,8,13,5,41.88993,-87.63427
13430,5,21,false,14,20,6,41.89077,-87.63169
TA1306000013,5,21,false,23,21,-2,41.89083,-87.61852
RN-,5,21,false,7,5,-2,41.89102,-87.63546
13434,5,21,false,3,7,4,41.89108,-87.66663
TA1307000117,5,21,false,13,28,15,41.89144,-87.62675
13033,5,21,false,10,9,-1,41.8916,-87.64835
13194,5,21,false,1,10,9,41.8918,-87.65878
TA1305000003,5,21,false,19,13,-6,41.89187,-87.62061
13022,5,21,false,100,83,-17,41.89227,-87.61205
TA1306000029,5,21,false,25,29,4,41.89256,-87.61449
13265,5,21,false,3,5,2,41.89383,-87.64172
13045,5,21,false,9,12,3,41.89403,-87.62931
13016,5,21,false,13,11,-2,41.89431,-87.62277
KA1503000041,5,21,false,5,4,-1,41.89452,-87.61798
TA1306000012,5,21,false,11,6,-5,41.89475,-87.63438
KP1705001026,5,21,false,9,5,-4,41.89483,-87.6323
13132,5,21,false,7,1,-6,41.89573,-87.67718
15530,5,21,false,15,4,-11,41.89575,-87.62596
13289,5,21,false,1,6,5,41.89638,-87.661
13303,5,21,false,10,11,1,41.89672,-87.63088
13017,5,21,false,5,2,-3,41.89676,-87.6357
13338,5,21,false,8,6,-2,41.89697,-87.62173
TA1307000061,5,21,false,7,7,0,41.89745,-87.62873
13034,5,21,false,4,9,5,41.89754,-87.62352
620,5,21,false,11,5,-6,41.89817,-87.63754
KA1504000103,5,21,false,2,7,5,41.89842,-87.68659
15529,5,21,false,5,9,4,41.89858,-87.62206
TA1307000128,5,21,false,6,9,3,41.89896,-87.6299
657,5,21,false,9,1,-8,41.89918,-87.6722
TA1306000011,5,21,false,7,7,0,41.89994,-87.63443
13290,5,21,false,5,6,1,41.90069,-87.66259
13042,5,21,false,35,26,-9,41.90097,-87.62377
KA1504000133,5,21,false,15,19,4,41.90234,-87.62773
TA1307000039,5,21,false,21,19,-2,41.90294,-87.63137
TA1305000034,5,21,false,14,13,-1,41.90313,-87.67391
KA1504000135,5,21,false,19,20,1,41.90319,-87.63439
13136,5,21,false,5,10,5,41.90326,-87.67845
13061,5,21,false,20,10,-10,41.90342,-87.66779
KA1504000079,5,21,false,5,4,-1,41.9035,-87.64334
TA1308000049,5,21,false,9,25,16,41.90672,-87.6349
KA1504000134,5,21,false,11,16,5,41.90687,-87.6262
13224,5,21,false,8,13,5,41.90706,-87.66725
TA1307000143,5,21,false,3,11,8,41.90762,-87.63854
13221,5,21,false,9,19,10,41.90765,-87.67254
TA1309000024,5,21,false,10,12,2,41.908,-87.63152
TA1305000041,5,21,false,26,10,-16,41.9094,-87.67769
331,5,21,false,7,2,-5,41.90965,-87.64812
TA1308000005,5,21,false,3,12,9,41.91042,-87.68238
13154,5,21,false,7,1,-6,41.91054,-87.65312
13058,5,21,false,10,5,-5,41.91059,-87.64942
TA1307000038,5,21,false,8,11,3,41.91138,-87.63868
LF-005,5,21,false,39,33,-6,41.91172,-87.62681
13128,5,21,false,11,9,-2,41.91197,-87.63197
TA1308000050,5,21,false,30,37,7,41.91211,-87.6347
13243,5,21,false,10,9,-1,41.91262,-87.6814
TA1306000032,5,21,false,7,11,4,41.9137,-87.65285
TA1307000166,5,21,false,4,6,2,41.91386,-87.64877
15655,5,21,false,6,1,-5,41.91401,-87.70514
13068,5,21,false,4,6,2,41.91554,-87.68703
13179,5,21,false,13,16,3,41.9157,-87.63461
13133,5,21,false,3,6,3,41.91598,-87.67733
15651,5,21,false,10,2,-8,41.91752,-87.70181
13266,5,21,false,1,5,4,41.91774,-87.69142
TA1309000029,5,21,false,2,6,4,41.9178,-87.68245
TA1309000006,5,21,false,8,1,-7,41.91809,-87.64375
13146,5,21,false,22,11,-11,41.91831,-87.63629
13059,5,21,false,12,10,-2,41.91845,-87.65222
13259,5,21,false,7,5,-2,41.91852,-87.69744
13192,5,21,false,17,22,5,41.91995,-87.64884
13242,5,21,false,4,6,2,41.92021,-87.69266
13292,5,21,false,5,1,-4,41.92152,-87.70733
TA1309000033,5,21,false,18,5,-13,41.92158,-87.65381
13193,5,21,false,21,26,5,41.92182,-87.64412
13191,5,21,false,8,10,2,41.92217,-87.63891
13084,5,21,false,11,9,-2,41.92268,-87.69715
LP-,5,21,false,15,4,-11,41.92396,-87.63584
TA1307000001,5,21,false,3,14,11,41.92535,-87.66581
TA1306000026,5,21,false,12,1,-11,41.92558,-87.65842
TA1306000016,5,21,false,12,4,-8,41.9256,-87.65371
TA1309000019,5,21,false,26,13,-13,41.92586,-87.63897
TA1309000058,5,21,false,7,11,4,41.92591,-87.64927
TA1308000001,5,21,false,26,15,-11,41.92627,-87.63086
13124,5,21,false,10,7,-3,41.92675,-87.63444
TA1309000023,5,21,false,8,9,1,41.9287,-87.65383
TA1307000113,5,21,false,9,8,-1,41.92878,-87.66391
13296,5,21,false,3,16,13,41.92883,-87.66852
TA1309000061,5,21,false,6,8,2,41.92915,-87.64909
TA1305000014,5,21,false,12,11,-1,41.92956,-87.64313
13085,5,21,false,12,11,-1,41.92958,-87.70789
TA1307000142,5,21,false,9,13,4,41.93125,-87.64432
13276,5,21,false,8,2,-6,41.93132,-87.63874
TA1307000064,5,21,false,6,7,1,41.93222,-87.65864
TA1306000014,5,21,false,2,13,11,41.93242,-87.65271
TA1309000039,5,21,false,14,8,-6,41.93258,-87.63642
TA1307000006,5,21,false,7,11,4,41.93571,-87.6636
TA1307000052,5,21,false,6,6,0,41.93628,-87.65266
TA1307000041,5,21,false,3,16,13,41.93669,-87.63683
13137,5,21,false,26,13,-13,41.9376,-87.6441
15642,5,21,false,10,6,-4,41.93843,-87.69801
TA1309000042,5,21,false,6,4,-2,41.93937,-87.66836
13229,5,21,false,5,6,1,41.93946,-87.66376
TA1308000019,5,21,false,7,3,-4,41.93973,-87.65886
13277,5,21,false,5,8,3,41.9401,-87.64546
TA1307000134,5,21,false,14,10,-4,41.94016,-87.65303
TA1309000049,5,21,false,4,13,9,41.94077,-87.63919
TA1307000138,5,21,false,5,2,-3,41.94334,-87.67094
13144,5,21,false,1,6,5,41.9434,-87.67964
TA1309000025,5,21,false,9,10,1,41.94368,-87.64894
13071,5,21,false,9,8,-1,41.94373,-87.66401
632,5,21,false,27,22,-5,41.94453,-87.6547
13278,5,21,false,4,8,4,41.94553,-87.64644
TA1309000050,5,21,false,5,2,-3,41.94618,-87.67331
13235,5,21,false,12,10,-2,41.94814,-87.66396
13325,5,21,false,6,9,3,41.94907,-87.64863
TA1307000126,5,21,false,29,11,-18,41.94936,-87.65451
TA1307000150,5,21,false,2,9,7,41.94945,-87.64646
TA1307000127,5,21,false,3,12,9,41.9508,-87.65918
13323,5,21,false,2,9,7,41.95282,-87.65
TA1309000043,5,21,false,5,7,2,41.95417,-87.66434
13063,5,21,false,3,5,2,41.95424,-87.65441
TA1308000022,5,21,false,9,15,6,41.95438,-87.64805
13379,5,21,false,1,9,8,41.95786,-87.6495
TA1309000027,5,21,false,3,6,3,41.9585,-87.65499
13389,5,21,false,3,8,5,41.961,-87.64958
TA1307000107,5,21,false,1,8,7,41.96164,-87.65464
TA1307000156,5,21,false,6,2,-4,41.96301,-87.68479
TA1308000012,5,21,false,19,16,-3,41.96398,-87.63818
639,5,21,false,1,9,8,41.96584,-87.64538
TA1307000119,5,21,false,5,7,2,41.96796,-87.65
TA1308000021,5,21,false,6,3,-3,41.96883,-87.65765
13108,5,21,false,2,5,3,41.97379,-87.65971
KA1504000146,5,21,false,9,1,-8,41.978,-87.66805
KA1504000152,5,21,false,4,7,3,41.98403,-87.65231
15571,5,21,false,7,6,-1,41.99478,-87.66028
KA1503000014,5,21,true,6,1,-5,41.7851,-87.60108
TA1308000009,5,21,true,1,6,5,41.79522,-87.58075
13216,5,21,true,3,5,2,41.83473,-87.62581
13215,5,21,true,1,5,4,41.83634,-87.6135
TA1309000055,5,21,true,3,7,4,41.8382,-87.64514
KA1503000038,5,21,true,5,8,3,41.83845,-87.6354
TA1308000036,5,21,true,1,5,4,41.83883,-87.62186
TA1307000139,5,21,true,3,5,2,41.84205,-87.61698
13075,5,21,true,5,1,-4,41.8531,-87.63192
15545,5,21,true,8,11,3,41.85627,-87.61334
13102,5,21,true,6,9,3,41.85762,-87.61942
13150,5,21,true,10,4,-6,41.85783,-87.62455
13164,5,21,true,5,4,-1,41.85818,-87.65648
TA1307000124,5,21,true,4,6,2,41.86411,-87.62372
13354,5,21,true,1,6,5,41.86524,-87.66651
13431,5,21,true,11,3,-8,41.8661,-87.60728
TA1305000002,5,21,true,9,8,-1,41.86721,-87.62597
KA1706005007,5,21,true,2,8,6,41.86749,-87.63219
SL-005,5,21,true,11,10,-1,41.8679,-87.62304
13160,5,21,true,10,8,-2,41.86947,-87.65548
TA1309000010,5,21,true,3,6,3,41.87074,-87.62574
TA1307000130,5,21,true,8,4,-4,41.87178,-87.65103
SL-008,5,21,true,7,4,-3,41.87209,-87.62956
13332,5,21,true,7,14,7,41.87219,-87.6615
SL-011,5,21,true,5,1,-4,41.87256,-87.63356
623,5,21,true,6,6,0,41.87272,-87.62399
13028,5,21,true,1,7,6,41.87475,-87.64981
15541,5,21,true,9,3,-6,41.8758,-87.62086
15539,5,21,true,5,4,-1,41.87763,-87.64405
13158,5,21,true,8,7,-1,41.87764,-87.64957
13157,5,21,true,1,7,6,41.87773,-87.6548
TA1305000025,5,21,true,3,8,5,41.87773,-87.63528
13156,5,21,true,1,6,5,41.88042,-87.65554
13300,5,21,true,8,12,4,41.88097,-87.61675
13008,5,21,true,7,1,-6,41.88105,-87.62408
TA1305000006,5,21,true,6,1,-5,41.88122,-87.6296
TA1307000120,5,21,true,11,13,2,41.88188,-87.64879
TA1305000032,5,21,true,6,8,2,41.88218,-87.64109
13353,5,21,true,3,6,3,41.88283,-87.6612
WL-012,5,21,true,3,8,5,41.88337,-87.6412
13053,5,21,true,12,8,-4,41.88365,-87.64863
15535,5,21,true,14,4,-10,41.8846,-87.64455
TA1305000029,5,21,true,4,7,3,41.88466,-87.62787
13263,5,21,true,8,4,-4,41.88467,-87.61952
TA1306000015,5,21,true,10,2,-8,41.88549,-87.65232
13021,5,21,true,5,3,-2,41.88559,-87.64184
TA1307000111,5,21,true,6,3,-3,41.88582,-87.63548
TA1305000011,5,21,true,6,8,2,41.886,-87.62418
TA1308000029,5,21,true,7,4,-3,41.88673,-87.62225
TA1307000131,5,21,true,3,7,4,41.88688,-87.62606
TA1305000022,5,21,true,5,5,0,41.88817,-87.63656
TA1306000003,5,21,true,12,10,-2,41.88867,-87.64442
KA1503000043,5,21,true,4,9,5,41.88918,-87.63851
13050,5,21,true,7,13,6,41.88919,-87.62775
TA1307000151,5,21,true,7,13,6,41.88993,-87.63427
13430,5,21,true,19,13,-6,41.89077,-87.63169
TA1306000013,5,21,true,6,8,2,41.89083,-87.61852
RN-,5,21,true,7,9,2,41.89102,-87.63546
TA1307000117,5,21,true,12,12,0,41.89144,-87.62675
13033,5,21,true,11,11,0,41.8916,-87.64835
TA1305000003,5,21,true,15,11,-4,41.89187,-87.62061
13022,5,21,true,13,17,4,41.89227,-87.61205
TA1306000029,5,21,true,8,9,1,41.89256,-87.61449
13265,5,21,true,8,12,4,41.89383,-87.64172
13045,5,21,true,9,6,-3,41.89403,-87.62931
KA1503000041,5,21,true,3,7,4,41.89452,-87.61798
TA1307000062,5,21,true,4,5,1,41.89466,-87.63839
TA1306000012,5,21,true,7,11,4,41.89475,-87.63438
KP1705001026,5,21,true,3,6,3,41.89483,-87.6323
13132,5,21,true,8,5,-3,41.89573,-87.67718
15530,5,21,true,11,8,-3,41.89575,-87.62596
13289,5,21,true,4,10,6,41.89638,-87.661
13303,5,21,true,6,9,3,41.89672,-87.63088
TA1307000061,5,21,true,5,8,3,41.89745,-87.62873
620,5,21,true,2,6,4,41.89817,-87.63754
KA1504000103,5,21,true,1,8,7,41.89842,-87.68659
15529,5,21,true,8,9,1,41.89858,-87.62206
TA1307000128,5,21,true,6,5,-1,41.89896,-87.6299
KA1504000116,5,21,true,1,7,6,41.90023,-87.64299
13290,5,21,true,4,11,7,41.90069,-87.66259
13042,5,21,true,9,4,-5,41.90097,-87.62377
KA1504000133,5,21,true,15,9,-6,41.90234,-87.62773
TA1307000039,5,21,true,16,24,8,41.90294,-87.63137
13256,5,21,true,6,2,-4,41.90302,-87.69749
TA1305000034,5,21,true,7,10,3,41.90313,-87.67391
KA1504000135,5,21,true,15,11,-4,41.90319,-87.63439
13136,5,21,true,4,7,3,41.90326,-87.67845
13061,5,21,true,8,9,1,41.90342,-87.66779
KA1504000079,5,21,true,5,5,0,41.9035,-87.64334
TA1308000049,5,21,true,17,18,1,41.90672,-87.6349
KA1504000134,5,21,true,6,4,-2,41.90687,-87.6262
13224,5,21,true,2,7,5,41.90706,-87.66725
TA1307000143,5,21,true,1,5,4,41.90762,-87.63854
13221,5,21,true,10,11,1,41.90765,-87.67254
TA1309000024,5,21,true,6,16,10,41.908,-87.63152
TA1305000041,5,21,true,12,11,-1,41.9094,-87.67769
331,5,21,true,12,7,-5,41.90965,-87.64812
TA1305000037,5,21,true,5,8,3,41.91018,-87.67003
LF-005,5,21,true,21,10,-11,41.91172,-87.62681
13128,5,21,true,5,4,-1,41.91197,-87.63197
TA1308000050,5,21,true,24,11,-13,41.91211,-87.6347
13243,5,21,true,5,3,-2,41.91262,-87.6814
TA1306000032,5,21,true,2,10,8,41.9137,-87.65285
TA1307000166,5,21,true,5,3,-2,41.91386,-87.64877
13068,5,21,true,3,5,2,41.91554,-87.68703
13179,5,21,true,11,11,0,41.9157,-87.63461
13266,5,21,true,5,3,-2,41.91774,-87.69142
TA1309000006,5,21,true,5,8,3,41.91809,-87.64375
TA1307000163,5,21,true,6,5,-1,41.91821,-87.65696
13146,5,21,true,12,14,2,41.91831,-87.63629
13059,5,21,true,7,12,5,41.91845,-87.65222
13192,5,21,true,6,9,3,41.91995,-87.64884
13242,5,21,true,6,2,-4,41.92021,-87.69266
TA1309000033,5,21,true,6,10,4,41.92158,-87.65381
13193,5,21,true,15,17,2,41.92182,-87.64412
13191,5,21,true,5,5,0,41.92217,-87.63891
13084,5,21,true,7,5,-2,41.92268,-87.69715
TA1307000001,5,21,true,9,2,-7,41.92535,-87.66581
TA1306000026,5,21,true,11,4,-7,41.92558,-87.65842
TA1306000016,5,21,true,10,6,-4,41.9256,-87.65371
TA1309000019,5,21,true,10,9,-1,41.92586,-87.63897
TA1309000058,5,21,true,6,6,0,41.92591,-87.64927
TA1308000001,5,21,true,6,4,-2,41.92627,-87.63086
TA1309000023,5,21,true,5,7,2,41.9287,-87.65383
TA1307000113,5,21,true,10,10,0,41.92878,-87.66391
TA1309000061,5,21,true,7,8,1,41.92915,-87.64909
TA1305000014,5,21,true,9,11,2,41.92956,-87.64313
TA1307000142,5,21,true,9,11,2,41.93125,-87.64432
13276,5,21,true,10,13,3,41.93132,-87.63874
TA1307000064,5,21,true,5,13,8,41.93222,-87.65864
TA1306000014,5,21,true,3,9,6,41.93242,-87.65271
TA1309000039,5,21,true,8,2,-6,41.93258,-87.63642
13294,5,21,true,1,6,5,41.9326,-87.66595
TA1309000036,5,21,true,4,11,7,41.93313,-87.64776
TA1307000006,5,21,true,5,12,7,41.93571,-87.6636
TA1307000052,5,21,true,9,10,1,41.93628,-87.65266
TA1307000136,5,21,true,8,8,0,41.9365,-87.64755
TA1307000041,5,21,true,9,11,2,41.93669,-87.63683
13137,5,21,true,15,15,0,41.9376,-87.6441
TA1308000019,5,21,true,2,5,3,41.93973,-87.65886
13277,5,21,true,8,9,1,41.9401,-87.64546
TA1307000134,5,21,true,9,16,7,41.94016,-87.65303
TA1309000049,5,21,true,6,7,1,41.94077,-87.63919
TA1307000138,5,21,true,6,3,-3,41.94334,-87.67094
TA1309000025,5,21,true,10,15,5,41.94368,-87.64894
13071,5,21,true,9,14,5,41.94373,-87.66401
632,5,21,true,14,12,-2,41.94453,-87.6547
13278,5,21,true,9,14,5,41.94553,-87.64644
13235,5,21,true,10,12,2,41.94814,-87.66396
13325,5,21,true,3,10,7,41.94907,-87.64863
TA1307000126,5,21,true,11,10,-1,41.94936,-87.65451
TA1307000150,5,21,true,2,6,4,41.94945,-87.64646
TA1307000127,5,21,true,6,4,-2,41.9508,-87.65918
13063,5,21,true,8,14,6,41.95424,-87.65441
TA1307000149,5,21,true,5,3,-2,41.95467,-87.67392
13379,5,21,true,7,12,5,41.95786,-87.6495
TA1309000027,5,21,true,1,7,6,41.9585,-87.65499
13389,5,21,true,2,5,3,41.961,-87.64958
TA1307000144,5,21,true,6,5,-1,41.96142,-87.6762
TA1307000107,5,21,true,9,7,-2,41.96164,-87.65464
TA1308000012,5,21,true,10,7,-3,41.96398,-87.63818
13074,5,21,true,8,5,-3,41.96521,-87.6582
KA1504000093,5,21,true,2,6,4,41.96587,-87.69365
TA1309000014,5,21,true,6,2,-4,41.96709,-87.66744
TA1309000066,5,21,true,3,5,2,41.9691,-87.67423
TA1309000041,5,21,true,4,6,2,41.96951,-87.65471
13108,5,21,true,2,5,3,41.97379,-87.65971
KA1504000146,5,21,true,7,4,-3,41.978,-87.66805
KA1504000151,5,21,true,4,6,2,41.98359,-87.66916
KA1504000152,5,21,true,5,4,-1,41.98403,-87.65231
15575,5,21,true,5,2,-3,41.98975,-87.66014
596,5,21,true,6,6,0,42.04822,-87.68348
KA1503000018,5,22,false,1,5,4,41.76663,-87.57645
KA1503000014,5,22,false,5,8,3,41.7851,-87.60108
TA1308000009,5,22,false,13,13,0,41.79522,-87.58075
TA1307000164,5,22,false,4,10,6,41.79527,-87.59647
KA1503000052,5,22,false,7,1,-6,41.79935,-87.60097
KA1503000059,5,22,false,7,2,-5,41.79952,-87.58643
TA1309000037,5,22,false,5,10,5,41.79957,-87.59474
KA1503000005,5,22,false,6,2,-4,41.83079,-87.6325
KA1503000004,5,22,false,7,3,-4,41.83127,-87.6088
15445,5,22,false,7,1,-6,41.83453,-87.63183
13216,5,22,false,1,5,4,41.83473,-87.62581
TA1307000048,5,22,false,16,6,-10,41.83855,-87.60821
TA1308000026,5,22,false,5,2,-3,41.85008,-87.63214
13102,5,22,false,4,6,2,41.85762,-87.61942
13150,5,22,false,4,6,2,41.85783,-87.62455
TA1307000159,5,22,false,5,3,-2,41.8579,-87.6687
13164,5,22,false,5,2,-3,41.85818,-87.65648
SL-012,5,22,false,10,7,-3,41.86038,-87.62581
TA1307000124,5,22,false,7,15,8,41.86411,-87.62372
13431,5,22,false,5,10,5,41.8661,-87.60728
TA1305000002,5,22,false,12,13,1,41.86721,-87.62597
KA1706005007,5,22,false,1,5,4,41.86749,-87.63219
SL-005,5,22,false,15,30,15,41.8679,-87.62304
15550,5,22,false,13,6,-7,41.87024,-87.63947
TA1309000010,5,22,false,22,27,5,41.87074,-87.62574
SL-008,5,22,false,8,9,1,41.87209,-87.62956
13332,5,22,false,1,11,10,41.87219,-87.6615
SL-011,5,22,false,6,12,6,41.87256,-87.63356
623,5,22,false,20,32,12,41.87272,-87.62399
SL-007,5,22,false,4,16,12,41.87404,-87.6277
15541,5,22,false,21,23,2,41.8758,-87.62086
TA1305000009,5,22,false,6,2,-4,41.87593,-87.63068
624,5,22,false,5,5,0,41.87626,-87.62923
13158,5,22,false,8,4,-4,41.87764,-87.64957
13157,5,22,false,3,6,3,41.87773,-87.6548
TA1305000025,5,22,false,7,3,-4,41.87773,-87.63528
TA1309000004,5,22,false,7,6,-1,41.87811,-87.63184
13011,5,22,false,7,12,5,41.87931,-87.63993
KA1503000034,5,22,false,1,5,4,41.87938,-87.63197
13300,5,22,false,28,27,-1,41.88097,-87.61675
13008,5,22,false,44,40,-4,41.88105,-87.62408
TA1305000006,5,22,false,9,5,-4,41.88122,-87.6296
TA1307000120,5,22,false,7,5,-2,41.88188,-87.64879
13341,5,22,false,5,5,0,41.88208,-87.63985
13036,5,22,false,2,6,4,41.8821,-87.62513
13353,5,22,false,3,6,3,41.88283,-87.6612
13409,5,22,false,5,8,3,41.8831,-87.6511
WL-012,5,22,false,3,5,2,41.88337,-87.6412
13053,5,22,false,13,5,-8,41.88365,-87.64863
13001,5,22,false,11,12,1,41.88397,-87.62459
18062,5,22,false,24,3,-21,41.88412,-87.65427
TA1306000010,5,22,false,5,6,1,41.88419,-87.62961
TA1305000030,5,22,false,5,10,5,41.88459,-87.63178
15535,5,22,false,9,4,-5,41.8846,-87.64455
TA1305000029,5,22,false,9,14,5,41.88466,-87.62787
13263,5,22,false,18,8,-10,41.88467,-87.61952
TA1306000015,5,22,false,31,15,-16,41.88549,-87.65232
TA1307000111,5,22,false,12,2,-10,41.88582,-87.63548
KA1503000012,5,22,false,4,6,2,41.88599,-87.63089
TA1305000011,5,22,false,29,24,-5,41.886,-87.62418
15534,5,22,false,8,10,2,41.88627,-87.61749
TA1308000029,5,22,false,14,8,-6,41.88673,-87.62225
TA1307000131,5,22,false,23,9,-14,41.88688,-87.62606
KA1503000064,5,22,false,5,8,3,41.88697,-87.61281
TA1305000022,5,22,false,5,3,-2,41.88817,-87.63656
TA1306000003,5,22,false,5,10,5,41.88867,-87.64442
KA1503000043,5,22,false,4,7,3,41.88918,-87.63851
13050,5,22,false,24,12,-12,41.88919,-87.62775
TA1307000151,5,22,false,20,24,4,41.88993,-87.63427
636,5,22,false,7,6,-1,41.88997,-87.63662
13427,5,22,false,6,6,0,41.89054,-87.62205
13430,5,22,false,9,19,10,41.89077,-87.63169
TA1306000013,5,22,false,28,18,-10,41.89083,-87.61852
RN-,5,22,false,1,8,7,41.89102,-87.63546
TA1307000117,5,22,false,16,22,6,41.89144,-87.62675
13033,5,22,false,6,4,-2,41.8916,-87.64835
13194,5,22,false,6,5,-1,41.8918,-87.65878
TA1305000003,5,22,false,18,17,-1,41.89187,-87.62061
13022,5,22,false,50,52,2,41.89227,-87.61205
TA1306000029,5,22,false,7,16,9,41.89256,-87.61449
13265,5,22,false,2,7,5,41.89383,-87.64172
13045,5,22,false,19,15,-4,41.89403,-87.62931
13016,5,22,false,6,11,5,41.89431,-87.62277
KA1503000041,5,22,false,11,19,8,41.89452,-87.61798
TA1306000012,5,22,false,8,17,9,41.89475,-87.63438
13132,5,22,false,6,7,1,41.89573,-87.67718
15530,5,22,false,5,8,3,41.89575,-87.62596
13247,5,22,false,5,7,2,41.89597,-87.66775
TA1305000020,5,22,false,8,4,-4,41.89636,-87.65406
13289,5,22,false,1,6,5,41.89638,-87.661
13303,5,22,false,8,5,-3,41.89672,-87.63088
13017,5,22,false,7,6,-1,41.89676,-87.6357
13338,5,22,false,2,8,6,41.89697,-87.62173
TA1307000061,5,22,false,9,2,-7,41.89745,-87.62873
13034,5,22,false,8,3,-5,41.89754,-87.62352
620,5,22,false,2,5,3,41.89817,-87.63754
KA1504000103,5,22,false,2,6,4,41.89842,-87.68659
15529,5,22,false,11,20,9,41.89858,-87.62206
13248,5,22,false,4,6,2,41.89964,-87.66788
TA1306000011,5,22,false,5,4,-1,41.89994,-87.63443
13290,5,22,false,8,1,-7,41.90069,-87.66259
13042,5,22,false,21,20,-1,41.90097,-87.62377
TA1307000070,5,22,false,1,8,7,41.90133,-87.67742
KA1504000133,5,22,false,5,8,3,41.90234,-87.62773
TA1307000039,5,22,false,27,36,9,41.90294,-87.63137
TA1305000034,5,22,false,8,12,4,41.90313,-87.67391
KA1504000135,5,22,false,14,17,3,41.90319,-87.63439
KA1504000079,5,22,false,7,7,0,41.9035,-87.64334
TA1308000049,5,22,false,23,21,-2,41.90672,-87.6349
KA1504000134,5,22,false,2,7,5,41.90687,-87.6262
TA1307000143,5,22,false,1,7,6,41.90762,-87.63854
13221,5,22,false,8,9,1,41.90765,-87.67254
TA1309000024,5,22,false,6,10,4,41.908,-87.63152
TA1305000041,5,22,false,12,16,4,41.9094,-87.67769
TA1305000037,5,22,false,6,4,-2,41.91018,-87.67003
TA1308000005,5,22,false,6,4,-2,41.91042,-87.68238
13058,5,22,false,8,1,-7,41.91059,-87.64942
TA1307000038,5,22,false,13,2,-11,41.91138,-87.63868
LF-005,5,22,false,20,16,-4,41.91172,-87.62681
13128,5,22,false,3,5,2,41.91197,-87.63197
TA1308000050,5,22,false,37,36,-1,41.91211,-87.6347
13243,5,22,false,12,6,-6,41.91262,-87.6814
TA1306000032,5,22,false,7,8,1,41.9137,-87.65285
TA1307000166,5,22,false,5,5,0,41.91386,-87.64877
13068,5,22,false,8,11,3,41.91554,-87.68703
13179,5,22,false,22,24,2,41.9157,-87.63461
13133,5,22,false,6,11,5,41.91598,-87.67733
TA1309000006,5,22,false,7,4,-3,41.91809,-87.64375
13146,5,22,false,15,12,-3,41.91831,-87.63629
13059,5,22,false,6,9,3,41.91845,-87.65222
13192,5,22,false,10,11,1,41.91995,-87.64884
13242,5,22,false,1,6,5,41.92021,-87.69266
TA1309000033,5,22,false,16,11,-5,41.92158,-87.65381
13193,5,22,false,17,22,5,41.92182,-87.64412
13191,5,22,false,5,10,5,41.92217,-87.63891
13084,5,22,false,13,7,-6,41.92268,-87.69715
LP-,5,22,false,5,5,0,41.92396,-87.63584
KA1504000140,5,22,false,1,6,5,41.92409,-87.67646
TA1307000001,5,22,false,8,3,-5,41.92535,-87.66581
TA1306000026,5,22,false,7,14,7,41.92558,-87.65842
TA1306000016,5,22,false,11,3,-8,41.9256,-87.65371
TA1309000019,5,22,false,8,14,6,41.92586,-87.63897
TA1309000058,5,22,false,13,6,-7,41.92591,-87.64927
TA1308000001,5,22,false,9,15,6,41.92627,-87.63086
13124,5,22,false,7,12,5,41.92675,-87.63444
TA1309000023,5,22,false,7,9,2,41.9287,-87.65383
TA1307000113,5,22,false,13,11,-2,41.92878,-87.66391
13296,5,22,false,9,3,-6,41.92883,-87.66852
TA1309000061,5,22,false,14,20,6,41.92915,-87.64909
TA1305000014,5,22,false,14,14,0,41.92956,-87.64313
13085,5,22,false,5,8,3,41.92958,-87.70789
TA1307000142,5,22,false,10,21,11,41.93125,-87.64432
13276,5,22,false,7,7,0,41.93132,-87.63874
TA1307000064,5,22,false,12,15,3,41.93222,-87.65864
TA1306000014,5,22,false,6,6,0,41.93242,-87.65271
TA1309000039,5,22,false,3,15,12,41.93258,-87.63642
TA1307000006,5,22,false,1,6,5,41.93571,-87.6636
13268,5,22,false,2,5,3,41.93588,-87.67843
TA1307000052,5,22,false,10,7,-3,41.93628,-87.65266
TA1307000136,5,22,false,12,8,-4,41.9365,-87.64755
TA1307000041,5,22,false,9,7,-2,41.93669,-87.63683
13137,5,22,false,10,7,-3,41.9376,-87.6441
KA17018068,5,22,false,5,4,-1,41.93935,-87.68327
13229,5,22,false,9,5,-4,41.93946,-87.66376
TA1308000019,5,22,false,26,11,-15,41.93973,-87.65886
13277,5,22,false,8,3,-5,41.9401,-87.64546
TA1307000134,5,22,false,24,9,-15,41.94016,-87.65303
TA1309000049,5,22,false,6,13,7,41.94077,-87.63919
TA1307000138,5,22,false,3,7,4,41.94334,-87.67094
TA1309000025,5,22,false,5,8,3,41.94368,-87.64894
13071,5,22,false,15,6,-9,41.94373,-87.66401
632,5,22,false,30,24,-6,41.94453,-87.6547
13278,5,22,false,12,14,2,41.94553,-87.64644
13235,5,22,false,14,11,-3,41.94814,-87.66396
13325,5,22,false,8,5,-3,41.94907,-87.64863
TA1307000126,5,22,false,7,16,9,41.94936,-87.65451
13319,5,22,false,5,6,1,41.95069,-87.6687
TA1307000127,5,22,false,16,2,-14,41.9508,-87.65918
13323,5,22,false,3,10,7,41.95282,-87.65
TA1309000043,5,22,false,8,2,-6,41.95417,-87.66434
13063,5,22,false,6,5,-1,41.95424,-87.65441
TA1307000149,5,22,false,5,3,-2,41.95467,-87.67392
TA1308000047,5,22,false,5,2,-3,41.95709,-87.6642
13379,5,22,false,2,5,3,41.95786,-87.6495
TA1307000156,5,22,false,2,5,3,41.96301,-87.68479
TA1308000012,5,22,false,17,11,-6,41.96398,-87.63818
13074,5,22,false,5,3,-2,41.96521,-87.6582
TA1309000014,5,22,false,15,11,-4,41.96709,-87.66744
TA1309000066,5,22,false,7,6,-1,41.9691,-87.67423
TA1309000035,5,22,false,6,8,2,41.97335,-87.66785
KA1504000149,5,22,false,1,5,4,41.97562,-87.67945
KA1504000146,5,22,false,12,3,-9,41.978,-87.66805
E008,5,22,false,3,6,3,42.05049,-87.67782
13217,5,22,true,6,10,4,41.83488,-87.61792
KA1503000038,5,22,true,1,5,4,41.83845,-87.6354
13150,5,22,true,3,8,5,41.85783,-87.62455
SL-012,5,22,true,4,6,2,41.86038,-87.62581
TA1309000001,5,22,true,4,6,2,41.86488,-87.64708
TA1305000002,5,22,true,8,6,-2,41.86721,-87.62597
KA1706005007,5,22,true,8,2,-6,41.86749,-87.63219
SL-005,5,22,true,6,8,2,41.8679,-87.62304
644,5,22,true,3,5,2,41.86859,-87.68625
13139,5,22,true,5,3,-2,41.86893,-87.65913
TA1309000010,5,22,true,1,5,4,41.87074,-87.62574
SL-008,5,22,true,10,7,-3,41.87209,-87.62956
13332,5,22,true,6,12,6,41.87219,-87.6615
SL-011,5,22,true,3,7,4,41.87256,-87.63356
623,5,22,true,5,2,-3,41.87272,-87.62399
13158,5,22,true,9,8,-1,41.87764,-87.64957
13157,5,22,true,4,10,6,41.87773,-87.6548
TA1305000025,5,22,true,3,5,2,41.87773,-87.63528
TA1305000006,5,22,true,7,5,-2,41.88122,-87.6296
13353,5,22,true,6,1,-5,41.88283,-87.6612
13409,5,22,true,5,5,0,41.8831,-87.6511
13053,5,22,true,8,6,-2,41.88365,-87.64863
18062,5,22,true,6,6,0,41.88412,-87.65427
TA1306000010,5,22,true,6,2,-4,41.88419,-87.62961
15535,5,22,true,5,7,2,41.8846,-87.64455
TA1305000029,5,22,true,6,2,-4,41.88466,-87.62787
TA1306000015,5,22,true,13,8,-5,41.88549,-87.65232
13021,5,22,true,3,5,2,41.88559,-87.64184
KA1503000012,5,22,true,5,3,-2,41.88599,-87.63089
TA1305000011,5,22,true,6,5,-1,41.886,-87.62418
TA1306000003,5,22,true,7,15,8,41.88867,-87.64442
KA1503000043,5,22,true,8,7,-1,41.88918,-87.63851
13050,5,22,true,10,4,-6,41.88919,-87.62775
636,5,22,true,5,3,-2,41.88997,-87.63662
13430,5,22,true,11,6,-5,41.89077,-87.63169
TA1306000013,5,22,true,11,8,-3,41.89083,-87.61852
RN-,5,22,true,7,7,0,41.89102,-87.63546
13434,5,22,true,3,6,3,41.89108,-87.66663
TA1307000117,5,22,true,5,4,-1,41.89144,-87.62675
13033,5,22,true,8,9,1,41.8916,-87.64835
TA1305000003,5,22,true,11,3,-8,41.89187,-87.62061
13022,5,22,true,6,5,-1,41.89227,-87.61205
TA1306000029,5,22,true,3,6,3,41.89256,-87.61449
13265,5,22,true,6,8,2,41.89383,-87.64172
13045,5,22,true,11,6,-5,41.89403,-87.62931
13016,5,22,true,5,3,-2,41.89431,-87.62277
KA1503000041,5,22,true,4,9,5,41.89452,-87.61798
TA1307000062,5,22,true,3,7,4,41.89466,-87.63839
TA1306000012,5,22,true,9,9,0,41.89475,-87.63438
KP1705001026,5,22,true,2,5,3,41.89483,-87.6323
13132,5,22,true,7,3,-4,41.89573,-87.67718
15530,5,22,true,5,7,2,41.89575,-87.62596
13247,5,22,true,4,5,1,41.89597,-87.66775
13303,5,22,true,8,6,-2,41.89672,-87.63088
TA1307000061,5,22,true,3,10,7,41.89745,-87.62873
KA1504000103,5,22,true,1,8,7,41.89842,-87.68659
13042,5,22,true,5,6,1,41.90097,-87.62377
KA1504000133,5,22,true,10,11,1,41.90234,-87.62773
TA1307000039,5,22,true,16,19,3,41.90294,-87.63137
TA1305000034,5,22,true,2,7,5,41.90313,-87.67391
KA1504000135,5,22,true,11,10,-1,41.90319,-87.63439
13136,5,22,true,1,5,4,41.90326,-87.67845
13061,5,22,true,6,9,3,41.90342,-87.66779
TA1308000049,5,22,true,12,8,-4,41.90672,-87.6349
13221,5,22,true,7,1,-6,41.90765,-87.67254
TA1309000024,5,22,true,14,11,-3,41.908,-87.63152
TA1305000041,5,22,true,13,6,-7,41.9094,-87.67769
331,5,22,true,1,6,5,41.90965,-87.64812
TA1305000037,5,22,true,6,4,-2,41.91018,-87.67003
TA1306000008,5,22,true,3,5,2,41.9102,-87.6435
13257,5,22,true,3,6,3,41.91054,-87.68956
TA1307000038,5,22,true,5,11,6,41.91138,-87.63868
LF-005,5,22,true,11,2,-9,41.91172,-87.62681
TA1308000050,5,22,true,23,29,6,41.91211,-87.6347
13243,5,22,true,5,11,6,41.91262,-87.6814
TA1306000032,5,22,true,2,7,5,41.9137,-87.65285
TA1307000166,5,22,true,5,4,-1,41.91386,-87.64877
13179,5,22,true,9,10,1,41.9157,-87.63461
TA1309000006,5,22,true,4,6,2,41.91809,-87.64375
TA1307000163,5,22,true,6,6,0,41.91821,-87.65696
13146,5,22,true,6,6,0,41.91831,-87.63629
13059,5,22,true,14,6,-8,41.91845,-87.65222
13192,5,22,true,4,8,4,41.91995,-87.64884
13288,5,22,true,2,6,4,41.92008,-87.67788
TA1309000033,5,22,true,3,12,9,41.92158,-87.65381
13193,5,22,true,13,5,-8,41.92182,-87.64412
13191,5,22,true,8,6,-2,41.92217,-87.63891
13084,5,22,true,9,2,-7,41.92268,-87.69715
TA1307000001,5,22,true,4,7,3,41.92535,-87.66581
TA1306000016,5,22,true,6,2,-4,41.9256,-87.65371
TA1309000019,5,22,true,3,9,6,41.92586,-87.63897
TA1309000058,5,22,true,14,11,-3,41.92591,-87.64927
TA1308000001,5,22,true,6,4,-2,41.92627,-87.63086
TA1309000023,5,22,true,9,8,-1,41.9287,-87.65383
TA1307000113,5,22,true,6,9,3,41.92878,-87.66391
TA1309000061,5,22,true,10,7,-3,41.92915,-87.64909
TA1305000014,5,22,true,2,5,3,41.92956,-87.64313
TA1307000142,5,22,true,11,13,2,41.93125,-87.64432
13276,5,22,true,5,8,3,41.93132,-87.63874
TA1309000039,5,22,true,8,10,2,41.93258,-87.63642
13294,5,22,true,3,6,3,41.9326,-87.66595
13268,5,22,true,2,5,3,41.93588,-87.67843
TA1307000136,5,22,true,12,3,-9,41.9365,-87.64755
TA1307000041,5,22,true,2,5,3,41.93669,-87.63683
13137,5,22,true,14,8,-6,41.9376,-87.6441
TA1309000042,5,22,true,4,5,1,41.93937,-87.66836
13229,5,22,true,3,5,2,41.93946,-87.66376
TA1308000019,5,22,true,8,8,0,41.93973,-87.65886
13277,5,22,true,3,6,3,41.9401,-87.64546
TA1307000134,5,22,true,11,10,-1,41.94016,-87.65303
TA1309000049,5,22,true,10,3,-7,41.94077,-87.63919
TA1307000138,5,22,true,5,3,-2,41.94334,-87.67094
TA1309000025,5,22,true,3,9,6,41.94368,-87.64894
13071,5,22,true,9,8,-1,41.94373,-87.66401
632,5,22,true,10,6,-4,41.94453,-87.6547
13278,5,22,true,8,18,10,41.94553,-87.64644
13235,5,22,true,11,4,-7,41.94814,-87.66396
13325,5,22,true,10,6,-4,41.94907,-87.64863
TA1307000126,5,22,true,7,11,4,41.94936,-87.65451
TA1307000127,5,22,true,9,6,-3,41.9508,-87.65918
13323,5,22,true,7,5,-2,41.95282,-87.65
TA1309000043,5,22,true,5,2,-3,41.95417,-87.66434
13063,5,22,true,9,6,-3,41.95424,-87.65441
TA1309000026,5,22,true,5,2,-3,41.95601,-87.6802
KA1503000022,5,22,true,5,3,-2,41.96158,-87.66609
TA1307000107,5,22,true,2,5,3,41.96164,-87.65464
TA1309000014,5,22,true,5,9,4,41.96709,-87.66744
TA1307000158,5,22,true,2,8,6,41.9671,-87.67904
KA1504000146,5,22,true,11,6,-5,41.978,-87.66805
655,5,22,true,5,2,-3,41.97987,-87.68194
KA1504000152,5,22,true,6,11,5,41.98403,-87.65231
KA1503000014,5,23,false,1,5,4,41.7851,-87.60108
TA1308000009,5,23,false,14,10,-4,41.79522,-87.58075
KA1503000052,5,23,false,2,7,5,41.79935,-87.60097
KA1503000059,5,23,false,2,6,4,41.79952,-87.58643
KA1503000005,5,23,false,5,1,-4,41.83079,-87.6325
TA1307000048,5,23,false,11,7,-4,41.83855,-87.60821
TA1305000004,5,23,false,2,8,6,41.8514,-87.61884
13075,5,23,false,10,6,-4,41.8531,-87.63192
15546,5,23,false,4,7,3,41.85416,-87.61916
13102,5,23,false,5,5,0,41.85762,-87.61942
13150,5,23,false,7,3,-4,41.85783,-87.62455
13164,5,23,false,1,7,6,41.85818,-87.65648
SL-012,5,23,false,6,13,7,41.86038,-87.62581
TA1307000124,5,23,false,8,7,-1,41.86411,-87.62372
13431,5,23,false,9,3,-6,41.8661,-87.60728
TA1305000002,5,23,false,9,3,-6,41.86721,-87.62597
TA1305000017,5,23,false,1,5,4,41.86734,-87.64863
SL-005,5,23,false,13,15,2,41.8679,-87.62304
13139,5,23,false,2,5,3,41.86893,-87.65913
TA1309000010,5,23,false,7,7,0,41.87074,-87.62574
SL-008,5,23,false,11,21,10,41.87209,-87.62956
13332,5,23,false,1,5,4,41.87219,-87.6615
SL-011,5,23,false,6,6,0,41.87256,-87.63356
623,5,23,false,25,25,0,41.87272,-87.62399
SL-007,5,23,false,5,5,0,41.87404,-87.6277
15541,5,23,false,26,19,-7,41.8758,-87.62086
TA1305000010,5,23,false,11,15,4,41.87623,-87.62444
624,5,23,false,5,4,-1,41.87626,-87.62923
TA1305000035,5,23,false,5,5,0,41.87716,-87.62787
13158,5,23,false,7,7,0,41.87764,-87.64957
TA1309000002,5,23,false,8,11,3,41.87784,-87.62408
KA1503000015,5,23,false,2,7,5,41.87948,-87.6257
WL-011,5,23,false,4,5,1,41.88034,-87.64273
13300,5,23,false,22,17,-5,41.88097,-87.61675
13008,5,23,false,42,42,0,41.88105,-87.62408
TA1305000006,5,23,false,1,10,9,41.88122,-87.6296
TA1307000120,5,23,false,10,4,-6,41.88188,-87.64879
13036,5,23,false,8,2,-6,41.8821,-87.62513
TA1305000032,5,23,false,1,5,4,41.88218,-87.64109
13409,5,23,false,8,4,-4,41.8831,-87.6511
WL-012,5,23,false,3,6,3,41.88337,-87.6412
13053,5,23,false,14,12,-2,41.88365,-87.64863
13001,5,23,false,11,22,11,41.88397,-87.62459
13155,5,23,false,8,1,-7,41.88407,-87.65689
18062,5,23,false,1,13,12,41.88412,-87.65427
TA1306000010,5,23,false,1,8,7,41.88419,-87.62961
TA1305000030,5,23,false,9,1,-8,41.88459,-87.63178
15535,5,23,false,13,4,-9,41.8846,-87.64455
TA1305000029,5,23,false,18,11,-7,41.88466,-87.62787
13263,5,23,false,11,17,6,41.88467,-87.61952
TA1306000015,5,23,false,25,5,-20,41.88549,-87.65232
13021,5,23,false,8,6,-2,41.88559,-87.64184
KA1503000012,5,23,false,6,5,-1,41.88599,-87.63089
TA1305000011,5,23,false,30,18,-12,41.886,-87.62418
TA1308000029,5,23,false,14,10,-4,41.88673,-87.62225
TA1307000131,5,23,false,25,17,-8,41.88688,-87.62606
KA1503000064,5,23,false,6,3,-3,41.88697,-87.61281
TA1306000003,5,23,false,6,12,6,41.88867,-87.64442
KA1503000043,5,23,false,3,5,2,41.88918,-87.63851
13050,5,23,false,34,6,-28,41.88919,-87.62775
TA1307000151,5,23,false,11,25,14,41.88993,-87.63427
636,5,23,false,7,7,0,41.88997,-87.63662
13427,5,23,false,2,6,4,41.89054,-87.62205
13430,5,23,false,27,19,-8,41.89077,-87.63169
TA1306000013,5,23,false,18,24,6,41.89083,-87.61852
RN-,5,23,false,3,6,3,41.89102,-87.63546
TA1308000006,5,23,false,3,8,5,41.89128,-87.67686
TA1307000117,5,23,false,33,19,-14,41.89144,-87.62675
13033,5,23,false,24,6,-18,41.8916,-87.64835
13194,5,23,false,2,5,3,41.8918,-87.65878
TA1305000003,5,23,false,17,12,-5,41.89187,-87.62061
13022,5,23,false,57,25,-32,41.89227,-87.61205
TA1306000029,5,23,false,5,11,6,41.89256,-87.61449
13265,5,23,false,4,10,6,41.89383,-87.64172
13045,5,23,false,14,10,-4,41.89403,-87.62931
13016,5,23,false,9,5,-4,41.89431,-87.62277
KA1503000041,5,23,false,9,6,-3,41.89452,-87.61798
13196,5,23,false,5,2,-3,41.89455,-87.65345
TA1307000062,5,23,false,8,3,-5,41.89466,-87.63839
TA1306000012,5,23,false,20,14,-6,41.89475,-87.63438
KP1705001026,5,23,false,5,12,7,41.89483,-87.6323
13132,5,23,false,5,2,-3,41.89573,-87.67718
13247,5,23,false,8,3,-5,41.89597,-87.66775
TA1305000020,5,23,false,3,6,3,41.89636,-87.65406
13303,5,23,false,14,6,-8,41.89672,-87.63088
13017,5,23,false,3,6,3,41.89676,-87.6357
13338,5,23,false,6,2,-4,41.89697,-87.62173
TA1307000061,5,23,false,8,8,0,41.89745,-87.62873
13034,5,23,false,3,7,4,41.89754,-87.62352
TA1306000009,5,23,false,6,4,-2,41.89772,-87.64299
KA1504000103,5,23,false,5,4,-1,41.89842,-87.68659
15529,5,23,false,9,2,-7,41.89858,-87.62206
TA1307000128,5,23,false,8,9,1,41.89896,-87.6299
657,5,23,false,3,9,6,41.89918,-87.6722
13248,5,23,false,3,9,6,41.89964,-87.66788
TA1306000011,5,23,false,6,2,-4,41.89994,-87.63443
KA1504000116,5,23,false,3,5,2,41.90023,-87.64299
13042,5,23,false,21,24,3,41.90097,-87.62377
KA1504000133,5,23,false,13,11,-2,41.90234,-87.62773
13241,5,23,false,2,6,4,41.9029,-87.68731
TA1307000039,5,23,false,17,22,5,41.90294,-87.63137
TA1305000034,5,23,false,16,4,-12,41.90313,-87.67391
KA1504000135,5,23,false,15,23,8,41.90319,-87.63439
13136,5,23,false,10,7,-3,41.90326,-87.67845
13061,5,23,false,10,9,-1,41.90342,-87.66779
TA1307000115,5,23,false,5,2,-3,41.9046,-87.64056
TA1308000049,5,23,false,39,24,-15,41.90672,-87.6349
KA1504000134,5,23,false,15,12,-3,41.90687,-87.6262
13224,5,23,false,5,4,-1,41.90706,-87.66725
TA1307000143,5,23,false,10,3,-7,41.90762,-87.63854
13221,5,23,false,8,7,-1,41.90765,-87.67254
TA1309000024,5,23,false,10,15,5,41.908,-87.63152
TA1305000041,5,23,false,8,12,4,41.9094,-87.67769
331,5,23,false,8,8,0,41.90965,-87.64812
TA1305000037,5,23,false,6,9,3,41.91018,-87.67003
TA1306000008,5,23,false,11,1,-10,41.9102,-87.6435
13058,5,23,false,1,8,7,41.91059,-87.64942
TA1307000038,5,23,false,12,12,0,41.91138,-87.63868
LF-005,5,23,false,7,7,0,41.91172,-87.62681
13128,5,23,false,5,5,0,41.91197,-87.63197
TA1308000050,5,23,false,64,40,-24,41.91211,-87.6347
13243,5,23,false,16,15,-1,41.91262,-87.6814
TA1306000032,5,23,false,3,7,4,41.9137,-87.65285
TA1307000166,5,23,false,9,8,-1,41.91386,-87.64877
18017,5,23,false,1,5,4,41.91416,-87.71676
TA1306000007,5,23,false,4,5,1,41.91469,-87.64333
13179,5,23,false,39,26,-13,41.9157,-87.63461
13133,5,23,false,11,11,0,41.91598,-87.67733
15651,5,23,false,9,2,-7,41.91752,-87.70181
TA1309000029,5,23,false,1,5,4,41.9178,-87.68245
TA1309000006,5,23,false,7,9,2,41.91809,-87.64375
TA1307000163,5,23,false,7,8,1,41.91821,-87.65696
13146,5,23,false,12,6,-6,41.91831,-87.63629
13059,5,23,false,10,13,3,41.91845,-87.65222
13192,5,23,false,16,16,0,41.91995,-87.64884
13288,5,23,false,5,1,-4,41.92008,-87.67788
13242,5,23,false,5,2,-3,41.92021,-87.69266
13292,5,23,false,5,3,-2,41.92152,-87.70733
TA1309000033,5,23,false,7,5,-2,41.92158,-87.65381
13193,5,23,false,39,24,-15,41.92182,-87.64412
13191,5,23,false,12,13,1,41.92217,-87.63891
13084,5,23,false,14,17,3,41.92268,-87.69715
LP-,5,23,false,1,6,5,41.92396,-87.63584
TA1307000001,5,23,false,9,17,8,41.92535,-87.66581
TA1306000026,5,23,false,3,6,3,41.92558,-87.65842
TA1306000016,5,23,false,12,6,-6,41.9256,-87.65371
TA1309000019,5,23,false,7,17,10,41.92586,-87.63897
TA1309000058,5,23,false,27,21,-6,41.92591,-87.64927
TA1308000001,5,23,false,10,11,1,41.92627,-87.63086
13124,5,23,false,6,15,9,41.92675,-87.63444
TA1309000023,5,23,false,12,8,-4,41.9287,-87.65383
TA1307000113,5,23,false,17,9,-8,41.92878,-87.66391
13296,5,23,false,4,10,6,41.92883,-87.66852
TA1309000059,5,23,false,1,8,7,41.92889,-87.65898
TA1309000061,5,23,false,18,19,1,41.92915,-87.64909
TA1308000031,5,23,false,7,1,-6,41.92946,-87.68417
TA1305000014,5,23,false,4,13,9,41.92956,-87.64313
TA1307000142,5,23,false,13,14,1,41.93125,-87.64432
13276,5,23,false,5,14,9,41.93132,-87.63874
13271,5,23,false,1,6,5,41.93192,-87.67784
TA1307000064,5,23,false,11,7,-4,41.93222,-87.65864
TA1306000014,5,23,false,26,13,-13,41.93242,-87.65271
TA1309000039,5,23,false,3,8,5,41.93258,-87.63642
13294,5,23,false,6,6,0,41.9326,-87.66595
TA1307000006,5,23,false,15,2,-13,41.93571,-87.6636
13268,5,23,false,2,7,5,41.93588,-87.67843
13269,5,23,false,3,7,4,41.93609,-87.66983
TA1307000052,5,23,false,21,8,-13,41.93628,-87.65266
TA1307000136,5,23,false,15,15,0,41.9365,-87.64755
TA1307000041,5,23,false,2,8,6,41.93669,-87.63683
13137,5,23,false,8,13,5,41.9376,-87.6441
TA1309000042,5,23,false,5,10,5,41.93937,-87.66836
13229,5,23,false,15,8,-7,41.93946,-87.66376
TA1308000019,5,23,false,14,18,4,41.93973,-87.65886
13277,5,23,false,5,8,3,41.9401,-87.64546
TA1307000134,5,23,false,23,22,-1,41.94016,-87.65303
TA1309000049,5,23,false,8,4,-4,41.94077,-87.63919
TA1307000138,5,23,false,8,4,-4,41.94334,-87.67094
TA1309000025,5,23,false,23,16,-7,41.94368,-87.64894
13071,5,23,false,7,5,-2,41.94373,-87.66401
632,5,23,false,23,25,2,41.94453,-87.6547
13278,5,23,false,9,9,0,41.94553,-87.64644
KA1504000142,5,23,false,9,9,0,41.94735,-87.71759
13235,5,23,false,13,10,-3,41.94814,-87.66396
13325,5,23,false,8,9,1,41.94907,-87.64863
TA1307000126,5,23,false,13,11,-2,41.94936,-87.65451
TA1307000150,5,23,false,9,16,7,41.94945,-87.64646
TA1307000127,5,23,false,5,11,6,41.9508,-87.65918
13323,5,23,false,17,4,-13,41.95282,-87.65
13063,5,23,false,7,10,3,41.95424,-87.65441
TA1308000022,5,23,false,6,4,-2,41.95438,-87.64805
TA1309000026,5,23,false,4,7,3,41.95601,-87.6802
TA1309000027,5,23,false,7,6,-1,41.9585,-87.65499
TA1307000107,5,23,false,6,11,5,41.96164,-87.65464
TA1307000156,5,23,false,6,4,-2,41.96301,-87.68479
TA1308000012,5,23,false,4,9,5,41.96398,-87.63818
13074,5,23,false,4,5,1,41.96521,-87.6582
TA1309000066,5,23,false,1,6,5,41.9691,-87.67423
TA1309000035,5,23,false,1,6,5,41.97335,-87.66785
KA1504000146,5,23,false,12,4,-8,41.978,-87.66805
KA1504000151,5,23,false,5,5,0,41.98359,-87.66916
15578,5,23,false,5,3,-2,41.98405,-87.66027
TA1308000009,5,23,true,5,1,-4,41.79522,-87.58075
15445,5,23,true,5,3,-2,41.83453,-87.63183
13215,5,23,true,1,6,5,41.83634,-87.6135
KA1503000038,5,23,true,3,6,3,41.83845,-87.6354
TA1307000139,5,23,true,6,1,-5,41.84205,-87.61698
TA1305000002,5,23,true,5,4,-1,41.86721,-87.62597
SL-005,5,23,true,4,6,2,41.8679,-87.62304
644,5,23,true,6,2,-4,41.86859,-87.68625
13139,5,23,true,2,5,3,41.86893,-87.65913
TA1309000010,5,23,true,9,6,-3,41.87074,-87.62574
13332,5,23,true,4,7,3,41.87219,-87.6615
SL-011,5,23,true,2,7,5,41.87256,-87.63356
623,5,23,true,5,5,0,41.87272,-87.62399
13157,5,23,true,3,6,3,41.87773,-87.6548
TA1305000025,5,23,true,5,8,3,41.87773,-87.63528
13008,5,23,true,5,1,-4,41.88105,-87.62408
TA1307000120,5,23,true,3,7,4,41.88188,-87.64879
13353,5,23,true,2,5,3,41.88283,-87.6612
13053,5,23,true,14,6,-8,41.88365,-87.64863
TA1306000010,5,23,true,1,5,4,41.88419,-87.62961
15535,5,23,true,9,3,-6,41.8846,-87.64455
13263,5,23,true,4,5,1,41.88467,-87.61952
TA1306000015,5,23,true,10,7,-3,41.88549,-87.65232
15534,5,23,true,1,6,5,41.88627,-87.61749
TA1306000003,5,23,true,18,9,-9,41.88867,-87.64442
KA1503000043,5,23,true,11,9,-2,41.88918,-87.63851
13050,5,23,true,9,4,-5,41.88919,-87.62775
TA1307000151,5,23,true,16,10,-6,41.88993,-87.63427
13430,5,23,true,8,7,-1,41.89077,-87.63169
TA1306000013,5,23,true,7,11,4,41.89083,-87.61852
RN-,5,23,true,6,6,0,41.89102,-87.63546
TA1307000117,5,23,true,11,9,-2,41.89144,-87.62675
13033,5,23,true,13,4,-9,41.8916,-87.64835
TA1305000003,5,23,true,7,1,-6,41.89187,-87.62061
643,5,23,true,1,5,4,41.89203,-87.68939
13022,5,23,true,3,8,5,41.89227,-87.61205
TA1306000029,5,23,true,2,5,3,41.89256,-87.61449
13265,5,23,true,4,8,4,41.89383,-87.64172
13045,5,23,true,10,8,-2,41.89403,-87.62931
KA1503000041,5,23,true,5,7,2,41.89452,-87.61798
TA1307000062,5,23,true,5,2,-3,41.89466,-87.63839
TA1306000012,5,23,true,8,7,-1,41.89475,-87.63438
13132,5,23,true,7,3,-4,41.89573,-87.67718
13303,5,23,true,8,7,-1,41.89672,-87.63088
620,5,23,true,1,5,4,41.89817,-87.63754
15529,5,23,true,6,8,2,41.89858,-87.62206
TA1307000128,5,23,true,10,7,-3,41.89896,-87.6299
13248,5,23,true,2,5,3,41.89964,-87.66788
TA1306000011,5,23,true,5,11,6,41.89994,-87.63443
13042,5,23,true,5,4,-1,41.90097,-87.62377
13241,5,23,true,1,6,5,41.9029,-87.68731
TA1307000039,5,23,true,8,15,7,41.90294,-87.63137
TA1305000034,5,23,true,6,4,-2,41.90313,-87.67391
KA1504000135,5,23,true,12,10,-2,41.90319,-87.63439
13136,5,23,true,5,3,-2,41.90326,-87.67845
13061,5,23,true,10,7,-3,41.90342,-87.66779
TA1307000115,5,23,true,6,5,-1,41.9046,-87.64056
TA1308000049,5,23,true,19,11,-8,41.90672,-87.6349
KA1504000134,5,23,true,3,5,2,41.90687,-87.6262
TA1309000024,5,23,true,6,8,2,41.908,-87.63152
TA1305000041,5,23,true,7,11,4,41.9094,-87.67769
TA1307000038,5,23,true,7,7,0,41.91138,-87.63868
LF-005,5,23,true,6,6,0,41.91172,-87.62681
13128,5,23,true,4,5,1,41.91197,-87.63197
TA1308000050,5,23,true,28,26,-2,41.91211,-87.6347
13243,5,23,true,5,8,3,41.91262,-87.6814
TA1306000032,5,23,true,5,5,0,41.9137,-87.65285
TA1307000166,5,23,true,11,6,-5,41.91386,-87.64877
13179,5,23,true,12,9,-3,41.9157,-87.63461
13133,5,23,true,5,7,2,41.91598,-87.67733
TA1309000006,5,23,true,8,5,-3,41.91809,-87.64375
TA1307000163,5,23,true,4,6,2,41.91821,-87.65696
13146,5,23,true,13,9,-4,41.91831,-87.63629
13059,5,23,true,3,10,7,41.91845,-87.65222
13192,5,23,true,12,4,-8,41.91995,-87.64884
13288,5,23,true,6,1,-5,41.92008,-87.67788
TA1309000033,5,23,true,8,13,5,41.92158,-87.65381
13193,5,23,true,20,6,-14,41.92182,-87.64412
13191,5,23,true,6,6,0,41.92217,-87.63891
TA1307000001,5,23,true,2,10,8,41.92535,-87.66581
TA1306000016,5,23,true,9,2,-7,41.9256,-87.65371
TA1309000019,5,23,true,15,12,-3,41.92586,-87.63897
TA1309000058,5,23,true,18,17,-1,41.92591,-87.64927
TA1308000001,5,23,true,8,7,-1,41.92627,-87.63086
TA1309000023,5,23,true,6,11,5,41.9287,-87.65383
TA1307000113,5,23,true,12,3,-9,41.92878,-87.66391
TA1309000059,5,23,true,2,7,5,41.92889,-87.65898
TA1309000061,5,23,true,14,8,-6,41.92915,-87.64909
TA1305000014,5,23,true,11,8,-3,41.92956,-87.64313
TA1307000142,5,23,true,10,11,1,41.93125,-87.64432
13276,5,23,true,2,11,9,41.93132,-87.63874
TA1307000064,5,23,true,10,9,-1,41.93222,-87.65864
TA1306000014,5,23,true,8,12,4,41.93242,-87.65271
TA1309000039,5,23,true,4,8,4,41.93258,-87.63642
13294,5,23,true,7,5,-2,41.9326,-87.66595
TA1309000036,5,23,true,8,6,-2,41.93313,-87.64776
TA1307000006,5,23,true,7,1,-6,41.93571,-87.6636
13269,5,23,true,4,6,2,41.93609,-87.66983
TA1307000052,5,23,true,9,3,-6,41.93628,-87.65266
TA1307000136,5,23,true,9,7,-2,41.9365,-87.64755
13137,5,23,true,8,11,3,41.9376,-87.6441
TA1309000042,5,23,true,5,1,-4,41.93937,-87.66836
TA1308000019,5,23,true,13,13,0,41.93973,-87.65886
13277,5,23,true,3,5,2,41.9401,-87.64546
TA1307000134,5,23,true,13,10,-3,41.94016,-87.65303
TA1309000049,5,23,true,5,2,-3,41.94077,-87.63919
TA1309000025,5,23,true,17,11,-6,41.94368,-87.64894
632,5,23,true,10,13,3,41.94453,-87.6547
13278,5,23,true,7,6,-1,41.94553,-87.64644
13235,5,23,true,7,1,-6,41.94814,-87.66396
13325,5,23,true,9,8,-1,41.94907,-87.64863
TA1307000126,5,23,true,6,9,3,41.94936,-87.65451
TA1307000150,5,23,true,3,8,5,41.94945,-87.64646
TA1307000127,5,23,true,8,9,1,41.9508,-87.65918
13323,5,23,true,2,5,3,41.95282,-87.65
13063,5,23,true,8,2,-6,41.95424,-87.65441
TA1308000022,5,23,true,3,6,3,41.95438,-87.64805
TA1308000012,5,23,true,5,2,-3,41.96398,-87.63818
13074,5,23,true,1,5,4,41.96521,-87.6582
TA1309000035,5,23,true,2,6,4,41.97335,-87.66785
KA1503000029,6,0,false,2,5,3,41.77364,-87.56747
KA1503000014,6,0,false,5,7,2,41.7851,-87.60108
TA1307000048,6,0,false,8,8,0,41.83855,-87.60821
13075,6,0,false,5,1,-4,41.8531,-87.63192
13089,6,0,false,1,5,4,41.85497,-87.67567
13164,6,0,false,2,8,6,41.85818,-87.65648
SL-012,6,0,false,1,8,7,41.86038,-87.62581
13431,6,0,false,1,13,12,41.8661,-87.60728
TA1305000002,6,0,false,6,19,13,41.86721,-87.62597
SL-005,6,0,false,23,20,-3,41.8679,-87.62304
TA1309000010,6,0,false,13,18,5,41.87074,-87.62574
SL-008,6,0,false,14,11,-3,41.87209,-87.62956
623,6,0,false,10,18,8,41.87272,-87.62399
SL-007,6,0,false,11,21,10,41.87404,-87.6277
SL-010,6,0,false,7,9,2,41.87501,-87.63309
15541,6,0,false,7,17,10,41.8758,-87.62086
TA1305000010,6,0,false,5,3,-2,41.87623,-87.62444
13158,6,0,false,5,4,-1,41.87764,-87.64957
TA1305000025,6,0,false,5,3,-2,41.87773,-87.63528
TA1309000002,6,0,false,21,20,-1,41.87784,-87.62408
TA1309000004,6,0,false,6,4,-2,41.87811,-87.63184
KA1503000015,6,0,false,7,2,-5,41.87948,-87.6257
WL-011,6,0,false,1,11,10,41.88034,-87.64273
13300,6,0,false,21,13,-8,41.88097,-87.61675
13008,6,0,false,36,41,5,41.88105,-87.62408
TA1305000006,6,0,false,3,5,2,41.88122,-87.6296
13056,6,0,false,9,1,-8,41.88168,-87.63951
TA1307000120,6,0,false,14,8,-6,41.88188,-87.64879
13409,6,0,false,12,9,-3,41.8831,-87.6511
13053,6,0,false,13,5,-8,41.88365,-87.64863
13001,6,0,false,23,17,-6,41.88397,-87.62459
TA1306000010,6,0,false,9,6,-3,41.88419,-87.62961
TA1305000030,6,0,false,8,8,0,41.88459,-87.63178
15535,6,0,false,12,5,-7,41.8846,-87.64455
TA1305000029,6,0,false,7,2,-5,41.88466,-87.62787
13263,6,0,false,9,6,-3,41.88467,-87.61952
TA1306000015,6,0,false,8,3,-5,41.88549,-87.65232
13021,6,0,false,4,9,5,41.88559,-87.64184
TA1307000111,6,0,false,2,14,12,41.88582,-87.63548
KA1503000012,6,0,false,6,13,7,41.88599,-87.63089
TA1305000011,6,0,false,5,24,19,41.886,-87.62418
15534,6,0,false,4,5,1,41.88627,-87.61749
13197,6,0,false,8,2,-6,41.8866,-87.65816
TA1308000029,6,0,false,11,15,4,41.88673,-87.62225
TA1307000131,6,0,false,5,16,11,41.88688,-87.62606
TA1305000022,6,0,false,1,5,4,41.88817,-87.63656
TA1306000003,6,0,false,17,13,-4,41.88867,-87.64442
KA1503000043,6,0,false,6,19,13,41.88918,-87.63851
13050,6,0,false,17,25,8,41.88919,-87.62775
TA1307000151,6,0,false,24,16,-8,41.88993,-87.63427
636,6,0,false,7,6,-1,41.88997,-87.63662
13427,6,0,false,7,2,-5,41.89054,-87.62205
13430,6,0,false,30,15,-15,41.89077,-87.63169
TA1306000013,6,0,false,24,21,-3,41.89083,-87.61852
RN-,6,0,false,6,9,3,41.89102,-87.63546
13434,6,0,false,3,7,4,41.89108,-87.66663
TA1307000117,6,0,false,18,12,-6,41.89144,-87.62675
13033,6,0,false,14,11,-3,41.8916,-87.64835
13194,6,0,false,7,7,0,41.8918,-87.65878
TA1305000003,6,0,false,4,19,15,41.89187,-87.62061
13022,6,0,false,31,34,3,41.89227,-87.61205
TA1306000029,6,0,false,15,8,-7,41.89256,-87.61449
13265,6,0,false,7,5,-2,41.89383,-87.64172
13045,6,0,false,4,12,8,41.89403,-87.62931
13016,6,0,false,9,5,-4,41.89431,-87.62277
KA1503000041,6,0,false,9,2,-7,41.89452,-87.61798
13196,6,0,false,1,5,4,41.89455,-87.65345
TA1307000062,6,0,false,9,7,-2,41.89466,-87.63839
TA1306000012,6,0,false,11,16,5,41.89475,-87.63438
KP1705001026,6,0,false,6,9,3,41.89483,-87.6323
13132,6,0,false,8,1,-7,41.89573,-87.67718
15530,6,0,false,4,10,6,41.89575,-87.62596
18003,6,0,false,2,6,4,41.89575,-87.62011
13247,6,0,false,5,10,5,41.89597,-87.66775
TA1305000020,6,0,false,13,6,-7,41.89636,-87.65406
13289,6,0,false,16,6,-10,41.89638,-87.661
13303,6,0,false,2,7,5,41.89672,-87.63088
13017,6,0,false,6,6,0,41.89676,-87.6357
13338,6,0,false,8,5,-3,41.89697,-87.62173
TA1307000061,6,0,false,16,10,-6,41.89745,-87.62873
13034,6,0,false,3,8,5,41.89754,-87.62352
620,6,0,false,3,6,3,41.89817,-87.63754
KA1504000103,6,0,false,3,10,7,41.89842,-87.68659
15529,6,0,false,5,3,-2,41.89858,-87.62206
TA1306000011,6,0,false,6,1,-5,41.89994,-87.63443
13042,6,0,false,7,14,7,41.90097,-87.62377
TA1307000070,6,0,false,7,5,-2,41.90133,-87.67742
KA1504000133,6,0,false,11,14,3,41.90234,-87.62773
13241,6,0,false,2,7,5,41.9029,-87.68731
TA1306000006,6,0,false,3,7,4,41.90292,-87.63772
TA1307000039,6,0,false,34,27,-7,41.90294,-87.63137
TA1305000034,6,0,false,13,7,-6,41.90313,-87.67391
KA1504000135,6,0,false,32,15,-17,41.90319,-87.63439
13136,6,0,false,8,7,-1,41.90326,-87.67845
13061,6,0,false,12,12,0,41.90342,-87.66779
KA1504000079,6,0,false,4,9,5,41.9035,-87.64334
TA1308000049,6,0,false,45,22,-23,41.90672,-87.6349
KA1504000134,6,0,false,2,7,5,41.90687,-87.6262
TA1307000143,6,0,false,3,11,8,41.90762,-87.63854
13221,6,0,false,14,9,-5,41.90765,-87.67254
TA1309000024,6,0,false,28,8,-20,41.908,-87.63152
TA1305000041,6,0,false,10,11,1,41.9094,-87.67769
331,6,0,false,12,9,-3,41.90965,-87.64812
TA1305000037,6,0,false,19,10,-9,41.91018,-87.67003
TA1306000008,6,0,false,7,9,2,41.9102,-87.6435
13058,6,0,false,6,8,2,41.91059,-87.64942
TA1307000038,6,0,false,16,9,-7,41.91138,-87.63868
LF-005,6,0,false,21,20,-1,41.91172,-87.62681
13128,6,0,false,13,7,-6,41.91197,-87.63197
TA1308000050,6,0,false,36,16,-20,41.91211,-87.6347
13243,6,0,false,2,7,5,41.91262,-87.6814
TA1306000032,6,0,false,2,12,10,41.9137,-87.65285
TA1307000166,6,0,false,9,13,4,41.91386,-87.64877
18067,6,0,false,2,9,7,41.9146,-87.66796
TA1306000007,6,0,false,5,6,1,41.91469,-87.64333
13068,6,0,false,9,9,0,41.91554,-87.68703
13179,6,0,false,24,32,8,41.9157,-87.63461
13133,6,0,false,19,8,-11,41.91598,-87.67733
15650,6,0,false,5,2,-3,41.91711,-87.71023
TA1309000006,6,0,false,10,5,-5,41.91809,-87.64375
13146,6,0,false,3,17,14,41.91831,-87.63629
13059,6,0,false,11,7,-4,41.91845,-87.65222
13192,6,0,false,6,6,0,41.91995,-87.64884
TA1309000030,6,0,false,3,5,2,41.92077,-87.66372
TA1309000033,6,0,false,23,12,-11,41.92158,-87.65381
13193,6,0,false,28,37,9,41.92182,-87.64412
13191,6,0,false,3,11,8,41.92217,-87.63891
13084,6,0,false,15,8,-7,41.92268,-87.69715
LP-,6,0,false,6,14,8,41.92396,-87.63584
TA1307000001,6,0,false,9,7,-2,41.92535,-87.66581
TA1306000026,6,0,false,4,8,4,41.92558,-87.65842
TA1306000016,6,0,false,11,5,-6,41.9256,-87.65371
TA1309000019,6,0,false,6,7,1,41.92586,-87.63897
TA1309000058,6,0,false,32,19,-13,41.92591,-87.64927
TA1308000001,6,0,false,8,3,-5,41.92627,-87.63086
15646,6,0,false,1,5,4,41.92668,-87.6977
13124,6,0,false,4,6,2,41.92675,-87.63444
TA1309000023,6,0,false,20,10,-10,41.9287,-87.65383
TA1307000113,6,0,false,4,18,14,41.92878,-87.66391
13296,6,0,false,3,6,3,41.92883,-87.66852
TA1309000059,6,0,false,8,6,-2,41.92889,-87.65898
TA1309000061,6,0,false,18,10,-8,41.92915,-87.64909
TA1305000014,6,0,false,16,10,-6,41.92956,-87.64313
13085,6,0,false,7,10,3,41.92958,-87.70789
TA1307000142,6,0,false,24,9,-15,41.93125,-87.64432
TA1307000064,6,0,false,6,7,1,41.93222,-87.65864
TA1306000014,6,0,false,28,6,-22,41.93242,-87.65271
TA1309000039,6,0,false,5,7,2,41.93258,-87.63642
13294,6,0,false,4,9,5,41.9326,-87.66595
TA1309000036,6,0,false,9,8,-1,41.93313,-87.64776
TA1307000006,6,0,false,6,3,-3,41.93571,-87.6636
13268,6,0,false,2,10,8,41.93588,-87.67843
TA1307000052,6,0,false,16,13,-3,41.93628,-87.65266
TA1307000136,6,0,false,17,10,-7,41.9365,-87.64755
TA1307000041,6,0,false,2,5,3,41.93669,-87.63683
13137,6,0,false,5,9,4,41.9376,-87.6441
15642,6,0,false,3,10,7,41.93843,-87.69801
KA17018068,6,0,false,3,5,2,41.93935,-87.68327
TA1309000042,6,0,false,10,4,-6,41.93937,-87.66836
13229,6,0,false,4,8,4,41.93946,-87.66376
TA1308000019,6,0,false,9,8,-1,41.93973,-87.65886
13277,6,0,false,8,9,1,41.9401,-87.64546
TA1307000134,6,0,false,19,12,-7,41.94016,-87.65303
TA1309000049,6,0,false,7,10,3,41.94077,-87.63919
TA1307000138,6,0,false,7,5,-2,41.94334,-87.67094
13144,6,0,false,5,3,-2,41.9434,-87.67964
TA1309000025,6,0,false,13,26,13,41.94368,-87.64894
13071,6,0,false,13,9,-4,41.94373,-87.66401
632,6,0,false,25,18,-7,41.94453,-87.6547
13278,6,0,false,8,10,2,41.94553,-87.64644
13235,6,0,false,7,6,-1,41.94814,-87.66396
13325,6,0,false,13,10,-3,41.94907,-87.64863
TA1307000126,6,0,false,12,19,7,41.94936,-87.65451
TA1307000150,6,0,false,6,4,-2,41.94945,-87.64646
TA1307000127,6,0,false,8,7,-1,41.9508,-87.65918
13323,6,0,false,7,9,2,41.95282,-87.65
13063,6,0,false,12,4,-8,41.95424,-87.65441
TA1308000022,6,0,false,4,5,1,41.95438,-87.64805
TA1309000026,6,0,false,5,2,-3,41.95601,-87.6802
TA1309000027,6,0,false,1,7,6,41.9585,-87.65499
13389,6,0,false,1,6,5,41.961,-87.64958
KA1503000022,6,0,false,3,5,2,41.96158,-87.66609
TA1307000107,6,0,false,8,7,-1,41.96164,-87.65464
TA1308000012,6,0,false,8,5,-3,41.96398,-87.63818
13074,6,0,false,2,6,4,41.96521,-87.6582
KA1503000059,6,0,true,7,2,-5,41.79952,-87.58643
13102,6,0,true,2,5,3,41.85762,-87.61942
WL-011,6,0,true,5,3,-2,41.88034,-87.64273
TA1307000120,6,0,true,8,8,0,41.88188,-87.64879
TA1305000032,6,0,true,4,8,4,41.88218,-87.64109
13053,6,0,true,9,4,-5,41.88365,-87.64863
15535,6,0,true,7,3,-4,41.8846,-87.64455
TA1306000015,6,0,true,5,3,-2,41.88549,-87.65232
13021,6,0,true,5,1,-4,41.88559,-87.64184
TA1305000011,6,0,true,5,7,2,41.886,-87.62418
15534,6,0,true,5,8,3,41.88627,-87.61749
TA1308000029,6,0,true,1,7,6,41.88673,-87.62225
TA1307000131,6,0,true,5,1,-4,41.88688,-87.62606
TA1306000003,6,0,true,14,17,3,41.88867,-87.64442
KA1503000043,6,0,true,5,7,2,41.88918,-87.63851
13050,6,0,true,9,4,-5,41.88919,-87.62775
TA1307000151,6,0,true,16,5,-11,41.88993,-87.63427
13427,6,0,true,2,5,3,41.89054,-87.62205
13430,6,0,true,18,8,-10,41.89077,-87.63169
TA1307000117,6,0,true,9,6,-3,41.89144,-87.62675
13033,6,0,true,11,4,-7,41.8916,-87.64835
TA1305000003,6,0,true,7,2,-5,41.89187,-87.62061
13022,6,0,true,4,6,2,41.89227,-87.61205
13045,6,0,true,9,7,-2,41.89403,-87.62931
KA1503000041,6,0,true,7,10,3,41.89452,-87.61798
TA1307000062,6,0,true,1,6,5,41.89466,-87.63839
TA1306000012,6,0,true,7,11,4,41.89475,-87.63438
13132,6,0,true,6,6,0,41.89573,-87.67718
TA1305000020,6,0,true,5,1,-4,41.89636,-87.65406
13017,6,0,true,4,6,2,41.89676,-87.6357
15529,6,0,true,2,7,5,41.89858,-87.62206
TA1307000128,6,0,true,9,14,5,41.89896,-87.6299
TA1306000011,6,0,true,3,5,2,41.89994,-87.63443
KA1504000116,6,0,true,1,5,4,41.90023,-87.64299
TA1307000039,6,0,true,19,20,1,41.90294,-87.63137
TA1305000034,6,0,true,15,3,-12,41.90313,-87.67391
KA1504000135,6,0,true,22,6,-16,41.90319,-87.63439
13136,6,0,true,3,5,2,41.90326,-87.67845
13061,6,0,true,10,11,1,41.90342,-87.66779
TA1308000049,6,0,true,24,13,-11,41.90672,-87.6349
KA1504000134,6,0,true,2,9,7,41.90687,-87.6262
13224,6,0,true,1,6,5,41.90706,-87.66725
13221,6,0,true,6,5,-1,41.90765,-87.67254
TA1309000024,6,0,true,10,14,4,41.908,-87.63152
TA1305000041,6,0,true,15,11,-4,41.9094,-87.67769
TA1305000037,6,0,true,13,5,-8,41.91018,-87.67003
13058,6,0,true,6,5,-1,41.91059,-87.64942
TA1307000038,6,0,true,14,14,0,41.91138,-87.63868
13128,6,0,true,7,1,-6,41.91197,-87.63197
TA1308000050,6,0,true,15,14,-1,41.91211,-87.6347
13243,6,0,true,5,4,-1,41.91262,-87.6814
TA1307000166,6,0,true,5,10,5,41.91386,-87.64877
TA1306000007,6,0,true,1,6,5,41.91469,-87.64333
13068,6,0,true,6,3,-3,41.91554,-87.68703
13179,6,0,true,12,7,-5,41.9157,-87.63461
13133,6,0,true,5,4,-1,41.91598,-87.67733
TA1309000006,6,0,true,3,6,3,41.91809,-87.64375
13146,6,0,true,4,5,1,41.91831,-87.63629
13059,6,0,true,4,9,5,41.91845,-87.65222
13192,6,0,true,5,1,-4,41.91995,-87.64884
TA1309000033,6,0,true,6,8,2,41.92158,-87.65381
13193,6,0,true,15,19,4,41.92182,-87.64412
13191,6,0,true,1,5,4,41.92217,-87.63891
13084,6,0,true,4,7,3,41.92268,-87.69715
TA1309000058,6,0,true,7,12,5,41.92591,-87.64927
TA1309000023,6,0,true,11,7,-4,41.9287,-87.65383
TA1307000113,6,0,true,4,6,2,41.92878,-87.66391
TA1309000061,6,0,true,13,7,-6,41.92915,-87.64909
TA1305000014,6,0,true,4,5,1,41.92956,-87.64313
TA1307000142,6,0,true,11,8,-3,41.93125,-87.64432
TA1307000064,6,0,true,6,10,4,41.93222,-87.65864
TA1306000014,6,0,true,14,10,-4,41.93242,-87.65271
13294,6,0,true,5,7,2,41.9326,-87.66595
TA1307000006,6,0,true,5,6,1,41.93571,-87.6636
TA1307000052,6,0,true,9,2,-7,41.93628,-87.65266
TA1307000136,6,0,true,5,8,3,41.9365,-87.64755
TA1309000042,6,0,true,13,5,-8,41.93937,-87.66836
13229,6,0,true,5,3,-2,41.93946,-87.66376
TA1308000019,6,0,true,6,3,-3,41.93973,-87.65886
TA1307000134,6,0,true,10,5,-5,41.94016,-87.65303
TA1309000049,6,0,true,3,7,4,41.94077,-87.63919
TA1309000025,6,0,true,16,9,-7,41.94368,-87.64894
13071,6,0,true,5,8,3,41.94373,-87.66401
632,6,0,true,18,11,-7,41.94453,-87.6547
13278,6,0,true,6,6,0,41.94553,-87.64644
13235,6,0,true,5,3,-2,41.94814,-87.66396
13325,6,0,true,9,10,1,41.94907,-87.64863
TA1307000126,6,0,true,6,4,-2,41.94936,-87.65451
TA1307000127,6,0,true,2,7,5,41.9508,-87.65918
13063,6,0,true,6,7,1,41.95424,-87.65441
TA1309000026,6,0,true,6,3,-3,41.95601,-87.6802
13379,6,0,true,1,5,4,41.95786,-87.6495
KA1503000022,6,0,true,2,6,4,41.96158,-87.66609
TA1307000048,6,1,false,5,1,-4,41.83855,-87.60821
13075,6,1,false,4,11,7,41.8531,-87.63192
SL-013,6,1,false,2,7,5,41.85659,-87.62755
13150,6,1,false,7,7,0,41.85783,-87.62455
13163,6,1,false,8,8,0,41.85808,-87.65108
13164,6,1,false,2,5,3,41.85818,-87.65648
TA1305000002,6,1,false,13,23,10,41.86721,-87.62597
SL-005,6,1,false,3,11,8,41.8679,-87.62304
TA1309000010,6,1,false,6,20,14,41.87074,-87.62574
623,6,1,false,8,13,5,41.87272,-87.62399
SL-007,6,1,false,10,14,4,41.87404,-87.6277
13028,6,1,false,5,3,-2,41.87475,-87.64981
15541,6,1,false,11,5,-6,41.8758,-87.62086
TA1305000010,6,1,false,2,11,9,41.87623,-87.62444
624,6,1,false,5,6,1,41.87626,-87.62923
TA1305000035,6,1,false,2,7,5,41.87716,-87.62787
13158,6,1,false,3,5,2,41.87764,-87.64957
TA1305000025,6,1,false,5,3,-2,41.87773,-87.63528
TA1309000002,6,1,false,11,17,6,41.87784,-87.62408
13300,6,1,false,18,25,7,41.88097,-87.61675
13008,6,1,false,11,8,-3,41.88105,-87.62408
TA1307000120,6,1,false,5,5,0,41.88188,-87.64879
13036,6,1,false,3,5,2,41.8821,-87.62513
13006,6,1,false,5,2,-3,41.88268,-87.63252
13001,6,1,false,16,19,3,41.88397,-87.62459
TA1305000030,6,1,false,3,16,13,41.88459,-87.63178
TA1305000029,6,1,false,3,11,8,41.88466,-87.62787
13263,6,1,false,10,15,5,41.88467,-87.61952
TA1306000015,6,1,false,15,5,-10,41.88549,-87.65232
TA1307000111,6,1,false,13,13,0,41.88582,-87.63548
KA1503000012,6,1,false,12,13,1,41.88599,-87.63089
TA1305000011,6,1,false,20,14,-6,41.886,-87.62418
TA1308000029,6,1,false,7,15,8,41.88673,-87.62225
TA1307000131,6,1,false,12,8,-4,41.88688,-87.62606
TA1306000003,6,1,false,6,6,0,41.88867,-87.64442
KA1503000043,6,1,false,15,15,0,41.88918,-87.63851
13050,6,1,false,11,7,-4,41.88919,-87.62775
TA1307000151,6,1,false,14,11,-3,41.88993,-87.63427
KA1503000044,6,1,false,9,2,-7,41.89018,-87.6262
13427,6,1,false,8,12,4,41.89054,-87.62205
13430,6,1,false,20,20,0,41.89077,-87.63169
TA1306000013,6,1,false,10,4,-6,41.89083,-87.61852
TA1307000117,6,1,false,28,10,-18,41.89144,-87.62675
13033,6,1,false,8,6,-2,41.8916,-87.64835
13194,6,1,false,2,5,3,41.8918,-87.65878
TA1305000003,6,1,false,7,12,5,41.89187,-87.62061
13022,6,1,false,7,18,11,41.89227,-87.61205
TA1306000029,6,1,false,19,15,-4,41.89256,-87.61449
13265,6,1,false,5,6,1,41.89383,-87.64172
KA1503000041,6,1,false,8,6,-2,41.89452,-87.61798
TA1306000012,6,1,false,12,20,8,41.89475,-87.63438
KP1705001026,6,1,false,6,7,1,41.89483,-87.6323
13132,6,1,false,9,7,-2,41.89573,-87.67718
TA1305000020,6,1,false,6,13,7,41.89636,-87.65406
13289,6,1,false,1,7,6,41.89638,-87.661
13303,6,1,false,7,9,2,41.89672,-87.63088
13017,6,1,false,9,5,-4,41.89676,-87.6357
TA1307000061,6,1,false,3,14,11,41.89745,-87.62873
13034,6,1,false,2,7,5,41.89754,-87.62352
KA1504000103,6,1,false,8,8,0,41.89842,-87.68659
TA1307000128,6,1,false,10,10,0,41.89896,-87.6299
TA1306000011,6,1,false,8,2,-6,41.89994,-87.63443
13290,6,1,false,3,5,2,41.90069,-87.66259
13042,6,1,false,9,5,-4,41.90097,-87.62377
TA1307000070,6,1,false,8,4,-4,41.90133,-87.67742
KA1504000133,6,1,false,8,8,0,41.90234,-87.62773
TA1306000006,6,1,false,9,2,-7,41.90292,-87.63772
TA1307000039,6,1,false,39,19,-20,41.90294,-87.63137
TA1305000034,6,1,false,15,6,-9,41.90313,-87.67391
KA1504000135,6,1,false,21,12,-9,41.90319,-87.63439
13136,6,1,false,27,6,-21,41.90326,-87.67845
13061,6,1,false,16,18,2,41.90342,-87.66779
KA1504000079,6,1,false,8,4,-4,41.9035,-87.64334
TA1308000049,6,1,false,18,10,-8,41.90672,-87.6349
KA1504000134,6,1,false,6,4,-2,41.90687,-87.6262
13224,6,1,false,8,4,-4,41.90706,-87.66725
TA1307000143,6,1,false,19,5,-14,41.90762,-87.63854
13221,6,1,false,18,17,-1,41.90765,-87.67254
TA1309000024,6,1,false,38,16,-22,41.908,-87.63152
TA1305000041,6,1,false,25,13,-12,41.9094,-87.67769
TA1305000037,6,1,false,11,5,-6,41.91018,-87.67003
13154,6,1,false,7,7,0,41.91054,-87.65312
TA1307000038,6,1,false,32,10,-22,41.91138,-87.63868
LF-005,6,1,false,15,10,-5,41.91172,-87.62681
13128,6,1,false,12,5,-7,41.91197,-87.63197
TA1308000050,6,1,false,17,18,1,41.91211,-87.6347
13243,6,1,false,14,10,-4,41.91262,-87.6814
TA1307000166,6,1,false,8,13,5,41.91386,-87.64877
13068,6,1,false,8,10,2,41.91554,-87.68703
13179,6,1,false,29,17,-12,41.9157,-87.63461
13133,6,1,false,16,10,-6,41.91598,-87.67733
15650,6,1,false,6,2,-4,41.91711,-87.71023
TA1309000006,6,1,false,8,3,-5,41.91809,-87.64375
TA1307000163,6,1,false,3,6,3,41.91821,-87.65696
13146,6,1,false,3,5,2,41.91831,-87.63629
13059,6,1,false,17,13,-4,41.91845,-87.65222
13192,6,1,false,17,13,-4,41.91995,-87.64884
13292,6,1,false,2,8,6,41.92152,-87.70733
TA1309000033,6,1,false,19,18,-1,41.92158,-87.65381
13193,6,1,false,43,25,-18,41.92182,-87.64412
13084,6,1,false,11,11,0,41.92268,-87.69715
LP-,6,1,false,8,11,3,41.92396,-87.63584
15648,6,1,false,6,4,-2,41.92464,-87.68931
TA1307000001,6,1,false,4,8,4,41.92535,-87.66581
TA1306000026,6,1,false,1,9,8,41.92558,-87.65842
TA1306000016,6,1,false,12,14,2,41.9256,-87.65371
TA1309000019,6,1,false,6,5,-1,41.92586,-87.63897
TA1309000058,6,1,false,21,15,-6,41.92591,-87.64927
TA1309000023,6,1,false,28,10,-18,41.9287,-87.65383
TA1307000113,6,1,false,5,5,0,41.92878,-87.66391
13296,6,1,false,10,2,-8,41.92883,-87.66852
TA1309000061,6,1,false,16,10,-6,41.92915,-87.64909
TA1305000014,6,1,false,6,10,4,41.92956,-87.64313
13085,6,1,false,12,15,3,41.92958,-87.70789
TA1307000142,6,1,false,19,13,-6,41.93125,-87.64432
13271,6,1,false,2,5,3,41.93192,-87.67784
TA1307000064,6,1,false,7,6,-1,41.93222,-87.65864
TA1306000014,6,1,false,14,6,-8,41.93242,-87.65271
TA1309000039,6,1,false,5,7,2,41.93258,-87.63642
13294,6,1,false,4,13,9,41.9326,-87.66595
TA1309000036,6,1,false,16,8,-8,41.93313,-87.64776
TA1307000006,6,1,false,11,5,-6,41.93571,-87.6636
TA1307000052,6,1,false,5,12,7,41.93628,-87.65266
TA1307000136,6,1,false,9,13,4,41.9365,-87.64755
13137,6,1,false,4,21,17,41.9376,-87.6441
TA1309000042,6,1,false,4,6,2,41.93937,-87.66836
13229,6,1,false,6,4,-2,41.93946,-87.66376
TA1308000019,6,1,false,15,14,-1,41.93973,-87.65886
13277,6,1,false,12,12,0,41.9401,-87.64546
TA1307000134,6,1,false,40,22,-18,41.94016,-87.65303
TA1309000049,6,1,false,2,12,10,41.94077,-87.63919
TA1307000138,6,1,false,6,11,5,41.94334,-87.67094
13144,6,1,false,2,6,4,41.9434,-87.67964
TA1309000025,6,1,false,30,15,-15,41.94368,-87.64894
13071,6,1,false,9,11,2,41.94373,-87.66401
632,6,1,false,27,20,-7,41.94453,-87.6547
13278,6,1,false,7,3,-4,41.94553,-87.64644
13325,6,1,false,13,9,-4,41.94907,-87.64863
TA1307000126,6,1,false,22,17,-5,41.94936,-87.65451
13319,6,1,false,1,8,7,41.95069,-87.6687
TA1307000127,6,1,false,14,8,-6,41.9508,-87.65918
13323,6,1,false,16,11,-5,41.95282,-87.65
13063,6,1,false,8,14,6,41.95424,-87.65441
TA1309000027,6,1,false,1,7,6,41.9585,-87.65499
TA1307000107,6,1,false,2,5,3,41.96164,-87.65464
13074,6,1,false,5,5,0,41.96521,-87.6582
TA1309000066,6,1,false,1,5,4,41.9691,-87.67423
15578,6,1,false,2,5,3,41.98405,-87.66027
13156,6,1,true,7,1,-6,41.88042,-87.65554
TA1307000120,6,1,true,9,3,-6,41.88188,-87.64879
TA1305000032,6,1,true,3,5,2,41.88218,-87.64109
15535,6,1,true,7,1,-6,41.8846,-87.64455
TA1306000003,6,1,true,2,7,5,41.88867,-87.64442
KA1503000043,6,1,true,7,5,-2,41.88918,-87.63851
TA1307000151,6,1,true,11,2,-9,41.88993,-87.63427
13430,6,1,true,10,7,-3,41.89077,-87.63169
RN-,6,1,true,5,2,-3,41.89102,-87.63546
13033,6,1,true,6,4,-2,41.8916,-87.64835
13194,6,1,true,2,5,3,41.8918,-87.65878
13022,6,1,true,7,1,-6,41.89227,-87.61205
13265,6,1,true,2,8,6,41.89383,-87.64172
13045,6,1,true,8,3,-5,41.89403,-87.62931
TA1306000012,6,1,true,6,5,-1,41.89475,-87.63438
13303,6,1,true,4,5,1,41.89672,-87.63088
13017,6,1,true,4,6,2,41.89676,-87.6357
TA1307000128,6,1,true,9,8,-1,41.89896,-87.6299
TA1306000011,6,1,true,6,4,-2,41.89994,-87.63443
KA1504000133,6,1,true,8,8,0,41.90234,-87.62773
TA1307000039,6,1,true,26,15,-11,41.90294,-87.63137
KA1504000135,6,1,true,23,7,-16,41.90319,-87.63439
13136,6,1,true,9,4,-5,41.90326,-87.67845
13061,6,1,true,3,13,10,41.90342,-87.66779
KA1504000079,6,1,true,1,6,5,41.9035,-87.64334
TA1308000049,6,1,true,6,9,3,41.90672,-87.6349
TA1307000143,6,1,true,7,2,-5,41.90762,-87.63854
13221,6,1,true,9,10,1,41.90765,-87.67254
TA1309000024,6,1,true,19,8,-11,41.908,-87.63152
TA1305000041,6,1,true,16,13,-3,41.9094,-87.67769
TA1305000037,6,1,true,7,4,-3,41.91018,-87.67003
TA1307000038,6,1,true,23,2,-21,41.91138,-87.63868
TA1308000050,6,1,true,10,7,-3,41.91211,-87.6347
TA1307000166,6,1,true,3,7,4,41.91386,-87.64877
13179,6,1,true,19,11,-8,41.9157,-87.63461
13133,6,1,true,9,2,-7,41.91598,-87.67733
TA1309000006,6,1,true,6,4,-2,41.91809,-87.64375
13059,6,1,true,6,9,3,41.91845,-87.65222
13192,6,1,true,6,3,-3,41.91995,-87.64884
TA1309000033,6,1,true,6,11,5,41.92158,-87.65381
13193,6,1,true,13,11,-2,41.92182,-87.64412
TA1307000001,6,1,true,3,9,6,41.92535,-87.66581
TA1306000016,6,1,true,8,2,-6,41.9256,-87.65371
TA1309000019,6,1,true,5,9,4,41.92586,-87.63897
TA1309000023,6,1,true,9,3,-6,41.9287,-87.65383
13296,6,1,true,1,6,5,41.92883,-87.66852
TA1309000059,6,1,true,1,6,5,41.92889,-87.65898
TA1309000061,6,1,true,7,6,-1,41.92915,-87.64909
TA1305000014,6,1,true,3,9,6,41.92956,-87.64313
13085,6,1,true,5,2,-3,41.92958,-87.70789
TA1307000142,6,1,true,7,10,3,41.93125,-87.64432
TA1306000014,6,1,true,10,6,-4,41.93242,-87.65271
TA1309000039,6,1,true,2,5,3,41.93258,-87.63642
13294,6,1,true,2,6,4,41.9326,-87.66595
TA1307000006,6,1,true,5,3,-2,41.93571,-87.6636
TA1307000136,6,1,true,10,6,-4,41.9365,-87.64755
13137,6,1,true,5,4,-1,41.9376,-87.6441
TA1308000019,6,1,true,7,4,-3,41.93973,-87.65886
13277,6,1,true,3,6,3,41.9401,-87.64546
TA1307000134,6,1,true,16,10,-6,41.94016,-87.65303
TA1309000049,6,1,true,6,6,0,41.94077,-87.63919
TA1309000025,6,1,true,11,11,0,41.94368,-87.64894
13071,6,1,true,4,7,3,41.94373,-87.66401
632,6,1,true,16,7,-9,41.94453,-87.6547
13278,6,1,true,8,1,-7,41.94553,-87.64644
13235,6,1,true,1,5,4,41.94814,-87.66396
13325,6,1,true,17,6,-11,41.94907,-87.64863
TA1307000126,6,1,true,4,5,1,41.94936,-87.65451
13323,6,1,true,6,4,-2,41.95282,-87.65
TA1309000027,6,1,true,1,6,5,41.9585,-87.65499
TA1307000107,6,1,true,3,5,2,41.96164,-87.65464
TA1309000014,6,1,true,1,5,4,41.96709,-87.66744
TA1308000009,6,2,false,4,8,4,41.79522,-87.58075
TA1309000037,6,2,false,7,5,-2,41.79957,-87.59474
13075,6,2,false,3,5,2,41.8531,-87.63192
TA1305000002,6,2,false,7,6,-1,41.86721,-87.62597
SL-005,6,2,false,2,11,9,41.8679,-87.62304
13160,6,2,false,1,7,6,41.86947,-87.65548
TA1309000010,6,2,false,8,5,-3,41.87074,-87.62574
SL-008,6,2,false,9,3,-6,41.87209,-87.62956
623,6,2,false,7,15,8,41.87272,-87.62399
15541,6,2,false,5,3,-2,41.8758,-87.62086
TA1305000010,6,2,false,4,6,2,41.87623,-87.62444
624,6,2,false,2,10,8,41.87626,-87.62923
13158,6,2,false,10,13,3,41.87764,-87.64957
TA1309000002,6,2,false,7,6,-1,41.87784,-87.62408
KA1503000015,6,2,false,2,11,9,41.87948,-87.6257
13300,6,2,false,18,9,-9,41.88097,-87.61675
13008,6,2,false,7,17,10,41.88105,-87.62408
TA1307000120,6,2,false,5,11,6,41.88188,-87.64879
13036,6,2,false,4,5,1,41.8821,-87.62513
TA1305000032,6,2,false,5,2,-3,41.88218,-87.64109
13409,6,2,false,5,1,-4,41.8831,-87.6511
13001,6,2,false,12,16,4,41.88397,-87.62459
TA1306000010,6,2,false,6,2,-4,41.88419,-87.62961
TA1305000030,6,2,false,3,5,2,41.88459,-87.63178
15535,6,2,false,1,6,5,41.8846,-87.64455
TA1305000029,6,2,false,4,20,16,41.88466,-87.62787
TA1306000015,6,2,false,4,6,2,41.88549,-87.65232
13021,6,2,false,7,4,-3,41.88559,-87.64184
KA1503000012,6,2,false,2,6,4,41.88599,-87.63089
TA1305000011,6,2,false,13,15,2,41.886,-87.62418
15534,6,2,false,5,8,3,41.88627,-87.61749
TA1308000029,6,2,false,8,5,-3,41.88673,-87.62225
TA1307000131,6,2,false,5,15,10,41.88688,-87.62606
TA1306000003,6,2,false,11,11,0,41.88867,-87.64442
13050,6,2,false,5,7,2,41.88919,-87.62775
TA1307000151,6,2,false,8,7,-1,41.88993,-87.63427
13427,6,2,false,5,1,-4,41.89054,-87.62205
13430,6,2,false,9,7,-2,41.89077,-87.63169
TA1306000013,6,2,false,3,19,16,41.89083,-87.61852
RN-,6,2,false,8,3,-5,41.89102,-87.63546
TA1307000117,6,2,false,15,16,1,41.89144,-87.62675
13033,6,2,false,7,5,-2,41.8916,-87.64835
TA1305000003,6,2,false,6,8,2,41.89187,-87.62061
13022,6,2,false,3,5,2,41.89227,-87.61205
TA1306000029,6,2,false,6,6,0,41.89256,-87.61449
13265,6,2,false,3,8,5,41.89383,-87.64172
13045,6,2,false,2,5,3,41.89403,-87.62931
KA1503000041,6,2,false,2,9,7,41.89452,-87.61798
13196,6,2,false,1,9,8,41.89455,-87.65345
TA1306000012,6,2,false,11,8,-3,41.89475,-87.63438
KP1705001026,6,2,false,11,10,-1,41.89483,-87.6323
13132,6,2,false,1,5,4,41.89573,-87.67718
15530,6,2,false,1,8,7,41.89575,-87.62596
18003,6,2,false,1,7,6,41.89575,-87.62011
13247,6,2,false,2,8,6,41.89597,-87.66775
TA1305000020,6,2,false,7,12,5,41.89636,-87.65406
13303,6,2,false,7,6,-1,41.89672,-87.63088
13017,6,2,false,9,8,-1,41.89676,-87.6357
TA1307000061,6,2,false,1,6,5,41.89745,-87.62873
620,6,2,false,2,7,5,41.89817,-87.63754
TA1307000128,6,2,false,3,11,8,41.89896,-87.6299
657,6,2,false,2,5,3,41.89918,-87.6722
13290,6,2,false,5,2,-3,41.90069,-87.66259
13042,6,2,false,9,1,-8,41.90097,-87.62377
KA1504000133,6,2,false,9,13,4,41.90234,-87.62773
13241,6,2,false,1,6,5,41.9029,-87.68731
TA1307000039,6,2,false,31,24,-7,41.90294,-87.63137
TA1305000034,6,2,false,8,8,0,41.90313,-87.67391
KA1504000135,6,2,false,3,5,2,41.90319,-87.63439
13061,6,2,false,11,21,10,41.90342,-87.66779
KA1504000079,6,2,false,7,3,-4,41.9035,-87.64334
TA1308000049,6,2,false,10,7,-3,41.90672,-87.6349
KA1504000134,6,2,false,4,5,1,41.90687,-87.6262
13224,6,2,false,1,7,6,41.90706,-87.66725
13221,6,2,false,7,9,2,41.90765,-87.67254
TA1309000024,6,2,false,7,9,2,41.908,-87.63152
TA1305000041,6,2,false,14,17,3,41.9094,-87.67769
331,6,2,false,8,8,0,41.90965,-87.64812
TA1305000037,6,2,false,7,8,1,41.91018,-87.67003
TA1306000008,6,2,false,5,9,4,41.9102,-87.6435
13257,6,2,false,3,6,3,41.91054,-87.68956
13154,6,2,false,6,3,-3,41.91054,-87.65312
13058,6,2,false,8,7,-1,41.91059,-87.64942
TA1307000038,6,2,false,7,9,2,41.91138,-87.63868
LF-005,6,2,false,2,15,13,41.91172,-87.62681
13128,6,2,false,6,1,-5,41.91197,-87.63197
TA1308000050,6,2,false,14,22,8,41.91211,-87.6347
13243,6,2,false,6,10,4,41.91262,-87.6814
TA1307000166,6,2,false,7,6,-1,41.91386,-87.64877
15655,6,2,false,4,6,2,41.91401,-87.70514
13068,6,2,false,4,6,2,41.91554,-87.68703
13179,6,2,false,9,11,2,41.9157,-87.63461
13133,6,2,false,5,7,2,41.91598,-87.67733
TA1307000163,6,2,false,3,11,8,41.91821,-87.65696
13146,6,2,false,20,11,-9,41.91831,-87.63629
13059,6,2,false,7,5,-2,41.91845,-87.65222
13192,6,2,false,23,19,-4,41.91995,-87.64884
13288,6,2,false,7,5,-2,41.92008,-87.67788
TA1309000033,6,2,false,8,9,1,41.92158,-87.65381
13193,6,2,false,11,12,1,41.92182,-87.64412
13084,6,2,false,6,6,0,41.92268,-87.69715
TA1307000001,6,2,false,2,11,9,41.92535,-87.66581
TA1306000026,6,2,false,7,11,4,41.92558,-87.65842
TA1306000016,6,2,false,8,5,-3,41.9256,-87.65371
TA1309000019,6,2,false,13,12,-1,41.92586,-87.63897
TA1309000058,6,2,false,13,12,-1,41.92591,-87.64927
TA1308000001,6,2,false,3,5,2,41.92627,-87.63086
15646,6,2,false,2,5,3,41.92668,-87.6977
TA1309000023,6,2,false,12,12,0,41.9287,-87.65383
TA1307000113,6,2,false,3,11,8,41.92878,-87.66391
TA1309000059,6,2,false,2,6,4,41.92889,-87.65898
TA1309000061,6,2,false,19,18,-1,41.92915,-87.64909
TA1305000014,6,2,false,15,11,-4,41.92956,-87.64313
13085,6,2,false,2,7,5,41.92958,-87.70789
TA1307000142,6,2,false,7,13,6,41.93125,-87.64432
13271,6,2,false,2,5,3,41.93192,-87.67784
TA1307000064,6,2,false,7,9,2,41.93222,-87.65864
TA1306000014,6,2,false,13,8,-5,41.93242,-87.65271
TA1309000039,6,2,false,5,8,3,41.93258,-87.63642
13294,6,2,false,8,10,2,41.9326,-87.66595
TA1309000036,6,2,false,12,1,-11,41.93313,-87.64776
TA1307000006,6,2,false,7,9,2,41.93571,-87.6636
13268,6,2,false,2,6,4,41.93588,-87.67843
TA1307000052,6,2,false,8,9,1,41.93628,-87.65266
TA1307000136,6,2,false,12,15,3,41.9365,-87.64755
13137,6,2,false,7,5,-2,41.9376,-87.6441
TA1309000042,6,2,false,5,8,3,41.93937,-87.66836
13229,6,2,false,8,12,4,41.93946,-87.66376
TA1308000019,6,2,false,11,7,-4,41.93973,-87.65886
13277,6,2,false,12,14,2,41.9401,-87.64546
TA1307000134,6,2,false,7,17,10,41.94016,-87.65303
13143,6,2,false,5,6,1,41.94059,-87.67853
TA1309000049,6,2,false,6,9,3,41.94077,-87.63919
TA1307000138,6,2,false,5,4,-1,41.94334,-87.67094
TA1309000025,6,2,false,14,9,-5,41.94368,-87.64894
13071,6,2,false,18,7,-11,41.94373,-87.66401
632,6,2,false,17,18,1,41.94453,-87.6547
13278,6,2,false,21,10,-11,41.94553,-87.64644
13235,6,2,false,6,3,-3,41.94814,-87.66396
13325,6,2,false,12,9,-3,41.94907,-87.64863
TA1307000126,6,2,false,22,6,-16,41.94936,-87.65451
TA1307000150,6,2,false,8,8,0,41.94945,-87.64646
13319,6,2,false,7,3,-4,41.95069,-87.6687
TA1307000127,6,2,false,11,6,-5,41.9508,-87.65918
13323,6,2,false,15,7,-8,41.95282,-87.65
13063,6,2,false,4,5,1,41.95424,-87.65441
TA1307000107,6,2,false,4,11,7,41.96164,-87.65464
13074,6,2,false,11,4,-7,41.96521,-87.6582
13108,6,2,false,3,6,3,41.97379,-87.65971
SL-005,6,2,true,1,5,4,41.8679,-87.62304
13158,6,2,true,1,6,5,41.87764,-87.64957
TA1305000011,6,2,true,1,5,4,41.886,-87.62418
TA1307000151,6,2,true,6,6,0,41.88993,-87.63427
TA1307000117,6,2,true,7,4,-3,41.89144,-87.62675
13033,6,2,true,1,8,7,41.8916,-87.64835
TA1306000012,6,2,true,6,5,-1,41.89475,-87.63438
13017,6,2,true,1,5,4,41.89676,-87.6357
TA1307000128,6,2,true,3,7,4,41.89896,-87.6299
TA1307000039,6,2,true,13,9,-4,41.90294,-87.63137
KA1504000135,6,2,true,7,7,0,41.90319,-87.63439
13061,6,2,true,5,4,-1,41.90342,-87.66779
TA1309000024,6,2,true,8,7,-1,41.908,-87.63152
TA1305000041,6,2,true,9,9,0,41.9094,-87.67769
TA1305000037,6,2,true,1,7,6,41.91018,-87.67003
13058,6,2,true,5,2,-3,41.91059,-87.64942
13179,6,2,true,7,2,-5,41.9157,-87.63461
13133,6,2,true,2,6,4,41.91598,-87.67733
13146,6,2,true,8,2,-6,41.91831,-87.63629
13059,6,2,true,1,5,4,41.91845,-87.65222
13192,6,2,true,5,3,-2,41.91995,-87.64884
13193,6,2,true,4,5,1,41.92182,-87.64412
TA1306000026,6,2,true,1,8,7,41.92558,-87.65842
TA1309000023,6,2,true,6,2,-4,41.9287,-87.65383
TA1309000061,6,2,true,8,8,0,41.92915,-87.64909
TA1307000142,6,2,true,6,11,5,41.93125,-87.64432
TA1307000064,6,2,true,2,8,6,41.93222,-87.65864
TA1306000014,6,2,true,4,5,1,41.93242,-87.65271
TA1307000136,6,2,true,3,8,5,41.9365,-87.64755
13137,6,2,true,4,5,1,41.9376,-87.6441
TA1308000019,6,2,true,5,5,0,41.93973,-87.65886
13277,6,2,true,7,2,-5,41.9401,-87.64546
TA1307000134,6,2,true,4,9,5,41.94016,-87.65303
TA1309000025,6,2,true,5,3,-2,41.94368,-87.64894
13071,6,2,true,2,5,3,41.94373,-87.66401
13278,6,2,true,9,9,0,41.94553,-87.64644
13325,6,2,true,9,3,-6,41.94907,-87.64863
TA1307000150,6,2,true,6,2,-4,41.94945,-87.64646
13063,6,2,true,8,1,-7,41.95424,-87.65441
KA1503000004,6,3,false,2,5,3,41.83127,-87.6088
SL-005,6,3,false,1,7,6,41.8679,-87.62304
623,6,3,false,2,10,8,41.87272,-87.62399
13037,6,3,false,7,3,-4,41.87588,-87.64078
KA1503000015,6,3,false,2,9,7,41.87948,-87.6257
13300,6,3,false,1,16,15,41.88097,-87.61675
15535,6,3,false,1,6,5,41.8846,-87.64455
TA1305000029,6,3,false,5,9,4,41.88466,-87.62787
TA1305000011,6,3,false,2,5,3,41.886,-87.62418
TA1308000029,6,3,false,2,16,14,41.88673,-87.62225
TA1307000131,6,3,false,11,11,0,41.88688,-87.62606
13050,6,3,false,3,6,3,41.88919,-87.62775
13430,6,3,false,4,5,1,41.89077,-87.63169
RN-,6,3,false,2,5,3,41.89102,-87.63546
TA1305000003,6,3,false,5,1,-4,41.89187,-87.62061
KA1503000041,6,3,false,4,7,3,41.89452,-87.61798
KP1705001026,6,3,false,5,3,-2,41.89483,-87.6323
TA1307000128,6,3,false,9,1,-8,41.89896,-87.6299
KA1504000133,6,3,false,6,4,-2,41.90234,-87.62773
TA1307000039,6,3,false,18,10,-8,41.90294,-87.63137
KA1504000079,6,3,false,5,1,-4,41.9035,-87.64334
TA1305000041,6,3,false,6,2,-4,41.9094,-87.67769
331,6,3,false,5,3,-2,41.90965,-87.64812
TA1306000008,6,3,false,1,5,4,41.9102,-87.6435
13058,6,3,false,5,3,-2,41.91059,-87.64942
LF-005,6,3,false,6,3,-3,41.91172,-87.62681
TA1308000050,6,3,false,8,10,2,41.91211,-87.6347
TA1307000166,6,3,false,1,5,4,41.91386,-87.64877
13179,6,3,false,3,5,2,41.9157,-87.63461
13146,6,3,false,7,1,-6,41.91831,-87.63629
TA1309000030,6,3,false,1,5,4,41.92077,-87.66372
TA1309000033,6,3,false,6,9,3,41.92158,-87.65381
13193,6,3,false,5,3,-2,41.92182,-87.64412
LP-,6,3,false,3,7,4,41.92396,-87.63584
TA1309000019,6,3,false,4,6,2,41.92586,-87.63897
TA1309000058,6,3,false,4,6,2,41.92591,-87.64927
TA1309000061,6,3,false,14,9,-5,41.92915,-87.64909
TA1307000142,6,3,false,8,5,-3,41.93125,-87.64432
TA1306000014,6,3,false,5,5,0,41.93242,-87.65271
TA1309000042,6,3,false,5,3,-2,41.93937,-87.66836
TA1308000019,6,3,false,5,3,-2,41.93973,-87.65886
13277,6,3,false,11,9,-2,41.9401,-87.64546
TA1307000134,6,3,false,9,2,-7,41.94016,-87.65303
TA1309000025,6,3,false,6,7,1,41.94368,-87.64894
13071,6,3,false,5,3,-2,41.94373,-87.66401
632,6,3,false,8,9,1,41.94453,-87.6547
13278,6,3,false,14,5,-9,41.94553,-87.64644
TA1307000126,6,3,false,1,7,6,41.94936,-87.65451
TA1307000150,6,3,false,5,2,-3,41.94945,-87.64646
TA1307000127,6,3,false,7,5,-2,41.9508,-87.65918
13323,6,3,false,7,7,0,41.95282,-87.65
15578,6,3,false,1,8,7,41.98405,-87.66027
13409,6,3,true,1,5,4,41.8831,-87.6511
13050,6,3,true,10,1,-9,41.88919,-87.62775
KP1705001026,6,3,true,6,2,-4,41.89483,-87.6323
TA1307000128,6,3,true,5,4,-1,41.89896,-87.6299
KA1504000116,6,3,true,1,6,5,41.90023,-87.64299
TA1307000039,6,3,true,8,6,-2,41.90294,-87.63137
TA1307000142,6,3,true,3,6,3,41.93125,-87.64432
TA1307000052,6,3,true,9,2,-7,41.93628,-87.65266
TA1307000134,6,3,true,6,6,0,41.94016,-87.65303
13278,6,3,true,8,5,-3,41.94553,-87.64644
KA1503000014,6,4,false,5,3,-2,41.7851,-87.60108
TA1305000002,6,4,false,4,6,2,41.86721,-87.62597
623,6,4,false,3,5,2,41.87272,-87.62399
13008,6,4,false,1,6,5,41.88105,-87.62408
13001,6,4,false,7,4,-3,41.88397,-87.62459
TA1308000029,6,4,false,1,5,4,41.88673,-87.62225
TA1307000131,6,4,false,5,4,-1,41.88688,-87.62606
TA1305000022,6,4,false,7,3,-4,41.88817,-87.63656
TA1307000117,6,4,false,7,3,-4,41.89144,-87.62675
TA1305000003,6,4,false,9,1,-8,41.89187,-87.62061
13017,6,4,false,3,9,6,41.89676,-87.6357
15529,6,4,false,4,5,1,41.89858,-87.62206
TA1308000050,6,4,false,6,1,-5,41.91211,-87.6347
13179,6,4,false,3,7,4,41.9157,-87.63461
TA1309000033,6,4,false,9,5,-4,41.92158,-87.65381
TA1309000058,6,4,false,7,4,-3,41.92591,-87.64927
TA1306000014,6,4,false,1,6,5,41.93242,-87.65271
TA1307000134,6,4,false,5,8,3,41.94016,-87.65303
TA1309000025,6,4,false,2,5,3,41.94368,-87.64894
13278,6,4,false,3,5,2,41.94553,-87.64644
13235,6,4,false,1,5,4,41.94814,-87.66396
TA1307000117,6,4,true,8,1,-7,41.89144,-87.62675
TA1305000002,6,5,false,6,1,-5,41.86721,-87.62597
13300,6,5,false,3,14,11,41.88097,-87.61675
13001,6,5,false,2,10,8,41.88397,-87.62459
TA1307000117,6,5,false,4,6,2,41.89144,-87.62675
TA1305000003,6,5,false,3,6,3,41.89187,-87.62061
13022,6,5,false,5,4,-1,41.89227,-87.61205
13034,6,5,false,2,5,3,41.89754,-87.62352
LF-005,6,5,false,6,2,-4,41.91172,-87.62681
TA1308000001,6,5,false,1,6,5,41.92627,-87.63086
TA1307000048,6,5,true,2,5,3,41.83855,-87.60821
13431,6,5,true,1,5,4,41.8661,-87.60728
13300,6,5,true,1,12,11,41.88097,-87.61675
TA1305000004,6,6,false,2,6,4,41.8514,-87.61884
TA1305000002,6,6,false,1,8,7,41.86721,-87.62597
SL-011,6,6,false,5,2,-3,41.87256,-87.63356
13300,6,6,false,5,1,-4,41.88097,-87.61675
TA1307000117,6,6,false,3,9,6,41.89144,-87.62675
13022,6,6,false,1,9,8,41.89227,-87.61205
13016,6,6,false,1,7,6,41.89431,-87.62277
13338,6,6,false,1,7,6,41.89697,-87.62173
13042,6,6,false,5,3,-2,41.90097,-87.62377
TA1308000050,6,6,false,1,5,4,41.91211,-87.6347
13179,6,6,false,4,9,5,41.9157,-87.63461
13276,6,6,false,5,2,-3,41.93132,-87.63874
TA1307000048,6,6,true,6,4,-2,41.83855,-87.60821
13163,6,6,true,1,5,4,41.85808,-87.65108
SL-005,6,6,true,6,5,-1,41.8679,-87.62304
KA1504000104,6,6,true,1,8,7,41.87296,-87.66912
13300,6,6,true,1,8,7,41.88097,-87.61675
KA1503000064,6,6,true,1,5,4,41.88697,-87.61281
KA1503000043,6,6,true,1,5,4,41.88918,-87.63851
13022,6,6,true,8,6,-2,41.89227,-87.61205
13016,6,6,true,1,10,9,41.89431,-87.62277
KA1503000041,6,6,true,4,7,3,41.89452,-87.61798
15530,6,6,true,5,3,-2,41.89575,-87.62596
13338,6,6,true,5,19,14,41.89697,-87.62173
KA1504000133,6,6,true,6,2,-4,41.90234,-87.62773
TA1307000039,6,6,true,6,3,-3,41.90294,-87.63137
LF-005,6,6,true,2,7,5,41.91172,-87.62681
13128,6,6,true,1,12,11,41.91197,-87.63197
TA1308000050,6,6,true,3,6,3,41.91211,-87.6347
TA1306000007,6,6,true,7,1,-6,41.91469,-87.64333
13179,6,6,true,6,10,4,41.9157,-87.63461
13192,6,6,true,2,7,5,41.91995,-87.64884
13278,6,6,true,6,2,-4,41.94553,-87.64644
SL-005,6,7,false,9,5,-4,41.8679,-87.62304
13300,6,7,false,15,11,-4,41.88097,-87.61675
TA1306000010,6,7,false,5,3,-2,41.88419,-87.62961
15534,6,7,false,5,1,-4,41.88627,-87.61749
TA1307000131,6,7,false,6,1,-5,41.88688,-87.62606
KA1503000064,6,7,false,1,5,4,41.88697,-87.61281
KA1503000043,6,7,false,6,1,-5,41.88918,-87.63851
TA1307000117,6,7,false,5,1,-4,41.89144,-87.62675
13022,6,7,false,4,15,11,41.89227,-87.61205
TA1306000029,6,7,false,6,6,0,41.89256,-87.61449
13045,6,7,false,4,6,2,41.89403,-87.62931
13016,6,7,false,9,2,-7,41.89431,-87.62277
TA1306000012,6,7,false,7,2,-5,41.89475,-87.63438
13338,6,7,false,8,1,-7,41.89697,-87.62173
15529,6,7,false,6,2,-4,41.89858,-87.62206
13042,6,7,false,17,8,-9,41.90097,-87.62377
TA1307000039,6,7,false,8,3,-5,41.90294,-87.63137
LF-005,6,7,false,6,7,1,41.91172,-87.62681
13179,6,7,false,9,13,4,41.9157,-87.63461
LP-,6,7,false,1,6,5,41.92396,-87.63584
TA1307000001,6,7,false,6,1,-5,41.92535,-87.66581
13124,6,7,false,6,1,-5,41.92675,-87.63444
TA1305000014,6,7,false,5,4,-1,41.92956,-87.64313
TA1307000064,6,7,false,3,5,2,41.93222,-87.65864
TA1309000039,6,7,false,6,2,-4,41.93258,-87.63642
TA1307000136,6,7,false,6,1,-5,41.9365,-87.64755
13137,6,7,false,7,4,-3,41.9376,-87.6441
TA1309000049,6,7,false,5,1,-4,41.94077,-87.63919
TA1307000126,6,7,false,5,2,-3,41.94936,-87.65451
TA1309000037,6,7,true,5,2,-3,41.79957,-87.59474
TA1307000048,6,7,true,5,3,-2,41.83855,-87.60821
15545,6,7,true,10,7,-3,41.85627,-87.61334
13150,6,7,true,4,6,2,41.85783,-87.62455
TA1307000124,6,7,true,5,2,-3,41.86411,-87.62372
TA1305000017,6,7,true,5,1,-4,41.86734,-87.64863
SL-005,6,7,true,9,3,-6,41.8679,-87.62304
TA1309000064,6,7,true,1,5,4,41.87127,-87.67369
13332,6,7,true,5,1,-4,41.87219,-87.6615
KA1504000104,6,7,true,3,5,2,41.87296,-87.66912
13300,6,7,true,24,11,-13,41.88097,-87.61675
13008,6,7,true,2,6,4,41.88105,-87.62408
TA1307000120,6,7,true,5,3,-2,41.88188,-87.64879
13353,6,7,true,2,5,3,41.88283,-87.6612
13263,6,7,true,6,6,0,41.88467,-87.61952
13021,6,7,true,1,6,5,41.88559,-87.64184
KA1503000012,6,7,true,1,5,4,41.88599,-87.63089
TA1306000003,6,7,true,5,4,-1,41.88867,-87.64442
KA1503000043,6,7,true,4,16,12,41.88918,-87.63851
TA1307000151,6,7,true,2,7,5,41.88993,-87.63427
TA1306000013,6,7,true,6,3,-3,41.89083,-87.61852
TA1307000117,6,7,true,5,4,-1,41.89144,-87.62675
TA1305000003,6,7,true,3,6,3,41.89187,-87.62061
13022,6,7,true,5,7,2,41.89227,-87.61205
TA1306000029,6,7,true,9,2,-7,41.89256,-87.61449
13045,6,7,true,6,3,-3,41.89403,-87.62931
13016,6,7,true,7,6,-1,41.89431,-87.62277
KA1503000041,6,7,true,6,8,2,41.89452,-87.61798
TA1307000062,6,7,true,4,6,2,41.89466,-87.63839
TA1306000012,6,7,true,5,4,-1,41.89475,-87.63438
15530,6,7,true,5,3,-2,41.89575,-87.62596
18003,6,7,true,5,5,0,41.89575,-87.62011
13017,6,7,true,7,4,-3,41.89676,-87.6357
13338,6,7,true,10,7,-3,41.89697,-87.62173
TA1306000009,6,7,true,5,1,-4,41.89772,-87.64299
620,6,7,true,6,2,-4,41.89817,-87.63754
TA1307000128,6,7,true,5,4,-1,41.89896,-87.6299
TA1307000039,6,7,true,7,16,9,41.90294,-87.63137
TA1308000049,6,7,true,6,6,0,41.90672,-87.6349
TA1309000024,6,7,true,6,4,-2,41.908,-87.63152
LF-005,6,7,true,6,9,3,41.91172,-87.62681
TA1308000050,6,7,true,8,5,-3,41.91211,-87.6347
13179,6,7,true,8,21,13,41.9157,-87.63461
TA1309000006,6,7,true,6,1,-5,41.91809,-87.64375
13059,6,7,true,5,4,-1,41.91845,-87.65222
13193,6,7,true,2,5,3,41.92182,-87.64412
TA1307000001,6,7,true,2,6,4,41.92535,-87.66581
TA1309000019,6,7,true,9,1,-8,41.92586,-87.63897
TA1309000058,6,7,true,1,9,8,41.92591,-87.64927
TA1308000001,6,7,true,7,8,1,41.92627,-87.63086
TA1305000014,6,7,true,12,1,-11,41.92956,-87.64313
TA1307000142,6,7,true,2,6,4,41.93125,-87.64432
13276,6,7,true,12,5,-7,41.93132,-87.63874
TA1306000014,6,7,true,2,8,6,41.93242,-87.65271
TA1309000039,6,7,true,11,6,-5,41.93258,-87.63642
13268,6,7,true,3,5,2,41.93588,-87.67843
13137,6,7,true,7,5,-2,41.9376,-87.6441
13277,6,7,true,6,5,-1,41.9401,-87.64546
TA1309000049,6,7,true,8,4,-4,41.94077,-87.63919
13071,6,7,true,4,6,2,41.94373,-87.66401
13325,6,7,true,5,8,3,41.94907,-87.64863
TA1307000150,6,7,true,4,7,3,41.94945,-87.64646
13063,6,7,true,7,4,-3,41.95424,-87.65441
TA1309000027,6,7,true,6,2,-4,41.9585,-87.65499
13389,6,7,true,5,1,-4,41.961,-87.64958
TA1307000107,6,7,true,9,1,-8,41.96164,-87.65464
TA1308000012,6,7,true,6,6,0,41.96398,-87.63818
15545,6,8,false,3,5,2,41.85627,-87.61334
13150,6,8,false,1,5,4,41.85783,-87.62455
TA1307000124,6,8,false,5,2,-3,41.86411,-87.62372
13431,6,8,false,6,5,-1,41.8661,-87.60728
15544,6,8,false,7,15,8,41.86723,-87.61536
SL-005,6,8,false,9,5,-4,41.8679,-87.62304
SL-009,6,8,false,10,2,-8,41.87081,-87.63121
SL-008,6,8,false,7,6,-1,41.87209,-87.62956
623,6,8,false,6,6,0,41.87272,-87.62399
15541,6,8,false,8,4,-4,41.8758,-87.62086
13300,6,8,false,17,10,-7,41.88097,-87.61675
13008,6,8,false,7,10,3,41.88105,-87.62408
13409,6,8,false,6,2,-4,41.8831,-87.6511
13263,6,8,false,9,9,0,41.88467,-87.61952
TA1305000011,6,8,false,6,6,0,41.886,-87.62418
TA1307000131,6,8,false,8,6,-2,41.88688,-87.62606
KA1503000064,6,8,false,12,12,0,41.88697,-87.61281
TA1306000003,6,8,false,6,1,-5,41.88867,-87.64442
KA1503000043,6,8,false,5,1,-4,41.88918,-87.63851
TA1307000151,6,8,false,3,5,2,41.88993,-87.63427
13427,6,8,false,8,5,-3,41.89054,-87.62205
13430,6,8,false,5,3,-2,41.89077,-87.63169
TA1306000013,6,8,false,7,5,-2,41.89083,-87.61852
RN-,6,8,false,5,3,-2,41.89102,-87.63546
13033,6,8,false,5,3,-2,41.8916,-87.64835
TA1305000003,6,8,false,10,8,-2,41.89187,-87.62061
13022,6,8,false,22,25,3,41.89227,-87.61205
TA1306000029,6,8,false,6,8,2,41.89256,-87.61449
13045,6,8,false,10,7,-3,41.89403,-87.62931
13016,6,8,false,16,1,-15,41.89431,-87.62277
KA1503000041,6,8,false,6,1,-5,41.89452,-87.61798
TA1306000012,6,8,false,9,3,-6,41.89475,-87.63438
KP1705001026,6,8,false,2,5,3,41.89483,-87.6323
15530,6,8,false,10,1,-9,41.89575,-87.62596
TA1305000020,6,8,false,8,4,-4,41.89636,-87.65406
13303,6,8,false,5,4,-1,41.89672,-87.63088
13338,6,8,false,5,5,0,41.89697,-87.62173
13034,6,8,false,11,3,-8,41.89754,-87.62352
15529,6,8,false,6,3,-3,41.89858,-87.62206
TA1307000128,6,8,false,9,3,-6,41.89896,-87.6299
13042,6,8,false,28,18,-10,41.90097,-87.62377
TA1307000039,6,8,false,14,4,-10,41.90294,-87.63137
KA1504000135,6,8,false,7,4,-3,41.90319,-87.63439
KA1504000134,6,8,false,2,5,3,41.90687,-87.6262
TA1305000037,6,8,false,5,1,-4,41.91018,-87.67003
LF-005,6,8,false,19,28,9,41.91172,-87.62681
13128,6,8,false,7,8,1,41.91197,-87.63197
TA1308000050,6,8,false,7,11,4,41.91211,-87.6347
TA1307000166,6,8,false,5,1,-4,41.91386,-87.64877
13179,6,8,false,21,18,-3,41.9157,-87.63461
13146,6,8,false,12,4,-8,41.91831,-87.63629
13193,6,8,false,8,5,-3,41.92182,-87.64412
13191,6,8,false,5,6,1,41.92217,-87.63891
TA1306000016,6,8,false,1,6,5,41.9256,-87.65371
TA1309000019,6,8,false,3,5,2,41.92586,-87.63897
TA1309000058,6,8,false,8,2,-6,41.92591,-87.64927
TA1308000001,6,8,false,6,5,-1,41.92627,-87.63086
TA1305000014,6,8,false,6,7,1,41.92956,-87.64313
13276,6,8,false,16,3,-13,41.93132,-87.63874
TA1306000014,6,8,false,5,4,-1,41.93242,-87.65271
TA1309000039,6,8,false,8,6,-2,41.93258,-87.63642
TA1307000052,6,8,false,5,3,-2,41.93628,-87.65266
TA1307000136,6,8,false,8,3,-5,41.9365,-87.64755
TA1307000041,6,8,false,9,2,-7,41.93669,-87.63683
13137,6,8,false,6,3,-3,41.9376,-87.6441
TA1308000019,6,8,false,6,4,-2,41.93973,-87.65886
TA1307000134,6,8,false,5,4,-1,41.94016,-87.65303
TA1309000049,6,8,false,6,8,2,41.94077,-87.63919
TA1309000025,6,8,false,4,5,1,41.94368,-87.64894
13278,6,8,false,12,4,-8,41.94553,-87.64644
13325,6,8,false,2,5,3,41.94907,-87.64863
TA1307000126,6,8,false,4,6,2,41.94936,-87.65451
TA1307000150,6,8,false,1,5,4,41.94945,-87.64646
13319,6,8,false,4,5,1,41.95069,-87.6687
13063,6,8,false,6,2,-4,41.95424,-87.65441
TA1308000022,6,8,false,5,4,-1,41.95438,-87.64805
13389,6,8,false,5,4,-1,41.961,-87.64958
15622,6,8,false,1,5,4,41.96108,-87.69544
TA1307000107,6,8,false,6,3,-3,41.96164,-87.65464
TA1308000012,6,8,false,6,7,1,41.96398,-87.63818
KA1504000152,6,8,false,8,1,-7,41.98403,-87.65231
KA1503000014,6,8,true,7,1,-6,41.7851,-87.60108
TA1308000009,6,8,true,5,1,-4,41.79522,-87.58075
TA1309000037,6,8,true,2,6,4,41.79957,-87.59474
TA1307000048,6,8,true,2,5,3,41.83855,-87.60821
15545,6,8,true,10,10,0,41.85627,-87.61334
13102,6,8,true,7,2,-5,41.85762,-87.61942
13150,6,8,true,5,5,0,41.85783,-87.62455
TA1307000124,6,8,true,10,2,-8,41.86411,-87.62372
13431,6,8,true,6,2,-4,41.8661,-87.60728
WL-008,6,8,true,2,5,3,41.86712,-87.64108
TA1305000002,6,8,true,5,5,0,41.86721,-87.62597
15544,6,8,true,4,5,1,41.86723,-87.61536
KA1706005007,6,8,true,7,2,-5,41.86749,-87.63219
SL-005,6,8,true,11,9,-2,41.8679,-87.62304
TA1309000010,6,8,true,10,6,-4,41.87074,-87.62574
SL-008,6,8,true,3,7,4,41.87209,-87.62956
623,6,8,true,5,3,-2,41.87272,-87.62399
KA1504000104,6,8,true,2,7,5,41.87296,-87.66912
13158,6,8,true,5,2,-3,41.87764,-87.64957
WL-011,6,8,true,3,8,5,41.88034,-87.64273
13300,6,8,true,17,19,2,41.88097,-87.61675
13008,6,8,true,5,5,0,41.88105,-87.62408
TA1307000120,6,8,true,6,8,2,41.88188,-87.64879
TA1305000032,6,8,true,5,9,4,41.88218,-87.64109
13353,6,8,true,6,1,-5,41.88283,-87.6612
13001,6,8,true,2,6,4,41.88397,-87.62459
18062,6,8,true,3,5,2,41.88412,-87.65427
TA1306000010,6,8,true,3,6,3,41.88419,-87.62961
15535,6,8,true,3,5,2,41.8846,-87.64455
TA1305000029,6,8,true,1,5,4,41.88466,-87.62787
13263,6,8,true,14,4,-10,41.88467,-87.61952
TA1306000015,6,8,true,5,2,-3,41.88549,-87.65232
KA1503000064,6,8,true,6,10,4,41.88697,-87.61281
TA1305000022,6,8,true,5,8,3,41.88817,-87.63656
TA1306000003,6,8,true,6,4,-2,41.88867,-87.64442
KA1503000043,6,8,true,11,24,13,41.88918,-87.63851
13050,6,8,true,5,3,-2,41.88919,-87.62775
TA1307000151,6,8,true,8,4,-4,41.88993,-87.63427
636,6,8,true,5,5,0,41.88997,-87.63662
TA1306000013,6,8,true,10,6,-4,41.89083,-87.61852
RN-,6,8,true,8,3,-5,41.89102,-87.63546
TA1307000117,6,8,true,6,7,1,41.89144,-87.62675
13033,6,8,true,5,3,-2,41.8916,-87.64835
13194,6,8,true,7,2,-5,41.8918,-87.65878
TA1305000003,6,8,true,4,6,2,41.89187,-87.62061
13022,6,8,true,9,11,2,41.89227,-87.61205
TA1306000029,6,8,true,8,8,0,41.89256,-87.61449
13265,6,8,true,10,9,-1,41.89383,-87.64172
13045,6,8,true,7,22,15,41.89403,-87.62931
13016,6,8,true,6,6,0,41.89431,-87.62277
KA1503000041,6,8,true,6,12,6,41.89452,-87.61798
TA1307000062,6,8,true,2,5,3,41.89466,-87.63839
TA1306000012,6,8,true,12,5,-7,41.89475,-87.63438
KP1705001026,6,8,true,4,8,4,41.89483,-87.6323
15530,6,8,true,5,9,4,41.89575,-87.62596
13289,6,8,true,5,1,-4,41.89638,-87.661
13303,6,8,true,4,5,1,41.89672,-87.63088
13338,6,8,true,4,6,2,41.89697,-87.62173
15529,6,8,true,6,7,1,41.89858,-87.62206
TA1307000128,6,8,true,6,5,-1,41.89896,-87.6299
KA1504000116,6,8,true,7,3,-4,41.90023,-87.64299
13290,6,8,true,5,1,-4,41.90069,-87.66259
13042,6,8,true,6,11,5,41.90097,-87.62377
KA1504000133,6,8,true,5,8,3,41.90234,-87.62773
TA1307000039,6,8,true,14,15,1,41.90294,-87.63137
KA1504000135,6,8,true,12,15,3,41.90319,-87.63439
13061,6,8,true,7,4,-3,41.90342,-87.66779
KA1504000079,6,8,true,5,6,1,41.9035,-87.64334
TA1308000049,6,8,true,4,5,1,41.90672,-87.6349
13224,6,8,true,5,2,-3,41.90706,-87.66725
TA1307000143,6,8,true,5,3,-2,41.90762,-87.63854
13221,6,8,true,3,5,2,41.90765,-87.67254
TA1309000024,6,8,true,8,6,-2,41.908,-87.63152
331,6,8,true,1,8,7,41.90965,-87.64812
TA1305000037,6,8,true,4,6,2,41.91018,-87.67003
13154,6,8,true,6,8,2,41.91054,-87.65312
TA1307000038,6,8,true,1,6,5,41.91138,-87.63868
LF-005,6,8,true,16,11,-5,41.91172,-87.62681
13128,6,8,true,11,5,-6,41.91197,-87.63197
TA1308000050,6,8,true,19,18,-1,41.91211,-87.6347
TA1306000032,6,8,true,8,3,-5,41.9137,-87.65285
18067,6,8,true,5,3,-2,41.9146,-87.66796
13179,6,8,true,26,23,-3,41.9157,-87.63461
TA1307000163,6,8,true,8,5,-3,41.91821,-87.65696
13146,6,8,true,18,9,-9,41.91831,-87.63629
13059,6,8,true,4,7,3,41.91845,-87.65222
13192,6,8,true,6,4,-2,41.91995,-87.64884
TA1309000030,6,8,true,3,7,4,41.92077,-87.66372
TA1309000033,6,8,true,8,6,-2,41.92158,-87.65381
13193,6,8,true,9,12,3,41.92182,-87.64412
13191,6,8,true,9,1,-8,41.92217,-87.63891
LP-,6,8,true,5,2,-3,41.92396,-87.63584
TA1306000026,6,8,true,4,5,1,41.92558,-87.65842
TA1306000016,6,8,true,5,8,3,41.9256,-87.65371
TA1309000019,6,8,true,8,10,2,41.92586,-87.63897
TA1309000058,6,8,true,3,12,9,41.92591,-87.64927
TA1308000001,6,8,true,8,9,1,41.92627,-87.63086
TA1309000023,6,8,true,7,6,-1,41.9287,-87.65383
TA1307000113,6,8,true,8,2,-6,41.92878,-87.66391
TA1309000059,6,8,true,5,2,-3,41.92889,-87.65898
TA1307000142,6,8,true,5,3,-2,41.93125,-87.64432
13276,6,8,true,10,5,-5,41.93132,-87.63874
TA1307000064,6,8,true,7,5,-2,41.93222,-87.65864
TA1306000014,6,8,true,3,5,2,41.93242,-87.65271
TA1309000039,6,8,true,7,12,5,41.93258,-87.63642
TA1309000036,6,8,true,2,5,3,41.93313,-87.64776
TA1307000136,6,8,true,6,4,-2,41.9365,-87.64755
TA1307000041,6,8,true,9,4,-5,41.93669,-87.63683
13137,6,8,true,8,11,3,41.9376,-87.6441
13229,6,8,true,8,3,-5,41.93946,-87.66376
TA1308000019,6,8,true,7,5,-2,41.93973,-87.65886
13277,6,8,true,8,5,-3,41.9401,-87.64546
TA1307000134,6,8,true,7,3,-4,41.94016,-87.65303
TA1309000049,6,8,true,12,13,1,41.94077,-87.63919
13278,6,8,true,11,5,-6,41.94553,-87.64644
13235,6,8,true,1,5,4,41.94814,-87.66396
13325,6,8,true,9,10,1,41.94907,-87.64863
TA1307000126,6,8,true,5,3,-2,41.94936,-87.65451
TA1307000150,6,8,true,12,6,-6,41.94945,-87.64646
TA1307000127,6,8,true,5,4,-1,41.9508,-87.65918
13323,6,8,true,4,5,1,41.95282,-87.65
13063,6,8,true,6,5,-1,41.95424,-87.65441
13379,6,8,true,8,4,-4,41.95786,-87.6495
13389,6,8,true,5,8,3,41.961,-87.64958
TA1307000107,6,8,true,9,9,0,41.96164,-87.65464
TA1308000012,6,8,true,9,8,-1,41.96398,-87.63818
13074,6,8,true,6,3,-3,41.96521,-87.6582
639,6,8,true,4,12,8,41.96584,-87.64538
TA1307000158,6,8,true,6,1,-5,41.9671,-87.67904
TA1307000119,6,8,true,7,4,-3,41.96796,-87.65
TA1309000066,6,8,true,1,5,4,41.9691,-87.67423
KA1504000171,6,8,true,8,2,-6,41.97161,-87.65016
KA1504000152,6,8,true,6,8,2,41.98403,-87.65231
KA1504000159,6,8,true,5,1,-4,42.01059,-87.66241
TA1309000063,6,9,false,5,2,-3,41.79325,-87.5878
TA1308000009,6,9,false,8,6,-2,41.79522,-87.58075
TA1307000164,6,9,false,5,1,-4,41.79527,-87.59647
KA1503000052,6,9,false,9,1,-8,41.79935,-87.60097
KA1503000059,6,9,false,5,3,-2,41.79952,-87.58643
TA1309000037,6,9,false,9,3,-6,41.79957,-87.59474
13398,6,9,false,6,2,-4,41.80256,-87.59035
TA1308000043,6,9,false,6,1,-5,41.83066,-87.64715
TA1307000048,6,9,false,7,4,-3,41.83855,-87.60821
13075,6,9,false,6,1,-5,41.8531,-87.63192
13102,6,9,false,8,2,-6,41.85762,-87.61942
13150,6,9,false,7,2,-5,41.85783,-87.62455
SL-012,6,9,false,5,3,-2,41.86038,-87.62581
TA1307000124,6,9,false,8,5,-3,41.86411,-87.62372
13431,6,9,false,2,8,6,41.8661,-87.60728
TA1305000002,6,9,false,8,7,-1,41.86721,-87.62597
15544,6,9,false,9,23,14,41.86723,-87.61536
SL-005,6,9,false,33,12,-21,41.8679,-87.62304
TA1309000010,6,9,false,11,2,-9,41.87074,-87.62574
SL-008,6,9,false,11,7,-4,41.87209,-87.62956
SL-011,6,9,false,6,7,1,41.87256,-87.63356
623,6,9,false,16,6,-10,41.87272,-87.62399
15541,6,9,false,6,13,7,41.8758,-87.62086
624,6,9,false,8,5,-3,41.87626,-87.62923
TA1309000002,6,9,false,11,8,-3,41.87784,-87.62408
TA1309000008,6,9,false,2,5,3,41.87933,-87.6355
WL-011,6,9,false,6,2,-4,41.88034,-87.64273
13156,6,9,false,5,1,-4,41.88042,-87.65554
13300,6,9,false,43,43,0,41.88097,-87.61675
13008,6,9,false,29,29,0,41.88105,-87.62408
TA1305000006,6,9,false,4,8,4,41.88122,-87.6296
TA1307000120,6,9,false,6,2,-4,41.88188,-87.64879
13036,6,9,false,8,4,-4,41.8821,-87.62513
TA1305000032,6,9,false,10,3,-7,41.88218,-87.64109
13409,6,9,false,7,2,-5,41.8831,-87.6511
13053,6,9,false,7,8,1,41.88365,-87.64863
13001,6,9,false,18,13,-5,41.88397,-87.62459
18062,6,9,false,7,7,0,41.88412,-87.65427
TA1306000010,6,9,false,11,1,-10,41.88419,-87.62961
15535,6,9,false,6,5,-1,41.8846,-87.64455
TA1305000029,6,9,false,8,10,2,41.88466,-87.62787
13263,6,9,false,11,4,-7,41.88467,-87.61952
TA1306000015,6,9,false,2,5,3,41.88549,-87.65232
13021,6,9,false,4,6,2,41.88559,-87.64184
TA1307000111,6,9,false,5,4,-1,41.88582,-87.63548
KA1503000012,6,9,false,8,4,-4,41.88599,-87.63089
TA1305000011,6,9,false,15,15,0,41.886,-87.62418
15534,6,9,false,5,1,-4,41.88627,-87.61749
TA1308000029,6,9,false,9,3,-6,41.88673,-87.62225
TA1307000131,6,9,false,5,3,-2,41.88688,-87.62606
KA1503000064,6,9,false,25,21,-4,41.88697,-87.61281
TA1305000022,6,9,false,10,14,4,41.88817,-87.63656
TA1306000003,6,9,false,3,7,4,41.88867,-87.64442
KA1503000043,6,9,false,22,11,-11,41.88918,-87.63851
TA1307000151,6,9,false,13,8,-5,41.88993,-87.63427
13430,6,9,false,12,3,-9,41.89077,-87.63169
TA1306000013,6,9,false,26,11,-15,41.89083,-87.61852
RN-,6,9,false,6,3,-3,41.89102,-87.63546
TA1307000117,6,9,false,8,6,-2,41.89144,-87.62675
13033,6,9,false,6,4,-2,41.8916,-87.64835
TA1305000003,6,9,false,14,7,-7,41.89187,-87.62061
13022,6,9,false,41,52,11,41.89227,-87.61205
TA1306000029,6,9,false,14,6,-8,41.89256,-87.61449
13265,6,9,false,10,1,-9,41.89383,-87.64172
13045,6,9,false,17,8,-9,41.89403,-87.62931
13016,6,9,false,17,11,-6,41.89431,-87.62277
KA1503000041,6,9,false,10,5,-5,41.89452,-87.61798
TA1307000062,6,9,false,8,3,-5,41.89466,-87.63839
TA1306000012,6,9,false,14,12,-2,41.89475,-87.63438
KP1705001026,6,9,false,10,7,-3,41.89483,-87.6323
13132,6,9,false,4,6,2,41.89573,-87.67718
15530,6,9,false,7,4,-3,41.89575,-87.62596
18003,6,9,false,8,2,-6,41.89575,-87.62011
13289,6,9,false,4,5,1,41.89638,-87.661
13303,6,9,false,6,5,-1,41.89672,-87.63088
13338,6,9,false,5,6,1,41.89697,-87.62173
TA1306000009,6,9,false,5,3,-2,41.89772,-87.64299
15529,6,9,false,16,6,-10,41.89858,-87.62206
TA1307000128,6,9,false,8,9,1,41.89896,-87.6299
13248,6,9,false,6,5,-1,41.89964,-87.66788
13042,6,9,false,25,22,-3,41.90097,-87.62377
KA1504000133,6,9,false,13,10,-3,41.90234,-87.62773
TA1307000039,6,9,false,18,10,-8,41.90294,-87.63137
KA1504000135,6,9,false,18,12,-6,41.90319,-87.63439
13061,6,9,false,11,10,-1,41.90342,-87.66779
TA1308000049,6,9,false,9,15,6,41.90672,-87.6349
KA1504000134,6,9,false,6,3,-3,41.90687,-87.6262
13221,6,9,false,6,1,-5,41.90765,-87.67254
TA1309000024,6,9,false,7,3,-4,41.908,-87.63152
TA1305000041,6,9,false,4,11,7,41.9094,-87.67769
331,6,9,false,6,5,-1,41.90965,-87.64812
TA1305000037,6,9,false,4,5,1,41.91018,-87.67003
13058,6,9,false,5,8,3,41.91059,-87.64942
LF-005,6,9,false,27,38,11,41.91172,-87.62681
13128,6,9,false,4,6,2,41.91197,-87.63197
TA1308000050,6,9,false,14,23,9,41.91211,-87.6347
13243,6,9,false,5,1,-4,41.91262,-87.6814
TA1306000032,6,9,false,7,3,-4,41.9137,-87.65285
13068,6,9,false,6,2,-4,41.91554,-87.68703
13179,6,9,false,28,37,9,41.9157,-87.63461
13146,6,9,false,11,24,13,41.91831,-87.63629
13059,6,9,false,11,6,-5,41.91845,-87.65222
13192,6,9,false,3,7,4,41.91995,-87.64884
TA1309000030,6,9,false,1,5,4,41.92077,-87.66372
TA1309000033,6,9,false,6,7,1,41.92158,-87.65381
13193,6,9,false,12,8,-4,41.92182,-87.64412
13191,6,9,false,5,7,2,41.92217,-87.63891
LP-,6,9,false,11,6,-5,41.92396,-87.63584
TA1307000001,6,9,false,6,6,0,41.92535,-87.66581
TA1306000016,6,9,false,10,2,-8,41.9256,-87.65371
TA1309000019,6,9,false,17,16,-1,41.92586,-87.63897
TA1309000058,6,9,false,10,13,3,41.92591,-87.64927
TA1308000001,6,9,false,12,19,7,41.92627,-87.63086
13124,6,9,false,1,5,4,41.92675,-87.63444
TA1309000023,6,9,false,9,5,-4,41.9287,-87.65383
TA1307000113,6,9,false,5,3,-2,41.92878,-87.66391
13296,6,9,false,5,1,-4,41.92883,-87.66852
TA1309000061,6,9,false,6,3,-3,41.92915,-87.64909
TA1305000014,6,9,false,10,9,-1,41.92956,-87.64313
TA1307000142,6,9,false,9,6,-3,41.93125,-87.64432
13276,6,9,false,12,8,-4,41.93132,-87.63874
TA1307000064,6,9,false,7,9,2,41.93222,-87.65864
TA1309000039,6,9,false,19,11,-8,41.93258,-87.63642
TA1309000036,6,9,false,8,2,-6,41.93313,-87.64776
TA1307000006,6,9,false,4,7,3,41.93571,-87.6636
TA1307000136,6,9,false,15,7,-8,41.9365,-87.64755
TA1307000041,6,9,false,10,11,1,41.93669,-87.63683
13137,6,9,false,12,10,-2,41.9376,-87.6441
TA1309000042,6,9,false,7,3,-4,41.93937,-87.66836
TA1308000019,6,9,false,4,6,2,41.93973,-87.65886
13277,6,9,false,7,6,-1,41.9401,-87.64546
TA1307000134,6,9,false,6,6,0,41.94016,-87.65303
TA1309000049,6,9,false,28,2,-26,41.94077,-87.63919
TA1307000138,6,9,false,6,2,-4,41.94334,-87.67094
13071,6,9,false,7,8,1,41.94373,-87.66401
632,6,9,false,6,6,0,41.94453,-87.6547
13278,6,9,false,7,6,-1,41.94553,-87.64644
13235,6,9,false,7,4,-3,41.94814,-87.66396
13325,6,9,false,6,3,-3,41.94907,-87.64863
TA1307000127,6,9,false,9,12,3,41.9508,-87.65918
13323,6,9,false,10,2,-8,41.95282,-87.65
13063,6,9,false,6,4,-2,41.95424,-87.65441
TA1308000022,6,9,false,12,4,-8,41.95438,-87.64805
TA1309000027,6,9,false,8,4,-4,41.9585,-87.65499
13389,6,9,false,6,4,-2,41.961,-87.64958
15622,6,9,false,6,4,-2,41.96108,-87.69544
TA1307000107,6,9,false,5,5,0,41.96164,-87.65464
TA1308000012,6,9,false,8,20,12,41.96398,-87.63818
639,6,9,false,7,3,-4,41.96584,-87.64538
TA1307000158,6,9,false,5,1,-4,41.9671,-87.67904
KA1504000171,6,9,false,6,3,-3,41.97161,-87.65016
TA1309000035,6,9,false,5,2,-3,41.97335,-87.66785
KA1504000146,6,9,false,7,4,-3,41.978,-87.66805
KA1504000151,6,9,false,3,6,3,41.98359,-87.66916
KA1504000152,6,9,false,3,5,2,41.98403,-87.65231
596,6,9,false,6,5,-1,42.04822,-87.68348
E008,6,9,false,4,6,2,42.05049,-87.67782
KA1503000014,6,9,true,5,3,-2,41.7851,-87.60108
KA1503000070,6,9,true,1,10,9,41.78794,-87.58831
KA1503000074,6,9,true,3,5,2,41.79174,-87.58395
TA1309000063,6,9,true,8,4,-4,41.79325,-87.5878
KA1503000052,6,9,true,6,2,-4,41.79935,-87.60097
KA1503000059,6,9,true,8,1,-7,41.79952,-87.58643
TA1309000037,6,9,true,6,2,-4,41.79957,-87.59474
TA1307000048,6,9,true,4,5,1,41.83855,-87.60821
13089,6,9,true,6,4,-2,41.85497,-87.67567
15545,6,9,true,15,12,-3,41.85627,-87.61334
13102,6,9,true,8,6,-2,41.85762,-87.61942
13150,6,9,true,7,2,-5,41.85783,-87.62455
TA1307000124,6,9,true,7,10,3,41.86411,-87.62372
13029,6,9,true,3,5,2,41.86531,-87.6179
TA1305000002,6,9,true,10,9,-1,41.86721,-87.62597
15544,6,9,true,4,6,2,41.86723,-87.61536
SL-005,6,9,true,14,14,0,41.8679,-87.62304
TA1309000010,6,9,true,4,7,3,41.87074,-87.62574
TA1307000130,6,9,true,3,5,2,41.87178,-87.65103
SL-008,6,9,true,12,10,-2,41.87209,-87.62956
13332,6,9,true,11,4,-7,41.87219,-87.6615
SL-011,6,9,true,5,2,-3,41.87256,-87.63356
623,6,9,true,6,4,-2,41.87272,-87.62399
SL-007,6,9,true,5,4,-1,41.87404,-87.6277
13028,6,9,true,6,4,-2,41.87475,-87.64981
15541,6,9,true,2,7,5,41.8758,-87.62086
15539,6,9,true,5,1,-4,41.87763,-87.64405
13158,6,9,true,6,10,4,41.87764,-87.64957
13157,6,9,true,9,4,-5,41.87773,-87.6548
TA1305000025,6,9,true,5,3,-2,41.87773,-87.63528
638,6,9,true,5,6,1,41.87827,-87.64078
KA1503000015,6,9,true,1,7,6,41.87948,-87.6257
WL-011,6,9,true,5,4,-1,41.88034,-87.64273
13300,6,9,true,14,21,7,41.88097,-87.61675
13008,6,9,true,4,7,3,41.88105,-87.62408
TA1305000006,6,9,true,2,6,4,41.88122,-87.6296
TA1307000120,6,9,true,21,14,-7,41.88188,-87.64879
13036,6,9,true,1,8,7,41.8821,-87.62513
TA1305000032,6,9,true,8,10,2,41.88218,-87.64109
13353,6,9,true,9,9,0,41.88283,-87.6612
13409,6,9,true,5,2,-3,41.8831,-87.6511
13053,6,9,true,1,11,10,41.88365,-87.64863
13001,6,9,true,7,4,-3,41.88397,-87.62459
TA1306000010,6,9,true,4,5,1,41.88419,-87.62961
15535,6,9,true,8,13,5,41.8846,-87.64455
TA1305000029,6,9,true,3,6,3,41.88466,-87.62787
13263,6,9,true,8,2,-6,41.88467,-87.61952
TA1306000015,6,9,true,3,5,2,41.88549,-87.65232
13021,6,9,true,2,7,5,41.88559,-87.64184
KA1503000012,6,9,true,7,8,1,41.88599,-87.63089
TA1305000011,6,9,true,6,9,3,41.886,-87.62418
TA1308000029,6,9,true,5,2,-3,41.88673,-87.62225
KA1503000064,6,9,true,4,11,7,41.88697,-87.61281
TA1305000022,6,9,true,9,4,-5,41.88817,-87.63656
TA1306000003,6,9,true,20,8,-12,41.88867,-87.64442
KA1503000043,6,9,true,22,26,4,41.88918,-87.63851
TA1307000151,6,9,true,5,10,5,41.88993,-87.63427
636,6,9,true,7,5,-2,41.88997,-87.63662
13427,6,9,true,7,1,-6,41.89054,-87.62205
13430,6,9,true,3,6,3,41.89077,-87.63169
TA1306000013,6,9,true,15,11,-4,41.89083,-87.61852
RN-,6,9,true,6,9,3,41.89102,-87.63546
TA1307000117,6,9,true,3,9,6,41.89144,-87.62675
13033,6,9,true,17,10,-7,41.8916,-87.64835
13194,6,9,true,6,1,-5,41.8918,-87.65878
TA1305000003,6,9,true,11,8,-3,41.89187,-87.62061
13022,6,9,true,18,19,1,41.89227,-87.61205
TA1306000029,6,9,true,13,6,-7,41.89256,-87.61449
13265,6,9,true,17,4,-13,41.89383,-87.64172
13045,6,9,true,25,25,0,41.89403,-87.62931
13016,6,9,true,10,3,-7,41.89431,-87.62277
KA1503000041,6,9,true,13,7,-6,41.89452,-87.61798
TA1307000062,6,9,true,12,4,-8,41.89466,-87.63839
TA1306000012,6,9,true,13,8,-5,41.89475,-87.63438
KP1705001026,6,9,true,9,4,-5,41.89483,-87.6323
18058,6,9,true,4,6,2,41.8955,-87.68201
637,6,9,true,5,4,-1,41.89563,-87.67209
13132,6,9,true,5,4,-1,41.89573,-87.67718
15530,6,9,true,8,4,-4,41.89575,-87.62596
18003,6,9,true,2,6,4,41.89575,-87.62011
TA1305000020,6,9,true,4,5,1,41.89636,-87.65406
13289,6,9,true,3,7,4,41.89638,-87.661
13303,6,9,true,5,6,1,41.89672,-87.63088
13017,6,9,true,9,6,-3,41.89676,-87.6357
13338,6,9,true,11,3,-8,41.89697,-87.62173
TA1307000061,6,9,true,7,3,-4,41.89745,-87.62873
TA1306000009,6,9,true,9,5,-4,41.89772,-87.64299
620,6,9,true,5,4,-1,41.89817,-87.63754
15529,6,9,true,11,5,-6,41.89858,-87.62206
TA1307000128,6,9,true,7,7,0,41.89896,-87.6299
657,6,9,true,7,4,-3,41.89918,-87.6722
13248,6,9,true,11,1,-10,41.89964,-87.66788
TA1306000011,6,9,true,4,5,1,41.89994,-87.63443
KA1504000116,6,9,true,8,5,-3,41.90023,-87.64299
13290,6,9,true,7,4,-3,41.90069,-87.66259
13042,6,9,true,12,19,7,41.90097,-87.62377
KA1504000133,6,9,true,7,8,1,41.90234,-87.62773
TA1307000039,6,9,true,38,32,-6,41.90294,-87.63137
KA1504000135,6,9,true,23,27,4,41.90319,-87.63439
13136,6,9,true,3,7,4,41.90326,-87.67845
13061,6,9,true,13,12,-1,41.90342,-87.66779
KA1504000079,6,9,true,5,7,2,41.9035,-87.64334
TA1307000115,6,9,true,5,1,-4,41.9046,-87.64056
TA1308000049,6,9,true,14,9,-5,41.90672,-87.6349
KA1504000134,6,9,true,5,3,-2,41.90687,-87.6262
13224,6,9,true,8,6,-2,41.90706,-87.66725
TA1307000143,6,9,true,5,3,-2,41.90762,-87.63854
13221,6,9,true,5,8,3,41.90765,-87.67254
TA1309000024,6,9,true,5,12,7,41.908,-87.63152
TA1305000041,6,9,true,7,8,1,41.9094,-87.67769
331,6,9,true,9,15,6,41.90965,-87.64812
13257,6,9,true,6,4,-2,41.91054,-87.68956
13154,6,9,true,5,10,5,41.91054,-87.65312
13058,6,9,true,5,9,4,41.91059,-87.64942
TA1307000038,6,9,true,6,8,2,41.91138,-87.63868
LF-005,6,9,true,22,31,9,41.91172,-87.62681
13128,6,9,true,5,9,4,41.91197,-87.63197
TA1308000050,6,9,true,25,27,2,41.91211,-87.6347
13243,6,9,true,10,7,-3,41.91262,-87.6814
TA1306000032,6,9,true,8,9,1,41.9137,-87.65285
TA1307000166,6,9,true,9,4,-5,41.91386,-87.64877
13068,6,9,true,5,1,-4,41.91554,-87.68703
13179,6,9,true,34,40,6,41.9157,-87.63461
13133,6,9,true,6,1,-5,41.91598,-87.67733
TA1309000006,6,9,true,6,2,-4,41.91809,-87.64375
13146,6,9,true,26,22,-4,41.91831,-87.63629
13059,6,9,true,14,15,1,41.91845,-87.65222
13192,6,9,true,7,9,2,41.91995,-87.64884
TA1309000033,6,9,true,6,6,0,41.92158,-87.65381
13193,6,9,true,16,24,8,41.92182,-87.64412
13191,6,9,true,9,8,-1,41.92217,-87.63891
LP-,6,9,true,9,7,-2,41.92396,-87.63584
TA1307000001,6,9,true,11,5,-6,41.92535,-87.66581
TA1306000026,6,9,true,5,6,1,41.92558,-87.65842
TA1306000016,6,9,true,11,8,-3,41.9256,-87.65371
TA1309000019,6,9,true,13,10,-3,41.92586,-87.63897
TA1309000058,6,9,true,18,25,7,41.92591,-87.64927
TA1308000001,6,9,true,16,15,-1,41.92627,-87.63086
TA1309000023,6,9,true,11,6,-5,41.9287,-87.65383
TA1309000059,6,9,true,8,3,-5,41.92889,-87.65898
TA1309000061,6,9,true,9,7,-2,41.92915,-87.64909
TA1305000014,6,9,true,12,13,1,41.92956,-87.64313
TA1307000142,6,9,true,20,13,-7,41.93125,-87.64432
13276,6,9,true,18,5,-13,41.93132,-87.63874
TA1307000064,6,9,true,11,6,-5,41.93222,-87.65864
TA1306000014,6,9,true,8,12,4,41.93242,-87.65271
TA1309000039,6,9,true,18,9,-9,41.93258,-87.63642
TA1309000036,6,9,true,7,5,-2,41.93313,-87.64776
TA1307000006,6,9,true,4,11,7,41.93571,-87.6636
13268,6,9,true,8,7,-1,41.93588,-87.67843
TA1307000052,6,9,true,10,8,-2,41.93628,-87.65266
TA1307000136,6,9,true,8,5,-3,41.9365,-87.64755
TA1307000041,6,9,true,19,16,-3,41.93669,-87.63683
13137,6,9,true,22,22,0,41.9376,-87.6441
TA1309000042,6,9,true,2,5,3,41.93937,-87.66836
13229,6,9,true,5,2,-3,41.93946,-87.66376
TA1308000019,6,9,true,8,12,4,41.93973,-87.65886
13277,6,9,true,21,10,-11,41.9401,-87.64546
TA1307000134,6,9,true,7,5,-2,41.94016,-87.65303
TA1309000049,6,9,true,16,12,-4,41.94077,-87.63919
TA1307000138,6,9,true,8,8,0,41.94334,-87.67094
TA1309000025,6,9,true,6,16,10,41.94368,-87.64894
13071,6,9,true,13,6,-7,41.94373,-87.66401
632,6,9,true,5,7,2,41.94453,-87.6547
15632,6,9,true,1,5,4,41.94664,-87.69463
13235,6,9,true,9,12,3,41.94814,-87.66396
13325,6,9,true,11,8,-3,41.94907,-87.64863
TA1307000126,6,9,true,6,7,1,41.94936,-87.65451
TA1307000150,6,9,true,21,12,-9,41.94945,-87.64646
TA1307000127,6,9,true,5,5,0,41.9508,-87.65918
13323,6,9,true,6,5,-1,41.95282,-87.65
13063,6,9,true,4,9,5,41.95424,-87.65441
TA1308000022,6,9,true,17,8,-9,41.95438,-87.64805
TA1309000026,6,9,true,3,6,3,41.95601,-87.6802
13379,6,9,true,15,3,-12,41.95786,-87.6495
TA1309000027,6,9,true,11,4,-7,41.9585,-87.65499
13389,6,9,true,6,9,3,41.961,-87.64958
TA1307000144,6,9,true,5,4,-1,41.96142,-87.6762
TA1309000021,6,9,true,2,5,3,41.9615,-87.6714
TA1307000107,6,9,true,11,5,-6,41.96164,-87.65464
TA1307000156,6,9,true,3,5,2,41.96301,-87.68479
TA1309000012,6,9,true,7,1,-6,41.96325,-87.67928
TA1308000012,6,9,true,6,28,22,41.96398,-87.63818
13074,6,9,true,4,6,2,41.96521,-87.6582
639,6,9,true,6,11,5,41.96584,-87.64538
TA1309000014,6,9,true,8,5,-3,41.96709,-87.66744
TA1307000158,6,9,true,8,4,-4,41.9671,-87.67904
TA1309000066,6,9,true,7,6,-1,41.9691,-87.67423
TA1309000041,6,9,true,5,3,-2,41.96951,-87.65471
KA1504000171,6,9,true,8,3,-5,41.97161,-87.65016
TA1309000035,6,9,true,4,5,1,41.97335,-87.66785
13108,6,9,true,6,5,-1,41.97379,-87.65971
KA1504000149,6,9,true,2,5,3,41.97562,-87.67945
KA1504000146,6,9,true,2,7,5,41.978,-87.66805
13109,6,9,true,9,4,-5,41.97835,-87.65976
KA1504000152,6,9,true,14,7,-7,41.98403,-87.65231
RP-009,6,9,true,4,5,1,42.00107,-87.66122
15491,6,10,false,6,3,-3,41.78096,-87.57624
KA1503000014,6,10,false,7,2,-5,41.7851,-87.60108
KA1503000074,6,10,false,2,9,7,41.79174,-87.58395
TA1308000009,6,10,false,16,5,-11,41.79522,-87.58075
TA1307000164,6,10,false,5,3,-2,41.79527,-87.59647
KA1503000059,6,10,false,5,2,-3,41.79952,-87.58643
KA1503000004,6,10,false,5,4,-1,41.83127,-87.6088
TA1307000048,6,10,false,10,8,-2,41.83855,-87.60821
13075,6,10,false,4,6,2,41.8531,-87.63192
15545,6,10,false,7,14,7,41.85627,-87.61334
13102,6,10,false,13,3,-10,41.85762,-87.61942
13150,6,10,false,6,3,-3,41.85783,-87.62455
13163,6,10,false,7,1,-6,41.85808,-87.65108
SL-012,6,10,false,9,3,-6,41.86038,-87.62581
TA1307000124,6,10,false,7,4,-3,41.86411,-87.62372
TA1309000001,6,10,false,6,1,-5,41.86488,-87.64708
13431,6,10,false,9,11,2,41.8661,-87.60728
TA1305000002,6,10,false,15,12,-3,41.86721,-87.62597
15544,6,10,false,22,50,28,41.86723,-87.61536
KA1706005007,6,10,false,5,2,-3,41.86749,-87.63219
SL-005,6,10,false,46,26,-20,41.8679,-87.62304
13160,6,10,false,5,2,-3,41.86947,-87.65548
TA1309000010,6,10,false,16,3,-13,41.87074,-87.62574
SL-008,6,10,false,13,10,-3,41.87209,-87.62956
13332,6,10,false,7,3,-4,41.87219,-87.6615
SL-011,6,10,false,16,4,-12,41.87256,-87.63356
623,6,10,false,26,16,-10,41.87272,-87.62399
SL-007,6,10,false,7,14,7,41.87404,-87.6277
15541,6,10,false,16,16,0,41.8758,-87.62086
TA1305000010,6,10,false,8,2,-6,41.87623,-87.62444
13158,6,10,false,11,6,-5,41.87764,-87.64957
13157,6,10,false,8,2,-6,41.87773,-87.6548
TA1305000025,6,10,false,7,5,-2,41.87773,-87.63528
TA1309000002,6,10,false,5,8,3,41.87784,-87.62408
TA1309000004,6,10,false,19,7,-12,41.87811,-87.63184
638,6,10,false,4,10,6,41.87827,-87.64078
13011,6,10,false,6,4,-2,41.87931,-87.63993
KA1503000034,6,10,false,6,2,-4,41.87938,-87.63197
KA1503000015,6,10,false,5,11,6,41.87948,-87.6257
WL-011,6,10,false,7,5,-2,41.88034,-87.64273
13156,6,10,false,9,3,-6,41.88042,-87.65554
13300,6,10,false,49,26,-23,41.88097,-87.61675
13008,6,10,false,31,44,13,41.88105,-87.62408
TA1305000006,6,10,false,19,8,-11,41.88122,-87.6296
13056,6,10,false,8,5,-3,41.88168,-87.63951
TA1307000120,6,10,false,15,17,2,41.88188,-87.64879
13341,6,10,false,6,4,-2,41.88208,-87.63985
13036,6,10,false,10,8,-2,41.8821,-87.62513
TA1305000032,6,10,false,18,9,-9,41.88218,-87.64109
13006,6,10,false,8,3,-5,41.88268,-87.63252
13353,6,10,false,4,7,3,41.88283,-87.6612
WL-012,6,10,false,4,7,3,41.88337,-87.6412
13053,6,10,false,8,13,5,41.88365,-87.64863
13001,6,10,false,15,15,0,41.88397,-87.62459
13155,6,10,false,5,2,-3,41.88407,-87.65689
18062,6,10,false,7,2,-5,41.88412,-87.65427
TA1306000010,6,10,false,15,7,-8,41.88419,-87.62961
TA1305000030,6,10,false,6,1,-5,41.88459,-87.63178
15535,6,10,false,16,14,-2,41.8846,-87.64455
TA1305000029,6,10,false,15,4,-11,41.88466,-87.62787
13263,6,10,false,8,6,-2,41.88467,-87.61952
TA1306000015,6,10,false,4,13,9,41.88549,-87.65232
13021,6,10,false,8,6,-2,41.88559,-87.64184
TA1307000111,6,10,false,5,4,-1,41.88582,-87.63548
KA1503000012,6,10,false,13,15,2,41.88599,-87.63089
TA1305000011,6,10,false,31,19,-12,41.886,-87.62418
15534,6,10,false,6,1,-5,41.88627,-87.61749
TA1308000029,6,10,false,14,10,-4,41.88673,-87.62225
TA1307000131,6,10,false,10,11,1,41.88688,-87.62606
KA1503000064,6,10,false,40,28,-12,41.88697,-87.61281
TA1305000022,6,10,false,17,2,-15,41.88817,-87.63656
TA1306000003,6,10,false,9,9,0,41.88867,-87.64442
KA1503000043,6,10,false,18,14,-4,41.88918,-87.63851
13050,6,10,false,17,14,-3,41.88919,-87.62775
13432,6,10,false,1,7,6,41.88989,-87.67149
TA1307000151,6,10,false,12,14,2,41.88993,-87.63427
636,6,10,false,5,2,-3,41.88997,-87.63662
KA1503000044,6,10,false,14,4,-10,41.89018,-87.6262
13427,6,10,false,9,8,-1,41.89054,-87.62205
13430,6,10,false,16,13,-3,41.89077,-87.63169
TA1306000013,6,10,false,20,7,-13,41.89083,-87.61852
RN-,6,10,false,7,8,1,41.89102,-87.63546
TA1308000006,6,10,false,6,1,-5,41.89128,-87.67686
TA1307000117,6,10,false,16,17,1,41.89144,-87.62675
13033,6,10,false,8,5,-3,41.8916,-87.64835
TA1305000003,6,10,false,14,8,-6,41.89187,-87.62061
13022,6,10,false,105,94,-11,41.89227,-87.61205
TA1306000029,6,10,false,12,11,-1,41.89256,-87.61449
13265,6,10,false,10,8,-2,41.89383,-87.64172
13045,6,10,false,24,16,-8,41.89403,-87.62931
13016,6,10,false,18,15,-3,41.89431,-87.62277
KA1503000041,6,10,false,27,5,-22,41.89452,-87.61798
13196,6,10,false,10,4,-6,41.89455,-87.65345
TA1307000062,6,10,false,12,1,-11,41.89466,-87.63839
TA1306000012,6,10,false,18,21,3,41.89475,-87.63438
KP1705001026,6,10,false,8,7,-1,41.89483,-87.6323
13132,6,10,false,8,3,-5,41.89573,-87.67718
15530,6,10,false,12,20,8,41.89575,-87.62596
18003,6,10,false,8,2,-6,41.89575,-87.62011
13247,6,10,false,5,8,3,41.89597,-87.66775
TA1305000020,6,10,false,12,3,-9,41.89636,-87.65406
13289,6,10,false,8,4,-4,41.89638,-87.661
13303,6,10,false,9,4,-5,41.89672,-87.63088
13017,6,10,false,10,6,-4,41.89676,-87.6357
13338,6,10,false,8,11,3,41.89697,-87.62173
TA1307000061,6,10,false,20,5,-15,41.89745,-87.62873
13034,6,10,false,8,8,0,41.89754,-87.62352
TA1306000009,6,10,false,6,6,0,41.89772,-87.64299
620,6,10,false,7,4,-3,41.89817,-87.63754
15529,6,10,false,11,7,-4,41.89858,-87.62206
TA1307000128,6,10,false,22,15,-7,41.89896,-87.6299
KA1504000116,6,10,false,8,4,-4,41.90023,-87.64299
13290,6,10,false,6,4,-2,41.90069,-87.66259
13042,6,10,false,40,52,12,41.90097,-87.62377
TA1307000070,6,10,false,6,3,-3,41.90133,-87.67742
KA1504000133,6,10,false,16,10,-6,41.90234,-87.62773
TA1306000006,6,10,false,5,2,-3,41.90292,-87.63772
TA1307000039,6,10,false,40,23,-17,41.90294,-87.63137
TA1305000034,6,10,false,5,5,0,41.90313,-87.67391
KA1504000135,6,10,false,14,22,8,41.90319,-87.63439
13136,6,10,false,4,5,1,41.90326,-87.67845
13061,6,10,false,17,15,-2,41.90342,-87.66779
KA1504000079,6,10,false,7,1,-6,41.9035,-87.64334
TA1308000049,6,10,false,11,14,3,41.90672,-87.6349
KA1504000134,6,10,false,8,4,-4,41.90687,-87.6262
13224,6,10,false,8,3,-5,41.90706,-87.66725
TA1307000143,6,10,false,6,5,-1,41.90762,-87.63854
13221,6,10,false,10,8,-2,41.90765,-87.67254
TA1309000024,6,10,false,7,13,6,41.908,-87.63152
TA1305000041,6,10,false,11,13,2,41.9094,-87.67769
331,6,10,false,11,10,-1,41.90965,-87.64812
TA1305000037,6,10,false,11,6,-5,41.91018,-87.67003
TA1306000008,6,10,false,6,3,-3,41.9102,-87.6435
TA1308000005,6,10,false,6,3,-3,41.91042,-87.68238
13257,6,10,false,7,1,-6,41.91054,-87.68956
13154,6,10,false,6,11,5,41.91054,-87.65312
13058,6,10,false,9,9,0,41.91059,-87.64942
TA1307000038,6,10,false,12,5,-7,41.91138,-87.63868
LF-005,6,10,false,52,57,5,41.91172,-87.62681
13128,6,10,false,22,12,-10,41.91197,-87.63197
TA1308000050,6,10,false,44,44,0,41.91211,-87.6347
13243,6,10,false,13,10,-3,41.91262,-87.6814
TA1306000032,6,10,false,6,2,-4,41.9137,-87.65285
TA1307000166,6,10,false,6,1,-5,41.91386,-87.64877
15655,6,10,false,6,1,-5,41.91401,-87.70514
18067,6,10,false,9,3,-6,41.9146,-87.66796
TA1306000007,6,10,false,15,2,-13,41.91469,-87.64333
13068,6,10,false,6,5,-1,41.91554,-87.68703
13179,6,10,false,47,52,5,41.9157,-87.63461
13133,6,10,false,4,5,1,41.91598,-87.67733
15651,6,10,false,6,1,-5,41.91752,-87.70181
13266,6,10,false,5,3,-2,41.91774,-87.69142
TA1309000029,6,10,false,8,2,-6,41.9178,-87.68245
TA1307000163,6,10,false,14,1,-13,41.91821,-87.65696
13146,6,10,false,33,59,26,41.91831,-87.63629
13059,6,10,false,14,15,1,41.91845,-87.65222
13192,6,10,false,10,20,10,41.91995,-87.64884
13288,6,10,false,6,1,-5,41.92008,-87.67788
TA1309000033,6,10,false,8,15,7,41.92158,-87.65381
13193,6,10,false,21,18,-3,41.92182,-87.64412
13191,6,10,false,9,9,0,41.92217,-87.63891
13084,6,10,false,2,7,5,41.92268,-87.69715
LP-,6,10,false,18,28,10,41.92396,-87.63584
TA1307000001,6,10,false,16,4,-12,41.92535,-87.66581
TA1306000026,6,10,false,8,8,0,41.92558,-87.65842
TA1306000016,6,10,false,5,3,-2,41.9256,-87.65371
TA1309000019,6,10,false,24,7,-17,41.92586,-87.63897
TA1309000058,6,10,false,14,10,-4,41.92591,-87.64927
TA1308000001,6,10,false,26,42,16,41.92627,-87.63086
13124,6,10,false,7,4,-3,41.92675,-87.63444
TA1309000023,6,10,false,10,9,-1,41.9287,-87.65383
TA1307000113,6,10,false,7,2,-5,41.92878,-87.66391
TA1309000059,6,10,false,7,6,-1,41.92889,-87.65898
TA1309000061,6,10,false,12,11,-1,41.92915,-87.64909
TA1305000014,6,10,false,14,14,0,41.92956,-87.64313
13085,6,10,false,10,5,-5,41.92958,-87.70789
15643,6,10,false,7,3,-4,41.93057,-87.7238
TA1307000142,6,10,false,24,11,-13,41.93125,-87.64432
13276,6,10,false,12,8,-4,41.93132,-87.63874
TA1307000064,6,10,false,13,5,-8,41.93222,-87.65864
TA1306000014,6,10,false,16,7,-9,41.93242,-87.65271
TA1309000039,6,10,false,35,12,-23,41.93258,-87.63642
TA1309000036,6,10,false,16,7,-9,41.93313,-87.64776
TA1307000006,6,10,false,8,4,-4,41.93571,-87.6636
13268,6,10,false,6,3,-3,41.93588,-87.67843
13269,6,10,false,10,4,-6,41.93609,-87.66983
TA1307000052,6,10,false,11,13,2,41.93628,-87.65266
TA1307000136,6,10,false,7,8,1,41.9365,-87.64755
TA1307000041,6,10,false,19,12,-7,41.93669,-87.63683
13137,6,10,false,35,24,-11,41.9376,-87.6441
TA1309000042,6,10,false,8,3,-5,41.93937,-87.66836
13229,6,10,false,5,5,0,41.93946,-87.66376
TA1308000019,6,10,false,8,4,-4,41.93973,-87.65886
13277,6,10,false,5,5,0,41.9401,-87.64546
TA1307000134,6,10,false,12,27,15,41.94016,-87.65303
13143,6,10,false,7,6,-1,41.94059,-87.67853
TA1309000049,6,10,false,26,26,0,41.94077,-87.63919
TA1307000138,6,10,false,6,4,-2,41.94334,-87.67094
TA1309000025,6,10,false,9,4,-5,41.94368,-87.64894
13071,6,10,false,8,13,5,41.94373,-87.66401
632,6,10,false,13,18,5,41.94453,-87.6547
13278,6,10,false,15,17,2,41.94553,-87.64644
13235,6,10,false,7,5,-2,41.94814,-87.66396
13325,6,10,false,7,4,-3,41.94907,-87.64863
TA1307000126,6,10,false,14,14,0,41.94936,-87.65451
TA1307000150,6,10,false,20,5,-15,41.94945,-87.64646
13319,6,10,false,9,10,1,41.95069,-87.6687
TA1307000127,6,10,false,14,10,-4,41.9508,-87.65918
13323,6,10,false,5,6,1,41.95282,-87.65
TA1309000043,6,10,false,5,4,-1,41.95417,-87.66434
13063,6,10,false,7,6,-1,41.95424,-87.65441
TA1308000022,6,10,false,18,6,-12,41.95438,-87.64805
13379,6,10,false,8,5,-3,41.95786,-87.6495
TA1309000027,6,10,false,5,2,-3,41.9585,-87.65499
13389,6,10,false,8,6,-2,41.961,-87.64958
TA1307000107,6,10,false,11,7,-4,41.96164,-87.65464
TA1308000012,6,10,false,11,18,7,41.96398,-87.63818
639,6,10,false,16,13,-3,41.96584,-87.64538
TA1309000014,6,10,false,8,7,-1,41.96709,-87.66744
TA1307000119,6,10,false,5,6,1,41.96796,-87.65
TA1309000066,6,10,false,5,4,-1,41.9691,-87.67423
KA1504000171,6,10,false,13,9,-4,41.97161,-87.65016
TA1309000035,6,10,false,5,3,-2,41.97335,-87.66785
KA1504000146,6,10,false,2,7,5,41.978,-87.66805
KA1504000151,6,10,false,1,7,6,41.98359,-87.66916
KA1504000152,6,10,false,18,15,-3,41.98403,-87.65231
E002,6,10,false,5,3,-2,42.03256,-87.67912
KA1503000014,6,10,true,5,6,1,41.7851,-87.60108
KA1504000076,6,10,true,6,2,-4,41.7943,-87.60145
TA1308000009,6,10,true,5,4,-1,41.79522,-87.58075
TA1307000164,6,10,true,6,4,-2,41.79527,-87.59647
KA1503000052,6,10,true,5,5,0,41.79935,-87.60097
KA1503000059,6,10,true,7,2,-5,41.79952,-87.58643
TA1309000037,6,10,true,5,4,-1,41.79957,-87.59474
KA1503000007,6,10,true,2,6,4,41.80242,-87.58689
TA1308000043,6,10,true,2,5,3,41.83066,-87.64715
13217,6,10,true,6,4,-2,41.83488,-87.61792
TA1307000048,6,10,true,6,9,3,41.83855,-87.60821
TA1307000139,6,10,true,7,1,-6,41.84205,-87.61698
13091,6,10,true,5,3,-2,41.85409,-87.68585
15545,6,10,true,13,17,4,41.85627,-87.61334
13102,6,10,true,16,9,-7,41.85762,-87.61942
13164,6,10,true,5,1,-4,41.85818,-87.65648
SL-012,6,10,true,6,9,3,41.86038,-87.62581
TA1306000002,6,10,true,7,4,-3,41.86238,-87.65108
TA1307000124,6,10,true,21,8,-13,41.86411,-87.62372
13431,6,10,true,5,5,0,41.8661,-87.60728
TA1305000002,6,10,true,19,10,-9,41.86721,-87.62597
15544,6,10,true,6,3,-3,41.86723,-87.61536
KA1706005007,6,10,true,4,6,2,41.86749,-87.63219
SL-005,6,10,true,19,16,-3,41.8679,-87.62304
13139,6,10,true,2,6,4,41.86893,-87.65913
13160,6,10,true,9,4,-5,41.86947,-87.65548
15550,6,10,true,5,5,0,41.87024,-87.63947
TA1309000010,6,10,true,21,8,-13,41.87074,-87.62574
SL-009,6,10,true,5,3,-2,41.87081,-87.63121
TA1307000121,6,10,true,1,9,8,41.87184,-87.64664
SL-008,6,10,true,12,15,3,41.87209,-87.62956
13332,6,10,true,11,7,-4,41.87219,-87.6615
SL-011,6,10,true,8,2,-6,41.87256,-87.63356
623,6,10,true,6,3,-3,41.87272,-87.62399
KA1504000104,6,10,true,5,5,0,41.87296,-87.66912
SL-010,6,10,true,5,2,-3,41.87501,-87.63309
15539,6,10,true,8,2,-6,41.87763,-87.64405
13158,6,10,true,17,11,-6,41.87764,-87.64957
13157,6,10,true,13,7,-6,41.87773,-87.6548
TA1305000025,6,10,true,7,1,-6,41.87773,-87.63528
13206,6,10,true,7,1,-6,41.87794,-87.66201
638,6,10,true,6,10,4,41.87827,-87.64078
13011,6,10,true,8,11,3,41.87931,-87.63993
KA1503000015,6,10,true,5,8,3,41.87948,-87.6257
WL-011,6,10,true,11,4,-7,41.88034,-87.64273
13156,6,10,true,5,11,6,41.88042,-87.65554
13300,6,10,true,17,29,12,41.88097,-87.61675
13008,6,10,true,8,9,1,41.88105,-87.62408
TA1305000006,6,10,true,5,5,0,41.88122,-87.6296
TA1307000120,6,10,true,17,18,1,41.88188,-87.64879
13341,6,10,true,2,11,9,41.88208,-87.63985
13036,6,10,true,4,5,1,41.8821,-87.62513
TA1305000032,6,10,true,12,14,2,41.88218,-87.64109
13353,6,10,true,6,3,-3,41.88283,-87.6612
654,6,10,true,4,6,2,41.88307,-87.65698
13409,6,10,true,9,8,-1,41.8831,-87.6511
WL-012,6,10,true,3,6,3,41.88337,-87.6412
13053,6,10,true,7,13,6,41.88365,-87.64863
13001,6,10,true,10,6,-4,41.88397,-87.62459
13155,6,10,true,11,3,-8,41.88407,-87.65689
TA1306000010,6,10,true,4,12,8,41.88419,-87.62961
TA1305000030,6,10,true,1,5,4,41.88459,-87.63178
15535,6,10,true,12,9,-3,41.8846,-87.64455
TA1305000029,6,10,true,9,13,4,41.88466,-87.62787
13263,6,10,true,7,9,2,41.88467,-87.61952
TA1306000015,6,10,true,7,12,5,41.88549,-87.65232
13021,6,10,true,7,7,0,41.88559,-87.64184
TA1307000111,6,10,true,7,3,-4,41.88582,-87.63548
KA1503000012,6,10,true,6,4,-2,41.88599,-87.63089
TA1305000011,6,10,true,4,5,1,41.886,-87.62418
15534,6,10,true,7,6,-1,41.88627,-87.61749
13197,6,10,true,6,2,-4,41.8866,-87.65816
TA1308000029,6,10,true,10,2,-8,41.88673,-87.62225
KA1503000064,6,10,true,3,12,9,41.88697,-87.61281
TA1305000022,6,10,true,12,6,-6,41.88817,-87.63656
TA1306000003,6,10,true,11,7,-4,41.88867,-87.64442
KA1503000043,6,10,true,31,36,5,41.88918,-87.63851
13050,6,10,true,8,10,2,41.88919,-87.62775
TA1307000151,6,10,true,8,11,3,41.88993,-87.63427
636,6,10,true,3,7,4,41.88997,-87.63662
13427,6,10,true,5,3,-2,41.89054,-87.62205
13430,6,10,true,8,10,2,41.89077,-87.63169
TA1306000013,6,10,true,12,7,-5,41.89083,-87.61852
RN-,6,10,true,5,7,2,41.89102,-87.63546
TA1308000006,6,10,true,3,6,3,41.89128,-87.67686
TA1307000117,6,10,true,16,15,-1,41.89144,-87.62675
TA1305000003,6,10,true,7,14,7,41.89187,-87.62061
13022,6,10,true,36,26,-10,41.89227,-87.61205
TA1306000029,6,10,true,15,15,0,41.89256,-87.61449
13265,6,10,true,21,8,-13,41.89383,-87.64172
13045,6,10,true,17,23,6,41.89403,-87.62931
13016,6,10,true,10,9,-1,41.89431,-87.62277
KA1503000041,6,10,true,17,9,-8,41.89452,-87.61798
TA1307000062,6,10,true,13,4,-9,41.89466,-87.63839
TA1306000012,6,10,true,18,15,-3,41.89475,-87.63438
KP1705001026,6,10,true,9,11,2,41.89483,-87.6323
637,6,10,true,5,6,1,41.89563,-87.67209
13132,6,10,true,7,9,2,41.89573,-87.67718
15530,6,10,true,8,10,2,41.89575,-87.62596
18003,6,10,true,8,4,-4,41.89575,-87.62011
13247,6,10,true,12,3,-9,41.89597,-87.66775
TA1305000020,6,10,true,5,6,1,41.89636,-87.65406
13289,6,10,true,6,3,-3,41.89638,-87.661
13303,6,10,true,4,6,2,41.89672,-87.63088
13017,6,10,true,9,16,7,41.89676,-87.6357
13338,6,10,true,6,3,-3,41.89697,-87.62173
TA1307000061,6,10,true,8,3,-5,41.89745,-87.62873
TA1306000009,6,10,true,9,4,-5,41.89772,-87.64299
620,6,10,true,8,11,3,41.89817,-87.63754
KA1504000103,6,10,true,5,2,-3,41.89842,-87.68659
15529,6,10,true,10,7,-3,41.89858,-87.62206
TA1307000128,6,10,true,18,16,-2,41.89896,-87.6299
13248,6,10,true,9,11,2,41.89964,-87.66788
TA1306000011,6,10,true,4,6,2,41.89994,-87.63443
KA1504000116,6,10,true,11,10,-1,41.90023,-87.64299
13290,6,10,true,6,6,0,41.90069,-87.66259
13042,6,10,true,24,29,5,41.90097,-87.62377
TA1307000070,6,10,true,11,1,-10,41.90133,-87.67742
KA1504000133,6,10,true,11,13,2,41.90234,-87.62773
TA1306000006,6,10,true,5,5,0,41.90292,-87.63772
TA1307000039,6,10,true,29,45,16,41.90294,-87.63137
TA1305000034,6,10,true,5,5,0,41.90313,-87.67391
KA1504000135,6,10,true,28,21,-7,41.90319,-87.63439
13136,6,10,true,5,6,1,41.90326,-87.67845
13061,6,10,true,18,17,-1,41.90342,-87.66779
KA1504000079,6,10,true,10,13,3,41.9035,-87.64334
TA1307000115,6,10,true,3,6,3,41.9046,-87.64056
TA1308000049,6,10,true,9,9,0,41.90672,-87.6349
KA1504000134,6,10,true,5,6,1,41.90687,-87.6262
13224,6,10,true,12,2,-10,41.90706,-87.66725
TA1307000143,6,10,true,5,4,-1,41.90762,-87.63854
13221,6,10,true,12,12,0,41.90765,-87.67254
TA1309000024,6,10,true,13,9,-4,41.908,-87.63152
331,6,10,true,12,19,7,41.90965,-87.64812
TA1305000037,6,10,true,6,9,3,41.91018,-87.67003
TA1306000008,6,10,true,8,6,-2,41.9102,-87.6435
TA1308000005,6,10,true,9,2,-7,41.91042,-87.68238
13154,6,10,true,16,13,-3,41.91054,-87.65312
13058,6,10,true,4,7,3,41.91059,-87.64942
TA1307000038,6,10,true,8,12,4,41.91138,-87.63868
LF-005,6,10,true,28,34,6,41.91172,-87.62681
13128,6,10,true,8,20,12,41.91197,-87.63197
TA1308000050,6,10,true,38,51,13,41.91211,-87.6347
13243,6,10,true,5,13,8,41.91262,-87.6814
TA1306000032,6,10,true,15,16,1,41.9137,-87.65285
TA1307000166,6,10,true,11,10,-1,41.91386,-87.64877
18067,6,10,true,3,9,6,41.9146,-87.66796
TA1306000007,6,10,true,11,5,-6,41.91469,-87.64333
13068,6,10,true,8,6,-2,41.91554,-87.68703
13179,6,10,true,49,48,-1,41.9157,-87.63461
13133,6,10,true,8,12,4,41.91598,-87.67733
TA1305000039,6,10,true,5,8,3,41.9163,-87.66749
13266,6,10,true,7,1,-6,41.91774,-87.69142
TA1309000029,6,10,true,5,1,-4,41.9178,-87.68245
TA1307000163,6,10,true,8,9,1,41.91821,-87.65696
13146,6,10,true,29,27,-2,41.91831,-87.63629
13059,6,10,true,25,15,-10,41.91845,-87.65222
13192,6,10,true,12,18,6,41.91995,-87.64884
13242,6,10,true,5,6,1,41.92021,-87.69266
TA1309000030,6,10,true,7,12,5,41.92077,-87.66372
13292,6,10,true,6,2,-4,41.92152,-87.70733
TA1309000033,6,10,true,7,11,4,41.92158,-87.65381
13193,6,10,true,21,17,-4,41.92182,-87.64412
13191,6,10,true,15,5,-10,41.92217,-87.63891
LP-,6,10,true,12,11,-1,41.92396,-87.63584
KA1504000140,6,10,true,5,1,-4,41.92409,-87.67646
KA1504000090,6,10,true,1,5,4,41.92483,-87.7145
TA1307000001,6,10,true,10,8,-2,41.92535,-87.66581
TA1306000026,6,10,true,13,9,-4,41.92558,-87.65842
TA1306000016,6,10,true,13,13,0,41.9256,-87.65371
TA1309000019,6,10,true,13,14,1,41.92586,-87.63897
TA1309000058,6,10,true,29,17,-12,41.92591,-87.64927
TA1308000001,6,10,true,23,25,2,41.92627,-87.63086
13124,6,10,true,5,3,-2,41.92675,-87.63444
TA1309000023,6,10,true,6,14,8,41.9287,-87.65383
TA1307000113,6,10,true,7,5,-2,41.92878,-87.66391
TA1309000059,6,10,true,14,5,-9,41.92889,-87.65898
TA1309000061,6,10,true,7,12,5,41.92915,-87.64909
TA1305000014,6,10,true,21,13,-8,41.92956,-87.64313
13085,6,10,true,6,6,0,41.92958,-87.70789
TA1307000142,6,10,true,24,15,-9,41.93125,-87.64432
13276,6,10,true,12,13,1,41.93132,-87.63874
TA1307000064,6,10,true,13,10,-3,41.93222,-87.65864
TA1306000014,6,10,true,16,10,-6,41.93242,-87.65271
TA1309000039,6,10,true,17,10,-7,41.93258,-87.63642
13294,6,10,true,5,2,-3,41.9326,-87.66595
TA1309000036,6,10,true,10,10,0,41.93313,-87.64776
TA1307000006,6,10,true,7,8,1,41.93571,-87.6636
13269,6,10,true,2,6,4,41.93609,-87.66983
TA1307000052,6,10,true,8,12,4,41.93628,-87.65266
TA1307000136,6,10,true,14,19,5,41.9365,-87.64755
TA1307000041,6,10,true,8,11,3,41.93669,-87.63683
13137,6,10,true,31,22,-9,41.9376,-87.6441
TA1309000042,6,10,true,7,12,5,41.93937,-87.66836
13229,6,10,true,6,6,0,41.93946,-87.66376
TA1308000019,6,10,true,5,9,4,41.93973,-87.65886
13277,6,10,true,6,12,6,41.9401,-87.64546
TA1307000134,6,10,true,22,21,-1,41.94016,-87.65303
TA1309000049,6,10,true,10,13,3,41.94077,-87.63919
TA1307000138,6,10,true,5,4,-1,41.94334,-87.67094
13144,6,10,true,6,2,-4,41.9434,-87.67964
TA1309000025,6,10,true,18,17,-1,41.94368,-87.64894
13071,6,10,true,14,17,3,41.94373,-87.66401
632,6,10,true,9,13,4,41.94453,-87.6547
13278,6,10,true,15,6,-9,41.94553,-87.64644
13235,6,10,true,9,16,7,41.94814,-87.66396
13325,6,10,true,12,17,5,41.94907,-87.64863
TA1307000126,6,10,true,13,4,-9,41.94936,-87.65451
TA1307000150,6,10,true,24,7,-17,41.94945,-87.64646
13319,6,10,true,11,4,-7,41.95069,-87.6687
TA1307000127,6,10,true,8,6,-2,41.9508,-87.65918
13323,6,10,true,8,12,4,41.95282,-87.65
TA1309000043,6,10,true,5,3,-2,41.95417,-87.66434
13063,6,10,true,7,4,-3,41.95424,-87.65441
TA1308000022,6,10,true,10,10,0,41.95438,-87.64805
TA1309000026,6,10,true,7,5,-2,41.95601,-87.6802
13379,6,10,true,7,2,-5,41.95786,-87.6495
TA1309000027,6,10,true,9,8,-1,41.9585,-87.65499
13389,6,10,true,17,13,-4,41.961,-87.64958
15622,6,10,true,6,6,0,41.96108,-87.69544
TA1307000144,6,10,true,1,5,4,41.96142,-87.6762
TA1309000021,6,10,true,5,5,0,41.9615,-87.6714
KA1503000022,6,10,true,6,3,-3,41.96158,-87.66609
TA1307000107,6,10,true,12,11,-1,41.96164,-87.65464
TA1307000156,6,10,true,2,7,5,41.96301,-87.68479
TA1308000012,6,10,true,8,17,9,41.96398,-87.63818
13074,6,10,true,7,7,0,41.96521,-87.6582
639,6,10,true,9,7,-2,41.96584,-87.64538
TA1307000140,6,10,true,5,6,1,41.96643,-87.68865
TA1309000014,6,10,true,10,3,-7,41.96709,-87.66744
TA1307000158,6,10,true,5,7,2,41.9671,-87.67904
TA1307000119,6,10,true,4,5,1,41.96796,-87.65
TA1309000066,6,10,true,7,9,2,41.9691,-87.67423
KA1504000171,6,10,true,12,12,0,41.97161,-87.65016
TA1309000035,6,10,true,9,7,-2,41.97335,-87.66785
13108,6,10,true,1,5,4,41.97379,-87.65971
KA1504000146,6,10,true,9,10,1,41.978,-87.66805
KA1504000152,6,10,true,14,14,0,41.98403,-87.65231
15575,6,10,true,5,4,-1,41.98975,-87.66014
RP-009,6,10,true,5,2,-3,42.00107,-87.66122
520,6,10,true,6,2,-4,42.01597,-87.66859
596,6,10,true,5,3,-2,42.04822,-87.68348
KA1503000014,6,11,false,7,8,1,41.7851,-87.60108
KA1503000074,6,11,false,14,7,-7,41.79174,-87.58395
TA1308000009,6,11,false,13,18,5,41.79522,-87.58075
TA1307000164,6,11,false,11,1,-10,41.79527,-87.59647
KA1503000059,6,11,false,5,7,2,41.79952,-87.58643
TA1309000037,6,11,false,8,9,1,41.79957,-87.59474
TA1308000023,6,11,false,5,3,-2,41.81649,-87.60659
TA1308000038,6,11,false,3,5,2,41.82298,-87.6071
KA1503000004,6,11,false,7,3,-4,41.83127,-87.6088
TA1307000048,6,11,false,2,9,7,41.83855,-87.60821
TA1307000005,6,11,false,5,2,-3,41.84569,-87.6225
TA1305000004,6,11,false,5,7,2,41.8514,-87.61884
13075,6,11,false,9,14,5,41.8531,-87.63192
15545,6,11,false,12,22,10,41.85627,-87.61334
SL-013,6,11,false,22,3,-19,41.85659,-87.62755
13102,6,11,false,5,7,2,41.85762,-87.61942
SL-012,6,11,false,7,2,-5,41.86038,-87.62581
TA1307000124,6,11,false,17,8,-9,41.86411,-87.62372
TA1309000001,6,11,false,2,5,3,41.86488,-87.64708
13029,6,11,false,5,5,0,41.86531,-87.6179
13431,6,11,false,15,15,0,41.8661,-87.60728
TA1305000002,6,11,false,24,15,-9,41.86721,-87.62597
15544,6,11,false,44,36,-8,41.86723,-87.61536
KA1706005007,6,11,false,8,6,-2,41.86749,-87.63219
SL-005,6,11,false,46,32,-14,41.8679,-87.62304
TA1309000010,6,11,false,20,14,-6,41.87074,-87.62574
SL-009,6,11,false,6,4,-2,41.87081,-87.63121
TA1307000121,6,11,false,2,9,7,41.87184,-87.64664
SL-008,6,11,false,30,18,-12,41.87209,-87.62956
SL-011,6,11,false,19,17,-2,41.87256,-87.63356
623,6,11,false,22,10,-12,41.87272,-87.62399
SL-007,6,11,false,24,7,-17,41.87404,-87.6277
15541,6,11,false,42,17,-25,41.8758,-87.62086
13037,6,11,false,6,2,-4,41.87588,-87.64078
624,6,11,false,13,12,-1,41.87626,-87.62923
TA1305000035,6,11,false,9,6,-3,41.87716,-87.62787
13158,6,11,false,6,9,3,41.87764,-87.64957
13157,6,11,false,9,1,-8,41.87773,-87.6548
TA1305000025,6,11,false,12,13,1,41.87773,-87.63528
TA1309000002,6,11,false,10,7,-3,41.87784,-87.62408
TA1309000004,6,11,false,10,4,-6,41.87811,-87.63184
638,6,11,false,17,5,-12,41.87827,-87.64078
TA1305000005,6,11,false,8,7,-1,41.87924,-87.62975
13011,6,11,false,11,6,-5,41.87931,-87.63993
TA1309000008,6,11,false,5,2,-3,41.87933,-87.6355
KA1503000015,6,11,false,13,4,-9,41.87948,-87.6257
WL-011,6,11,false,8,2,-6,41.88034,-87.64273
13156,6,11,false,17,6,-11,41.88042,-87.65554
13300,6,11,false,96,95,-1,41.88097,-87.61675
13008,6,11,false,55,45,-10,41.88105,-87.62408
TA1305000006,6,11,false,16,5,-11,41.88122,-87.6296
TA1307000120,6,11,false,20,25,5,41.88188,-87.64879
13341,6,11,false,5,1,-4,41.88208,-87.63985
13036,6,11,false,7,4,-3,41.8821,-87.62513
TA1305000032,6,11,false,17,2,-15,41.88218,-87.64109
13006,6,11,false,2,6,4,41.88268,-87.63252
13409,6,11,false,3,7,4,41.8831,-87.6511
13053,6,11,false,27,30,3,41.88365,-87.64863
13001,6,11,false,17,19,2,41.88397,-87.62459
13155,6,11,false,4,6,2,41.88407,-87.65689
18062,6,11,false,8,8,0,41.88412,-87.65427
TA1306000010,6,11,false,13,4,-9,41.88419,-87.62961
TA1305000030,6,11,false,14,6,-8,41.88459,-87.63178
15535,6,11,false,12,10,-2,41.8846,-87.64455
TA1305000029,6,11,false,22,16,-6,41.88466,-87.62787
13263,6,11,false,19,16,-3,41.88467,-87.61952
TA1306000015,6,11,false,8,24,16,41.88549,-87.65232
13021,6,11,false,7,6,-1,41.88559,-87.64184
TA1307000111,6,11,false,10,7,-3,41.88582,-87.63548
KA1503000012,6,11,false,10,7,-3,41.88599,-87.63089
TA1305000011,6,11,false,20,22,2,41.886,-87.62418
15534,6,11,false,6,3,-3,41.88627,-87.61749
13197,6,11,false,1,5,4,41.8866,-87.65816
TA1308000029,6,11,false,16,5,-11,41.88673,-87.62225
TA1307000131,6,11,false,20,8,-12,41.88688,-87.62606
KA1503000064,6,11,false,43,42,-1,41.88697,-87.61281
TA1305000022,6,11,false,24,3,-21,41.88817,-87.63656
TA1306000003,6,11,false,9,8,-1,41.88867,-87.64442
KA1503000043,6,11,false,36,19,-17,41.88918,-87.63851
13050,6,11,false,24,24,0,41.88919,-87.62775
TA1307000151,6,11,false,22,19,-3,41.88993,-87.63427
636,6,11,false,13,14,1,41.88997,-87.63662
KA1503000044,6,11,false,5,3,-2,41.89018,-87.6262
13427,6,11,false,22,16,-6,41.89054,-87.62205
13430,6,11,false,18,24,6,41.89077,-87.63169
TA1306000013,6,11,false,23,22,-1,41.89083,-87.61852
RN-,6,11,false,13,11,-2,41.89102,-87.63546
TA1308000006,6,11,false,7,3,-4,41.89128,-87.67686
TA1307000117,6,11,false,18,27,9,41.89144,-87.62675
13033,6,11,false,14,11,-3,41.8916,-87.64835
13194,6,11,false,5,4,-1,41.8918,-87.65878
TA1305000003,6,11,false,22,17,-5,41.89187,-87.62061
13022,6,11,false,125,169,44,41.89227,-87.61205
TA1306000029,6,11,false,22,22,0,41.89256,-87.61449
13265,6,11,false,19,9,-10,41.89383,-87.64172
13045,6,11,false,26,23,-3,41.89403,-87.62931
13016,6,11,false,15,19,4,41.89431,-87.62277
KA1503000041,6,11,false,9,6,-3,41.89452,-87.61798
13196,6,11,false,5,4,-1,41.89455,-87.65345
TA1307000062,6,11,false,10,4,-6,41.89466,-87.63839
TA1306000012,6,11,false,29,28,-1,41.89475,-87.63438
KP1705001026,6,11,false,17,13,-4,41.89483,-87.6323
637,6,11,false,5,5,0,41.89563,-87.67209
13132,6,11,false,7,13,6,41.89573,-87.67718
15530,6,11,false,19,12,-7,41.89575,-87.62596
18003,6,11,false,12,3,-9,41.89575,-87.62011
13247,6,11,false,5,3,-2,41.89597,-87.66775
TA1305000020,6,11,false,15,5,-10,41.89636,-87.65406
13289,6,11,false,13,3,-10,41.89638,-87.661
13303,6,11,false,8,9,1,41.89672,-87.63088
13017,6,11,false,16,8,-8,41.89676,-87.6357
13338,6,11,false,11,6,-5,41.89697,-87.62173
TA1307000061,6,11,false,3,7,4,41.89745,-87.62873
13034,6,11,false,16,13,-3,41.89754,-87.62352
TA1306000009,6,11,false,7,6,-1,41.89772,-87.64299
620,6,11,false,7,8,1,41.89817,-87.63754
15529,6,11,false,14,11,-3,41.89858,-87.62206
TA1307000128,6,11,false,14,25,11,41.89896,-87.6299
657,6,11,false,5,1,-4,41.89918,-87.6722
KA1504000116,6,11,false,6,10,4,41.90023,-87.64299
13290,6,11,false,5,1,-4,41.90069,-87.66259
13042,6,11,false,98,99,1,41.90097,-87.62377
TA1307000070,6,11,false,9,2,-7,41.90133,-87.67742
KA1504000133,6,11,false,22,20,-2,41.90234,-87.62773
13241,6,11,false,9,2,-7,41.9029,-87.68731
TA1307000039,6,11,false,37,36,-1,41.90294,-87.63137
658,6,11,false,7,3,-4,41.903,-87.6838
TA1305000034,6,11,false,6,14,8,41.90313,-87.67391
KA1504000135,6,11,false,21,29,8,41.90319,-87.63439
13136,6,11,false,8,10,2,41.90326,-87.67845
13061,6,11,false,24,9,-15,41.90342,-87.66779
KA1504000079,6,11,false,5,7,2,41.9035,-87.64334
TA1308000049,6,11,false,23,41,18,41.90672,-87.6349
KA1504000134,6,11,false,13,30,17,41.90687,-87.6262
13224,6,11,false,12,3,-9,41.90706,-87.66725
TA1307000143,6,11,false,2,6,4,41.90762,-87.63854
13221,6,11,false,18,13,-5,41.90765,-87.67254
TA1309000024,6,11,false,16,23,7,41.908,-87.63152
TA1305000041,6,11,false,10,23,13,41.9094,-87.67769
331,6,11,false,18,13,-5,41.90965,-87.64812
TA1305000037,6,11,false,15,6,-9,41.91018,-87.67003
TA1306000008,6,11,false,6,3,-3,41.9102,-87.6435
TA1308000005,6,11,false,22,10,-12,41.91042,-87.68238
13154,6,11,false,12,5,-7,41.91054,-87.65312
13058,6,11,false,12,18,6,41.91059,-87.64942
TA1307000038,6,11,false,17,19,2,41.91138,-87.63868
LF-005,6,11,false,86,104,18,41.91172,-87.62681
13128,6,11,false,24,31,7,41.91197,-87.63197
TA1308000050,6,11,false,34,36,2,41.91211,-87.6347
13243,6,11,false,7,6,-1,41.91262,-87.6814
TA1306000032,6,11,false,14,11,-3,41.9137,-87.65285
TA1307000166,6,11,false,7,9,2,41.91386,-87.64877
15655,6,11,false,5,1,-4,41.91401,-87.70514
18067,6,11,false,9,7,-2,41.9146,-87.66796
13068,6,11,false,18,6,-12,41.91554,-87.68703
13179,6,11,false,100,105,5,41.9157,-87.63461
13133,6,11,false,14,7,-7,41.91598,-87.67733
TA1305000039,6,11,false,7,2,-5,41.9163,-87.66749
15650,6,11,false,5,5,0,41.91711,-87.71023
TA1309000029,6,11,false,5,1,-4,41.9178,-87.68245
TA1309000006,6,11,false,9,8,-1,41.91809,-87.64375
TA1307000163,6,11,false,5,9,4,41.91821,-87.65696
13146,6,11,false,37,42,5,41.91831,-87.63629
13059,6,11,false,18,19,1,41.91845,-87.65222
13259,6,11,false,2,9,7,41.91852,-87.69744
13192,6,11,false,14,20,6,41.91995,-87.64884
13288,6,11,false,11,3,-8,41.92008,-87.67788
TA1309000030,6,11,false,6,7,1,41.92077,-87.66372
TA1309000033,6,11,false,10,10,0,41.92158,-87.65381
13193,6,11,false,34,33,-1,41.92182,-87.64412
13191,6,11,false,17,7,-10,41.92217,-87.63891
13084,6,11,false,7,4,-3,41.92268,-87.69715
LP-,6,11,false,19,36,17,41.92396,-87.63584
TA1307000001,6,11,false,9,5,-4,41.92535,-87.66581
TA1306000026,6,11,false,17,7,-10,41.92558,-87.65842
TA1306000016,6,11,false,17,16,-1,41.9256,-87.65371
TA1309000019,6,11,false,26,28,2,41.92586,-87.63897
TA1309000058,6,11,false,19,24,5,41.92591,-87.64927
TA1308000001,6,11,false,51,78,27,41.92627,-87.63086
13124,6,11,false,21,18,-3,41.92675,-87.63444
TA1309000023,6,11,false,5,4,-1,41.9287,-87.65383
TA1307000113,6,11,false,17,7,-10,41.92878,-87.66391
13296,6,11,false,9,1,-8,41.92883,-87.66852
TA1309000059,6,11,false,8,2,-6,41.92889,-87.65898
TA1309000061,6,11,false,15,12,-3,41.92915,-87.64909
TA1308000031,6,11,false,5,3,-2,41.92946,-87.68417
TA1305000014,6,11,false,31,23,-8,41.92956,-87.64313
13085,6,11,false,5,10,5,41.92958,-87.70789
TA1307000142,6,11,false,23,12,-11,41.93125,-87.64432
13276,6,11,false,19,19,0,41.93132,-87.63874
13271,6,11,false,7,2,-5,41.93192,-87.67784
TA1307000064,6,11,false,21,6,-15,41.93222,-87.65864
TA1306000014,6,11,false,26,15,-11,41.93242,-87.65271
TA1309000039,6,11,false,26,19,-7,41.93258,-87.63642
TA1309000036,6,11,false,10,7,-3,41.93313,-87.64776
TA1307000006,6,11,false,10,10,0,41.93571,-87.6636
13268,6,11,false,5,2,-3,41.93588,-87.67843
13269,6,11,false,5,6,1,41.93609,-87.66983
TA1307000052,6,11,false,12,6,-6,41.93628,-87.65266
TA1307000136,6,11,false,9,10,1,41.9365,-87.64755
TA1307000041,6,11,false,29,25,-4,41.93669,-87.63683
13137,6,11,false,17,17,0,41.9376,-87.6441
KA17018068,6,11,false,7,2,-5,41.93935,-87.68327
TA1309000042,6,11,false,7,4,-3,41.93937,-87.66836
13229,6,11,false,9,7,-2,41.93946,-87.66376
TA1308000019,6,11,false,8,7,-1,41.93973,-87.65886
13277,6,11,false,19,7,-12,41.9401,-87.64546
TA1307000134,6,11,false,26,19,-7,41.94016,-87.65303
13143,6,11,false,5,5,0,41.94059,-87.67853
TA1309000049,6,11,false,19,22,3,41.94077,-87.63919
TA1307000138,6,11,false,6,5,-1,41.94334,-87.67094
TA1309000025,6,11,false,17,17,0,41.94368,-87.64894
13071,6,11,false,11,17,6,41.94373,-87.66401
632,6,11,false,18,24,6,41.94453,-87.6547
13278,6,11,false,22,20,-2,41.94553,-87.64644
13235,6,11,false,14,10,-4,41.94814,-87.66396
13325,6,11,false,24,20,-4,41.94907,-87.64863
TA1307000126,6,11,false,17,28,11,41.94936,-87.65451
TA1307000150,6,11,false,17,11,-6,41.94945,-87.64646
13319,6,11,false,6,11,5,41.95069,-87.6687
TA1307000127,6,11,false,10,22,12,41.9508,-87.65918
13323,6,11,false,5,6,1,41.95282,-87.65
TA1309000043,6,11,false,6,3,-3,41.95417,-87.66434
13063,6,11,false,14,7,-7,41.95424,-87.65441
TA1308000022,6,11,false,10,10,0,41.95438,-87.64805
TA1309000026,6,11,false,5,5,0,41.95601,-87.6802
13249,6,11,false,5,1,-4,41.95606,-87.66885
13379,6,11,false,5,7,2,41.95786,-87.6495
TA1309000027,6,11,false,6,2,-4,41.9585,-87.65499
13389,6,11,false,9,6,-3,41.961,-87.64958
TA1307000107,6,11,false,15,4,-11,41.96164,-87.65464
TA1308000012,6,11,false,14,25,11,41.96398,-87.63818
639,6,11,false,28,21,-7,41.96584,-87.64538
TA1307000140,6,11,false,2,5,3,41.96643,-87.68865
TA1309000014,6,11,false,8,1,-7,41.96709,-87.66744
TA1307000158,6,11,false,5,1,-4,41.9671,-87.67904
TA1307000119,6,11,false,2,8,6,41.96796,-87.65
TA1309000066,6,11,false,11,6,-5,41.9691,-87.67423
TA1309000041,6,11,false,6,1,-5,41.96951,-87.65471
KA1504000171,6,11,false,7,8,1,41.97161,-87.65016
KA1504000152,6,11,false,12,18,6,41.98403,-87.65231
KA1504000148,6,11,false,9,1,-8,41.99086,-87.66971
15571,6,11,false,12,3,-9,41.99478,-87.66028
660,6,11,false,4,8,4,42.00458,-87.66143
E008,6,11,false,8,3,-5,42.05049,-87.67782
KA1503000002,6,11,true,4,5,1,41.76641,-87.5657
TA1308000009,6,11,true,5,7,2,41.79522,-87.58075
13217,6,11,true,9,3,-6,41.83488,-87.61792
13215,6,11,true,6,3,-3,41.83634,-87.6135
TA1309000055,6,11,true,6,1,-5,41.8382,-87.64514
TA1307000048,6,11,true,3,6,3,41.83855,-87.60821
TA1307000139,6,11,true,2,9,7,41.84205,-87.61698
13075,6,11,true,7,5,-2,41.8531,-87.63192
15545,6,11,true,22,30,8,41.85627,-87.61334
SL-013,6,11,true,2,8,6,41.85659,-87.62755
13102,6,11,true,6,5,-1,41.85762,-87.61942
13150,6,11,true,7,8,1,41.85783,-87.62455
13164,6,11,true,6,1,-5,41.85818,-87.65648
SL-012,6,11,true,18,7,-11,41.86038,-87.62581
TA1307000124,6,11,true,11,11,0,41.86411,-87.62372
13431,6,11,true,5,7,2,41.8661,-87.60728
TA1305000002,6,11,true,20,11,-9,41.86721,-87.62597
15544,6,11,true,4,8,4,41.86723,-87.61536
KA1706005007,6,11,true,5,6,1,41.86749,-87.63219
SL-005,6,11,true,8,13,5,41.8679,-87.62304
13160,6,11,true,4,7,3,41.86947,-87.65548
15550,6,11,true,5,4,-1,41.87024,-87.63947
TA1309000010,6,11,true,10,13,3,41.87074,-87.62574
SL-009,6,11,true,5,7,2,41.87081,-87.63121
TA1309000064,6,11,true,1,6,5,41.87127,-87.67369
TA1307000121,6,11,true,6,5,-1,41.87184,-87.64664
SL-008,6,11,true,12,16,4,41.87209,-87.62956
13332,6,11,true,6,9,3,41.87219,-87.6615
SL-011,6,11,true,11,6,-5,41.87256,-87.63356
KA1504000104,6,11,true,5,2,-3,41.87296,-87.66912
SL-007,6,11,true,7,5,-2,41.87404,-87.6277
13028,6,11,true,15,5,-10,41.87475,-87.64981
SL-010,6,11,true,6,2,-4,41.87501,-87.63309
15541,6,11,true,8,2,-6,41.8758,-87.62086
15539,6,11,true,11,8,-3,41.87763,-87.64405
13158,6,11,true,17,12,-5,41.87764,-87.64957
13157,6,11,true,11,12,1,41.87773,-87.6548
TA1305000025,6,11,true,7,10,3,41.87773,-87.63528
TA1309000002,6,11,true,2,5,3,41.87784,-87.62408
13206,6,11,true,7,4,-3,41.87794,-87.66201
638,6,11,true,8,2,-6,41.87827,-87.64078
13011,6,11,true,7,1,-6,41.87931,-87.63993
KA1503000015,6,11,true,11,4,-7,41.87948,-87.6257
WL-011,6,11,true,8,5,-3,41.88034,-87.64273
13156,6,11,true,17,9,-8,41.88042,-87.65554
13300,6,11,true,16,12,-4,41.88097,-87.61675
13008,6,11,true,10,7,-3,41.88105,-87.62408
TA1305000006,6,11,true,10,8,-2,41.88122,-87.6296
TA1307000120,6,11,true,15,16,1,41.88188,-87.64879
13341,6,11,true,5,3,-2,41.88208,-87.63985
13036,6,11,true,3,6,3,41.8821,-87.62513
TA1305000032,6,11,true,5,4,-1,41.88218,-87.64109
13353,6,11,true,1,6,5,41.88283,-87.6612
13409,6,11,true,7,13,6,41.8831,-87.6511
WL-012,6,11,true,2,7,5,41.88337,-87.6412
13053,6,11,true,13,15,2,41.88365,-87.64863
13001,6,11,true,2,9,7,41.88397,-87.62459
13155,6,11,true,6,3,-3,41.88407,-87.65689
18062,6,11,true,3,5,2,41.88412,-87.65427
TA1306000010,6,11,true,5,12,7,41.88419,-87.62961
15535,6,11,true,5,12,7,41.8846,-87.64455
TA1305000029,6,11,true,12,7,-5,41.88466,-87.62787
13263,6,11,true,6,12,6,41.88467,-87.61952
TA1306000015,6,11,true,4,14,10,41.88549,-87.65232
13021,6,11,true,12,6,-6,41.88559,-87.64184
TA1307000111,6,11,true,10,3,-7,41.88582,-87.63548
13073,6,11,true,1,5,4,41.88592,-87.66717
KA1503000012,6,11,true,4,9,5,41.88599,-87.63089
TA1305000011,6,11,true,11,6,-5,41.886,-87.62418
15534,6,11,true,10,9,-1,41.88627,-87.61749
13197,6,11,true,6,8,2,41.8866,-87.65816
TA1308000029,6,11,true,7,5,-2,41.88673,-87.62225
KA1503000064,6,11,true,11,13,2,41.88697,-87.61281
TA1305000022,6,11,true,13,6,-7,41.88817,-87.63656
TA1306000003,6,11,true,16,20,4,41.88867,-87.64442
KA1503000043,6,11,true,28,21,-7,41.88918,-87.63851
13050,6,11,true,5,12,7,41.88919,-87.62775
TA1307000151,6,11,true,18,11,-7,41.88993,-87.63427
636,6,11,true,12,10,-2,41.88997,-87.63662
13430,6,11,true,7,18,11,41.89077,-87.63169
TA1306000013,6,11,true,13,17,4,41.89083,-87.61852
RN-,6,11,true,9,19,10,41.89102,-87.63546
TA1307000117,6,11,true,11,9,-2,41.89144,-87.62675
13033,6,11,true,8,9,1,41.8916,-87.64835
13194,6,11,true,6,5,-1,41.8918,-87.65878
TA1305000003,6,11,true,6,10,4,41.89187,-87.62061
13022,6,11,true,42,28,-14,41.89227,-87.61205
TA1306000029,6,11,true,11,12,1,41.89256,-87.61449
13265,6,11,true,14,12,-2,41.89383,-87.64172
13045,6,11,true,18,23,5,41.89403,-87.62931
13016,6,11,true,9,7,-2,41.89431,-87.62277
KA1503000041,6,11,true,8,8,0,41.89452,-87.61798
13196,6,11,true,6,5,-1,41.89455,-87.65345
TA1307000062,6,11,true,8,7,-1,41.89466,-87.63839
TA1306000012,6,11,true,21,22,1,41.89475,-87.63438
KP1705001026,6,11,true,10,12,2,41.89483,-87.6323
13132,6,11,true,1,9,8,41.89573,-87.67718
15530,6,11,true,10,12,2,41.89575,-87.62596
18003,6,11,true,3,6,3,41.89575,-87.62011
13247,6,11,true,7,4,-3,41.89597,-87.66775
TA1305000020,6,11,true,10,6,-4,41.89636,-87.65406
13289,6,11,true,9,4,-5,41.89638,-87.661
13303,6,11,true,9,9,0,41.89672,-87.63088
13017,6,11,true,11,11,0,41.89676,-87.6357
13338,6,11,true,1,8,7,41.89697,-87.62173
TA1307000061,6,11,true,7,8,1,41.89745,-87.62873
TA1306000009,6,11,true,9,7,-2,41.89772,-87.64299
620,6,11,true,10,10,0,41.89817,-87.63754
15529,6,11,true,9,7,-2,41.89858,-87.62206
TA1307000128,6,11,true,16,14,-2,41.89896,-87.6299
13248,6,11,true,4,5,1,41.89964,-87.66788
KA1504000116,6,11,true,9,3,-6,41.90023,-87.64299
17660,6,11,true,5,2,-3,41.90036,-87.69671
13290,6,11,true,7,5,-2,41.90069,-87.66259
13042,6,11,true,25,30,5,41.90097,-87.62377
TA1307000070,6,11,true,7,2,-5,41.90133,-87.67742
KA1504000133,6,11,true,14,13,-1,41.90234,-87.62773
TA1306000006,6,11,true,4,5,1,41.90292,-87.63772
TA1307000039,6,11,true,34,26,-8,41.90294,-87.63137
658,6,11,true,7,4,-3,41.903,-87.6838
TA1305000034,6,11,true,8,18,10,41.90313,-87.67391
KA1504000135,6,11,true,18,16,-2,41.90319,-87.63439
13136,6,11,true,7,8,1,41.90326,-87.67845
13061,6,11,true,16,11,-5,41.90342,-87.66779
KA1504000079,6,11,true,7,10,3,41.9035,-87.64334
TA1307000115,6,11,true,5,8,3,41.9046,-87.64056
TA1308000049,6,11,true,18,17,-1,41.90672,-87.6349
KA1504000134,6,11,true,8,11,3,41.90687,-87.6262
13224,6,11,true,3,6,3,41.90706,-87.66725
TA1307000143,6,11,true,9,2,-7,41.90762,-87.63854
13221,6,11,true,13,9,-4,41.90765,-87.67254
TA1309000024,6,11,true,11,25,14,41.908,-87.63152
TA1305000041,6,11,true,8,6,-2,41.9094,-87.67769
331,6,11,true,24,11,-13,41.90965,-87.64812
TA1305000037,6,11,true,5,12,7,41.91018,-87.67003
TA1306000008,6,11,true,7,3,-4,41.9102,-87.6435
TA1308000005,6,11,true,3,6,3,41.91042,-87.68238
13258,6,11,true,3,5,2,41.91043,-87.69718
13154,6,11,true,12,13,1,41.91054,-87.65312
13058,6,11,true,12,9,-3,41.91059,-87.64942
TA1307000038,6,11,true,4,17,13,41.91138,-87.63868
LF-005,6,11,true,29,31,2,41.91172,-87.62681
13128,6,11,true,10,12,2,41.91197,-87.63197
TA1308000050,6,11,true,37,29,-8,41.91211,-87.6347
13243,6,11,true,6,6,0,41.91262,-87.6814
TA1306000032,6,11,true,15,8,-7,41.9137,-87.65285
TA1307000166,6,11,true,10,5,-5,41.91386,-87.64877
18067,6,11,true,9,3,-6,41.9146,-87.66796
TA1306000007,6,11,true,6,7,1,41.91469,-87.64333
13068,6,11,true,6,10,4,41.91554,-87.68703
13179,6,11,true,55,41,-14,41.9157,-87.63461
13133,6,11,true,6,3,-3,41.91598,-87.67733
TA1305000039,6,11,true,8,5,-3,41.9163,-87.66749
TA1309000006,6,11,true,6,17,11,41.91809,-87.64375
TA1307000163,6,11,true,11,9,-2,41.91821,-87.65696
13146,6,11,true,22,34,12,41.91831,-87.63629
13059,6,11,true,14,17,3,41.91845,-87.65222
13259,6,11,true,6,5,-1,41.91852,-87.69744
13192,6,11,true,19,16,-3,41.91995,-87.64884
13288,6,11,true,2,6,4,41.92008,-87.67788
13242,6,11,true,3,7,4,41.92021,-87.69266
TA1309000030,6,11,true,14,4,-10,41.92077,-87.66372
13292,6,11,true,6,2,-4,41.92152,-87.70733
TA1309000033,6,11,true,16,15,-1,41.92158,-87.65381
13193,6,11,true,15,14,-1,41.92182,-87.64412
13191,6,11,true,10,11,1,41.92217,-87.63891
13084,6,11,true,10,2,-8,41.92268,-87.69715
LP-,6,11,true,11,14,3,41.92396,-87.63584
KA1504000090,6,11,true,5,1,-4,41.92483,-87.7145
TA1307000001,6,11,true,11,9,-2,41.92535,-87.66581
TA1306000026,6,11,true,8,7,-1,41.92558,-87.65842
TA1306000016,6,11,true,13,12,-1,41.9256,-87.65371
TA1309000019,6,11,true,19,18,-1,41.92586,-87.63897
TA1309000058,6,11,true,21,21,0,41.92591,-87.64927
TA1308000001,6,11,true,26,26,0,41.92627,-87.63086
13124,6,11,true,7,14,7,41.92675,-87.63444
TA1309000023,6,11,true,14,13,-1,41.9287,-87.65383
TA1307000113,6,11,true,7,7,0,41.92878,-87.66391
13296,6,11,true,6,7,1,41.92883,-87.66852
TA1309000059,6,11,true,6,8,2,41.92889,-87.65898
TA1309000061,6,11,true,9,18,9,41.92915,-87.64909
TA1305000014,6,11,true,16,14,-2,41.92956,-87.64313
TA1307000142,6,11,true,8,24,16,41.93125,-87.64432
13276,6,11,true,11,17,6,41.93132,-87.63874
TA1307000064,6,11,true,11,11,0,41.93222,-87.65864
TA1306000014,6,11,true,11,14,3,41.93242,-87.65271
TA1309000039,6,11,true,12,26,14,41.93258,-87.63642
13294,6,11,true,4,6,2,41.9326,-87.66595
TA1309000036,6,11,true,13,6,-7,41.93313,-87.64776
TA1307000006,6,11,true,11,10,-1,41.93571,-87.6636
TA1307000052,6,11,true,9,16,7,41.93628,-87.65266
TA1307000136,6,11,true,15,15,0,41.9365,-87.64755
TA1307000041,6,11,true,14,17,3,41.93669,-87.63683
13137,6,11,true,16,19,3,41.9376,-87.6441
KA17018068,6,11,true,4,5,1,41.93935,-87.68327
TA1309000042,6,11,true,20,14,-6,41.93937,-87.66836
13229,6,11,true,5,3,-2,41.93946,-87.66376
TA1308000019,6,11,true,6,8,2,41.93973,-87.65886
13277,6,11,true,18,8,-10,41.9401,-87.64546
TA1307000134,6,11,true,12,15,3,41.94016,-87.65303
TA1309000049,6,11,true,10,18,8,41.94077,-87.63919
TA1307000138,6,11,true,4,7,3,41.94334,-87.67094
TA1309000025,6,11,true,13,19,6,41.94368,-87.64894
13071,6,11,true,14,12,-2,41.94373,-87.66401
632,6,11,true,10,5,-5,41.94453,-87.6547
13278,6,11,true,15,17,2,41.94553,-87.64644
13235,6,11,true,27,17,-10,41.94814,-87.66396
13325,6,11,true,17,24,7,41.94907,-87.64863
TA1307000126,6,11,true,10,12,2,41.94936,-87.65451
TA1307000150,6,11,true,11,18,7,41.94945,-87.64646
13319,6,11,true,6,9,3,41.95069,-87.6687
TA1307000127,6,11,true,6,15,9,41.9508,-87.65918
15628,6,11,true,1,5,4,41.95216,-87.69806
13323,6,11,true,12,14,2,41.95282,-87.65
TA1309000043,6,11,true,5,3,-2,41.95417,-87.66434
13063,6,11,true,10,9,-1,41.95424,-87.65441
TA1308000022,6,11,true,9,7,-2,41.95438,-87.64805
TA1309000026,6,11,true,4,10,6,41.95601,-87.6802
13379,6,11,true,9,12,3,41.95786,-87.6495
TA1309000018,6,11,true,5,2,-3,41.95791,-87.67357
TA1309000027,6,11,true,12,5,-7,41.9585,-87.65499
13389,6,11,true,19,15,-4,41.961,-87.64958
TA1307000144,6,11,true,7,4,-3,41.96142,-87.6762
TA1309000021,6,11,true,7,2,-5,41.9615,-87.6714
KA1503000022,6,11,true,9,4,-5,41.96158,-87.66609
TA1307000107,6,11,true,20,7,-13,41.96164,-87.65464
TA1307000156,6,11,true,7,6,-1,41.96301,-87.68479
TA1309000012,6,11,true,6,2,-4,41.96325,-87.67928
TA1308000012,6,11,true,12,11,-1,41.96398,-87.63818
13074,6,11,true,9,7,-2,41.96521,-87.6582
639,6,11,true,11,12,1,41.96584,-87.64538
TA1307000140,6,11,true,8,10,2,41.96643,-87.68865
TA1309000014,6,11,true,4,12,8,41.96709,-87.66744
TA1307000158,6,11,true,2,7,5,41.9671,-87.67904
TA1307000119,6,11,true,5,7,2,41.96796,-87.65
TA1308000021,6,11,true,5,1,-4,41.96883,-87.65765
TA1309000066,6,11,true,7,5,-2,41.9691,-87.67423
TA1309000041,6,11,true,6,6,0,41.96951,-87.65471
KA1504000171,6,11,true,5,13,8,41.97161,-87.65016
TA1309000035,6,11,true,7,6,-1,41.97335,-87.66785
13108,6,11,true,7,6,-1,41.97379,-87.65971
KA1504000078,6,11,true,6,2,-4,41.97491,-87.69258
KA1504000149,6,11,true,6,1,-5,41.97562,-87.67945
KA1504000146,6,11,true,10,13,3,41.978,-87.66805
13109,6,11,true,5,3,-2,41.97835,-87.65976
KA1504000147,6,11,true,4,6,2,41.97976,-87.67754
KA1504000151,6,11,true,6,2,-4,41.98359,-87.66916
KA1504000152,6,11,true,13,15,2,41.98403,-87.65231
15578,6,11,true,5,5,0,41.98405,-87.66027
15575,6,11,true,6,7,1,41.98975,-87.66014
15571,6,11,true,5,4,-1,41.99478,-87.66028
660,6,11,true,5,1,-4,42.00458,-87.66143
KA1504000175,6,11,true,5,2,-3,42.00797,-87.66549
523,6,11,true,3,5,2,42.02089,-87.66505
15491,6,12,false,5,5,0,41.78096,-87.57624
KA1503000014,6,12,false,6,4,-2,41.7851,-87.60108
KA1503000074,6,12,false,3,20,17,41.79174,-87.58395
TA1309000063,6,12,false,4,7,3,41.79325,-87.5878
TA1308000009,6,12,false,16,20,4,41.79522,-87.58075
KA1503000059,6,12,false,1,5,4,41.79952,-87.58643
TA1309000037,6,12,false,5,7,2,41.79957,-87.59474
KA1503000004,6,12,false,2,6,4,41.83127,-87.6088
13217,6,12,false,5,2,-3,41.83488,-87.61792
13215,6,12,false,6,6,0,41.83634,-87.6135
TA1308000046,6,12,false,1,5,4,41.83779,-87.65115
TA1307000048,6,12,false,15,8,-7,41.83855,-87.60821
TA1305000004,6,12,false,5,3,-2,41.8514,-87.61884
13075,6,12,false,5,19,14,41.8531,-87.63192
15545,6,12,false,19,12,-7,41.85627,-87.61334
SL-013,6,12,false,7,1,-6,41.85659,-87.62755
13150,6,12,false,10,9,-1,41.85783,-87.62455
13163,6,12,false,6,1,-5,41.85808,-87.65108
13164,6,12,false,4,5,1,41.85818,-87.65648
TA1307000124,6,12,false,11,11,0,41.86411,-87.62372
TA1309000001,6,12,false,7,1,-6,41.86488,-87.64708
13029,6,12,false,10,12,2,41.86531,-87.6179
13431,6,12,false,16,21,5,41.8661,-87.60728
TA1305000002,6,12,false,16,15,-1,41.86721,-87.62597
15544,6,12,false,49,70,21,41.86723,-87.61536
TA1305000017,6,12,false,4,5,1,41.86734,-87.64863
SL-005,6,12,false,19,19,0,41.8679,-87.62304
TA1309000010,6,12,false,15,21,6,41.87074,-87.62574
SL-009,6,12,false,10,7,-3,41.87081,-87.63121
SL-008,6,12,false,11,12,1,41.87209,-87.62956
13332,6,12,false,12,3,-9,41.87219,-87.6615
SL-011,6,12,false,11,2,-9,41.87256,-87.63356
623,6,12,false,9,6,-3,41.87272,-87.62399
KA1504000104,6,12,false,9,1,-8,41.87296,-87.66912
15541,6,12,false,33,41,8,41.8758,-87.62086
TA1305000010,6,12,false,6,2,-4,41.87623,-87.62444
624,6,12,false,5,2,-3,41.87626,-87.62923
TA1305000035,6,12,false,5,3,-2,41.87716,-87.62787
15539,6,12,false,12,6,-6,41.87763,-87.64405
13158,6,12,false,10,3,-7,41.87764,-87.64957
13157,6,12,false,10,11,1,41.87773,-87.6548
TA1305000025,6,12,false,10,4,-6,41.87773,-87.63528
TA1309000002,6,12,false,19,12,-7,41.87784,-87.62408
13206,6,12,false,7,1,-6,41.87794,-87.66201
TA1309000004,6,12,false,11,3,-8,41.87811,-87.63184
638,6,12,false,9,6,-3,41.87827,-87.64078
13011,6,12,false,13,10,-3,41.87931,-87.63993
KA1503000015,6,12,false,9,8,-1,41.87948,-87.6257
13156,6,12,false,16,14,-2,41.88042,-87.65554
13300,6,12,false,83,53,-30,41.88097,-87.61675
13008,6,12,false,49,77,28,41.88105,-87.62408
TA1305000006,6,12,false,15,6,-9,41.88122,-87.6296
13056,6,12,false,8,3,-5,41.88168,-87.63951
TA1307000120,6,12,false,26,22,-4,41.88188,-87.64879
13341,6,12,false,11,4,-7,41.88208,-87.63985
13036,6,12,false,14,6,-8,41.8821,-87.62513
TA1305000032,6,12,false,18,10,-8,41.88218,-87.64109
13006,6,12,false,2,6,4,41.88268,-87.63252
13353,6,12,false,8,1,-7,41.88283,-87.6612
654,6,12,false,6,3,-3,41.88307,-87.65698
13409,6,12,false,4,12,8,41.8831,-87.6511
WL-012,6,12,false,16,7,-9,41.88337,-87.6412
13053,6,12,false,27,16,-11,41.88365,-87.64863
13001,6,12,false,11,19,8,41.88397,-87.62459
13155,6,12,false,6,5,-1,41.88407,-87.65689
18062,6,12,false,5,4,-1,41.88412,-87.65427
TA1306000010,6,12,false,12,5,-7,41.88419,-87.62961
TA1305000030,6,12,false,11,5,-6,41.88459,-87.63178
15535,6,12,false,10,6,-4,41.8846,-87.64455
TA1305000029,6,12,false,13,13,0,41.88466,-87.62787
13263,6,12,false,24,19,-5,41.88467,-87.61952
TA1306000015,6,12,false,19,22,3,41.88549,-87.65232
13021,6,12,false,13,7,-6,41.88559,-87.64184
TA1307000111,6,12,false,4,5,1,41.88582,-87.63548
KA1503000012,6,12,false,18,6,-12,41.88599,-87.63089
TA1305000011,6,12,false,9,10,1,41.886,-87.62418
15534,6,12,false,7,12,5,41.88627,-87.61749
TA1307000131,6,12,false,15,15,0,41.88688,-87.62606
KA1503000064,6,12,false,49,49,0,41.88697,-87.61281
TA1305000022,6,12,false,3,7,4,41.88817,-87.63656
TA1306000003,6,12,false,10,14,4,41.88867,-87.64442
KA1503000043,6,12,false,21,10,-11,41.88918,-87.63851
13050,6,12,false,17,27,10,41.88919,-87.62775
TA1307000151,6,12,false,20,22,2,41.88993,-87.63427
636,6,12,false,6,4,-2,41.88997,-87.63662
KA1503000044,6,12,false,7,11,4,41.89018,-87.6262
13427,6,12,false,7,16,9,41.89054,-87.62205
13430,6,12,false,10,15,5,41.89077,-87.63169
TA1306000013,6,12,false,22,20,-2,41.89083,-87.61852
RN-,6,12,false,11,7,-4,41.89102,-87.63546
13434,6,12,false,6,8,2,41.89108,-87.66663
TA1307000117,6,12,false,39,40,1,41.89144,-87.62675
13033,6,12,false,3,12,9,41.8916,-87.64835
13194,6,12,false,7,6,-1,41.8918,-87.65878
TA1305000003,6,12,false,33,32,-1,41.89187,-87.62061
13022,6,12,false,186,232,46,41.89227,-87.61205
TA1306000029,6,12,false,18,49,31,41.89256,-87.61449
13265,6,12,false,5,9,4,41.89383,-87.64172
13045,6,12,false,27,25,-2,41.89403,-87.62931
13016,6,12,false,17,24,7,41.89431,-87.62277
KA1503000041,6,12,false,11,7,-4,41.89452,-87.61798
13196,6,12,false,8,3,-5,41.89455,-87.65345
TA1307000062,6,12,false,5,1,-4,41.89466,-87.63839
TA1306000012,6,12,false,20,18,-2,41.89475,-87.63438
KP1705001026,6,12,false,4,6,2,41.89483,-87.6323
637,6,12,false,9,2,-7,41.89563,-87.67209
13132,6,12,false,9,3,-6,41.89573,-87.67718
15530,6,12,false,25,16,-9,41.89575,-87.62596
18003,6,12,false,4,5,1,41.89575,-87.62011
13247,6,12,false,11,4,-7,41.89597,-87.66775
TA1305000020,6,12,false,10,10,0,41.89636,-87.65406
13289,6,12,false,8,3,-5,41.89638,-87.661
13303,6,12,false,12,17,5,41.89672,-87.63088
13338,6,12,false,20,19,-1,41.89697,-87.62173
TA1307000061,6,12,false,8,2,-6,41.89745,-87.62873
13034,6,12,false,10,22,12,41.89754,-87.62352
TA1306000009,6,12,false,13,12,-1,41.89772,-87.64299
620,6,12,false,6,7,1,41.89817,-87.63754
KA1504000103,6,12,false,5,2,-3,41.89842,-87.68659
15529,6,12,false,14,25,11,41.89858,-87.62206
TA1307000128,6,12,false,24,21,-3,41.89896,-87.6299
657,6,12,false,8,1,-7,41.89918,-87.6722
KA1504000117,6,12,false,6,1,-5,41.89936,-87.64848
13248,6,12,false,6,2,-4,41.89964,-87.66788
TA1306000011,6,12,false,9,6,-3,41.89994,-87.63443
KA1504000116,6,12,false,7,1,-6,41.90023,-87.64299
17660,6,12,false,6,7,1,41.90036,-87.69671
13290,6,12,false,9,6,-3,41.90069,-87.66259
13042,6,12,false,73,87,14,41.90097,-87.62377
TA1307000070,6,12,false,11,4,-7,41.90133,-87.67742
KA1504000133,6,12,false,21,44,23,41.90234,-87.62773
TA1307000039,6,12,false,25,31,6,41.90294,-87.63137
13256,6,12,false,7,3,-4,41.90302,-87.69749
TA1305000034,6,12,false,10,8,-2,41.90313,-87.67391
KA1504000135,6,12,false,26,29,3,41.90319,-87.63439
13136,6,12,false,11,8,-3,41.90326,-87.67845
13061,6,12,false,25,15,-10,41.90342,-87.66779
KA1504000079,6,12,false,12,11,-1,41.9035,-87.64334
TA1307000115,6,12,false,6,5,-1,41.9046,-87.64056
TA1308000049,6,12,false,33,42,9,41.90672,-87.6349
KA1504000134,6,12,false,13,6,-7,41.90687,-87.6262
13224,6,12,false,7,3,-4,41.90706,-87.66725
TA1307000143,6,12,false,3,6,3,41.90762,-87.63854
13221,6,12,false,17,14,-3,41.90765,-87.67254
TA1309000024,6,12,false,32,23,-9,41.908,-87.63152
TA1305000041,6,12,false,31,17,-14,41.9094,-87.67769
331,6,12,false,9,16,7,41.90965,-87.64812
TA1305000037,6,12,false,9,7,-2,41.91018,-87.67003
TA1306000008,6,12,false,3,9,6,41.9102,-87.6435
13257,6,12,false,7,5,-2,41.91054,-87.68956
13154,6,12,false,10,12,2,41.91054,-87.65312
13058,6,12,false,7,7,0,41.91059,-87.64942
TA1307000038,6,12,false,13,15,2,41.91138,-87.63868
LF-005,6,12,false,78,122,44,41.91172,-87.62681
13128,6,12,false,27,22,-5,41.91197,-87.63197
TA1308000050,6,12,false,42,54,12,41.91211,-87.6347
13243,6,12,false,7,11,4,41.91262,-87.6814
TA1306000032,6,12,false,10,2,-8,41.9137,-87.65285
TA1307000166,6,12,false,9,10,1,41.91386,-87.64877
18067,6,12,false,5,2,-3,41.9146,-87.66796
TA1306000007,6,12,false,4,6,2,41.91469,-87.64333
13179,6,12,false,77,98,21,41.9157,-87.63461
13133,6,12,false,10,13,3,41.91598,-87.67733
TA1305000039,6,12,false,9,5,-4,41.9163,-87.66749
15651,6,12,false,12,10,-2,41.91752,-87.70181
TA1309000029,6,12,false,5,7,2,41.9178,-87.68245
TA1309000006,6,12,false,14,17,3,41.91809,-87.64375
TA1307000163,6,12,false,12,5,-7,41.91821,-87.65696
13146,6,12,false,25,32,7,41.91831,-87.63629
13059,6,12,false,21,24,3,41.91845,-87.65222
13192,6,12,false,25,4,-21,41.91995,-87.64884
13288,6,12,false,4,6,2,41.92008,-87.67788
13242,6,12,false,5,2,-3,41.92021,-87.69266
TA1309000030,6,12,false,4,10,6,41.92077,-87.66372
TA1309000033,6,12,false,29,9,-20,41.92158,-87.65381
13193,6,12,false,21,25,4,41.92182,-87.64412
13191,6,12,false,11,21,10,41.92217,-87.63891
13084,6,12,false,8,8,0,41.92268,-87.69715
LP-,6,12,false,35,44,9,41.92396,-87.63584
KA1504000140,6,12,false,8,2,-6,41.92409,-87.67646
TA1307000001,6,12,false,16,13,-3,41.92535,-87.66581
TA1306000026,6,12,false,18,7,-11,41.92558,-87.65842
TA1306000016,6,12,false,10,3,-7,41.9256,-87.65371
TA1309000019,6,12,false,37,42,5,41.92586,-87.63897
TA1309000058,6,12,false,30,21,-9,41.92591,-87.64927
TA1308000001,6,12,false,44,58,14,41.92627,-87.63086
15646,6,12,false,6,1,-5,41.92668,-87.6977
13124,6,12,false,23,27,4,41.92675,-87.63444
TA1309000023,6,12,false,7,6,-1,41.9287,-87.65383
TA1307000113,6,12,false,11,12,1,41.92878,-87.66391
13296,6,12,false,7,4,-3,41.92883,-87.66852
TA1309000061,6,12,false,11,11,0,41.92915,-87.64909
TA1308000031,6,12,false,5,4,-1,41.92946,-87.68417
TA1305000014,6,12,false,17,13,-4,41.92956,-87.64313
13085,6,12,false,12,10,-2,41.92958,-87.70789
TA1307000142,6,12,false,27,12,-15,41.93125,-87.64432
13276,6,12,false,27,27,0,41.93132,-87.63874
15645,6,12,false,5,1,-4,41.93191,-87.70121
TA1307000064,6,12,false,11,13,2,41.93222,-87.65864
TA1306000014,6,12,false,11,5,-6,41.93242,-87.65271
TA1309000039,6,12,false,40,23,-17,41.93258,-87.63642
13294,6,12,false,14,3,-11,41.9326,-87.66595
TA1309000036,6,12,false,14,8,-6,41.93313,-87.64776
TA1307000006,6,12,false,10,10,0,41.93571,-87.6636
13269,6,12,false,5,2,-3,41.93609,-87.66983
TA1307000052,6,12,false,10,7,-3,41.93628,-87.65266
TA1307000136,6,12,false,9,8,-1,41.9365,-87.64755
TA1307000041,6,12,false,35,33,-2,41.93669,-87.63683
13137,6,12,false,25,10,-15,41.9376,-87.6441
TA1309000042,6,12,false,9,8,-1,41.93937,-87.66836
13229,6,12,false,10,6,-4,41.93946,-87.66376
TA1308000019,6,12,false,11,12,1,41.93973,-87.65886
13277,6,12,false,18,13,-5,41.9401,-87.64546
TA1307000134,6,12,false,22,37,15,41.94016,-87.65303
TA1309000049,6,12,false,26,37,11,41.94077,-87.63919
TA1307000138,6,12,false,7,9,2,41.94334,-87.67094
13144,6,12,false,5,1,-4,41.9434,-87.67964
TA1309000025,6,12,false,22,21,-1,41.94368,-87.64894
13071,6,12,false,20,22,2,41.94373,-87.66401
632,6,12,false,11,17,6,41.94453,-87.6547
13278,6,12,false,19,20,1,41.94553,-87.64644
13235,6,12,false,10,20,10,41.94814,-87.66396
13325,6,12,false,17,16,-1,41.94907,-87.64863
TA1307000126,6,12,false,12,31,19,41.94936,-87.65451
TA1307000150,6,12,false,19,20,1,41.94945,-87.64646
13319,6,12,false,7,5,-2,41.95069,-87.6687
TA1307000127,6,12,false,15,13,-2,41.9508,-87.65918
13323,6,12,false,8,13,5,41.95282,-87.65
TA1309000043,6,12,false,7,13,6,41.95417,-87.66434
13063,6,12,false,15,17,2,41.95424,-87.65441
TA1308000022,6,12,false,7,14,7,41.95438,-87.64805
13379,6,12,false,14,7,-7,41.95786,-87.6495
TA1309000027,6,12,false,9,6,-3,41.9585,-87.65499
13389,6,12,false,7,25,18,41.961,-87.64958
TA1307000107,6,12,false,6,7,1,41.96164,-87.65464
TA1309000012,6,12,false,3,7,4,41.96325,-87.67928
TA1308000012,6,12,false,29,29,0,41.96398,-87.63818
639,6,12,false,11,21,10,41.96584,-87.64538
TA1307000119,6,12,false,5,12,7,41.96796,-87.65
TA1308000021,6,12,false,5,2,-3,41.96883,-87.65765
TA1309000066,6,12,false,5,2,-3,41.9691,-87.67423
TA1309000041,6,12,false,5,4,-1,41.96951,-87.65471
KA1504000171,6,12,false,13,6,-7,41.97161,-87.65016
TA1309000035,6,12,false,6,15,9,41.97335,-87.66785
13108,6,12,false,6,5,-1,41.97379,-87.65971
KA1504000146,6,12,false,9,3,-6,41.978,-87.66805
13109,6,12,false,6,9,3,41.97835,-87.65976
KA1504000147,6,12,false,1,7,6,41.97976,-87.67754
KA1504000151,6,12,false,5,4,-1,41.98359,-87.66916
KA1504000152,6,12,false,30,26,-4,41.98403,-87.65231
15575,6,12,false,4,8,4,41.98975,-87.66014
15571,6,12,false,3,7,4,41.99478,-87.66028
KA1504000156,6,12,false,5,1,-4,41.99925,-87.67137
RP-009,6,12,false,3,5,2,42.00107,-87.66122
KA1504000159,6,12,false,2,5,3,42.01059,-87.66241
596,6,12,false,7,7,0,42.04822,-87.68348
KA1503000014,6,12,true,7,1,-6,41.7851,-87.60108
TA1308000009,6,12,true,8,5,-3,41.79522,-87.58075
TA1307000164,6,12,true,3,6,3,41.79527,-87.59647
KA1503000059,6,12,true,6,2,-4,41.79952,-87.58643
TA1309000037,6,12,true,4,8,4,41.79957,-87.59474
TA1309000055,6,12,true,2,5,3,41.8382,-87.64514
TA1307000048,6,12,true,8,6,-2,41.83855,-87.60821
TA1307000005,6,12,true,6,2,-4,41.84569,-87.6225
TA1305000004,6,12,true,5,1,-4,41.8514,-87.61884
13091,6,12,true,3,6,3,41.85409,-87.68585
15545,6,12,true,13,10,-3,41.85627,-87.61334
13102,6,12,true,8,9,1,41.85762,-87.61942
13150,6,12,true,1,8,7,41.85783,-87.62455
TA1307000159,6,12,true,4,5,1,41.8579,-87.6687
13164,6,12,true,5,4,-1,41.85818,-87.65648
TA1307000124,6,12,true,6,8,2,41.86411,-87.62372
13029,6,12,true,2,5,3,41.86531,-87.6179
WL-008,6,12,true,6,3,-3,41.86712,-87.64108
TA1305000002,6,12,true,16,15,-1,41.86721,-87.62597
15544,6,12,true,9,14,5,41.86723,-87.61536
SL-005,6,12,true,16,10,-6,41.8679,-87.62304
13139,6,12,true,5,2,-3,41.86893,-87.65913
13160,6,12,true,4,5,1,41.86947,-87.65548
TA1309000010,6,12,true,16,9,-7,41.87074,-87.62574
TA1309000064,6,12,true,9,5,-4,41.87127,-87.67369
TA1307000121,6,12,true,11,6,-5,41.87184,-87.64664
SL-008,6,12,true,10,9,-1,41.87209,-87.62956
13332,6,12,true,7,9,2,41.87219,-87.6615
623,6,12,true,6,2,-4,41.87272,-87.62399
KA1504000104,6,12,true,7,3,-4,41.87296,-87.66912
15541,6,12,true,9,3,-6,41.8758,-87.62086
15539,6,12,true,9,11,2,41.87763,-87.64405
13158,6,12,true,5,7,2,41.87764,-87.64957
13157,6,12,true,13,7,-6,41.87773,-87.6548
TA1305000025,6,12,true,6,11,5,41.87773,-87.63528
638,6,12,true,6,5,-1,41.87827,-87.64078
13156,6,12,true,3,7,4,41.88042,-87.65554
13300,6,12,true,21,30,9,41.88097,-87.61675
13008,6,12,true,12,7,-5,41.88105,-87.62408
TA1305000006,6,12,true,5,3,-2,41.88122,-87.6296
TA1307000120,6,12,true,14,12,-2,41.88188,-87.64879
13341,6,12,true,1,5,4,41.88208,-87.63985
TA1305000032,6,12,true,8,12,4,41.88218,-87.64109
13006,6,12,true,5,5,0,41.88268,-87.63252
654,6,12,true,7,2,-5,41.88307,-87.65698
13409,6,12,true,8,4,-4,41.8831,-87.6511
WL-012,6,12,true,6,13,7,41.88337,-87.6412
13053,6,12,true,11,9,-2,41.88365,-87.64863
13001,6,12,true,7,3,-4,41.88397,-87.62459
18062,6,12,true,7,3,-4,41.88412,-87.65427
TA1306000010,6,12,true,5,6,1,41.88419,-87.62961
TA1305000030,6,12,true,6,3,-3,41.88459,-87.63178
15535,6,12,true,7,7,0,41.8846,-87.64455
TA1305000029,6,12,true,3,6,3,41.88466,-87.62787
13263,6,12,true,9,6,-3,41.88467,-87.61952
TA1306000015,6,12,true,5,10,5,41.88549,-87.65232
13021,6,12,true,9,8,-1,41.88559,-87.64184
TA1307000111,6,12,true,5,5,0,41.88582,-87.63548
KA1503000012,6,12,true,6,3,-3,41.88599,-87.63089
TA1305000011,6,12,true,9,5,-4,41.886,-87.62418
15534,6,12,true,1,8,7,41.88627,-87.61749
KA1503000064,6,12,true,12,20,8,41.88697,-87.61281
TA1305000022,6,12,true,5,5,0,41.88817,-87.63656
TA1306000003,6,12,true,11,13,2,41.88867,-87.64442
KA1503000043,6,12,true,21,14,-7,41.88918,-87.63851
13050,6,12,true,10,7,-3,41.88919,-87.62775
TA1307000151,6,12,true,19,21,2,41.88993,-87.63427
13430,6,12,true,6,7,1,41.89077,-87.63169
TA1306000013,6,12,true,10,10,0,41.89083,-87.61852
RN-,6,12,true,9,8,-1,41.89102,-87.63546
TA1307000117,6,12,true,9,21,12,41.89144,-87.62675
13033,6,12,true,7,8,1,41.8916,-87.64835
13194,6,12,true,7,6,-1,41.8918,-87.65878
TA1305000003,6,12,true,13,15,2,41.89187,-87.62061
13022,6,12,true,31,20,-11,41.89227,-87.61205
TA1306000029,6,12,true,14,11,-3,41.89256,-87.61449
13265,6,12,true,12,12,0,41.89383,-87.64172
13045,6,12,true,14,14,0,41.89403,-87.62931
13016,6,12,true,3,6,3,41.89431,-87.62277
KA1503000041,6,12,true,5,8,3,41.89452,-87.61798
TA1307000062,6,12,true,5,7,2,41.89466,-87.63839
TA1306000012,6,12,true,20,28,8,41.89475,-87.63438
KP1705001026,6,12,true,7,5,-2,41.89483,-87.6323
637,6,12,true,8,7,-1,41.89563,-87.67209
13132,6,12,true,5,3,-2,41.89573,-87.67718
15530,6,12,true,9,10,1,41.89575,-87.62596
13247,6,12,true,6,4,-2,41.89597,-87.66775
TA1305000020,6,12,true,9,9,0,41.89636,-87.65406
13289,6,12,true,2,5,3,41.89638,-87.661
13303,6,12,true,11,8,-3,41.89672,-87.63088
13017,6,12,true,5,5,0,41.89676,-87.6357
13338,6,12,true,5,8,3,41.89697,-87.62173
TA1307000061,6,12,true,2,5,3,41.89745,-87.62873
13034,6,12,true,11,4,-7,41.89754,-87.62352
TA1306000009,6,12,true,16,10,-6,41.89772,-87.64299
620,6,12,true,10,9,-1,41.89817,-87.63754
15529,6,12,true,6,10,4,41.89858,-87.62206
TA1307000128,6,12,true,14,12,-2,41.89896,-87.6299
13248,6,12,true,7,2,-5,41.89964,-87.66788
KA1504000116,6,12,true,5,5,0,41.90023,-87.64299
17660,6,12,true,7,2,-5,41.90036,-87.69671
13290,6,12,true,7,5,-2,41.90069,-87.66259
13042,6,12,true,18,30,12,41.90097,-87.62377
TA1307000070,6,12,true,3,8,5,41.90133,-87.67742
KA1504000133,6,12,true,20,12,-8,41.90234,-87.62773
13241,6,12,true,7,1,-6,41.9029,-87.68731
TA1307000039,6,12,true,26,25,-1,41.90294,-87.63137
TA1305000034,6,12,true,5,6,1,41.90313,-87.67391
KA1504000135,6,12,true,30,26,-4,41.90319,-87.63439
13136,6,12,true,9,11,2,41.90326,-87.67845
13061,6,12,true,19,17,-2,41.90342,-87.66779
KA1504000079,6,12,true,15,13,-2,41.9035,-87.64334
TA1308000049,6,12,true,11,25,14,41.90672,-87.6349
KA1504000134,6,12,true,6,11,5,41.90687,-87.6262
13221,6,12,true,14,9,-5,41.90765,-87.67254
TA1309000024,6,12,true,14,30,16,41.908,-87.63152
TA1305000041,6,12,true,13,19,6,41.9094,-87.67769
331,6,12,true,12,11,-1,41.90965,-87.64812
TA1306000008,6,12,true,4,6,2,41.9102,-87.6435
TA1308000005,6,12,true,8,1,-7,41.91042,-87.68238
13154,6,12,true,7,15,8,41.91054,-87.65312
13058,6,12,true,13,8,-5,41.91059,-87.64942
TA1307000038,6,12,true,11,16,5,41.91138,-87.63868
LF-005,6,12,true,27,36,9,41.91172,-87.62681
13128,6,12,true,5,4,-1,41.91197,-87.63197
TA1308000050,6,12,true,27,18,-9,41.91211,-87.6347
13243,6,12,true,13,9,-4,41.91262,-87.6814
TA1306000032,6,12,true,8,7,-1,41.9137,-87.65285
TA1307000166,6,12,true,9,7,-2,41.91386,-87.64877
TA1306000007,6,12,true,4,9,5,41.91469,-87.64333
13068,6,12,true,5,7,2,41.91554,-87.68703
13179,6,12,true,63,38,-25,41.9157,-87.63461
13133,6,12,true,3,5,2,41.91598,-87.67733
TA1305000039,6,12,true,2,10,8,41.9163,-87.66749
TA1309000006,6,12,true,13,16,3,41.91809,-87.64375
TA1307000163,6,12,true,11,11,0,41.91821,-87.65696
13146,6,12,true,21,17,-4,41.91831,-87.63629
13059,6,12,true,15,14,-1,41.91845,-87.65222
13192,6,12,true,10,5,-5,41.91995,-87.64884
TA1309000030,6,12,true,8,12,4,41.92077,-87.66372
TA1309000033,6,12,true,17,9,-8,41.92158,-87.65381
13193,6,12,true,14,11,-3,41.92182,-87.64412
13191,6,12,true,6,13,7,41.92217,-87.63891
13084,6,12,true,4,10,6,41.92268,-87.69715
LP-,6,12,true,15,9,-6,41.92396,-87.63584
TA1306000026,6,12,true,14,4,-10,41.92558,-87.65842
TA1306000016,6,12,true,13,8,-5,41.9256,-87.65371
TA1309000019,6,12,true,19,24,5,41.92586,-87.63897
TA1309000058,6,12,true,20,20,0,41.92591,-87.64927
TA1308000001,6,12,true,26,18,-8,41.92627,-87.63086
13124,6,12,true,10,12,2,41.92675,-87.63444
TA1309000023,6,12,true,7,5,-2,41.9287,-87.65383
TA1307000113,6,12,true,11,8,-3,41.92878,-87.66391
TA1309000059,6,12,true,7,3,-4,41.92889,-87.65898
TA1309000061,6,12,true,10,8,-2,41.92915,-87.64909
TA1305000014,6,12,true,13,14,1,41.92956,-87.64313
TA1307000142,6,12,true,14,10,-4,41.93125,-87.64432
13276,6,12,true,12,15,3,41.93132,-87.63874
TA1307000064,6,12,true,10,12,2,41.93222,-87.65864
TA1306000014,6,12,true,6,3,-3,41.93242,-87.65271
TA1309000039,6,12,true,10,21,11,41.93258,-87.63642
13294,6,12,true,12,4,-8,41.9326,-87.66595
TA1309000036,6,12,true,15,13,-2,41.93313,-87.64776
TA1307000006,6,12,true,8,3,-5,41.93571,-87.6636
13269,6,12,true,6,3,-3,41.93609,-87.66983
TA1307000052,6,12,true,13,6,-7,41.93628,-87.65266
TA1307000136,6,12,true,9,6,-3,41.9365,-87.64755
TA1307000041,6,12,true,18,26,8,41.93669,-87.63683
13137,6,12,true,18,15,-3,41.9376,-87.6441
TA1309000042,6,12,true,7,3,-4,41.93937,-87.66836
13229,6,12,true,10,6,-4,41.93946,-87.66376
TA1308000019,6,12,true,15,16,1,41.93973,-87.65886
13277,6,12,true,12,6,-6,41.9401,-87.64546
TA1307000134,6,12,true,20,23,3,41.94016,-87.65303
TA1309000049,6,12,true,15,24,9,41.94077,-87.63919
TA1307000138,6,12,true,8,8,0,41.94334,-87.67094
TA1309000025,6,12,true,11,18,7,41.94368,-87.64894
13071,6,12,true,18,22,4,41.94373,-87.66401
632,6,12,true,10,6,-4,41.94453,-87.6547
13278,6,12,true,9,21,12,41.94553,-87.64644
13235,6,12,true,9,16,7,41.94814,-87.66396
13253,6,12,true,5,7,2,41.9488,-87.67527
13325,6,12,true,19,17,-2,41.94907,-87.64863
TA1307000126,6,12,true,9,24,15,41.94936,-87.65451
TA1307000150,6,12,true,13,17,4,41.94945,-87.64646
13319,6,12,true,7,8,1,41.95069,-87.6687
TA1307000127,6,12,true,5,8,3,41.9508,-87.65918
13323,6,12,true,8,12,4,41.95282,-87.65
TA1309000043,6,12,true,4,5,1,41.95417,-87.66434
13063,6,12,true,2,6,4,41.95424,-87.65441
TA1308000022,6,12,true,18,7,-11,41.95438,-87.64805
TA1307000149,6,12,true,5,3,-2,41.95467,-87.67392
TA1309000026,6,12,true,5,6,1,41.95601,-87.6802
13249,6,12,true,5,4,-1,41.95606,-87.66885
13379,6,12,true,12,14,2,41.95786,-87.6495
TA1309000018,6,12,true,3,6,3,41.95791,-87.67357
TA1309000027,6,12,true,3,8,5,41.9585,-87.65499
13389,6,12,true,12,15,3,41.961,-87.64958
TA1307000144,6,12,true,3,9,6,41.96142,-87.6762
KA1503000022,6,12,true,10,5,-5,41.96158,-87.66609
TA1307000107,6,12,true,14,12,-2,41.96164,-87.65464
TA1307000156,6,12,true,11,5,-6,41.96301,-87.68479
TA1308000012,6,12,true,11,14,3,41.96398,-87.63818
13074,6,12,true,5,8,3,41.96521,-87.6582
639,6,12,true,9,7,-2,41.96584,-87.64538
TA1309000014,6,12,true,11,7,-4,41.96709,-87.66744
TA1307000158,6,12,true,4,5,1,41.9671,-87.67904
TA1307000119,6,12,true,4,6,2,41.96796,-87.65
TA1308000021,6,12,true,2,5,3,41.96883,-87.65765
TA1309000066,6,12,true,12,6,-6,41.9691,-87.67423
KA1504000171,6,12,true,7,12,5,41.97161,-87.65016
TA1309000035,6,12,true,12,9,-3,41.97335,-87.66785
13108,6,12,true,6,2,-4,41.97379,-87.65971
KA1504000146,6,12,true,4,6,2,41.978,-87.66805
13109,6,12,true,4,7,3,41.97835,-87.65976
KA1504000151,6,12,true,4,5,1,41.98359,-87.66916
KA1504000152,6,12,true,12,18,6,41.98403,-87.65231
15578,6,12,true,5,5,0,41.98405,-87.66027
15575,6,12,true,3,8,5,41.98975,-87.66014
15571,6,12,true,5,7,2,41.99478,-87.66028
RP-009,6,12,true,5,2,-3,42.00107,-87.66122
596,6,12,true,6,5,-1,42.04822,-87.68348
KA1503000002,6,13,false,9,5,-4,41.76641,-87.5657
15491,6,13,false,7,9,2,41.78096,-87.57624
KA1503000070,6,13,false,5,1,-4,41.78794,-87.58831
KA1503000074,6,13,false,14,11,-3,41.79174,-87.58395
TA1309000063,6,13,false,5,5,0,41.79325,-87.5878
KA1504000076,6,13,false,7,6,-1,41.7943,-87.60145
TA1308000009,6,13,false,15,21,6,41.79522,-87.58075
TA1307000164,6,13,false,4,6,2,41.79527,-87.59647
TA1309000037,6,13,false,8,3,-5,41.79957,-87.59474
TA1307000048,6,13,false,17,14,-3,41.83855,-87.60821
TA1307000005,6,13,false,3,5,2,41.84569,-87.6225
TA1305000001,6,13,false,7,7,0,41.85262,-87.6265
13075,6,13,false,14,7,-7,41.8531,-87.63192
15545,6,13,false,9,9,0,41.85627,-87.61334
SL-006,6,13,false,2,5,3,41.8568,-87.63387
13102,6,13,false,9,11,2,41.85762,-87.61942
13163,6,13,false,9,6,-3,41.85808,-87.65108
13164,6,13,false,5,1,-4,41.85818,-87.65648
TA1307000124,6,13,false,23,11,-12,41.86411,-87.62372
TA1309000001,6,13,false,6,3,-3,41.86488,-87.64708
13029,6,13,false,5,6,1,41.86531,-87.6179
13431,6,13,false,24,21,-3,41.8661,-87.60728
WL-008,6,13,false,12,1,-11,41.86712,-87.64108
TA1305000002,6,13,false,10,4,-6,41.86721,-87.62597
15544,6,13,false,88,51,-37,41.86723,-87.61536
KA1706005007,6,13,false,2,5,3,41.86749,-87.63219
SL-005,6,13,false,24,22,-2,41.8679,-87.62304
TA1309000010,6,13,false,12,20,8,41.87074,-87.62574
SL-009,6,13,false,7,4,-3,41.87081,-87.63121
SL-008,6,13,false,13,14,1,41.87209,-87.62956
SL-011,6,13,false,4,9,5,41.87256,-87.63356
623,6,13,false,15,19,4,41.87272,-87.62399
SL-007,6,13,false,8,4,-4,41.87404,-87.6277
15541,6,13,false,26,38,12,41.8758,-87.62086
TA1305000010,6,13,false,6,7,1,41.87623,-87.62444
TA1305000035,6,13,false,8,5,-3,41.87716,-87.62787
13158,6,13,false,11,10,-1,41.87764,-87.64957
13157,6,13,false,11,13,2,41.87773,-87.6548
TA1305000025,6,13,false,16,11,-5,41.87773,-87.63528
TA1309000002,6,13,false,19,15,-4,41.87784,-87.62408
TA1309000004,6,13,false,11,1,-10,41.87811,-87.63184
638,6,13,false,3,6,3,41.87827,-87.64078
TA1305000005,6,13,false,14,5,-9,41.87924,-87.62975
13011,6,13,false,18,5,-13,41.87931,-87.63993
TA1309000008,6,13,false,3,5,2,41.87933,-87.6355
KA1503000034,6,13,false,6,2,-4,41.87938,-87.63197
KA1503000015,6,13,false,7,10,3,41.87948,-87.6257
TA1309000007,6,13,false,7,8,1,41.88022,-87.63526
13156,6,13,false,13,10,-3,41.88042,-87.65554
13300,6,13,false,85,64,-21,41.88097,-87.61675
13008,6,13,false,93,64,-29,41.88105,-87.62408
TA1305000006,6,13,false,8,16,8,41.88122,-87.6296
TA1307000120,6,13,false,34,14,-20,41.88188,-87.64879
13341,6,13,false,7,7,0,41.88208,-87.63985
13036,6,13,false,6,10,4,41.8821,-87.62513
TA1305000032,6,13,false,7,5,-2,41.88218,-87.64109
13006,6,13,false,8,6,-2,41.88268,-87.63252
13353,6,13,false,9,2,-7,41.88283,-87.6612
13409,6,13,false,12,9,-3,41.8831,-87.6511
WL-012,6,13,false,17,9,-8,41.88337,-87.6412
13053,6,13,false,30,32,2,41.88365,-87.64863
13001,6,13,false,56,30,-26,41.88397,-87.62459
18062,6,13,false,7,11,4,41.88412,-87.65427
TA1306000010,6,13,false,7,8,1,41.88419,-87.62961
TA1305000030,6,13,false,14,8,-6,41.88459,-87.63178
15535,6,13,false,15,9,-6,41.8846,-87.64455
TA1305000029,6,13,false,5,5,0,41.88466,-87.62787
13263,6,13,false,14,10,-4,41.88467,-87.61952
TA1306000015,6,13,false,13,20,7,41.88549,-87.65232
13021,6,13,false,10,2,-8,41.88559,-87.64184
TA1307000111,6,13,false,8,8,0,41.88582,-87.63548
KA17018054,6,13,false,3,6,3,41.88595,-87.67701
KA1503000012,6,13,false,8,10,2,41.88599,-87.63089
TA1305000011,6,13,false,18,15,-3,41.886,-87.62418
15534,6,13,false,9,13,4,41.88627,-87.61749
13197,6,13,false,6,5,-1,41.8866,-87.65816
TA1308000029,6,13,false,11,9,-2,41.88673,-87.62225
TA1307000131,6,13,false,38,37,-1,41.88688,-87.62606
KA1503000064,6,13,false,50,36,-14,41.88697,-87.61281
TA1305000022,6,13,false,7,3,-4,41.88817,-87.63656
TA1306000003,6,13,false,14,13,-1,41.88867,-87.64442
KA1503000043,6,13,false,15,18,3,41.88918,-87.63851
13050,6,13,false,20,23,3,41.88919,-87.62775
TA1307000151,6,13,false,22,17,-5,41.88993,-87.63427
KA1503000044,6,13,false,7,3,-4,41.89018,-87.6262
13427,6,13,false,8,6,-2,41.89054,-87.62205
13430,6,13,false,21,22,1,41.89077,-87.63169
TA1306000013,6,13,false,29,20,-9,41.89083,-87.61852
RN-,6,13,false,15,11,-4,41.89102,-87.63546
13434,6,13,false,8,1,-7,41.89108,-87.66663
TA1307000117,6,13,false,41,35,-6,41.89144,-87.62675
13033,6,13,false,14,9,-5,41.8916,-87.64835
13194,6,13,false,10,4,-6,41.8918,-87.65878
TA1305000003,6,13,false,17,26,9,41.89187,-87.62061
13022,6,13,false,216,206,-10,41.89227,-87.61205
TA1306000029,6,13,false,42,29,-13,41.89256,-87.61449
13265,6,13,false,13,7,-6,41.89383,-87.64172
13045,6,13,false,27,26,-1,41.89403,-87.62931
13016,6,13,false,22,15,-7,41.89431,-87.62277
KA1503000041,6,13,false,3,5,2,41.89452,-87.61798
TA1307000062,6,13,false,5,3,-2,41.89466,-87.63839
TA1306000012,6,13,false,44,31,-13,41.89475,-87.63438
KP1705001026,6,13,false,15,13,-2,41.89483,-87.6323
637,6,13,false,13,9,-4,41.89563,-87.67209
13132,6,13,false,13,5,-8,41.89573,-87.67718
15530,6,13,false,14,26,12,41.89575,-87.62596
13247,6,13,false,9,17,8,41.89597,-87.66775
TA1305000020,6,13,false,17,7,-10,41.89636,-87.65406
13289,6,13,false,7,6,-1,41.89638,-87.661
13303,6,13,false,10,8,-2,41.89672,-87.63088
13017,6,13,false,4,9,5,41.89676,-87.6357
13338,6,13,false,8,13,5,41.89697,-87.62173
TA1307000061,6,13,false,8,9,1,41.89745,-87.62873
13034,6,13,false,22,27,5,41.89754,-87.62352
TA1306000009,6,13,false,14,3,-11,41.89772,-87.64299
620,6,13,false,11,8,-3,41.89817,-87.63754
KA1504000103,6,13,false,7,3,-4,41.89842,-87.68659
15529,6,13,false,20,34,14,41.89858,-87.62206
TA1307000128,6,13,false,13,22,9,41.89896,-87.6299
657,6,13,false,5,2,-3,41.89918,-87.6722
KA1504000117,6,13,false,5,1,-4,41.89936,-87.64848
13248,6,13,false,3,6,3,41.89964,-87.66788
TA1306000011,6,13,false,8,2,-6,41.89994,-87.63443
KA1504000116,6,13,false,5,1,-4,41.90023,-87.64299
17660,6,13,false,8,5,-3,41.90036,-87.69671
13290,6,13,false,5,5,0,41.90069,-87.66259
13042,6,13,false,68,79,11,41.90097,-87.62377
KA1504000133,6,13,false,30,29,-1,41.90234,-87.62773
13241,6,13,false,8,3,-5,41.9029,-87.68731
TA1307000039,6,13,false,29,50,21,41.90294,-87.63137
13256,6,13,false,3,7,4,41.90302,-87.69749
TA1305000034,6,13,false,18,7,-11,41.90313,-87.67391
KA1504000135,6,13,false,33,50,17,41.90319,-87.63439
13136,6,13,false,9,8,-1,41.90326,-87.67845
13061,6,13,false,24,19,-5,41.90342,-87.66779
KA1504000079,6,13,false,9,8,-1,41.9035,-87.64334
TA1308000049,6,13,false,29,31,2,41.90672,-87.6349
KA1504000134,6,13,false,16,23,7,41.90687,-87.6262
13224,6,13,false,13,8,-5,41.90706,-87.66725
TA1307000143,6,13,false,2,16,14,41.90762,-87.63854
13221,6,13,false,19,13,-6,41.90765,-87.67254
TA1309000024,6,13,false,26,22,-4,41.908,-87.63152
TA1305000041,6,13,false,40,33,-7,41.9094,-87.67769
15652,6,13,false,5,2,-3,41.90965,-87.71664
331,6,13,false,16,20,4,41.90965,-87.64812
TA1305000037,6,13,false,10,5,-5,41.91018,-87.67003
TA1306000008,6,13,false,9,8,-1,41.9102,-87.6435
TA1308000005,6,13,false,10,3,-7,41.91042,-87.68238
13258,6,13,false,2,9,7,41.91043,-87.69718
13257,6,13,false,11,3,-8,41.91054,-87.68956
13154,6,13,false,15,21,6,41.91054,-87.65312
13058,6,13,false,16,13,-3,41.91059,-87.64942
TA1307000038,6,13,false,20,21,1,41.91138,-87.63868
LF-005,6,13,false,84,138,54,41.91172,-87.62681
13128,6,13,false,22,22,0,41.91197,-87.63197
TA1308000050,6,13,false,47,53,6,41.91211,-87.6347
13243,6,13,false,16,6,-10,41.91262,-87.6814
TA1306000032,6,13,false,9,10,1,41.9137,-87.65285
TA1307000166,6,13,false,9,3,-6,41.91386,-87.64877
15655,6,13,false,5,1,-4,41.91401,-87.70514
18067,6,13,false,5,15,10,41.9146,-87.66796
TA1306000007,6,13,false,5,9,4,41.91469,-87.64333
13068,6,13,false,12,10,-2,41.91554,-87.68703
13179,6,13,false,51,57,6,41.9157,-87.63461
13133,6,13,false,15,4,-11,41.91598,-87.67733
TA1305000039,6,13,false,14,6,-8,41.9163,-87.66749
13266,6,13,false,6,10,4,41.91774,-87.69142
TA1309000006,6,13,false,18,13,-5,41.91809,-87.64375
TA1307000163,6,13,false,8,3,-5,41.91821,-87.65696
13146,6,13,false,48,56,8,41.91831,-87.63629
13059,6,13,false,26,19,-7,41.91845,-87.65222
13259,6,13,false,6,3,-3,41.91852,-87.69744
13192,6,13,false,23,14,-9,41.91995,-87.64884
13288,6,13,false,6,6,0,41.92008,-87.67788
13242,6,13,false,9,8,-1,41.92021,-87.69266
TA1309000030,6,13,false,10,7,-3,41.92077,-87.66372
TA1309000033,6,13,false,13,9,-4,41.92158,-87.65381
13193,6,13,false,26,28,2,41.92182,-87.64412
13191,6,13,false,18,18,0,41.92217,-87.63891
13084,6,13,false,13,6,-7,41.92268,-87.69715
LP-,6,13,false,51,45,-6,41.92396,-87.63584
KA1504000140,6,13,false,7,3,-4,41.92409,-87.67646
TA1307000001,6,13,false,6,7,1,41.92535,-87.66581
TA1306000026,6,13,false,11,4,-7,41.92558,-87.65842
TA1306000016,6,13,false,14,13,-1,41.9256,-87.65371
TA1309000019,6,13,false,46,44,-2,41.92586,-87.63897
TA1309000058,6,13,false,18,21,3,41.92591,-87.64927
TA1308000001,6,13,false,97,100,3,41.92627,-87.63086
13124,6,13,false,26,33,7,41.92675,-87.63444
TA1309000023,6,13,false,17,20,3,41.9287,-87.65383
TA1307000113,6,13,false,17,5,-12,41.92878,-87.66391
13296,6,13,false,14,8,-6,41.92883,-87.66852
TA1309000059,6,13,false,6,5,-1,41.92889,-87.65898
TA1309000061,6,13,false,9,12,3,41.92915,-87.64909
TA1308000031,6,13,false,5,7,2,41.92946,-87.68417
TA1305000014,6,13,false,20,23,3,41.92956,-87.64313
13085,6,13,false,18,8,-10,41.92958,-87.70789
TA1307000142,6,13,false,18,18,0,41.93125,-87.64432
13276,6,13,false,22,16,-6,41.93132,-87.63874
13271,6,13,false,1,9,8,41.93192,-87.67784
TA1307000064,6,13,false,16,2,-14,41.93222,-87.65864
TA1306000014,6,13,false,9,10,1,41.93242,-87.65271
TA1309000039,6,13,false,41,34,-7,41.93258,-87.63642
13294,6,13,false,9,2,-7,41.9326,-87.66595
TA1309000036,6,13,false,5,6,1,41.93313,-87.64776
TA1307000006,6,13,false,10,8,-2,41.93571,-87.6636
13268,6,13,false,5,3,-2,41.93588,-87.67843
13269,6,13,false,10,2,-8,41.93609,-87.66983
TA1307000052,6,13,false,14,14,0,41.93628,-87.65266
TA1307000136,6,13,false,19,21,2,41.9365,-87.64755
TA1307000041,6,13,false,45,50,5,41.93669,-87.63683
13137,6,13,false,19,23,4,41.9376,-87.6441
15642,6,13,false,1,5,4,41.93843,-87.69801
TA1309000042,6,13,false,7,6,-1,41.93937,-87.66836
13229,6,13,false,9,10,1,41.93946,-87.66376
TA1308000019,6,13,false,14,7,-7,41.93973,-87.65886
13277,6,13,false,11,13,2,41.9401,-87.64546
TA1307000134,6,13,false,27,18,-9,41.94016,-87.65303
13143,6,13,false,7,4,-3,41.94059,-87.67853
TA1309000049,6,13,false,59,51,-8,41.94077,-87.63919
TA1307000138,6,13,false,17,7,-10,41.94334,-87.67094
13144,6,13,false,8,1,-7,41.9434,-87.67964
TA1309000025,6,13,false,32,26,-6,41.94368,-87.64894
13071,6,13,false,26,22,-4,41.94373,-87.66401
632,6,13,false,22,31,9,41.94453,-87.6547
15631,6,13,false,8,2,-6,41.94524,-87.70665
13278,6,13,false,20,23,3,41.94553,-87.64644
KA1504000143,6,13,false,2,5,3,41.94664,-87.68337
13235,6,13,false,9,10,1,41.94814,-87.66396
13325,6,13,false,22,24,2,41.94907,-87.64863
TA1307000126,6,13,false,8,40,32,41.94936,-87.65451
TA1307000150,6,13,false,15,18,3,41.94945,-87.64646
13319,6,13,false,19,5,-14,41.95069,-87.6687
TA1307000127,6,13,false,19,17,-2,41.9508,-87.65918
13323,6,13,false,7,9,2,41.95282,-87.65
13063,6,13,false,10,9,-1,41.95424,-87.65441
TA1308000022,6,13,false,18,26,8,41.95438,-87.64805
TA1309000026,6,13,false,7,3,-4,41.95601,-87.6802
13379,6,13,false,7,18,11,41.95786,-87.6495
TA1309000027,6,13,false,10,4,-6,41.9585,-87.65499
13389,6,13,false,26,29,3,41.961,-87.64958
TA1309000021,6,13,false,5,2,-3,41.9615,-87.6714
TA1307000107,6,13,false,13,6,-7,41.96164,-87.65464
TA1307000156,6,13,false,8,4,-4,41.96301,-87.68479
TA1308000012,6,13,false,36,36,0,41.96398,-87.63818
13074,6,13,false,5,14,9,41.96521,-87.6582
639,6,13,false,12,15,3,41.96584,-87.64538
TA1309000014,6,13,false,5,4,-1,41.96709,-87.66744
TA1307000119,6,13,false,10,10,0,41.96796,-87.65
TA1308000021,6,13,false,8,2,-6,41.96883,-87.65765
TA1309000066,6,13,false,12,2,-10,41.9691,-87.67423
TA1309000041,6,13,false,5,7,2,41.96951,-87.65471
KA1504000171,6,13,false,16,21,5,41.97161,-87.65016
TA1309000035,6,13,false,6,3,-3,41.97335,-87.66785
13108,6,13,false,8,4,-4,41.97379,-87.65971
KA1504000146,6,13,false,12,8,-4,41.978,-87.66805
13109,6,13,false,3,12,9,41.97835,-87.65976
KA1504000152,6,13,false,19,25,6,41.98403,-87.65231
15575,6,13,false,12,17,5,41.98975,-87.66014
15571,6,13,false,7,6,-1,41.99478,-87.66028
KA1504000159,6,13,false,1,10,9,42.01059,-87.66241
520,6,13,false,5,1,-4,42.01597,-87.66859
E008,6,13,false,6,3,-3,42.05049,-87.67782
605,6,13,false,7,4,-3,42.05294,-87.67342
KA1503000071,6,13,true,3,12,9,41.79148,-87.59988
TA1308000009,6,13,true,7,4,-3,41.79522,-87.58075
TA1307000164,6,13,true,2,5,3,41.79527,-87.59647
KA1503000059,6,13,true,6,3,-3,41.79952,-87.58643
TA1309000037,6,13,true,6,5,-1,41.79957,-87.59474
13216,6,13,true,3,6,3,41.83473,-87.62581
TA1307000048,6,13,true,10,5,-5,41.83855,-87.60821
13075,6,13,true,5,4,-1,41.8531,-87.63192
15545,6,13,true,6,11,5,41.85627,-87.61334
13102,6,13,true,11,6,-5,41.85762,-87.61942
13150,6,13,true,5,1,-4,41.85783,-87.62455
13099,6,13,true,3,7,4,41.85784,-87.64627
13164,6,13,true,6,4,-2,41.85818,-87.65648
SL-012,6,13,true,3,9,6,41.86038,-87.62581
TA1307000124,6,13,true,4,6,2,41.86411,-87.62372
13431,6,13,true,5,7,2,41.8661,-87.60728
TA1305000002,6,13,true,16,18,2,41.86721,-87.62597
15544,6,13,true,11,7,-4,41.86723,-87.61536
SL-005,6,13,true,9,5,-4,41.8679,-87.62304
644,6,13,true,9,3,-6,41.86859,-87.68625
13139,6,13,true,5,7,2,41.86893,-87.65913
13160,6,13,true,7,12,5,41.86947,-87.65548
TA1309000010,6,13,true,4,8,4,41.87074,-87.62574
SL-009,6,13,true,5,5,0,41.87081,-87.63121
TA1309000064,6,13,true,11,1,-10,41.87127,-87.67369
SL-008,6,13,true,8,7,-1,41.87209,-87.62956
13332,6,13,true,16,12,-4,41.87219,-87.6615
623,6,13,true,6,4,-2,41.87272,-87.62399
KA1504000104,6,13,true,8,4,-4,41.87296,-87.66912
15541,6,13,true,10,5,-5,41.8758,-87.62086
15539,6,13,true,5,5,0,41.87763,-87.64405
13158,6,13,true,1,8,7,41.87764,-87.64957
13157,6,13,true,12,11,-1,41.87773,-87.6548
TA1305000025,6,13,true,6,5,-1,41.87773,-87.63528
TA1309000002,6,13,true,5,5,0,41.87784,-87.62408
KA1503000015,6,13,true,10,3,-7,41.87948,-87.6257
13156,6,13,true,5,5,0,41.88042,-87.65554
13300,6,13,true,17,26,9,41.88097,-87.61675
13008,6,13,true,12,7,-5,41.88105,-87.62408
TA1307000120,6,13,true,19,20,1,41.88188,-87.64879
13036,6,13,true,6,3,-3,41.8821,-87.62513
TA1305000032,6,13,true,8,5,-3,41.88218,-87.64109
13006,6,13,true,2,5,3,41.88268,-87.63252
13353,6,13,true,11,5,-6,41.88283,-87.6612
654,6,13,true,2,6,4,41.88307,-87.65698
13409,6,13,true,16,8,-8,41.8831,-87.6511
WL-012,6,13,true,8,4,-4,41.88337,-87.6412
13053,6,13,true,13,17,4,41.88365,-87.64863
13001,6,13,true,8,5,-3,41.88397,-87.62459
13155,6,13,true,9,3,-6,41.88407,-87.65689
18062,6,13,true,1,9,8,41.88412,-87.65427
TA1306000010,6,13,true,12,7,-5,41.88419,-87.62961
TA1305000030,6,13,true,7,2,-5,41.88459,-87.63178
15535,6,13,true,8,11,3,41.8846,-87.64455
TA1305000029,6,13,true,1,8,7,41.88466,-87.62787
13263,6,13,true,14,7,-7,41.88467,-87.61952
TA1306000015,6,13,true,8,8,0,41.88549,-87.65232
13021,6,13,true,6,5,-1,41.88559,-87.64184
TA1307000111,6,13,true,7,5,-2,41.88582,-87.63548
KA17018054,6,13,true,2,5,3,41.88595,-87.67701
KA1503000012,6,13,true,6,7,1,41.88599,-87.63089
TA1305000011,6,13,true,5,5,0,41.886,-87.62418
15534,6,13,true,7,8,1,41.88627,-87.61749
13197,6,13,true,3,6,3,41.8866,-87.65816
TA1308000029,6,13,true,4,7,3,41.88673,-87.62225
TA1307000131,6,13,true,4,6,2,41.88688,-87.62606
KA1503000064,6,13,true,11,18,7,41.88697,-87.61281
TA1305000022,6,13,true,2,6,4,41.88817,-87.63656
TA1306000003,6,13,true,17,8,-9,41.88867,-87.64442
KA1503000043,6,13,true,18,14,-4,41.88918,-87.63851
13050,6,13,true,12,7,-5,41.88919,-87.62775
TA1307000151,6,13,true,11,12,1,41.88993,-87.63427
13427,6,13,true,5,4,-1,41.89054,-87.62205
13430,6,13,true,13,7,-6,41.89077,-87.63169
TA1306000013,6,13,true,3,14,11,41.89083,-87.61852
RN-,6,13,true,9,8,-1,41.89102,-87.63546
13434,6,13,true,4,7,3,41.89108,-87.66663
TA1307000117,6,13,true,9,6,-3,41.89144,-87.62675
13033,6,13,true,10,5,-5,41.8916,-87.64835
13194,6,13,true,6,9,3,41.8918,-87.65878
TA1305000003,6,13,true,7,9,2,41.89187,-87.62061
13022,6,13,true,22,33,11,41.89227,-87.61205
TA1306000029,6,13,true,16,11,-5,41.89256,-87.61449
13265,6,13,true,12,14,2,41.89383,-87.64172
13045,6,13,true,15,11,-4,41.89403,-87.62931
13016,6,13,true,15,8,-7,41.89431,-87.62277
KA1503000041,6,13,true,8,9,1,41.89452,-87.61798
TA1307000062,6,13,true,4,6,2,41.89466,-87.63839
TA1306000012,6,13,true,19,19,0,41.89475,-87.63438
KP1705001026,6,13,true,9,5,-4,41.89483,-87.6323
637,6,13,true,2,5,3,41.89563,-87.67209
13132,6,13,true,10,5,-5,41.89573,-87.67718
15530,6,13,true,10,8,-2,41.89575,-87.62596
13247,6,13,true,6,7,1,41.89597,-87.66775
TA1305000020,6,13,true,11,8,-3,41.89636,-87.65406
13289,6,13,true,8,8,0,41.89638,-87.661
13303,6,13,true,7,4,-3,41.89672,-87.63088
13017,6,13,true,9,10,1,41.89676,-87.6357
13338,6,13,true,7,6,-1,41.89697,-87.62173
TA1307000061,6,13,true,7,6,-1,41.89745,-87.62873
13034,6,13,true,10,7,-3,41.89754,-87.62352
TA1306000009,6,13,true,8,6,-2,41.89772,-87.64299
620,6,13,true,6,5,-1,41.89817,-87.63754
15529,6,13,true,12,5,-7,41.89858,-87.62206
TA1307000128,6,13,true,21,13,-8,41.89896,-87.6299
13248,6,13,true,6,6,0,41.89964,-87.66788
TA1306000011,6,13,true,2,6,4,41.89994,-87.63443
KA1504000116,6,13,true,9,6,-3,41.90023,-87.64299
17660,6,13,true,3,5,2,41.90036,-87.69671
13290,6,13,true,12,13,1,41.90069,-87.66259
13042,6,13,true,18,18,0,41.90097,-87.62377
TA1307000070,6,13,true,5,2,-3,41.90133,-87.67742
KA1504000133,6,13,true,15,17,2,41.90234,-87.62773
TA1307000039,6,13,true,20,42,22,41.90294,-87.63137
TA1305000034,6,13,true,7,7,0,41.90313,-87.67391
KA1504000135,6,13,true,26,28,2,41.90319,-87.63439
13136,6,13,true,6,4,-2,41.90326,-87.67845
13061,6,13,true,17,19,2,41.90342,-87.66779
KA1504000079,6,13,true,6,4,-2,41.9035,-87.64334
TA1307000115,6,13,true,3,5,2,41.9046,-87.64056
TA1308000049,6,13,true,15,15,0,41.90672,-87.6349
KA1504000134,6,13,true,16,12,-4,41.90687,-87.6262
13224,6,13,true,6,10,4,41.90706,-87.66725
TA1307000143,6,13,true,5,5,0,41.90762,-87.63854
13221,6,13,true,11,7,-4,41.90765,-87.67254
TA1309000024,6,13,true,10,14,4,41.908,-87.63152
TA1305000041,6,13,true,18,16,-2,41.9094,-87.67769
331,6,13,true,14,14,0,41.90965,-87.64812
TA1305000037,6,13,true,12,9,-3,41.91018,-87.67003
TA1306000008,6,13,true,3,9,6,41.9102,-87.6435
13154,6,13,true,16,10,-6,41.91054,-87.65312
13058,6,13,true,10,13,3,41.91059,-87.64942
TA1307000038,6,13,true,13,10,-3,41.91138,-87.63868
LF-005,6,13,true,31,42,11,41.91172,-87.62681
13128,6,13,true,6,10,4,41.91197,-87.63197
TA1308000050,6,13,true,26,20,-6,41.91211,-87.6347
13243,6,13,true,10,3,-7,41.91262,-87.6814
TA1306000032,6,13,true,7,4,-3,41.9137,-87.65285
TA1307000166,6,13,true,4,10,6,41.91386,-87.64877
15655,6,13,true,5,2,-3,41.91401,-87.70514
18017,6,13,true,4,5,1,41.91416,-87.71676
TA1306000007,6,13,true,4,8,4,41.91469,-87.64333
13179,6,13,true,33,29,-4,41.9157,-87.63461
13133,6,13,true,4,7,3,41.91598,-87.67733
TA1305000039,6,13,true,9,2,-7,41.9163,-87.66749
TA1309000029,6,13,true,7,2,-5,41.9178,-87.68245
TA1309000006,6,13,true,7,7,0,41.91809,-87.64375
TA1307000163,6,13,true,7,8,1,41.91821,-87.65696
13146,6,13,true,49,35,-14,41.91831,-87.63629
13059,6,13,true,19,25,6,41.91845,-87.65222
13192,6,13,true,14,17,3,41.91995,-87.64884
13288,6,13,true,3,5,2,41.92008,-87.67788
13242,6,13,true,1,5,4,41.92021,-87.69266
TA1309000030,6,13,true,9,6,-3,41.92077,-87.66372
TA1309000033,6,13,true,6,8,2,41.92158,-87.65381
13193,6,13,true,12,21,9,41.92182,-87.64412
13191,6,13,true,12,9,-3,41.92217,-87.63891
13084,6,13,true,3,10,7,41.92268,-87.69715
LP-,6,13,true,9,14,5,41.92396,-87.63584
TA1307000001,6,13,true,9,5,-4,41.92535,-87.66581
TA1306000026,6,13,true,5,6,1,41.92558,-87.65842
TA1306000016,6,13,true,15,4,-11,41.9256,-87.65371
TA1309000019,6,13,true,20,15,-5,41.92586,-87.63897
TA1309000058,6,13,true,4,16,12,41.92591,-87.64927
TA1308000001,6,13,true,28,36,8,41.92627,-87.63086
13124,6,13,true,8,9,1,41.92675,-87.63444
TA1309000023,6,13,true,9,7,-2,41.9287,-87.65383
TA1307000113,6,13,true,5,4,-1,41.92878,-87.66391
TA1309000059,6,13,true,4,6,2,41.92889,-87.65898
TA1309000061,6,13,true,10,6,-4,41.92915,-87.64909
TA1308000031,6,13,true,5,3,-2,41.92946,-87.68417
TA1305000014,6,13,true,9,20,11,41.92956,-87.64313
13085,6,13,true,9,7,-2,41.92958,-87.70789
TA1307000142,6,13,true,10,13,3,41.93125,-87.64432
13276,6,13,true,14,12,-2,41.93132,-87.63874
TA1307000064,6,13,true,9,11,2,41.93222,-87.65864
TA1306000014,6,13,true,3,8,5,41.93242,-87.65271
TA1309000039,6,13,true,13,22,9,41.93258,-87.63642
13294,6,13,true,4,5,1,41.9326,-87.66595
TA1309000036,6,13,true,2,5,3,41.93313,-87.64776
TA1307000006,6,13,true,9,9,0,41.93571,-87.6636
13269,6,13,true,5,4,-1,41.93609,-87.66983
TA1307000052,6,13,true,14,24,10,41.93628,-87.65266
TA1307000136,6,13,true,13,13,0,41.9365,-87.64755
TA1307000041,6,13,true,34,28,-6,41.93669,-87.63683
13137,6,13,true,8,12,4,41.9376,-87.6441
TA1309000042,6,13,true,5,7,2,41.93937,-87.66836
TA1308000019,6,13,true,13,11,-2,41.93973,-87.65886
13277,6,13,true,3,8,5,41.9401,-87.64546
TA1307000134,6,13,true,23,15,-8,41.94016,-87.65303
TA1309000049,6,13,true,29,28,-1,41.94077,-87.63919
TA1307000138,6,13,true,13,10,-3,41.94334,-87.67094
TA1309000025,6,13,true,15,13,-2,41.94368,-87.64894
13071,6,13,true,20,17,-3,41.94373,-87.66401
632,6,13,true,10,15,5,41.94453,-87.6547
13278,6,13,true,13,10,-3,41.94553,-87.64644
13235,6,13,true,14,7,-7,41.94814,-87.66396
13325,6,13,true,8,11,3,41.94907,-87.64863
TA1307000126,6,13,true,4,16,12,41.94936,-87.65451
TA1307000150,6,13,true,18,7,-11,41.94945,-87.64646
13319,6,13,true,5,9,4,41.95069,-87.6687
TA1307000127,6,13,true,10,9,-1,41.9508,-87.65918
13323,6,13,true,13,5,-8,41.95282,-87.65
TA1309000043,6,13,true,9,10,1,41.95417,-87.66434
13063,6,13,true,12,12,0,41.95424,-87.65441
TA1308000022,6,13,true,8,12,4,41.95438,-87.64805
TA1307000149,6,13,true,7,6,-1,41.95467,-87.67392
TA1309000026,6,13,true,9,6,-3,41.95601,-87.6802
TA1308000047,6,13,true,5,8,3,41.95709,-87.6642
13379,6,13,true,8,8,0,41.95786,-87.6495
13389,6,13,true,8,19,11,41.961,-87.64958
15622,6,13,true,4,6,2,41.96108,-87.69544
TA1307000144,6,13,true,12,3,-9,41.96142,-87.6762
TA1309000021,6,13,true,3,5,2,41.9615,-87.6714
15623,6,13,true,6,3,-3,41.96154,-87.69117
KA1503000022,6,13,true,6,2,-4,41.96158,-87.66609
TA1307000107,6,13,true,3,9,6,41.96164,-87.65464
TA1307000156,6,13,true,8,4,-4,41.96301,-87.68479
TA1308000012,6,13,true,16,18,2,41.96398,-87.63818
13074,6,13,true,5,8,3,41.96521,-87.6582
639,6,13,true,7,6,-1,41.96584,-87.64538
TA1309000014,6,13,true,8,6,-2,41.96709,-87.66744
TA1307000158,6,13,true,6,11,5,41.9671,-87.67904
TA1307000119,6,13,true,8,4,-4,41.96796,-87.65
TA1309000066,6,13,true,1,5,4,41.9691,-87.67423
TA1309000041,6,13,true,5,3,-2,41.96951,-87.65471
KA1504000171,6,13,true,9,12,3,41.97161,-87.65016
TA1309000035,6,13,true,9,3,-6,41.97335,-87.66785
13108,6,13,true,5,6,1,41.97379,-87.65971
KA1504000149,6,13,true,7,2,-5,41.97562,-87.67945
KA1504000146,6,13,true,11,15,4,41.978,-87.66805
13109,6,13,true,8,6,-2,41.97835,-87.65976
KA1504000152,6,13,true,16,16,0,41.98403,-87.65231
15575,6,13,true,8,10,2,41.98975,-87.66014
15571,6,13,true,6,5,-1,41.99478,-87.66028
RP-009,6,13,true,6,3,-3,42.00107,-87.66122
KA1504000175,6,13,true,4,6,2,42.00797,-87.66549
KA1503000029,6,14,false,5,2,-3,41.77364,-87.56747
15491,6,14,false,8,10,2,41.78096,-87.57624
KA1503000071,6,14,false,7,3,-4,41.79148,-87.59988
KA1503000074,6,14,false,13,10,-3,41.79174,-87.58395
TA1308000009,6,14,false,10,13,3,41.79522,-87.58075
KA1503000059,6,14,false,4,6,2,41.79952,-87.58643
TA1309000037,6,14,false,8,6,-2,41.79957,-87.59474
TA1308000002,6,14,false,5,1,-4,41.80983,-87.59937
KA1503000065,6,14,false,2,7,5,41.81409,-87.59701
KA1503000005,6,14,false,3,9,6,41.83079,-87.6325
TA1307000048,6,14,false,14,27,13,41.83855,-87.60821
13075,6,14,false,18,7,-11,41.8531,-87.63192
15545,6,14,false,4,8,4,41.85627,-87.61334
SL-006,6,14,false,5,5,0,41.8568,-87.63387
13102,6,14,false,5,12,7,41.85762,-87.61942
13150,6,14,false,7,3,-4,41.85783,-87.62455
13099,6,14,false,8,4,-4,41.85784,-87.64627
13164,6,14,false,5,2,-3,41.85818,-87.65648
SL-012,6,14,false,7,8,1,41.86038,-87.62581
TA1307000124,6,14,false,3,17,14,41.86411,-87.62372
13029,6,14,false,14,25,11,41.86531,-87.6179
13431,6,14,false,41,19,-22,41.8661,-87.60728
WL-008,6,14,false,9,2,-7,41.86712,-87.64108
TA1305000002,6,14,false,5,15,10,41.86721,-87.62597
15544,6,14,false,100,72,-28,41.86723,-87.61536
SL-005,6,14,false,18,33,15,41.8679,-87.62304
15550,6,14,false,4,5,1,41.87024,-87.63947
TA1309000010,6,14,false,20,32,12,41.87074,-87.62574
SL-009,6,14,false,2,5,3,41.87081,-87.63121
TA1307000130,6,14,false,3,10,7,41.87178,-87.65103
SL-008,6,14,false,10,15,5,41.87209,-87.62956
SL-011,6,14,false,16,12,-4,41.87256,-87.63356
623,6,14,false,15,32,17,41.87272,-87.62399
SL-007,6,14,false,9,7,-2,41.87404,-87.6277
15541,6,14,false,47,39,-8,41.8758,-87.62086
13037,6,14,false,2,7,5,41.87588,-87.64078
TA1305000010,6,14,false,2,7,5,41.87623,-87.62444
624,6,14,false,5,4,-1,41.87626,-87.62923
TA1305000035,6,14,false,7,5,-2,41.87716,-87.62787
15539,6,14,false,6,3,-3,41.87763,-87.64405
13158,6,14,false,12,5,-7,41.87764,-87.64957
13157,6,14,false,8,6,-2,41.87773,-87.6548
TA1305000025,6,14,false,9,4,-5,41.87773,-87.63528
TA1309000002,6,14,false,16,26,10,41.87784,-87.62408
TA1309000004,6,14,false,10,3,-7,41.87811,-87.63184
638,6,14,false,6,5,-1,41.87827,-87.64078
13011,6,14,false,10,1,-9,41.87931,-87.63993
TA1309000008,6,14,false,5,11,6,41.87933,-87.6355
KA1503000034,6,14,false,1,8,7,41.87938,-87.63197
KA1503000015,6,14,false,9,5,-4,41.87948,-87.6257
WL-011,6,14,false,5,4,-1,41.88034,-87.64273
13156,6,14,false,10,11,1,41.88042,-87.65554
13300,6,14,false,83,77,-6,41.88097,-87.61675
13008,6,14,false,77,107,30,41.88105,-87.62408
TA1305000006,6,14,false,12,6,-6,41.88122,-87.6296
13056,6,14,false,7,2,-5,41.88168,-87.63951
TA1307000120,6,14,false,12,16,4,41.88188,-87.64879
13341,6,14,false,12,6,-6,41.88208,-87.63985
13036,6,14,false,10,8,-2,41.8821,-87.62513
TA1305000032,6,14,false,8,8,0,41.88218,-87.64109
13353,6,14,false,6,6,0,41.88283,-87.6612
13409,6,14,false,7,14,7,41.8831,-87.6511
KA1503000072,6,14,false,5,5,0,41.88317,-87.63693
WL-012,6,14,false,18,14,-4,41.88337,-87.6412
13053,6,14,false,31,28,-3,41.88365,-87.64863
13001,6,14,false,8,26,18,41.88397,-87.62459
13155,6,14,false,5,3,-2,41.88407,-87.65689
18062,6,14,false,6,10,4,41.88412,-87.65427
TA1306000010,6,14,false,8,15,7,41.88419,-87.62961
TA1305000030,6,14,false,7,12,5,41.88459,-87.63178
TA1305000029,6,14,false,22,21,-1,41.88466,-87.62787
13263,6,14,false,10,23,13,41.88467,-87.61952
TA1306000015,6,14,false,22,10,-12,41.88549,-87.65232
13021,6,14,false,6,7,1,41.88559,-87.64184
TA1307000111,6,14,false,1,8,7,41.88582,-87.63548
13073,6,14,false,4,7,3,41.88592,-87.66717
KA17018054,6,14,false,6,3,-3,41.88595,-87.67701
KA1503000012,6,14,false,12,18,6,41.88599,-87.63089
TA1305000011,6,14,false,17,37,20,41.886,-87.62418
15534,6,14,false,19,19,0,41.88627,-87.61749
TA1308000029,6,14,false,6,10,4,41.88673,-87.62225
TA1307000131,6,14,false,24,32,8,41.88688,-87.62606
KA1503000064,6,14,false,55,44,-11,41.88697,-87.61281
TA1305000022,6,14,false,6,9,3,41.88817,-87.63656
TA1306000003,6,14,false,19,23,4,41.88867,-87.64442
KA1503000043,6,14,false,15,13,-2,41.88918,-87.63851
13050,6,14,false,28,21,-7,41.88919,-87.62775
TA1307000151,6,14,false,15,24,9,41.88993,-87.63427
636,6,14,false,2,8,6,41.88997,-87.63662
KA1503000044,6,14,false,8,16,8,41.89018,-87.6262
13427,6,14,false,7,13,6,41.89054,-87.62205
13430,6,14,false,16,21,5,41.89077,-87.63169
TA1306000013,6,14,false,31,47,16,41.89083,-87.61852
RN-,6,14,false,8,13,5,41.89102,-87.63546
13434,6,14,false,2,6,4,41.89108,-87.66663
TA1308000006,6,14,false,6,4,-2,41.89128,-87.67686
TA1307000117,6,14,false,28,41,13,41.89144,-87.62675
13033,6,14,false,9,12,3,41.8916,-87.64835
13194,6,14,false,9,8,-1,41.8918,-87.65878
TA1305000003,6,14,false,29,35,6,41.89187,-87.62061
13022,6,14,false,200,220,20,41.89227,-87.61205
TA1306000029,6,14,false,28,36,8,41.89256,-87.61449
13265,6,14,false,7,9,2,41.89383,-87.64172
13045,6,14,false,26,17,-9,41.89403,-87.62931
13016,6,14,false,18,31,13,41.89431,-87.62277
KA1503000041,6,14,false,11,17,6,41.89452,-87.61798
13196,6,14,false,9,8,-1,41.89455,-87.65345
TA1307000062,6,14,false,4,9,5,41.89466,-87.63839
TA1306000012,6,14,false,20,23,3,41.89475,-87.63438
KP1705001026,6,14,false,13,16,3,41.89483,-87.6323
637,6,14,false,5,5,0,41.89563,-87.67209
13132,6,14,false,13,13,0,41.89573,-87.67718
15530,6,14,false,8,29,21,41.89575,-87.62596
13247,6,14,false,7,7,0,41.89597,-87.66775
TA1305000020,6,14,false,8,11,3,41.89636,-87.65406
13289,6,14,false,9,7,-2,41.89638,-87.661
13303,6,14,false,6,12,6,41.89672,-87.63088
13017,6,14,false,7,6,-1,41.89676,-87.6357
13338,6,14,false,15,22,7,41.89697,-87.62173
TA1307000061,6,14,false,18,6,-12,41.89745,-87.62873
13034,6,14,false,22,39,17,41.89754,-87.62352
TA1306000009,6,14,false,5,5,0,41.89772,-87.64299
620,6,14,false,7,8,1,41.89817,-87.63754
15529,6,14,false,9,22,13,41.89858,-87.62206
TA1307000128,6,14,false,31,39,8,41.89896,-87.6299
TA1306000011,6,14,false,6,8,2,41.89994,-87.63443
KA1504000116,6,14,false,1,9,8,41.90023,-87.64299
17660,6,14,false,7,6,-1,41.90036,-87.69671
13290,6,14,false,9,10,1,41.90069,-87.66259
13042,6,14,false,100,106,6,41.90097,-87.62377
KA1504000133,6,14,false,16,22,6,41.90234,-87.62773
13241,6,14,false,8,6,-2,41.9029,-87.68731
TA1307000039,6,14,false,28,43,15,41.90294,-87.63137
658,6,14,false,3,6,3,41.903,-87.6838
13256,6,14,false,5,3,-2,41.90302,-87.69749
TA1305000034,6,14,false,13,10,-3,41.90313,-87.67391
KA1504000135,6,14,false,26,33,7,41.90319,-87.63439
13136,6,14,false,7,11,4,41.90326,-87.67845
13061,6,14,false,16,22,6,41.90342,-87.66779
KA1504000079,6,14,false,11,18,7,41.9035,-87.64334
TA1307000115,6,14,false,10,6,-4,41.9046,-87.64056
TA1308000049,6,14,false,27,25,-2,41.90672,-87.6349
KA1504000134,6,14,false,18,17,-1,41.90687,-87.6262
13224,6,14,false,7,7,0,41.90706,-87.66725
TA1307000143,6,14,false,4,8,4,41.90762,-87.63854
13221,6,14,false,13,14,1,41.90765,-87.67254
TA1309000024,6,14,false,21,30,9,41.908,-87.63152
TA1305000041,6,14,false,21,24,3,41.9094,-87.67769
331,6,14,false,21,14,-7,41.90965,-87.64812
15653,6,14,false,6,2,-4,41.90979,-87.7053
TA1305000037,6,14,false,9,10,1,41.91018,-87.67003
TA1306000008,6,14,false,3,22,19,41.9102,-87.6435
TA1308000005,6,14,false,5,4,-1,41.91042,-87.68238
13257,6,14,false,6,9,3,41.91054,-87.68956
13154,6,14,false,13,11,-2,41.91054,-87.65312
13058,6,14,false,14,14,0,41.91059,-87.64942
TA1307000038,6,14,false,16,11,-5,41.91138,-87.63868
LF-005,6,14,false,136,211,75,41.91172,-87.62681
13128,6,14,false,20,27,7,41.91197,-87.63197
TA1308000050,6,14,false,49,68,19,41.91211,-87.6347
13243,6,14,false,9,9,0,41.91262,-87.6814
TA1306000032,6,14,false,9,16,7,41.9137,-87.65285
TA1307000166,6,14,false,9,7,-2,41.91386,-87.64877
18067,6,14,false,18,11,-7,41.9146,-87.66796
13068,6,14,false,4,6,2,41.91554,-87.68703
13179,6,14,false,58,70,12,41.9157,-87.63461
13133,6,14,false,11,10,-1,41.91598,-87.67733
15651,6,14,false,6,8,2,41.91752,-87.70181
TA1309000029,6,14,false,3,9,6,41.9178,-87.68245
TA1309000006,6,14,false,4,13,9,41.91809,-87.64375
TA1307000163,6,14,false,10,11,1,41.91821,-87.65696
13146,6,14,false,52,45,-7,41.91831,-87.63629
13059,6,14,false,18,33,15,41.91845,-87.65222
13192,6,14,false,15,20,5,41.91995,-87.64884
13288,6,14,false,7,7,0,41.92008,-87.67788
13242,6,14,false,2,5,3,41.92021,-87.69266
TA1309000030,6,14,false,6,11,5,41.92077,-87.66372
TA1309000033,6,14,false,14,14,0,41.92158,-87.65381
13193,6,14,false,45,44,-1,41.92182,-87.64412
13191,6,14,false,18,13,-5,41.92217,-87.63891
13084,6,14,false,10,10,0,41.92268,-87.69715
LP-,6,14,false,39,40,1,41.92396,-87.63584
KA1504000140,6,14,false,3,5,2,41.92409,-87.67646
TA1307000001,6,14,false,13,15,2,41.92535,-87.66581
TA1306000026,6,14,false,5,2,-3,41.92558,-87.65842
TA1306000016,6,14,false,13,11,-2,41.9256,-87.65371
TA1309000019,6,14,false,34,40,6,41.92586,-87.63897
TA1309000058,6,14,false,36,31,-5,41.92591,-87.64927
TA1308000001,6,14,false,102,103,1,41.92627,-87.63086
13124,6,14,false,24,17,-7,41.92675,-87.63444
TA1309000023,6,14,false,9,13,4,41.9287,-87.65383
TA1307000113,6,14,false,13,15,2,41.92878,-87.66391
13296,6,14,false,5,4,-1,41.92883,-87.66852
TA1309000059,6,14,false,12,4,-8,41.92889,-87.65898
TA1309000061,6,14,false,15,23,8,41.92915,-87.64909
TA1308000031,6,14,false,1,5,4,41.92946,-87.68417
TA1305000014,6,14,false,24,30,6,41.92956,-87.64313
13085,6,14,false,8,8,0,41.92958,-87.70789
TA1307000142,6,14,false,17,16,-1,41.93125,-87.64432
13276,6,14,false,25,24,-1,41.93132,-87.63874
TA1307000064,6,14,false,5,11,6,41.93222,-87.65864
TA1306000014,6,14,false,16,23,7,41.93242,-87.65271
TA1309000039,6,14,false,31,55,24,41.93258,-87.63642
TA1309000036,6,14,false,8,15,7,41.93313,-87.64776
TA1307000006,6,14,false,6,11,5,41.93571,-87.6636
13269,6,14,false,6,7,1,41.93609,-87.66983
TA1307000052,6,14,false,9,9,0,41.93628,-87.65266
TA1307000136,6,14,false,18,18,0,41.9365,-87.64755
TA1307000041,6,14,false,29,39,10,41.93669,-87.63683
13137,6,14,false,26,25,-1,41.9376,-87.6441
TA1309000042,6,14,false,3,9,6,41.93937,-87.66836
13229,6,14,false,7,3,-4,41.93946,-87.66376
TA1308000019,6,14,false,8,13,5,41.93973,-87.65886
13277,6,14,false,10,20,10,41.9401,-87.64546
TA1307000134,6,14,false,11,17,6,41.94016,-87.65303
13143,6,14,false,2,5,3,41.94059,-87.67853
TA1309000049,6,14,false,41,56,15,41.94077,-87.63919
TA1307000138,6,14,false,7,5,-2,41.94334,-87.67094
TA1309000025,6,14,false,14,23,9,41.94368,-87.64894
13071,6,14,false,21,22,1,41.94373,-87.66401
632,6,14,false,18,22,4,41.94453,-87.6547
13278,6,14,false,15,24,9,41.94553,-87.64644
13235,6,14,false,13,7,-6,41.94814,-87.66396
13325,6,14,false,18,12,-6,41.94907,-87.64863
TA1307000126,6,14,false,11,37,26,41.94936,-87.65451
TA1307000150,6,14,false,15,19,4,41.94945,-87.64646
13319,6,14,false,11,6,-5,41.95069,-87.6687
TA1307000127,6,14,false,11,22,11,41.9508,-87.65918
13323,6,14,false,7,10,3,41.95282,-87.65
13063,6,14,false,8,15,7,41.95424,-87.65441
TA1308000022,6,14,false,21,18,-3,41.95438,-87.64805
TA1309000026,6,14,false,5,3,-2,41.95601,-87.6802
TA1308000047,6,14,false,7,4,-3,41.95709,-87.6642
13379,6,14,false,10,13,3,41.95786,-87.6495
TA1309000018,6,14,false,3,6,3,41.95791,-87.67357
TA1309000027,6,14,false,5,7,2,41.9585,-87.65499
13389,6,14,false,17,15,-2,41.961,-87.64958
TA1307000144,6,14,false,1,5,4,41.96142,-87.6762
TA1307000107,6,14,false,6,21,15,41.96164,-87.65464
TA1307000156,6,14,false,1,9,8,41.96301,-87.68479
TA1308000012,6,14,false,56,32,-24,41.96398,-87.63818
13074,6,14,false,3,11,8,41.96521,-87.6582
639,6,14,false,6,6,0,41.96584,-87.64538
TA1309000014,6,14,false,5,9,4,41.96709,-87.66744
TA1307000119,6,14,false,7,5,-2,41.96796,-87.65
TA1308000021,6,14,false,4,8,4,41.96883,-87.65765
TA1309000066,6,14,false,2,5,3,41.9691,-87.67423
KA1504000171,6,14,false,10,8,-2,41.97161,-87.65016
TA1309000035,6,14,false,9,9,0,41.97335,-87.66785
13108,6,14,false,9,12,3,41.97379,-87.65971
KA1504000146,6,14,false,8,9,1,41.978,-87.66805
KA1504000152,6,14,false,26,23,-3,41.98403,-87.65231
15575,6,14,false,3,9,6,41.98975,-87.66014
15571,6,14,false,6,20,14,41.99478,-87.66028
523,6,14,false,2,5,3,42.02089,-87.66505
596,6,14,false,7,1,-6,42.04822,-87.68348
E008,6,14,false,6,9,3,42.05049,-87.67782
604,6,14,false,5,1,-4,42.05824,-87.67744
KA1503000014,6,14,true,5,2,-3,41.7851,-87.60108
KA1503000071,6,14,true,7,10,3,41.79148,-87.59988
TA1309000063,6,14,true,6,4,-2,41.79325,-87.5878
KA1504000076,6,14,true,1,7,6,41.7943,-87.60145
TA1308000009,6,14,true,7,6,-1,41.79522,-87.58075
KA1503000052,6,14,true,5,4,-1,41.79935,-87.60097
TA1309000037,6,14,true,7,10,3,41.79957,-87.59474
KA1503000007,6,14,true,4,6,2,41.80242,-87.58689
TA1309000067,6,14,true,5,2,-3,41.80303,-87.60661
13216,6,14,true,4,7,3,41.83473,-87.62581
TA1308000046,6,14,true,4,5,1,41.83779,-87.65115
TA1305000001,6,14,true,1,5,4,41.85262,-87.6265
13075,6,14,true,5,5,0,41.8531,-87.63192
15545,6,14,true,15,11,-4,41.85627,-87.61334
13135,6,14,true,6,3,-3,41.85753,-87.66157
13102,6,14,true,3,6,3,41.85762,-87.61942
13150,6,14,true,7,5,-2,41.85783,-87.62455
13163,6,14,true,5,3,-2,41.85808,-87.65108
13164,6,14,true,3,6,3,41.85818,-87.65648
SL-012,6,14,true,8,5,-3,41.86038,-87.62581
13304,6,14,true,5,1,-4,41.86126,-87.65659
13431,6,14,true,10,12,2,41.8661,-87.60728
KA1504000101,6,14,true,5,2,-3,41.86651,-87.68466
WL-008,6,14,true,3,5,2,41.86712,-87.64108
TA1305000002,6,14,true,9,8,-1,41.86721,-87.62597
15544,6,14,true,6,8,2,41.86723,-87.61536
KA1706005007,6,14,true,4,5,1,41.86749,-87.63219
SL-005,6,14,true,8,14,6,41.8679,-87.62304
644,6,14,true,9,5,-4,41.86859,-87.68625
13139,6,14,true,7,4,-3,41.86893,-87.65913
13285,6,14,true,10,9,-1,41.86928,-87.67372
13160,6,14,true,5,4,-1,41.86947,-87.65548
TA1309000010,6,14,true,16,14,-2,41.87074,-87.62574
TA1309000064,6,14,true,5,3,-2,41.87127,-87.67369
TA1307000130,6,14,true,7,8,1,41.87178,-87.65103
TA1307000121,6,14,true,3,8,5,41.87184,-87.64664
SL-008,6,14,true,7,10,3,41.87209,-87.62956
13332,6,14,true,5,5,0,41.87219,-87.6615
SL-011,6,14,true,10,10,0,41.87256,-87.63356
SL-007,6,14,true,2,5,3,41.87404,-87.6277
13028,6,14,true,5,4,-1,41.87475,-87.64981
15541,6,14,true,10,2,-8,41.8758,-87.62086
13037,6,14,true,5,5,0,41.87588,-87.64078
15539,6,14,true,3,10,7,41.87763,-87.64405
13158,6,14,true,5,9,4,41.87764,-87.64957
13157,6,14,true,10,6,-4,41.87773,-87.6548
TA1305000025,6,14,true,5,11,6,41.87773,-87.63528
TA1309000002,6,14,true,6,3,-3,41.87784,-87.62408
TA1309000004,6,14,true,3,5,2,41.87811,-87.63184
638,6,14,true,10,2,-8,41.87827,-87.64078
13011,6,14,true,5,8,3,41.87931,-87.63993
WL-011,6,14,true,8,2,-6,41.88034,-87.64273
13156,6,14,true,2,7,5,41.88042,-87.65554
13300,6,14,true,17,20,3,41.88097,-87.61675
13008,6,14,true,12,7,-5,41.88105,-87.62408
TA1305000006,6,14,true,6,6,0,41.88122,-87.6296
TA1307000120,6,14,true,21,14,-7,41.88188,-87.64879
13341,6,14,true,1,7,6,41.88208,-87.63985
TA1305000032,6,14,true,7,10,3,41.88218,-87.64109
13353,6,14,true,3,9,6,41.88283,-87.6612
13409,6,14,true,10,7,-3,41.8831,-87.6511
WL-012,6,14,true,8,4,-4,41.88337,-87.6412
13053,6,14,true,16,12,-4,41.88365,-87.64863
13001,6,14,true,6,12,6,41.88397,-87.62459
13155,6,14,true,5,6,1,41.88407,-87.65689
18062,6,14,true,5,5,0,41.88412,-87.65427
TA1306000010,6,14,true,7,6,-1,41.88419,-87.62961
15535,6,14,true,6,3,-3,41.8846,-87.64455
TA1305000029,6,14,true,8,11,3,41.88466,-87.62787
13263,6,14,true,2,10,8,41.88467,-87.61952
TA1306000015,6,14,true,5,6,1,41.88549,-87.65232
13021,6,14,true,6,9,3,41.88559,-87.64184
13073,6,14,true,1,8,7,41.88592,-87.66717
KA1503000012,6,14,true,7,7,0,41.88599,-87.63089
TA1305000011,6,14,true,7,11,4,41.886,-87.62418
15534,6,14,true,6,8,2,41.88627,-87.61749
13197,6,14,true,5,3,-2,41.8866,-87.65816
KA1503000064,6,14,true,13,18,5,41.88697,-87.61281
TA1305000022,6,14,true,11,8,-3,41.88817,-87.63656
TA1306000003,6,14,true,15,14,-1,41.88867,-87.64442
KA1503000043,6,14,true,10,15,5,41.88918,-87.63851
13050,6,14,true,9,12,3,41.88919,-87.62775
TA1307000151,6,14,true,5,10,5,41.88993,-87.63427
Hubbard Bike-checking (LBS-WH-TEST),6,14,true,5,1,-4,41.88995,-87.68034
636,6,14,true,7,2,-5,41.88997,-87.63662
KA1503000044,6,14,true,3,6,3,41.89018,-87.6262
13430,6,14,true,9,2,-7,41.89077,-87.63169
TA1306000013,6,14,true,10,12,2,41.89083,-87.61852
RN-,6,14,true,9,12,3,41.89102,-87.63546
13434,6,14,true,5,1,-4,41.89108,-87.66663
TA1307000117,6,14,true,9,13,4,41.89144,-87.62675
13033,6,14,true,12,11,-1,41.8916,-87.64835
13194,6,14,true,6,10,4,41.8918,-87.65878
TA1305000003,6,14,true,14,14,0,41.89187,-87.62061
13022,6,14,true,41,30,-11,41.89227,-87.61205
TA1306000029,6,14,true,4,15,11,41.89256,-87.61449
13265,6,14,true,8,12,4,41.89383,-87.64172
13045,6,14,true,13,18,5,41.89403,-87.62931
13016,6,14,true,4,6,2,41.89431,-87.62277
KA1503000041,6,14,true,7,12,5,41.89452,-87.61798
13196,6,14,true,4,6,2,41.89455,-87.65345
TA1307000062,6,14,true,1,6,5,41.89466,-87.63839
TA1306000012,6,14,true,17,17,0,41.89475,-87.63438
KP1705001026,6,14,true,11,7,-4,41.89483,-87.6323
637,6,14,true,4,9,5,41.89563,-87.67209
13132,6,14,true,1,10,9,41.89573,-87.67718
15530,6,14,true,13,4,-9,41.89575,-87.62596
18003,6,14,true,3,7,4,41.89575,-87.62011
13247,6,14,true,5,1,-4,41.89597,-87.66775
13289,6,14,true,8,5,-3,41.89638,-87.661
13303,6,14,true,6,7,1,41.89672,-87.63088
13017,6,14,true,5,6,1,41.89676,-87.6357
13338,6,14,true,5,5,0,41.89697,-87.62173
TA1307000061,6,14,true,6,4,-2,41.89745,-87.62873
TA1306000009,6,14,true,6,4,-2,41.89772,-87.64299
620,6,14,true,8,3,-5,41.89817,-87.63754
15529,6,14,true,5,13,8,41.89858,-87.62206
TA1307000128,6,14,true,10,21,11,41.89896,-87.6299
657,6,14,true,5,3,-2,41.89918,-87.6722
KA1504000117,6,14,true,2,5,3,41.89936,-87.64848
13248,6,14,true,7,4,-3,41.89964,-87.66788
TA1306000011,6,14,true,6,5,-1,41.89994,-87.63443
KA1504000116,6,14,true,7,7,0,41.90023,-87.64299
13290,6,14,true,5,5,0,41.90069,-87.66259
13042,6,14,true,30,23,-7,41.90097,-87.62377
KA1504000133,6,14,true,12,7,-5,41.90234,-87.62773
13241,6,14,true,4,6,2,41.9029,-87.68731
TA1307000039,6,14,true,14,20,6,41.90294,-87.63137
13256,6,14,true,6,3,-3,41.90302,-87.69749
TA1305000034,6,14,true,5,7,2,41.90313,-87.67391
KA1504000135,6,14,true,21,21,0,41.90319,-87.63439
13061,6,14,true,23,15,-8,41.90342,-87.66779
KA1504000079,6,14,true,7,5,-2,41.9035,-87.64334
TA1307000115,6,14,true,4,5,1,41.9046,-87.64056
TA1308000049,6,14,true,15,19,4,41.90672,-87.6349
KA1504000134,6,14,true,11,11,0,41.90687,-87.6262
13224,6,14,true,2,6,4,41.90706,-87.66725
TA1307000143,6,14,true,7,4,-3,41.90762,-87.63854
13221,6,14,true,4,8,4,41.90765,-87.67254
TA1309000024,6,14,true,13,14,1,41.908,-87.63152
TA1305000041,6,14,true,16,17,1,41.9094,-87.67769
331,6,14,true,8,9,1,41.90965,-87.64812
TA1305000037,6,14,true,11,11,0,41.91018,-87.67003
TA1306000008,6,14,true,4,5,1,41.9102,-87.6435
13154,6,14,true,15,16,1,41.91054,-87.65312
13058,6,14,true,12,11,-1,41.91059,-87.64942
TA1307000038,6,14,true,4,6,2,41.91138,-87.63868
LF-005,6,14,true,53,82,29,41.91172,-87.62681
13128,6,14,true,8,12,4,41.91197,-87.63197
TA1308000050,6,14,true,28,24,-4,41.91211,-87.6347
13243,6,14,true,8,8,0,41.91262,-87.6814
TA1306000032,6,14,true,10,9,-1,41.9137,-87.65285
TA1307000166,6,14,true,3,8,5,41.91386,-87.64877
18067,6,14,true,7,10,3,41.9146,-87.66796
TA1306000007,6,14,true,6,2,-4,41.91469,-87.64333
13068,6,14,true,7,5,-2,41.91554,-87.68703
13179,6,14,true,29,27,-2,41.9157,-87.63461
13133,6,14,true,2,10,8,41.91598,-87.67733
13266,6,14,true,6,2,-4,41.91774,-87.69142
TA1309000029,6,14,true,3,7,4,41.9178,-87.68245
TA1309000006,6,14,true,10,9,-1,41.91809,-87.64375
TA1307000163,6,14,true,5,21,16,41.91821,-87.65696
13146,6,14,true,41,29,-12,41.91831,-87.63629
13059,6,14,true,16,13,-3,41.91845,-87.65222
13259,6,14,true,1,5,4,41.91852,-87.69744
13192,6,14,true,12,13,1,41.91995,-87.64884
13242,6,14,true,7,2,-5,41.92021,-87.69266
TA1309000030,6,14,true,10,4,-6,41.92077,-87.66372
TA1309000033,6,14,true,8,10,2,41.92158,-87.65381
13193,6,14,true,19,27,8,41.92182,-87.64412
13191,6,14,true,10,13,3,41.92217,-87.63891
13084,6,14,true,1,8,7,41.92268,-87.69715
LP-,6,14,true,22,15,-7,41.92396,-87.63584
TA1307000001,6,14,true,7,16,9,41.92535,-87.66581
TA1306000026,6,14,true,11,9,-2,41.92558,-87.65842
TA1306000016,6,14,true,5,9,4,41.9256,-87.65371
TA1309000019,6,14,true,26,26,0,41.92586,-87.63897
TA1309000058,6,14,true,18,16,-2,41.92591,-87.64927
TA1308000001,6,14,true,33,19,-14,41.92627,-87.63086
13124,6,14,true,5,5,0,41.92675,-87.63444
TA1309000023,6,14,true,5,4,-1,41.9287,-87.65383
TA1307000113,6,14,true,6,7,1,41.92878,-87.66391
13296,6,14,true,5,5,0,41.92883,-87.66852
TA1309000059,6,14,true,11,11,0,41.92889,-87.65898
TA1309000061,6,14,true,11,12,1,41.92915,-87.64909
TA1308000031,6,14,true,2,5,3,41.92946,-87.68417
TA1305000014,6,14,true,18,21,3,41.92956,-87.64313
13085,6,14,true,7,6,-1,41.92958,-87.70789
TA1307000142,6,14,true,11,13,2,41.93125,-87.64432
13276,6,14,true,9,18,9,41.93132,-87.63874
13271,6,14,true,5,2,-3,41.93192,-87.67784
TA1307000064,6,14,true,10,11,1,41.93222,-87.65864
TA1306000014,6,14,true,9,8,-1,41.93242,-87.65271
TA1309000039,6,14,true,13,31,18,41.93258,-87.63642
13294,6,14,true,5,4,-1,41.9326,-87.66595
TA1309000036,6,14,true,12,11,-1,41.93313,-87.64776
TA1307000006,6,14,true,13,6,-7,41.93571,-87.6636
13269,6,14,true,6,2,-4,41.93609,-87.66983
TA1307000052,6,14,true,5,8,3,41.93628,-87.65266
TA1307000136,6,14,true,13,11,-2,41.9365,-87.64755
TA1307000041,6,14,true,30,24,-6,41.93669,-87.63683
13137,6,14,true,20,18,-2,41.9376,-87.6441
TA1309000042,6,14,true,8,5,-3,41.93937,-87.66836
13229,6,14,true,4,7,3,41.93946,-87.66376
TA1308000019,6,14,true,6,8,2,41.93973,-87.65886
13277,6,14,true,7,14,7,41.9401,-87.64546
TA1307000134,6,14,true,10,7,-3,41.94016,-87.65303
TA1309000049,6,14,true,19,25,6,41.94077,-87.63919
TA1307000138,6,14,true,6,2,-4,41.94334,-87.67094
TA1309000025,6,14,true,12,11,-1,41.94368,-87.64894
13071,6,14,true,10,17,7,41.94373,-87.66401
632,6,14,true,7,13,6,41.94453,-87.6547
13278,6,14,true,18,10,-8,41.94553,-87.64644
13235,6,14,true,6,13,7,41.94814,-87.66396
13253,6,14,true,2,5,3,41.9488,-87.67527
13325,6,14,true,13,16,3,41.94907,-87.64863
TA1307000126,6,14,true,5,20,15,41.94936,-87.65451
TA1307000150,6,14,true,18,15,-3,41.94945,-87.64646
13319,6,14,true,4,6,2,41.95069,-87.6687
TA1307000127,6,14,true,6,9,3,41.9508,-87.65918
13323,6,14,true,4,7,3,41.95282,-87.65
TA1309000043,6,14,true,2,8,6,41.95417,-87.66434
13063,6,14,true,8,8,0,41.95424,-87.65441
TA1308000022,6,14,true,4,11,7,41.95438,-87.64805
TA1307000149,6,14,true,7,3,-4,41.95467,-87.67392
TA1308000047,6,14,true,8,9,1,41.95709,-87.6642
13379,6,14,true,15,11,-4,41.95786,-87.6495
TA1309000027,6,14,true,6,5,-1,41.9585,-87.65499
13389,6,14,true,9,8,-1,41.961,-87.64958
TA1309000021,6,14,true,5,1,-4,41.9615,-87.6714
KA1503000022,6,14,true,2,5,3,41.96158,-87.66609
TA1307000107,6,14,true,9,5,-4,41.96164,-87.65464
TA1307000156,6,14,true,6,6,0,41.96301,-87.68479
TA1308000012,6,14,true,25,24,-1,41.96398,-87.63818
13074,6,14,true,9,8,-1,41.96521,-87.6582
639,6,14,true,12,9,-3,41.96584,-87.64538
TA1309000014,6,14,true,13,7,-6,41.96709,-87.66744
TA1307000119,6,14,true,2,6,4,41.96796,-87.65
TA1309000066,6,14,true,5,8,3,41.9691,-87.67423
TA1309000041,6,14,true,7,14,7,41.96951,-87.65471
KA1504000171,6,14,true,5,8,3,41.97161,-87.65016
TA1309000035,6,14,true,10,11,1,41.97335,-87.66785
13108,6,14,true,3,15,12,41.97379,-87.65971
KA1504000149,6,14,true,6,2,-4,41.97562,-87.67945
KA1504000146,6,14,true,14,11,-3,41.978,-87.66805
13109,6,14,true,1,6,5,41.97835,-87.65976
655,6,14,true,3,5,2,41.97987,-87.68194
KA1504000152,6,14,true,14,7,-7,41.98403,-87.65231
15575,6,14,true,4,6,2,41.98975,-87.66014
15571,6,14,true,5,6,1,41.99478,-87.66028
RP-009,6,14,true,5,7,2,42.00107,-87.66122
20232,6,15,false,5,2,-3,41.68588,-87.57378
KA1503000074,6,15,false,6,12,6,41.79174,-87.58395
TA1309000063,6,15,false,2,5,3,41.79325,-87.5878
KA1504000076,6,15,false,5,3,-2,41.7943,-87.60145
TA1308000009,6,15,false,14,12,-2,41.79522,-87.58075
KA1503000052,6,15,false,5,4,-1,41.79935,-87.60097
KA1503000059,6,15,false,9,9,0,41.79952,-87.58643
TA1309000037,6,15,false,9,3,-6,41.79957,-87.59474
KA1503000007,6,15,false,5,7,2,41.80242,-87.58689
KA1503000004,6,15,false,10,12,2,41.83127,-87.6088
TA1307000048,6,15,false,11,18,7,41.83855,-87.60821
TA1305000004,6,15,false,7,1,-6,41.8514,-87.61884
TA1305000001,6,15,false,5,4,-1,41.85262,-87.6265
13075,6,15,false,5,14,9,41.8531,-87.63192
15545,6,15,false,11,7,-4,41.85627,-87.61334
13135,6,15,false,2,5,3,41.85753,-87.66157
13102,6,15,false,5,9,4,41.85762,-87.61942
13164,6,15,false,1,7,6,41.85818,-87.65648
SL-012,6,15,false,6,3,-3,41.86038,-87.62581
TA1307000124,6,15,false,9,7,-2,41.86411,-87.62372
13029,6,15,false,32,9,-23,41.86531,-87.6179
13431,6,15,false,19,23,4,41.8661,-87.60728
TA1305000002,6,15,false,7,16,9,41.86721,-87.62597
15544,6,15,false,76,54,-22,41.86723,-87.61536
KA1706005007,6,15,false,7,8,1,41.86749,-87.63219
SL-005,6,15,false,25,17,-8,41.8679,-87.62304
13139,6,15,false,3,6,3,41.86893,-87.65913
13160,6,15,false,9,4,-5,41.86947,-87.65548
TA1309000010,6,15,false,6,7,1,41.87074,-87.62574
SL-009,6,15,false,3,7,4,41.87081,-87.63121
SL-008,6,15,false,14,21,7,41.87209,-87.62956
13332,6,15,false,4,5,1,41.87219,-87.6615
623,6,15,false,10,17,7,41.87272,-87.62399
SL-007,6,15,false,5,12,7,41.87404,-87.6277
15541,6,15,false,31,31,0,41.8758,-87.62086
13037,6,15,false,5,3,-2,41.87588,-87.64078
TA1305000010,6,15,false,8,7,-1,41.87623,-87.62444
TA1305000035,6,15,false,11,16,5,41.87716,-87.62787
13158,6,15,false,7,11,4,41.87764,-87.64957
13157,6,15,false,8,4,-4,41.87773,-87.6548
TA1305000025,6,15,false,7,4,-3,41.87773,-87.63528
TA1309000002,6,15,false,16,24,8,41.87784,-87.62408
638,6,15,false,3,6,3,41.87827,-87.64078
13011,6,15,false,8,2,-6,41.87931,-87.63993
TA1309000008,6,15,false,10,4,-6,41.87933,-87.6355
KA1503000015,6,15,false,12,16,4,41.87948,-87.6257
TA1309000007,6,15,false,1,9,8,41.88022,-87.63526
WL-011,6,15,false,9,5,-4,41.88034,-87.64273
13156,6,15,false,5,13,8,41.88042,-87.65554
13300,6,15,false,47,60,13,41.88097,-87.61675
13008,6,15,false,76,104,28,41.88105,-87.62408
TA1307000120,6,15,false,17,22,5,41.88188,-87.64879
13341,6,15,false,5,2,-3,41.88208,-87.63985
13036,6,15,false,11,13,2,41.8821,-87.62513
TA1305000032,6,15,false,11,8,-3,41.88218,-87.64109
13353,6,15,false,1,7,6,41.88283,-87.6612
13409,6,15,false,11,12,1,41.8831,-87.6511
WL-012,6,15,false,6,2,-4,41.88337,-87.6412
13053,6,15,false,20,18,-2,41.88365,-87.64863
13001,6,15,false,24,16,-8,41.88397,-87.62459
18062,6,15,false,6,3,-3,41.88412,-87.65427
TA1306000010,6,15,false,9,7,-2,41.88419,-87.62961
TA1305000030,6,15,false,9,10,1,41.88459,-87.63178
15535,6,15,false,3,9,6,41.8846,-87.64455
TA1305000029,6,15,false,22,21,-1,41.88466,-87.62787
13263,6,15,false,21,23,2,41.88467,-87.61952
TA1306000015,6,15,false,16,19,3,41.88549,-87.65232
13021,6,15,false,6,3,-3,41.88559,-87.64184
TA1307000111,6,15,false,6,9,3,41.88582,-87.63548
13073,6,15,false,5,5,0,41.88592,-87.66717
KA17018054,6,15,false,1,5,4,41.88595,-87.67701
KA1503000012,6,15,false,4,9,5,41.88599,-87.63089
TA1305000011,6,15,false,28,16,-12,41.886,-87.62418
15534,6,15,false,17,11,-6,41.88627,-87.61749
TA1308000029,6,15,false,6,12,6,41.88673,-87.62225
TA1307000131,6,15,false,14,22,8,41.88688,-87.62606
KA1503000064,6,15,false,34,28,-6,41.88697,-87.61281
TA1305000022,6,15,false,6,1,-5,41.88817,-87.63656
TA1306000003,6,15,false,11,8,-3,41.88867,-87.64442
KA1503000043,6,15,false,7,14,7,41.88918,-87.63851
13050,6,15,false,12,27,15,41.88919,-87.62775
TA1307000151,6,15,false,16,14,-2,41.88993,-87.63427
636,6,15,false,4,6,2,41.88997,-87.63662
KA1503000044,6,15,false,2,7,5,41.89018,-87.6262
13427,6,15,false,17,10,-7,41.89054,-87.62205
13430,6,15,false,29,15,-14,41.89077,-87.63169
TA1306000013,6,15,false,21,28,7,41.89083,-87.61852
RN-,6,15,false,9,8,-1,41.89102,-87.63546
TA1307000117,6,15,false,37,44,7,41.89144,-87.62675
13033,6,15,false,13,15,2,41.8916,-87.64835
13194,6,15,false,11,7,-4,41.8918,-87.65878
TA1305000003,6,15,false,16,34,18,41.89187,-87.62061
13022,6,15,false,194,182,-12,41.89227,-87.61205
TA1306000029,6,15,false,42,46,4,41.89256,-87.61449
13265,6,15,false,8,7,-1,41.89383,-87.64172
13045,6,15,false,14,16,2,41.89403,-87.62931
13016,6,15,false,16,15,-1,41.89431,-87.62277
KA1503000041,6,15,false,16,24,8,41.89452,-87.61798
13196,6,15,false,9,4,-5,41.89455,-87.65345
TA1307000062,6,15,false,3,8,5,41.89466,-87.63839
TA1306000012,6,15,false,23,30,7,41.89475,-87.63438
KP1705001026,6,15,false,7,19,12,41.89483,-87.6323
637,6,15,false,7,3,-4,41.89563,-87.67209
13132,6,15,false,6,4,-2,41.89573,-87.67718
15530,6,15,false,21,9,-12,41.89575,-87.62596
18003,6,15,false,2,6,4,41.89575,-87.62011
13247,6,15,false,2,8,6,41.89597,-87.66775
TA1305000020,6,15,false,8,3,-5,41.89636,-87.65406
13303,6,15,false,11,10,-1,41.89672,-87.63088
13017,6,15,false,5,5,0,41.89676,-87.6357
13338,6,15,false,13,14,1,41.89697,-87.62173
TA1307000061,6,15,false,8,3,-5,41.89745,-87.62873
13034,6,15,false,31,33,2,41.89754,-87.62352
TA1306000009,6,15,false,7,10,3,41.89772,-87.64299
620,6,15,false,13,9,-4,41.89817,-87.63754
KA1504000103,6,15,false,3,12,9,41.89842,-87.68659
15529,6,15,false,13,12,-1,41.89858,-87.62206
TA1307000128,6,15,false,33,28,-5,41.89896,-87.6299
TA1306000011,6,15,false,2,8,6,41.89994,-87.63443
13290,6,15,false,8,7,-1,41.90069,-87.66259
13042,6,15,false,84,90,6,41.90097,-87.62377
KA1504000133,6,15,false,20,11,-9,41.90234,-87.62773
TA1306000006,6,15,false,7,8,1,41.90292,-87.63772
TA1307000039,6,15,false,29,18,-11,41.90294,-87.63137
658,6,15,false,6,5,-1,41.903,-87.6838
13256,6,15,false,4,5,1,41.90302,-87.69749
TA1305000034,6,15,false,11,12,1,41.90313,-87.67391
KA1504000135,6,15,false,24,32,8,41.90319,-87.63439
13136,6,15,false,3,6,3,41.90326,-87.67845
13061,6,15,false,22,15,-7,41.90342,-87.66779
KA1504000079,6,15,false,20,5,-15,41.9035,-87.64334
TA1307000115,6,15,false,5,5,0,41.9046,-87.64056
TA1308000049,6,15,false,30,25,-5,41.90672,-87.6349
KA1504000134,6,15,false,21,13,-8,41.90687,-87.6262
TA1307000143,6,15,false,6,6,0,41.90762,-87.63854
13221,6,15,false,19,4,-15,41.90765,-87.67254
TA1309000024,6,15,false,19,17,-2,41.908,-87.63152
TA1305000041,6,15,false,23,21,-2,41.9094,-87.67769
331,6,15,false,12,16,4,41.90965,-87.64812
TA1305000037,6,15,false,5,2,-3,41.91018,-87.67003
TA1306000008,6,15,false,7,2,-5,41.9102,-87.6435
13258,6,15,false,6,4,-2,41.91043,-87.69718
13257,6,15,false,6,8,2,41.91054,-87.68956
13154,6,15,false,7,5,-2,41.91054,-87.65312
13058,6,15,false,17,15,-2,41.91059,-87.64942
TA1307000038,6,15,false,11,19,8,41.91138,-87.63868
LF-005,6,15,false,156,147,-9,41.91172,-87.62681
13128,6,15,false,20,15,-5,41.91197,-87.63197
TA1308000050,6,15,false,31,39,8,41.91211,-87.6347
13243,6,15,false,6,11,5,41.91262,-87.6814
TA1306000032,6,15,false,8,11,3,41.9137,-87.65285
TA1307000166,6,15,false,5,10,5,41.91386,-87.64877
18017,6,15,false,6,3,-3,41.91416,-87.71676
18067,6,15,false,17,5,-12,41.9146,-87.66796
13179,6,15,false,44,32,-12,41.9157,-87.63461
13133,6,15,false,7,8,1,41.91598,-87.67733
15650,6,15,false,1,8,7,41.91711,-87.71023
TA1309000029,6,15,false,5,5,0,41.9178,-87.68245
TA1309000006,6,15,false,12,11,-1,41.91809,-87.64375
TA1307000163,6,15,false,4,5,1,41.91821,-87.65696
13146,6,15,false,56,34,-22,41.91831,-87.63629
13059,6,15,false,22,27,5,41.91845,-87.65222
13192,6,15,false,9,10,1,41.91995,-87.64884
13288,6,15,false,4,7,3,41.92008,-87.67788
TA1309000030,6,15,false,7,8,1,41.92077,-87.66372
TA1309000033,6,15,false,8,16,8,41.92158,-87.65381
13193,6,15,false,26,25,-1,41.92182,-87.64412
13191,6,15,false,9,5,-4,41.92217,-87.63891
13084,6,15,false,11,5,-6,41.92268,-87.69715
LP-,6,15,false,9,9,0,41.92396,-87.63584
TA1307000001,6,15,false,3,7,4,41.92535,-87.66581
TA1306000026,6,15,false,6,14,8,41.92558,-87.65842
TA1306000016,6,15,false,10,10,0,41.9256,-87.65371
TA1309000019,6,15,false,25,30,5,41.92586,-87.63897
TA1309000058,6,15,false,19,19,0,41.92591,-87.64927
TA1308000001,6,15,false,65,63,-2,41.92627,-87.63086
13124,6,15,false,14,9,-5,41.92675,-87.63444
TA1309000023,6,15,false,20,13,-7,41.9287,-87.65383
TA1307000113,6,15,false,3,11,8,41.92878,-87.66391
13296,6,15,false,8,6,-2,41.92883,-87.66852
TA1309000059,6,15,false,4,9,5,41.92889,-87.65898
TA1309000061,6,15,false,17,12,-5,41.92915,-87.64909
TA1308000031,6,15,false,9,9,0,41.92946,-87.68417
TA1305000014,6,15,false,16,18,2,41.92956,-87.64313
13085,6,15,false,12,12,0,41.92958,-87.70789
TA1307000142,6,15,false,19,13,-6,41.93125,-87.64432
13276,6,15,false,26,25,-1,41.93132,-87.63874
TA1307000064,6,15,false,5,10,5,41.93222,-87.65864
TA1306000014,6,15,false,9,5,-4,41.93242,-87.65271
TA1309000039,6,15,false,21,26,5,41.93258,-87.63642
13294,6,15,false,9,4,-5,41.9326,-87.66595
TA1309000036,6,15,false,5,5,0,41.93313,-87.64776
TA1307000006,6,15,false,11,10,-1,41.93571,-87.6636
TA1307000052,6,15,false,2,18,16,41.93628,-87.65266
TA1307000136,6,15,false,10,12,2,41.9365,-87.64755
TA1307000041,6,15,false,29,28,-1,41.93669,-87.63683
13137,6,15,false,25,21,-4,41.9376,-87.6441
15642,6,15,false,5,4,-1,41.93843,-87.69801
KA17018068,6,15,false,5,1,-4,41.93935,-87.68327
TA1309000042,6,15,false,5,4,-1,41.93937,-87.66836
13229,6,15,false,2,8,6,41.93946,-87.66376
TA1308000019,6,15,false,11,10,-1,41.93973,-87.65886
13277,6,15,false,12,19,7,41.9401,-87.64546
TA1307000134,6,15,false,16,21,5,41.94016,-87.65303
13143,6,15,false,5,1,-4,41.94059,-87.67853
TA1309000049,6,15,false,26,25,-1,41.94077,-87.63919
TA1307000138,6,15,false,10,6,-4,41.94334,-87.67094
13144,6,15,false,1,6,5,41.9434,-87.67964
TA1309000025,6,15,false,16,25,9,41.94368,-87.64894
13071,6,15,false,22,19,-3,41.94373,-87.66401
632,6,15,false,28,20,-8,41.94453,-87.6547
13278,6,15,false,9,14,5,41.94553,-87.64644
TA1309000050,6,15,false,7,1,-6,41.94618,-87.67331
KA1504000143,6,15,false,1,5,4,41.94664,-87.68337
13235,6,15,false,6,14,8,41.94814,-87.66396
13325,6,15,false,7,14,7,41.94907,-87.64863
TA1307000126,6,15,false,31,18,-13,41.94936,-87.65451
TA1307000150,6,15,false,12,21,9,41.94945,-87.64646
13319,6,15,false,8,3,-5,41.95069,-87.6687
TA1307000127,6,15,false,13,9,-4,41.9508,-87.65918
13323,6,15,false,10,6,-4,41.95282,-87.65
13063,6,15,false,10,7,-3,41.95424,-87.65441
TA1308000022,6,15,false,27,22,-5,41.95438,-87.64805
TA1308000047,6,15,false,2,7,5,41.95709,-87.6642
13379,6,15,false,7,5,-2,41.95786,-87.6495
TA1309000027,6,15,false,6,1,-5,41.9585,-87.65499
13389,6,15,false,11,13,2,41.961,-87.64958
TA1307000144,6,15,false,5,1,-4,41.96142,-87.6762
TA1307000107,6,15,false,7,11,4,41.96164,-87.65464
TA1308000012,6,15,false,28,38,10,41.96398,-87.63818
13074,6,15,false,7,3,-4,41.96521,-87.6582
639,6,15,false,18,15,-3,41.96584,-87.64538
TA1307000158,6,15,false,2,6,4,41.9671,-87.67904
TA1307000119,6,15,false,8,6,-2,41.96796,-87.65
TA1309000066,6,15,false,6,3,-3,41.9691,-87.67423
TA1309000041,6,15,false,4,6,2,41.96951,-87.65471
KA1504000171,6,15,false,8,6,-2,41.97161,-87.65016
TA1309000035,6,15,false,6,10,4,41.97335,-87.66785
KA1504000146,6,15,false,2,5,3,41.978,-87.66805
13109,6,15,false,13,6,-7,41.97835,-87.65976
KA1504000152,6,15,false,12,15,3,41.98403,-87.65231
15571,6,15,false,6,9,3,41.99478,-87.66028
E002,6,15,false,6,2,-4,42.03256,-87.67912
596,6,15,false,5,7,2,42.04822,-87.68348
E008,6,15,false,9,11,2,42.05049,-87.67782
605,6,15,false,8,3,-5,42.05294,-87.67342
604,6,15,false,6,5,-1,42.05824,-87.67744
TA1307000048,6,15,true,7,5,-2,41.83855,-87.60821
TA1308000036,6,15,true,6,3,-3,41.83883,-87.62186
TA1307000139,6,15,true,7,3,-4,41.84205,-87.61698
13075,6,15,true,5,5,0,41.8531,-87.63192
15545,6,15,true,8,8,0,41.85627,-87.61334
13102,6,15,true,6,4,-2,41.85762,-87.61942
13150,6,15,true,9,7,-2,41.85783,-87.62455
SL-012,6,15,true,5,2,-3,41.86038,-87.62581
TA1307000124,6,15,true,2,5,3,41.86411,-87.62372
13431,6,15,true,2,13,11,41.8661,-87.60728
TA1305000002,6,15,true,10,8,-2,41.86721,-87.62597
15544,6,15,true,9,15,6,41.86723,-87.61536
SL-005,6,15,true,4,7,3,41.8679,-87.62304
644,6,15,true,1,8,7,41.86859,-87.68625
13139,6,15,true,9,6,-3,41.86893,-87.65913
13160,6,15,true,3,6,3,41.86947,-87.65548
TA1309000010,6,15,true,14,15,1,41.87074,-87.62574
TA1307000130,6,15,true,5,3,-2,41.87178,-87.65103
TA1307000121,6,15,true,11,6,-5,41.87184,-87.64664
SL-008,6,15,true,9,7,-2,41.87209,-87.62956
13332,6,15,true,12,12,0,41.87219,-87.6615
623,6,15,true,6,6,0,41.87272,-87.62399
SL-007,6,15,true,6,2,-4,41.87404,-87.6277
SL-010,6,15,true,1,5,4,41.87501,-87.63309
15539,6,15,true,6,8,2,41.87763,-87.64405
13158,6,15,true,6,13,7,41.87764,-87.64957
13157,6,15,true,4,6,2,41.87773,-87.6548
TA1305000025,6,15,true,6,3,-3,41.87773,-87.63528
13206,6,15,true,2,6,4,41.87794,-87.66201
13300,6,15,true,8,8,0,41.88097,-87.61675
13008,6,15,true,11,7,-4,41.88105,-87.62408
TA1305000006,6,15,true,3,5,2,41.88122,-87.6296
TA1307000120,6,15,true,13,14,1,41.88188,-87.64879
13341,6,15,true,5,1,-4,41.88208,-87.63985
TA1305000032,6,15,true,8,8,0,41.88218,-87.64109
13353,6,15,true,5,10,5,41.88283,-87.6612
13409,6,15,true,6,5,-1,41.8831,-87.6511
WL-012,6,15,true,7,2,-5,41.88337,-87.6412
13053,6,15,true,12,16,4,41.88365,-87.64863
13001,6,15,true,4,5,1,41.88397,-87.62459
TA1306000010,6,15,true,5,11,6,41.88419,-87.62961
15535,6,15,true,7,7,0,41.8846,-87.64455
TA1305000029,6,15,true,5,9,4,41.88466,-87.62787
13263,6,15,true,14,13,-1,41.88467,-87.61952
TA1306000015,6,15,true,6,13,7,41.88549,-87.65232
13021,6,15,true,4,5,1,41.88559,-87.64184
KA1503000012,6,15,true,6,3,-3,41.88599,-87.63089
TA1305000011,6,15,true,5,6,1,41.886,-87.62418
TA1308000029,6,15,true,8,1,-7,41.88673,-87.62225
TA1307000131,6,15,true,2,6,4,41.88688,-87.62606
KA1503000064,6,15,true,10,9,-1,41.88697,-87.61281
TA1306000003,6,15,true,15,8,-7,41.88867,-87.64442
KA1503000043,6,15,true,14,11,-3,41.88918,-87.63851
13050,6,15,true,6,10,4,41.88919,-87.62775
TA1307000151,6,15,true,5,11,6,41.88993,-87.63427
636,6,15,true,5,3,-2,41.88997,-87.63662
KA1503000044,6,15,true,5,3,-2,41.89018,-87.6262
13427,6,15,true,3,5,2,41.89054,-87.62205
13430,6,15,true,11,8,-3,41.89077,-87.63169
TA1306000013,6,15,true,11,12,1,41.89083,-87.61852
RN-,6,15,true,11,11,0,41.89102,-87.63546
TA1307000117,6,15,true,15,11,-4,41.89144,-87.62675
13033,6,15,true,13,11,-2,41.8916,-87.64835
13194,6,15,true,6,4,-2,41.8918,-87.65878
TA1305000003,6,15,true,6,9,3,41.89187,-87.62061
13022,6,15,true,28,20,-8,41.89227,-87.61205
TA1306000029,6,15,true,13,14,1,41.89256,-87.61449
13265,6,15,true,4,6,2,41.89383,-87.64172
13045,6,15,true,10,7,-3,41.89403,-87.62931
13016,6,15,true,6,4,-2,41.89431,-87.62277
KA1503000041,6,15,true,5,12,7,41.89452,-87.61798
13196,6,15,true,7,5,-2,41.89455,-87.65345
TA1306000012,6,15,true,23,13,-10,41.89475,-87.63438
KP1705001026,6,15,true,6,11,5,41.89483,-87.6323
13132,6,15,true,4,6,2,41.89573,-87.67718
15530,6,15,true,12,9,-3,41.89575,-87.62596
13247,6,15,true,5,5,0,41.89597,-87.66775
TA1305000020,6,15,true,6,3,-3,41.89636,-87.65406
13303,6,15,true,4,14,10,41.89672,-87.63088
13338,6,15,true,5,5,0,41.89697,-87.62173
13034,6,15,true,8,7,-1,41.89754,-87.62352
TA1306000009,6,15,true,1,7,6,41.89772,-87.64299
620,6,15,true,3,7,4,41.89817,-87.63754
15529,6,15,true,18,8,-10,41.89858,-87.62206
TA1307000128,6,15,true,15,20,5,41.89896,-87.6299
13290,6,15,true,12,10,-2,41.90069,-87.66259
13042,6,15,true,16,11,-5,41.90097,-87.62377
KA1504000133,6,15,true,9,8,-1,41.90234,-87.62773
TA1307000039,6,15,true,19,16,-3,41.90294,-87.63137
13256,6,15,true,7,1,-6,41.90302,-87.69749
TA1305000034,6,15,true,10,10,0,41.90313,-87.67391
KA1504000135,6,15,true,14,22,8,41.90319,-87.63439
13136,6,15,true,6,2,-4,41.90326,-87.67845
13061,6,15,true,7,13,6,41.90342,-87.66779
KA1504000079,6,15,true,11,7,-4,41.9035,-87.64334
TA1307000115,6,15,true,4,5,1,41.9046,-87.64056
TA1308000049,6,15,true,12,11,-1,41.90672,-87.6349
KA1504000134,6,15,true,8,7,-1,41.90687,-87.6262
13224,6,15,true,6,6,0,41.90706,-87.66725
TA1307000143,6,15,true,8,5,-3,41.90762,-87.63854
13221,6,15,true,9,13,4,41.90765,-87.67254
TA1309000024,6,15,true,15,5,-10,41.908,-87.63152
TA1305000041,6,15,true,17,17,0,41.9094,-87.67769
331,6,15,true,8,14,6,41.90965,-87.64812
TA1305000037,6,15,true,3,7,4,41.91018,-87.67003
TA1306000008,6,15,true,9,5,-4,41.9102,-87.6435
TA1308000005,6,15,true,2,9,7,41.91042,-87.68238
13154,6,15,true,15,8,-7,41.91054,-87.65312
TA1307000038,6,15,true,6,4,-2,41.91138,-87.63868
LF-005,6,15,true,46,53,7,41.91172,-87.62681
13128,6,15,true,9,9,0,41.91197,-87.63197
TA1308000050,6,15,true,27,17,-10,41.91211,-87.6347
13243,6,15,true,9,6,-3,41.91262,-87.6814
TA1306000032,6,15,true,4,6,2,41.9137,-87.65285
TA1307000166,6,15,true,8,3,-5,41.91386,-87.64877
18067,6,15,true,7,5,-2,41.9146,-87.66796
TA1306000007,6,15,true,2,6,4,41.91469,-87.64333
13068,6,15,true,1,6,5,41.91554,-87.68703
13179,6,15,true,21,24,3,41.9157,-87.63461
13133,6,15,true,11,12,1,41.91598,-87.67733
TA1305000039,6,15,true,6,7,1,41.9163,-87.66749
TA1309000029,6,15,true,1,5,4,41.9178,-87.68245
TA1309000006,6,15,true,12,8,-4,41.91809,-87.64375
TA1307000163,6,15,true,6,8,2,41.91821,-87.65696
13146,6,15,true,17,21,4,41.91831,-87.63629
13059,6,15,true,12,15,3,41.91845,-87.65222
13192,6,15,true,9,8,-1,41.91995,-87.64884
13288,6,15,true,6,8,2,41.92008,-87.67788
13242,6,15,true,5,3,-2,41.92021,-87.69266
TA1309000030,6,15,true,3,7,4,41.92077,-87.66372
TA1309000033,6,15,true,8,5,-3,41.92158,-87.65381
13193,6,15,true,15,30,15,41.92182,-87.64412
13191,6,15,true,5,7,2,41.92217,-87.63891
13084,6,15,true,8,4,-4,41.92268,-87.69715
LP-,6,15,true,5,6,1,41.92396,-87.63584
KA1504000090,6,15,true,5,2,-3,41.92483,-87.7145
TA1307000001,6,15,true,9,9,0,41.92535,-87.66581
TA1306000026,6,15,true,11,6,-5,41.92558,-87.65842
TA1306000016,6,15,true,8,8,0,41.9256,-87.65371
TA1309000019,6,15,true,20,23,3,41.92586,-87.63897
TA1309000058,6,15,true,10,11,1,41.92591,-87.64927
TA1308000001,6,15,true,27,21,-6,41.92627,-87.63086
TA1309000023,6,15,true,5,8,3,41.9287,-87.65383
TA1307000113,6,15,true,8,2,-6,41.92878,-87.66391
13296,6,15,true,4,5,1,41.92883,-87.66852
TA1309000061,6,15,true,6,6,0,41.92915,-87.64909
TA1305000014,6,15,true,24,17,-7,41.92956,-87.64313
13085,6,15,true,11,8,-3,41.92958,-87.70789
TA1307000142,6,15,true,16,16,0,41.93125,-87.64432
13276,6,15,true,10,22,12,41.93132,-87.63874
13271,6,15,true,1,6,5,41.93192,-87.67784
TA1307000064,6,15,true,9,10,1,41.93222,-87.65864
TA1306000014,6,15,true,7,12,5,41.93242,-87.65271
TA1309000039,6,15,true,15,9,-6,41.93258,-87.63642
TA1309000036,6,15,true,8,8,0,41.93313,-87.64776
TA1307000006,6,15,true,5,7,2,41.93571,-87.6636
13268,6,15,true,5,4,-1,41.93588,-87.67843
13269,6,15,true,3,5,2,41.93609,-87.66983
TA1307000052,6,15,true,7,8,1,41.93628,-87.65266
TA1307000136,6,15,true,9,7,-2,41.9365,-87.64755
TA1307000041,6,15,true,13,16,3,41.93669,-87.63683
13137,6,15,true,15,18,3,41.9376,-87.6441
TA1309000042,6,15,true,5,12,7,41.93937,-87.66836
TA1308000019,6,15,true,4,5,1,41.93973,-87.65886
13277,6,15,true,11,11,0,41.9401,-87.64546
TA1307000134,6,15,true,12,9,-3,41.94016,-87.65303
TA1309000049,6,15,true,13,18,5,41.94077,-87.63919
TA1307000138,6,15,true,4,6,2,41.94334,-87.67094
TA1309000025,6,15,true,14,16,2,41.94368,-87.64894
13071,6,15,true,15,12,-3,41.94373,-87.66401
632,6,15,true,9,8,-1,41.94453,-87.6547
13278,6,15,true,17,16,-1,41.94553,-87.64644
13235,6,15,true,9,9,0,41.94814,-87.66396
13325,6,15,true,9,11,2,41.94907,-87.64863
TA1307000126,6,15,true,12,7,-5,41.94936,-87.65451
TA1307000150,6,15,true,20,13,-7,41.94945,-87.64646
13319,6,15,true,6,6,0,41.95069,-87.6687
TA1307000127,6,15,true,3,6,3,41.9508,-87.65918
13323,6,15,true,5,6,1,41.95282,-87.65
13063,6,15,true,9,7,-2,41.95424,-87.65441
TA1308000022,6,15,true,13,7,-6,41.95438,-87.64805
TA1309000026,6,15,true,6,2,-4,41.95601,-87.6802
13379,6,15,true,7,6,-1,41.95786,-87.6495
TA1309000027,6,15,true,2,6,4,41.9585,-87.65499
13389,6,15,true,15,4,-11,41.961,-87.64958
15623,6,15,true,2,6,4,41.96154,-87.69117
KA1503000022,6,15,true,4,7,3,41.96158,-87.66609
TA1307000107,6,15,true,12,17,5,41.96164,-87.65464
TA1307000156,6,15,true,5,5,0,41.96301,-87.68479
TA1308000012,6,15,true,12,13,1,41.96398,-87.63818
13074,6,15,true,5,7,2,41.96521,-87.6582
639,6,15,true,6,9,3,41.96584,-87.64538
TA1309000014,6,15,true,2,8,6,41.96709,-87.66744
TA1308000021,6,15,true,5,7,2,41.96883,-87.65765
TA1309000066,6,15,true,8,6,-2,41.9691,-87.67423
TA1309000041,6,15,true,6,4,-2,41.96951,-87.65471
KA1504000171,6,15,true,9,4,-5,41.97161,-87.65016
KA1504000146,6,15,true,11,6,-5,41.978,-87.66805
13109,6,15,true,7,4,-3,41.97835,-87.65976
KA1504000152,6,15,true,10,6,-4,41.98403,-87.65231
15571,6,15,true,6,9,3,41.99478,-87.66028
660,6,15,true,2,7,5,42.00458,-87.66143
598,6,15,true,5,1,-4,42.02578,-87.68411
596,6,15,true,6,3,-3,42.04822,-87.68348
KA1503000074,6,16,false,18,2,-16,41.79174,-87.58395
TA1309000063,6,16,false,3,6,3,41.79325,-87.5878
TA1308000009,6,16,false,11,12,1,41.79522,-87.58075
KA1503000007,6,16,false,9,5,-4,41.80242,-87.58689
TA1307000129,6,16,false,12,5,-7,41.83104,-87.62683
KA1503000004,6,16,false,1,8,7,41.83127,-87.6088
15445,6,16,false,9,1,-8,41.83453,-87.63183
KA1503000038,6,16,false,5,1,-4,41.83845,-87.6354
TA1307000048,6,16,false,15,22,7,41.83855,-87.60821
TA1305000001,6,16,false,6,2,-4,41.85262,-87.6265
13075,6,16,false,10,11,1,41.8531,-87.63192
15545,6,16,false,7,5,-2,41.85627,-87.61334
13135,6,16,false,6,5,-1,41.85753,-87.66157
13102,6,16,false,9,7,-2,41.85762,-87.61942
13150,6,16,false,5,5,0,41.85783,-87.62455
TA1307000044,6,16,false,7,1,-6,41.85794,-87.64083
13164,6,16,false,5,12,7,41.85818,-87.65648
SL-012,6,16,false,7,7,0,41.86038,-87.62581
TA1307000124,6,16,false,9,13,4,41.86411,-87.62372
13029,6,16,false,18,4,-14,41.86531,-87.6179
13431,6,16,false,29,28,-1,41.8661,-87.60728
WL-008,6,16,false,12,6,-6,41.86712,-87.64108
TA1305000002,6,16,false,12,9,-3,41.86721,-87.62597
15544,6,16,false,41,38,-3,41.86723,-87.61536
KA1706005007,6,16,false,1,6,5,41.86749,-87.63219
SL-005,6,16,false,34,22,-12,41.8679,-87.62304
13139,6,16,false,3,6,3,41.86893,-87.65913
TA1309000010,6,16,false,10,10,0,41.87074,-87.62574
SL-009,6,16,false,7,5,-2,41.87081,-87.63121
SL-008,6,16,false,17,9,-8,41.87209,-87.62956
SL-011,6,16,false,4,8,4,41.87256,-87.63356
623,6,16,false,27,18,-9,41.87272,-87.62399
15541,6,16,false,34,22,-12,41.8758,-87.62086
624,6,16,false,11,4,-7,41.87626,-87.62923
TA1305000035,6,16,false,6,8,2,41.87716,-87.62787
13158,6,16,false,10,3,-7,41.87764,-87.64957
13157,6,16,false,4,6,2,41.87773,-87.6548
TA1305000025,6,16,false,14,13,-1,41.87773,-87.63528
TA1309000002,6,16,false,13,18,5,41.87784,-87.62408
638,6,16,false,5,6,1,41.87827,-87.64078
13011,6,16,false,6,16,10,41.87931,-87.63993
KA1503000015,6,16,false,9,4,-5,41.87948,-87.6257
WL-011,6,16,false,9,7,-2,41.88034,-87.64273
13156,6,16,false,15,2,-13,41.88042,-87.65554
13300,6,16,false,75,81,6,41.88097,-87.61675
13008,6,16,false,72,45,-27,41.88105,-87.62408
TA1305000006,6,16,false,11,11,0,41.88122,-87.6296
TA1307000120,6,16,false,21,30,9,41.88188,-87.64879
13341,6,16,false,2,5,3,41.88208,-87.63985
13036,6,16,false,12,10,-2,41.8821,-87.62513
13409,6,16,false,6,4,-2,41.8831,-87.6511
WL-012,6,16,false,11,6,-5,41.88337,-87.6412
13053,6,16,false,16,34,18,41.88365,-87.64863
13001,6,16,false,24,30,6,41.88397,-87.62459
TA1306000010,6,16,false,9,4,-5,41.88419,-87.62961
TA1305000030,6,16,false,13,7,-6,41.88459,-87.63178
15535,6,16,false,14,7,-7,41.8846,-87.64455
TA1305000029,6,16,false,8,14,6,41.88466,-87.62787
13263,6,16,false,41,18,-23,41.88467,-87.61952
TA1306000015,6,16,false,27,11,-16,41.88549,-87.65232
13021,6,16,false,7,9,2,41.88559,-87.64184
TA1307000111,6,16,false,10,2,-8,41.88582,-87.63548
KA17018054,6,16,false,5,6,1,41.88595,-87.67701
KA1503000012,6,16,false,17,15,-2,41.88599,-87.63089
TA1305000011,6,16,false,30,26,-4,41.886,-87.62418
15534,6,16,false,11,14,3,41.88627,-87.61749
TA1308000029,6,16,false,11,9,-2,41.88673,-87.62225
TA1307000131,6,16,false,35,38,3,41.88688,-87.62606
KA1503000064,6,16,false,41,52,11,41.88697,-87.61281
TA1305000022,6,16,false,6,12,6,41.88817,-87.63656
TA1306000003,6,16,false,13,13,0,41.88867,-87.64442
KA1503000043,6,16,false,8,20,12,41.88918,-87.63851
13050,6,16,false,9,11,2,41.88919,-87.62775
TA1307000151,6,16,false,27,27,0,41.88993,-87.63427
13427,6,16,false,3,19,16,41.89054,-87.62205
13430,6,16,false,29,29,0,41.89077,-87.63169
TA1306000013,6,16,false,28,30,2,41.89083,-87.61852
RN-,6,16,false,8,11,3,41.89102,-87.63546
13434,6,16,false,4,5,1,41.89108,-87.66663
TA1307000117,6,16,false,34,45,11,41.89144,-87.62675
13033,6,16,false,11,15,4,41.8916,-87.64835
13194,6,16,false,3,7,4,41.8918,-87.65878
TA1305000003,6,16,false,34,30,-4,41.89187,-87.62061
13022,6,16,false,174,193,19,41.89227,-87.61205
TA1306000029,6,16,false,28,21,-7,41.89256,-87.61449
13265,6,16,false,8,10,2,41.89383,-87.64172
13045,6,16,false,17,15,-2,41.89403,-87.62931
13016,6,16,false,10,11,1,41.89431,-87.62277
KA1503000041,6,16,false,5,19,14,41.89452,-87.61798
13196,6,16,false,1,5,4,41.89455,-87.65345
TA1307000062,6,16,false,6,4,-2,41.89466,-87.63839
TA1306000012,6,16,false,25,27,2,41.89475,-87.63438
KP1705001026,6,16,false,14,8,-6,41.89483,-87.6323
18058,6,16,false,1,7,6,41.8955,-87.68201
637,6,16,false,7,6,-1,41.89563,-87.67209
13132,6,16,false,7,14,7,41.89573,-87.67718
15530,6,16,false,13,20,7,41.89575,-87.62596
18003,6,16,false,7,6,-1,41.89575,-87.62011
13247,6,16,false,5,7,2,41.89597,-87.66775
TA1305000020,6,16,false,6,10,4,41.89636,-87.65406
13303,6,16,false,11,8,-3,41.89672,-87.63088
13017,6,16,false,7,5,-2,41.89676,-87.6357
13338,6,16,false,7,4,-3,41.89697,-87.62173
TA1307000061,6,16,false,6,12,6,41.89745,-87.62873
13034,6,16,false,44,17,-27,41.89754,-87.62352
TA1306000009,6,16,false,7,7,0,41.89772,-87.64299
15529,6,16,false,25,10,-15,41.89858,-87.62206
TA1307000128,6,16,false,19,10,-9,41.89896,-87.6299
TA1306000011,6,16,false,9,7,-2,41.89994,-87.63443
17660,6,16,false,6,2,-4,41.90036,-87.69671
13290,6,16,false,7,10,3,41.90069,-87.66259
13042,6,16,false,96,79,-17,41.90097,-87.62377
TA1307000070,6,16,false,7,6,-1,41.90133,-87.67742
KA1504000133,6,16,false,13,16,3,41.90234,-87.62773
15654,6,16,false,10,4,-6,41.90271,-87.70923
13241,6,16,false,5,11,6,41.9029,-87.68731
TA1306000006,6,16,false,4,6,2,41.90292,-87.63772
TA1307000039,6,16,false,25,21,-4,41.90294,-87.63137
13256,6,16,false,6,6,0,41.90302,-87.69749
TA1305000034,6,16,false,12,15,3,41.90313,-87.67391
KA1504000135,6,16,false,36,34,-2,41.90319,-87.63439
13136,6,16,false,3,8,5,41.90326,-87.67845
13061,6,16,false,23,18,-5,41.90342,-87.66779
KA1504000079,6,16,false,17,11,-6,41.9035,-87.64334
TA1307000115,6,16,false,6,4,-2,41.9046,-87.64056
TA1308000049,6,16,false,30,27,-3,41.90672,-87.6349
KA1504000134,6,16,false,12,13,1,41.90687,-87.6262
13224,6,16,false,5,11,6,41.90706,-87.66725
TA1307000143,6,16,false,8,4,-4,41.90762,-87.63854
13221,6,16,false,13,13,0,41.90765,-87.67254
TA1309000024,6,16,false,25,13,-12,41.908,-87.63152
TA1305000041,6,16,false,17,20,3,41.9094,-87.67769
331,6,16,false,15,18,3,41.90965,-87.64812
TA1305000037,6,16,false,5,8,3,41.91018,-87.67003
TA1306000008,6,16,false,14,4,-10,41.9102,-87.6435
TA1308000005,6,16,false,4,7,3,41.91042,-87.68238
13257,6,16,false,6,5,-1,41.91054,-87.68956
13154,6,16,false,9,8,-1,41.91054,-87.65312
13058,6,16,false,7,6,-1,41.91059,-87.64942
TA1307000038,6,16,false,16,9,-7,41.91138,-87.63868
LF-005,6,16,false,197,141,-56,41.91172,-87.62681
13128,6,16,false,16,22,6,41.91197,-87.63197
TA1308000050,6,16,false,55,56,1,41.91211,-87.6347
13243,6,16,false,16,16,0,41.91262,-87.6814
TA1306000032,6,16,false,3,5,2,41.9137,-87.65285
TA1307000166,6,16,false,11,12,1,41.91386,-87.64877
15655,6,16,false,5,5,0,41.91401,-87.70514
TA1306000007,6,16,false,6,4,-2,41.91469,-87.64333
13068,6,16,false,5,11,6,41.91554,-87.68703
13179,6,16,false,77,61,-16,41.9157,-87.63461
13133,6,16,false,8,14,6,41.91598,-87.67733
TA1305000039,6,16,false,4,5,1,41.9163,-87.66749
15651,6,16,false,5,10,5,41.91752,-87.70181
13266,6,16,false,5,6,1,41.91774,-87.69142
TA1309000029,6,16,false,11,8,-3,41.9178,-87.68245
TA1309000006,6,16,false,11,12,1,41.91809,-87.64375
TA1307000163,6,16,false,7,6,-1,41.91821,-87.65696
13146,6,16,false,42,45,3,41.91831,-87.63629
13059,6,16,false,19,21,2,41.91845,-87.65222
13259,6,16,false,3,5,2,41.91852,-87.69744
13192,6,16,false,4,25,21,41.91995,-87.64884
13288,6,16,false,2,7,5,41.92008,-87.67788
13242,6,16,false,12,2,-10,41.92021,-87.69266
TA1309000030,6,16,false,11,4,-7,41.92077,-87.66372
13292,6,16,false,5,6,1,41.92152,-87.70733
TA1309000033,6,16,false,25,35,10,41.92158,-87.65381
13193,6,16,false,41,24,-17,41.92182,-87.64412
13191,6,16,false,22,16,-6,41.92217,-87.63891
13084,6,16,false,8,9,1,41.92268,-87.69715
LP-,6,16,false,29,20,-9,41.92396,-87.63584
TA1307000001,6,16,false,17,12,-5,41.92535,-87.66581
TA1306000026,6,16,false,5,9,4,41.92558,-87.65842
TA1306000016,6,16,false,6,2,-4,41.9256,-87.65371
TA1309000019,6,16,false,21,30,9,41.92586,-87.63897
TA1309000058,6,16,false,28,21,-7,41.92591,-87.64927
TA1308000001,6,16,false,116,95,-21,41.92627,-87.63086
13124,6,16,false,13,5,-8,41.92675,-87.63444
TA1309000023,6,16,false,24,22,-2,41.9287,-87.65383
TA1307000113,6,16,false,7,14,7,41.92878,-87.66391
13296,6,16,false,3,9,6,41.92883,-87.66852
TA1309000059,6,16,false,12,9,-3,41.92889,-87.65898
TA1309000061,6,16,false,4,32,28,41.92915,-87.64909
TA1308000031,6,16,false,9,4,-5,41.92946,-87.68417
TA1305000014,6,16,false,15,18,3,41.92956,-87.64313
13085,6,16,false,11,8,-3,41.92958,-87.70789
TA1307000142,6,16,false,22,18,-4,41.93125,-87.64432
13276,6,16,false,15,17,2,41.93132,-87.63874
13271,6,16,false,7,3,-4,41.93192,-87.67784
TA1307000064,6,16,false,12,14,2,41.93222,-87.65864
TA1306000014,6,16,false,17,16,-1,41.93242,-87.65271
TA1309000039,6,16,false,47,23,-24,41.93258,-87.63642
13294,6,16,false,3,9,6,41.9326,-87.66595
TA1309000036,6,16,false,7,14,7,41.93313,-87.64776
TA1307000006,6,16,false,7,18,11,41.93571,-87.6636
13269,6,16,false,5,5,0,41.93609,-87.66983
TA1307000052,6,16,false,18,16,-2,41.93628,-87.65266
TA1307000136,6,16,false,13,16,3,41.9365,-87.64755
TA1307000041,6,16,false,39,38,-1,41.93669,-87.63683
13137,6,16,false,22,29,7,41.9376,-87.6441
KA17018068,6,16,false,2,8,6,41.93935,-87.68327
TA1309000042,6,16,false,1,9,8,41.93937,-87.66836
13229,6,16,false,8,9,1,41.93946,-87.66376
TA1308000019,6,16,false,13,12,-1,41.93973,-87.65886
13277,6,16,false,18,5,-13,41.9401,-87.64546
TA1307000134,6,16,false,19,36,17,41.94016,-87.65303
TA1309000049,6,16,false,36,28,-8,41.94077,-87.63919
TA1307000138,6,16,false,8,11,3,41.94334,-87.67094
13144,6,16,false,3,8,5,41.9434,-87.67964
TA1309000025,6,16,false,22,22,0,41.94368,-87.64894
13071,6,16,false,21,22,1,41.94373,-87.66401
632,6,16,false,26,34,8,41.94453,-87.6547
13278,6,16,false,9,21,12,41.94553,-87.64644
13235,6,16,false,10,15,5,41.94814,-87.66396
13325,6,16,false,18,16,-2,41.94907,-87.64863
TA1307000126,6,16,false,29,33,4,41.94936,-87.65451
TA1307000150,6,16,false,15,26,11,41.94945,-87.64646
13319,6,16,false,5,2,-3,41.95069,-87.6687
TA1307000127,6,16,false,24,25,1,41.9508,-87.65918
13323,6,16,false,12,19,7,41.95282,-87.65
TA1309000043,6,16,false,3,7,4,41.95417,-87.66434
13063,6,16,false,10,9,-1,41.95424,-87.65441
TA1308000022,6,16,false,17,15,-2,41.95438,-87.64805
TA1309000026,6,16,false,1,7,6,41.95601,-87.6802
TA1308000047,6,16,false,5,1,-4,41.95709,-87.6642
13379,6,16,false,10,9,-1,41.95786,-87.6495
TA1309000027,6,16,false,7,3,-4,41.9585,-87.65499
13389,6,16,false,17,8,-9,41.961,-87.64958
TA1309000021,6,16,false,3,7,4,41.9615,-87.6714
TA1307000107,6,16,false,4,7,3,41.96164,-87.65464
TA1308000012,6,16,false,61,45,-16,41.96398,-87.63818
639,6,16,false,6,7,1,41.96584,-87.64538
TA1309000014,6,16,false,5,8,3,41.96709,-87.66744
TA1307000119,6,16,false,6,6,0,41.96796,-87.65
TA1308000021,6,16,false,6,5,-1,41.96883,-87.65765
TA1309000066,6,16,false,6,8,2,41.9691,-87.67423
TA1309000041,6,16,false,5,4,-1,41.96951,-87.65471
KA1504000171,6,16,false,8,9,1,41.97161,-87.65016
TA1309000035,6,16,false,4,5,1,41.97335,-87.66785
KA1504000146,6,16,false,3,8,5,41.978,-87.66805
13109,6,16,false,5,3,-2,41.97835,-87.65976
KA1504000152,6,16,false,27,23,-4,41.98403,-87.65231
15571,6,16,false,6,1,-5,41.99478,-87.66028
660,6,16,false,2,6,4,42.00458,-87.66143
KA1504000175,6,16,false,2,6,4,42.00797,-87.66549
596,6,16,false,5,5,0,42.04822,-87.68348
604,6,16,false,3,10,7,42.05824,-87.67744
TA1309000063,6,16,true,7,6,-1,41.79325,-87.5878
TA1308000009,6,16,true,6,2,-4,41.79522,-87.58075
TA1309000037,6,16,true,4,5,1,41.79957,-87.59474
13216,6,16,true,9,2,-7,41.83473,-87.62581
TA1309000055,6,16,true,3,5,2,41.8382,-87.64514
TA1307000048,6,16,true,7,6,-1,41.83855,-87.60821
15545,6,16,true,9,5,-4,41.85627,-87.61334
13135,6,16,true,5,3,-2,41.85753,-87.66157
13102,6,16,true,7,8,1,41.85762,-87.61942
13150,6,16,true,8,7,-1,41.85783,-87.62455
13164,6,16,true,7,4,-3,41.85818,-87.65648
SL-012,6,16,true,8,8,0,41.86038,-87.62581
TA1306000002,6,16,true,1,5,4,41.86238,-87.65108
TA1307000124,6,16,true,10,8,-2,41.86411,-87.62372
TA1309000001,6,16,true,5,3,-2,41.86488,-87.64708
13029,6,16,true,7,3,-4,41.86531,-87.6179
13431,6,16,true,7,4,-3,41.8661,-87.60728
WL-008,6,16,true,3,5,2,41.86712,-87.64108
TA1305000002,6,16,true,9,11,2,41.86721,-87.62597
KA1706005007,6,16,true,7,3,-4,41.86749,-87.63219
SL-005,6,16,true,6,16,10,41.8679,-87.62304
13139,6,16,true,7,6,-1,41.86893,-87.65913
13285,6,16,true,5,1,-4,41.86928,-87.67372
13160,6,16,true,3,5,2,41.86947,-87.65548
TA1309000010,6,16,true,13,9,-4,41.87074,-87.62574
TA1309000064,6,16,true,3,5,2,41.87127,-87.67369
TA1307000130,6,16,true,7,7,0,41.87178,-87.65103
TA1307000121,6,16,true,10,9,-1,41.87184,-87.64664
SL-008,6,16,true,14,8,-6,41.87209,-87.62956
13332,6,16,true,14,4,-10,41.87219,-87.6615
SL-011,6,16,true,2,5,3,41.87256,-87.63356
624,6,16,true,2,6,4,41.87626,-87.62923
TA1305000035,6,16,true,2,5,3,41.87716,-87.62787
15539,6,16,true,4,5,1,41.87763,-87.64405
13158,6,16,true,9,10,1,41.87764,-87.64957
13157,6,16,true,2,11,9,41.87773,-87.6548
13011,6,16,true,5,1,-4,41.87931,-87.63993
WL-011,6,16,true,4,5,1,41.88034,-87.64273
13300,6,16,true,11,13,2,41.88097,-87.61675
13008,6,16,true,9,8,-1,41.88105,-87.62408
TA1307000120,6,16,true,14,12,-2,41.88188,-87.64879
13036,6,16,true,4,5,1,41.8821,-87.62513
TA1305000032,6,16,true,10,11,1,41.88218,-87.64109
13409,6,16,true,6,5,-1,41.8831,-87.6511
13053,6,16,true,16,14,-2,41.88365,-87.64863
13001,6,16,true,5,9,4,41.88397,-87.62459
18062,6,16,true,2,5,3,41.88412,-87.65427
TA1306000010,6,16,true,5,6,1,41.88419,-87.62961
TA1305000029,6,16,true,16,8,-8,41.88466,-87.62787
13263,6,16,true,15,8,-7,41.88467,-87.61952
TA1306000015,6,16,true,3,6,3,41.88549,-87.65232
TA1307000111,6,16,true,5,2,-3,41.88582,-87.63548
KA17018054,6,16,true,6,1,-5,41.88595,-87.67701
KA1503000012,6,16,true,10,9,-1,41.88599,-87.63089
TA1305000011,6,16,true,1,8,7,41.886,-87.62418
15534,6,16,true,10,4,-6,41.88627,-87.61749
TA1308000029,6,16,true,3,5,2,41.88673,-87.62225
KA1503000064,6,16,true,14,14,0,41.88697,-87.61281
TA1305000022,6,16,true,9,6,-3,41.88817,-87.63656
TA1306000003,6,16,true,5,21,16,41.88867,-87.64442
KA1503000043,6,16,true,19,9,-10,41.88918,-87.63851
13050,6,16,true,13,8,-5,41.88919,-87.62775
15664,6,16,true,2,5,3,41.8895,-87.68821
TA1307000151,6,16,true,16,11,-5,41.88993,-87.63427
13427,6,16,true,6,3,-3,41.89054,-87.62205
13430,6,16,true,10,10,0,41.89077,-87.63169
TA1306000013,6,16,true,5,10,5,41.89083,-87.61852
RN-,6,16,true,8,10,2,41.89102,-87.63546
13434,6,16,true,3,5,2,41.89108,-87.66663
TA1307000117,6,16,true,24,18,-6,41.89144,-87.62675
13033,6,16,true,8,12,4,41.8916,-87.64835
13194,6,16,true,3,9,6,41.8918,-87.65878
TA1305000003,6,16,true,15,8,-7,41.89187,-87.62061
13022,6,16,true,30,22,-8,41.89227,-87.61205
TA1306000029,6,16,true,11,7,-4,41.89256,-87.61449
13265,6,16,true,12,11,-1,41.89383,-87.64172
13045,6,16,true,7,12,5,41.89403,-87.62931
13016,6,16,true,11,9,-2,41.89431,-87.62277
KA1503000041,6,16,true,9,7,-2,41.89452,-87.61798
TA1306000012,6,16,true,15,15,0,41.89475,-87.63438
KP1705001026,6,16,true,9,7,-2,41.89483,-87.6323
13132,6,16,true,6,14,8,41.89573,-87.67718
15530,6,16,true,4,7,3,41.89575,-87.62596
13289,6,16,true,5,3,-2,41.89638,-87.661
13303,6,16,true,8,6,-2,41.89672,-87.63088
13338,6,16,true,8,3,-5,41.89697,-87.62173
TA1307000061,6,16,true,7,5,-2,41.89745,-87.62873
13034,6,16,true,5,2,-3,41.89754,-87.62352
TA1306000009,6,16,true,1,7,6,41.89772,-87.64299
620,6,16,true,4,7,3,41.89817,-87.63754
15529,6,16,true,5,5,0,41.89858,-87.62206
TA1307000128,6,16,true,20,14,-6,41.89896,-87.6299
TA1306000011,6,16,true,9,3,-6,41.89994,-87.63443
13290,6,16,true,5,7,2,41.90069,-87.66259
13042,6,16,true,23,19,-4,41.90097,-87.62377
TA1307000070,6,16,true,5,1,-4,41.90133,-87.67742
KA1504000133,6,16,true,10,10,0,41.90234,-87.62773
13241,6,16,true,4,7,3,41.9029,-87.68731
TA1306000006,6,16,true,7,1,-6,41.90292,-87.63772
TA1307000039,6,16,true,32,30,-2,41.90294,-87.63137
658,6,16,true,2,5,3,41.903,-87.6838
13256,6,16,true,4,7,3,41.90302,-87.69749
TA1305000034,6,16,true,3,9,6,41.90313,-87.67391
KA1504000135,6,16,true,20,14,-6,41.90319,-87.63439
13061,6,16,true,11,21,10,41.90342,-87.66779
KA1504000079,6,16,true,5,6,1,41.9035,-87.64334
TA1308000049,6,16,true,15,17,2,41.90672,-87.6349
KA1504000134,6,16,true,10,9,-1,41.90687,-87.6262
13224,6,16,true,8,8,0,41.90706,-87.66725
13221,6,16,true,7,5,-2,41.90765,-87.67254
TA1309000024,6,16,true,12,16,4,41.908,-87.63152
TA1305000041,6,16,true,16,18,2,41.9094,-87.67769
331,6,16,true,13,6,-7,41.90965,-87.64812
TA1305000037,6,16,true,6,7,1,41.91018,-87.67003
TA1306000008,6,16,true,6,4,-2,41.9102,-87.6435
TA1308000005,6,16,true,5,3,-2,41.91042,-87.68238
13258,6,16,true,7,2,-5,41.91043,-87.69718
13154,6,16,true,7,8,1,41.91054,-87.65312
13058,6,16,true,13,12,-1,41.91059,-87.64942
TA1307000038,6,16,true,5,6,1,41.91138,-87.63868
LF-005,6,16,true,60,46,-14,41.91172,-87.62681
13128,6,16,true,19,6,-13,41.91197,-87.63197
TA1308000050,6,16,true,27,40,13,41.91211,-87.6347
13243,6,16,true,15,12,-3,41.91262,-87.6814
TA1307000166,6,16,true,6,7,1,41.91386,-87.64877
18017,6,16,true,6,6,0,41.91416,-87.71676
18067,6,16,true,11,12,1,41.9146,-87.66796
TA1306000007,6,16,true,2,6,4,41.91469,-87.64333
13068,6,16,true,5,4,-1,41.91554,-87.68703
13179,6,16,true,28,34,6,41.9157,-87.63461
13133,6,16,true,8,10,2,41.91598,-87.67733
TA1305000039,6,16,true,3,5,2,41.9163,-87.66749
TA1309000029,6,16,true,9,5,-4,41.9178,-87.68245
TA1309000006,6,16,true,12,5,-7,41.91809,-87.64375
TA1307000163,6,16,true,10,10,0,41.91821,-87.65696
13146,6,16,true,26,19,-7,41.91831,-87.63629
13059,6,16,true,20,18,-2,41.91845,-87.65222
13259,6,16,true,3,6,3,41.91852,-87.69744
13192,6,16,true,5,12,7,41.91995,-87.64884
13288,6,16,true,7,4,-3,41.92008,-87.67788
TA1309000030,6,16,true,6,5,-1,41.92077,-87.66372
13292,6,16,true,3,7,4,41.92152,-87.70733
TA1309000033,6,16,true,9,10,1,41.92158,-87.65381
13193,6,16,true,23,26,3,41.92182,-87.64412
13191,6,16,true,16,14,-2,41.92217,-87.63891
13084,6,16,true,6,8,2,41.92268,-87.69715
LP-,6,16,true,7,11,4,41.92396,-87.63584
TA1307000001,6,16,true,10,4,-6,41.92535,-87.66581
TA1306000026,6,16,true,8,5,-3,41.92558,-87.65842
TA1306000016,6,16,true,7,7,0,41.9256,-87.65371
TA1309000019,6,16,true,16,13,-3,41.92586,-87.63897
TA1309000058,6,16,true,9,17,8,41.92591,-87.64927
TA1308000001,6,16,true,32,16,-16,41.92627,-87.63086
TA1309000023,6,16,true,8,11,3,41.9287,-87.65383
TA1307000113,6,16,true,9,7,-2,41.92878,-87.66391
TA1309000061,6,16,true,12,9,-3,41.92915,-87.64909
TA1305000014,6,16,true,13,13,0,41.92956,-87.64313
13085,6,16,true,8,7,-1,41.92958,-87.70789
TA1307000142,6,16,true,9,9,0,41.93125,-87.64432
13276,6,16,true,19,17,-2,41.93132,-87.63874
13271,6,16,true,7,3,-4,41.93192,-87.67784
TA1307000064,6,16,true,13,16,3,41.93222,-87.65864
TA1306000014,6,16,true,8,10,2,41.93242,-87.65271
TA1309000039,6,16,true,20,13,-7,41.93258,-87.63642
13294,6,16,true,4,7,3,41.9326,-87.66595
TA1309000036,6,16,true,9,7,-2,41.93313,-87.64776
TA1307000006,6,16,true,10,5,-5,41.93571,-87.6636
TA1307000052,6,16,true,19,10,-9,41.93628,-87.65266
TA1307000136,6,16,true,8,6,-2,41.9365,-87.64755
TA1307000041,6,16,true,11,11,0,41.93669,-87.63683
13137,6,16,true,15,18,3,41.9376,-87.6441
TA1309000042,6,16,true,11,8,-3,41.93937,-87.66836
13229,6,16,true,4,7,3,41.93946,-87.66376
TA1308000019,6,16,true,9,9,0,41.93973,-87.65886
13277,6,16,true,6,9,3,41.9401,-87.64546
TA1307000134,6,16,true,16,23,7,41.94016,-87.65303
TA1309000049,6,16,true,13,15,2,41.94077,-87.63919
TA1307000138,6,16,true,5,6,1,41.94334,-87.67094
13144,6,16,true,3,6,3,41.9434,-87.67964
TA1309000025,6,16,true,12,11,-1,41.94368,-87.64894
13071,6,16,true,14,15,1,41.94373,-87.66401
632,6,16,true,16,18,2,41.94453,-87.6547
13278,6,16,true,15,11,-4,41.94553,-87.64644
15632,6,16,true,4,5,1,41.94664,-87.69463
13235,6,16,true,21,12,-9,41.94814,-87.66396
13325,6,16,true,17,14,-3,41.94907,-87.64863
TA1307000126,6,16,true,11,24,13,41.94936,-87.65451
TA1307000150,6,16,true,15,11,-4,41.94945,-87.64646
TA1307000127,6,16,true,11,3,-8,41.9508,-87.65918
13323,6,16,true,7,7,0,41.95282,-87.65
13063,6,16,true,4,18,14,41.95424,-87.65441
TA1308000022,6,16,true,11,6,-5,41.95438,-87.64805
TA1307000149,6,16,true,2,5,3,41.95467,-87.67392
TA1309000026,6,16,true,3,7,4,41.95601,-87.6802
13379,6,16,true,13,13,0,41.95786,-87.6495
TA1309000027,6,16,true,6,12,6,41.9585,-87.65499
13389,6,16,true,5,8,3,41.961,-87.64958
KA1503000022,6,16,true,6,4,-2,41.96158,-87.66609
TA1307000107,6,16,true,17,11,-6,41.96164,-87.65464
TA1307000156,6,16,true,4,9,5,41.96301,-87.68479
TA1308000012,6,16,true,28,28,0,41.96398,-87.63818
13074,6,16,true,6,6,0,41.96521,-87.6582
639,6,16,true,7,2,-5,41.96584,-87.64538
TA1307000140,6,16,true,6,7,1,41.96643,-87.68865
TA1309000014,6,16,true,5,8,3,41.96709,-87.66744
TA1309000066,6,16,true,6,4,-2,41.9691,-87.67423
KA1504000171,6,16,true,7,6,-1,41.97161,-87.65016
TA1309000035,6,16,true,9,7,-2,41.97335,-87.66785
13109,6,16,true,6,7,1,41.97835,-87.65976
KA1504000152,6,16,true,17,18,1,41.98403,-87.65231
15578,6,16,true,6,3,-3,41.98405,-87.66027
15575,6,16,true,5,3,-2,41.98975,-87.66014
KA1503000014,6,17,false,2,7,5,41.7851,-87.60108
KA1503000074,6,17,false,11,1,-10,41.79174,-87.58395
TA1308000009,6,17,false,25,15,-10,41.79522,-87.58075
TA1307000164,6,17,false,3,6,3,41.79527,-87.59647
KA1503000059,6,17,false,5,5,0,41.79952,-87.58643
KA1503000007,6,17,false,9,11,2,41.80242,-87.58689
13398,6,17,false,1,5,4,41.80256,-87.59035
TA1308000038,6,17,false,5,1,-4,41.82298,-87.6071
KA1503000004,6,17,false,6,2,-4,41.83127,-87.6088
TA1307000048,6,17,false,18,14,-4,41.83855,-87.60821
TA1307000139,6,17,false,5,3,-2,41.84205,-87.61698
TA1305000001,6,17,false,4,7,3,41.85262,-87.6265
13075,6,17,false,9,13,4,41.8531,-87.63192
15545,6,17,false,5,7,2,41.85627,-87.61334
SL-006,6,17,false,3,8,5,41.8568,-87.63387
13102,6,17,false,15,13,-2,41.85762,-87.61942
13150,6,17,false,6,2,-4,41.85783,-87.62455
TA1307000159,6,17,false,1,6,5,41.8579,-87.6687
13164,6,17,false,7,3,-4,41.85818,-87.65648
SL-012,6,17,false,8,5,-3,41.86038,-87.62581
TA1307000124,6,17,false,6,15,9,41.86411,-87.62372
TA1309000001,6,17,false,7,4,-3,41.86488,-87.64708
13431,6,17,false,35,17,-18,41.8661,-87.60728
TA1305000002,6,17,false,18,6,-12,41.86721,-87.62597
15544,6,17,false,29,20,-9,41.86723,-87.61536
KA1706005007,6,17,false,8,9,1,41.86749,-87.63219
SL-005,6,17,false,28,29,1,41.8679,-87.62304
TA1309000010,6,17,false,22,23,1,41.87074,-87.62574
SL-009,6,17,false,4,6,2,41.87081,-87.63121
SL-008,6,17,false,9,7,-2,41.87209,-87.62956
SL-011,6,17,false,5,9,4,41.87256,-87.63356
623,6,17,false,21,21,0,41.87272,-87.62399
SL-007,6,17,false,5,9,4,41.87404,-87.6277
13326,6,17,false,1,5,4,41.87425,-87.63958
SL-010,6,17,false,7,8,1,41.87501,-87.63309
15541,6,17,false,42,28,-14,41.8758,-87.62086
TA1305000010,6,17,false,4,16,12,41.87623,-87.62444
624,6,17,false,4,6,2,41.87626,-87.62923
TA1305000035,6,17,false,11,6,-5,41.87716,-87.62787
15539,6,17,false,7,3,-4,41.87763,-87.64405
13158,6,17,false,4,7,3,41.87764,-87.64957
13157,6,17,false,8,6,-2,41.87773,-87.6548
TA1305000025,6,17,false,7,7,0,41.87773,-87.63528
TA1309000002,6,17,false,29,27,-2,41.87784,-87.62408
13206,6,17,false,2,5,3,41.87794,-87.66201
638,6,17,false,1,8,7,41.87827,-87.64078
TA1305000005,6,17,false,4,7,3,41.87924,-87.62975
13011,6,17,false,10,6,-4,41.87931,-87.63993
TA1309000008,6,17,false,9,9,0,41.87933,-87.6355
KA1503000015,6,17,false,9,14,5,41.87948,-87.6257
TA1309000007,6,17,false,3,7,4,41.88022,-87.63526
WL-011,6,17,false,6,5,-1,41.88034,-87.64273
13156,6,17,false,12,9,-3,41.88042,-87.65554
13300,6,17,false,102,91,-11,41.88097,-87.61675
13008,6,17,false,30,41,11,41.88105,-87.62408
TA1305000006,6,17,false,12,27,15,41.88122,-87.6296
13134,6,17,false,3,8,5,41.88138,-87.67493
13056,6,17,false,6,4,-2,41.88168,-87.63951
TA1307000120,6,17,false,12,27,15,41.88188,-87.64879
13341,6,17,false,12,11,-1,41.88208,-87.63985
13036,6,17,false,11,14,3,41.8821,-87.62513
TA1305000032,6,17,false,11,21,10,41.88218,-87.64109
13353,6,17,false,8,2,-6,41.88283,-87.6612
654,6,17,false,3,6,3,41.88307,-87.65698
13409,6,17,false,5,14,9,41.8831,-87.6511
WL-012,6,17,false,7,10,3,41.88337,-87.6412
13053,6,17,false,22,17,-5,41.88365,-87.64863
13001,6,17,false,21,19,-2,41.88397,-87.62459
13155,6,17,false,1,10,9,41.88407,-87.65689
TA1306000010,6,17,false,10,7,-3,41.88419,-87.62961
TA1305000030,6,17,false,11,12,1,41.88459,-87.63178
15535,6,17,false,4,20,16,41.8846,-87.64455
TA1305000029,6,17,false,13,21,8,41.88466,-87.62787
13263,6,17,false,28,22,-6,41.88467,-87.61952
TA1306000015,6,17,false,10,29,19,41.88549,-87.65232
13021,6,17,false,12,19,7,41.88559,-87.64184
TA1307000111,6,17,false,6,16,10,41.88582,-87.63548
KA1503000012,6,17,false,19,21,2,41.88599,-87.63089
TA1305000011,6,17,false,33,32,-1,41.886,-87.62418
15534,6,17,false,8,7,-1,41.88627,-87.61749
TA1308000029,6,17,false,12,18,6,41.88673,-87.62225
TA1307000131,6,17,false,24,25,1,41.88688,-87.62606
KA1503000064,6,17,false,36,33,-3,41.88697,-87.61281
TA1305000022,6,17,false,6,15,9,41.88817,-87.63656
TA1306000003,6,17,false,13,11,-2,41.88867,-87.64442
KA1503000043,6,17,false,15,16,1,41.88918,-87.63851
13050,6,17,false,17,15,-2,41.88919,-87.62775
TA1307000151,6,17,false,13,16,3,41.88993,-87.63427
636,6,17,false,5,10,5,41.88997,-87.63662
KA1503000044,6,17,false,8,5,-3,41.89018,-87.6262
13427,6,17,false,26,15,-11,41.89054,-87.62205
13430,6,17,false,16,16,0,41.89077,-87.63169
TA1306000013,6,17,false,28,36,8,41.89083,-87.61852
RN-,6,17,false,6,10,4,41.89102,-87.63546
TA1308000006,6,17,false,8,6,-2,41.89128,-87.67686
TA1307000117,6,17,false,40,38,-2,41.89144,-87.62675
13033,6,17,false,26,15,-11,41.8916,-87.64835
13194,6,17,false,9,11,2,41.8918,-87.65878
TA1305000003,6,17,false,25,26,1,41.89187,-87.62061
13022,6,17,false,170,188,18,41.89227,-87.61205
TA1306000029,6,17,false,39,42,3,41.89256,-87.61449
13265,6,17,false,13,15,2,41.89383,-87.64172
13045,6,17,false,20,32,12,41.89403,-87.62931
13016,6,17,false,17,17,0,41.89431,-87.62277
KA1503000041,6,17,false,18,28,10,41.89452,-87.61798
13196,6,17,false,5,20,15,41.89455,-87.65345
TA1307000062,6,17,false,10,5,-5,41.89466,-87.63839
TA1306000012,6,17,false,15,15,0,41.89475,-87.63438
KP1705001026,6,17,false,18,28,10,41.89483,-87.6323
637,6,17,false,6,3,-3,41.89563,-87.67209
13132,6,17,false,3,5,2,41.89573,-87.67718
15530,6,17,false,30,22,-8,41.89575,-87.62596
18003,6,17,false,9,9,0,41.89575,-87.62011
13247,6,17,false,13,5,-8,41.89597,-87.66775
TA1305000020,6,17,false,16,9,-7,41.89636,-87.65406
13289,6,17,false,1,8,7,41.89638,-87.661
13303,6,17,false,22,19,-3,41.89672,-87.63088
13017,6,17,false,7,12,5,41.89676,-87.6357
13338,6,17,false,17,4,-13,41.89697,-87.62173
TA1307000061,6,17,false,12,8,-4,41.89745,-87.62873
13034,6,17,false,26,25,-1,41.89754,-87.62352
TA1306000009,6,17,false,5,7,2,41.89772,-87.64299
15529,6,17,false,21,17,-4,41.89858,-87.62206
TA1307000128,6,17,false,19,18,-1,41.89896,-87.6299
657,6,17,false,2,5,3,41.89918,-87.6722
TA1306000011,6,17,false,8,5,-3,41.89994,-87.63443
KA1504000116,6,17,false,3,10,7,41.90023,-87.64299
17660,6,17,false,7,6,-1,41.90036,-87.69671
13290,6,17,false,12,9,-3,41.90069,-87.66259
13042,6,17,false,93,95,2,41.90097,-87.62377
KA1504000133,6,17,false,17,20,3,41.90234,-87.62773
13241,6,17,false,6,3,-3,41.9029,-87.68731
TA1306000006,6,17,false,3,9,6,41.90292,-87.63772
TA1307000039,6,17,false,35,29,-6,41.90294,-87.63137
TA1305000034,6,17,false,18,9,-9,41.90313,-87.67391
KA1504000135,6,17,false,32,31,-1,41.90319,-87.63439
13136,6,17,false,6,6,0,41.90326,-87.67845
13061,6,17,false,22,13,-9,41.90342,-87.66779
KA1504000079,6,17,false,9,10,1,41.9035,-87.64334
TA1307000115,6,17,false,2,5,3,41.9046,-87.64056
TA1308000049,6,17,false,37,24,-13,41.90672,-87.6349
KA1504000134,6,17,false,23,12,-11,41.90687,-87.6262
13224,6,17,false,15,17,2,41.90706,-87.66725
TA1307000143,6,17,false,20,10,-10,41.90762,-87.63854
13221,6,17,false,15,13,-2,41.90765,-87.67254
13245,6,17,false,4,7,3,41.90777,-87.68586
TA1309000024,6,17,false,27,11,-16,41.908,-87.63152
TA1305000041,6,17,false,12,31,19,41.9094,-87.67769
331,6,17,false,18,30,12,41.90965,-87.64812
TA1305000037,6,17,false,10,7,-3,41.91018,-87.67003
TA1306000008,6,17,false,11,10,-1,41.9102,-87.6435
TA1308000005,6,17,false,9,5,-4,41.91042,-87.68238
13257,6,17,false,9,5,-4,41.91054,-87.68956
13154,6,17,false,12,12,0,41.91054,-87.65312
13058,6,17,false,13,9,-4,41.91059,-87.64942
TA1307000038,6,17,false,36,23,-13,41.91138,-87.63868
LF-005,6,17,false,97,106,9,41.91172,-87.62681
13128,6,17,false,34,28,-6,41.91197,-87.63197
TA1308000050,6,17,false,68,55,-13,41.91211,-87.6347
13243,6,17,false,13,10,-3,41.91262,-87.6814
TA1306000032,6,17,false,9,15,6,41.9137,-87.65285
TA1307000166,6,17,false,12,14,2,41.91386,-87.64877
18017,6,17,false,7,1,-6,41.91416,-87.71676
18067,6,17,false,10,4,-6,41.9146,-87.66796
TA1306000007,6,17,false,8,7,-1,41.91469,-87.64333
13068,6,17,false,2,5,3,41.91554,-87.68703
13179,6,17,false,41,41,0,41.9157,-87.63461
13133,6,17,false,21,22,1,41.91598,-87.67733
TA1305000039,6,17,false,14,7,-7,41.9163,-87.66749
15650,6,17,false,5,12,7,41.91711,-87.71023
13266,6,17,false,7,7,0,41.91774,-87.69142
TA1309000029,6,17,false,2,7,5,41.9178,-87.68245
TA1309000006,6,17,false,11,15,4,41.91809,-87.64375
TA1307000163,6,17,false,7,13,6,41.91821,-87.65696
13146,6,17,false,83,51,-32,41.91831,-87.63629
13059,6,17,false,23,17,-6,41.91845,-87.65222
13192,6,17,false,19,11,-8,41.91995,-87.64884
13288,6,17,false,5,12,7,41.92008,-87.67788
TA1309000030,6,17,false,9,10,1,41.92077,-87.66372
TA1309000033,6,17,false,14,11,-3,41.92158,-87.65381
13193,6,17,false,13,28,15,41.92182,-87.64412
13191,6,17,false,22,23,1,41.92217,-87.63891
13084,6,17,false,11,17,6,41.92268,-87.69715
LP-,6,17,false,24,17,-7,41.92396,-87.63584
KA1504000090,6,17,false,7,5,-2,41.92483,-87.7145
TA1307000001,6,17,false,4,21,17,41.92535,-87.66581
TA1306000026,6,17,false,7,8,1,41.92558,-87.65842
TA1306000016,6,17,false,20,15,-5,41.9256,-87.65371
TA1309000019,6,17,false,37,24,-13,41.92586,-87.63897
TA1309000058,6,17,false,18,21,3,41.92591,-87.64927
TA1308000001,6,17,false,88,88,0,41.92627,-87.63086
15646,6,17,false,2,5,3,41.92668,-87.6977
13124,6,17,false,26,15,-11,41.92675,-87.63444
TA1309000023,6,17,false,19,31,12,41.9287,-87.65383
TA1307000113,6,17,false,12,24,12,41.92878,-87.66391
13296,6,17,false,8,13,5,41.92883,-87.66852
TA1309000059,6,17,false,13,14,1,41.92889,-87.65898
TA1309000061,6,17,false,24,15,-9,41.92915,-87.64909
TA1308000031,6,17,false,5,4,-1,41.92946,-87.68417
TA1305000014,6,17,false,16,17,1,41.92956,-87.64313
13085,6,17,false,7,14,7,41.92958,-87.70789
15643,6,17,false,2,5,3,41.93057,-87.7238
TA1307000142,6,17,false,25,21,-4,41.93125,-87.64432
13276,6,17,false,29,22,-7,41.93132,-87.63874
13271,6,17,false,5,5,0,41.93192,-87.67784
TA1307000064,6,17,false,20,17,-3,41.93222,-87.65864
TA1306000014,6,17,false,19,17,-2,41.93242,-87.65271
TA1309000039,6,17,false,30,35,5,41.93258,-87.63642
13294,6,17,false,6,6,0,41.9326,-87.66595
TA1309000036,6,17,false,18,16,-2,41.93313,-87.64776
TA1307000006,6,17,false,12,16,4,41.93571,-87.6636
13268,6,17,false,6,6,0,41.93588,-87.67843
13269,6,17,false,5,5,0,41.93609,-87.66983
TA1307000052,6,17,false,13,15,2,41.93628,-87.65266
TA1307000136,6,17,false,13,12,-1,41.9365,-87.64755
TA1307000041,6,17,false,42,40,-2,41.93669,-87.63683
13137,6,17,false,30,31,1,41.9376,-87.6441
TA1309000042,6,17,false,3,11,8,41.93937,-87.66836
13229,6,17,false,10,13,3,41.93946,-87.66376
TA1308000019,6,17,false,13,17,4,41.93973,-87.65886
13277,6,17,false,16,13,-3,41.9401,-87.64546
TA1307000134,6,17,false,26,32,6,41.94016,-87.65303
TA1309000049,6,17,false,41,46,5,41.94077,-87.63919
15634,6,17,false,5,4,-1,41.94304,-87.68729
TA1307000138,6,17,false,6,5,-1,41.94334,-87.67094
13144,6,17,false,7,7,0,41.9434,-87.67964
TA1309000025,6,17,false,22,18,-4,41.94368,-87.64894
13071,6,17,false,19,29,10,41.94373,-87.66401
632,6,17,false,34,42,8,41.94453,-87.6547
13278,6,17,false,21,19,-2,41.94553,-87.64644
TA1309000050,6,17,false,5,3,-2,41.94618,-87.67331
13235,6,17,false,9,23,14,41.94814,-87.66396
13253,6,17,false,3,6,3,41.9488,-87.67527
13325,6,17,false,16,18,2,41.94907,-87.64863
TA1307000126,6,17,false,16,65,49,41.94936,-87.65451
TA1307000150,6,17,false,20,12,-8,41.94945,-87.64646
13319,6,17,false,6,7,1,41.95069,-87.6687
TA1307000127,6,17,false,12,21,9,41.9508,-87.65918
15628,6,17,false,5,6,1,41.95216,-87.69806
13323,6,17,false,15,5,-10,41.95282,-87.65
TA1309000043,6,17,false,7,1,-6,41.95417,-87.66434
13063,6,17,false,14,13,-1,41.95424,-87.65441
TA1308000022,6,17,false,4,12,8,41.95438,-87.64805
TA1307000149,6,17,false,6,7,1,41.95467,-87.67392
TA1308000047,6,17,false,1,7,6,41.95709,-87.6642
13379,6,17,false,8,7,-1,41.95786,-87.6495
TA1309000018,6,17,false,12,4,-8,41.95791,-87.67357
TA1309000027,6,17,false,9,6,-3,41.9585,-87.65499
13389,6,17,false,13,7,-6,41.961,-87.64958
KA1503000022,6,17,false,5,6,1,41.96158,-87.66609
TA1307000107,6,17,false,5,11,6,41.96164,-87.65464
TA1307000156,6,17,false,2,5,3,41.96301,-87.68479
TA1308000012,6,17,false,56,30,-26,41.96398,-87.63818
13074,6,17,false,13,5,-8,41.96521,-87.6582
639,6,17,false,12,10,-2,41.96584,-87.64538
TA1307000140,6,17,false,5,2,-3,41.96643,-87.68865
TA1309000014,6,17,false,7,17,10,41.96709,-87.66744
TA1307000119,6,17,false,9,8,-1,41.96796,-87.65
TA1308000021,6,17,false,5,7,2,41.96883,-87.65765
TA1309000066,6,17,false,10,2,-8,41.9691,-87.67423
KA1504000171,6,17,false,8,8,0,41.97161,-87.65016
13108,6,17,false,3,6,3,41.97379,-87.65971
KA1504000146,6,17,false,17,10,-7,41.978,-87.66805
13109,6,17,false,12,7,-5,41.97835,-87.65976
KA1504000151,6,17,false,3,6,3,41.98359,-87.66916
KA1504000152,6,17,false,31,21,-10,41.98403,-87.65231
15578,6,17,false,11,7,-4,41.98405,-87.66027
15575,6,17,false,3,5,2,41.98975,-87.66014
KA1504000156,6,17,false,2,6,4,41.99925,-87.67137
660,6,17,false,7,3,-4,42.00458,-87.66143
KA1504000175,6,17,false,3,5,2,42.00797,-87.66549
E002,6,17,false,5,2,-3,42.03256,-87.67912
596,6,17,false,7,9,2,42.04822,-87.68348
E008,6,17,false,8,4,-4,42.05049,-87.67782
604,6,17,false,3,5,2,42.05824,-87.67744
TA1308000009,6,17,true,10,8,-2,41.79522,-87.58075
TA1307000048,6,17,true,6,8,2,41.83855,-87.60821
TA1308000036,6,17,true,5,9,4,41.83883,-87.62186
TA1307000139,6,17,true,6,2,-4,41.84205,-87.61698
TA1305000001,6,17,true,6,3,-3,41.85262,-87.6265
15545,6,17,true,9,9,0,41.85627,-87.61334
13135,6,17,true,3,8,5,41.85753,-87.66157
13102,6,17,true,6,5,-1,41.85762,-87.61942
13150,6,17,true,5,7,2,41.85783,-87.62455
13164,6,17,true,6,7,1,41.85818,-87.65648
SL-012,6,17,true,8,6,-2,41.86038,-87.62581
TA1307000124,6,17,true,8,6,-2,41.86411,-87.62372
13431,6,17,true,15,11,-4,41.8661,-87.60728
TA1305000002,6,17,true,12,19,7,41.86721,-87.62597
15544,6,17,true,2,8,6,41.86723,-87.61536
KA1706005007,6,17,true,7,5,-2,41.86749,-87.63219
SL-005,6,17,true,16,13,-3,41.8679,-87.62304
644,6,17,true,5,4,-1,41.86859,-87.68625
13160,6,17,true,11,3,-8,41.86947,-87.65548
TA1309000010,6,17,true,7,12,5,41.87074,-87.62574
SL-008,6,17,true,7,8,1,41.87209,-87.62956
13332,6,17,true,6,8,2,41.87219,-87.6615
SL-011,6,17,true,3,7,4,41.87256,-87.63356
623,6,17,true,9,3,-6,41.87272,-87.62399
SL-007,6,17,true,2,7,5,41.87404,-87.6277
SL-010,6,17,true,6,1,-5,41.87501,-87.63309
624,6,17,true,5,3,-2,41.87626,-87.62923
15539,6,17,true,5,2,-3,41.87763,-87.64405
13158,6,17,true,7,7,0,41.87764,-87.64957
13157,6,17,true,5,6,1,41.87773,-87.6548
13206,6,17,true,5,4,-1,41.87794,-87.66201
638,6,17,true,7,4,-3,41.87827,-87.64078
TA1305000005,6,17,true,5,1,-4,41.87924,-87.62975
13011,6,17,true,7,9,2,41.87931,-87.63993
15667,6,17,true,5,5,0,41.8798,-87.68609
WL-011,6,17,true,5,8,3,41.88034,-87.64273
13300,6,17,true,24,21,-3,41.88097,-87.61675
13008,6,17,true,6,7,1,41.88105,-87.62408
TA1305000006,6,17,true,7,9,2,41.88122,-87.6296
TA1307000120,6,17,true,13,10,-3,41.88188,-87.64879
13341,6,17,true,5,2,-3,41.88208,-87.63985
13036,6,17,true,3,5,2,41.8821,-87.62513
TA1305000032,6,17,true,10,12,2,41.88218,-87.64109
13353,6,17,true,9,2,-7,41.88283,-87.6612
13409,6,17,true,7,2,-5,41.8831,-87.6511
WL-012,6,17,true,6,5,-1,41.88337,-87.6412
13053,6,17,true,17,10,-7,41.88365,-87.64863
TA1306000010,6,17,true,5,8,3,41.88419,-87.62961
15535,6,17,true,6,11,5,41.8846,-87.64455
TA1305000029,6,17,true,9,12,3,41.88466,-87.62787
13263,6,17,true,13,10,-3,41.88467,-87.61952
TA1306000015,6,17,true,6,12,6,41.88549,-87.65232
13021,6,17,true,3,8,5,41.88559,-87.64184
TA1307000111,6,17,true,5,6,1,41.88582,-87.63548
KA1503000012,6,17,true,6,10,4,41.88599,-87.63089
TA1305000011,6,17,true,6,12,6,41.886,-87.62418
TA1307000131,6,17,true,6,2,-4,41.88688,-87.62606
KA1503000064,6,17,true,7,10,3,41.88697,-87.61281
TA1305000022,6,17,true,12,10,-2,41.88817,-87.63656
TA1306000003,6,17,true,20,17,-3,41.88867,-87.64442
KA1503000043,6,17,true,21,13,-8,41.88918,-87.63851
13050,6,17,true,5,8,3,41.88919,-87.62775
TA1307000151,6,17,true,13,14,1,41.88993,-87.63427
636,6,17,true,4,7,3,41.88997,-87.63662
13427,6,17,true,5,1,-4,41.89054,-87.62205
13430,6,17,true,10,10,0,41.89077,-87.63169
TA1306000013,6,17,true,10,10,0,41.89083,-87.61852
RN-,6,17,true,9,12,3,41.89102,-87.63546
13434,6,17,true,3,8,5,41.89108,-87.66663
TA1307000117,6,17,true,13,21,8,41.89144,-87.62675
13033,6,17,true,15,12,-3,41.8916,-87.64835
13194,6,17,true,4,7,3,41.8918,-87.65878
TA1305000003,6,17,true,17,8,-9,41.89187,-87.62061
13022,6,17,true,24,16,-8,41.89227,-87.61205
TA1306000029,6,17,true,8,16,8,41.89256,-87.61449
13265,6,17,true,13,17,4,41.89383,-87.64172
13045,6,17,true,17,24,7,41.89403,-87.62931
13016,6,17,true,10,9,-1,41.89431,-87.62277
KA1503000041,6,17,true,5,10,5,41.89452,-87.61798
TA1307000062,6,17,true,4,9,5,41.89466,-87.63839
TA1306000012,6,17,true,18,15,-3,41.89475,-87.63438
KP1705001026,6,17,true,7,4,-3,41.89483,-87.6323
637,6,17,true,2,5,3,41.89563,-87.67209
15530,6,17,true,8,9,1,41.89575,-87.62596
18003,6,17,true,8,3,-5,41.89575,-87.62011
13247,6,17,true,6,4,-2,41.89597,-87.66775
TA1305000020,6,17,true,4,8,4,41.89636,-87.65406
13289,6,17,true,7,8,1,41.89638,-87.661
13303,6,17,true,20,12,-8,41.89672,-87.63088
13017,6,17,true,7,4,-3,41.89676,-87.6357
13338,6,17,true,6,7,1,41.89697,-87.62173
TA1307000061,6,17,true,9,5,-4,41.89745,-87.62873
13034,6,17,true,5,4,-1,41.89754,-87.62352
TA1306000009,6,17,true,16,3,-13,41.89772,-87.64299
620,6,17,true,7,12,5,41.89817,-87.63754
KA1504000103,6,17,true,5,3,-2,41.89842,-87.68659
15529,6,17,true,9,5,-4,41.89858,-87.62206
TA1307000128,6,17,true,16,16,0,41.89896,-87.6299
TA1306000011,6,17,true,10,13,3,41.89994,-87.63443
17660,6,17,true,5,1,-4,41.90036,-87.69671
13290,6,17,true,5,6,1,41.90069,-87.66259
13042,6,17,true,26,22,-4,41.90097,-87.62377
TA1307000070,6,17,true,3,5,2,41.90133,-87.67742
KA1504000133,6,17,true,10,7,-3,41.90234,-87.62773
TA1307000039,6,17,true,20,19,-1,41.90294,-87.63137
TA1305000034,6,17,true,12,10,-2,41.90313,-87.67391
KA1504000135,6,17,true,21,21,0,41.90319,-87.63439
13136,6,17,true,6,7,1,41.90326,-87.67845
13061,6,17,true,11,6,-5,41.90342,-87.66779
KA1504000079,6,17,true,8,5,-3,41.9035,-87.64334
TA1307000115,6,17,true,9,3,-6,41.9046,-87.64056
TA1308000049,6,17,true,17,19,2,41.90672,-87.6349
KA1504000134,6,17,true,12,12,0,41.90687,-87.6262
13224,6,17,true,14,11,-3,41.90706,-87.66725
TA1307000143,6,17,true,7,8,1,41.90762,-87.63854
13221,6,17,true,11,9,-2,41.90765,-87.67254
TA1309000024,6,17,true,29,13,-16,41.908,-87.63152
TA1305000041,6,17,true,11,9,-2,41.9094,-87.67769
331,6,17,true,14,20,6,41.90965,-87.64812
TA1305000037,6,17,true,4,9,5,41.91018,-87.67003
TA1306000008,6,17,true,5,5,0,41.9102,-87.6435
TA1308000005,6,17,true,9,11,2,41.91042,-87.68238
13154,6,17,true,10,13,3,41.91054,-87.65312
13058,6,17,true,5,10,5,41.91059,-87.64942
TA1307000038,6,17,true,10,9,-1,41.91138,-87.63868
LF-005,6,17,true,44,26,-18,41.91172,-87.62681
13128,6,17,true,16,6,-10,41.91197,-87.63197
TA1308000050,6,17,true,44,34,-10,41.91211,-87.6347
13243,6,17,true,6,13,7,41.91262,-87.6814
TA1309000032,6,17,true,1,6,5,41.91293,-87.66417
TA1306000032,6,17,true,13,10,-3,41.9137,-87.65285
TA1307000166,6,17,true,8,15,7,41.91386,-87.64877
18067,6,17,true,14,9,-5,41.9146,-87.66796
TA1306000007,6,17,true,7,6,-1,41.91469,-87.64333
13068,6,17,true,9,3,-6,41.91554,-87.68703
13179,6,17,true,17,16,-1,41.9157,-87.63461
13133,6,17,true,7,9,2,41.91598,-87.67733
13266,6,17,true,2,7,5,41.91774,-87.69142
TA1309000029,6,17,true,6,4,-2,41.9178,-87.68245
TA1309000006,6,17,true,8,7,-1,41.91809,-87.64375
TA1307000163,6,17,true,14,2,-12,41.91821,-87.65696
13146,6,17,true,27,35,8,41.91831,-87.63629
13059,6,17,true,18,22,4,41.91845,-87.65222
13192,6,17,true,15,9,-6,41.91995,-87.64884
13288,6,17,true,3,6,3,41.92008,-87.67788
13242,6,17,true,1,5,4,41.92021,-87.69266
TA1309000030,6,17,true,2,5,3,41.92077,-87.66372
13292,6,17,true,5,4,-1,41.92152,-87.70733
TA1309000033,6,17,true,12,19,7,41.92158,-87.65381
13193,6,17,true,18,10,-8,41.92182,-87.64412
13191,6,17,true,6,12,6,41.92217,-87.63891
13084,6,17,true,2,5,3,41.92268,-87.69715
LP-,6,17,true,17,4,-13,41.92396,-87.63584
TA1307000001,6,17,true,8,13,5,41.92535,-87.66581
TA1306000026,6,17,true,5,13,8,41.92558,-87.65842
TA1306000016,6,17,true,10,9,-1,41.9256,-87.65371
TA1309000019,6,17,true,22,15,-7,41.92586,-87.63897
TA1309000058,6,17,true,12,19,7,41.92591,-87.64927
TA1308000001,6,17,true,26,18,-8,41.92627,-87.63086
15646,6,17,true,1,7,6,41.92668,-87.6977
13124,6,17,true,6,3,-3,41.92675,-87.63444
TA1309000023,6,17,true,16,23,7,41.9287,-87.65383
TA1307000113,6,17,true,14,8,-6,41.92878,-87.66391
13296,6,17,true,4,5,1,41.92883,-87.66852
TA1309000059,6,17,true,2,8,6,41.92889,-87.65898
TA1309000061,6,17,true,18,18,0,41.92915,-87.64909
TA1305000014,6,17,true,15,13,-2,41.92956,-87.64313
13085,6,17,true,8,10,2,41.92958,-87.70789
TA1307000142,6,17,true,15,17,2,41.93125,-87.64432
13276,6,17,true,13,5,-8,41.93132,-87.63874
13271,6,17,true,3,7,4,41.93192,-87.67784
TA1307000064,6,17,true,9,10,1,41.93222,-87.65864
TA1306000014,6,17,true,17,11,-6,41.93242,-87.65271
TA1309000039,6,17,true,21,11,-10,41.93258,-87.63642
TA1309000036,6,17,true,18,13,-5,41.93313,-87.64776
TA1307000006,6,17,true,9,20,11,41.93571,-87.6636
13269,6,17,true,6,8,2,41.93609,-87.66983
TA1307000052,6,17,true,6,16,10,41.93628,-87.65266
TA1307000136,6,17,true,15,16,1,41.9365,-87.64755
TA1307000041,6,17,true,19,12,-7,41.93669,-87.63683
13137,6,17,true,19,19,0,41.9376,-87.6441
TA1309000042,6,17,true,6,9,3,41.93937,-87.66836
13229,6,17,true,8,5,-3,41.93946,-87.66376
TA1308000019,6,17,true,5,8,3,41.93973,-87.65886
13277,6,17,true,9,9,0,41.9401,-87.64546
TA1307000134,6,17,true,14,23,9,41.94016,-87.65303
TA1309000049,6,17,true,20,18,-2,41.94077,-87.63919
13144,6,17,true,13,5,-8,41.9434,-87.67964
TA1309000025,6,17,true,11,14,3,41.94368,-87.64894
13071,6,17,true,12,15,3,41.94373,-87.66401
632,6,17,true,13,15,2,41.94453,-87.6547
13278,6,17,true,10,16,6,41.94553,-87.64644
13235,6,17,true,13,11,-2,41.94814,-87.66396
13325,6,17,true,15,19,4,41.94907,-87.64863
TA1307000126,6,17,true,7,33,26,41.94936,-87.65451
TA1307000150,6,17,true,14,10,-4,41.94945,-87.64646
TA1307000127,6,17,true,5,15,10,41.9508,-87.65918
13323,6,17,true,6,10,4,41.95282,-87.65
TA1309000043,6,17,true,3,8,5,41.95417,-87.66434
13063,6,17,true,13,5,-8,41.95424,-87.65441
TA1308000022,6,17,true,5,5,0,41.95438,-87.64805
TA1307000149,6,17,true,2,6,4,41.95467,-87.67392
TA1309000026,6,17,true,9,4,-5,41.95601,-87.6802
13379,6,17,true,8,4,-4,41.95786,-87.6495
TA1309000027,6,17,true,7,4,-3,41.9585,-87.65499
13389,6,17,true,13,6,-7,41.961,-87.64958
TA1307000144,6,17,true,3,5,2,41.96142,-87.6762
TA1309000021,6,17,true,5,1,-4,41.9615,-87.6714
KA1503000022,6,17,true,3,11,8,41.96158,-87.66609
TA1307000107,6,17,true,11,11,0,41.96164,-87.65464
TA1308000012,6,17,true,17,19,2,41.96398,-87.63818
13074,6,17,true,6,6,0,41.96521,-87.6582
639,6,17,true,6,7,1,41.96584,-87.64538
TA1307000140,6,17,true,7,4,-3,41.96643,-87.68865
TA1309000014,6,17,true,6,10,4,41.96709,-87.66744
TA1307000158,6,17,true,5,5,0,41.9671,-87.67904
TA1308000021,6,17,true,7,4,-3,41.96883,-87.65765
KA1504000080,6,17,true,4,5,1,41.96887,-87.69609
TA1309000066,6,17,true,4,5,1,41.9691,-87.67423
KA1504000171,6,17,true,8,13,5,41.97161,-87.65016
TA1309000035,6,17,true,9,8,-1,41.97335,-87.66785
13108,6,17,true,5,15,10,41.97379,-87.65971
KA1504000149,6,17,true,5,4,-1,41.97562,-87.67945
KA1504000146,6,17,true,5,12,7,41.978,-87.66805
13109,6,17,true,7,5,-2,41.97835,-87.65976
KA1504000152,6,17,true,12,10,-2,41.98403,-87.65231
15578,6,17,true,8,2,-6,41.98405,-87.66027
15575,6,17,true,6,2,-4,41.98975,-87.66014
15571,6,17,true,9,7,-2,41.99478,-87.66028
660,6,17,true,4,6,2,42.00458,-87.66143
525,6,17,true,4,5,1,42.01272,-87.66605
KA1503000014,6,18,false,9,8,-1,41.7851,-87.60108
KA1503000071,6,18,false,5,6,1,41.79148,-87.59988
TA1308000009,6,18,false,10,14,4,41.79522,-87.58075
15470,6,18,false,5,3,-2,41.80228,-87.61807
KA1503000007,6,18,false,8,8,0,41.80242,-87.58689
TA1308000038,6,18,false,6,4,-2,41.82298,-87.6071
KA1503000004,6,18,false,6,3,-3,41.83127,-87.6088
TA1307000048,6,18,false,25,21,-4,41.83855,-87.60821
TA1308000036,6,18,false,2,7,5,41.83883,-87.62186
TA1305000004,6,18,false,5,2,-3,41.8514,-87.61884
TA1305000001,6,18,false,1,9,8,41.85262,-87.6265
13075,6,18,false,9,11,2,41.8531,-87.63192
15545,6,18,false,20,9,-11,41.85627,-87.61334
SL-013,6,18,false,6,2,-4,41.85659,-87.62755
13135,6,18,false,2,7,5,41.85753,-87.66157
13102,6,18,false,10,4,-6,41.85762,-87.61942
13164,6,18,false,5,2,-3,41.85818,-87.65648
TA1307000124,6,18,false,19,6,-13,41.86411,-87.62372
TA1309000001,6,18,false,3,7,4,41.86488,-87.64708
13029,6,18,false,2,10,8,41.86531,-87.6179
13431,6,18,false,21,22,1,41.8661,-87.60728
TA1305000002,6,18,false,15,17,2,41.86721,-87.62597
15544,6,18,false,16,23,7,41.86723,-87.61536
KA1706005007,6,18,false,11,8,-3,41.86749,-87.63219
SL-005,6,18,false,22,23,1,41.8679,-87.62304
13160,6,18,false,6,1,-5,41.86947,-87.65548
TA1309000010,6,18,false,24,9,-15,41.87074,-87.62574
SL-008,6,18,false,13,16,3,41.87209,-87.62956
623,6,18,false,18,33,15,41.87272,-87.62399
SL-007,6,18,false,13,10,-3,41.87404,-87.6277
15541,6,18,false,19,23,4,41.8758,-87.62086
TA1305000010,6,18,false,14,1,-13,41.87623,-87.62444
TA1305000035,6,18,false,11,6,-5,41.87716,-87.62787
13158,6,18,false,9,12,3,41.87764,-87.64957
13157,6,18,false,4,5,1,41.87773,-87.6548
TA1305000025,6,18,false,8,14,6,41.87773,-87.63528
TA1309000002,6,18,false,18,10,-8,41.87784,-87.62408
13206,6,18,false,5,5,0,41.87794,-87.66201
TA1309000004,6,18,false,4,5,1,41.87811,-87.63184
TA1305000005,6,18,false,8,5,-3,41.87924,-87.62975
13011,6,18,false,10,10,0,41.87931,-87.63993
KA1503000034,6,18,false,5,9,4,41.87938,-87.63197
KA1503000015,6,18,false,6,2,-4,41.87948,-87.6257
WL-011,6,18,false,3,8,5,41.88034,-87.64273
13156,6,18,false,5,10,5,41.88042,-87.65554
13300,6,18,false,76,78,2,41.88097,-87.61675
13008,6,18,false,67,61,-6,41.88105,-87.62408
TA1305000006,6,18,false,15,16,1,41.88122,-87.6296
13134,6,18,false,2,8,6,41.88138,-87.67493
13056,6,18,false,1,8,7,41.88168,-87.63951
TA1307000120,6,18,false,19,18,-1,41.88188,-87.64879
13036,6,18,false,15,10,-5,41.8821,-87.62513
TA1305000032,6,18,false,16,13,-3,41.88218,-87.64109
13409,6,18,false,1,7,6,41.8831,-87.6511
WL-012,6,18,false,9,9,0,41.88337,-87.6412
13053,6,18,false,18,24,6,41.88365,-87.64863
13001,6,18,false,8,9,1,41.88397,-87.62459
18062,6,18,false,6,6,0,41.88412,-87.65427
TA1306000010,6,18,false,9,11,2,41.88419,-87.62961
TA1305000030,6,18,false,11,6,-5,41.88459,-87.63178
15535,6,18,false,10,12,2,41.8846,-87.64455
TA1305000029,6,18,false,22,19,-3,41.88466,-87.62787
13263,6,18,false,20,11,-9,41.88467,-87.61952
TA1306000015,6,18,false,17,15,-2,41.88549,-87.65232
13021,6,18,false,6,14,8,41.88559,-87.64184
TA1307000111,6,18,false,10,5,-5,41.88582,-87.63548
13073,6,18,false,10,2,-8,41.88592,-87.66717
KA1503000012,6,18,false,13,14,1,41.88599,-87.63089
TA1305000011,6,18,false,29,35,6,41.886,-87.62418
15534,6,18,false,15,13,-2,41.88627,-87.61749
TA1308000029,6,18,false,20,20,0,41.88673,-87.62225
TA1307000131,6,18,false,9,7,-2,41.88688,-87.62606
KA1503000064,6,18,false,42,42,0,41.88697,-87.61281
TA1305000022,6,18,false,15,8,-7,41.88817,-87.63656
TA1306000003,6,18,false,13,16,3,41.88867,-87.64442
KA1503000043,6,18,false,14,20,6,41.88918,-87.63851
13050,6,18,false,20,16,-4,41.88919,-87.62775
TA1307000151,6,18,false,27,22,-5,41.88993,-87.63427
636,6,18,false,7,7,0,41.88997,-87.63662
KA1503000044,6,18,false,9,13,4,41.89018,-87.6262
13427,6,18,false,4,14,10,41.89054,-87.62205
13430,6,18,false,31,16,-15,41.89077,-87.63169
TA1306000013,6,18,false,42,33,-9,41.89083,-87.61852
RN-,6,18,false,10,13,3,41.89102,-87.63546
13434,6,18,false,3,8,5,41.89108,-87.66663
TA1308000006,6,18,false,4,5,1,41.89128,-87.67686
TA1307000117,6,18,false,38,44,6,41.89144,-87.62675
13033,6,18,false,15,25,10,41.8916,-87.64835
13194,6,18,false,8,8,0,41.8918,-87.65878
TA1305000003,6,18,false,18,19,1,41.89187,-87.62061
13022,6,18,false,189,169,-20,41.89227,-87.61205
TA1306000029,6,18,false,40,30,-10,41.89256,-87.61449
13265,6,18,false,14,11,-3,41.89383,-87.64172
13045,6,18,false,39,26,-13,41.89403,-87.62931
13016,6,18,false,13,21,8,41.89431,-87.62277
KA1503000041,6,18,false,14,6,-8,41.89452,-87.61798
13196,6,18,false,15,9,-6,41.89455,-87.65345
TA1307000062,6,18,false,2,6,4,41.89466,-87.63839
TA1306000012,6,18,false,30,22,-8,41.89475,-87.63438
KP1705001026,6,18,false,11,21,10,41.89483,-87.6323
18058,6,18,false,4,5,1,41.8955,-87.68201
13132,6,18,false,7,7,0,41.89573,-87.67718
15530,6,18,false,13,15,2,41.89575,-87.62596
18003,6,18,false,3,9,6,41.89575,-87.62011
13247,6,18,false,3,6,3,41.89597,-87.66775
TA1305000020,6,18,false,9,12,3,41.89636,-87.65406
13289,6,18,false,7,4,-3,41.89638,-87.661
13303,6,18,false,7,12,5,41.89672,-87.63088
13338,6,18,false,13,9,-4,41.89697,-87.62173
TA1307000061,6,18,false,6,12,6,41.89745,-87.62873
13034,6,18,false,14,15,1,41.89754,-87.62352
TA1306000009,6,18,false,9,3,-6,41.89772,-87.64299
620,6,18,false,9,7,-2,41.89817,-87.63754
KA1504000103,6,18,false,5,2,-3,41.89842,-87.68659
15529,6,18,false,19,11,-8,41.89858,-87.62206
TA1307000128,6,18,false,24,17,-7,41.89896,-87.6299
657,6,18,false,5,2,-3,41.89918,-87.6722
13248,6,18,false,3,6,3,41.89964,-87.66788
TA1306000011,6,18,false,8,6,-2,41.89994,-87.63443
KA1504000116,6,18,false,9,4,-5,41.90023,-87.64299
17660,6,18,false,6,9,3,41.90036,-87.69671
13290,6,18,false,7,8,1,41.90069,-87.66259
13042,6,18,false,67,53,-14,41.90097,-87.62377
TA1307000070,6,18,false,6,7,1,41.90133,-87.67742
KA1504000133,6,18,false,23,29,6,41.90234,-87.62773
13241,6,18,false,4,6,2,41.9029,-87.68731
TA1307000039,6,18,false,31,34,3,41.90294,-87.63137
658,6,18,false,1,5,4,41.903,-87.6838
TA1305000034,6,18,false,10,12,2,41.90313,-87.67391
KA1504000135,6,18,false,28,22,-6,41.90319,-87.63439
13136,6,18,false,5,10,5,41.90326,-87.67845
13061,6,18,false,17,28,11,41.90342,-87.66779
KA1504000079,6,18,false,15,7,-8,41.9035,-87.64334
TA1307000115,6,18,false,6,4,-2,41.9046,-87.64056
TA1308000049,6,18,false,36,42,6,41.90672,-87.6349
KA1504000134,6,18,false,12,11,-1,41.90687,-87.6262
13224,6,18,false,5,14,9,41.90706,-87.66725
13221,6,18,false,6,21,15,41.90765,-87.67254
TA1309000024,6,18,false,6,13,7,41.908,-87.63152
TA1305000041,6,18,false,27,19,-8,41.9094,-87.67769
331,6,18,false,17,17,0,41.90965,-87.64812
TA1305000037,6,18,false,17,15,-2,41.91018,-87.67003
TA1306000008,6,18,false,11,18,7,41.9102,-87.6435
TA1308000005,6,18,false,5,10,5,41.91042,-87.68238
13258,6,18,false,9,4,-5,41.91043,-87.69718
13154,6,18,false,12,4,-8,41.91054,-87.65312
13058,6,18,false,8,13,5,41.91059,-87.64942
TA1307000038,6,18,false,20,16,-4,41.91138,-87.63868
LF-005,6,18,false,76,80,4,41.91172,-87.62681
13128,6,18,false,11,8,-3,41.91197,-87.63197
TA1308000050,6,18,false,32,36,4,41.91211,-87.6347
13243,6,18,false,6,9,3,41.91262,-87.6814
TA1306000032,6,18,false,9,5,-4,41.9137,-87.65285
TA1307000166,6,18,false,11,10,-1,41.91386,-87.64877
18067,6,18,false,9,6,-3,41.9146,-87.66796
TA1306000007,6,18,false,7,4,-3,41.91469,-87.64333
13068,6,18,false,8,8,0,41.91554,-87.68703
13179,6,18,false,36,29,-7,41.9157,-87.63461
13133,6,18,false,6,7,1,41.91598,-87.67733
TA1305000039,6,18,false,6,1,-5,41.9163,-87.66749
15650,6,18,false,7,4,-3,41.91711,-87.71023
15651,6,18,false,4,7,3,41.91752,-87.70181
TA1309000006,6,18,false,4,14,10,41.91809,-87.64375
TA1307000163,6,18,false,7,7,0,41.91821,-87.65696
13146,6,18,false,48,29,-19,41.91831,-87.63629
13059,6,18,false,22,24,2,41.91845,-87.65222
13259,6,18,false,5,5,0,41.91852,-87.69744
13192,6,18,false,12,18,6,41.91995,-87.64884
13288,6,18,false,3,5,2,41.92008,-87.67788
13242,6,18,false,3,5,2,41.92021,-87.69266
TA1309000033,6,18,false,11,17,6,41.92158,-87.65381
13193,6,18,false,41,37,-4,41.92182,-87.64412
13191,6,18,false,25,21,-4,41.92217,-87.63891
13084,6,18,false,12,12,0,41.92268,-87.69715
LP-,6,18,false,22,6,-16,41.92396,-87.63584
15648,6,18,false,4,6,2,41.92464,-87.68931
TA1307000001,6,18,false,13,21,8,41.92535,-87.66581
TA1306000026,6,18,false,7,6,-1,41.92558,-87.65842
TA1306000016,6,18,false,14,6,-8,41.9256,-87.65371
TA1309000019,6,18,false,31,22,-9,41.92586,-87.63897
TA1309000058,6,18,false,19,24,5,41.92591,-87.64927
TA1308000001,6,18,false,41,37,-4,41.92627,-87.63086
13124,6,18,false,15,10,-5,41.92675,-87.63444
TA1309000023,6,18,false,25,24,-1,41.9287,-87.65383
TA1307000113,6,18,false,18,28,10,41.92878,-87.66391
13296,6,18,false,1,8,7,41.92883,-87.66852
TA1309000061,6,18,false,19,26,7,41.92915,-87.64909
TA1308000031,6,18,false,5,9,4,41.92946,-87.68417
TA1305000014,6,18,false,23,31,8,41.92956,-87.64313
13085,6,18,false,13,18,5,41.92958,-87.70789
TA1307000142,6,18,false,16,15,-1,41.93125,-87.64432
13276,6,18,false,10,9,-1,41.93132,-87.63874
13271,6,18,false,4,7,3,41.93192,-87.67784
TA1307000064,6,18,false,13,17,4,41.93222,-87.65864
TA1306000014,6,18,false,16,32,16,41.93242,-87.65271
TA1309000039,6,18,false,18,20,2,41.93258,-87.63642
13294,6,18,false,1,11,10,41.9326,-87.66595
TA1309000036,6,18,false,13,15,2,41.93313,-87.64776
TA1307000006,6,18,false,13,9,-4,41.93571,-87.6636
13268,6,18,false,3,5,2,41.93588,-87.67843
13269,6,18,false,5,4,-1,41.93609,-87.66983
TA1307000052,6,18,false,16,25,9,41.93628,-87.65266
TA1307000136,6,18,false,10,17,7,41.9365,-87.64755
TA1307000041,6,18,false,37,36,-1,41.93669,-87.63683
13137,6,18,false,25,16,-9,41.9376,-87.6441
15642,6,18,false,7,4,-3,41.93843,-87.69801
TA1309000042,6,18,false,11,7,-4,41.93937,-87.66836
13229,6,18,false,10,13,3,41.93946,-87.66376
TA1308000019,6,18,false,20,21,1,41.93973,-87.65886
13277,6,18,false,14,22,8,41.9401,-87.64546
TA1307000134,6,18,false,17,34,17,41.94016,-87.65303
13143,6,18,false,3,7,4,41.94059,-87.67853
TA1309000049,6,18,false,36,28,-8,41.94077,-87.63919
TA1307000138,6,18,false,14,5,-9,41.94334,-87.67094
TA1309000025,6,18,false,15,30,15,41.94368,-87.64894
13071,6,18,false,17,17,0,41.94373,-87.66401
632,6,18,false,28,62,34,41.94453,-87.6547
13278,6,18,false,23,19,-4,41.94553,-87.64644
TA1309000050,6,18,false,4,8,4,41.94618,-87.67331
13235,6,18,false,9,12,3,41.94814,-87.66396
13253,6,18,false,11,6,-5,41.9488,-87.67527
13325,6,18,false,6,14,8,41.94907,-87.64863
TA1307000126,6,18,false,11,34,23,41.94936,-87.65451
TA1307000150,6,18,false,13,30,17,41.94945,-87.64646
13319,6,18,false,2,5,3,41.95069,-87.6687
TA1307000127,6,18,false,12,7,-5,41.9508,-87.65918
13323,6,18,false,10,19,9,41.95282,-87.65
TA1309000043,6,18,false,4,11,7,41.95417,-87.66434
13063,6,18,false,2,20,18,41.95424,-87.65441
TA1308000022,6,18,false,10,10,0,41.95438,-87.64805
TA1307000149,6,18,false,3,5,2,41.95467,-87.67392
13379,6,18,false,5,7,2,41.95786,-87.6495
TA1309000027,6,18,false,8,1,-7,41.9585,-87.65499
13389,6,18,false,15,5,-10,41.961,-87.64958
TA1307000144,6,18,false,3,6,3,41.96142,-87.6762
TA1307000107,6,18,false,8,4,-4,41.96164,-87.65464
TA1308000012,6,18,false,35,31,-4,41.96398,-87.63818
13074,6,18,false,8,8,0,41.96521,-87.6582
639,6,18,false,15,8,-7,41.96584,-87.64538
TA1309000014,6,18,false,6,5,-1,41.96709,-87.66744
TA1307000119,6,18,false,7,2,-5,41.96796,-87.65
TA1308000021,6,18,false,6,8,2,41.96883,-87.65765
KA1504000171,6,18,false,15,5,-10,41.97161,-87.65016
TA1309000035,6,18,false,5,10,5,41.97335,-87.66785
KA1504000146,6,18,false,8,8,0,41.978,-87.66805
13109,6,18,false,7,3,-4,41.97835,-87.65976
KA1504000152,6,18,false,21,21,0,41.98403,-87.65231
15578,6,18,false,7,6,-1,41.98405,-87.66027
15575,6,18,false,7,3,-4,41.98975,-87.66014
15571,6,18,false,2,5,3,41.99478,-87.66028
660,6,18,false,3,6,3,42.00458,-87.66143
598,6,18,false,5,1,-4,42.02578,-87.68411
E008,6,18,false,8,6,-2,42.05049,-87.67782
TA1308000009,6,18,true,9,7,-2,41.79522,-87.58075
TA1309000037,6,18,true,5,3,-2,41.79957,-87.59474
KA1503000004,6,18,true,5,3,-2,41.83127,-87.6088
13216,6,18,true,6,1,-5,41.83473,-87.62581
13217,6,18,true,1,7,6,41.83488,-87.61792
TA1308000046,6,18,true,5,2,-3,41.83779,-87.65115
TA1309000055,6,18,true,8,9,1,41.8382,-87.64514
TA1307000048,6,18,true,7,5,-2,41.83855,-87.60821
13075,6,18,true,4,5,1,41.8531,-87.63192
15546,6,18,true,6,4,-2,41.85416,-87.61916
15545,6,18,true,11,15,4,41.85627,-87.61334
13102,6,18,true,7,5,-2,41.85762,-87.61942
13150,6,18,true,2,7,5,41.85783,-87.62455
13164,6,18,true,3,7,4,41.85818,-87.65648
SL-012,6,18,true,7,8,1,41.86038,-87.62581
TA1307000124,6,18,true,6,6,0,41.86411,-87.62372
13029,6,18,true,2,7,5,41.86531,-87.6179
13431,6,18,true,16,16,0,41.8661,-87.60728
WL-008,6,18,true,5,10,5,41.86712,-87.64108
TA1305000002,6,18,true,18,11,-7,41.86721,-87.62597
15544,6,18,true,4,6,2,41.86723,-87.61536
KA1706005007,6,18,true,4,6,2,41.86749,-87.63219
SL-005,6,18,true,23,14,-9,41.8679,-87.62304
644,6,18,true,7,4,-3,41.86859,-87.68625
13139,6,18,true,1,5,4,41.86893,-87.65913
13160,6,18,true,8,3,-5,41.86947,-87.65548
TA1309000010,6,18,true,4,9,5,41.87074,-87.62574
SL-009,6,18,true,7,2,-5,41.87081,-87.63121
TA1307000130,6,18,true,10,9,-1,41.87178,-87.65103
SL-008,6,18,true,5,11,6,41.87209,-87.62956
13332,6,18,true,12,13,1,41.87219,-87.6615
SL-011,6,18,true,7,3,-4,41.87256,-87.63356
623,6,18,true,9,1,-8,41.87272,-87.62399
SL-007,6,18,true,6,7,1,41.87404,-87.6277
13158,6,18,true,6,7,1,41.87764,-87.64957
13157,6,18,true,5,5,0,41.87773,-87.6548
TA1305000025,6,18,true,3,5,2,41.87773,-87.63528
13206,6,18,true,8,7,-1,41.87794,-87.66201
WL-011,6,18,true,10,6,-4,41.88034,-87.64273
13156,6,18,true,2,6,4,41.88042,-87.65554
13300,6,18,true,19,19,0,41.88097,-87.61675
13008,6,18,true,9,13,4,41.88105,-87.62408
TA1305000006,6,18,true,11,4,-7,41.88122,-87.6296
TA1307000120,6,18,true,11,13,2,41.88188,-87.64879
TA1305000032,6,18,true,7,6,-1,41.88218,-87.64109
13409,6,18,true,6,3,-3,41.8831,-87.6511
13053,6,18,true,11,11,0,41.88365,-87.64863
13001,6,18,true,3,7,4,41.88397,-87.62459
TA1306000010,6,18,true,9,5,-4,41.88419,-87.62961
TA1305000030,6,18,true,6,4,-2,41.88459,-87.63178
15535,6,18,true,6,9,3,41.8846,-87.64455
TA1305000029,6,18,true,6,10,4,41.88466,-87.62787
13263,6,18,true,9,16,7,41.88467,-87.61952
TA1306000015,6,18,true,11,12,1,41.88549,-87.65232
13021,6,18,true,8,8,0,41.88559,-87.64184
KA1503000012,6,18,true,2,12,10,41.88599,-87.63089
TA1305000011,6,18,true,8,6,-2,41.886,-87.62418
15534,6,18,true,5,11,6,41.88627,-87.61749
TA1307000131,6,18,true,6,5,-1,41.88688,-87.62606
KA1503000064,6,18,true,15,13,-2,41.88697,-87.61281
TA1305000022,6,18,true,1,13,12,41.88817,-87.63656
TA1306000003,6,18,true,12,13,1,41.88867,-87.64442
KA1503000043,6,18,true,16,10,-6,41.88918,-87.63851
13050,6,18,true,8,10,2,41.88919,-87.62775
TA1307000151,6,18,true,14,14,0,41.88993,-87.63427
636,6,18,true,3,11,8,41.88997,-87.63662
KA1503000044,6,18,true,5,4,-1,41.89018,-87.6262
13427,6,18,true,6,5,-1,41.89054,-87.62205
13430,6,18,true,8,9,1,41.89077,-87.63169
TA1306000013,6,18,true,15,12,-3,41.89083,-87.61852
RN-,6,18,true,9,11,2,41.89102,-87.63546
TA1307000117,6,18,true,25,18,-7,41.89144,-87.62675
13033,6,18,true,11,13,2,41.8916,-87.64835
13194,6,18,true,6,5,-1,41.8918,-87.65878
TA1305000003,6,18,true,19,9,-10,41.89187,-87.62061
13022,6,18,true,24,26,2,41.89227,-87.61205
TA1306000029,6,18,true,12,9,-3,41.89256,-87.61449
13265,6,18,true,8,18,10,41.89383,-87.64172
13045,6,18,true,11,10,-1,41.89403,-87.62931
13016,6,18,true,9,6,-3,41.89431,-87.62277
KA1503000041,6,18,true,8,8,0,41.89452,-87.61798
TA1307000062,6,18,true,6,5,-1,41.89466,-87.63839
TA1306000012,6,18,true,14,16,2,41.89475,-87.63438
KP1705001026,6,18,true,10,6,-4,41.89483,-87.6323
637,6,18,true,5,5,0,41.89563,-87.67209
13132,6,18,true,5,4,-1,41.89573,-87.67718
13247,6,18,true,7,1,-6,41.89597,-87.66775
TA1305000020,6,18,true,5,3,-2,41.89636,-87.65406
13017,6,18,true,9,5,-4,41.89676,-87.6357
13338,6,18,true,7,10,3,41.89697,-87.62173
TA1307000061,6,18,true,12,6,-6,41.89745,-87.62873
TA1306000009,6,18,true,5,6,1,41.89772,-87.64299
620,6,18,true,15,7,-8,41.89817,-87.63754
KA1504000103,6,18,true,3,5,2,41.89842,-87.68659
15529,6,18,true,7,10,3,41.89858,-87.62206
TA1307000128,6,18,true,15,17,2,41.89896,-87.6299
657,6,18,true,5,3,-2,41.89918,-87.6722
13248,6,18,true,2,7,5,41.89964,-87.66788
TA1306000011,6,18,true,8,6,-2,41.89994,-87.63443
13042,6,18,true,21,26,5,41.90097,-87.62377
TA1307000070,6,18,true,3,5,2,41.90133,-87.67742
KA1504000133,6,18,true,14,13,-1,41.90234,-87.62773
TA1307000039,6,18,true,33,17,-16,41.90294,-87.63137
658,6,18,true,2,5,3,41.903,-87.6838
TA1305000034,6,18,true,6,6,0,41.90313,-87.67391
KA1504000135,6,18,true,27,21,-6,41.90319,-87.63439
13136,6,18,true,6,8,2,41.90326,-87.67845
13061,6,18,true,8,19,11,41.90342,-87.66779
KA1504000079,6,18,true,5,4,-1,41.9035,-87.64334
TA1308000049,6,18,true,33,18,-15,41.90672,-87.6349
KA1504000134,6,18,true,6,9,3,41.90687,-87.6262
13224,6,18,true,8,9,1,41.90706,-87.66725
13221,6,18,true,9,13,4,41.90765,-87.67254
TA1309000024,6,18,true,8,10,2,41.908,-87.63152
TA1305000041,6,18,true,12,14,2,41.9094,-87.67769
331,6,18,true,9,11,2,41.90965,-87.64812
TA1305000037,6,18,true,2,5,3,41.91018,-87.67003
TA1306000008,6,18,true,8,9,1,41.9102,-87.6435
TA1308000005,6,18,true,4,7,3,41.91042,-87.68238
13257,6,18,true,1,5,4,41.91054,-87.68956
13154,6,18,true,9,4,-5,41.91054,-87.65312
13058,6,18,true,5,10,5,41.91059,-87.64942
TA1307000038,6,18,true,11,9,-2,41.91138,-87.63868
LF-005,6,18,true,35,22,-13,41.91172,-87.62681
13128,6,18,true,5,5,0,41.91197,-87.63197
TA1308000050,6,18,true,24,23,-1,41.91211,-87.6347
13243,6,18,true,9,9,0,41.91262,-87.6814
TA1306000032,6,18,true,7,11,4,41.9137,-87.65285
TA1307000166,6,18,true,6,6,0,41.91386,-87.64877
TA1306000007,6,18,true,5,5,0,41.91469,-87.64333
13068,6,18,true,3,7,4,41.91554,-87.68703
13179,6,18,true,23,18,-5,41.9157,-87.63461
13133,6,18,true,4,5,1,41.91598,-87.67733
13266,6,18,true,2,6,4,41.91774,-87.69142
TA1309000006,6,18,true,14,8,-6,41.91809,-87.64375
TA1307000163,6,18,true,2,7,5,41.91821,-87.65696
13146,6,18,true,31,21,-10,41.91831,-87.63629
13059,6,18,true,6,10,4,41.91845,-87.65222
13192,6,18,true,4,10,6,41.91995,-87.64884
13288,6,18,true,5,4,-1,41.92008,-87.67788
13242,6,18,true,6,4,-2,41.92021,-87.69266
TA1309000030,6,18,true,2,5,3,41.92077,-87.66372
13292,6,18,true,5,3,-2,41.92152,-87.70733
TA1309000033,6,18,true,11,7,-4,41.92158,-87.65381
13193,6,18,true,16,21,5,41.92182,-87.64412
13191,6,18,true,14,9,-5,41.92217,-87.63891
13084,6,18,true,2,8,6,41.92268,-87.69715
LP-,6,18,true,12,5,-7,41.92396,-87.63584
TA1307000001,6,18,true,6,9,3,41.92535,-87.66581
TA1306000026,6,18,true,7,4,-3,41.92558,-87.65842
TA1306000016,6,18,true,7,5,-2,41.9256,-87.65371
TA1309000019,6,18,true,9,16,7,41.92586,-87.63897
TA1309000058,6,18,true,14,14,0,41.92591,-87.64927
TA1308000001,6,18,true,14,13,-1,41.92627,-87.63086
15646,6,18,true,5,3,-2,41.92668,-87.6977
TA1309000023,6,18,true,9,14,5,41.9287,-87.65383
TA1307000113,6,18,true,5,8,3,41.92878,-87.66391
13296,6,18,true,3,9,6,41.92883,-87.66852
TA1309000061,6,18,true,11,10,-1,41.92915,-87.64909
TA1305000014,6,18,true,14,12,-2,41.92956,-87.64313
13085,6,18,true,6,8,2,41.92958,-87.70789
TA1307000142,6,18,true,13,14,1,41.93125,-87.64432
13276,6,18,true,9,8,-1,41.93132,-87.63874
13271,6,18,true,5,2,-3,41.93192,-87.67784
TA1307000064,6,18,true,5,10,5,41.93222,-87.65864
TA1306000014,6,18,true,8,13,5,41.93242,-87.65271
TA1309000039,6,18,true,13,8,-5,41.93258,-87.63642
13294,6,18,true,4,5,1,41.9326,-87.66595
TA1309000036,6,18,true,9,8,-1,41.93313,-87.64776
TA1307000006,6,18,true,5,10,5,41.93571,-87.6636
TA1307000052,6,18,true,9,12,3,41.93628,-87.65266
TA1307000136,6,18,true,13,10,-3,41.9365,-87.64755
TA1307000041,6,18,true,15,11,-4,41.93669,-87.63683
13137,6,18,true,18,24,6,41.9376,-87.6441
TA1309000042,6,18,true,8,10,2,41.93937,-87.66836
13229,6,18,true,5,7,2,41.93946,-87.66376
TA1308000019,6,18,true,8,17,9,41.93973,-87.65886
13277,6,18,true,12,10,-2,41.9401,-87.64546
TA1307000134,6,18,true,17,17,0,41.94016,-87.65303
TA1309000049,6,18,true,23,9,-14,41.94077,-87.63919
TA1307000138,6,18,true,4,7,3,41.94334,-87.67094
TA1309000025,6,18,true,13,11,-2,41.94368,-87.64894
13071,6,18,true,11,13,2,41.94373,-87.66401
632,6,18,true,6,14,8,41.94453,-87.6547
13278,6,18,true,9,21,12,41.94553,-87.64644
13235,6,18,true,11,15,4,41.94814,-87.66396
13325,6,18,true,16,16,0,41.94907,-87.64863
TA1307000126,6,18,true,11,9,-2,41.94936,-87.65451
TA1307000150,6,18,true,17,8,-9,41.94945,-87.64646
13319,6,18,true,6,5,-1,41.95069,-87.6687
TA1307000127,6,18,true,11,5,-6,41.9508,-87.65918
15628,6,18,true,5,3,-2,41.95216,-87.69806
13323,6,18,true,7,6,-1,41.95282,-87.65
TA1309000043,6,18,true,7,4,-3,41.95417,-87.66434
13063,6,18,true,9,6,-3,41.95424,-87.65441
TA1308000022,6,18,true,6,11,5,41.95438,-87.64805
TA1309000026,6,18,true,14,3,-11,41.95601,-87.6802
13379,6,18,true,3,8,5,41.95786,-87.6495
TA1309000027,6,18,true,2,8,6,41.9585,-87.65499
13389,6,18,true,9,5,-4,41.961,-87.64958
TA1307000144,6,18,true,4,8,4,41.96142,-87.6762
TA1307000107,6,18,true,6,12,6,41.96164,-87.65464
TA1308000012,6,18,true,12,10,-2,41.96398,-87.63818
13074,6,18,true,2,5,3,41.96521,-87.6582
639,6,18,true,13,5,-8,41.96584,-87.64538
TA1309000014,6,18,true,4,11,7,41.96709,-87.66744
TA1307000119,6,18,true,5,2,-3,41.96796,-87.65
TA1309000066,6,18,true,5,5,0,41.9691,-87.67423
TA1309000035,6,18,true,4,6,2,41.97335,-87.66785
13108,6,18,true,6,7,1,41.97379,-87.65971
KA1504000149,6,18,true,5,4,-1,41.97562,-87.67945
KA1504000146,6,18,true,6,5,-1,41.978,-87.66805
13109,6,18,true,6,5,-1,41.97835,-87.65976
KA1504000152,6,18,true,16,13,-3,41.98403,-87.65231
15578,6,18,true,9,3,-6,41.98405,-87.66027
15575,6,18,true,3,5,2,41.98975,-87.66014
596,6,18,true,5,5,0,42.04822,-87.68348
15491,6,19,false,1,5,4,41.78096,-87.57624
KA1503000014,6,19,false,1,6,5,41.7851,-87.60108
KA1503000074,6,19,false,4,7,3,41.79174,-87.58395
TA1309000063,6,19,false,2,7,5,41.79325,-87.5878
TA1308000009,6,19,false,8,13,5,41.79522,-87.58075
TA1307000164,6,19,false,8,4,-4,41.79527,-87.59647
KA1503000052,6,19,false,5,1,-4,41.79935,-87.60097
KA1503000059,6,19,false,9,11,2,41.79952,-87.58643
KA1503000007,6,19,false,6,5,-1,41.80242,-87.58689
TA1308000002,6,19,false,6,1,-5,41.80983,-87.59937
KA1503000004,6,19,false,8,4,-4,41.83127,-87.6088
TA1307000048,6,19,false,13,19,6,41.83855,-87.60821
13075,6,19,false,14,12,-2,41.8531,-87.63192
15545,6,19,false,15,5,-10,41.85627,-87.61334
SL-013,6,19,false,2,7,5,41.85659,-87.62755
SL-006,6,19,false,11,12,1,41.8568,-87.63387
13102,6,19,false,5,14,9,41.85762,-87.61942
13150,6,19,false,5,2,-3,41.85783,-87.62455
13099,6,19,false,6,1,-5,41.85784,-87.64627
13164,6,19,false,8,4,-4,41.85818,-87.65648
SL-012,6,19,false,7,3,-4,41.86038,-87.62581
TA1307000124,6,19,false,7,11,4,41.86411,-87.62372
13029,6,19,false,20,13,-7,41.86531,-87.6179
13431,6,19,false,9,15,6,41.8661,-87.60728
TA1305000002,6,19,false,14,8,-6,41.86721,-87.62597
15544,6,19,false,26,17,-9,41.86723,-87.61536
SL-005,6,19,false,27,34,7,41.8679,-87.62304
13160,6,19,false,2,6,4,41.86947,-87.65548
TA1309000010,6,19,false,10,11,1,41.87074,-87.62574
SL-008,6,19,false,12,15,3,41.87209,-87.62956
13332,6,19,false,8,6,-2,41.87219,-87.6615
SL-011,6,19,false,16,8,-8,41.87256,-87.63356
623,6,19,false,21,22,1,41.87272,-87.62399
SL-007,6,19,false,12,4,-8,41.87404,-87.6277
15541,6,19,false,20,17,-3,41.8758,-87.62086
TA1305000010,6,19,false,1,9,8,41.87623,-87.62444
624,6,19,false,9,5,-4,41.87626,-87.62923
15539,6,19,false,5,3,-2,41.87763,-87.64405
13158,6,19,false,7,13,6,41.87764,-87.64957
13157,6,19,false,9,9,0,41.87773,-87.6548
TA1305000025,6,19,false,8,8,0,41.87773,-87.63528
TA1309000002,6,19,false,14,18,4,41.87784,-87.62408
TA1305000005,6,19,false,6,2,-4,41.87924,-87.62975
13011,6,19,false,12,8,-4,41.87931,-87.63993
TA1309000008,6,19,false,4,6,2,41.87933,-87.6355
KA1503000034,6,19,false,7,5,-2,41.87938,-87.63197
KA1503000015,6,19,false,10,15,5,41.87948,-87.6257
TA1309000007,6,19,false,5,5,0,41.88022,-87.63526
WL-011,6,19,false,6,2,-4,41.88034,-87.64273
13156,6,19,false,17,18,1,41.88042,-87.65554
13300,6,19,false,70,93,23,41.88097,-87.61675
13008,6,19,false,63,63,0,41.88105,-87.62408
TA1305000006,6,19,false,18,22,4,41.88122,-87.6296
TA1307000120,6,19,false,19,31,12,41.88188,-87.64879
13036,6,19,false,8,12,4,41.8821,-87.62513
TA1305000032,6,19,false,8,9,1,41.88218,-87.64109
13006,6,19,false,8,6,-2,41.88268,-87.63252
13353,6,19,false,8,14,6,41.88283,-87.6612
13409,6,19,false,5,5,0,41.8831,-87.6511
WL-012,6,19,false,8,11,3,41.88337,-87.6412
13053,6,19,false,13,23,10,41.88365,-87.64863
13001,6,19,false,23,15,-8,41.88397,-87.62459
13155,6,19,false,6,6,0,41.88407,-87.65689
18062,6,19,false,11,7,-4,41.88412,-87.65427
TA1306000010,6,19,false,8,12,4,41.88419,-87.62961
TA1305000030,6,19,false,4,8,4,41.88459,-87.63178
15535,6,19,false,13,11,-2,41.8846,-87.64455
TA1305000029,6,19,false,29,35,6,41.88466,-87.62787
13263,6,19,false,19,16,-3,41.88467,-87.61952
TA1306000015,6,19,false,5,8,3,41.88549,-87.65232
13021,6,19,false,12,9,-3,41.88559,-87.64184
TA1307000111,6,19,false,10,6,-4,41.88582,-87.63548
KA17018054,6,19,false,5,1,-4,41.88595,-87.67701
KA1503000012,6,19,false,14,13,-1,41.88599,-87.63089
TA1305000011,6,19,false,25,10,-15,41.886,-87.62418
15534,6,19,false,20,9,-11,41.88627,-87.61749
TA1308000029,6,19,false,10,15,5,41.88673,-87.62225
TA1307000131,6,19,false,22,18,-4,41.88688,-87.62606
KA1503000064,6,19,false,35,47,12,41.88697,-87.61281
TA1305000022,6,19,false,14,12,-2,41.88817,-87.63656
TA1306000003,6,19,false,21,27,6,41.88867,-87.64442
KA1503000043,6,19,false,3,7,4,41.88918,-87.63851
13050,6,19,false,18,14,-4,41.88919,-87.62775
TA1307000151,6,19,false,16,28,12,41.88993,-87.63427
636,6,19,false,10,13,3,41.88997,-87.63662
KA1503000044,6,19,false,6,9,3,41.89018,-87.6262
13427,6,19,false,17,12,-5,41.89054,-87.62205
13430,6,19,false,17,17,0,41.89077,-87.63169
TA1306000013,6,19,false,29,47,18,41.89083,-87.61852
RN-,6,19,false,3,8,5,41.89102,-87.63546
TA1308000006,6,19,false,7,4,-3,41.89128,-87.67686
TA1307000117,6,19,false,39,35,-4,41.89144,-87.62675
13033,6,19,false,7,19,12,41.8916,-87.64835
13194,6,19,false,5,6,1,41.8918,-87.65878
TA1305000003,6,19,false,26,27,1,41.89187,-87.62061
13022,6,19,false,189,187,-2,41.89227,-87.61205
TA1306000029,6,19,false,45,41,-4,41.89256,-87.61449
13265,6,19,false,5,5,0,41.89383,-87.64172
13045,6,19,false,24,21,-3,41.89403,-87.62931
13016,6,19,false,26,17,-9,41.89431,-87.62277
KA1503000041,6,19,false,16,12,-4,41.89452,-87.61798
13196,6,19,false,6,7,1,41.89455,-87.65345
TA1307000062,6,19,false,3,9,6,41.89466,-87.63839
TA1306000012,6,19,false,20,28,8,41.89475,-87.63438
KP1705001026,6,19,false,17,22,5,41.89483,-87.6323
637,6,19,false,5,2,-3,41.89563,-87.67209
13132,6,19,false,16,8,-8,41.89573,-87.67718
15530,6,19,false,21,5,-16,41.89575,-87.62596
18003,6,19,false,11,2,-9,41.89575,-87.62011
13247,6,19,false,7,5,-2,41.89597,-87.66775
TA1305000020,6,19,false,9,7,-2,41.89636,-87.65406
13289,6,19,false,8,12,4,41.89638,-87.661
13303,6,19,false,10,11,1,41.89672,-87.63088
13338,6,19,false,10,9,-1,41.89697,-87.62173
TA1307000061,6,19,false,7,3,-4,41.89745,-87.62873
13034,6,19,false,18,18,0,41.89754,-87.62352
TA1306000009,6,19,false,9,6,-3,41.89772,-87.64299
620,6,19,false,8,2,-6,41.89817,-87.63754
KA1504000103,6,19,false,2,8,6,41.89842,-87.68659
15529,6,19,false,10,8,-2,41.89858,-87.62206
TA1307000128,6,19,false,25,25,0,41.89896,-87.6299
KA1504000117,6,19,false,5,2,-3,41.89936,-87.64848
13248,6,19,false,4,5,1,41.89964,-87.66788
17660,6,19,false,4,5,1,41.90036,-87.69671
13290,6,19,false,9,8,-1,41.90069,-87.66259
13042,6,19,false,63,73,10,41.90097,-87.62377
TA1307000070,6,19,false,8,7,-1,41.90133,-87.67742
KA1504000133,6,19,false,21,21,0,41.90234,-87.62773
TA1306000006,6,19,false,5,1,-4,41.90292,-87.63772
TA1307000039,6,19,false,39,21,-18,41.90294,-87.63137
13256,6,19,false,5,5,0,41.90302,-87.69749
TA1305000034,6,19,false,13,26,13,41.90313,-87.67391
KA1504000135,6,19,false,34,23,-11,41.90319,-87.63439
13136,6,19,false,6,11,5,41.90326,-87.67845
13061,6,19,false,16,28,12,41.90342,-87.66779
KA1504000079,6,19,false,13,7,-6,41.9035,-87.64334
TA1308000049,6,19,false,22,26,4,41.90672,-87.6349
KA1504000134,6,19,false,9,11,2,41.90687,-87.6262
13224,6,19,false,13,6,-7,41.90706,-87.66725
TA1307000143,6,19,false,4,11,7,41.90762,-87.63854
13221,6,19,false,15,22,7,41.90765,-87.67254
TA1309000024,6,19,false,19,26,7,41.908,-87.63152
TA1305000041,6,19,false,15,14,-1,41.9094,-87.67769
15652,6,19,false,6,1,-5,41.90965,-87.71664
331,6,19,false,5,4,-1,41.90965,-87.64812
TA1305000037,6,19,false,7,14,7,41.91018,-87.67003
TA1308000005,6,19,false,5,18,13,41.91042,-87.68238
13258,6,19,false,6,8,2,41.91043,-87.69718
13257,6,19,false,6,2,-4,41.91054,-87.68956
13154,6,19,false,6,6,0,41.91054,-87.65312
13058,6,19,false,8,5,-3,41.91059,-87.64942
TA1307000038,6,19,false,12,5,-7,41.91138,-87.63868
LF-005,6,19,false,47,62,15,41.91172,-87.62681
13128,6,19,false,18,12,-6,41.91197,-87.63197
TA1308000050,6,19,false,37,51,14,41.91211,-87.6347
13243,6,19,false,5,9,4,41.91262,-87.6814
TA1306000032,6,19,false,7,6,-1,41.9137,-87.65285
TA1307000166,6,19,false,9,2,-7,41.91386,-87.64877
18067,6,19,false,3,6,3,41.9146,-87.66796
TA1306000007,6,19,false,7,6,-1,41.91469,-87.64333
13068,6,19,false,3,5,2,41.91554,-87.68703
13179,6,19,false,29,19,-10,41.9157,-87.63461
13133,6,19,false,9,12,3,41.91598,-87.67733
15650,6,19,false,4,5,1,41.91711,-87.71023
15651,6,19,false,4,12,8,41.91752,-87.70181
TA1309000029,6,19,false,11,9,-2,41.9178,-87.68245
TA1309000006,6,19,false,26,18,-8,41.91809,-87.64375
TA1307000163,6,19,false,12,7,-5,41.91821,-87.65696
13146,6,19,false,20,19,-1,41.91831,-87.63629
13059,6,19,false,12,16,4,41.91845,-87.65222
13192,6,19,false,20,16,-4,41.91995,-87.64884
13288,6,19,false,7,5,-2,41.92008,-87.67788
13242,6,19,false,4,6,2,41.92021,-87.69266
TA1309000030,6,19,false,8,2,-6,41.92077,-87.66372
13292,6,19,false,5,5,0,41.92152,-87.70733
TA1309000033,6,19,false,20,16,-4,41.92158,-87.65381
13193,6,19,false,28,30,2,41.92182,-87.64412
13191,6,19,false,17,13,-4,41.92217,-87.63891
13084,6,19,false,9,7,-2,41.92268,-87.69715
LP-,6,19,false,17,8,-9,41.92396,-87.63584
15648,6,19,false,9,3,-6,41.92464,-87.68931
KA1504000090,6,19,false,6,6,0,41.92483,-87.7145
TA1307000001,6,19,false,6,10,4,41.92535,-87.66581
TA1306000026,6,19,false,10,10,0,41.92558,-87.65842
TA1306000016,6,19,false,10,10,0,41.9256,-87.65371
TA1309000019,6,19,false,28,22,-6,41.92586,-87.63897
TA1309000058,6,19,false,22,26,4,41.92591,-87.64927
TA1308000001,6,19,false,32,45,13,41.92627,-87.63086
TA1309000023,6,19,false,18,15,-3,41.9287,-87.65383
TA1307000113,6,19,false,13,10,-3,41.92878,-87.66391
TA1309000059,6,19,false,1,10,9,41.92889,-87.65898
TA1309000061,6,19,false,6,26,20,41.92915,-87.64909
TA1305000014,6,19,false,23,20,-3,41.92956,-87.64313
13085,6,19,false,9,11,2,41.92958,-87.70789
TA1307000142,6,19,false,23,18,-5,41.93125,-87.64432
13276,6,19,false,9,12,3,41.93132,-87.63874
TA1307000064,6,19,false,20,9,-11,41.93222,-87.65864
TA1306000014,6,19,false,13,9,-4,41.93242,-87.65271
TA1309000039,6,19,false,11,16,5,41.93258,-87.63642
13294,6,19,false,4,5,1,41.9326,-87.66595
TA1309000036,6,19,false,3,18,15,41.93313,-87.64776
TA1307000006,6,19,false,8,18,10,41.93571,-87.6636
13268,6,19,false,5,2,-3,41.93588,-87.67843
TA1307000052,6,19,false,16,14,-2,41.93628,-87.65266
TA1307000136,6,19,false,16,19,3,41.9365,-87.64755
TA1307000041,6,19,false,14,12,-2,41.93669,-87.63683
13137,6,19,false,20,27,7,41.9376,-87.6441
15642,6,19,false,7,2,-5,41.93843,-87.69801
TA1309000042,6,19,false,10,12,2,41.93937,-87.66836
13229,6,19,false,4,7,3,41.93946,-87.66376
TA1308000019,6,19,false,14,17,3,41.93973,-87.65886
13277,6,19,false,6,28,22,41.9401,-87.64546
TA1307000134,6,19,false,19,10,-9,41.94016,-87.65303
TA1309000049,6,19,false,24,23,-1,41.94077,-87.63919
TA1307000138,6,19,false,2,10,8,41.94334,-87.67094
13144,6,19,false,4,8,4,41.9434,-87.67964
TA1309000025,6,19,false,16,17,1,41.94368,-87.64894
13071,6,19,false,7,9,2,41.94373,-87.66401
632,6,19,false,31,31,0,41.94453,-87.6547
13278,6,19,false,23,20,-3,41.94553,-87.64644
13235,6,19,false,8,18,10,41.94814,-87.66396
13325,6,19,false,10,9,-1,41.94907,-87.64863
TA1307000126,6,19,false,6,18,12,41.94936,-87.65451
TA1307000150,6,19,false,6,11,5,41.94945,-87.64646
13319,6,19,false,5,3,-2,41.95069,-87.6687
TA1307000127,6,19,false,14,11,-3,41.9508,-87.65918
13323,6,19,false,15,5,-10,41.95282,-87.65
13063,6,19,false,10,7,-3,41.95424,-87.65441
TA1308000022,6,19,false,11,15,4,41.95438,-87.64805
13379,6,19,false,12,6,-6,41.95786,-87.6495
TA1309000027,6,19,false,1,6,5,41.9585,-87.65499
13389,6,19,false,12,3,-9,41.961,-87.64958
TA1307000107,6,19,false,14,13,-1,41.96164,-87.65464
TA1308000012,6,19,false,32,20,-12,41.96398,-87.63818
13074,6,19,false,5,6,1,41.96521,-87.6582
639,6,19,false,7,6,-1,41.96584,-87.64538
TA1307000140,6,19,false,6,1,-5,41.96643,-87.68865
TA1307000158,6,19,false,1,6,5,41.9671,-87.67904
TA1307000119,6,19,false,6,4,-2,41.96796,-87.65
TA1308000021,6,19,false,2,6,4,41.96883,-87.65765
TA1309000066,6,19,false,3,9,6,41.9691,-87.67423
KA1504000171,6,19,false,7,12,5,41.97161,-87.65016
TA1309000035,6,19,false,2,8,6,41.97335,-87.66785
13108,6,19,false,7,9,2,41.97379,-87.65971
KA1504000146,6,19,false,10,4,-6,41.978,-87.66805
13109,6,19,false,13,12,-1,41.97835,-87.65976
KA1504000152,6,19,false,24,17,-7,41.98403,-87.65231
15578,6,19,false,8,4,-4,41.98405,-87.66027
15575,6,19,false,3,5,2,41.98975,-87.66014
15571,6,19,false,6,3,-3,41.99478,-87.66028
RP-009,6,19,false,6,4,-2,42.00107,-87.66122
E002,6,19,false,2,6,4,42.03256,-87.67912
596,6,19,false,6,4,-2,42.04822,-87.68348
E008,6,19,false,4,10,6,42.05049,-87.67782
KA1503000014,6,19,true,4,6,2,41.7851,-87.60108
TA1309000063,6,19,true,5,5,0,41.79325,-87.5878
TA1308000009,6,19,true,7,8,1,41.79522,-87.58075
TA1307000164,6,19,true,5,7,2,41.79527,-87.59647
KA1503000052,6,19,true,5,3,-2,41.79935,-87.60097
TA1309000037,6,19,true,5,5,0,41.79957,-87.59474
KA1503000007,6,19,true,3,6,3,41.80242,-87.58689
13398,6,19,true,3,5,2,41.80256,-87.59035
KA1503000065,6,19,true,3,6,3,41.81409,-87.59701
13217,6,19,true,4,6,2,41.83488,-87.61792
13215,6,19,true,5,2,-3,41.83634,-87.6135
TA1309000055,6,19,true,8,5,-3,41.8382,-87.64514
TA1307000048,6,19,true,6,12,6,41.83855,-87.60821
TA1308000036,6,19,true,8,2,-6,41.83883,-87.62186
TA1307000139,6,19,true,4,9,5,41.84205,-87.61698
13075,6,19,true,2,5,3,41.8531,-87.63192
15545,6,19,true,24,20,-4,41.85627,-87.61334
13102,6,19,true,4,6,2,41.85762,-87.61942
13164,6,19,true,4,7,3,41.85818,-87.65648
TA1307000124,6,19,true,6,9,3,41.86411,-87.62372
13029,6,19,true,5,4,-1,41.86531,-87.6179
13431,6,19,true,17,10,-7,41.8661,-87.60728
WL-008,6,19,true,6,5,-1,41.86712,-87.64108
TA1305000002,6,19,true,6,11,5,41.86721,-87.62597
15544,6,19,true,7,10,3,41.86723,-87.61536
KA1706005007,6,19,true,5,2,-3,41.86749,-87.63219
SL-005,6,19,true,13,17,4,41.8679,-87.62304
644,6,19,true,6,3,-3,41.86859,-87.68625
13160,6,19,true,3,6,3,41.86947,-87.65548
TA1309000010,6,19,true,8,8,0,41.87074,-87.62574
SL-008,6,19,true,8,9,1,41.87209,-87.62956
13332,6,19,true,8,10,2,41.87219,-87.6615
SL-011,6,19,true,6,2,-4,41.87256,-87.63356
SL-010,6,19,true,3,5,2,41.87501,-87.63309
15541,6,19,true,2,5,3,41.8758,-87.62086
15539,6,19,true,1,6,5,41.87763,-87.64405
13158,6,19,true,3,9,6,41.87764,-87.64957
13157,6,19,true,7,3,-4,41.87773,-87.6548
TA1305000025,6,19,true,4,8,4,41.87773,-87.63528
638,6,19,true,5,4,-1,41.87827,-87.64078
13011,6,19,true,10,3,-7,41.87931,-87.63993
WL-011,6,19,true,9,5,-4,41.88034,-87.64273
13156,6,19,true,3,8,5,41.88042,-87.65554
13300,6,19,true,18,20,2,41.88097,-87.61675
13008,6,19,true,14,10,-4,41.88105,-87.62408
TA1307000120,6,19,true,12,10,-2,41.88188,-87.64879
13036,6,19,true,8,5,-3,41.8821,-87.62513
TA1305000032,6,19,true,8,5,-3,41.88218,-87.64109
13353,6,19,true,8,7,-1,41.88283,-87.6612
WL-012,6,19,true,6,2,-4,41.88337,-87.6412
13053,6,19,true,7,11,4,41.88365,-87.64863
13001,6,19,true,9,3,-6,41.88397,-87.62459
18062,6,19,true,2,5,3,41.88412,-87.65427
TA1306000010,6,19,true,7,4,-3,41.88419,-87.62961
TA1305000030,6,19,true,6,3,-3,41.88459,-87.63178
15535,6,19,true,9,16,7,41.8846,-87.64455
TA1305000029,6,19,true,12,9,-3,41.88466,-87.62787
13263,6,19,true,4,9,5,41.88467,-87.61952
13021,6,19,true,8,7,-1,41.88559,-87.64184
TA1307000111,6,19,true,1,5,4,41.88582,-87.63548
KA1503000012,6,19,true,7,7,0,41.88599,-87.63089
TA1305000011,6,19,true,5,8,3,41.886,-87.62418
15534,6,19,true,3,10,7,41.88627,-87.61749
TA1308000029,6,19,true,10,4,-6,41.88673,-87.62225
TA1307000131,6,19,true,5,3,-2,41.88688,-87.62606
KA1503000064,6,19,true,17,20,3,41.88697,-87.61281
TA1305000022,6,19,true,8,7,-1,41.88817,-87.63656
TA1306000003,6,19,true,10,16,6,41.88867,-87.64442
KA1503000043,6,19,true,9,6,-3,41.88918,-87.63851
13050,6,19,true,12,12,0,41.88919,-87.62775
13432,6,19,true,2,6,4,41.88989,-87.67149
TA1307000151,6,19,true,8,10,2,41.88993,-87.63427
636,6,19,true,6,2,-4,41.88997,-87.63662
13427,6,19,true,3,6,3,41.89054,-87.62205
13430,6,19,true,6,11,5,41.89077,-87.63169
TA1306000013,6,19,true,9,21,12,41.89083,-87.61852
RN-,6,19,true,7,5,-2,41.89102,-87.63546
13434,6,19,true,6,4,-2,41.89108,-87.66663
TA1307000117,6,19,true,8,14,6,41.89144,-87.62675
13033,6,19,true,11,8,-3,41.8916,-87.64835
TA1305000003,6,19,true,17,13,-4,41.89187,-87.62061
13022,6,19,true,20,23,3,41.89227,-87.61205
TA1306000029,6,19,true,9,14,5,41.89256,-87.61449
13265,6,19,true,12,14,2,41.89383,-87.64172
13045,6,19,true,8,7,-1,41.89403,-87.62931
13016,6,19,true,13,6,-7,41.89431,-87.62277
13196,6,19,true,4,8,4,41.89455,-87.65345
TA1306000012,6,19,true,16,21,5,41.89475,-87.63438
KP1705001026,6,19,true,9,11,2,41.89483,-87.6323
637,6,19,true,4,5,1,41.89563,-87.67209
13132,6,19,true,3,6,3,41.89573,-87.67718
15530,6,19,true,4,9,5,41.89575,-87.62596
13247,6,19,true,4,10,6,41.89597,-87.66775
TA1305000020,6,19,true,8,5,-3,41.89636,-87.65406
13289,6,19,true,2,6,4,41.89638,-87.661
13303,6,19,true,8,13,5,41.89672,-87.63088
13017,6,19,true,4,5,1,41.89676,-87.6357
13338,6,19,true,12,8,-4,41.89697,-87.62173
13034,6,19,true,9,1,-8,41.89754,-87.62352
620,6,19,true,4,7,3,41.89817,-87.63754
15529,6,19,true,10,7,-3,41.89858,-87.62206
TA1307000128,6,19,true,12,13,1,41.89896,-87.6299
13248,6,19,true,3,5,2,41.89964,-87.66788
13290,6,19,true,7,11,4,41.90069,-87.66259
13042,6,19,true,23,16,-7,41.90097,-87.62377
KA1504000133,6,19,true,8,10,2,41.90234,-87.62773
TA1307000039,6,19,true,29,20,-9,41.90294,-87.63137
TA1305000034,6,19,true,7,6,-1,41.90313,-87.67391
KA1504000135,6,19,true,15,22,7,41.90319,-87.63439
13136,6,19,true,6,8,2,41.90326,-87.67845
13061,6,19,true,15,12,-3,41.90342,-87.66779
KA1504000079,6,19,true,4,7,3,41.9035,-87.64334
TA1307000115,6,19,true,2,5,3,41.9046,-87.64056
TA1308000049,6,19,true,17,15,-2,41.90672,-87.6349
KA1504000134,6,19,true,6,5,-1,41.90687,-87.6262
13224,6,19,true,6,8,2,41.90706,-87.66725
TA1307000143,6,19,true,5,2,-3,41.90762,-87.63854
13221,6,19,true,14,10,-4,41.90765,-87.67254
TA1309000024,6,19,true,11,12,1,41.908,-87.63152
TA1305000041,6,19,true,10,18,8,41.9094,-87.67769
331,6,19,true,10,9,-1,41.90965,-87.64812
TA1306000008,6,19,true,12,10,-2,41.9102,-87.6435
TA1308000005,6,19,true,3,7,4,41.91042,-87.68238
13154,6,19,true,5,3,-2,41.91054,-87.65312
TA1307000038,6,19,true,10,10,0,41.91138,-87.63868
LF-005,6,19,true,25,18,-7,41.91172,-87.62681
TA1308000050,6,19,true,34,21,-13,41.91211,-87.6347
13243,6,19,true,6,8,2,41.91262,-87.6814
TA1307000166,6,19,true,8,4,-4,41.91386,-87.64877
18067,6,19,true,5,3,-2,41.9146,-87.66796
TA1306000007,6,19,true,1,5,4,41.91469,-87.64333
13068,6,19,true,2,8,6,41.91554,-87.68703
13179,6,19,true,12,21,9,41.9157,-87.63461
13133,6,19,true,3,13,10,41.91598,-87.67733
15650,6,19,true,1,5,4,41.91711,-87.71023
TA1309000029,6,19,true,7,3,-4,41.9178,-87.68245
TA1309000006,6,19,true,9,11,2,41.91809,-87.64375
TA1307000163,6,19,true,10,7,-3,41.91821,-87.65696
13146,6,19,true,12,19,7,41.91831,-87.63629
13059,6,19,true,6,8,2,41.91845,-87.65222
13192,6,19,true,9,10,1,41.91995,-87.64884
13242,6,19,true,6,6,0,41.92021,-87.69266
TA1309000033,6,19,true,13,10,-3,41.92158,-87.65381
13193,6,19,true,21,14,-7,41.92182,-87.64412
13191,6,19,true,8,6,-2,41.92217,-87.63891
13084,6,19,true,8,4,-4,41.92268,-87.69715
TA1307000001,6,19,true,11,2,-9,41.92535,-87.66581
TA1306000026,6,19,true,3,8,5,41.92558,-87.65842
TA1306000016,6,19,true,6,6,0,41.9256,-87.65371
TA1309000019,6,19,true,12,16,4,41.92586,-87.63897
TA1309000058,6,19,true,16,15,-1,41.92591,-87.64927
TA1308000001,6,19,true,22,15,-7,41.92627,-87.63086
15646,6,19,true,1,8,7,41.92668,-87.6977
TA1309000023,6,19,true,10,18,8,41.9287,-87.65383
TA1307000113,6,19,true,9,7,-2,41.92878,-87.66391
TA1309000059,6,19,true,3,8,5,41.92889,-87.65898
TA1309000061,6,19,true,19,15,-4,41.92915,-87.64909
TA1308000031,6,19,true,5,1,-4,41.92946,-87.68417
TA1305000014,6,19,true,20,15,-5,41.92956,-87.64313
13085,6,19,true,7,10,3,41.92958,-87.70789
TA1307000142,6,19,true,10,10,0,41.93125,-87.64432
13276,6,19,true,5,9,4,41.93132,-87.63874
13271,6,19,true,4,6,2,41.93192,-87.67784
TA1307000064,6,19,true,7,11,4,41.93222,-87.65864
TA1306000014,6,19,true,11,19,8,41.93242,-87.65271
TA1309000039,6,19,true,10,6,-4,41.93258,-87.63642
TA1309000036,6,19,true,9,12,3,41.93313,-87.64776
TA1307000006,6,19,true,9,7,-2,41.93571,-87.6636
13268,6,19,true,2,8,6,41.93588,-87.67843
TA1307000052,6,19,true,17,14,-3,41.93628,-87.65266
TA1307000136,6,19,true,14,6,-8,41.9365,-87.64755
TA1307000041,6,19,true,16,12,-4,41.93669,-87.63683
13137,6,19,true,21,26,5,41.9376,-87.6441
15642,6,19,true,5,1,-4,41.93843,-87.69801
TA1309000042,6,19,true,9,10,1,41.93937,-87.66836
13229,6,19,true,7,9,2,41.93946,-87.66376
TA1308000019,6,19,true,16,9,-7,41.93973,-87.65886
13277,6,19,true,12,7,-5,41.9401,-87.64546
TA1307000134,6,19,true,12,11,-1,41.94016,-87.65303
TA1309000049,6,19,true,14,17,3,41.94077,-87.63919
TA1307000138,6,19,true,6,8,2,41.94334,-87.67094
13144,6,19,true,3,8,5,41.9434,-87.67964
TA1309000025,6,19,true,20,12,-8,41.94368,-87.64894
13071,6,19,true,17,13,-4,41.94373,-87.66401
632,6,19,true,12,20,8,41.94453,-87.6547
13278,6,19,true,8,13,5,41.94553,-87.64644
13235,6,19,true,9,15,6,41.94814,-87.66396
13325,6,19,true,16,9,-7,41.94907,-87.64863
TA1307000126,6,19,true,11,15,4,41.94936,-87.65451
TA1307000150,6,19,true,10,6,-4,41.94945,-87.64646
13319,6,19,true,2,7,5,41.95069,-87.6687
TA1307000127,6,19,true,4,10,6,41.9508,-87.65918
13323,6,19,true,10,6,-4,41.95282,-87.65
13063,6,19,true,9,8,-1,41.95424,-87.65441
TA1308000022,6,19,true,7,12,5,41.95438,-87.64805
TA1309000026,6,19,true,1,7,6,41.95601,-87.6802
13379,6,19,true,9,9,0,41.95786,-87.6495
13389,6,19,true,10,6,-4,41.961,-87.64958
KA1503000022,6,19,true,4,8,4,41.96158,-87.66609
TA1307000107,6,19,true,16,6,-10,41.96164,-87.65464
TA1308000012,6,19,true,18,17,-1,41.96398,-87.63818
13074,6,19,true,7,3,-4,41.96521,-87.6582
639,6,19,true,12,1,-11,41.96584,-87.64538
TA1307000140,6,19,true,5,5,0,41.96643,-87.68865
TA1309000014,6,19,true,1,7,6,41.96709,-87.66744
TA1307000119,6,19,true,7,3,-4,41.96796,-87.65
TA1309000066,6,19,true,4,9,5,41.9691,-87.67423
KA1504000171,6,19,true,12,3,-9,41.97161,-87.65016
TA1309000035,6,19,true,4,5,1,41.97335,-87.66785
13108,6,19,true,7,8,1,41.97379,-87.65971
KA1504000146,6,19,true,4,6,2,41.978,-87.66805
13109,6,19,true,5,11,6,41.97835,-87.65976
KA1504000152,6,19,true,8,11,3,41.98403,-87.65231
15575,6,19,true,4,6,2,41.98975,-87.66014
15571,6,19,true,3,5,2,41.99478,-87.66028
TA1309000063,6,20,false,2,5,3,41.79325,-87.5878
TA1308000009,6,20,false,8,9,1,41.79522,-87.58075
TA1309000037,6,20,false,5,9,4,41.79957,-87.59474
KA1503000007,6,20,false,5,4,-1,41.80242,-87.58689
TA1308000038,6,20,false,8,3,-5,41.82298,-87.6071
KA1503000004,6,20,false,13,13,0,41.83127,-87.6088
TA1307000048,6,20,false,17,12,-5,41.83855,-87.60821
TA1308000026,6,20,false,5,4,-1,41.85008,-87.63214
TA1305000001,6,20,false,6,3,-3,41.85262,-87.6265
13075,6,20,false,12,8,-4,41.8531,-87.63192
15545,6,20,false,18,10,-8,41.85627,-87.61334
SL-013,6,20,false,7,1,-6,41.85659,-87.62755
13102,6,20,false,4,7,3,41.85762,-87.61942
13150,6,20,false,6,7,1,41.85783,-87.62455
13164,6,20,false,4,5,1,41.85818,-87.65648
TA1307000124,6,20,false,18,20,2,41.86411,-87.62372
13029,6,20,false,8,3,-5,41.86531,-87.6179
13431,6,20,false,6,12,6,41.8661,-87.60728
TA1305000002,6,20,false,10,18,8,41.86721,-87.62597
15544,6,20,false,8,11,3,41.86723,-87.61536
KA1706005007,6,20,false,5,6,1,41.86749,-87.63219
SL-005,6,20,false,20,27,7,41.8679,-87.62304
13139,6,20,false,3,5,2,41.86893,-87.65913
13160,6,20,false,4,5,1,41.86947,-87.65548
TA1309000010,6,20,false,12,27,15,41.87074,-87.62574
TA1307000130,6,20,false,12,12,0,41.87178,-87.65103
SL-008,6,20,false,15,13,-2,41.87209,-87.62956
13332,6,20,false,6,3,-3,41.87219,-87.6615
SL-011,6,20,false,4,6,2,41.87256,-87.63356
623,6,20,false,23,27,4,41.87272,-87.62399
SL-007,6,20,false,8,12,4,41.87404,-87.6277
15541,6,20,false,47,50,3,41.8758,-87.62086
TA1305000010,6,20,false,10,13,3,41.87623,-87.62444
13158,6,20,false,7,7,0,41.87764,-87.64957
13157,6,20,false,6,9,3,41.87773,-87.6548
TA1305000025,6,20,false,21,9,-12,41.87773,-87.63528
TA1309000002,6,20,false,13,13,0,41.87784,-87.62408
13206,6,20,false,4,9,5,41.87794,-87.66201
TA1305000005,6,20,false,5,2,-3,41.87924,-87.62975
13011,6,20,false,8,9,1,41.87931,-87.63993
TA1309000008,6,20,false,4,9,5,41.87933,-87.6355
KA1503000015,6,20,false,17,11,-6,41.87948,-87.6257
WL-011,6,20,false,4,14,10,41.88034,-87.64273
13156,6,20,false,6,14,8,41.88042,-87.65554
13300,6,20,false,71,50,-21,41.88097,-87.61675
13008,6,20,false,52,53,1,41.88105,-87.62408
TA1305000006,6,20,false,16,3,-13,41.88122,-87.6296
TA1307000120,6,20,false,16,13,-3,41.88188,-87.64879
13341,6,20,false,14,6,-8,41.88208,-87.63985
13036,6,20,false,15,16,1,41.8821,-87.62513
TA1305000032,6,20,false,6,16,10,41.88218,-87.64109
13353,6,20,false,2,6,4,41.88283,-87.6612
13409,6,20,false,2,6,4,41.8831,-87.6511
WL-012,6,20,false,6,5,-1,41.88337,-87.6412
13053,6,20,false,3,7,4,41.88365,-87.64863
13001,6,20,false,22,18,-4,41.88397,-87.62459
13155,6,20,false,7,10,3,41.88407,-87.65689
18062,6,20,false,5,4,-1,41.88412,-87.65427
15535,6,20,false,11,10,-1,41.8846,-87.64455
TA1305000029,6,20,false,8,14,6,41.88466,-87.62787
13263,6,20,false,21,26,5,41.88467,-87.61952
TA1306000015,6,20,false,29,20,-9,41.88549,-87.65232
13021,6,20,false,5,7,2,41.88559,-87.64184
TA1307000111,6,20,false,5,5,0,41.88582,-87.63548
KA1503000012,6,20,false,12,21,9,41.88599,-87.63089
TA1305000011,6,20,false,18,21,3,41.886,-87.62418
15534,6,20,false,6,7,1,41.88627,-87.61749
13197,6,20,false,1,10,9,41.8866,-87.65816
TA1308000029,6,20,false,8,15,7,41.88673,-87.62225
TA1307000131,6,20,false,29,28,-1,41.88688,-87.62606
KA1503000064,6,20,false,53,49,-4,41.88697,-87.61281
TA1305000022,6,20,false,11,7,-4,41.88817,-87.63656
TA1306000003,6,20,false,11,4,-7,41.88867,-87.64442
KA1503000043,6,20,false,16,9,-7,41.88918,-87.63851
13050,6,20,false,17,20,3,41.88919,-87.62775
TA1307000151,6,20,false,14,15,1,41.88993,-87.63427
636,6,20,false,8,5,-3,41.88997,-87.63662
KA1503000044,6,20,false,8,9,1,41.89018,-87.6262
13427,6,20,false,19,15,-4,41.89054,-87.62205
13430,6,20,false,17,33,16,41.89077,-87.63169
TA1306000013,6,20,false,40,26,-14,41.89083,-87.61852
RN-,6,20,false,15,6,-9,41.89102,-87.63546
13434,6,20,false,6,6,0,41.89108,-87.66663
TA1308000006,6,20,false,7,1,-6,41.89128,-87.67686
TA1307000117,6,20,false,30,36,6,41.89144,-87.62675
13033,6,20,false,13,9,-4,41.8916,-87.64835
13194,6,20,false,8,8,0,41.8918,-87.65878
TA1305000003,6,20,false,15,21,6,41.89187,-87.62061
13022,6,20,false,153,199,46,41.89227,-87.61205
TA1306000029,6,20,false,39,35,-4,41.89256,-87.61449
13265,6,20,false,5,10,5,41.89383,-87.64172
13045,6,20,false,10,21,11,41.89403,-87.62931
13016,6,20,false,15,20,5,41.89431,-87.62277
KA1503000041,6,20,false,31,23,-8,41.89452,-87.61798
13196,6,20,false,2,5,3,41.89455,-87.65345
TA1307000062,6,20,false,7,5,-2,41.89466,-87.63839
TA1306000012,6,20,false,22,10,-12,41.89475,-87.63438
KP1705001026,6,20,false,12,9,-3,41.89483,-87.6323
18058,6,20,false,2,6,4,41.8955,-87.68201
637,6,20,false,12,3,-9,41.89563,-87.67209
13132,6,20,false,5,11,6,41.89573,-87.67718
15530,6,20,false,19,14,-5,41.89575,-87.62596
18003,6,20,false,5,4,-1,41.89575,-87.62011
13247,6,20,false,5,4,-1,41.89597,-87.66775
TA1305000020,6,20,false,5,12,7,41.89636,-87.65406
13289,6,20,false,1,7,6,41.89638,-87.661
13303,6,20,false,13,11,-2,41.89672,-87.63088
13017,6,20,false,8,5,-3,41.89676,-87.6357
13338,6,20,false,9,8,-1,41.89697,-87.62173
TA1307000061,6,20,false,5,6,1,41.89745,-87.62873
13034,6,20,false,11,5,-6,41.89754,-87.62352
KA1504000103,6,20,false,2,5,3,41.89842,-87.68659
15529,6,20,false,4,8,4,41.89858,-87.62206
TA1307000128,6,20,false,16,9,-7,41.89896,-87.6299
657,6,20,false,2,6,4,41.89918,-87.6722
13290,6,20,false,4,12,8,41.90069,-87.66259
13042,6,20,false,65,62,-3,41.90097,-87.62377
KA1504000133,6,20,false,13,11,-2,41.90234,-87.62773
TA1307000039,6,20,false,17,18,1,41.90294,-87.63137
658,6,20,false,2,7,5,41.903,-87.6838
13256,6,20,false,3,13,10,41.90302,-87.69749
TA1305000034,6,20,false,6,18,12,41.90313,-87.67391
KA1504000135,6,20,false,26,36,10,41.90319,-87.63439
13136,6,20,false,9,8,-1,41.90326,-87.67845
13061,6,20,false,24,18,-6,41.90342,-87.66779
KA1504000079,6,20,false,5,5,0,41.9035,-87.64334
TA1307000115,6,20,false,3,5,2,41.9046,-87.64056
TA1308000049,6,20,false,29,35,6,41.90672,-87.6349
KA1504000134,6,20,false,10,13,3,41.90687,-87.6262
13224,6,20,false,11,3,-8,41.90706,-87.66725
TA1307000143,6,20,false,6,2,-4,41.90762,-87.63854
13221,6,20,false,6,11,5,41.90765,-87.67254
TA1309000024,6,20,false,17,14,-3,41.908,-87.63152
TA1305000041,6,20,false,4,11,7,41.9094,-87.67769
331,6,20,false,4,16,12,41.90965,-87.64812
TA1305000037,6,20,false,7,3,-4,41.91018,-87.67003
TA1306000008,6,20,false,10,8,-2,41.9102,-87.6435
13258,6,20,false,3,5,2,41.91043,-87.69718
13058,6,20,false,13,8,-5,41.91059,-87.64942
TA1307000038,6,20,false,14,14,0,41.91138,-87.63868
LF-005,6,20,false,45,50,5,41.91172,-87.62681
13128,6,20,false,8,9,1,41.91197,-87.63197
TA1308000050,6,20,false,39,46,7,41.91211,-87.6347
13243,6,20,false,9,9,0,41.91262,-87.6814
TA1306000032,6,20,false,6,9,3,41.9137,-87.65285
TA1307000166,6,20,false,7,7,0,41.91386,-87.64877
15655,6,20,false,1,5,4,41.91401,-87.70514
TA1306000007,6,20,false,8,10,2,41.91469,-87.64333
13068,6,20,false,9,12,3,41.91554,-87.68703
13179,6,20,false,17,31,14,41.9157,-87.63461
13133,6,20,false,17,10,-7,41.91598,-87.67733
TA1305000039,6,20,false,3,5,2,41.9163,-87.66749
15650,6,20,false,6,3,-3,41.91711,-87.71023
TA1309000029,6,20,false,1,8,7,41.9178,-87.68245
TA1309000006,6,20,false,8,10,2,41.91809,-87.64375
TA1307000163,6,20,false,6,1,-5,41.91821,-87.65696
13146,6,20,false,23,19,-4,41.91831,-87.63629
13059,6,20,false,15,12,-3,41.91845,-87.65222
13259,6,20,false,3,6,3,41.91852,-87.69744
13192,6,20,false,13,9,-4,41.91995,-87.64884
13288,6,20,false,5,3,-2,41.92008,-87.67788
13242,6,20,false,6,6,0,41.92021,-87.69266
13292,6,20,false,6,2,-4,41.92152,-87.70733
TA1309000033,6,20,false,13,14,1,41.92158,-87.65381
13193,6,20,false,28,23,-5,41.92182,-87.64412
13191,6,20,false,16,12,-4,41.92217,-87.63891
13084,6,20,false,10,8,-2,41.92268,-87.69715
LP-,6,20,false,4,5,1,41.92396,-87.63584
TA1307000001,6,20,false,9,2,-7,41.92535,-87.66581
TA1306000026,6,20,false,7,7,0,41.92558,-87.65842
TA1306000016,6,20,false,7,12,5,41.9256,-87.65371
TA1309000019,6,20,false,19,21,2,41.92586,-87.63897
TA1309000058,6,20,false,23,26,3,41.92591,-87.64927
TA1308000001,6,20,false,40,41,1,41.92627,-87.63086
TA1309000023,6,20,false,11,16,5,41.9287,-87.65383
TA1307000113,6,20,false,17,10,-7,41.92878,-87.66391
13296,6,20,false,4,6,2,41.92883,-87.66852
TA1309000061,6,20,false,22,7,-15,41.92915,-87.64909
TA1305000014,6,20,false,8,14,6,41.92956,-87.64313
13085,6,20,false,11,12,1,41.92958,-87.70789
TA1307000142,6,20,false,17,6,-11,41.93125,-87.64432
13276,6,20,false,18,14,-4,41.93132,-87.63874
TA1307000064,6,20,false,4,10,6,41.93222,-87.65864
TA1306000014,6,20,false,13,13,0,41.93242,-87.65271
TA1309000039,6,20,false,20,11,-9,41.93258,-87.63642
TA1309000036,6,20,false,5,13,8,41.93313,-87.64776
TA1307000006,6,20,false,11,4,-7,41.93571,-87.6636
13269,6,20,false,2,6,4,41.93609,-87.66983
TA1307000052,6,20,false,17,12,-5,41.93628,-87.65266
TA1307000136,6,20,false,18,16,-2,41.9365,-87.64755
TA1307000041,6,20,false,19,18,-1,41.93669,-87.63683
13137,6,20,false,16,23,7,41.9376,-87.6441
TA1309000042,6,20,false,4,8,4,41.93937,-87.66836
13229,6,20,false,6,11,5,41.93946,-87.66376
TA1308000019,6,20,false,15,16,1,41.93973,-87.65886
13277,6,20,false,12,10,-2,41.9401,-87.64546
TA1307000134,6,20,false,10,15,5,41.94016,-87.65303
13143,6,20,false,3,11,8,41.94059,-87.67853
TA1309000049,6,20,false,16,11,-5,41.94077,-87.63919
TA1307000138,6,20,false,4,11,7,41.94334,-87.67094
TA1309000025,6,20,false,14,18,4,41.94368,-87.64894
13071,6,20,false,14,11,-3,41.94373,-87.66401
632,6,20,false,22,27,5,41.94453,-87.6547
15631,6,20,false,2,8,6,41.94524,-87.70665
13278,6,20,false,15,16,1,41.94553,-87.64644
13235,6,20,false,25,14,-11,41.94814,-87.66396
13253,6,20,false,6,6,0,41.9488,-87.67527
13325,6,20,false,17,20,3,41.94907,-87.64863
TA1307000126,6,20,false,15,35,20,41.94936,-87.65451
TA1307000150,6,20,false,8,12,4,41.94945,-87.64646
13319,6,20,false,2,7,5,41.95069,-87.6687
TA1307000127,6,20,false,17,20,3,41.9508,-87.65918
13323,6,20,false,13,11,-2,41.95282,-87.65
TA1309000043,6,20,false,7,6,-1,41.95417,-87.66434
13063,6,20,false,3,11,8,41.95424,-87.65441
TA1308000022,6,20,false,13,10,-3,41.95438,-87.64805
TA1307000149,6,20,false,5,5,0,41.95467,-87.67392
13379,6,20,false,13,8,-5,41.95786,-87.6495
TA1309000027,6,20,false,6,7,1,41.9585,-87.65499
TA1307000144,6,20,false,7,4,-3,41.96142,-87.6762
TA1309000021,6,20,false,7,3,-4,41.9615,-87.6714
KA1503000022,6,20,false,5,10,5,41.96158,-87.66609
TA1307000107,6,20,false,22,11,-11,41.96164,-87.65464
TA1308000012,6,20,false,15,15,0,41.96398,-87.63818
13074,6,20,false,2,6,4,41.96521,-87.6582
639,6,20,false,7,5,-2,41.96584,-87.64538
TA1307000140,6,20,false,4,9,5,41.96643,-87.68865
TA1307000119,6,20,false,3,6,3,41.96796,-87.65
KA1504000171,6,20,false,7,10,3,41.97161,-87.65016
TA1309000035,6,20,false,14,12,-2,41.97335,-87.66785
13108,6,20,false,8,4,-4,41.97379,-87.65971
KA1504000146,6,20,false,4,6,2,41.978,-87.66805
13109,6,20,false,4,5,1,41.97835,-87.65976
KA1504000152,6,20,false,6,9,3,41.98403,-87.65231
15571,6,20,false,6,3,-3,41.99478,-87.66028
KA1504000159,6,20,false,1,7,6,42.01059,-87.66241
E008,6,20,false,1,6,5,42.05049,-87.67782
KA1503000014,6,20,true,9,6,-3,41.7851,-87.60108
TA1309000063,6,20,true,1,9,8,41.79325,-87.5878
TA1308000009,6,20,true,6,10,4,41.79522,-87.58075
KA1503000007,6,20,true,2,5,3,41.80242,-87.58689
TA1308000045,6,20,true,2,5,3,41.83062,-87.64129
13217,6,20,true,8,3,-5,41.83488,-87.61792
TA1309000055,6,20,true,8,4,-4,41.8382,-87.64514
KA1503000038,6,20,true,3,12,9,41.83845,-87.6354
TA1307000048,6,20,true,19,10,-9,41.83855,-87.60821
TA1307000139,6,20,true,6,8,2,41.84205,-87.61698
13075,6,20,true,9,6,-3,41.8531,-87.63192
15545,6,20,true,17,11,-6,41.85627,-87.61334
13102,6,20,true,6,6,0,41.85762,-87.61942
13150,6,20,true,2,7,5,41.85783,-87.62455
13164,6,20,true,1,6,5,41.85818,-87.65648
TA1307000124,6,20,true,3,7,4,41.86411,-87.62372
13431,6,20,true,5,6,1,41.8661,-87.60728
WL-008,6,20,true,6,3,-3,41.86712,-87.64108
TA1305000002,6,20,true,4,16,12,41.86721,-87.62597
15544,6,20,true,8,7,-1,41.86723,-87.61536
SL-005,6,20,true,6,9,3,41.8679,-87.62304
644,6,20,true,3,8,5,41.86859,-87.68625
13139,6,20,true,7,7,0,41.86893,-87.65913
13160,6,20,true,4,8,4,41.86947,-87.65548
TA1309000010,6,20,true,4,5,1,41.87074,-87.62574
TA1307000130,6,20,true,9,7,-2,41.87178,-87.65103
SL-008,6,20,true,11,9,-2,41.87209,-87.62956
13332,6,20,true,7,5,-2,41.87219,-87.6615
SL-011,6,20,true,3,7,4,41.87256,-87.63356
15541,6,20,true,7,8,1,41.8758,-87.62086
15539,6,20,true,4,9,5,41.87763,-87.64405
13158,6,20,true,8,7,-1,41.87764,-87.64957
13157,6,20,true,6,6,0,41.87773,-87.6548
TA1305000025,6,20,true,3,5,2,41.87773,-87.63528
WL-011,6,20,true,6,4,-2,41.88034,-87.64273
13300,6,20,true,21,14,-7,41.88097,-87.61675
13008,6,20,true,6,6,0,41.88105,-87.62408
TA1307000120,6,20,true,17,10,-7,41.88188,-87.64879
TA1305000032,6,20,true,9,6,-3,41.88218,-87.64109
13409,6,20,true,4,6,2,41.8831,-87.6511
13053,6,20,true,10,4,-6,41.88365,-87.64863
TA1306000010,6,20,true,6,10,4,41.88419,-87.62961
TA1305000030,6,20,true,7,3,-4,41.88459,-87.63178
15535,6,20,true,9,7,-2,41.8846,-87.64455
13263,6,20,true,10,8,-2,41.88467,-87.61952
TA1306000015,6,20,true,6,6,0,41.88549,-87.65232
13021,6,20,true,4,7,3,41.88559,-87.64184
KA1503000012,6,20,true,6,7,1,41.88599,-87.63089
TA1307000131,6,20,true,2,5,3,41.88688,-87.62606
KA1503000064,6,20,true,14,10,-4,41.88697,-87.61281
TA1305000022,6,20,true,4,9,5,41.88817,-87.63656
TA1306000003,6,20,true,16,28,12,41.88867,-87.64442
KA1503000043,6,20,true,6,6,0,41.88918,-87.63851
13050,6,20,true,9,9,0,41.88919,-87.62775
TA1307000151,6,20,true,13,14,1,41.88993,-87.63427
636,6,20,true,6,11,5,41.88997,-87.63662
KA1503000044,6,20,true,5,5,0,41.89018,-87.6262
13430,6,20,true,11,15,4,41.89077,-87.63169
TA1306000013,6,20,true,13,16,3,41.89083,-87.61852
RN-,6,20,true,3,6,3,41.89102,-87.63546
13434,6,20,true,8,5,-3,41.89108,-87.66663
TA1307000117,6,20,true,6,3,-3,41.89144,-87.62675
13033,6,20,true,5,9,4,41.8916,-87.64835
13194,6,20,true,9,2,-7,41.8918,-87.65878
TA1305000003,6,20,true,5,7,2,41.89187,-87.62061
13022,6,20,true,17,26,9,41.89227,-87.61205
TA1306000029,6,20,true,7,9,2,41.89256,-87.61449
13265,6,20,true,6,6,0,41.89383,-87.64172
13045,6,20,true,12,20,8,41.89403,-87.62931
13016,6,20,true,3,7,4,41.89431,-87.62277
13196,6,20,true,2,10,8,41.89455,-87.65345
TA1306000012,6,20,true,13,14,1,41.89475,-87.63438
KP1705001026,6,20,true,9,3,-6,41.89483,-87.6323
637,6,20,true,2,5,3,41.89563,-87.67209
13132,6,20,true,6,8,2,41.89573,-87.67718
15530,6,20,true,6,8,2,41.89575,-87.62596
13247,6,20,true,1,8,7,41.89597,-87.66775
TA1305000020,6,20,true,5,6,1,41.89636,-87.65406
13289,6,20,true,7,7,0,41.89638,-87.661
13303,6,20,true,7,6,-1,41.89672,-87.63088
13017,6,20,true,2,5,3,41.89676,-87.6357
TA1307000061,6,20,true,4,5,1,41.89745,-87.62873
13034,6,20,true,5,1,-4,41.89754,-87.62352
15529,6,20,true,6,8,2,41.89858,-87.62206
TA1307000128,6,20,true,8,13,5,41.89896,-87.6299
13290,6,20,true,9,4,-5,41.90069,-87.66259
13042,6,20,true,20,10,-10,41.90097,-87.62377
TA1307000070,6,20,true,1,5,4,41.90133,-87.67742
KA1504000133,6,20,true,15,6,-9,41.90234,-87.62773
TA1307000039,6,20,true,8,17,9,41.90294,-87.63137
13256,6,20,true,8,2,-6,41.90302,-87.69749
TA1305000034,6,20,true,7,16,9,41.90313,-87.67391
KA1504000135,6,20,true,17,20,3,41.90319,-87.63439
13136,6,20,true,7,10,3,41.90326,-87.67845
13061,6,20,true,17,13,-4,41.90342,-87.66779
KA1504000079,6,20,true,4,6,2,41.9035,-87.64334
TA1307000115,6,20,true,3,6,3,41.9046,-87.64056
TA1308000049,6,20,true,14,25,11,41.90672,-87.6349
KA1504000134,6,20,true,6,4,-2,41.90687,-87.6262
13224,6,20,true,3,5,2,41.90706,-87.66725
13221,6,20,true,12,12,0,41.90765,-87.67254
TA1309000024,6,20,true,16,11,-5,41.908,-87.63152
TA1305000041,6,20,true,11,9,-2,41.9094,-87.67769
331,6,20,true,12,3,-9,41.90965,-87.64812
TA1306000008,6,20,true,4,6,2,41.9102,-87.6435
TA1308000005,6,20,true,6,4,-2,41.91042,-87.68238
13258,6,20,true,3,6,3,41.91043,-87.69718
13154,6,20,true,8,6,-2,41.91054,-87.65312
13058,6,20,true,7,5,-2,41.91059,-87.64942
TA1307000038,6,20,true,8,8,0,41.91138,-87.63868
LF-005,6,20,true,15,16,1,41.91172,-87.62681
TA1308000050,6,20,true,29,22,-7,41.91211,-87.6347
13243,6,20,true,11,6,-5,41.91262,-87.6814
TA1306000032,6,20,true,2,7,5,41.9137,-87.65285
TA1307000166,6,20,true,8,12,4,41.91386,-87.64877
15655,6,20,true,4,5,1,41.91401,-87.70514
13179,6,20,true,13,14,1,41.9157,-87.63461
13133,6,20,true,8,4,-4,41.91598,-87.67733
15651,6,20,true,6,3,-3,41.91752,-87.70181
TA1309000029,6,20,true,7,4,-3,41.9178,-87.68245
TA1309000006,6,20,true,9,6,-3,41.91809,-87.64375
TA1307000163,6,20,true,2,5,3,41.91821,-87.65696
13146,6,20,true,15,9,-6,41.91831,-87.63629
13059,6,20,true,7,3,-4,41.91845,-87.65222
13192,6,20,true,9,8,-1,41.91995,-87.64884
13288,6,20,true,2,6,4,41.92008,-87.67788
13292,6,20,true,5,2,-3,41.92152,-87.70733
TA1309000033,6,20,true,7,4,-3,41.92158,-87.65381
13193,6,20,true,26,21,-5,41.92182,-87.64412
13191,6,20,true,7,8,1,41.92217,-87.63891
13084,6,20,true,6,9,3,41.92268,-87.69715
LP-,6,20,true,5,2,-3,41.92396,-87.63584
TA1306000026,6,20,true,4,12,8,41.92558,-87.65842
TA1306000016,6,20,true,5,9,4,41.9256,-87.65371
TA1309000019,6,20,true,5,14,9,41.92586,-87.63897
TA1309000058,6,20,true,8,13,5,41.92591,-87.64927
TA1308000001,6,20,true,14,8,-6,41.92627,-87.63086
TA1309000023,6,20,true,4,11,7,41.9287,-87.65383
TA1307000113,6,20,true,7,9,2,41.92878,-87.66391
TA1309000059,6,20,true,3,5,2,41.92889,-87.65898
TA1309000061,6,20,true,9,9,0,41.92915,-87.64909
TA1305000014,6,20,true,9,8,-1,41.92956,-87.64313
13085,6,20,true,6,6,0,41.92958,-87.70789
TA1307000142,6,20,true,13,12,-1,41.93125,-87.64432
13276,6,20,true,7,15,8,41.93132,-87.63874
TA1307000064,6,20,true,8,10,2,41.93222,-87.65864
TA1306000014,6,20,true,16,5,-11,41.93242,-87.65271
TA1309000039,6,20,true,4,10,6,41.93258,-87.63642
TA1309000036,6,20,true,6,6,0,41.93313,-87.64776
13269,6,20,true,2,6,4,41.93609,-87.66983
TA1307000052,6,20,true,9,10,1,41.93628,-87.65266
TA1307000136,6,20,true,7,11,4,41.9365,-87.64755
TA1307000041,6,20,true,13,14,1,41.93669,-87.63683
13137,6,20,true,22,12,-10,41.9376,-87.6441
TA1308000019,6,20,true,5,8,3,41.93973,-87.65886
13277,6,20,true,12,12,0,41.9401,-87.64546
TA1307000134,6,20,true,14,9,-5,41.94016,-87.65303
TA1309000049,6,20,true,12,10,-2,41.94077,-87.63919
TA1307000138,6,20,true,6,10,4,41.94334,-87.67094
TA1309000025,6,20,true,12,14,2,41.94368,-87.64894
13071,6,20,true,2,7,5,41.94373,-87.66401
632,6,20,true,15,12,-3,41.94453,-87.6547
13278,6,20,true,9,10,1,41.94553,-87.64644
13235,6,20,true,10,12,2,41.94814,-87.66396
13325,6,20,true,7,10,3,41.94907,-87.64863
TA1307000126,6,20,true,10,7,-3,41.94936,-87.65451
TA1307000150,6,20,true,6,9,3,41.94945,-87.64646
TA1307000127,6,20,true,6,7,1,41.9508,-87.65918
13323,6,20,true,5,7,2,41.95282,-87.65
13063,6,20,true,7,7,0,41.95424,-87.65441
TA1308000022,6,20,true,12,7,-5,41.95438,-87.64805
TA1307000149,6,20,true,4,9,5,41.95467,-87.67392
TA1308000047,6,20,true,2,5,3,41.95709,-87.6642
13389,6,20,true,3,5,2,41.961,-87.64958
TA1307000144,6,20,true,5,5,0,41.96142,-87.6762
KA1503000022,6,20,true,2,7,5,41.96158,-87.66609
TA1307000107,6,20,true,6,11,5,41.96164,-87.65464
13074,6,20,true,6,5,-1,41.96521,-87.6582
639,6,20,true,4,5,1,41.96584,-87.64538
TA1307000119,6,20,true,6,3,-3,41.96796,-87.65
TA1309000066,6,20,true,7,1,-6,41.9691,-87.67423
TA1309000041,6,20,true,4,7,3,41.96951,-87.65471
TA1309000035,6,20,true,5,6,1,41.97335,-87.66785
13108,6,20,true,13,12,-1,41.97379,-87.65971
13109,6,20,true,14,4,-10,41.97835,-87.65976
KA1504000152,6,20,true,5,9,4,41.98403,-87.65231
KA1504000148,6,20,true,2,5,3,41.99086,-87.66971
15571,6,20,true,10,10,0,41.99478,-87.66028
15491,6,21,false,10,7,-3,41.78096,-87.57624
TA1308000009,6,21,false,1,7,6,41.79522,-87.58075
KA1503000059,6,21,false,3,7,4,41.79952,-87.58643
TA1309000037,6,21,false,4,7,3,41.79957,-87.59474
13398,6,21,false,5,1,-4,41.80256,-87.59035
TA1308000038,6,21,false,1,7,6,41.82298,-87.6071
TA1307000048,6,21,false,9,13,4,41.83855,-87.60821
13075,6,21,false,8,10,2,41.8531,-87.63192
15545,6,21,false,2,5,3,41.85627,-87.61334
13102,6,21,false,6,3,-3,41.85762,-87.61942
13150,6,21,false,7,5,-2,41.85783,-87.62455
SL-012,6,21,false,2,6,4,41.86038,-87.62581
TA1307000124,6,21,false,14,8,-6,41.86411,-87.62372
TA1309000001,6,21,false,10,8,-2,41.86488,-87.64708
13029,6,21,false,17,8,-9,41.86531,-87.6179
13431,6,21,false,17,11,-6,41.8661,-87.60728
TA1305000002,6,21,false,17,15,-2,41.86721,-87.62597
15544,6,21,false,13,6,-7,41.86723,-87.61536
SL-005,6,21,false,21,14,-7,41.8679,-87.62304
TA1309000010,6,21,false,15,9,-6,41.87074,-87.62574
TA1307000130,6,21,false,4,7,3,41.87178,-87.65103
SL-008,6,21,false,4,8,4,41.87209,-87.62956
13332,6,21,false,2,9,7,41.87219,-87.6615
623,6,21,false,19,19,0,41.87272,-87.62399
SL-007,6,21,false,5,9,4,41.87404,-87.6277
15668,6,21,false,5,3,-2,41.87471,-87.68642
15541,6,21,false,51,40,-11,41.8758,-87.62086
TA1305000010,6,21,false,16,13,-3,41.87623,-87.62444
624,6,21,false,2,5,3,41.87626,-87.62923
15539,6,21,false,6,2,-4,41.87763,-87.64405
13158,6,21,false,12,10,-2,41.87764,-87.64957
TA1305000025,6,21,false,14,1,-13,41.87773,-87.63528
TA1309000002,6,21,false,8,14,6,41.87784,-87.62408
TA1305000005,6,21,false,1,8,7,41.87924,-87.62975
TA1309000008,6,21,false,12,3,-9,41.87933,-87.6355
KA1503000034,6,21,false,3,5,2,41.87938,-87.63197
KA1503000015,6,21,false,8,5,-3,41.87948,-87.6257
TA1309000007,6,21,false,3,6,3,41.88022,-87.63526
13156,6,21,false,4,5,1,41.88042,-87.65554
13300,6,21,false,52,53,1,41.88097,-87.61675
13008,6,21,false,49,58,9,41.88105,-87.62408
TA1305000006,6,21,false,5,2,-3,41.88122,-87.6296
13036,6,21,false,11,20,9,41.8821,-87.62513
TA1305000032,6,21,false,8,3,-5,41.88218,-87.64109
13353,6,21,false,10,2,-8,41.88283,-87.6612
13409,6,21,false,10,2,-8,41.8831,-87.6511
KA1503000072,6,21,false,5,4,-1,41.88317,-87.63693
WL-012,6,21,false,4,6,2,41.88337,-87.6412
13053,6,21,false,7,6,-1,41.88365,-87.64863
13001,6,21,false,18,37,19,41.88397,-87.62459
18062,6,21,false,7,4,-3,41.88412,-87.65427
TA1306000010,6,21,false,12,11,-1,41.88419,-87.62961
TA1305000030,6,21,false,10,16,6,41.88459,-87.63178
15535,6,21,false,19,11,-8,41.8846,-87.64455
TA1305000029,6,21,false,28,14,-14,41.88466,-87.62787
13263,6,21,false,15,23,8,41.88467,-87.61952
TA1306000015,6,21,false,19,12,-7,41.88549,-87.65232
13021,6,21,false,7,11,4,41.88559,-87.64184
TA1307000111,6,21,false,6,9,3,41.88582,-87.63548
13073,6,21,false,2,6,4,41.88592,-87.66717
KA1503000012,6,21,false,20,3,-17,41.88599,-87.63089
TA1305000011,6,21,false,19,19,0,41.886,-87.62418
15534,6,21,false,7,10,3,41.88627,-87.61749
TA1308000029,6,21,false,20,15,-5,41.88673,-87.62225
TA1307000131,6,21,false,20,17,-3,41.88688,-87.62606
KA1503000064,6,21,false,26,38,12,41.88697,-87.61281
TA1305000022,6,21,false,5,4,-1,41.88817,-87.63656
TA1306000003,6,21,false,11,9,-2,41.88867,-87.64442
KA1503000043,6,21,false,3,10,7,41.88918,-87.63851
13050,6,21,false,26,31,5,41.88919,-87.62775
TA1307000151,6,21,false,11,23,12,41.88993,-87.63427
636,6,21,false,2,11,9,41.88997,-87.63662
13427,6,21,false,13,12,-1,41.89054,-87.62205
13430,6,21,false,27,14,-13,41.89077,-87.63169
TA1306000013,6,21,false,43,45,2,41.89083,-87.61852
13434,6,21,false,6,3,-3,41.89108,-87.66663
TA1307000117,6,21,false,20,10,-10,41.89144,-87.62675
13033,6,21,false,9,17,8,41.8916,-87.64835
13194,6,21,false,4,10,6,41.8918,-87.65878
TA1305000003,6,21,false,25,30,5,41.89187,-87.62061
13022,6,21,false,109,116,7,41.89227,-87.61205
TA1306000029,6,21,false,25,55,30,41.89256,-87.61449
13265,6,21,false,9,6,-3,41.89383,-87.64172
13045,6,21,false,27,23,-4,41.89403,-87.62931
13016,6,21,false,24,15,-9,41.89431,-87.62277
KA1503000041,6,21,false,11,29,18,41.89452,-87.61798
TA1307000062,6,21,false,1,7,6,41.89466,-87.63839
TA1306000012,6,21,false,14,21,7,41.89475,-87.63438
KP1705001026,6,21,false,11,9,-2,41.89483,-87.6323
637,6,21,false,4,8,4,41.89563,-87.67209
15530,6,21,false,11,12,1,41.89575,-87.62596
18003,6,21,false,2,8,6,41.89575,-87.62011
13247,6,21,false,7,7,0,41.89597,-87.66775
TA1305000020,6,21,false,3,5,2,41.89636,-87.65406
13303,6,21,false,6,16,10,41.89672,-87.63088
13017,6,21,false,6,3,-3,41.89676,-87.6357
TA1307000061,6,21,false,13,6,-7,41.89745,-87.62873
13034,6,21,false,5,5,0,41.89754,-87.62352
KA1504000103,6,21,false,2,8,6,41.89842,-87.68659
15529,6,21,false,12,12,0,41.89858,-87.62206
TA1307000128,6,21,false,16,16,0,41.89896,-87.6299
13290,6,21,false,3,5,2,41.90069,-87.66259
13042,6,21,false,35,44,9,41.90097,-87.62377
KA1504000133,6,21,false,8,6,-2,41.90234,-87.62773
TA1307000039,6,21,false,15,14,-1,41.90294,-87.63137
TA1305000034,6,21,false,2,6,4,41.90313,-87.67391
KA1504000135,6,21,false,30,28,-2,41.90319,-87.63439
13136,6,21,false,8,11,3,41.90326,-87.67845
13061,6,21,false,8,9,1,41.90342,-87.66779
TA1307000115,6,21,false,3,5,2,41.9046,-87.64056
TA1308000049,6,21,false,28,26,-2,41.90672,-87.6349
KA1504000134,6,21,false,4,8,4,41.90687,-87.6262
13224,6,21,false,5,12,7,41.90706,-87.66725
13221,6,21,false,5,10,5,41.90765,-87.67254
TA1309000024,6,21,false,10,6,-4,41.908,-87.63152
TA1305000041,6,21,false,12,5,-7,41.9094,-87.67769
331,6,21,false,15,7,-8,41.90965,-87.64812
15653,6,21,false,5,7,2,41.90979,-87.7053
TA1305000037,6,21,false,8,9,1,41.91018,-87.67003
TA1308000005,6,21,false,10,7,-3,41.91042,-87.68238
13258,6,21,false,10,6,-4,41.91043,-87.69718
13058,6,21,false,3,5,2,41.91059,-87.64942
TA1307000038,6,21,false,12,16,4,41.91138,-87.63868
LF-005,6,21,false,20,33,13,41.91172,-87.62681
13128,6,21,false,12,15,3,41.91197,-87.63197
TA1308000050,6,21,false,38,40,2,41.91211,-87.6347
13243,6,21,false,6,8,2,41.91262,-87.6814
TA1307000166,6,21,false,5,3,-2,41.91386,-87.64877
18017,6,21,false,2,5,3,41.91416,-87.71676
18067,6,21,false,7,4,-3,41.9146,-87.66796
13068,6,21,false,3,5,2,41.91554,-87.68703
13179,6,21,false,9,4,-5,41.9157,-87.63461
13133,6,21,false,6,17,11,41.91598,-87.67733
TA1309000006,6,21,false,3,7,4,41.91809,-87.64375
TA1307000163,6,21,false,7,6,-1,41.91821,-87.65696
13146,6,21,false,16,24,8,41.91831,-87.63629
13059,6,21,false,13,12,-1,41.91845,-87.65222
13192,6,21,false,7,15,8,41.91995,-87.64884
13288,6,21,false,6,1,-5,41.92008,-87.67788
13242,6,21,false,5,1,-4,41.92021,-87.69266
TA1309000030,6,21,false,5,6,1,41.92077,-87.66372
13292,6,21,false,2,6,4,41.92152,-87.70733
TA1309000033,6,21,false,6,11,5,41.92158,-87.65381
13193,6,21,false,22,18,-4,41.92182,-87.64412
13191,6,21,false,10,6,-4,41.92217,-87.63891
13084,6,21,false,14,9,-5,41.92268,-87.69715
LP-,6,21,false,8,9,1,41.92396,-87.63584
TA1307000001,6,21,false,9,12,3,41.92535,-87.66581
TA1306000026,6,21,false,10,7,-3,41.92558,-87.65842
TA1306000016,6,21,false,4,23,19,41.9256,-87.65371
TA1309000019,6,21,false,22,14,-8,41.92586,-87.63897
TA1309000058,6,21,false,9,10,1,41.92591,-87.64927
TA1308000001,6,21,false,18,13,-5,41.92627,-87.63086
TA1309000023,6,21,false,17,6,-11,41.9287,-87.65383
TA1307000113,6,21,false,9,12,3,41.92878,-87.66391
13296,6,21,false,2,6,4,41.92883,-87.66852
TA1309000061,6,21,false,15,24,9,41.92915,-87.64909
TA1308000031,6,21,false,3,5,2,41.92946,-87.68417
TA1305000014,6,21,false,10,9,-1,41.92956,-87.64313
13085,6,21,false,6,15,9,41.92958,-87.70789
TA1307000142,6,21,false,4,23,19,41.93125,-87.64432
13276,6,21,false,11,13,2,41.93132,-87.63874
TA1307000064,6,21,false,11,16,5,41.93222,-87.65864
TA1306000014,6,21,false,5,8,3,41.93242,-87.65271
TA1309000039,6,21,false,6,14,8,41.93258,-87.63642
TA1309000036,6,21,false,10,5,-5,41.93313,-87.64776
TA1307000006,6,21,false,6,14,8,41.93571,-87.6636
TA1307000052,6,21,false,6,6,0,41.93628,-87.65266
TA1307000136,6,21,false,25,21,-4,41.9365,-87.64755
TA1307000041,6,21,false,10,12,2,41.93669,-87.63683
13137,6,21,false,12,18,6,41.9376,-87.6441
15642,6,21,false,2,9,7,41.93843,-87.69801
TA1309000042,6,21,false,9,5,-4,41.93937,-87.66836
13229,6,21,false,8,6,-2,41.93946,-87.66376
TA1308000019,6,21,false,23,18,-5,41.93973,-87.65886
13277,6,21,false,18,12,-6,41.9401,-87.64546
TA1307000134,6,21,false,28,25,-3,41.94016,-87.65303
13143,6,21,false,5,1,-4,41.94059,-87.67853
TA1309000049,6,21,false,5,11,6,41.94077,-87.63919
15634,6,21,false,4,5,1,41.94304,-87.68729
TA1307000138,6,21,false,7,6,-1,41.94334,-87.67094
13144,6,21,false,8,1,-7,41.9434,-87.67964
TA1309000025,6,21,false,11,10,-1,41.94368,-87.64894
13071,6,21,false,18,16,-2,41.94373,-87.66401
632,6,21,false,49,30,-19,41.94453,-87.6547
13278,6,21,false,10,14,4,41.94553,-87.64644
TA1309000050,6,21,false,5,2,-3,41.94618,-87.67331
KA1504000143,6,21,false,6,2,-4,41.94664,-87.68337
13235,6,21,false,7,10,3,41.94814,-87.66396
13325,6,21,false,12,15,3,41.94907,-87.64863
TA1307000126,6,21,false,31,22,-9,41.94936,-87.65451
TA1307000150,6,21,false,5,4,-1,41.94945,-87.64646
13319,6,21,false,1,6,5,41.95069,-87.6687
TA1307000127,6,21,false,16,5,-11,41.9508,-87.65918
13323,6,21,false,8,8,0,41.95282,-87.65
13063,6,21,false,1,10,9,41.95424,-87.65441
TA1308000022,6,21,false,6,13,7,41.95438,-87.64805
13379,6,21,false,7,4,-3,41.95786,-87.6495
13389,6,21,false,3,10,7,41.961,-87.64958
15622,6,21,false,2,6,4,41.96108,-87.69544
TA1307000144,6,21,false,6,2,-4,41.96142,-87.6762
TA1307000107,6,21,false,10,20,10,41.96164,-87.65464
TA1308000012,6,21,false,8,18,10,41.96398,-87.63818
TA1309000014,6,21,false,10,7,-3,41.96709,-87.66744
TA1307000119,6,21,false,5,5,0,41.96796,-87.65
KA1504000171,6,21,false,6,4,-2,41.97161,-87.65016
TA1309000035,6,21,false,9,4,-5,41.97335,-87.66785
KA1504000146,6,21,false,15,8,-7,41.978,-87.66805
13109,6,21,false,5,7,2,41.97835,-87.65976
KA1504000152,6,21,false,5,10,5,41.98403,-87.65231
15575,6,21,false,3,6,3,41.98975,-87.66014
15571,6,21,false,2,7,5,41.99478,-87.66028
E002,6,21,false,1,6,5,42.03256,-87.67912
TA1309000055,6,21,true,3,6,3,41.8382,-87.64514
TA1308000036,6,21,true,4,6,2,41.83883,-87.62186
TA1307000139,6,21,true,6,9,3,41.84205,-87.61698
15545,6,21,true,6,7,1,41.85627,-87.61334
13102,6,21,true,9,7,-2,41.85762,-87.61942
13164,6,21,true,5,5,0,41.85818,-87.65648
TA1307000124,6,21,true,5,9,4,41.86411,-87.62372
13431,6,21,true,5,5,0,41.8661,-87.60728
TA1305000002,6,21,true,10,6,-4,41.86721,-87.62597
SL-005,6,21,true,8,8,0,41.8679,-87.62304
TA1309000010,6,21,true,7,4,-3,41.87074,-87.62574
SL-009,6,21,true,1,6,5,41.87081,-87.63121
SL-008,6,21,true,6,2,-4,41.87209,-87.62956
13332,6,21,true,1,16,15,41.87219,-87.6615
623,6,21,true,5,7,2,41.87272,-87.62399
13028,6,21,true,2,6,4,41.87475,-87.64981
SL-010,6,21,true,3,6,3,41.87501,-87.63309
15541,6,21,true,5,3,-2,41.8758,-87.62086
15539,6,21,true,5,3,-2,41.87763,-87.64405
13158,6,21,true,6,4,-2,41.87764,-87.64957
13157,6,21,true,5,4,-1,41.87773,-87.6548
TA1305000025,6,21,true,5,5,0,41.87773,-87.63528
638,6,21,true,6,1,-5,41.87827,-87.64078
13011,6,21,true,5,5,0,41.87931,-87.63993
13156,6,21,true,4,7,3,41.88042,-87.65554
13300,6,21,true,13,10,-3,41.88097,-87.61675
13008,6,21,true,13,3,-10,41.88105,-87.62408
TA1307000120,6,21,true,6,13,7,41.88188,-87.64879
TA1305000032,6,21,true,6,10,4,41.88218,-87.64109
13409,6,21,true,1,8,7,41.8831,-87.6511
13053,6,21,true,9,8,-1,41.88365,-87.64863
13155,6,21,true,5,3,-2,41.88407,-87.65689
15535,6,21,true,1,5,4,41.8846,-87.64455
13263,6,21,true,12,8,-4,41.88467,-87.61952
TA1306000015,6,21,true,11,8,-3,41.88549,-87.65232
13021,6,21,true,9,6,-3,41.88559,-87.64184
KA1503000012,6,21,true,7,2,-5,41.88599,-87.63089
TA1305000011,6,21,true,7,3,-4,41.886,-87.62418
15534,6,21,true,6,5,-1,41.88627,-87.61749
TA1308000029,6,21,true,3,5,2,41.88673,-87.62225
KA1503000064,6,21,true,9,9,0,41.88697,-87.61281
TA1306000003,6,21,true,13,9,-4,41.88867,-87.64442
KA1503000043,6,21,true,6,12,6,41.88918,-87.63851
13050,6,21,true,5,8,3,41.88919,-87.62775
TA1307000151,6,21,true,9,9,0,41.88993,-87.63427
636,6,21,true,2,8,6,41.88997,-87.63662
13430,6,21,true,11,8,-3,41.89077,-87.63169
TA1306000013,6,21,true,3,18,15,41.89083,-87.61852
RN-,6,21,true,8,4,-4,41.89102,-87.63546
TA1307000117,6,21,true,6,7,1,41.89144,-87.62675
13033,6,21,true,10,8,-2,41.8916,-87.64835
13194,6,21,true,2,6,4,41.8918,-87.65878
TA1305000003,6,21,true,3,8,5,41.89187,-87.62061
13022,6,21,true,7,8,1,41.89227,-87.61205
TA1306000029,6,21,true,5,9,4,41.89256,-87.61449
13265,6,21,true,3,11,8,41.89383,-87.64172
13045,6,21,true,15,8,-7,41.89403,-87.62931
13016,6,21,true,2,7,5,41.89431,-87.62277
KA1503000041,6,21,true,6,5,-1,41.89452,-87.61798
TA1306000012,6,21,true,8,9,1,41.89475,-87.63438
KP1705001026,6,21,true,9,3,-6,41.89483,-87.6323
15530,6,21,true,8,7,-1,41.89575,-87.62596
13247,6,21,true,5,4,-1,41.89597,-87.66775
TA1305000020,6,21,true,6,3,-3,41.89636,-87.65406
13303,6,21,true,6,10,4,41.89672,-87.63088
TA1307000061,6,21,true,5,5,0,41.89745,-87.62873
TA1306000009,6,21,true,1,5,4,41.89772,-87.64299
15529,6,21,true,3,8,5,41.89858,-87.62206
TA1307000128,6,21,true,11,12,1,41.89896,-87.6299
13248,6,21,true,3,6,3,41.89964,-87.66788
TA1306000011,6,21,true,4,5,1,41.89994,-87.63443
13290,6,21,true,9,4,-5,41.90069,-87.66259
13042,6,21,true,11,4,-7,41.90097,-87.62377
TA1307000070,6,21,true,2,5,3,41.90133,-87.67742
KA1504000133,6,21,true,5,6,1,41.90234,-87.62773
13241,6,21,true,2,5,3,41.9029,-87.68731
TA1307000039,6,21,true,10,12,2,41.90294,-87.63137
TA1305000034,6,21,true,9,2,-7,41.90313,-87.67391
KA1504000135,6,21,true,14,17,3,41.90319,-87.63439
13061,6,21,true,13,14,1,41.90342,-87.66779
KA1504000079,6,21,true,5,2,-3,41.9035,-87.64334
TA1307000115,6,21,true,6,1,-5,41.9046,-87.64056
TA1308000049,6,21,true,18,8,-10,41.90672,-87.6349
13221,6,21,true,2,5,3,41.90765,-87.67254
TA1309000024,6,21,true,10,9,-1,41.908,-87.63152
TA1305000041,6,21,true,8,3,-5,41.9094,-87.67769
331,6,21,true,7,4,-3,41.90965,-87.64812
TA1306000008,6,21,true,2,5,3,41.9102,-87.6435
TA1308000005,6,21,true,2,5,3,41.91042,-87.68238
TA1307000038,6,21,true,6,4,-2,41.91138,-87.63868
LF-005,6,21,true,16,10,-6,41.91172,-87.62681
13128,6,21,true,7,4,-3,41.91197,-87.63197
TA1308000050,6,21,true,16,23,7,41.91211,-87.6347
13243,6,21,true,6,3,-3,41.91262,-87.6814
TA1306000032,6,21,true,1,6,5,41.9137,-87.65285
TA1307000166,6,21,true,5,5,0,41.91386,-87.64877
13179,6,21,true,9,8,-1,41.9157,-87.63461
13133,6,21,true,5,7,2,41.91598,-87.67733
TA1309000006,6,21,true,10,7,-3,41.91809,-87.64375
TA1307000163,6,21,true,3,12,9,41.91821,-87.65696
13146,6,21,true,9,14,5,41.91831,-87.63629
13059,6,21,true,9,11,2,41.91845,-87.65222
13192,6,21,true,7,5,-2,41.91995,-87.64884
13242,6,21,true,5,2,-3,41.92021,-87.69266
TA1309000033,6,21,true,6,12,6,41.92158,-87.65381
13193,6,21,true,15,8,-7,41.92182,-87.64412
13191,6,21,true,5,5,0,41.92217,-87.63891
13084,6,21,true,5,2,-3,41.92268,-87.69715
TA1307000001,6,21,true,7,11,4,41.92535,-87.66581
TA1306000026,6,21,true,4,6,2,41.92558,-87.65842
TA1306000016,6,21,true,7,7,0,41.9256,-87.65371
TA1309000019,6,21,true,9,11,2,41.92586,-87.63897
TA1309000058,6,21,true,8,5,-3,41.92591,-87.64927
TA1308000001,6,21,true,14,19,5,41.92627,-87.63086
TA1309000023,6,21,true,11,5,-6,41.9287,-87.65383
TA1307000113,6,21,true,6,10,4,41.92878,-87.66391
TA1309000059,6,21,true,3,6,3,41.92889,-87.65898
TA1309000061,6,21,true,8,11,3,41.92915,-87.64909
TA1305000014,6,21,true,6,9,3,41.92956,-87.64313
TA1307000142,6,21,true,7,10,3,41.93125,-87.64432
13276,6,21,true,8,8,0,41.93132,-87.63874
TA1307000064,6,21,true,5,4,-1,41.93222,-87.65864
TA1306000014,6,21,true,10,12,2,41.93242,-87.65271
TA1309000039,6,21,true,4,5,1,41.93258,-87.63642
TA1307000006,6,21,true,7,9,2,41.93571,-87.6636
TA1307000052,6,21,true,8,6,-2,41.93628,-87.65266
TA1307000136,6,21,true,12,17,5,41.9365,-87.64755
TA1307000041,6,21,true,7,7,0,41.93669,-87.63683
13137,6,21,true,16,12,-4,41.9376,-87.6441
TA1309000042,6,21,true,7,4,-3,41.93937,-87.66836
13229,6,21,true,6,3,-3,41.93946,-87.66376
TA1308000019,6,21,true,8,8,0,41.93973,-87.65886
13277,6,21,true,10,14,4,41.9401,-87.64546
TA1307000134,6,21,true,16,10,-6,41.94016,-87.65303
TA1309000049,6,21,true,10,7,-3,41.94077,-87.63919
TA1307000138,6,21,true,6,1,-5,41.94334,-87.67094
TA1309000025,6,21,true,3,9,6,41.94368,-87.64894
13071,6,21,true,10,11,1,41.94373,-87.66401
632,6,21,true,15,20,5,41.94453,-87.6547
13278,6,21,true,9,10,1,41.94553,-87.64644
13235,6,21,true,9,6,-3,41.94814,-87.66396
13325,6,21,true,5,10,5,41.94907,-87.64863
TA1307000126,6,21,true,17,9,-8,41.94936,-87.65451
TA1307000150,6,21,true,8,10,2,41.94945,-87.64646
13319,6,21,true,2,6,4,41.95069,-87.6687
TA1307000127,6,21,true,7,5,-2,41.9508,-87.65918
13323,6,21,true,2,11,9,41.95282,-87.65
TA1308000022,6,21,true,6,5,-1,41.95438,-87.64805
13379,6,21,true,4,5,1,41.95786,-87.6495
13389,6,21,true,5,7,2,41.961,-87.64958
KA1503000022,6,21,true,5,4,-1,41.96158,-87.66609
TA1307000107,6,21,true,10,8,-2,41.96164,-87.65464
TA1308000012,6,21,true,6,2,-4,41.96398,-87.63818
13074,6,21,true,4,6,2,41.96521,-87.6582
TA1309000014,6,21,true,5,3,-2,41.96709,-87.66744
TA1307000119,6,21,true,9,3,-6,41.96796,-87.65
TA1308000021,6,21,true,6,3,-3,41.96883,-87.65765
TA1309000066,6,21,true,5,2,-3,41.9691,-87.67423
TA1309000041,6,21,true,6,4,-2,41.96951,-87.65471
KA1504000171,6,21,true,8,5,-3,41.97161,-87.65016
13108,6,21,true,8,4,-4,41.97379,-87.65971
KA1504000146,6,21,true,7,3,-4,41.978,-87.66805
13109,6,21,true,4,7,3,41.97835,-87.65976
KA1504000152,6,21,true,7,11,4,41.98403,-87.65231
15578,6,21,true,3,5,2,41.98405,-87.66027
15571,6,21,true,4,6,2,41.99478,-87.66028
15491,6,22,false,7,2,-5,41.78096,-87.57624
TA1308000009,6,22,false,3,5,2,41.79522,-87.58075
KA1503000007,6,22,false,9,2,-7,41.80242,-87.58689
TA1307000048,6,22,false,6,6,0,41.83855,-87.60821
TA1307000005,6,22,false,8,1,-7,41.84569,-87.6225
13075,6,22,false,6,10,4,41.8531,-87.63192
13150,6,22,false,6,5,-1,41.85783,-87.62455
TA1307000124,6,22,false,12,12,0,41.86411,-87.62372
13431,6,22,false,2,8,6,41.8661,-87.60728
WL-008,6,22,false,7,3,-4,41.86712,-87.64108
TA1305000002,6,22,false,8,14,6,41.86721,-87.62597
15544,6,22,false,6,2,-4,41.86723,-87.61536
KA1706005007,6,22,false,4,5,1,41.86749,-87.63219
SL-005,6,22,false,16,30,14,41.8679,-87.62304
13160,6,22,false,5,5,0,41.86947,-87.65548
TA1309000010,6,22,false,10,16,6,41.87074,-87.62574
SL-009,6,22,false,5,5,0,41.87081,-87.63121
SL-008,6,22,false,9,18,9,41.87209,-87.62956
SL-011,6,22,false,9,9,0,41.87256,-87.63356
623,6,22,false,26,11,-15,41.87272,-87.62399
SL-007,6,22,false,13,14,1,41.87404,-87.6277
SL-010,6,22,false,3,5,2,41.87501,-87.63309
15541,6,22,false,22,34,12,41.8758,-87.62086
TA1305000010,6,22,false,8,9,1,41.87623,-87.62444
TA1305000035,6,22,false,7,9,2,41.87716,-87.62787
13158,6,22,false,9,7,-2,41.87764,-87.64957
13157,6,22,false,8,3,-5,41.87773,-87.6548
TA1309000002,6,22,false,15,9,-6,41.87784,-87.62408
TA1309000004,6,22,false,7,7,0,41.87811,-87.63184
TA1305000005,6,22,false,5,9,4,41.87924,-87.62975
13011,6,22,false,4,10,6,41.87931,-87.63993
KA1503000015,6,22,false,7,6,-1,41.87948,-87.6257
TA1309000007,6,22,false,7,5,-2,41.88022,-87.63526
WL-011,6,22,false,6,2,-4,41.88034,-87.64273
13300,6,22,false,33,48,15,41.88097,-87.61675
13008,6,22,false,54,32,-22,41.88105,-87.62408
TA1307000120,6,22,false,8,3,-5,41.88188,-87.64879
13036,6,22,false,19,2,-17,41.8821,-87.62513
TA1305000032,6,22,false,3,13,10,41.88218,-87.64109
13353,6,22,false,10,4,-6,41.88283,-87.6612
13409,6,22,false,17,10,-7,41.8831,-87.6511
KA1503000072,6,22,false,1,7,6,41.88317,-87.63693
13053,6,22,false,24,17,-7,41.88365,-87.64863
13001,6,22,false,33,28,-5,41.88397,-87.62459
18062,6,22,false,2,6,4,41.88412,-87.65427
TA1306000010,6,22,false,6,13,7,41.88419,-87.62961
TA1305000030,6,22,false,14,7,-7,41.88459,-87.63178
15535,6,22,false,7,3,-4,41.8846,-87.64455
TA1305000029,6,22,false,12,14,2,41.88466,-87.62787
13263,6,22,false,9,9,0,41.88467,-87.61952
TA1306000015,6,22,false,19,11,-8,41.88549,-87.65232
TA1307000111,6,22,false,10,5,-5,41.88582,-87.63548
KA1503000012,6,22,false,14,14,0,41.88599,-87.63089
TA1305000011,6,22,false,21,16,-5,41.886,-87.62418
15534,6,22,false,5,7,2,41.88627,-87.61749
TA1308000029,6,22,false,12,12,0,41.88673,-87.62225
TA1307000131,6,22,false,20,21,1,41.88688,-87.62606
KA1503000064,6,22,false,57,37,-20,41.88697,-87.61281
TA1305000022,6,22,false,10,13,3,41.88817,-87.63656
TA1306000003,6,22,false,3,15,12,41.88867,-87.64442
KA1503000043,6,22,false,20,5,-15,41.88918,-87.63851
13050,6,22,false,18,5,-13,41.88919,-87.62775
TA1307000151,6,22,false,20,25,5,41.88993,-87.63427
636,6,22,false,11,9,-2,41.88997,-87.63662
KA1503000044,6,22,false,8,8,0,41.89018,-87.6262
13427,6,22,false,11,12,1,41.89054,-87.62205
13430,6,22,false,16,28,12,41.89077,-87.63169
TA1306000013,6,22,false,54,35,-19,41.89083,-87.61852
RN-,6,22,false,8,6,-2,41.89102,-87.63546
13434,6,22,false,5,3,-2,41.89108,-87.66663
TA1307000117,6,22,false,25,33,8,41.89144,-87.62675
13033,6,22,false,17,19,2,41.8916,-87.64835
13194,6,22,false,2,9,7,41.8918,-87.65878
TA1305000003,6,22,false,25,21,-4,41.89187,-87.62061
13022,6,22,false,185,85,-100,41.89227,-87.61205
TA1306000029,6,22,false,45,24,-21,41.89256,-87.61449
13265,6,22,false,1,9,8,41.89383,-87.64172
13045,6,22,false,13,10,-3,41.89403,-87.62931
13016,6,22,false,8,7,-1,41.89431,-87.62277
KA1503000041,6,22,false,10,10,0,41.89452,-87.61798
TA1307000062,6,22,false,9,11,2,41.89466,-87.63839
TA1306000012,6,22,false,10,14,4,41.89475,-87.63438
KP1705001026,6,22,false,8,11,3,41.89483,-87.6323
637,6,22,false,5,4,-1,41.89563,-87.67209
13132,6,22,false,7,3,-4,41.89573,-87.67718
15530,6,22,false,6,13,7,41.89575,-87.62596
18003,6,22,false,4,9,5,41.89575,-87.62011
13247,6,22,false,7,8,1,41.89597,-87.66775
TA1305000020,6,22,false,5,5,0,41.89636,-87.65406
13289,6,22,false,3,9,6,41.89638,-87.661
13303,6,22,false,15,20,5,41.89672,-87.63088
13017,6,22,false,7,3,-4,41.89676,-87.6357
TA1307000061,6,22,false,6,3,-3,41.89745,-87.62873
13034,6,22,false,10,12,2,41.89754,-87.62352
TA1306000009,6,22,false,7,4,-3,41.89772,-87.64299
620,6,22,false,7,11,4,41.89817,-87.63754
KA1504000103,6,22,false,2,6,4,41.89842,-87.68659
15529,6,22,false,14,11,-3,41.89858,-87.62206
TA1307000128,6,22,false,12,18,6,41.89896,-87.6299
17660,6,22,false,6,4,-2,41.90036,-87.69671
13042,6,22,false,16,36,20,41.90097,-87.62377
TA1307000070,6,22,false,4,6,2,41.90133,-87.67742
KA1504000133,6,22,false,2,18,16,41.90234,-87.62773
TA1307000039,6,22,false,19,19,0,41.90294,-87.63137
TA1305000034,6,22,false,8,2,-6,41.90313,-87.67391
KA1504000135,6,22,false,25,23,-2,41.90319,-87.63439
13061,6,22,false,23,9,-14,41.90342,-87.66779
KA1504000079,6,22,false,8,9,1,41.9035,-87.64334
TA1307000115,6,22,false,7,3,-4,41.9046,-87.64056
TA1308000049,6,22,false,30,41,11,41.90672,-87.6349
KA1504000134,6,22,false,6,12,6,41.90687,-87.6262
13221,6,22,false,7,10,3,41.90765,-87.67254
TA1309000024,6,22,false,13,22,9,41.908,-87.63152
TA1305000041,6,22,false,13,8,-5,41.9094,-87.67769
331,6,22,false,12,8,-4,41.90965,-87.64812
TA1305000037,6,22,false,8,16,8,41.91018,-87.67003
TA1306000008,6,22,false,5,4,-1,41.9102,-87.6435
TA1308000005,6,22,false,5,5,0,41.91042,-87.68238
13257,6,22,false,4,8,4,41.91054,-87.68956
13058,6,22,false,5,3,-2,41.91059,-87.64942
TA1307000038,6,22,false,9,6,-3,41.91138,-87.63868
LF-005,6,22,false,28,15,-13,41.91172,-87.62681
13128,6,22,false,11,6,-5,41.91197,-87.63197
TA1308000050,6,22,false,51,48,-3,41.91211,-87.6347
TA1306000032,6,22,false,7,6,-1,41.9137,-87.65285
TA1307000166,6,22,false,10,2,-8,41.91386,-87.64877
18067,6,22,false,5,9,4,41.9146,-87.66796
13068,6,22,false,5,1,-4,41.91554,-87.68703
13179,6,22,false,13,21,8,41.9157,-87.63461
13133,6,22,false,13,13,0,41.91598,-87.67733
TA1309000029,6,22,false,6,2,-4,41.9178,-87.68245
TA1309000006,6,22,false,4,8,4,41.91809,-87.64375
TA1307000163,6,22,false,4,7,3,41.91821,-87.65696
13146,6,22,false,26,23,-3,41.91831,-87.63629
13059,6,22,false,9,15,6,41.91845,-87.65222
13192,6,22,false,14,8,-6,41.91995,-87.64884
13288,6,22,false,7,5,-2,41.92008,-87.67788
13292,6,22,false,2,8,6,41.92152,-87.70733
TA1309000033,6,22,false,15,11,-4,41.92158,-87.65381
13193,6,22,false,28,28,0,41.92182,-87.64412
13191,6,22,false,9,8,-1,41.92217,-87.63891
13084,6,22,false,12,17,5,41.92268,-87.69715
LP-,6,22,false,5,3,-2,41.92396,-87.63584
TA1307000001,6,22,false,19,12,-7,41.92535,-87.66581
TA1306000026,6,22,false,14,8,-6,41.92558,-87.65842
TA1306000016,6,22,false,11,16,5,41.9256,-87.65371
TA1309000019,6,22,false,14,11,-3,41.92586,-87.63897
TA1309000058,6,22,false,36,20,-16,41.92591,-87.64927
TA1308000001,6,22,false,10,6,-4,41.92627,-87.63086
TA1309000023,6,22,false,29,13,-16,41.9287,-87.65383
TA1307000113,6,22,false,8,2,-6,41.92878,-87.66391
13296,6,22,false,4,9,5,41.92883,-87.66852
TA1309000059,6,22,false,8,7,-1,41.92889,-87.65898
TA1309000061,6,22,false,26,22,-4,41.92915,-87.64909
TA1305000014,6,22,false,13,19,6,41.92956,-87.64313
13085,6,22,false,12,7,-5,41.92958,-87.70789
TA1307000142,6,22,false,12,12,0,41.93125,-87.64432
13276,6,22,false,6,7,1,41.93132,-87.63874
TA1307000064,6,22,false,9,2,-7,41.93222,-87.65864
TA1306000014,6,22,false,20,11,-9,41.93242,-87.65271
TA1309000039,6,22,false,8,7,-1,41.93258,-87.63642
TA1309000036,6,22,false,16,8,-8,41.93313,-87.64776
TA1307000006,6,22,false,3,6,3,41.93571,-87.6636
13269,6,22,false,2,8,6,41.93609,-87.66983
TA1307000052,6,22,false,13,8,-5,41.93628,-87.65266
TA1307000136,6,22,false,8,10,2,41.9365,-87.64755
TA1307000041,6,22,false,5,8,3,41.93669,-87.63683
13137,6,22,false,11,23,12,41.9376,-87.6441
TA1309000042,6,22,false,10,8,-2,41.93937,-87.66836
13229,6,22,false,14,4,-10,41.93946,-87.66376
TA1308000019,6,22,false,7,14,7,41.93973,-87.65886
13277,6,22,false,14,9,-5,41.9401,-87.64546
TA1307000134,6,22,false,49,34,-15,41.94016,-87.65303
13143,6,22,false,7,3,-4,41.94059,-87.67853
TA1309000049,6,22,false,1,8,7,41.94077,-87.63919
TA1307000138,6,22,false,9,6,-3,41.94334,-87.67094
13144,6,22,false,5,3,-2,41.9434,-87.67964
TA1309000025,6,22,false,25,15,-10,41.94368,-87.64894
13071,6,22,false,26,10,-16,41.94373,-87.66401
632,6,22,false,33,46,13,41.94453,-87.6547
13278,6,22,false,5,11,6,41.94553,-87.64644
KA1504000143,6,22,false,1,5,4,41.94664,-87.68337
13235,6,22,false,12,13,1,41.94814,-87.66396
TA1307000126,6,22,false,22,15,-7,41.94936,-87.65451
TA1307000150,6,22,false,3,7,4,41.94945,-87.64646
TA1307000127,6,22,false,20,11,-9,41.9508,-87.65918
13323,6,22,false,5,9,4,41.95282,-87.65
13063,6,22,false,3,12,9,41.95424,-87.65441
TA1309000026,6,22,false,9,5,-4,41.95601,-87.6802
13379,6,22,false,1,13,12,41.95786,-87.6495
TA1309000027,6,22,false,3,6,3,41.9585,-87.65499
13389,6,22,false,4,11,7,41.961,-87.64958
TA1307000144,6,22,false,1,5,4,41.96142,-87.6762
KA1503000022,6,22,false,11,6,-5,41.96158,-87.66609
TA1307000107,6,22,false,7,5,-2,41.96164,-87.65464
TA1308000012,6,22,false,5,6,1,41.96398,-87.63818
13074,6,22,false,6,3,-3,41.96521,-87.6582
639,6,22,false,6,2,-4,41.96584,-87.64538
TA1307000140,6,22,false,3,5,2,41.96643,-87.68865
TA1309000066,6,22,false,1,5,4,41.9691,-87.67423
KA1504000171,6,22,false,4,5,1,41.97161,-87.65016
TA1309000035,6,22,false,7,3,-4,41.97335,-87.66785
KA1504000149,6,22,false,3,5,2,41.97562,-87.67945
KA1504000152,6,22,false,3,10,7,41.98403,-87.65231
KA1503000014,6,22,true,1,7,6,41.7851,-87.60108
KA1503000071,6,22,true,6,1,-5,41.79148,-87.59988
TA1308000009,6,22,true,8,2,-6,41.79522,-87.58075
KA1503000007,6,22,true,1,5,4,41.80242,-87.58689
KA1503000038,6,22,true,2,7,5,41.83845,-87.6354
TA1307000139,6,22,true,1,5,4,41.84205,-87.61698
13102,6,22,true,8,4,-4,41.85762,-87.61942
TA1307000124,6,22,true,4,9,5,41.86411,-87.62372
13431,6,22,true,9,7,-2,41.8661,-87.60728
TA1305000002,6,22,true,5,9,4,41.86721,-87.62597
SL-005,6,22,true,5,14,9,41.8679,-87.62304
TA1309000010,6,22,true,4,5,1,41.87074,-87.62574
SL-008,6,22,true,6,7,1,41.87209,-87.62956
13332,6,22,true,4,17,13,41.87219,-87.6615
623,6,22,true,2,8,6,41.87272,-87.62399
15541,6,22,true,5,1,-4,41.8758,-87.62086
13158,6,22,true,1,8,7,41.87764,-87.64957
13300,6,22,true,11,5,-6,41.88097,-87.61675
TA1307000120,6,22,true,8,7,-1,41.88188,-87.64879
13409,6,22,true,7,5,-2,41.8831,-87.6511
13053,6,22,true,17,8,-9,41.88365,-87.64863
13001,6,22,true,6,2,-4,41.88397,-87.62459
TA1306000010,6,22,true,6,2,-4,41.88419,-87.62961
15535,6,22,true,5,7,2,41.8846,-87.64455
TA1306000015,6,22,true,6,9,3,41.88549,-87.65232
13021,6,22,true,3,7,4,41.88559,-87.64184
KA1503000012,6,22,true,2,6,4,41.88599,-87.63089
15534,6,22,true,2,12,10,41.88627,-87.61749
TA1307000131,6,22,true,2,6,4,41.88688,-87.62606
KA1503000064,6,22,true,11,9,-2,41.88697,-87.61281
TA1306000003,6,22,true,8,10,2,41.88867,-87.64442
KA1503000043,6,22,true,6,9,3,41.88918,-87.63851
13050,6,22,true,6,10,4,41.88919,-87.62775
TA1307000151,6,22,true,7,4,-3,41.88993,-87.63427
636,6,22,true,5,4,-1,41.88997,-87.63662
13430,6,22,true,10,14,4,41.89077,-87.63169
TA1306000013,6,22,true,13,6,-7,41.89083,-87.61852
RN-,6,22,true,6,6,0,41.89102,-87.63546
TA1307000117,6,22,true,15,7,-8,41.89144,-87.62675
13033,6,22,true,7,6,-1,41.8916,-87.64835
13194,6,22,true,2,7,5,41.8918,-87.65878
TA1305000003,6,22,true,11,5,-6,41.89187,-87.62061
13022,6,22,true,32,5,-27,41.89227,-87.61205
TA1306000029,6,22,true,11,14,3,41.89256,-87.61449
13265,6,22,true,4,5,1,41.89383,-87.64172
13045,6,22,true,13,7,-6,41.89403,-87.62931
KA1503000041,6,22,true,8,8,0,41.89452,-87.61798
TA1307000062,6,22,true,2,10,8,41.89466,-87.63839
TA1306000012,6,22,true,8,11,3,41.89475,-87.63438
13132,6,22,true,10,3,-7,41.89573,-87.67718
15530,6,22,true,3,5,2,41.89575,-87.62596
13289,6,22,true,6,2,-4,41.89638,-87.661
13303,6,22,true,4,9,5,41.89672,-87.63088
13017,6,22,true,7,4,-3,41.89676,-87.6357
620,6,22,true,3,5,2,41.89817,-87.63754
KA1504000103,6,22,true,1,5,4,41.89842,-87.68659
15529,6,22,true,8,8,0,41.89858,-87.62206
TA1307000128,6,22,true,8,11,3,41.89896,-87.6299
13248,6,22,true,1,7,6,41.89964,-87.66788
13042,6,22,true,7,3,-4,41.90097,-87.62377
TA1307000070,6,22,true,5,2,-3,41.90133,-87.67742
KA1504000133,6,22,true,10,8,-2,41.90234,-87.62773
TA1307000039,6,22,true,6,10,4,41.90294,-87.63137
TA1305000034,6,22,true,5,4,-1,41.90313,-87.67391
KA1504000135,6,22,true,8,16,8,41.90319,-87.63439
13136,6,22,true,5,7,2,41.90326,-87.67845
13061,6,22,true,10,6,-4,41.90342,-87.66779
TA1308000049,6,22,true,20,19,-1,41.90672,-87.6349
KA1504000134,6,22,true,6,9,3,41.90687,-87.6262
13221,6,22,true,8,2,-6,41.90765,-87.67254
TA1309000024,6,22,true,3,6,3,41.908,-87.63152
TA1305000041,6,22,true,5,2,-3,41.9094,-87.67769
TA1305000037,6,22,true,7,7,0,41.91018,-87.67003
TA1307000038,6,22,true,8,3,-5,41.91138,-87.63868
LF-005,6,22,true,4,7,3,41.91172,-87.62681
13128,6,22,true,5,4,-1,41.91197,-87.63197
TA1308000050,6,22,true,25,28,3,41.91211,-87.6347
TA1306000032,6,22,true,6,5,-1,41.9137,-87.65285
TA1307000166,6,22,true,1,5,4,41.91386,-87.64877
TA1306000007,6,22,true,2,7,5,41.91469,-87.64333
13179,6,22,true,8,11,3,41.9157,-87.63461
13133,6,22,true,6,5,-1,41.91598,-87.67733
TA1309000006,6,22,true,6,5,-1,41.91809,-87.64375
TA1307000163,6,22,true,3,6,3,41.91821,-87.65696
13146,6,22,true,13,14,1,41.91831,-87.63629
13059,6,22,true,9,11,2,41.91845,-87.65222
13192,6,22,true,3,5,2,41.91995,-87.64884
TA1309000033,6,22,true,8,9,1,41.92158,-87.65381
13193,6,22,true,13,24,11,41.92182,-87.64412
13084,6,22,true,5,3,-2,41.92268,-87.69715
TA1307000001,6,22,true,3,8,5,41.92535,-87.66581
TA1306000026,6,22,true,12,1,-11,41.92558,-87.65842
TA1306000016,6,22,true,4,7,3,41.9256,-87.65371
TA1309000019,6,22,true,2,10,8,41.92586,-87.63897
TA1309000058,6,22,true,11,8,-3,41.92591,-87.64927
TA1309000023,6,22,true,6,10,4,41.9287,-87.65383
TA1307000113,6,22,true,5,7,2,41.92878,-87.66391
TA1309000059,6,22,true,8,6,-2,41.92889,-87.65898
TA1309000061,6,22,true,12,14,2,41.92915,-87.64909
TA1305000014,6,22,true,11,15,4,41.92956,-87.64313
13085,6,22,true,2,6,4,41.92958,-87.70789
TA1307000142,6,22,true,10,6,-4,41.93125,-87.64432
13276,6,22,true,6,8,2,41.93132,-87.63874
TA1307000064,6,22,true,5,5,0,41.93222,-87.65864
TA1306000014,6,22,true,5,11,6,41.93242,-87.65271
TA1309000039,6,22,true,6,5,-1,41.93258,-87.63642
TA1309000036,6,22,true,5,6,1,41.93313,-87.64776
13268,6,22,true,5,4,-1,41.93588,-87.67843
TA1307000052,6,22,true,10,5,-5,41.93628,-87.65266
TA1307000136,6,22,true,9,5,-4,41.9365,-87.64755
TA1307000041,6,22,true,4,7,3,41.93669,-87.63683
13137,6,22,true,10,13,3,41.9376,-87.6441
TA1309000042,6,22,true,8,2,-6,41.93937,-87.66836
13229,6,22,true,8,2,-6,41.93946,-87.66376
TA1308000019,6,22,true,6,10,4,41.93973,-87.65886
13277,6,22,true,7,7,0,41.9401,-87.64546
TA1307000134,6,22,true,15,11,-4,41.94016,-87.65303
TA1309000049,6,22,true,4,7,3,41.94077,-87.63919
TA1307000138,6,22,true,7,2,-5,41.94334,-87.67094
13144,6,22,true,3,5,2,41.9434,-87.67964
TA1309000025,6,22,true,12,9,-3,41.94368,-87.64894
13071,6,22,true,6,7,1,41.94373,-87.66401
632,6,22,true,22,12,-10,41.94453,-87.6547
13278,6,22,true,3,13,10,41.94553,-87.64644
13235,6,22,true,8,7,-1,41.94814,-87.66396
13325,6,22,true,7,12,5,41.94907,-87.64863
TA1307000126,6,22,true,6,3,-3,41.94936,-87.65451
TA1307000127,6,22,true,4,7,3,41.9508,-87.65918
13323,6,22,true,3,8,5,41.95282,-87.65
TA1307000149,6,22,true,6,1,-5,41.95467,-87.67392
13379,6,22,true,1,7,6,41.95786,-87.6495
13389,6,22,true,3,6,3,41.961,-87.64958
KA1503000022,6,22,true,8,7,-1,41.96158,-87.66609
TA1307000107,6,22,true,4,5,1,41.96164,-87.65464
TA1308000012,6,22,true,5,1,-4,41.96398,-87.63818
13074,6,22,true,8,1,-7,41.96521,-87.6582
TA1309000066,6,22,true,1,5,4,41.9691,-87.67423
TA1309000035,6,22,true,10,6,-4,41.97335,-87.66785
KA1504000146,6,22,true,5,1,-4,41.978,-87.66805
13109,6,22,true,7,3,-4,41.97835,-87.65976
KA1504000152,6,22,true,3,6,3,41.98403,-87.65231
KA1503000014,6,23,false,3,5,2,41.7851,-87.60108
TA1308000009,6,23,false,10,4,-6,41.79522,-87.58075
TA1307000164,6,23,false,6,1,-5,41.79527,-87.59647
KA1503000052,6,23,false,1,9,8,41.79935,-87.60097
TA1308000035,6,23,false,1,5,4,41.80944,-87.59188
13420,6,23,false,8,2,-6,41.82459,-87.61678
KA1503000004,6,23,false,3,5,2,41.83127,-87.6088
TA1307000048,6,23,false,10,8,-2,41.83855,-87.60821
13075,6,23,false,13,9,-4,41.8531,-87.63192
15546,6,23,false,2,6,4,41.85416,-87.61916
SL-013,6,23,false,1,8,7,41.85659,-87.62755
13135,6,23,false,5,3,-2,41.85753,-87.66157
13102,6,23,false,1,10,9,41.85762,-87.61942
13164,6,23,false,10,1,-9,41.85818,-87.65648
TA1306000002,6,23,false,2,5,3,41.86238,-87.65108
TA1307000124,6,23,false,11,13,2,41.86411,-87.62372
TA1309000001,6,23,false,2,6,4,41.86488,-87.64708
TA1305000002,6,23,false,4,16,12,41.86721,-87.62597
KA1706005007,6,23,false,4,5,1,41.86749,-87.63219
SL-005,6,23,false,25,35,10,41.8679,-87.62304
TA1309000010,6,23,false,18,19,1,41.87074,-87.62574
SL-009,6,23,false,8,10,2,41.87081,-87.63121
SL-008,6,23,false,14,14,0,41.87209,-87.62956
13332,6,23,false,5,6,1,41.87219,-87.6615
623,6,23,false,24,37,13,41.87272,-87.62399
SL-007,6,23,false,14,23,9,41.87404,-87.6277
SL-010,6,23,false,2,7,5,41.87501,-87.63309
15541,6,23,false,38,29,-9,41.8758,-87.62086
13037,6,23,false,2,7,5,41.87588,-87.64078
TA1305000010,6,23,false,17,17,0,41.87623,-87.62444
624,6,23,false,12,7,-5,41.87626,-87.62923
TA1305000035,6,23,false,6,2,-4,41.87716,-87.62787
15539,6,23,false,3,9,6,41.87763,-87.64405
13158,6,23,false,15,9,-6,41.87764,-87.64957
13157,6,23,false,2,6,4,41.87773,-87.6548
TA1305000025,6,23,false,3,5,2,41.87773,-87.63528
TA1309000002,6,23,false,17,30,13,41.87784,-87.62408
13206,6,23,false,6,7,1,41.87794,-87.66201
TA1305000005,6,23,false,6,4,-2,41.87924,-87.62975
13011,6,23,false,8,10,2,41.87931,-87.63993
KA1503000015,6,23,false,8,7,-1,41.87948,-87.6257
WL-011,6,23,false,1,14,13,41.88034,-87.64273
13300,6,23,false,25,23,-2,41.88097,-87.61675
13008,6,23,false,31,35,4,41.88105,-87.62408
13134,6,23,false,1,7,6,41.88138,-87.67493
TA1307000120,6,23,false,22,6,-16,41.88188,-87.64879
TA1305000032,6,23,false,2,14,12,41.88218,-87.64109
13409,6,23,false,14,3,-11,41.8831,-87.6511
13053,6,23,false,20,13,-7,41.88365,-87.64863
13001,6,23,false,37,47,10,41.88397,-87.62459
13155,6,23,false,5,1,-4,41.88407,-87.65689
18062,6,23,false,6,9,3,41.88412,-87.65427
TA1306000010,6,23,false,8,5,-3,41.88419,-87.62961
TA1305000030,6,23,false,9,10,1,41.88459,-87.63178
15535,6,23,false,24,7,-17,41.8846,-87.64455
TA1305000029,6,23,false,10,7,-3,41.88466,-87.62787
13263,6,23,false,15,18,3,41.88467,-87.61952
TA1306000015,6,23,false,35,18,-17,41.88549,-87.65232
13021,6,23,false,21,8,-13,41.88559,-87.64184
TA1307000111,6,23,false,3,11,8,41.88582,-87.63548
13073,6,23,false,5,2,-3,41.88592,-87.66717
KA1503000012,6,23,false,18,9,-9,41.88599,-87.63089
TA1305000011,6,23,false,38,26,-12,41.886,-87.62418
15534,6,23,false,8,9,1,41.88627,-87.61749
TA1308000029,6,23,false,21,12,-9,41.88673,-87.62225
TA1307000131,6,23,false,16,19,3,41.88688,-87.62606
KA1503000064,6,23,false,24,22,-2,41.88697,-87.61281
TA1305000022,6,23,false,5,6,1,41.88817,-87.63656
TA1306000003,6,23,false,24,7,-17,41.88867,-87.64442
KA1503000043,6,23,false,7,21,14,41.88918,-87.63851
13050,6,23,false,27,34,7,41.88919,-87.62775
TA1307000151,6,23,false,29,36,7,41.88993,-87.63427
636,6,23,false,3,15,12,41.88997,-87.63662
13427,6,23,false,5,6,1,41.89054,-87.62205
13430,6,23,false,18,40,22,41.89077,-87.63169
TA1306000013,6,23,false,31,24,-7,41.89083,-87.61852
RN-,6,23,false,2,8,6,41.89102,-87.63546
13434,6,23,false,10,14,4,41.89108,-87.66663
TA1307000117,6,23,false,22,35,13,41.89144,-87.62675
13033,6,23,false,28,10,-18,41.8916,-87.64835
13194,6,23,false,1,5,4,41.8918,-87.65878
TA1305000003,6,23,false,29,18,-11,41.89187,-87.62061
13022,6,23,false,48,37,-11,41.89227,-87.61205
TA1306000029,6,23,false,51,25,-26,41.89256,-87.61449
13265,6,23,false,6,6,0,41.89383,-87.64172
13045,6,23,false,19,15,-4,41.89403,-87.62931
13016,6,23,false,12,15,3,41.89431,-87.62277
KA1503000041,6,23,false,26,13,-13,41.89452,-87.61798
13196,6,23,false,11,6,-5,41.89455,-87.65345
TA1307000062,6,23,false,7,10,3,41.89466,-87.63839
TA1306000012,6,23,false,11,20,9,41.89475,-87.63438
KP1705001026,6,23,false,7,16,9,41.89483,-87.6323
KA1504000114,6,23,false,5,3,-2,41.89547,-87.70614
18058,6,23,false,4,5,1,41.8955,-87.68201
13132,6,23,false,11,6,-5,41.89573,-87.67718
15530,6,23,false,18,8,-10,41.89575,-87.62596
18003,6,23,false,7,10,3,41.89575,-87.62011
13247,6,23,false,6,13,7,41.89597,-87.66775
TA1305000020,6,23,false,8,7,-1,41.89636,-87.65406
13289,6,23,false,3,16,13,41.89638,-87.661
13303,6,23,false,13,9,-4,41.89672,-87.63088
13017,6,23,false,5,8,3,41.89676,-87.6357
13338,6,23,false,5,5,0,41.89697,-87.62173
TA1307000061,6,23,false,1,13,12,41.89745,-87.62873
13034,6,23,false,7,4,-3,41.89754,-87.62352
TA1306000009,6,23,false,2,9,7,41.89772,-87.64299
620,6,23,false,2,7,5,41.89817,-87.63754
KA1504000103,6,23,false,3,6,3,41.89842,-87.68659
15529,6,23,false,14,7,-7,41.89858,-87.62206
TA1307000128,6,23,false,17,29,12,41.89896,-87.6299
TA1306000011,6,23,false,3,7,4,41.89994,-87.63443
KA1504000116,6,23,false,5,3,-2,41.90023,-87.64299
17660,6,23,false,2,9,7,41.90036,-87.69671
13290,6,23,false,2,5,3,41.90069,-87.66259
13042,6,23,false,31,19,-12,41.90097,-87.62377
TA1307000070,6,23,false,2,5,3,41.90133,-87.67742
KA1504000133,6,23,false,11,13,2,41.90234,-87.62773
TA1307000039,6,23,false,39,45,6,41.90294,-87.63137
13256,6,23,false,5,7,2,41.90302,-87.69749
TA1305000034,6,23,false,13,8,-5,41.90313,-87.67391
KA1504000135,6,23,false,36,32,-4,41.90319,-87.63439
13136,6,23,false,25,19,-6,41.90326,-87.67845
13061,6,23,false,27,22,-5,41.90342,-87.66779
KA1504000079,6,23,false,7,2,-5,41.9035,-87.64334
TA1308000049,6,23,false,39,25,-14,41.90672,-87.6349
KA1504000134,6,23,false,7,10,3,41.90687,-87.6262
13224,6,23,false,8,8,0,41.90706,-87.66725
TA1307000143,6,23,false,7,7,0,41.90762,-87.63854
13221,6,23,false,2,11,9,41.90765,-87.67254
TA1309000024,6,23,false,12,15,3,41.908,-87.63152
TA1305000041,6,23,false,12,15,3,41.9094,-87.67769
331,6,23,false,11,13,2,41.90965,-87.64812
15653,6,23,false,6,3,-3,41.90979,-87.7053
TA1305000037,6,23,false,7,9,2,41.91018,-87.67003
TA1306000008,6,23,false,9,7,-2,41.9102,-87.6435
TA1308000005,6,23,false,7,6,-1,41.91042,-87.68238
13258,6,23,false,7,3,-4,41.91043,-87.69718
13257,6,23,false,11,7,-4,41.91054,-87.68956
13058,6,23,false,6,5,-1,41.91059,-87.64942
TA1307000038,6,23,false,13,7,-6,41.91138,-87.63868
LF-005,6,23,false,16,14,-2,41.91172,-87.62681
13128,6,23,false,5,11,6,41.91197,-87.63197
TA1308000050,6,23,false,68,53,-15,41.91211,-87.6347
13243,6,23,false,5,13,8,41.91262,-87.6814
TA1306000032,6,23,false,5,15,10,41.9137,-87.65285
TA1307000166,6,23,false,4,5,1,41.91386,-87.64877
18067,6,23,false,3,5,2,41.9146,-87.66796
13179,6,23,false,32,16,-16,41.9157,-87.63461
13133,6,23,false,30,17,-13,41.91598,-87.67733
TA1309000006,6,23,false,16,3,-13,41.91809,-87.64375
TA1307000163,6,23,false,5,5,0,41.91821,-87.65696
13146,6,23,false,29,17,-12,41.91831,-87.63629
13059,6,23,false,9,11,2,41.91845,-87.65222
13192,6,23,false,7,28,21,41.91995,-87.64884
13288,6,23,false,4,12,8,41.92008,-87.67788
TA1309000030,6,23,false,6,8,2,41.92077,-87.66372
TA1309000033,6,23,false,9,11,2,41.92158,-87.65381
13193,6,23,false,31,22,-9,41.92182,-87.64412
13191,6,23,false,14,12,-2,41.92217,-87.63891
13084,6,23,false,14,12,-2,41.92268,-87.69715
LP-,6,23,false,8,11,3,41.92396,-87.63584
KA1504000090,6,23,false,5,5,0,41.92483,-87.7145
TA1307000001,6,23,false,13,5,-8,41.92535,-87.66581
TA1306000026,6,23,false,8,15,7,41.92558,-87.65842
TA1306000016,6,23,false,11,9,-2,41.9256,-87.65371
TA1309000019,6,23,false,21,23,2,41.92586,-87.63897
TA1309000058,6,23,false,20,30,10,41.92591,-87.64927
TA1308000001,6,23,false,6,8,2,41.92627,-87.63086
TA1309000023,6,23,false,18,15,-3,41.9287,-87.65383
TA1307000113,6,23,false,16,12,-4,41.92878,-87.66391
TA1309000059,6,23,false,9,10,1,41.92889,-87.65898
TA1309000061,6,23,false,25,25,0,41.92915,-87.64909
TA1305000014,6,23,false,14,8,-6,41.92956,-87.64313
13085,6,23,false,6,11,5,41.92958,-87.70789
TA1307000142,6,23,false,8,9,1,41.93125,-87.64432
13276,6,23,false,10,19,9,41.93132,-87.63874
15645,6,23,false,5,1,-4,41.93191,-87.70121
13271,6,23,false,3,6,3,41.93192,-87.67784
TA1307000064,6,23,false,11,17,6,41.93222,-87.65864
TA1306000014,6,23,false,20,19,-1,41.93242,-87.65271
TA1309000039,6,23,false,8,16,8,41.93258,-87.63642
13294,6,23,false,10,4,-6,41.9326,-87.66595
TA1309000036,6,23,false,2,12,10,41.93313,-87.64776
TA1307000006,6,23,false,17,6,-11,41.93571,-87.6636
13268,6,23,false,3,7,4,41.93588,-87.67843
TA1307000052,6,23,false,17,16,-1,41.93628,-87.65266
TA1307000136,6,23,false,10,12,2,41.9365,-87.64755
TA1307000041,6,23,false,7,5,-2,41.93669,-87.63683
13137,6,23,false,5,11,6,41.9376,-87.6441
TA1309000042,6,23,false,3,7,4,41.93937,-87.66836
13229,6,23,false,8,8,0,41.93946,-87.66376
TA1308000019,6,23,false,12,9,-3,41.93973,-87.65886
13277,6,23,false,16,8,-8,41.9401,-87.64546
TA1307000134,6,23,false,31,22,-9,41.94016,-87.65303
13143,6,23,false,11,2,-9,41.94059,-87.67853
TA1309000049,6,23,false,6,11,5,41.94077,-87.63919
TA1307000138,6,23,false,5,4,-1,41.94334,-87.67094
13144,6,23,false,5,5,0,41.9434,-87.67964
TA1309000025,6,23,false,33,36,3,41.94368,-87.64894
13071,6,23,false,18,14,-4,41.94373,-87.66401
632,6,23,false,31,26,-5,41.94453,-87.6547
13278,6,23,false,12,2,-10,41.94553,-87.64644
13235,6,23,false,8,5,-3,41.94814,-87.66396
13325,6,23,false,5,11,6,41.94907,-87.64863
TA1307000126,6,23,false,36,20,-16,41.94936,-87.65451
TA1307000150,6,23,false,1,16,15,41.94945,-87.64646
13319,6,23,false,7,3,-4,41.95069,-87.6687
TA1307000127,6,23,false,10,16,6,41.9508,-87.65918
13323,6,23,false,9,14,5,41.95282,-87.65
KA1504000096,6,23,false,7,3,-4,41.95361,-87.70932
13063,6,23,false,1,7,6,41.95424,-87.65441
KA1504000158,6,23,false,8,2,-6,41.95432,-87.68607
TA1307000149,6,23,false,6,5,-1,41.95467,-87.67392
13379,6,23,false,4,8,4,41.95786,-87.6495
KA1504000097,6,23,false,1,5,4,41.96116,-87.71658
KA1503000022,6,23,false,5,3,-2,41.96158,-87.66609
TA1307000107,6,23,false,5,10,5,41.96164,-87.65464
13074,6,23,false,3,5,2,41.96521,-87.6582
639,6,23,false,1,5,4,41.96584,-87.64538
KA1504000171,6,23,false,1,9,8,41.97161,-87.65016
TA1309000035,6,23,false,6,4,-2,41.97335,-87.66785
KA1504000146,6,23,false,5,13,8,41.978,-87.66805
13109,6,23,false,2,6,4,41.97835,-87.65976
604,6,23,false,2,5,3,42.05824,-87.67744
15545,6,23,true,5,3,-2,41.85627,-87.61334
13163,6,23,true,5,5,0,41.85808,-87.65108
13164,6,23,true,2,7,5,41.85818,-87.65648
13431,6,23,true,5,2,-3,41.8661,-87.60728
SL-005,6,23,true,5,6,1,41.8679,-87.62304
TA1309000010,6,23,true,8,3,-5,41.87074,-87.62574
TA1307000130,6,23,true,2,14,12,41.87178,-87.65103
SL-008,6,23,true,8,15,7,41.87209,-87.62956
13332,6,23,true,4,10,6,41.87219,-87.6615
SL-011,6,23,true,6,8,2,41.87256,-87.63356
623,6,23,true,6,3,-3,41.87272,-87.62399
13158,6,23,true,3,6,3,41.87764,-87.64957
13157,6,23,true,3,5,2,41.87773,-87.6548
TA1305000025,6,23,true,4,8,4,41.87773,-87.63528
13156,6,23,true,1,6,5,41.88042,-87.65554
TA1307000120,6,23,true,8,13,5,41.88188,-87.64879
TA1305000032,6,23,true,6,7,1,41.88218,-87.64109
13409,6,23,true,7,3,-4,41.8831,-87.6511
13053,6,23,true,14,3,-11,41.88365,-87.64863
15535,6,23,true,3,8,5,41.8846,-87.64455
TA1305000029,6,23,true,6,1,-5,41.88466,-87.62787
TA1306000015,6,23,true,16,5,-11,41.88549,-87.65232
TA1305000011,6,23,true,5,7,2,41.886,-87.62418
TA1306000003,6,23,true,17,3,-14,41.88867,-87.64442
KA1503000043,6,23,true,10,9,-1,41.88918,-87.63851
13050,6,23,true,12,8,-4,41.88919,-87.62775
TA1307000151,6,23,true,14,21,7,41.88993,-87.63427
636,6,23,true,4,8,4,41.88997,-87.63662
13430,6,23,true,13,9,-4,41.89077,-87.63169
TA1306000013,6,23,true,7,5,-2,41.89083,-87.61852
13434,6,23,true,3,5,2,41.89108,-87.66663
TA1307000117,6,23,true,8,8,0,41.89144,-87.62675
13033,6,23,true,15,14,-1,41.8916,-87.64835
TA1305000003,6,23,true,7,6,-1,41.89187,-87.62061
13022,6,23,true,5,1,-4,41.89227,-87.61205
TA1306000029,6,23,true,6,8,2,41.89256,-87.61449
13265,6,23,true,6,9,3,41.89383,-87.64172
13045,6,23,true,6,6,0,41.89403,-87.62931
KA1503000041,6,23,true,2,5,3,41.89452,-87.61798
13196,6,23,true,4,5,1,41.89455,-87.65345
TA1306000012,6,23,true,7,14,7,41.89475,-87.63438
KP1705001026,6,23,true,5,6,1,41.89483,-87.6323
13132,6,23,true,5,1,-4,41.89573,-87.67718
15530,6,23,true,7,4,-3,41.89575,-87.62596
TA1305000020,6,23,true,6,5,-1,41.89636,-87.65406
620,6,23,true,5,3,-2,41.89817,-87.63754
15529,6,23,true,4,9,5,41.89858,-87.62206
TA1307000128,6,23,true,4,9,5,41.89896,-87.6299
13248,6,23,true,4,7,3,41.89964,-87.66788
TA1306000011,6,23,true,5,2,-3,41.89994,-87.63443
TA1307000070,6,23,true,3,5,2,41.90133,-87.67742
KA1504000133,6,23,true,12,10,-2,41.90234,-87.62773
TA1307000039,6,23,true,20,27,7,41.90294,-87.63137
TA1305000034,6,23,true,8,4,-4,41.90313,-87.67391
KA1504000135,6,23,true,24,20,-4,41.90319,-87.63439
13136,6,23,true,11,5,-6,41.90326,-87.67845
13061,6,23,true,9,9,0,41.90342,-87.66779
TA1307000115,6,23,true,5,4,-1,41.9046,-87.64056
TA1308000049,6,23,true,21,18,-3,41.90672,-87.6349
13224,6,23,true,5,4,-1,41.90706,-87.66725
TA1307000143,6,23,true,7,5,-2,41.90762,-87.63854
13221,6,23,true,6,1,-5,41.90765,-87.67254
TA1309000024,6,23,true,4,5,1,41.908,-87.63152
TA1305000041,6,23,true,9,8,-1,41.9094,-87.67769
TA1305000037,6,23,true,8,8,0,41.91018,-87.67003
TA1306000008,6,23,true,2,5,3,41.9102,-87.6435
TA1308000050,6,23,true,24,31,7,41.91211,-87.6347
13243,6,23,true,1,7,6,41.91262,-87.6814
TA1306000032,6,23,true,3,7,4,41.9137,-87.65285
13179,6,23,true,9,8,-1,41.9157,-87.63461
13133,6,23,true,9,11,2,41.91598,-87.67733
TA1309000006,6,23,true,1,5,4,41.91809,-87.64375
TA1307000163,6,23,true,5,1,-4,41.91821,-87.65696
13146,6,23,true,16,21,5,41.91831,-87.63629
13059,6,23,true,6,11,5,41.91845,-87.65222
13192,6,23,true,2,13,11,41.91995,-87.64884
13288,6,23,true,5,1,-4,41.92008,-87.67788
13242,6,23,true,5,4,-1,41.92021,-87.69266
TA1309000033,6,23,true,5,6,1,41.92158,-87.65381
13193,6,23,true,19,16,-3,41.92182,-87.64412
13084,6,23,true,5,7,2,41.92268,-87.69715
TA1306000026,6,23,true,5,5,0,41.92558,-87.65842
TA1306000016,6,23,true,13,3,-10,41.9256,-87.65371
TA1309000019,6,23,true,5,11,6,41.92586,-87.63897
TA1309000058,6,23,true,9,9,0,41.92591,-87.64927
TA1309000023,6,23,true,16,3,-13,41.9287,-87.65383
TA1307000113,6,23,true,7,2,-5,41.92878,-87.66391
TA1309000059,6,23,true,4,6,2,41.92889,-87.65898
TA1309000061,6,23,true,14,9,-5,41.92915,-87.64909
TA1305000014,6,23,true,9,7,-2,41.92956,-87.64313
TA1307000142,6,23,true,7,6,-1,41.93125,-87.64432
TA1307000064,6,23,true,10,8,-2,41.93222,-87.65864
TA1306000014,6,23,true,10,3,-7,41.93242,-87.65271
TA1309000039,6,23,true,2,5,3,41.93258,-87.63642
TA1307000052,6,23,true,9,4,-5,41.93628,-87.65266
TA1307000136,6,23,true,4,5,1,41.9365,-87.64755
TA1307000041,6,23,true,2,9,7,41.93669,-87.63683
13137,6,23,true,9,18,9,41.9376,-87.6441
13229,6,23,true,5,4,-1,41.93946,-87.66376
TA1308000019,6,23,true,4,7,3,41.93973,-87.65886
13277,6,23,true,3,8,5,41.9401,-87.64546
TA1307000134,6,23,true,16,10,-6,41.94016,-87.65303
TA1309000049,6,23,true,9,13,4,41.94077,-87.63919
TA1309000025,6,23,true,14,13,-1,41.94368,-87.64894
13071,6,23,true,7,4,-3,41.94373,-87.66401
632,6,23,true,9,10,1,41.94453,-87.6547
13278,6,23,true,6,2,-4,41.94553,-87.64644
13235,6,23,true,6,5,-1,41.94814,-87.66396
TA1307000126,6,23,true,12,13,1,41.94936,-87.65451
TA1307000150,6,23,true,3,9,6,41.94945,-87.64646
TA1307000127,6,23,true,6,1,-5,41.9508,-87.65918
13323,6,23,true,8,6,-2,41.95282,-87.65
13063,6,23,true,4,5,1,41.95424,-87.65441
TA1308000022,6,23,true,5,3,-2,41.95438,-87.64805
13389,6,23,true,2,7,5,41.961,-87.64958
KA1503000022,6,23,true,3,6,3,41.96158,-87.66609
13109,6,23,true,7,4,-3,41.97835,-87.65976
KA1504000152,6,23,true,5,3,-2,41.98403,-87.65231
KA1504000076,7,0,false,1,5,4,41.7943,-87.60145
13215,7,0,false,2,5,3,41.83634,-87.6135
TA1307000048,7,0,false,14,4,-10,41.83855,-87.60821
13304,7,0,false,2,7,5,41.86126,-87.65659
TA1307000124,7,0,false,11,20,9,41.86411,-87.62372
13431,7,0,false,7,1,-6,41.8661,-87.60728
TA1305000002,7,0,false,12,12,0,41.86721,-87.62597
SL-005,7,0,false,17,20,3,41.8679,-87.62304
TA1309000010,7,0,false,6,13,7,41.87074,-87.62574
SL-009,7,0,false,8,1,-7,41.87081,-87.63121
15542,7,0,false,2,5,3,41.87146,-87.64095
SL-008,7,0,false,11,22,11,41.87209,-87.62956
SL-011,7,0,false,3,15,12,41.87256,-87.63356
623,7,0,false,14,33,19,41.87272,-87.62399
SL-010,7,0,false,10,1,-9,41.87501,-87.63309
15541,7,0,false,16,19,3,41.8758,-87.62086
TA1305000010,7,0,false,9,13,4,41.87623,-87.62444
TA1305000035,7,0,false,4,6,2,41.87716,-87.62787
13158,7,0,false,7,15,8,41.87764,-87.64957
TA1309000002,7,0,false,27,22,-5,41.87784,-87.62408
13206,7,0,false,2,5,3,41.87794,-87.66201
638,7,0,false,5,8,3,41.87827,-87.64078
TA1305000005,7,0,false,1,7,6,41.87924,-87.62975
KA1503000015,7,0,false,9,10,1,41.87948,-87.6257
WL-011,7,0,false,6,4,-2,41.88034,-87.64273
13300,7,0,false,29,27,-2,41.88097,-87.61675
13008,7,0,false,33,33,0,41.88105,-87.62408
TA1305000006,7,0,false,2,5,3,41.88122,-87.6296
TA1307000120,7,0,false,27,11,-16,41.88188,-87.64879
13036,7,0,false,2,9,7,41.8821,-87.62513
TA1305000032,7,0,false,3,16,13,41.88218,-87.64109
13353,7,0,false,7,3,-4,41.88283,-87.6612
WL-012,7,0,false,9,5,-4,41.88337,-87.6412
13053,7,0,false,5,12,7,41.88365,-87.64863
13001,7,0,false,36,21,-15,41.88397,-87.62459
13155,7,0,false,1,5,4,41.88407,-87.65689
18062,7,0,false,9,2,-7,41.88412,-87.65427
TA1305000030,7,0,false,2,8,6,41.88459,-87.63178
15535,7,0,false,10,14,4,41.8846,-87.64455
TA1305000029,7,0,false,4,8,4,41.88466,-87.62787
13263,7,0,false,18,14,-4,41.88467,-87.61952
TA1306000015,7,0,false,18,13,-5,41.88549,-87.65232
13021,7,0,false,10,13,3,41.88559,-87.64184
TA1307000111,7,0,false,5,1,-4,41.88582,-87.63548
KA1503000012,7,0,false,11,11,0,41.88599,-87.63089
TA1305000011,7,0,false,35,41,6,41.886,-87.62418
15534,7,0,false,6,9,3,41.88627,-87.61749
13197,7,0,false,5,1,-4,41.8866,-87.65816
TA1308000029,7,0,false,3,13,10,41.88673,-87.62225
TA1307000131,7,0,false,29,10,-19,41.88688,-87.62606
KA1503000064,7,0,false,8,4,-4,41.88697,-87.61281
TA1305000022,7,0,false,7,5,-2,41.88817,-87.63656
TA1306000003,7,0,false,23,9,-14,41.88867,-87.64442
KA1503000043,7,0,false,10,10,0,41.88918,-87.63851
13050,7,0,false,23,12,-11,41.88919,-87.62775
TA1307000151,7,0,false,33,23,-10,41.88993,-87.63427
636,7,0,false,9,4,-5,41.88997,-87.63662
KA1503000044,7,0,false,7,3,-4,41.89018,-87.6262
13427,7,0,false,10,5,-5,41.89054,-87.62205
13430,7,0,false,24,15,-9,41.89077,-87.63169
TA1306000013,7,0,false,34,16,-18,41.89083,-87.61852
RN-,7,0,false,7,12,5,41.89102,-87.63546
TA1308000006,7,0,false,3,7,4,41.89128,-87.67686
TA1307000117,7,0,false,18,20,2,41.89144,-87.62675
13033,7,0,false,11,16,5,41.8916,-87.64835
13194,7,0,false,8,8,0,41.8918,-87.65878
TA1305000003,7,0,false,18,12,-6,41.89187,-87.62061
13022,7,0,false,7,33,26,41.89227,-87.61205
TA1306000029,7,0,false,24,19,-5,41.89256,-87.61449
13265,7,0,false,10,9,-1,41.89383,-87.64172
13045,7,0,false,9,17,8,41.89403,-87.62931
13016,7,0,false,10,7,-3,41.89431,-87.62277
KA1503000041,7,0,false,13,15,2,41.89452,-87.61798
13196,7,0,false,5,6,1,41.89455,-87.65345
TA1307000062,7,0,false,3,13,10,41.89466,-87.63839
TA1306000012,7,0,false,33,16,-17,41.89475,-87.63438
KP1705001026,7,0,false,7,4,-3,41.89483,-87.6323
637,7,0,false,3,8,5,41.89563,-87.67209
13132,7,0,false,11,15,4,41.89573,-87.67718
15530,7,0,false,2,8,6,41.89575,-87.62596
18003,7,0,false,10,2,-8,41.89575,-87.62011
13247,7,0,false,13,15,2,41.89597,-87.66775
TA1305000020,7,0,false,7,12,5,41.89636,-87.65406
13289,7,0,false,8,10,2,41.89638,-87.661
13303,7,0,false,18,27,9,41.89672,-87.63088
13017,7,0,false,11,11,0,41.89676,-87.6357
TA1307000061,7,0,false,19,14,-5,41.89745,-87.62873
13034,7,0,false,7,16,9,41.89754,-87.62352
KA1504000103,7,0,false,5,6,1,41.89842,-87.68659
15529,7,0,false,5,9,4,41.89858,-87.62206
TA1307000128,7,0,false,16,15,-1,41.89896,-87.6299
13248,7,0,false,5,8,3,41.89964,-87.66788
KA1504000116,7,0,false,2,5,3,41.90023,-87.64299
13042,7,0,false,12,11,-1,41.90097,-87.62377
TA1307000070,7,0,false,3,6,3,41.90133,-87.67742
KA1504000133,7,0,false,17,19,2,41.90234,-87.62773
13241,7,0,false,4,5,1,41.9029,-87.68731
TA1306000006,7,0,false,5,9,4,41.90292,-87.63772
TA1307000039,7,0,false,33,29,-4,41.90294,-87.63137
658,7,0,false,5,3,-2,41.903,-87.6838
13256,7,0,false,2,6,4,41.90302,-87.69749
TA1305000034,7,0,false,20,6,-14,41.90313,-87.67391
KA1504000135,7,0,false,28,28,0,41.90319,-87.63439
13136,7,0,false,14,12,-2,41.90326,-87.67845
13061,7,0,false,19,19,0,41.90342,-87.66779
TA1308000049,7,0,false,44,39,-5,41.90672,-87.6349
KA1504000134,7,0,false,6,10,4,41.90687,-87.6262
13224,7,0,false,7,9,2,41.90706,-87.66725
TA1307000143,7,0,false,7,5,-2,41.90762,-87.63854
13221,7,0,false,20,17,-3,41.90765,-87.67254
TA1309000024,7,0,false,16,7,-9,41.908,-87.63152
TA1305000041,7,0,false,31,14,-17,41.9094,-87.67769
331,7,0,false,10,16,6,41.90965,-87.64812
TA1305000037,7,0,false,25,4,-21,41.91018,-87.67003
TA1306000008,7,0,false,3,5,2,41.9102,-87.6435
13258,7,0,false,3,10,7,41.91043,-87.69718
13154,7,0,false,4,6,2,41.91054,-87.65312
TA1307000038,7,0,false,17,17,0,41.91138,-87.63868
LF-005,7,0,false,2,13,11,41.91172,-87.62681
13128,7,0,false,8,2,-6,41.91197,-87.63197
TA1308000050,7,0,false,39,28,-11,41.91211,-87.6347
13243,7,0,false,16,7,-9,41.91262,-87.6814
TA1306000032,7,0,false,3,5,2,41.9137,-87.65285
TA1307000166,7,0,false,9,6,-3,41.91386,-87.64877
18017,7,0,false,2,7,5,41.91416,-87.71676
18067,7,0,false,3,11,8,41.9146,-87.66796
13068,7,0,false,5,5,0,41.91554,-87.68703
13179,7,0,false,26,21,-5,41.9157,-87.63461
13133,7,0,false,24,12,-12,41.91598,-87.67733
15651,7,0,false,1,10,9,41.91752,-87.70181
TA1309000006,7,0,false,8,10,2,41.91809,-87.64375
TA1307000163,7,0,false,7,2,-5,41.91821,-87.65696
13146,7,0,false,26,16,-10,41.91831,-87.63629
13059,7,0,false,15,13,-2,41.91845,-87.65222
13192,7,0,false,41,8,-33,41.91995,-87.64884
13288,7,0,false,4,7,3,41.92008,-87.67788
13292,7,0,false,2,5,3,41.92152,-87.70733
TA1309000033,7,0,false,21,15,-6,41.92158,-87.65381
13193,7,0,false,17,28,11,41.92182,-87.64412
13191,7,0,false,5,8,3,41.92217,-87.63891
13084,7,0,false,13,21,8,41.92268,-87.69715
LP-,7,0,false,12,15,3,41.92396,-87.63584
15648,7,0,false,6,10,4,41.92464,-87.68931
TA1307000001,7,0,false,14,19,5,41.92535,-87.66581
TA1306000026,7,0,false,3,11,8,41.92558,-87.65842
TA1306000016,7,0,false,11,3,-8,41.9256,-87.65371
TA1309000019,7,0,false,15,29,14,41.92586,-87.63897
TA1309000058,7,0,false,27,18,-9,41.92591,-87.64927
TA1308000001,7,0,false,4,9,5,41.92627,-87.63086
15646,7,0,false,10,1,-9,41.92668,-87.6977
TA1309000023,7,0,false,17,13,-4,41.9287,-87.65383
TA1307000113,7,0,false,21,17,-4,41.92878,-87.66391
13296,7,0,false,4,8,4,41.92883,-87.66852
TA1309000059,7,0,false,5,4,-1,41.92889,-87.65898
TA1309000061,7,0,false,17,29,12,41.92915,-87.64909
TA1305000014,7,0,false,17,12,-5,41.92956,-87.64313
13085,7,0,false,7,24,17,41.92958,-87.70789
TA1307000142,7,0,false,11,17,6,41.93125,-87.64432
13276,7,0,false,7,8,1,41.93132,-87.63874
13271,7,0,false,1,7,6,41.93192,-87.67784
TA1307000064,7,0,false,9,7,-2,41.93222,-87.65864
TA1306000014,7,0,false,19,22,3,41.93242,-87.65271
TA1309000039,7,0,false,7,5,-2,41.93258,-87.63642
TA1309000036,7,0,false,6,8,2,41.93313,-87.64776
TA1307000006,7,0,false,17,2,-15,41.93571,-87.6636
TA1307000052,7,0,false,16,22,6,41.93628,-87.65266
TA1307000136,7,0,false,12,18,6,41.9365,-87.64755
13137,7,0,false,18,11,-7,41.9376,-87.6441
KA17018068,7,0,false,2,5,3,41.93935,-87.68327
TA1309000042,7,0,false,6,8,2,41.93937,-87.66836
13229,7,0,false,10,14,4,41.93946,-87.66376
TA1308000019,7,0,false,24,7,-17,41.93973,-87.65886
13277,7,0,false,8,9,1,41.9401,-87.64546
TA1307000134,7,0,false,32,15,-17,41.94016,-87.65303
13143,7,0,false,5,5,0,41.94059,-87.67853
TA1309000049,7,0,false,6,9,3,41.94077,-87.63919
TA1309000025,7,0,false,26,9,-17,41.94368,-87.64894
13071,7,0,false,15,13,-2,41.94373,-87.66401
632,7,0,false,21,26,5,41.94453,-87.6547
13278,7,0,false,16,10,-6,41.94553,-87.64644
TA1309000050,7,0,false,4,5,1,41.94618,-87.67331
13235,7,0,false,15,6,-9,41.94814,-87.66396
13325,7,0,false,17,7,-10,41.94907,-87.64863
TA1307000126,7,0,false,20,20,0,41.94936,-87.65451
TA1307000127,7,0,false,15,18,3,41.9508,-87.65918
13323,7,0,false,15,14,-1,41.95282,-87.65
13063,7,0,false,15,9,-6,41.95424,-87.65441
13379,7,0,false,1,5,4,41.95786,-87.6495
TA1309000027,7,0,false,2,8,6,41.9585,-87.65499
TA1307000144,7,0,false,2,5,3,41.96142,-87.6762
TA1307000107,7,0,false,8,8,0,41.96164,-87.65464
TA1307000156,7,0,false,7,6,-1,41.96301,-87.68479
13074,7,0,false,1,8,7,41.96521,-87.6582
TA1309000014,7,0,false,11,5,-6,41.96709,-87.66744
604,7,0,false,8,5,-3,42.05824,-87.67744
KA1503000014,7,0,true,5,2,-3,41.7851,-87.60108
13164,7,0,true,5,3,-2,41.85818,-87.65648
TA1305000002,7,0,true,1,7,6,41.86721,-87.62597
SL-005,7,0,true,1,5,4,41.8679,-87.62304
TA1307000130,7,0,true,3,6,3,41.87178,-87.65103
SL-008,7,0,true,2,5,3,41.87209,-87.62956
13332,7,0,true,4,6,2,41.87219,-87.6615
SL-011,7,0,true,6,4,-2,41.87256,-87.63356
623,7,0,true,1,8,7,41.87272,-87.62399
TA1305000025,7,0,true,6,4,-2,41.87773,-87.63528
13206,7,0,true,3,6,3,41.87794,-87.66201
638,7,0,true,5,1,-4,41.87827,-87.64078
TA1307000120,7,0,true,10,9,-1,41.88188,-87.64879
TA1305000032,7,0,true,8,7,-1,41.88218,-87.64109
13409,7,0,true,6,5,-1,41.8831,-87.6511
15535,7,0,true,5,2,-3,41.8846,-87.64455
TA1306000015,7,0,true,10,5,-5,41.88549,-87.65232
13021,7,0,true,6,8,2,41.88559,-87.64184
TA1306000003,7,0,true,2,10,8,41.88867,-87.64442
KA1503000043,7,0,true,4,7,3,41.88918,-87.63851
13050,7,0,true,4,7,3,41.88919,-87.62775
TA1307000151,7,0,true,15,9,-6,41.88993,-87.63427
636,7,0,true,6,1,-5,41.88997,-87.63662
13427,7,0,true,7,1,-6,41.89054,-87.62205
13430,7,0,true,10,6,-4,41.89077,-87.63169
RN-,7,0,true,5,5,0,41.89102,-87.63546
13434,7,0,true,1,5,4,41.89108,-87.66663
TA1307000117,7,0,true,7,7,0,41.89144,-87.62675
13033,7,0,true,6,6,0,41.8916,-87.64835
13194,7,0,true,2,6,4,41.8918,-87.65878
TA1305000003,7,0,true,3,6,3,41.89187,-87.62061
TA1306000029,7,0,true,8,6,-2,41.89256,-87.61449
13265,7,0,true,2,6,4,41.89383,-87.64172
13045,7,0,true,7,5,-2,41.89403,-87.62931
13196,7,0,true,3,6,3,41.89455,-87.65345
TA1307000062,7,0,true,8,5,-3,41.89466,-87.63839
TA1306000012,7,0,true,13,16,3,41.89475,-87.63438
637,7,0,true,1,5,4,41.89563,-87.67209
13132,7,0,true,9,4,-5,41.89573,-87.67718
TA1305000020,7,0,true,2,5,3,41.89636,-87.65406
13289,7,0,true,1,5,4,41.89638,-87.661
13303,7,0,true,2,6,4,41.89672,-87.63088
13017,7,0,true,2,6,4,41.89676,-87.6357
TA1307000061,7,0,true,2,5,3,41.89745,-87.62873
TA1306000009,7,0,true,4,6,2,41.89772,-87.64299
15529,7,0,true,5,1,-4,41.89858,-87.62206
13248,7,0,true,3,7,4,41.89964,-87.66788
TA1306000011,7,0,true,5,4,-1,41.89994,-87.63443
KA1504000116,7,0,true,1,5,4,41.90023,-87.64299
13042,7,0,true,8,7,-1,41.90097,-87.62377
KA1504000133,7,0,true,5,5,0,41.90234,-87.62773
TA1307000039,7,0,true,10,11,1,41.90294,-87.63137
658,7,0,true,3,5,2,41.903,-87.6838
TA1305000034,7,0,true,10,3,-7,41.90313,-87.67391
KA1504000135,7,0,true,11,8,-3,41.90319,-87.63439
13136,7,0,true,8,2,-6,41.90326,-87.67845
13061,7,0,true,7,10,3,41.90342,-87.66779
TA1308000049,7,0,true,10,14,4,41.90672,-87.6349
13224,7,0,true,3,5,2,41.90706,-87.66725
TA1307000143,7,0,true,2,5,3,41.90762,-87.63854
13221,7,0,true,8,4,-4,41.90765,-87.67254
TA1309000024,7,0,true,10,11,1,41.908,-87.63152
TA1305000041,7,0,true,8,15,7,41.9094,-87.67769
TA1305000037,7,0,true,5,4,-1,41.91018,-87.67003
13058,7,0,true,3,5,2,41.91059,-87.64942
TA1307000038,7,0,true,9,10,1,41.91138,-87.63868
TA1308000050,7,0,true,17,13,-4,41.91211,-87.6347
TA1306000032,7,0,true,6,8,2,41.9137,-87.65285
TA1307000166,7,0,true,6,4,-2,41.91386,-87.64877
TA1306000007,7,0,true,5,4,-1,41.91469,-87.64333
13068,7,0,true,5,1,-4,41.91554,-87.68703
13179,7,0,true,4,7,3,41.9157,-87.63461
13133,7,0,true,8,5,-3,41.91598,-87.67733
TA1309000006,7,0,true,8,5,-3,41.91809,-87.64375
13146,7,0,true,7,11,4,41.91831,-87.63629
13059,7,0,true,12,7,-5,41.91845,-87.65222
TA1309000033,7,0,true,2,6,4,41.92158,-87.65381
13193,7,0,true,10,7,-3,41.92182,-87.64412
13191,7,0,true,6,2,-4,41.92217,-87.63891
13084,7,0,true,7,7,0,41.92268,-87.69715
TA1307000001,7,0,true,4,8,4,41.92535,-87.66581
TA1306000026,7,0,true,4,8,4,41.92558,-87.65842
TA1306000016,7,0,true,12,6,-6,41.9256,-87.65371
TA1309000019,7,0,true,5,10,5,41.92586,-87.63897
TA1309000058,7,0,true,8,7,-1,41.92591,-87.64927
TA1309000023,7,0,true,9,6,-3,41.9287,-87.65383
TA1307000113,7,0,true,5,5,0,41.92878,-87.66391
TA1309000059,7,0,true,6,3,-3,41.92889,-87.65898
TA1309000061,7,0,true,11,6,-5,41.92915,-87.64909
TA1305000014,7,0,true,8,5,-3,41.92956,-87.64313
TA1307000142,7,0,true,7,7,0,41.93125,-87.64432
TA1307000064,7,0,true,7,8,1,41.93222,-87.65864
TA1306000014,7,0,true,11,10,-1,41.93242,-87.65271
TA1309000036,7,0,true,2,5,3,41.93313,-87.64776
TA1307000006,7,0,true,5,4,-1,41.93571,-87.6636
TA1307000052,7,0,true,7,7,0,41.93628,-87.65266
TA1307000136,7,0,true,7,8,1,41.9365,-87.64755
TA1307000041,7,0,true,6,3,-3,41.93669,-87.63683
13137,7,0,true,11,7,-4,41.9376,-87.6441
TA1308000019,7,0,true,9,7,-2,41.93973,-87.65886
13277,7,0,true,11,12,1,41.9401,-87.64546
TA1307000134,7,0,true,16,13,-3,41.94016,-87.65303
TA1309000049,7,0,true,5,4,-1,41.94077,-87.63919
TA1309000025,7,0,true,12,9,-3,41.94368,-87.64894
13071,7,0,true,9,7,-2,41.94373,-87.66401
632,7,0,true,13,9,-4,41.94453,-87.6547
13278,7,0,true,12,8,-4,41.94553,-87.64644
13235,7,0,true,7,3,-4,41.94814,-87.66396
13325,7,0,true,17,5,-12,41.94907,-87.64863
TA1307000126,7,0,true,8,4,-4,41.94936,-87.65451
TA1307000127,7,0,true,9,8,-1,41.9508,-87.65918
13323,7,0,true,5,3,-2,41.95282,-87.65
13063,7,0,true,5,8,3,41.95424,-87.65441
TA1308000022,7,0,true,3,5,2,41.95438,-87.64805
13389,7,0,true,3,6,3,41.961,-87.64958
TA1307000048,7,1,false,6,10,4,41.83855,-87.60821
TA1307000005,7,1,false,5,4,-1,41.84569,-87.6225
13162,7,1,false,6,3,-3,41.85378,-87.64659
13164,7,1,false,5,1,-4,41.85818,-87.65648
TA1307000124,7,1,false,2,6,4,41.86411,-87.62372
TA1305000002,7,1,false,13,17,4,41.86721,-87.62597
SL-005,7,1,false,6,4,-2,41.8679,-87.62304
TA1309000010,7,1,false,10,15,5,41.87074,-87.62574
SL-008,7,1,false,8,8,0,41.87209,-87.62956
SL-011,7,1,false,5,13,8,41.87256,-87.63356
623,7,1,false,28,25,-3,41.87272,-87.62399
SL-007,7,1,false,13,18,5,41.87404,-87.6277
15541,7,1,false,20,19,-1,41.8758,-87.62086
13037,7,1,false,5,2,-3,41.87588,-87.64078
TA1305000010,7,1,false,15,22,7,41.87623,-87.62444
624,7,1,false,5,2,-3,41.87626,-87.62923
13158,7,1,false,6,11,5,41.87764,-87.64957
TA1309000002,7,1,false,23,11,-12,41.87784,-87.62408
638,7,1,false,5,5,0,41.87827,-87.64078
KA1503000015,7,1,false,11,15,4,41.87948,-87.6257
13300,7,1,false,9,10,1,41.88097,-87.61675
13008,7,1,false,25,47,22,41.88105,-87.62408
TA1305000006,7,1,false,5,6,1,41.88122,-87.6296
TA1307000120,7,1,false,16,18,2,41.88188,-87.64879
13036,7,1,false,3,5,2,41.8821,-87.62513
TA1305000032,7,1,false,1,8,7,41.88218,-87.64109
13353,7,1,false,5,7,2,41.88283,-87.6612
13053,7,1,false,10,7,-3,41.88365,-87.64863
13001,7,1,false,5,19,14,41.88397,-87.62459
18062,7,1,false,5,4,-1,41.88412,-87.65427
TA1305000029,7,1,false,18,14,-4,41.88466,-87.62787
13263,7,1,false,8,8,0,41.88467,-87.61952
TA1306000015,7,1,false,7,11,4,41.88549,-87.65232
13021,7,1,false,9,3,-6,41.88559,-87.64184
TA1307000111,7,1,false,1,8,7,41.88582,-87.63548
KA1503000012,7,1,false,2,7,5,41.88599,-87.63089
TA1305000011,7,1,false,24,38,14,41.886,-87.62418
TA1308000029,7,1,false,2,9,7,41.88673,-87.62225
TA1307000131,7,1,false,6,15,9,41.88688,-87.62606
TA1305000022,7,1,false,1,5,4,41.88817,-87.63656
TA1306000003,7,1,false,21,21,0,41.88867,-87.64442
KA1503000043,7,1,false,5,9,4,41.88918,-87.63851
13050,7,1,false,15,11,-4,41.88919,-87.62775
TA1307000151,7,1,false,23,17,-6,41.88993,-87.63427
636,7,1,false,10,6,-4,41.88997,-87.63662
KA1503000044,7,1,false,3,10,7,41.89018,-87.6262
13430,7,1,false,24,23,-1,41.89077,-87.63169
TA1306000013,7,1,false,9,26,17,41.89083,-87.61852
RN-,7,1,false,11,4,-7,41.89102,-87.63546
TA1307000117,7,1,false,24,21,-3,41.89144,-87.62675
13033,7,1,false,16,12,-4,41.8916,-87.64835
TA1305000003,7,1,false,12,23,11,41.89187,-87.62061
13022,7,1,false,11,13,2,41.89227,-87.61205
13045,7,1,false,13,14,1,41.89403,-87.62931
13016,7,1,false,18,20,2,41.89431,-87.62277
KA1503000041,7,1,false,4,9,5,41.89452,-87.61798
13196,7,1,false,1,7,6,41.89455,-87.65345
TA1307000062,7,1,false,6,5,-1,41.89466,-87.63839
TA1306000012,7,1,false,15,16,1,41.89475,-87.63438
KP1705001026,7,1,false,7,3,-4,41.89483,-87.6323
637,7,1,false,5,4,-1,41.89563,-87.67209
13132,7,1,false,3,5,2,41.89573,-87.67718
15530,7,1,false,8,10,2,41.89575,-87.62596
18003,7,1,false,5,2,-3,41.89575,-87.62011
13247,7,1,false,11,11,0,41.89597,-87.66775
TA1305000020,7,1,false,8,9,1,41.89636,-87.65406
13289,7,1,false,3,12,9,41.89638,-87.661
13303,7,1,false,14,6,-8,41.89672,-87.63088
13017,7,1,false,10,4,-6,41.89676,-87.6357
13338,7,1,false,2,6,4,41.89697,-87.62173
TA1307000061,7,1,false,4,5,1,41.89745,-87.62873
13034,7,1,false,6,8,2,41.89754,-87.62352
620,7,1,false,7,6,-1,41.89817,-87.63754
KA1504000103,7,1,false,4,7,3,41.89842,-87.68659
15529,7,1,false,14,13,-1,41.89858,-87.62206
TA1307000128,7,1,false,12,11,-1,41.89896,-87.6299
657,7,1,false,5,6,1,41.89918,-87.6722
13042,7,1,false,8,26,18,41.90097,-87.62377
TA1307000070,7,1,false,4,5,1,41.90133,-87.67742
KA1504000133,7,1,false,6,15,9,41.90234,-87.62773
TA1306000006,7,1,false,15,3,-12,41.90292,-87.63772
TA1307000039,7,1,false,11,14,3,41.90294,-87.63137
658,7,1,false,6,6,0,41.903,-87.6838
TA1305000034,7,1,false,4,10,6,41.90313,-87.67391
KA1504000135,7,1,false,20,15,-5,41.90319,-87.63439
13136,7,1,false,8,7,-1,41.90326,-87.67845
13061,7,1,false,21,15,-6,41.90342,-87.66779
TA1307000115,7,1,false,5,8,3,41.9046,-87.64056
TA1308000049,7,1,false,23,13,-10,41.90672,-87.6349
KA1504000134,7,1,false,3,7,4,41.90687,-87.6262
13224,7,1,false,5,4,-1,41.90706,-87.66725
13221,7,1,false,19,16,-3,41.90765,-87.67254
TA1309000024,7,1,false,14,5,-9,41.908,-87.63152
TA1305000041,7,1,false,23,27,4,41.9094,-87.67769
331,7,1,false,13,8,-5,41.90965,-87.64812
TA1305000037,7,1,false,10,9,-1,41.91018,-87.67003
TA1306000008,7,1,false,10,5,-5,41.9102,-87.6435
TA1308000005,7,1,false,4,7,3,41.91042,-87.68238
13258,7,1,false,3,6,3,41.91043,-87.69718
13257,7,1,false,3,14,11,41.91054,-87.68956
13154,7,1,false,8,5,-3,41.91054,-87.65312
13058,7,1,false,8,10,2,41.91059,-87.64942
TA1307000038,7,1,false,16,6,-10,41.91138,-87.63868
LF-005,7,1,false,5,14,9,41.91172,-87.62681
13128,7,1,false,7,7,0,41.91197,-87.63197
TA1308000050,7,1,false,15,12,-3,41.91211,-87.6347
13243,7,1,false,10,16,6,41.91262,-87.6814
TA1306000032,7,1,false,8,7,-1,41.9137,-87.65285
TA1307000166,7,1,false,6,4,-2,41.91386,-87.64877
TA1306000007,7,1,false,2,8,6,41.91469,-87.64333
13068,7,1,false,3,10,7,41.91554,-87.68703
13179,7,1,false,24,19,-5,41.9157,-87.63461
13133,7,1,false,9,9,0,41.91598,-87.67733
13266,7,1,false,7,3,-4,41.91774,-87.69142
TA1309000006,7,1,false,4,9,5,41.91809,-87.64375
13146,7,1,false,30,14,-16,41.91831,-87.63629
13059,7,1,false,10,13,3,41.91845,-87.65222
13259,7,1,false,4,6,2,41.91852,-87.69744
13192,7,1,false,25,13,-12,41.91995,-87.64884
13288,7,1,false,6,10,4,41.92008,-87.67788
TA1309000033,7,1,false,18,10,-8,41.92158,-87.65381
13193,7,1,false,22,19,-3,41.92182,-87.64412
13191,7,1,false,5,6,1,41.92217,-87.63891
13084,7,1,false,13,2,-11,41.92268,-87.69715
LP-,7,1,false,1,18,17,41.92396,-87.63584
15648,7,1,false,6,5,-1,41.92464,-87.68931
TA1307000001,7,1,false,5,12,7,41.92535,-87.66581
TA1306000026,7,1,false,11,5,-6,41.92558,-87.65842
TA1306000016,7,1,false,12,4,-8,41.9256,-87.65371
TA1309000019,7,1,false,16,11,-5,41.92586,-87.63897
TA1309000058,7,1,false,24,19,-5,41.92591,-87.64927
15646,7,1,false,1,8,7,41.92668,-87.6977
TA1309000023,7,1,false,25,9,-16,41.9287,-87.65383
TA1307000113,7,1,false,7,13,6,41.92878,-87.66391
TA1309000061,7,1,false,30,7,-23,41.92915,-87.64909
TA1305000014,7,1,false,10,11,1,41.92956,-87.64313
13085,7,1,false,6,6,0,41.92958,-87.70789
TA1307000142,7,1,false,11,12,1,41.93125,-87.64432
13276,7,1,false,9,9,0,41.93132,-87.63874
TA1307000064,7,1,false,15,9,-6,41.93222,-87.65864
TA1306000014,7,1,false,16,9,-7,41.93242,-87.65271
TA1309000039,7,1,false,7,18,11,41.93258,-87.63642
TA1309000036,7,1,false,8,3,-5,41.93313,-87.64776
TA1307000006,7,1,false,12,15,3,41.93571,-87.6636
13268,7,1,false,5,3,-2,41.93588,-87.67843
TA1307000052,7,1,false,10,15,5,41.93628,-87.65266
TA1307000136,7,1,false,17,15,-2,41.9365,-87.64755
13137,7,1,false,7,14,7,41.9376,-87.6441
KA17018068,7,1,false,3,5,2,41.93935,-87.68327
TA1309000042,7,1,false,7,5,-2,41.93937,-87.66836
13229,7,1,false,9,2,-7,41.93946,-87.66376
TA1308000019,7,1,false,7,8,1,41.93973,-87.65886
13277,7,1,false,3,10,7,41.9401,-87.64546
TA1307000134,7,1,false,20,11,-9,41.94016,-87.65303
TA1309000049,7,1,false,3,12,9,41.94077,-87.63919
TA1309000025,7,1,false,23,18,-5,41.94368,-87.64894
13071,7,1,false,12,13,1,41.94373,-87.66401
632,7,1,false,26,27,1,41.94453,-87.6547
13278,7,1,false,14,7,-7,41.94553,-87.64644
TA1309000050,7,1,false,1,8,7,41.94618,-87.67331
13235,7,1,false,7,11,4,41.94814,-87.66396
13325,7,1,false,14,16,2,41.94907,-87.64863
TA1307000126,7,1,false,16,12,-4,41.94936,-87.65451
TA1307000150,7,1,false,5,9,4,41.94945,-87.64646
TA1307000127,7,1,false,10,15,5,41.9508,-87.65918
13323,7,1,false,6,7,1,41.95282,-87.65
13063,7,1,false,6,11,5,41.95424,-87.65441
TA1308000022,7,1,false,6,11,5,41.95438,-87.64805
TA1309000027,7,1,false,3,12,9,41.9585,-87.65499
TA1307000107,7,1,false,5,7,2,41.96164,-87.65464
TA1309000041,7,1,false,1,6,5,41.96951,-87.65471
TA1309000035,7,1,false,3,8,5,41.97335,-87.66785
13109,7,1,false,2,7,5,41.97835,-87.65976
13332,7,1,true,4,5,1,41.87219,-87.6615
13158,7,1,true,4,5,1,41.87764,-87.64957
TA1307000120,7,1,true,13,4,-9,41.88188,-87.64879
TA1305000032,7,1,true,2,7,5,41.88218,-87.64109
13053,7,1,true,3,5,2,41.88365,-87.64863
15535,7,1,true,9,5,-4,41.8846,-87.64455
13021,7,1,true,6,2,-4,41.88559,-87.64184
TA1307000111,7,1,true,1,6,5,41.88582,-87.63548
TA1305000022,7,1,true,2,5,3,41.88817,-87.63656
TA1306000003,7,1,true,8,4,-4,41.88867,-87.64442
KA1503000043,7,1,true,7,2,-5,41.88918,-87.63851
13050,7,1,true,2,8,6,41.88919,-87.62775
TA1307000151,7,1,true,12,2,-10,41.88993,-87.63427
636,7,1,true,2,5,3,41.88997,-87.63662
13430,7,1,true,16,4,-12,41.89077,-87.63169
TA1306000013,7,1,true,1,6,5,41.89083,-87.61852
RN-,7,1,true,3,6,3,41.89102,-87.63546
TA1307000117,7,1,true,8,4,-4,41.89144,-87.62675
13033,7,1,true,5,3,-2,41.8916,-87.64835
13265,7,1,true,2,5,3,41.89383,-87.64172
13045,7,1,true,7,10,3,41.89403,-87.62931
13016,7,1,true,2,5,3,41.89431,-87.62277
TA1306000012,7,1,true,6,7,1,41.89475,-87.63438
KP1705001026,7,1,true,10,4,-6,41.89483,-87.6323
15530,7,1,true,7,3,-4,41.89575,-87.62596
13289,7,1,true,1,5,4,41.89638,-87.661
13303,7,1,true,7,6,-1,41.89672,-87.63088
TA1307000128,7,1,true,4,10,6,41.89896,-87.6299
13248,7,1,true,2,5,3,41.89964,-87.66788
KA1504000116,7,1,true,1,7,6,41.90023,-87.64299
13290,7,1,true,2,5,3,41.90069,-87.66259
TA1307000070,7,1,true,5,4,-1,41.90133,-87.67742
KA1504000133,7,1,true,14,4,-10,41.90234,-87.62773
TA1307000039,7,1,true,25,12,-13,41.90294,-87.63137
KA1504000135,7,1,true,11,7,-4,41.90319,-87.63439
13061,7,1,true,5,8,3,41.90342,-87.66779
TA1308000049,7,1,true,5,7,2,41.90672,-87.6349
13224,7,1,true,1,5,4,41.90706,-87.66725
13221,7,1,true,2,7,5,41.90765,-87.67254
TA1309000024,7,1,true,7,6,-1,41.908,-87.63152
TA1305000041,7,1,true,6,5,-1,41.9094,-87.67769
331,7,1,true,5,4,-1,41.90965,-87.64812
TA1305000037,7,1,true,7,3,-4,41.91018,-87.67003
13154,7,1,true,2,6,4,41.91054,-87.65312
13058,7,1,true,3,5,2,41.91059,-87.64942
TA1308000050,7,1,true,11,13,2,41.91211,-87.6347
13243,7,1,true,1,6,5,41.91262,-87.6814
13179,7,1,true,11,8,-3,41.9157,-87.63461
TA1309000006,7,1,true,5,2,-3,41.91809,-87.64375
13146,7,1,true,5,11,6,41.91831,-87.63629
TA1309000033,7,1,true,6,6,0,41.92158,-87.65381
13193,7,1,true,7,14,7,41.92182,-87.64412
13191,7,1,true,3,5,2,41.92217,-87.63891
TA1307000001,7,1,true,7,6,-1,41.92535,-87.66581
TA1309000019,7,1,true,3,9,6,41.92586,-87.63897
TA1309000023,7,1,true,10,5,-5,41.9287,-87.65383
TA1309000059,7,1,true,1,5,4,41.92889,-87.65898
TA1309000061,7,1,true,10,8,-2,41.92915,-87.64909
TA1305000014,7,1,true,5,7,2,41.92956,-87.64313
TA1307000142,7,1,true,4,7,3,41.93125,-87.64432
TA1307000064,7,1,true,10,2,-8,41.93222,-87.65864
TA1309000036,7,1,true,7,2,-5,41.93313,-87.64776
TA1307000006,7,1,true,6,5,-1,41.93571,-87.6636
TA1307000052,7,1,true,11,8,-3,41.93628,-87.65266
TA1307000136,7,1,true,8,9,1,41.9365,-87.64755
TA1307000134,7,1,true,6,8,2,41.94016,-87.65303
TA1309000025,7,1,true,8,11,3,41.94368,-87.64894
632,7,1,true,13,4,-9,41.94453,-87.6547
13278,7,1,true,7,6,-1,41.94553,-87.64644
13235,7,1,true,1,5,4,41.94814,-87.66396
13325,7,1,true,20,5,-15,41.94907,-87.64863
TA1307000126,7,1,true,8,3,-5,41.94936,-87.65451
TA1307000127,7,1,true,5,2,-3,41.9508,-87.65918
13323,7,1,true,6,3,-3,41.95282,-87.65
13063,7,1,true,5,4,-1,41.95424,-87.65441
KA1503000022,7,1,true,2,5,3,41.96158,-87.66609
TA1307000107,7,1,true,1,8,7,41.96164,-87.65464
TA1309000014,7,1,true,4,6,2,41.96709,-87.66744
KA1503000007,7,2,false,1,6,5,41.80242,-87.58689
TA1309000053,7,2,false,1,5,4,41.80985,-87.60675
SL-006,7,2,false,6,1,-5,41.8568,-87.63387
13150,7,2,false,1,6,5,41.85783,-87.62455
TA1307000124,7,2,false,1,7,6,41.86411,-87.62372
KA1504000101,7,2,false,5,1,-4,41.86651,-87.68466
TA1305000002,7,2,false,11,6,-5,41.86721,-87.62597
KA1706005007,7,2,false,1,5,4,41.86749,-87.63219
SL-005,7,2,false,2,7,5,41.8679,-87.62304
623,7,2,false,12,22,10,41.87272,-87.62399
SL-007,7,2,false,1,18,17,41.87404,-87.6277
13326,7,2,false,3,5,2,41.87425,-87.63958
15541,7,2,false,9,1,-8,41.8758,-87.62086
TA1305000010,7,2,false,18,15,-3,41.87623,-87.62444
TA1305000035,7,2,false,1,9,8,41.87716,-87.62787
KA1503000015,7,2,false,4,21,17,41.87948,-87.6257
WL-011,7,2,false,4,13,9,41.88034,-87.64273
13300,7,2,false,6,4,-2,41.88097,-87.61675
13008,7,2,false,25,42,17,41.88105,-87.62408
TA1307000120,7,2,false,9,6,-3,41.88188,-87.64879
13036,7,2,false,8,10,2,41.8821,-87.62513
TA1305000032,7,2,false,1,7,6,41.88218,-87.64109
13006,7,2,false,8,8,0,41.88268,-87.63252
13409,7,2,false,3,5,2,41.8831,-87.6511
WL-012,7,2,false,2,7,5,41.88337,-87.6412
13053,7,2,false,7,9,2,41.88365,-87.64863
13001,7,2,false,11,8,-3,41.88397,-87.62459
18062,7,2,false,14,1,-13,41.88412,-87.65427
15535,7,2,false,2,7,5,41.8846,-87.64455
13263,7,2,false,6,2,-4,41.88467,-87.61952
TA1306000015,7,2,false,12,5,-7,41.88549,-87.65232
13021,7,2,false,9,7,-2,41.88559,-87.64184
TA1307000111,7,2,false,11,5,-6,41.88582,-87.63548
KA1503000012,7,2,false,6,1,-5,41.88599,-87.63089
TA1305000011,7,2,false,21,23,2,41.886,-87.62418
TA1307000131,7,2,false,4,18,14,41.88688,-87.62606
TA1305000022,7,2,false,5,2,-3,41.88817,-87.63656
TA1306000003,7,2,false,9,8,-1,41.88867,-87.64442
KA1503000043,7,2,false,7,7,0,41.88918,-87.63851
13050,7,2,false,17,11,-6,41.88919,-87.62775
TA1307000151,7,2,false,24,11,-13,41.88993,-87.63427
13430,7,2,false,7,5,-2,41.89077,-87.63169
TA1306000013,7,2,false,1,6,5,41.89083,-87.61852
RN-,7,2,false,7,10,3,41.89102,-87.63546
TA1307000117,7,2,false,15,19,4,41.89144,-87.62675
13033,7,2,false,11,6,-5,41.8916,-87.64835
TA1305000003,7,2,false,18,27,9,41.89187,-87.62061
13022,7,2,false,5,10,5,41.89227,-87.61205
TA1306000029,7,2,false,8,9,1,41.89256,-87.61449
13045,7,2,false,12,8,-4,41.89403,-87.62931
13016,7,2,false,7,8,1,41.89431,-87.62277
TA1306000012,7,2,false,6,15,9,41.89475,-87.63438
KP1705001026,7,2,false,7,6,-1,41.89483,-87.6323
637,7,2,false,5,9,4,41.89563,-87.67209
15530,7,2,false,1,7,6,41.89575,-87.62596
13247,7,2,false,2,5,3,41.89597,-87.66775
TA1305000020,7,2,false,5,5,0,41.89636,-87.65406
13289,7,2,false,3,7,4,41.89638,-87.661
13303,7,2,false,17,8,-9,41.89672,-87.63088
13017,7,2,false,5,5,0,41.89676,-87.6357
TA1307000061,7,2,false,14,14,0,41.89745,-87.62873
13034,7,2,false,3,8,5,41.89754,-87.62352
TA1306000009,7,2,false,4,6,2,41.89772,-87.64299
620,7,2,false,10,10,0,41.89817,-87.63754
15529,7,2,false,4,12,8,41.89858,-87.62206
TA1307000128,7,2,false,12,15,3,41.89896,-87.6299
13042,7,2,false,11,2,-9,41.90097,-87.62377
TA1307000070,7,2,false,8,5,-3,41.90133,-87.67742
KA1504000133,7,2,false,10,5,-5,41.90234,-87.62773
13241,7,2,false,1,8,7,41.9029,-87.68731
TA1306000006,7,2,false,5,6,1,41.90292,-87.63772
TA1307000039,7,2,false,26,18,-8,41.90294,-87.63137
KA1504000135,7,2,false,14,16,2,41.90319,-87.63439
13136,7,2,false,10,8,-2,41.90326,-87.67845
13061,7,2,false,13,21,8,41.90342,-87.66779
KA1504000079,7,2,false,5,2,-3,41.9035,-87.64334
TA1307000115,7,2,false,8,2,-6,41.9046,-87.64056
TA1308000049,7,2,false,5,6,1,41.90672,-87.6349
KA1504000134,7,2,false,11,6,-5,41.90687,-87.6262
13224,7,2,false,9,5,-4,41.90706,-87.66725
13221,7,2,false,27,13,-14,41.90765,-87.67254
13245,7,2,false,2,6,4,41.90777,-87.68586
TA1309000024,7,2,false,15,15,0,41.908,-87.63152
TA1305000041,7,2,false,13,8,-5,41.9094,-87.67769
331,7,2,false,6,1,-5,41.90965,-87.64812
TA1305000037,7,2,false,5,7,2,41.91018,-87.67003
TA1306000008,7,2,false,9,3,-6,41.9102,-87.6435
13257,7,2,false,2,8,6,41.91054,-87.68956
13058,7,2,false,13,5,-8,41.91059,-87.64942
TA1307000038,7,2,false,12,14,2,41.91138,-87.63868
LF-005,7,2,false,5,5,0,41.91172,-87.62681
13128,7,2,false,10,10,0,41.91197,-87.63197
TA1308000050,7,2,false,16,19,3,41.91211,-87.6347
13243,7,2,false,7,2,-5,41.91262,-87.6814
TA1307000166,7,2,false,5,3,-2,41.91386,-87.64877
18067,7,2,false,6,1,-5,41.9146,-87.66796
13068,7,2,false,6,3,-3,41.91554,-87.68703
13179,7,2,false,10,11,1,41.9157,-87.63461
13133,7,2,false,6,8,2,41.91598,-87.67733
TA1309000006,7,2,false,6,4,-2,41.91809,-87.64375
13146,7,2,false,13,19,6,41.91831,-87.63629
13059,7,2,false,15,9,-6,41.91845,-87.65222
13192,7,2,false,16,8,-8,41.91995,-87.64884
13288,7,2,false,5,6,1,41.92008,-87.67788
TA1309000030,7,2,false,2,8,6,41.92077,-87.66372
TA1309000033,7,2,false,8,6,-2,41.92158,-87.65381
13193,7,2,false,23,16,-7,41.92182,-87.64412
13084,7,2,false,5,6,1,41.92268,-87.69715
KA1504000090,7,2,false,1,6,5,41.92483,-87.7145
TA1306000026,7,2,false,3,6,3,41.92558,-87.65842
TA1306000016,7,2,false,10,6,-4,41.9256,-87.65371
TA1309000019,7,2,false,8,10,2,41.92586,-87.63897
TA1309000058,7,2,false,13,9,-4,41.92591,-87.64927
TA1309000023,7,2,false,10,6,-4,41.9287,-87.65383
TA1307000113,7,2,false,5,19,14,41.92878,-87.66391
13296,7,2,false,4,5,1,41.92883,-87.66852
TA1309000059,7,2,false,3,8,5,41.92889,-87.65898
TA1309000061,7,2,false,18,5,-13,41.92915,-87.64909
TA1305000014,7,2,false,7,14,7,41.92956,-87.64313
13085,7,2,false,10,6,-4,41.92958,-87.70789
TA1307000142,7,2,false,13,14,1,41.93125,-87.64432
TA1307000064,7,2,false,5,13,8,41.93222,-87.65864
TA1306000014,7,2,false,20,7,-13,41.93242,-87.65271
TA1309000039,7,2,false,7,7,0,41.93258,-87.63642
13294,7,2,false,2,7,5,41.9326,-87.66595
TA1309000036,7,2,false,13,1,-12,41.93313,-87.64776
TA1307000006,7,2,false,7,11,4,41.93571,-87.6636
TA1307000052,7,2,false,15,8,-7,41.93628,-87.65266
TA1307000136,7,2,false,19,15,-4,41.9365,-87.64755
13137,7,2,false,7,5,-2,41.9376,-87.6441
15642,7,2,false,1,7,6,41.93843,-87.69801
13229,7,2,false,4,5,1,41.93946,-87.66376
TA1308000019,7,2,false,11,10,-1,41.93973,-87.65886
13277,7,2,false,10,5,-5,41.9401,-87.64546
TA1307000134,7,2,false,11,21,10,41.94016,-87.65303
TA1309000049,7,2,false,2,5,3,41.94077,-87.63919
TA1307000138,7,2,false,5,8,3,41.94334,-87.67094
TA1309000025,7,2,false,15,8,-7,41.94368,-87.64894
13071,7,2,false,16,6,-10,41.94373,-87.66401
632,7,2,false,15,9,-6,41.94453,-87.6547
13278,7,2,false,22,9,-13,41.94553,-87.64644
13235,7,2,false,6,1,-5,41.94814,-87.66396
13325,7,2,false,14,4,-10,41.94907,-87.64863
TA1307000126,7,2,false,13,8,-5,41.94936,-87.65451
TA1307000150,7,2,false,14,3,-11,41.94945,-87.64646
TA1307000127,7,2,false,18,4,-14,41.9508,-87.65918
13323,7,2,false,13,8,-5,41.95282,-87.65
13063,7,2,false,12,5,-7,41.95424,-87.65441
KA1504000171,7,2,false,4,5,1,41.97161,-87.65016
TA1309000035,7,2,false,1,6,5,41.97335,-87.66785
15578,7,2,false,4,5,1,41.98405,-87.66027
KA1503000043,7,2,true,6,6,0,41.88918,-87.63851
TA1307000151,7,2,true,13,13,0,41.88993,-87.63427
13430,7,2,true,7,2,-5,41.89077,-87.63169
RN-,7,2,true,12,6,-6,41.89102,-87.63546
13033,7,2,true,1,10,9,41.8916,-87.64835
TA1305000003,7,2,true,3,7,4,41.89187,-87.62061
13045,7,2,true,10,4,-6,41.89403,-87.62931
TA1306000012,7,2,true,6,6,0,41.89475,-87.63438
TA1305000020,7,2,true,1,5,4,41.89636,-87.65406
620,7,2,true,5,2,-3,41.89817,-87.63754
TA1307000039,7,2,true,18,11,-7,41.90294,-87.63137
KA1504000135,7,2,true,8,6,-2,41.90319,-87.63439
13136,7,2,true,6,3,-3,41.90326,-87.67845
TA1308000049,7,2,true,5,4,-1,41.90672,-87.6349
KA1504000134,7,2,true,1,5,4,41.90687,-87.6262
TA1309000024,7,2,true,7,8,1,41.908,-87.63152
TA1305000041,7,2,true,7,1,-6,41.9094,-87.67769
TA1305000037,7,2,true,5,5,0,41.91018,-87.67003
13058,7,2,true,5,3,-2,41.91059,-87.64942
TA1307000038,7,2,true,4,5,1,41.91138,-87.63868
13128,7,2,true,7,3,-4,41.91197,-87.63197
TA1308000050,7,2,true,2,10,8,41.91211,-87.6347
13179,7,2,true,7,4,-3,41.9157,-87.63461
13133,7,2,true,9,3,-6,41.91598,-87.67733
13146,7,2,true,8,5,-3,41.91831,-87.63629
TA1309000058,7,2,true,5,3,-2,41.92591,-87.64927
TA1309000023,7,2,true,5,3,-2,41.9287,-87.65383
TA1307000113,7,2,true,3,9,6,41.92878,-87.66391
TA1309000061,7,2,true,3,7,4,41.92915,-87.64909
TA1305000014,7,2,true,5,7,2,41.92956,-87.64313
TA1307000142,7,2,true,3,6,3,41.93125,-87.64432
TA1307000064,7,2,true,6,8,2,41.93222,-87.65864
TA1307000136,7,2,true,5,2,-3,41.9365,-87.64755
13277,7,2,true,9,3,-6,41.9401,-87.64546
TA1309000025,7,2,true,2,5,3,41.94368,-87.64894
13278,7,2,true,6,4,-2,41.94553,-87.64644
13325,7,2,true,12,7,-5,41.94907,-87.64863
13323,7,2,true,5,4,-1,41.95282,-87.65
TA1307000119,7,2,true,1,5,4,41.96796,-87.65
TA1309000053,7,3,false,2,9,7,41.80985,-87.60675
13150,7,3,false,1,7,6,41.85783,-87.62455
TA1305000002,7,3,false,4,10,6,41.86721,-87.62597
SL-005,7,3,false,5,6,1,41.8679,-87.62304
TA1309000010,7,3,false,4,5,1,41.87074,-87.62574
SL-008,7,3,false,7,4,-3,41.87209,-87.62956
623,7,3,false,7,29,22,41.87272,-87.62399
SL-007,7,3,false,4,12,8,41.87404,-87.6277
TA1305000010,7,3,false,6,12,6,41.87623,-87.62444
KA1503000015,7,3,false,5,18,13,41.87948,-87.6257
13008,7,3,false,8,15,7,41.88105,-87.62408
TA1307000120,7,3,false,1,5,4,41.88188,-87.64879
13353,7,3,false,1,5,4,41.88283,-87.6612
13053,7,3,false,5,5,0,41.88365,-87.64863
13001,7,3,false,11,10,-1,41.88397,-87.62459
TA1305000030,7,3,false,2,5,3,41.88459,-87.63178
15535,7,3,false,6,3,-3,41.8846,-87.64455
13263,7,3,false,3,9,6,41.88467,-87.61952
13021,7,3,false,5,4,-1,41.88559,-87.64184
TA1307000111,7,3,false,6,2,-4,41.88582,-87.63548
KA1503000012,7,3,false,2,6,4,41.88599,-87.63089
TA1305000011,7,3,false,12,7,-5,41.886,-87.62418
TA1307000131,7,3,false,12,9,-3,41.88688,-87.62606
TA1307000151,7,3,false,3,5,2,41.88993,-87.63427
636,7,3,false,5,2,-3,41.88997,-87.63662
RN-,7,3,false,6,1,-5,41.89102,-87.63546
TA1307000117,7,3,false,7,13,6,41.89144,-87.62675
TA1305000003,7,3,false,3,6,3,41.89187,-87.62061
13022,7,3,false,4,6,2,41.89227,-87.61205
13045,7,3,false,5,9,4,41.89403,-87.62931
KA1503000041,7,3,false,2,5,3,41.89452,-87.61798
TA1306000012,7,3,false,5,9,4,41.89475,-87.63438
13132,7,3,false,1,12,11,41.89573,-87.67718
13303,7,3,false,14,15,1,41.89672,-87.63088
13017,7,3,false,6,3,-3,41.89676,-87.6357
15529,7,3,false,2,9,7,41.89858,-87.62206
TA1307000128,7,3,false,13,3,-10,41.89896,-87.6299
13042,7,3,false,1,7,6,41.90097,-87.62377
KA1504000133,7,3,false,1,6,5,41.90234,-87.62773
15654,7,3,false,2,6,4,41.90271,-87.70923
TA1307000039,7,3,false,17,12,-5,41.90294,-87.63137
KA1504000135,7,3,false,8,11,3,41.90319,-87.63439
13136,7,3,false,5,3,-2,41.90326,-87.67845
13061,7,3,false,8,11,3,41.90342,-87.66779
KA1504000079,7,3,false,3,6,3,41.9035,-87.64334
TA1308000049,7,3,false,6,3,-3,41.90672,-87.6349
13221,7,3,false,9,12,3,41.90765,-87.67254
TA1309000024,7,3,false,7,7,0,41.908,-87.63152
TA1305000041,7,3,false,9,10,1,41.9094,-87.67769
TA1308000005,7,3,false,5,1,-4,41.91042,-87.68238
13258,7,3,false,2,5,3,41.91043,-87.69718
TA1307000038,7,3,false,6,3,-3,41.91138,-87.63868
LF-005,7,3,false,10,1,-9,41.91172,-87.62681
TA1308000050,7,3,false,13,7,-6,41.91211,-87.6347
13243,7,3,false,3,5,2,41.91262,-87.6814
13133,7,3,false,3,5,2,41.91598,-87.67733
TA1309000006,7,3,false,5,5,0,41.91809,-87.64375
TA1307000163,7,3,false,2,5,3,41.91821,-87.65696
13146,7,3,false,9,6,-3,41.91831,-87.63629
13059,7,3,false,2,5,3,41.91845,-87.65222
13192,7,3,false,8,7,-1,41.91995,-87.64884
TA1309000033,7,3,false,3,7,4,41.92158,-87.65381
13193,7,3,false,6,1,-5,41.92182,-87.64412
13084,7,3,false,5,4,-1,41.92268,-87.69715
15648,7,3,false,2,5,3,41.92464,-87.68931
TA1307000001,7,3,false,6,1,-5,41.92535,-87.66581
TA1309000019,7,3,false,5,9,4,41.92586,-87.63897
TA1309000058,7,3,false,5,7,2,41.92591,-87.64927
TA1309000023,7,3,false,8,9,1,41.9287,-87.65383
TA1307000113,7,3,false,6,3,-3,41.92878,-87.66391
13296,7,3,false,5,3,-2,41.92883,-87.66852
TA1309000061,7,3,false,7,7,0,41.92915,-87.64909
TA1305000014,7,3,false,4,8,4,41.92956,-87.64313
13085,7,3,false,1,5,4,41.92958,-87.70789
TA1307000142,7,3,false,8,4,-4,41.93125,-87.64432
13276,7,3,false,12,6,-6,41.93132,-87.63874
TA1307000064,7,3,false,9,5,-4,41.93222,-87.65864
TA1306000014,7,3,false,12,7,-5,41.93242,-87.65271
TA1309000039,7,3,false,5,5,0,41.93258,-87.63642
TA1307000006,7,3,false,6,13,7,41.93571,-87.6636
TA1307000052,7,3,false,5,4,-1,41.93628,-87.65266
13137,7,3,false,12,5,-7,41.9376,-87.6441
TA1309000042,7,3,false,5,2,-3,41.93937,-87.66836
13229,7,3,false,1,5,4,41.93946,-87.66376
13277,7,3,false,7,2,-5,41.9401,-87.64546
TA1307000134,7,3,false,10,10,0,41.94016,-87.65303
TA1309000049,7,3,false,7,3,-4,41.94077,-87.63919
TA1309000025,7,3,false,4,7,3,41.94368,-87.64894
632,7,3,false,4,7,3,41.94453,-87.6547
13278,7,3,false,12,6,-6,41.94553,-87.64644
13325,7,3,false,11,20,9,41.94907,-87.64863
TA1307000150,7,3,false,13,8,-5,41.94945,-87.64646
TA1307000127,7,3,false,11,7,-4,41.9508,-87.65918
13323,7,3,false,7,5,-2,41.95282,-87.65
13063,7,3,false,2,11,9,41.95424,-87.65441
TA1307000149,7,3,false,5,7,2,41.95467,-87.67392
KA1504000146,7,3,false,2,5,3,41.978,-87.66805
TA1307000117,7,3,true,3,5,2,41.89144,-87.62675
13022,7,3,true,5,1,-4,41.89227,-87.61205
13045,7,3,true,5,3,-2,41.89403,-87.62931
TA1307000061,7,3,true,4,5,1,41.89745,-87.62873
TA1307000039,7,3,true,7,6,-1,41.90294,-87.63137
13221,7,3,true,1,5,4,41.90765,-87.67254
TA1308000050,7,3,true,3,6,3,41.91211,-87.6347
13179,7,3,true,1,6,5,41.9157,-87.63461
13146,7,3,true,3,5,2,41.91831,-87.63629
TA1307000142,7,3,true,4,5,1,41.93125,-87.64432
TA1307000052,7,3,true,7,1,-6,41.93628,-87.65266
TA1308000019,7,3,true,4,5,1,41.93973,-87.65886
TA1307000134,7,3,true,3,5,2,41.94016,-87.65303
TA1309000025,7,3,true,5,4,-1,41.94368,-87.64894
632,7,3,true,4,5,1,41.94453,-87.6547
TA1307000126,7,3,true,5,1,-4,41.94936,-87.65451
TA1307000107,7,3,true,1,5,4,41.96164,-87.65464
15546,7,4,false,7,1,-6,41.85416,-87.61916
SL-005,7,4,false,4,6,2,41.8679,-87.62304
TA1309000010,7,4,false,7,7,0,41.87074,-87.62574
SL-008,7,4,false,1,5,4,41.87209,-87.62956
TA1305000005,7,4,false,5,1,-4,41.87924,-87.62975
13008,7,4,false,10,3,-7,41.88105,-87.62408
TA1306000010,7,4,false,3,6,3,41.88419,-87.62961
TA1306000015,7,4,false,1,6,5,41.88549,-87.65232
TA1305000011,7,4,false,3,8,5,41.886,-87.62418
TA1308000029,7,4,false,3,8,5,41.88673,-87.62225
TA1307000131,7,4,false,1,8,7,41.88688,-87.62606
13430,7,4,false,5,4,-1,41.89077,-87.63169
TA1307000117,7,4,false,4,5,1,41.89144,-87.62675
TA1306000029,7,4,false,2,7,5,41.89256,-87.61449
13045,7,4,false,2,5,3,41.89403,-87.62931
TA1306000012,7,4,false,6,1,-5,41.89475,-87.63438
15530,7,4,false,2,5,3,41.89575,-87.62596
18003,7,4,false,3,11,8,41.89575,-87.62011
13017,7,4,false,6,6,0,41.89676,-87.6357
TA1307000128,7,4,false,4,6,2,41.89896,-87.6299
TA1307000039,7,4,false,8,5,-3,41.90294,-87.63137
KA1504000135,7,4,false,4,5,1,41.90319,-87.63439
KA1504000134,7,4,false,5,2,-3,41.90687,-87.6262
TA1305000041,7,4,false,11,11,0,41.9094,-87.67769
TA1308000050,7,4,false,2,5,3,41.91211,-87.6347
TA1309000029,7,4,false,1,6,5,41.9178,-87.68245
TA1309000058,7,4,false,2,5,3,41.92591,-87.64927
TA1309000023,7,4,false,6,1,-5,41.9287,-87.65383
13085,7,4,false,6,1,-5,41.92958,-87.70789
TA1306000014,7,4,false,1,7,6,41.93242,-87.65271
TA1309000036,7,4,false,5,3,-2,41.93313,-87.64776
13277,7,4,false,5,4,-1,41.9401,-87.64546
TA1307000134,7,4,false,7,3,-4,41.94016,-87.65303
TA1309000025,7,4,false,2,7,5,41.94368,-87.64894
13071,7,4,false,2,7,5,41.94373,-87.66401
632,7,4,false,4,5,1,41.94453,-87.6547
13278,7,4,false,9,3,-6,41.94553,-87.64644
13325,7,4,false,8,3,-5,41.94907,-87.64863
TA1307000126,7,4,false,8,3,-5,41.94936,-87.65451
TA1307000150,7,4,false,9,3,-6,41.94945,-87.64646
13323,7,4,false,5,1,-4,41.95282,-87.65
13063,7,4,false,5,2,-3,41.95424,-87.65441
TA1309000035,7,4,false,5,5,0,41.97335,-87.66785
TA1307000039,7,4,true,6,2,-4,41.90294,-87.63137
13137,7,4,true,1,5,4,41.9376,-87.6441
13325,7,4,true,4,7,3,41.94907,-87.64863
13323,7,4,true,6,2,-4,41.95282,-87.65
TA1305000010,7,5,false,2,6,4,41.87623,-87.62444
13008,7,5,false,5,3,-2,41.88105,-87.62408
TA1307000117,7,5,false,3,10,7,41.89144,-87.62675
13022,7,5,false,3,6,3,41.89227,-87.61205
13042,7,5,false,5,2,-3,41.90097,-87.62377
KA1504000135,7,5,false,5,1,-4,41.90319,-87.63439
TA1308000050,7,5,false,7,1,-6,41.91211,-87.6347
TA1307000126,7,5,false,8,4,-4,41.94936,-87.65451
TA1308000009,7,6,false,6,2,-4,41.79522,-87.58075
623,7,6,false,9,3,-6,41.87272,-87.62399
TA1307000117,7,6,false,2,7,5,41.89144,-87.62675
13022,7,6,false,7,9,2,41.89227,-87.61205
13265,7,6,false,12,2,-10,41.89383,-87.64172
13016,7,6,false,2,11,9,41.89431,-87.62277
LF-005,7,6,false,5,1,-4,41.91172,-87.62681
13179,7,6,false,1,6,5,41.9157,-87.63461
LP-,7,6,false,6,1,-5,41.92396,-87.63584
TA1308000012,7,6,false,1,5,4,41.96398,-87.63818
TA1307000048,7,6,true,5,4,-1,41.83855,-87.60821
15545,7,6,true,5,5,0,41.85627,-87.61334
SL-005,7,6,true,6,3,-3,41.8679,-87.62304
KA1503000072,7,6,true,8,9,1,41.88317,-87.63693
TA1305000022,7,6,true,9,9,0,41.88817,-87.63656
13338,7,6,true,7,18,11,41.89697,-87.62173
KA1504000135,7,6,true,5,3,-2,41.90319,-87.63439
TA1308000009,7,7,false,4,5,1,41.79522,-87.58075
TA1307000124,7,7,false,5,2,-3,41.86411,-87.62372
TA1305000002,7,7,false,6,1,-5,41.86721,-87.62597
SL-005,7,7,false,7,3,-4,41.8679,-87.62304
623,7,7,false,14,8,-6,41.87272,-87.62399
KA1504000104,7,7,false,7,1,-6,41.87296,-87.66912
TA1309000007,7,7,false,6,1,-5,41.88022,-87.63526
13300,7,7,false,7,10,3,41.88097,-87.61675
13008,7,7,false,5,6,1,41.88105,-87.62408
TA1307000131,7,7,false,5,2,-3,41.88688,-87.62606
TA1306000013,7,7,false,5,2,-3,41.89083,-87.61852
TA1305000003,7,7,false,5,2,-3,41.89187,-87.62061
13022,7,7,false,12,10,-2,41.89227,-87.61205
13265,7,7,false,5,2,-3,41.89383,-87.64172
13016,7,7,false,12,3,-9,41.89431,-87.62277
KA1503000041,7,7,false,5,3,-2,41.89452,-87.61798
13338,7,7,false,9,2,-7,41.89697,-87.62173
13042,7,7,false,15,5,-10,41.90097,-87.62377
TA1307000039,7,7,false,5,7,2,41.90294,-87.63137
13061,7,7,false,6,1,-5,41.90342,-87.66779
TA1308000050,7,7,false,2,8,6,41.91211,-87.6347
13179,7,7,false,2,5,3,41.9157,-87.63461
13146,7,7,false,3,5,2,41.91831,-87.63629
LP-,7,7,false,4,5,1,41.92396,-87.63584
TA1307000142,7,7,false,5,3,-2,41.93125,-87.64432
13276,7,7,false,8,4,-4,41.93132,-87.63874
TA1307000064,7,7,false,5,2,-3,41.93222,-87.65864
TA1306000014,7,7,false,5,2,-3,41.93242,-87.65271
TA1309000049,7,7,false,8,7,-1,41.94077,-87.63919
TA1307000150,7,7,false,5,2,-3,41.94945,-87.64646
TA1308000012,7,7,false,6,1,-5,41.96398,-87.63818
KA1504000152,7,7,false,5,3,-2,41.98403,-87.65231
TA1308000009,7,7,true,7,7,0,41.79522,-87.58075
13216,7,7,true,3,6,3,41.83473,-87.62581
TA1309000055,7,7,true,5,5,0,41.8382,-87.64514
TA1307000048,7,7,true,4,5,1,41.83855,-87.60821
15545,7,7,true,6,6,0,41.85627,-87.61334
13102,7,7,true,5,2,-3,41.85762,-87.61942
13431,7,7,true,6,5,-1,41.8661,-87.60728
SL-005,7,7,true,11,4,-7,41.8679,-87.62304
TA1309000064,7,7,true,1,5,4,41.87127,-87.67369
SL-008,7,7,true,1,6,5,41.87209,-87.62956
KA1504000104,7,7,true,5,5,0,41.87296,-87.66912
WL-011,7,7,true,1,7,6,41.88034,-87.64273
13300,7,7,true,7,16,9,41.88097,-87.61675
13263,7,7,true,4,5,1,41.88467,-87.61952
KA1503000043,7,7,true,2,12,10,41.88918,-87.63851
TA1306000013,7,7,true,7,2,-5,41.89083,-87.61852
RN-,7,7,true,5,1,-4,41.89102,-87.63546
TA1307000117,7,7,true,8,1,-7,41.89144,-87.62675
13022,7,7,true,3,5,2,41.89227,-87.61205
13265,7,7,true,5,3,-2,41.89383,-87.64172
13016,7,7,true,8,13,5,41.89431,-87.62277
KA1503000041,7,7,true,10,3,-7,41.89452,-87.61798
TA1306000012,7,7,true,5,4,-1,41.89475,-87.63438
13132,7,7,true,6,2,-4,41.89573,-87.67718
13338,7,7,true,15,3,-12,41.89697,-87.62173
13042,7,7,true,5,4,-1,41.90097,-87.62377
KA1504000135,7,7,true,8,4,-4,41.90319,-87.63439
KA1504000134,7,7,true,5,1,-4,41.90687,-87.6262
TA1307000038,7,7,true,2,5,3,41.91138,-87.63868
13128,7,7,true,1,5,4,41.91197,-87.63197
13179,7,7,true,5,8,3,41.9157,-87.63461
13059,7,7,true,3,5,2,41.91845,-87.65222
TA1309000033,7,7,true,5,2,-3,41.92158,-87.65381
13193,7,7,true,8,9,1,41.92182,-87.64412
TA1308000001,7,7,true,9,5,-4,41.92627,-87.63086
TA1305000014,7,7,true,3,5,2,41.92956,-87.64313
TA1309000036,7,7,true,5,1,-4,41.93313,-87.64776
TA1307000052,7,7,true,3,6,3,41.93628,-87.65266
TA1309000049,7,7,true,6,2,-4,41.94077,-87.63919
13235,7,7,true,5,1,-4,41.94814,-87.66396
TA1307000150,7,7,true,8,6,-2,41.94945,-87.64646
TA1307000107,7,7,true,7,1,-6,41.96164,-87.65464
639,7,7,true,5,5,0,41.96584,-87.64538
KA1504000152,7,7,true,4,5,1,41.98403,-87.65231
TA1307000124,7,8,false,11,1,-10,41.86411,-87.62372
SL-005,7,8,false,10,10,0,41.8679,-87.62304
TA1309000010,7,8,false,5,1,-4,41.87074,-87.62574
SL-008,7,8,false,5,1,-4,41.87209,-87.62956
623,7,8,false,8,8,0,41.87272,-87.62399
15541,7,8,false,5,3,-2,41.8758,-87.62086
WL-011,7,8,false,6,1,-5,41.88034,-87.64273
13300,7,8,false,19,20,1,41.88097,-87.61675
13008,7,8,false,17,8,-9,41.88105,-87.62408
13001,7,8,false,9,2,-7,41.88397,-87.62459
13263,7,8,false,8,5,-3,41.88467,-87.61952
TA1305000011,7,8,false,6,3,-3,41.886,-87.62418
TA1307000131,7,8,false,6,1,-5,41.88688,-87.62606
KA1503000043,7,8,false,5,5,0,41.88918,-87.63851
13427,7,8,false,7,4,-3,41.89054,-87.62205
TA1306000013,7,8,false,10,1,-9,41.89083,-87.61852
TA1307000117,7,8,false,20,5,-15,41.89144,-87.62675
TA1305000003,7,8,false,13,6,-7,41.89187,-87.62061
13022,7,8,false,27,19,-8,41.89227,-87.61205
TA1306000029,7,8,false,8,1,-7,41.89256,-87.61449
13265,7,8,false,3,14,11,41.89383,-87.64172
13045,7,8,false,9,7,-2,41.89403,-87.62931
13016,7,8,false,12,7,-5,41.89431,-87.62277
KA1503000041,7,8,false,5,2,-3,41.89452,-87.61798
TA1306000012,7,8,false,6,4,-2,41.89475,-87.63438
13017,7,8,false,5,2,-3,41.89676,-87.6357
13338,7,8,false,5,2,-3,41.89697,-87.62173
15529,7,8,false,11,1,-10,41.89858,-87.62206
TA1307000128,7,8,false,3,5,2,41.89896,-87.6299
13042,7,8,false,10,12,2,41.90097,-87.62377
TA1307000039,7,8,false,10,9,-1,41.90294,-87.63137
13061,7,8,false,5,2,-3,41.90342,-87.66779
KA1504000134,7,8,false,5,3,-2,41.90687,-87.6262
13224,7,8,false,5,2,-3,41.90706,-87.66725
TA1307000143,7,8,false,8,3,-5,41.90762,-87.63854
TA1305000041,7,8,false,2,8,6,41.9094,-87.67769
331,7,8,false,5,1,-4,41.90965,-87.64812
13258,7,8,false,2,5,3,41.91043,-87.69718
LF-005,7,8,false,12,14,2,41.91172,-87.62681
TA1308000050,7,8,false,5,13,8,41.91211,-87.6347
13179,7,8,false,9,4,-5,41.9157,-87.63461
13059,7,8,false,5,3,-2,41.91845,-87.65222
13193,7,8,false,4,5,1,41.92182,-87.64412
LP-,7,8,false,10,6,-4,41.92396,-87.63584
TA1309000019,7,8,false,10,2,-8,41.92586,-87.63897
TA1308000001,7,8,false,7,8,1,41.92627,-87.63086
TA1305000014,7,8,false,2,9,7,41.92956,-87.64313
TA1307000142,7,8,false,2,6,4,41.93125,-87.64432
13276,7,8,false,8,8,0,41.93132,-87.63874
TA1306000014,7,8,false,3,7,4,41.93242,-87.65271
TA1309000039,7,8,false,5,5,0,41.93258,-87.63642
TA1307000041,7,8,false,8,5,-3,41.93669,-87.63683
13137,7,8,false,5,5,0,41.9376,-87.6441
TA1308000019,7,8,false,5,3,-2,41.93973,-87.65886
13277,7,8,false,4,7,3,41.9401,-87.64546
TA1309000049,7,8,false,10,8,-2,41.94077,-87.63919
13071,7,8,false,3,5,2,41.94373,-87.66401
13278,7,8,false,6,3,-3,41.94553,-87.64644
TA1307000127,7,8,false,2,6,4,41.9508,-87.65918
TA1308000022,7,8,false,6,1,-5,41.95438,-87.64805
13379,7,8,false,9,3,-6,41.95786,-87.6495
TA1309000027,7,8,false,8,1,-7,41.9585,-87.65499
639,7,8,false,6,3,-3,41.96584,-87.64538
TA1307000119,7,8,false,5,3,-2,41.96796,-87.65
TA1308000021,7,8,false,5,1,-4,41.96883,-87.65765
KA1504000152,7,8,false,3,5,2,41.98403,-87.65231
KA1503000014,7,8,true,6,2,-4,41.7851,-87.60108
TA1308000009,7,8,true,2,5,3,41.79522,-87.58075
TA1307000048,7,8,true,4,6,2,41.83855,-87.60821
15545,7,8,true,15,12,-3,41.85627,-87.61334
TA1306000002,7,8,true,6,2,-4,41.86238,-87.65108
TA1305000002,7,8,true,6,4,-2,41.86721,-87.62597
15544,7,8,true,2,6,4,41.86723,-87.61536
SL-005,7,8,true,5,5,0,41.8679,-87.62304
TA1309000010,7,8,true,4,5,1,41.87074,-87.62574
TA1307000130,7,8,true,4,5,1,41.87178,-87.65103
SL-008,7,8,true,5,6,1,41.87209,-87.62956
13332,7,8,true,5,1,-4,41.87219,-87.6615
623,7,8,true,5,2,-3,41.87272,-87.62399
13157,7,8,true,1,7,6,41.87773,-87.6548
WL-011,7,8,true,7,3,-4,41.88034,-87.64273
13156,7,8,true,11,6,-5,41.88042,-87.65554
13300,7,8,true,6,11,5,41.88097,-87.61675
13008,7,8,true,7,4,-3,41.88105,-87.62408
TA1307000120,7,8,true,4,7,3,41.88188,-87.64879
13053,7,8,true,1,5,4,41.88365,-87.64863
13001,7,8,true,1,5,4,41.88397,-87.62459
18062,7,8,true,2,7,5,41.88412,-87.65427
TA1305000029,7,8,true,5,2,-3,41.88466,-87.62787
13263,7,8,true,11,1,-10,41.88467,-87.61952
KA1503000012,7,8,true,2,6,4,41.88599,-87.63089
15534,7,8,true,6,2,-4,41.88627,-87.61749
KA1503000064,7,8,true,6,15,9,41.88697,-87.61281
TA1306000003,7,8,true,8,2,-6,41.88867,-87.64442
KA1503000043,7,8,true,6,8,2,41.88918,-87.63851
13050,7,8,true,1,5,4,41.88919,-87.62775
TA1307000151,7,8,true,6,4,-2,41.88993,-87.63427
636,7,8,true,6,2,-4,41.88997,-87.63662
13427,7,8,true,5,1,-4,41.89054,-87.62205
TA1306000013,7,8,true,6,4,-2,41.89083,-87.61852
13033,7,8,true,5,3,-2,41.8916,-87.64835
TA1305000003,7,8,true,5,2,-3,41.89187,-87.62061
13022,7,8,true,12,10,-2,41.89227,-87.61205
TA1306000029,7,8,true,7,1,-6,41.89256,-87.61449
13265,7,8,true,7,1,-6,41.89383,-87.64172
13045,7,8,true,9,10,1,41.89403,-87.62931
KA1503000041,7,8,true,8,8,0,41.89452,-87.61798
TA1306000012,7,8,true,9,4,-5,41.89475,-87.63438
KP1705001026,7,8,true,1,6,5,41.89483,-87.6323
637,7,8,true,5,2,-3,41.89563,-87.67209
13289,7,8,true,6,3,-3,41.89638,-87.661
13303,7,8,true,4,10,6,41.89672,-87.63088
13017,7,8,true,2,5,3,41.89676,-87.6357
13338,7,8,true,7,5,-2,41.89697,-87.62173
13034,7,8,true,5,3,-2,41.89754,-87.62352
15529,7,8,true,6,4,-2,41.89858,-87.62206
TA1307000128,7,8,true,5,1,-4,41.89896,-87.6299
13248,7,8,true,6,3,-3,41.89964,-87.66788
13042,7,8,true,1,9,8,41.90097,-87.62377
KA1504000133,7,8,true,3,5,2,41.90234,-87.62773
TA1307000039,7,8,true,15,18,3,41.90294,-87.63137
TA1305000034,7,8,true,5,3,-2,41.90313,-87.67391
KA1504000135,7,8,true,6,3,-3,41.90319,-87.63439
KA1504000134,7,8,true,7,4,-3,41.90687,-87.6262
TA1307000143,7,8,true,5,1,-4,41.90762,-87.63854
13221,7,8,true,1,10,9,41.90765,-87.67254
TA1309000024,7,8,true,6,3,-3,41.908,-87.63152
TA1305000041,7,8,true,3,8,5,41.9094,-87.67769
TA1306000008,7,8,true,6,3,-3,41.9102,-87.6435
TA1307000038,7,8,true,2,6,4,41.91138,-87.63868
LF-005,7,8,true,10,11,1,41.91172,-87.62681
TA1308000050,7,8,true,15,17,2,41.91211,-87.6347
TA1306000032,7,8,true,7,2,-5,41.9137,-87.65285
13179,7,8,true,13,7,-6,41.9157,-87.63461
13059,7,8,true,4,8,4,41.91845,-87.65222
TA1309000030,7,8,true,5,7,2,41.92077,-87.66372
TA1309000033,7,8,true,2,5,3,41.92158,-87.65381
13193,7,8,true,6,10,4,41.92182,-87.64412
LP-,7,8,true,5,2,-3,41.92396,-87.63584
TA1309000019,7,8,true,6,6,0,41.92586,-87.63897
TA1308000001,7,8,true,8,11,3,41.92627,-87.63086
13124,7,8,true,7,5,-2,41.92675,-87.63444
TA1309000023,7,8,true,3,5,2,41.9287,-87.65383
TA1309000061,7,8,true,5,3,-2,41.92915,-87.64909
TA1305000014,7,8,true,7,5,-2,41.92956,-87.64313
13276,7,8,true,5,4,-1,41.93132,-87.63874
TA1306000014,7,8,true,7,5,-2,41.93242,-87.65271
TA1309000039,7,8,true,5,6,1,41.93258,-87.63642
TA1307000052,7,8,true,2,7,5,41.93628,-87.65266
TA1307000136,7,8,true,4,8,4,41.9365,-87.64755
TA1307000041,7,8,true,7,1,-6,41.93669,-87.63683
13137,7,8,true,4,6,2,41.9376,-87.6441
TA1307000134,7,8,true,6,4,-2,41.94016,-87.65303
TA1309000049,7,8,true,10,15,5,41.94077,-87.63919
TA1309000025,7,8,true,5,1,-4,41.94368,-87.64894
632,7,8,true,6,5,-1,41.94453,-87.6547
13278,7,8,true,9,6,-3,41.94553,-87.64644
TA1307000150,7,8,true,10,3,-7,41.94945,-87.64646
13063,7,8,true,3,6,3,41.95424,-87.65441
13379,7,8,true,10,2,-8,41.95786,-87.6495
TA1307000107,7,8,true,8,7,-1,41.96164,-87.65464
TA1308000012,7,8,true,8,6,-2,41.96398,-87.63818
13074,7,8,true,4,10,6,41.96521,-87.6582
639,7,8,true,7,6,-1,41.96584,-87.64538
TA1309000014,7,8,true,5,2,-3,41.96709,-87.66744
TA1307000119,7,8,true,5,2,-3,41.96796,-87.65
TA1309000035,7,8,true,5,1,-4,41.97335,-87.66785
KA1504000152,7,8,true,8,10,2,41.98403,-87.65231
525,7,8,true,7,1,-6,42.01272,-87.66605
520,7,8,true,2,7,5,42.01597,-87.66859
20224,7,9,false,5,2,-3,41.71371,-87.53083
15491,7,9,false,5,2,-3,41.78096,-87.57624
TA1308000009,7,9,false,5,3,-2,41.79522,-87.58075
TA1307000048,7,9,false,11,1,-10,41.83855,-87.60821
15545,7,9,false,2,6,4,41.85627,-87.61334
13102,7,9,false,9,1,-8,41.85762,-87.61942
TA1307000124,7,9,false,12,1,-11,41.86411,-87.62372
TA1305000002,7,9,false,4,9,5,41.86721,-87.62597
15544,7,9,false,9,16,7,41.86723,-87.61536
SL-005,7,9,false,20,9,-11,41.8679,-87.62304
TA1309000010,7,9,false,6,6,0,41.87074,-87.62574
SL-008,7,9,false,4,5,1,41.87209,-87.62956
SL-011,7,9,false,3,9,6,41.87256,-87.63356
623,7,9,false,17,15,-2,41.87272,-87.62399
SL-007,7,9,false,9,5,-4,41.87404,-87.6277
15541,7,9,false,13,12,-1,41.8758,-87.62086
TA1305000010,7,9,false,11,5,-6,41.87623,-87.62444
13157,7,9,false,5,3,-2,41.87773,-87.6548
TA1305000025,7,9,false,3,8,5,41.87773,-87.63528
TA1309000002,7,9,false,7,5,-2,41.87784,-87.62408
TA1305000005,7,9,false,5,1,-4,41.87924,-87.62975
TA1309000008,7,9,false,3,10,7,41.87933,-87.6355
TA1309000007,7,9,false,8,3,-5,41.88022,-87.63526
WL-011,7,9,false,4,5,1,41.88034,-87.64273
13156,7,9,false,1,5,4,41.88042,-87.65554
13300,7,9,false,36,20,-16,41.88097,-87.61675
13008,7,9,false,25,22,-3,41.88105,-87.62408
TA1305000006,7,9,false,7,1,-6,41.88122,-87.6296
TA1307000120,7,9,false,8,13,5,41.88188,-87.64879
TA1305000032,7,9,false,10,3,-7,41.88218,-87.64109
13006,7,9,false,6,2,-4,41.88268,-87.63252
WL-012,7,9,false,5,3,-2,41.88337,-87.6412
13053,7,9,false,12,12,0,41.88365,-87.64863
13001,7,9,false,20,17,-3,41.88397,-87.62459
18062,7,9,false,1,6,5,41.88412,-87.65427
TA1305000030,7,9,false,6,6,0,41.88459,-87.63178
TA1305000029,7,9,false,12,4,-8,41.88466,-87.62787
13263,7,9,false,17,9,-8,41.88467,-87.61952
TA1306000015,7,9,false,2,6,4,41.88549,-87.65232
TA1307000111,7,9,false,7,3,-4,41.88582,-87.63548
TA1305000011,7,9,false,7,7,0,41.886,-87.62418
15534,7,9,false,11,4,-7,41.88627,-87.61749
TA1307000131,7,9,false,20,1,-19,41.88688,-87.62606
KA1503000064,7,9,false,18,4,-14,41.88697,-87.61281
TA1305000022,7,9,false,7,1,-6,41.88817,-87.63656
KA1503000043,7,9,false,7,2,-5,41.88918,-87.63851
13050,7,9,false,9,2,-7,41.88919,-87.62775
TA1307000151,7,9,false,7,5,-2,41.88993,-87.63427
KA1503000044,7,9,false,5,1,-4,41.89018,-87.6262
13427,7,9,false,10,5,-5,41.89054,-87.62205
TA1306000013,7,9,false,12,8,-4,41.89083,-87.61852
TA1307000117,7,9,false,19,4,-15,41.89144,-87.62675
13033,7,9,false,9,10,1,41.8916,-87.64835
13194,7,9,false,7,3,-4,41.8918,-87.65878
TA1305000003,7,9,false,20,11,-9,41.89187,-87.62061
13022,7,9,false,35,47,12,41.89227,-87.61205
TA1306000029,7,9,false,15,12,-3,41.89256,-87.61449
13045,7,9,false,16,8,-8,41.89403,-87.62931
13016,7,9,false,20,10,-10,41.89431,-87.62277
13196,7,9,false,4,5,1,41.89455,-87.65345
TA1307000062,7,9,false,11,4,-7,41.89466,-87.63839
TA1306000012,7,9,false,15,7,-8,41.89475,-87.63438
KP1705001026,7,9,false,9,3,-6,41.89483,-87.6323
13132,7,9,false,6,1,-5,41.89573,-87.67718
15530,7,9,false,5,2,-3,41.89575,-87.62596
13303,7,9,false,7,3,-4,41.89672,-87.63088
13017,7,9,false,6,3,-3,41.89676,-87.6357
13338,7,9,false,1,8,7,41.89697,-87.62173
TA1307000061,7,9,false,13,3,-10,41.89745,-87.62873
13034,7,9,false,15,12,-3,41.89754,-87.62352
TA1306000009,7,9,false,8,4,-4,41.89772,-87.64299
15529,7,9,false,14,4,-10,41.89858,-87.62206
TA1307000128,7,9,false,10,10,0,41.89896,-87.6299
13042,7,9,false,32,26,-6,41.90097,-87.62377
TA1307000039,7,9,false,22,9,-13,41.90294,-87.63137
13061,7,9,false,10,8,-2,41.90342,-87.66779
TA1308000049,7,9,false,1,6,5,41.90672,-87.6349
KA1504000134,7,9,false,6,2,-4,41.90687,-87.6262
TA1309000024,7,9,false,13,6,-7,41.908,-87.63152
TA1305000041,7,9,false,13,11,-2,41.9094,-87.67769
331,7,9,false,4,7,3,41.90965,-87.64812
13058,7,9,false,1,6,5,41.91059,-87.64942
TA1307000038,7,9,false,3,6,3,41.91138,-87.63868
LF-005,7,9,false,23,18,-5,41.91172,-87.62681
13128,7,9,false,11,6,-5,41.91197,-87.63197
TA1308000050,7,9,false,18,9,-9,41.91211,-87.6347
TA1307000166,7,9,false,3,5,2,41.91386,-87.64877
18067,7,9,false,2,5,3,41.9146,-87.66796
13179,7,9,false,12,18,6,41.9157,-87.63461
13133,7,9,false,8,5,-3,41.91598,-87.67733
TA1309000029,7,9,false,7,1,-6,41.9178,-87.68245
TA1309000006,7,9,false,1,5,4,41.91809,-87.64375
TA1307000163,7,9,false,2,8,6,41.91821,-87.65696
13146,7,9,false,7,9,2,41.91831,-87.63629
13059,7,9,false,13,6,-7,41.91845,-87.65222
13259,7,9,false,5,1,-4,41.91852,-87.69744
13192,7,9,false,7,1,-6,41.91995,-87.64884
TA1309000030,7,9,false,7,5,-2,41.92077,-87.66372
TA1309000033,7,9,false,5,2,-3,41.92158,-87.65381
13193,7,9,false,10,7,-3,41.92182,-87.64412
13191,7,9,false,5,5,0,41.92217,-87.63891
LP-,7,9,false,5,2,-3,41.92396,-87.63584
TA1306000026,7,9,false,6,3,-3,41.92558,-87.65842
TA1309000019,7,9,false,13,23,10,41.92586,-87.63897
TA1309000058,7,9,false,13,8,-5,41.92591,-87.64927
TA1308000001,7,9,false,13,13,0,41.92627,-87.63086
13124,7,9,false,3,5,2,41.92675,-87.63444
TA1309000023,7,9,false,5,5,0,41.9287,-87.65383
TA1307000113,7,9,false,5,1,-4,41.92878,-87.66391
13296,7,9,false,5,1,-4,41.92883,-87.66852
TA1305000014,7,9,false,6,9,3,41.92956,-87.64313
13085,7,9,false,2,11,9,41.92958,-87.70789
TA1307000142,7,9,false,7,10,3,41.93125,-87.64432
13276,7,9,false,16,8,-8,41.93132,-87.63874
TA1307000064,7,9,false,7,5,-2,41.93222,-87.65864
TA1306000014,7,9,false,7,3,-4,41.93242,-87.65271
TA1309000039,7,9,false,16,9,-7,41.93258,-87.63642
TA1309000036,7,9,false,4,6,2,41.93313,-87.64776
TA1307000006,7,9,false,6,5,-1,41.93571,-87.6636
TA1307000041,7,9,false,16,7,-9,41.93669,-87.63683
13137,7,9,false,7,12,5,41.9376,-87.6441
TA1309000042,7,9,false,5,4,-1,41.93937,-87.66836
15640,7,9,false,5,1,-4,41.93941,-87.72357
TA1308000019,7,9,false,11,4,-7,41.93973,-87.65886
13277,7,9,false,12,6,-6,41.9401,-87.64546
TA1309000049,7,9,false,21,14,-7,41.94077,-87.63919
TA1307000138,7,9,false,5,2,-3,41.94334,-87.67094
TA1309000025,7,9,false,5,5,0,41.94368,-87.64894
13071,7,9,false,1,6,5,41.94373,-87.66401
632,7,9,false,10,3,-7,41.94453,-87.6547
13278,7,9,false,4,6,2,41.94553,-87.64644
13235,7,9,false,5,7,2,41.94814,-87.66396
13325,7,9,false,5,2,-3,41.94907,-87.64863
TA1307000126,7,9,false,5,6,1,41.94936,-87.65451
TA1307000150,7,9,false,5,1,-4,41.94945,-87.64646
13319,7,9,false,5,1,-4,41.95069,-87.6687
TA1307000127,7,9,false,11,8,-3,41.9508,-87.65918
13323,7,9,false,5,2,-3,41.95282,-87.65
TA1308000022,7,9,false,12,4,-8,41.95438,-87.64805
13379,7,9,false,11,4,-7,41.95786,-87.6495
TA1307000107,7,9,false,5,1,-4,41.96164,-87.65464
TA1308000012,7,9,false,5,11,6,41.96398,-87.63818
KA1504000171,7,9,false,7,4,-3,41.97161,-87.65016
KA1504000152,7,9,false,9,7,-2,41.98403,-87.65231
15571,7,9,false,7,3,-4,41.99478,-87.66028
E008,7,9,false,9,3,-6,42.05049,-87.67782
KA1503000071,7,9,true,1,5,4,41.79148,-87.59988
TA1308000009,7,9,true,7,3,-4,41.79522,-87.58075
TA1309000037,7,9,true,6,2,-4,41.79957,-87.59474
TA1308000045,7,9,true,3,5,2,41.83062,-87.64129
TA1307000048,7,9,true,7,3,-4,41.83855,-87.60821
TA1307000139,7,9,true,6,3,-3,41.84205,-87.61698
13089,7,9,true,7,2,-5,41.85497,-87.67567
15545,7,9,true,16,18,2,41.85627,-87.61334
13135,7,9,true,5,4,-1,41.85753,-87.66157
13102,7,9,true,10,4,-6,41.85762,-87.61942
13150,7,9,true,4,8,4,41.85783,-87.62455
SL-012,7,9,true,6,3,-3,41.86038,-87.62581
TA1307000124,7,9,true,9,6,-3,41.86411,-87.62372
13431,7,9,true,7,10,3,41.8661,-87.60728
TA1305000002,7,9,true,10,8,-2,41.86721,-87.62597
SL-005,7,9,true,12,8,-4,41.8679,-87.62304
TA1309000010,7,9,true,10,6,-4,41.87074,-87.62574
TA1307000121,7,9,true,1,7,6,41.87184,-87.64664
SL-008,7,9,true,10,7,-3,41.87209,-87.62956
13332,7,9,true,5,4,-1,41.87219,-87.6615
SL-011,7,9,true,6,3,-3,41.87256,-87.63356
TA1306000025,7,9,true,5,5,0,41.87464,-87.65703
SL-010,7,9,true,5,2,-3,41.87501,-87.63309
15539,7,9,true,5,1,-4,41.87763,-87.64405
13156,7,9,true,3,8,5,41.88042,-87.65554
13300,7,9,true,14,12,-2,41.88097,-87.61675
13008,7,9,true,4,7,3,41.88105,-87.62408
TA1307000120,7,9,true,12,9,-3,41.88188,-87.64879
TA1305000032,7,9,true,9,7,-2,41.88218,-87.64109
13006,7,9,true,1,5,4,41.88268,-87.63252
654,7,9,true,1,5,4,41.88307,-87.65698
13053,7,9,true,4,5,1,41.88365,-87.64863
13001,7,9,true,5,6,1,41.88397,-87.62459
18062,7,9,true,2,8,6,41.88412,-87.65427
15535,7,9,true,9,4,-5,41.8846,-87.64455
13263,7,9,true,17,7,-10,41.88467,-87.61952
TA1306000015,7,9,true,4,7,3,41.88549,-87.65232
KA1503000012,7,9,true,7,5,-2,41.88599,-87.63089
TA1305000011,7,9,true,8,5,-3,41.886,-87.62418
15534,7,9,true,6,3,-3,41.88627,-87.61749
TA1308000029,7,9,true,5,2,-3,41.88673,-87.62225
KA1503000064,7,9,true,7,19,12,41.88697,-87.61281
TA1305000022,7,9,true,11,5,-6,41.88817,-87.63656
TA1306000003,7,9,true,4,9,5,41.88867,-87.64442
KA1503000043,7,9,true,12,12,0,41.88918,-87.63851
13050,7,9,true,3,5,2,41.88919,-87.62775
TA1307000151,7,9,true,5,12,7,41.88993,-87.63427
636,7,9,true,7,9,2,41.88997,-87.63662
13430,7,9,true,7,5,-2,41.89077,-87.63169
TA1306000013,7,9,true,9,9,0,41.89083,-87.61852
TA1307000117,7,9,true,5,4,-1,41.89144,-87.62675
13033,7,9,true,6,5,-1,41.8916,-87.64835
TA1305000003,7,9,true,9,6,-3,41.89187,-87.62061
13022,7,9,true,19,11,-8,41.89227,-87.61205
13265,7,9,true,9,3,-6,41.89383,-87.64172
13045,7,9,true,21,21,0,41.89403,-87.62931
13016,7,9,true,9,4,-5,41.89431,-87.62277
KA1503000041,7,9,true,7,7,0,41.89452,-87.61798
13196,7,9,true,5,1,-4,41.89455,-87.65345
TA1306000012,7,9,true,10,12,2,41.89475,-87.63438
15530,7,9,true,3,5,2,41.89575,-87.62596
13247,7,9,true,6,3,-3,41.89597,-87.66775
13289,7,9,true,7,3,-4,41.89638,-87.661
13017,7,9,true,5,4,-1,41.89676,-87.6357
13338,7,9,true,9,5,-4,41.89697,-87.62173
TA1307000061,7,9,true,6,4,-2,41.89745,-87.62873
TA1306000009,7,9,true,9,6,-3,41.89772,-87.64299
15529,7,9,true,5,4,-1,41.89858,-87.62206
TA1307000128,7,9,true,15,12,-3,41.89896,-87.6299
13248,7,9,true,5,6,1,41.89964,-87.66788
TA1306000011,7,9,true,5,1,-4,41.89994,-87.63443
KA1504000116,7,9,true,3,8,5,41.90023,-87.64299
13042,7,9,true,7,11,4,41.90097,-87.62377
KA1504000133,7,9,true,3,7,4,41.90234,-87.62773
TA1307000039,7,9,true,27,16,-11,41.90294,-87.63137
TA1305000034,7,9,true,7,4,-3,41.90313,-87.67391
KA1504000135,7,9,true,12,14,2,41.90319,-87.63439
13061,7,9,true,6,5,-1,41.90342,-87.66779
KA1504000079,7,9,true,6,9,3,41.9035,-87.64334
TA1308000049,7,9,true,10,6,-4,41.90672,-87.6349
13221,7,9,true,4,10,6,41.90765,-87.67254
TA1309000024,7,9,true,9,14,5,41.908,-87.63152
TA1305000041,7,9,true,8,11,3,41.9094,-87.67769
331,7,9,true,3,11,8,41.90965,-87.64812
13154,7,9,true,2,9,7,41.91054,-87.65312
TA1307000038,7,9,true,16,4,-12,41.91138,-87.63868
LF-005,7,9,true,16,31,15,41.91172,-87.62681
13128,7,9,true,4,10,6,41.91197,-87.63197
TA1308000050,7,9,true,18,13,-5,41.91211,-87.6347
13243,7,9,true,8,4,-4,41.91262,-87.6814
TA1306000032,7,9,true,7,3,-4,41.9137,-87.65285
TA1307000166,7,9,true,7,2,-5,41.91386,-87.64877
18067,7,9,true,5,2,-3,41.9146,-87.66796
13179,7,9,true,17,18,1,41.9157,-87.63461
15650,7,9,true,5,4,-1,41.91711,-87.71023
TA1307000163,7,9,true,7,6,-1,41.91821,-87.65696
13146,7,9,true,9,7,-2,41.91831,-87.63629
13059,7,9,true,11,8,-3,41.91845,-87.65222
13192,7,9,true,6,9,3,41.91995,-87.64884
TA1309000030,7,9,true,7,10,3,41.92077,-87.66372
TA1309000033,7,9,true,3,8,5,41.92158,-87.65381
13193,7,9,true,13,10,-3,41.92182,-87.64412
13191,7,9,true,9,4,-5,41.92217,-87.63891
LP-,7,9,true,6,4,-2,41.92396,-87.63584
TA1307000001,7,9,true,10,5,-5,41.92535,-87.66581
TA1309000019,7,9,true,18,11,-7,41.92586,-87.63897
TA1309000058,7,9,true,7,17,10,41.92591,-87.64927
TA1308000001,7,9,true,26,27,1,41.92627,-87.63086
15646,7,9,true,5,1,-4,41.92668,-87.6977
TA1307000113,7,9,true,6,5,-1,41.92878,-87.66391
TA1309000059,7,9,true,7,4,-3,41.92889,-87.65898
TA1309000061,7,9,true,8,5,-3,41.92915,-87.64909
TA1305000014,7,9,true,11,9,-2,41.92956,-87.64313
13085,7,9,true,3,6,3,41.92958,-87.70789
TA1307000142,7,9,true,7,11,4,41.93125,-87.64432
13276,7,9,true,9,10,1,41.93132,-87.63874
TA1307000064,7,9,true,8,4,-4,41.93222,-87.65864
TA1306000014,7,9,true,9,12,3,41.93242,-87.65271
TA1309000039,7,9,true,15,10,-5,41.93258,-87.63642
TA1309000036,7,9,true,8,3,-5,41.93313,-87.64776
TA1307000006,7,9,true,8,4,-4,41.93571,-87.6636
TA1307000052,7,9,true,9,3,-6,41.93628,-87.65266
TA1307000136,7,9,true,12,5,-7,41.9365,-87.64755
TA1307000041,7,9,true,15,14,-1,41.93669,-87.63683
13137,7,9,true,14,8,-6,41.9376,-87.6441
TA1308000019,7,9,true,5,11,6,41.93973,-87.65886
13277,7,9,true,6,4,-2,41.9401,-87.64546
TA1307000134,7,9,true,6,5,-1,41.94016,-87.65303
TA1309000049,7,9,true,11,11,0,41.94077,-87.63919
TA1309000025,7,9,true,3,6,3,41.94368,-87.64894
13071,7,9,true,10,13,3,41.94373,-87.66401
632,7,9,true,4,7,3,41.94453,-87.6547
13278,7,9,true,9,3,-6,41.94553,-87.64644
13235,7,9,true,7,7,0,41.94814,-87.66396
13325,7,9,true,5,8,3,41.94907,-87.64863
TA1307000126,7,9,true,3,6,3,41.94936,-87.65451
TA1307000150,7,9,true,11,4,-7,41.94945,-87.64646
13319,7,9,true,8,1,-7,41.95069,-87.6687
13323,7,9,true,4,8,4,41.95282,-87.65
13063,7,9,true,8,6,-2,41.95424,-87.65441
TA1308000022,7,9,true,12,6,-6,41.95438,-87.64805
TA1309000026,7,9,true,5,2,-3,41.95601,-87.6802
13379,7,9,true,7,6,-1,41.95786,-87.6495
TA1309000027,7,9,true,6,4,-2,41.9585,-87.65499
13389,7,9,true,12,4,-8,41.961,-87.64958
KA1503000022,7,9,true,7,6,-1,41.96158,-87.66609
TA1307000107,7,9,true,8,11,3,41.96164,-87.65464
TA1308000012,7,9,true,2,14,12,41.96398,-87.63818
13074,7,9,true,6,1,-5,41.96521,-87.6582
639,7,9,true,6,7,1,41.96584,-87.64538
KA1504000093,7,9,true,5,1,-4,41.96587,-87.69365
TA1309000014,7,9,true,6,5,-1,41.96709,-87.66744
TA1307000158,7,9,true,6,5,-1,41.9671,-87.67904
TA1307000119,7,9,true,3,6,3,41.96796,-87.65
TA1308000021,7,9,true,5,1,-4,41.96883,-87.65765
TA1309000015,7,9,true,5,1,-4,41.96889,-87.68401
TA1309000066,7,9,true,7,5,-2,41.9691,-87.67423
TA1309000041,7,9,true,5,5,0,41.96951,-87.65471
KA1504000171,7,9,true,9,5,-4,41.97161,-87.65016
KA1504000151,7,9,true,9,6,-3,41.98359,-87.66916
KA1504000152,7,9,true,11,10,-1,41.98403,-87.65231
15578,7,9,true,6,4,-2,41.98405,-87.66027
15491,7,10,false,8,3,-5,41.78096,-87.57624
TA1309000011,7,10,false,5,3,-2,41.78873,-87.60131
KA1503000071,7,10,false,6,5,-1,41.79148,-87.59988
KA1503000074,7,10,false,7,7,0,41.79174,-87.58395
TA1308000009,7,10,false,8,2,-6,41.79522,-87.58075
TA1307000164,7,10,false,7,3,-4,41.79527,-87.59647
KA1503000059,7,10,false,5,4,-1,41.79952,-87.58643
TA1309000037,7,10,false,6,5,-1,41.79957,-87.59474
TA1308000035,7,10,false,1,5,4,41.80944,-87.59188
TA1308000038,7,10,false,10,3,-7,41.82298,-87.6071
TA1307000048,7,10,false,10,8,-2,41.83855,-87.60821
TA1305000004,7,10,false,5,3,-2,41.8514,-87.61884
13075,7,10,false,4,11,7,41.8531,-87.63192
15545,7,10,false,14,9,-5,41.85627,-87.61334
13102,7,10,false,6,6,0,41.85762,-87.61942
13150,7,10,false,7,6,-1,41.85783,-87.62455
TA1307000124,7,10,false,10,8,-2,41.86411,-87.62372
13431,7,10,false,9,11,2,41.8661,-87.60728
TA1305000002,7,10,false,24,7,-17,41.86721,-87.62597
15544,7,10,false,12,39,27,41.86723,-87.61536
SL-005,7,10,false,29,17,-12,41.8679,-87.62304
TA1309000010,7,10,false,14,7,-7,41.87074,-87.62574
15542,7,10,false,2,6,4,41.87146,-87.64095
SL-008,7,10,false,14,5,-9,41.87209,-87.62956
SL-011,7,10,false,11,4,-7,41.87256,-87.63356
623,7,10,false,27,10,-17,41.87272,-87.62399
15541,7,10,false,23,15,-8,41.8758,-87.62086
TA1305000009,7,10,false,7,3,-4,41.87593,-87.63068
TA1305000010,7,10,false,5,3,-2,41.87623,-87.62444
TA1305000035,7,10,false,5,1,-4,41.87716,-87.62787
15539,7,10,false,2,5,3,41.87763,-87.64405
13158,7,10,false,15,4,-11,41.87764,-87.64957
13157,7,10,false,5,4,-1,41.87773,-87.6548
TA1305000025,7,10,false,15,9,-6,41.87773,-87.63528
TA1309000002,7,10,false,23,6,-17,41.87784,-87.62408
638,7,10,false,6,3,-3,41.87827,-87.64078
TA1305000005,7,10,false,14,5,-9,41.87924,-87.62975
13011,7,10,false,14,12,-2,41.87931,-87.63993
TA1309000008,7,10,false,9,4,-5,41.87933,-87.6355
KA1503000015,7,10,false,18,8,-10,41.87948,-87.6257
WL-011,7,10,false,9,3,-6,41.88034,-87.64273
13156,7,10,false,8,1,-7,41.88042,-87.65554
13300,7,10,false,45,31,-14,41.88097,-87.61675
13008,7,10,false,31,43,12,41.88105,-87.62408
TA1305000006,7,10,false,5,7,2,41.88122,-87.6296
13056,7,10,false,3,9,6,41.88168,-87.63951
TA1307000120,7,10,false,19,15,-4,41.88188,-87.64879
13341,7,10,false,9,7,-2,41.88208,-87.63985
13036,7,10,false,6,7,1,41.8821,-87.62513
TA1305000032,7,10,false,20,8,-12,41.88218,-87.64109
654,7,10,false,5,5,0,41.88307,-87.65698
13409,7,10,false,2,8,6,41.8831,-87.6511
KA1503000072,7,10,false,11,4,-7,41.88317,-87.63693
WL-012,7,10,false,7,6,-1,41.88337,-87.6412
13053,7,10,false,5,14,9,41.88365,-87.64863
13001,7,10,false,25,26,1,41.88397,-87.62459
TA1306000010,7,10,false,6,1,-5,41.88419,-87.62961
TA1305000030,7,10,false,17,1,-16,41.88459,-87.63178
15535,7,10,false,2,10,8,41.8846,-87.64455
TA1305000029,7,10,false,4,11,7,41.88466,-87.62787
13263,7,10,false,20,7,-13,41.88467,-87.61952
TA1306000015,7,10,false,6,15,9,41.88549,-87.65232
13021,7,10,false,5,4,-1,41.88559,-87.64184
TA1307000111,7,10,false,5,3,-2,41.88582,-87.63548
KA1503000012,7,10,false,10,7,-3,41.88599,-87.63089
TA1305000011,7,10,false,20,15,-5,41.886,-87.62418
15534,7,10,false,3,5,2,41.88627,-87.61749
TA1308000029,7,10,false,2,5,3,41.88673,-87.62225
TA1307000131,7,10,false,15,19,4,41.88688,-87.62606
KA1503000064,7,10,false,19,18,-1,41.88697,-87.61281
TA1305000022,7,10,false,11,4,-7,41.88817,-87.63656
TA1306000003,7,10,false,7,3,-4,41.88867,-87.64442
KA1503000043,7,10,false,11,8,-3,41.88918,-87.63851
13050,7,10,false,6,8,2,41.88919,-87.62775
TA1307000151,7,10,false,8,13,5,41.88993,-87.63427
636,7,10,false,7,8,1,41.88997,-87.63662
KA1503000044,7,10,false,11,7,-4,41.89018,-87.6262
13427,7,10,false,13,4,-9,41.89054,-87.62205
13430,7,10,false,16,10,-6,41.89077,-87.63169
TA1306000013,7,10,false,26,15,-11,41.89083,-87.61852
RN-,7,10,false,6,10,4,41.89102,-87.63546
13434,7,10,false,6,1,-5,41.89108,-87.66663
TA1308000006,7,10,false,5,3,-2,41.89128,-87.67686
TA1307000117,7,10,false,14,14,0,41.89144,-87.62675
13033,7,10,false,9,11,2,41.8916,-87.64835
13194,7,10,false,10,4,-6,41.8918,-87.65878
TA1305000003,7,10,false,12,12,0,41.89187,-87.62061
13022,7,10,false,72,130,58,41.89227,-87.61205
TA1306000029,7,10,false,17,11,-6,41.89256,-87.61449
13265,7,10,false,7,3,-4,41.89383,-87.64172
13045,7,10,false,13,15,2,41.89403,-87.62931
13016,7,10,false,28,14,-14,41.89431,-87.62277
KA1503000041,7,10,false,25,7,-18,41.89452,-87.61798
TA1306000012,7,10,false,20,19,-1,41.89475,-87.63438
KP1705001026,7,10,false,4,7,3,41.89483,-87.6323
13132,7,10,false,10,4,-6,41.89573,-87.67718
15530,7,10,false,25,17,-8,41.89575,-87.62596
18003,7,10,false,10,2,-8,41.89575,-87.62011
13247,7,10,false,2,6,4,41.89597,-87.66775
TA1305000020,7,10,false,9,3,-6,41.89636,-87.65406
13289,7,10,false,7,5,-2,41.89638,-87.661
13303,7,10,false,12,7,-5,41.89672,-87.63088
13017,7,10,false,7,1,-6,41.89676,-87.6357
13338,7,10,false,5,9,4,41.89697,-87.62173
TA1307000061,7,10,false,7,2,-5,41.89745,-87.62873
13034,7,10,false,15,10,-5,41.89754,-87.62352
TA1306000009,7,10,false,5,3,-2,41.89772,-87.64299
620,7,10,false,4,8,4,41.89817,-87.63754
15529,7,10,false,6,2,-4,41.89858,-87.62206
TA1307000128,7,10,false,28,11,-17,41.89896,-87.6299
KA1504000116,7,10,false,6,5,-1,41.90023,-87.64299
13290,7,10,false,10,4,-6,41.90069,-87.66259
13042,7,10,false,33,34,1,41.90097,-87.62377
KA1504000133,7,10,false,9,7,-2,41.90234,-87.62773
13241,7,10,false,6,1,-5,41.9029,-87.68731
TA1307000039,7,10,false,22,13,-9,41.90294,-87.63137
TA1305000034,7,10,false,3,8,5,41.90313,-87.67391
KA1504000135,7,10,false,24,12,-12,41.90319,-87.63439
13061,7,10,false,17,16,-1,41.90342,-87.66779
KA1504000079,7,10,false,5,4,-1,41.9035,-87.64334
TA1308000049,7,10,false,15,13,-2,41.90672,-87.6349
KA1504000134,7,10,false,20,4,-16,41.90687,-87.6262
13224,7,10,false,8,1,-7,41.90706,-87.66725
TA1307000143,7,10,false,4,7,3,41.90762,-87.63854
13221,7,10,false,4,11,7,41.90765,-87.67254
TA1309000024,7,10,false,11,3,-8,41.908,-87.63152
TA1305000041,7,10,false,15,22,7,41.9094,-87.67769
331,7,10,false,5,6,1,41.90965,-87.64812
TA1305000037,7,10,false,1,6,5,41.91018,-87.67003
13257,7,10,false,6,1,-5,41.91054,-87.68956
13154,7,10,false,4,5,1,41.91054,-87.65312
TA1307000038,7,10,false,5,6,1,41.91138,-87.63868
LF-005,7,10,false,57,56,-1,41.91172,-87.62681
13128,7,10,false,16,17,1,41.91197,-87.63197
TA1308000050,7,10,false,30,31,1,41.91211,-87.6347
13243,7,10,false,5,5,0,41.91262,-87.6814
TA1307000166,7,10,false,2,5,3,41.91386,-87.64877
18067,7,10,false,2,5,3,41.9146,-87.66796
13179,7,10,false,30,30,0,41.9157,-87.63461
13133,7,10,false,6,9,3,41.91598,-87.67733
15651,7,10,false,7,2,-5,41.91752,-87.70181
TA1309000029,7,10,false,5,1,-4,41.9178,-87.68245
TA1309000006,7,10,false,4,6,2,41.91809,-87.64375
13146,7,10,false,10,7,-3,41.91831,-87.63629
13059,7,10,false,12,18,6,41.91845,-87.65222
13259,7,10,false,2,7,5,41.91852,-87.69744
13192,7,10,false,8,11,3,41.91995,-87.64884
TA1309000030,7,10,false,5,3,-2,41.92077,-87.66372
TA1309000033,7,10,false,4,9,5,41.92158,-87.65381
13193,7,10,false,9,13,4,41.92182,-87.64412
13191,7,10,false,4,10,6,41.92217,-87.63891
13084,7,10,false,9,4,-5,41.92268,-87.69715
LP-,7,10,false,12,13,1,41.92396,-87.63584
TA1307000001,7,10,false,8,8,0,41.92535,-87.66581
TA1306000026,7,10,false,11,8,-3,41.92558,-87.65842
TA1306000016,7,10,false,6,5,-1,41.9256,-87.65371
TA1309000019,7,10,false,29,10,-19,41.92586,-87.63897
TA1309000058,7,10,false,7,15,8,41.92591,-87.64927
TA1308000001,7,10,false,19,40,21,41.92627,-87.63086
15646,7,10,false,5,3,-2,41.92668,-87.6977
13124,7,10,false,5,6,1,41.92675,-87.63444
TA1307000113,7,10,false,6,3,-3,41.92878,-87.66391
TA1308000031,7,10,false,7,3,-4,41.92946,-87.68417
TA1305000014,7,10,false,20,16,-4,41.92956,-87.64313
13085,7,10,false,9,11,2,41.92958,-87.70789
TA1307000142,7,10,false,14,7,-7,41.93125,-87.64432
13276,7,10,false,11,11,0,41.93132,-87.63874
TA1307000064,7,10,false,6,8,2,41.93222,-87.65864
TA1306000014,7,10,false,15,8,-7,41.93242,-87.65271
TA1309000039,7,10,false,22,8,-14,41.93258,-87.63642
TA1307000006,7,10,false,9,9,0,41.93571,-87.6636
13268,7,10,false,5,2,-3,41.93588,-87.67843
TA1307000052,7,10,false,12,12,0,41.93628,-87.65266
TA1307000136,7,10,false,11,9,-2,41.9365,-87.64755
TA1307000041,7,10,false,25,17,-8,41.93669,-87.63683
13137,7,10,false,11,10,-1,41.9376,-87.6441
TA1309000042,7,10,false,5,6,1,41.93937,-87.66836
13229,7,10,false,11,4,-7,41.93946,-87.66376
TA1308000019,7,10,false,7,10,3,41.93973,-87.65886
13277,7,10,false,7,18,11,41.9401,-87.64546
TA1307000134,7,10,false,12,13,1,41.94016,-87.65303
TA1309000049,7,10,false,21,15,-6,41.94077,-87.63919
TA1309000025,7,10,false,10,5,-5,41.94368,-87.64894
13071,7,10,false,10,15,5,41.94373,-87.66401
632,7,10,false,8,11,3,41.94453,-87.6547
13278,7,10,false,8,6,-2,41.94553,-87.64644
13235,7,10,false,10,11,1,41.94814,-87.66396
13325,7,10,false,8,7,-1,41.94907,-87.64863
TA1307000126,7,10,false,8,8,0,41.94936,-87.65451
TA1307000150,7,10,false,20,13,-7,41.94945,-87.64646
13319,7,10,false,6,10,4,41.95069,-87.6687
TA1307000127,7,10,false,9,9,0,41.9508,-87.65918
TA1309000043,7,10,false,7,3,-4,41.95417,-87.66434
13063,7,10,false,9,7,-2,41.95424,-87.65441
TA1308000022,7,10,false,13,8,-5,41.95438,-87.64805
13379,7,10,false,8,4,-4,41.95786,-87.6495
TA1309000027,7,10,false,8,6,-2,41.9585,-87.65499
13389,7,10,false,9,12,3,41.961,-87.64958
KA1503000022,7,10,false,9,2,-7,41.96158,-87.66609
TA1307000107,7,10,false,11,4,-7,41.96164,-87.65464
TA1308000012,7,10,false,9,15,6,41.96398,-87.63818
13074,7,10,false,7,4,-3,41.96521,-87.6582
639,7,10,false,6,5,-1,41.96584,-87.64538
TA1309000014,7,10,false,5,1,-4,41.96709,-87.66744
TA1309000066,7,10,false,6,5,-1,41.9691,-87.67423
TA1309000041,7,10,false,5,2,-3,41.96951,-87.65471
KA1504000171,7,10,false,16,9,-7,41.97161,-87.65016
TA1309000035,7,10,false,5,5,0,41.97335,-87.66785
13108,7,10,false,7,3,-4,41.97379,-87.65971
KA1504000146,7,10,false,4,10,6,41.978,-87.66805
KA1504000152,7,10,false,11,10,-1,41.98403,-87.65231
15571,7,10,false,8,4,-4,41.99478,-87.66028
KA1504000175,7,10,false,5,1,-4,42.00797,-87.66549
E008,7,10,false,9,6,-3,42.05049,-87.67782
KA1503000014,7,10,true,2,8,6,41.7851,-87.60108
KA1503000071,7,10,true,2,5,3,41.79148,-87.59988
KA1504000076,7,10,true,7,4,-3,41.7943,-87.60145
TA1308000009,7,10,true,9,5,-4,41.79522,-87.58075
TA1307000164,7,10,true,4,6,2,41.79527,-87.59647
TA1309000037,7,10,true,8,3,-5,41.79957,-87.59474
TA1308000045,7,10,true,4,6,2,41.83062,-87.64129
13215,7,10,true,5,2,-3,41.83634,-87.6135
TA1307000048,7,10,true,7,6,-1,41.83855,-87.60821
TA1308000036,7,10,true,5,3,-2,41.83883,-87.62186
TA1307000139,7,10,true,5,3,-2,41.84205,-87.61698
13307,7,10,true,5,1,-4,41.85489,-87.66359
15545,7,10,true,16,17,1,41.85627,-87.61334
13102,7,10,true,13,6,-7,41.85762,-87.61942
13150,7,10,true,11,2,-9,41.85783,-87.62455
13164,7,10,true,5,2,-3,41.85818,-87.65648
SL-012,7,10,true,3,5,2,41.86038,-87.62581
TA1306000002,7,10,true,5,1,-4,41.86238,-87.65108
TA1307000124,7,10,true,15,8,-7,41.86411,-87.62372
13431,7,10,true,10,11,1,41.8661,-87.60728
WL-008,7,10,true,5,8,3,41.86712,-87.64108
TA1305000002,7,10,true,13,6,-7,41.86721,-87.62597
15544,7,10,true,2,7,5,41.86723,-87.61536
SL-005,7,10,true,13,9,-4,41.8679,-87.62304
13139,7,10,true,12,4,-8,41.86893,-87.65913
13160,7,10,true,6,3,-3,41.86947,-87.65548
15550,7,10,true,2,5,3,41.87024,-87.63947
TA1309000010,7,10,true,9,8,-1,41.87074,-87.62574
TA1307000130,7,10,true,1,6,5,41.87178,-87.65103
TA1307000121,7,10,true,2,10,8,41.87184,-87.64664
SL-008,7,10,true,17,7,-10,41.87209,-87.62956
13332,7,10,true,12,12,0,41.87219,-87.6615
SL-011,7,10,true,9,5,-4,41.87256,-87.63356
623,7,10,true,9,3,-6,41.87272,-87.62399
SL-007,7,10,true,5,3,-2,41.87404,-87.6277
TA1306000025,7,10,true,5,1,-4,41.87464,-87.65703
SL-010,7,10,true,6,2,-4,41.87501,-87.63309
15539,7,10,true,6,2,-4,41.87763,-87.64405
13158,7,10,true,5,8,3,41.87764,-87.64957
13157,7,10,true,6,3,-3,41.87773,-87.6548
TA1309000002,7,10,true,1,5,4,41.87784,-87.62408
13011,7,10,true,7,7,0,41.87931,-87.63993
WL-011,7,10,true,11,5,-6,41.88034,-87.64273
13156,7,10,true,4,8,4,41.88042,-87.65554
13300,7,10,true,13,22,9,41.88097,-87.61675
13008,7,10,true,3,15,12,41.88105,-87.62408
TA1307000120,7,10,true,15,20,5,41.88188,-87.64879
13341,7,10,true,3,7,4,41.88208,-87.63985
13036,7,10,true,5,4,-1,41.8821,-87.62513
TA1305000032,7,10,true,6,7,1,41.88218,-87.64109
13006,7,10,true,6,3,-3,41.88268,-87.63252
13353,7,10,true,6,4,-2,41.88283,-87.6612
654,7,10,true,6,5,-1,41.88307,-87.65698
WL-012,7,10,true,7,3,-4,41.88337,-87.6412
13053,7,10,true,11,13,2,41.88365,-87.64863
13001,7,10,true,13,8,-5,41.88397,-87.62459
TA1305000030,7,10,true,9,2,-7,41.88459,-87.63178
15535,7,10,true,7,4,-3,41.8846,-87.64455
TA1305000029,7,10,true,2,7,5,41.88466,-87.62787
13263,7,10,true,12,10,-2,41.88467,-87.61952
TA1306000015,7,10,true,3,8,5,41.88549,-87.65232
13021,7,10,true,4,6,2,41.88559,-87.64184
TA1307000111,7,10,true,6,7,1,41.88582,-87.63548
KA1503000012,7,10,true,7,8,1,41.88599,-87.63089
TA1305000011,7,10,true,5,2,-3,41.886,-87.62418
TA1308000029,7,10,true,5,3,-2,41.88673,-87.62225
KA1503000064,7,10,true,18,20,2,41.88697,-87.61281
TA1305000022,7,10,true,5,7,2,41.88817,-87.63656
TA1306000003,7,10,true,11,6,-5,41.88867,-87.64442
KA1503000043,7,10,true,16,16,0,41.88918,-87.63851
13050,7,10,true,4,8,4,41.88919,-87.62775
TA1307000151,7,10,true,13,9,-4,41.88993,-87.63427
636,7,10,true,13,9,-4,41.88997,-87.63662
13430,7,10,true,5,10,5,41.89077,-87.63169
TA1306000013,7,10,true,5,9,4,41.89083,-87.61852
RN-,7,10,true,7,3,-4,41.89102,-87.63546
13434,7,10,true,2,5,3,41.89108,-87.66663
TA1307000117,7,10,true,6,7,1,41.89144,-87.62675
13033,7,10,true,16,15,-1,41.8916,-87.64835
13194,7,10,true,12,10,-2,41.8918,-87.65878
TA1305000003,7,10,true,13,10,-3,41.89187,-87.62061
13022,7,10,true,36,24,-12,41.89227,-87.61205
TA1306000029,7,10,true,8,9,1,41.89256,-87.61449
13265,7,10,true,15,7,-8,41.89383,-87.64172
13045,7,10,true,18,12,-6,41.89403,-87.62931
13016,7,10,true,8,7,-1,41.89431,-87.62277
KA1503000041,7,10,true,8,7,-1,41.89452,-87.61798
13196,7,10,true,10,3,-7,41.89455,-87.65345
TA1307000062,7,10,true,3,6,3,41.89466,-87.63839
TA1306000012,7,10,true,22,14,-8,41.89475,-87.63438
KP1705001026,7,10,true,8,4,-4,41.89483,-87.6323
637,7,10,true,8,6,-2,41.89563,-87.67209
13132,7,10,true,8,4,-4,41.89573,-87.67718
15530,7,10,true,5,16,11,41.89575,-87.62596
13247,7,10,true,5,6,1,41.89597,-87.66775
TA1305000020,7,10,true,7,6,-1,41.89636,-87.65406
13289,7,10,true,5,1,-4,41.89638,-87.661
13303,7,10,true,12,9,-3,41.89672,-87.63088
13017,7,10,true,6,12,6,41.89676,-87.6357
13338,7,10,true,6,5,-1,41.89697,-87.62173
TA1307000061,7,10,true,7,3,-4,41.89745,-87.62873
TA1306000009,7,10,true,10,4,-6,41.89772,-87.64299
KA1504000103,7,10,true,5,2,-3,41.89842,-87.68659
15529,7,10,true,6,5,-1,41.89858,-87.62206
TA1307000128,7,10,true,18,19,1,41.89896,-87.6299
13248,7,10,true,7,2,-5,41.89964,-87.66788
KA1504000116,7,10,true,17,11,-6,41.90023,-87.64299
13290,7,10,true,7,7,0,41.90069,-87.66259
13042,7,10,true,12,20,8,41.90097,-87.62377
KA1504000133,7,10,true,5,7,2,41.90234,-87.62773
TA1306000006,7,10,true,8,4,-4,41.90292,-87.63772
TA1307000039,7,10,true,20,16,-4,41.90294,-87.63137
KA1504000135,7,10,true,14,23,9,41.90319,-87.63439
13136,7,10,true,3,5,2,41.90326,-87.67845
13061,7,10,true,13,8,-5,41.90342,-87.66779
KA1504000079,7,10,true,4,8,4,41.9035,-87.64334
TA1308000049,7,10,true,8,6,-2,41.90672,-87.6349
KA1504000134,7,10,true,3,5,2,41.90687,-87.6262
13221,7,10,true,10,10,0,41.90765,-87.67254
TA1309000024,7,10,true,8,12,4,41.908,-87.63152
TA1305000041,7,10,true,10,11,1,41.9094,-87.67769
331,7,10,true,4,8,4,41.90965,-87.64812
TA1305000037,7,10,true,7,3,-4,41.91018,-87.67003
TA1308000005,7,10,true,2,5,3,41.91042,-87.68238
13154,7,10,true,7,10,3,41.91054,-87.65312
13058,7,10,true,7,4,-3,41.91059,-87.64942
LF-005,7,10,true,28,38,10,41.91172,-87.62681
13128,7,10,true,7,13,6,41.91197,-87.63197
TA1308000050,7,10,true,30,28,-2,41.91211,-87.6347
13243,7,10,true,8,11,3,41.91262,-87.6814
TA1306000032,7,10,true,7,3,-4,41.9137,-87.65285
TA1307000166,7,10,true,6,5,-1,41.91386,-87.64877
18067,7,10,true,6,5,-1,41.9146,-87.66796
TA1306000007,7,10,true,3,5,2,41.91469,-87.64333
13068,7,10,true,6,4,-2,41.91554,-87.68703
13179,7,10,true,26,29,3,41.9157,-87.63461
13133,7,10,true,11,3,-8,41.91598,-87.67733
13266,7,10,true,5,1,-4,41.91774,-87.69142
TA1309000029,7,10,true,5,1,-4,41.9178,-87.68245
TA1309000006,7,10,true,5,5,0,41.91809,-87.64375
TA1307000163,7,10,true,5,9,4,41.91821,-87.65696
13146,7,10,true,12,14,2,41.91831,-87.63629
13059,7,10,true,15,11,-4,41.91845,-87.65222
13192,7,10,true,9,11,2,41.91995,-87.64884
13288,7,10,true,13,3,-10,41.92008,-87.67788
TA1309000030,7,10,true,9,6,-3,41.92077,-87.66372
TA1309000033,7,10,true,5,13,8,41.92158,-87.65381
13193,7,10,true,9,8,-1,41.92182,-87.64412
13191,7,10,true,7,8,1,41.92217,-87.63891
LP-,7,10,true,17,12,-5,41.92396,-87.63584
TA1307000001,7,10,true,10,6,-4,41.92535,-87.66581
TA1306000026,7,10,true,8,5,-3,41.92558,-87.65842
TA1309000019,7,10,true,14,9,-5,41.92586,-87.63897
TA1309000058,7,10,true,14,7,-7,41.92591,-87.64927
TA1308000001,7,10,true,11,20,9,41.92627,-87.63086
13124,7,10,true,5,6,1,41.92675,-87.63444
TA1309000023,7,10,true,6,13,7,41.9287,-87.65383
TA1307000113,7,10,true,9,6,-3,41.92878,-87.66391
TA1309000059,7,10,true,7,5,-2,41.92889,-87.65898
TA1309000061,7,10,true,4,11,7,41.92915,-87.64909
TA1305000014,7,10,true,17,19,2,41.92956,-87.64313
13085,7,10,true,5,16,11,41.92958,-87.70789
TA1307000142,7,10,true,8,12,4,41.93125,-87.64432
13276,7,10,true,19,12,-7,41.93132,-87.63874
13271,7,10,true,4,5,1,41.93192,-87.67784
TA1307000064,7,10,true,16,7,-9,41.93222,-87.65864
TA1306000014,7,10,true,12,10,-2,41.93242,-87.65271
TA1309000039,7,10,true,14,10,-4,41.93258,-87.63642
TA1309000036,7,10,true,5,9,4,41.93313,-87.64776
13268,7,10,true,6,2,-4,41.93588,-87.67843
13269,7,10,true,7,4,-3,41.93609,-87.66983
TA1307000052,7,10,true,5,5,0,41.93628,-87.65266
TA1307000136,7,10,true,6,16,10,41.9365,-87.64755
TA1307000041,7,10,true,20,17,-3,41.93669,-87.63683
13137,7,10,true,23,14,-9,41.9376,-87.6441
TA1309000042,7,10,true,5,9,4,41.93937,-87.66836
13229,7,10,true,9,7,-2,41.93946,-87.66376
TA1308000019,7,10,true,10,8,-2,41.93973,-87.65886
13277,7,10,true,11,10,-1,41.9401,-87.64546
TA1307000134,7,10,true,14,11,-3,41.94016,-87.65303
TA1309000049,7,10,true,7,9,2,41.94077,-87.63919
TA1307000138,7,10,true,2,5,3,41.94334,-87.67094
13144,7,10,true,10,4,-6,41.9434,-87.67964
TA1309000025,7,10,true,11,12,1,41.94368,-87.64894
13071,7,10,true,10,12,2,41.94373,-87.66401
632,7,10,true,8,7,-1,41.94453,-87.6547
13278,7,10,true,12,11,-1,41.94553,-87.64644
13235,7,10,true,20,13,-7,41.94814,-87.66396
13253,7,10,true,5,2,-3,41.9488,-87.67527
13325,7,10,true,13,9,-4,41.94907,-87.64863
TA1307000126,7,10,true,6,5,-1,41.94936,-87.65451
TA1307000150,7,10,true,9,14,5,41.94945,-87.64646
13319,7,10,true,2,6,4,41.95069,-87.6687
TA1307000127,7,10,true,5,8,3,41.9508,-87.65918
13323,7,10,true,12,7,-5,41.95282,-87.65
13063,7,10,true,11,4,-7,41.95424,-87.65441
TA1308000022,7,10,true,9,10,1,41.95438,-87.64805
13379,7,10,true,2,6,4,41.95786,-87.6495
TA1309000027,7,10,true,6,7,1,41.9585,-87.65499
13389,7,10,true,11,6,-5,41.961,-87.64958
KA1503000022,7,10,true,9,4,-5,41.96158,-87.66609
TA1307000107,7,10,true,6,7,1,41.96164,-87.65464
TA1307000156,7,10,true,5,6,1,41.96301,-87.68479
TA1308000012,7,10,true,15,20,5,41.96398,-87.63818
13074,7,10,true,10,4,-6,41.96521,-87.6582
639,7,10,true,9,11,2,41.96584,-87.64538
KA1504000093,7,10,true,7,1,-6,41.96587,-87.69365
TA1307000140,7,10,true,7,7,0,41.96643,-87.68865
TA1309000014,7,10,true,5,2,-3,41.96709,-87.66744
TA1307000158,7,10,true,7,5,-2,41.9671,-87.67904
TA1308000021,7,10,true,4,5,1,41.96883,-87.65765
TA1309000066,7,10,true,8,11,3,41.9691,-87.67423
TA1309000041,7,10,true,5,3,-2,41.96951,-87.65471
KA1504000171,7,10,true,6,2,-4,41.97161,-87.65016
TA1309000035,7,10,true,6,7,1,41.97335,-87.66785
13108,7,10,true,6,3,-3,41.97379,-87.65971
KA1504000146,7,10,true,5,6,1,41.978,-87.66805
KA1504000152,7,10,true,20,16,-4,41.98403,-87.65231
15575,7,10,true,7,3,-4,41.98975,-87.66014
15571,7,10,true,6,6,0,41.99478,-87.66028
660,7,10,true,2,5,3,42.00458,-87.66143
KA1503000046,7,11,false,6,1,-5,41.78041,-87.59141
KA1503000014,7,11,false,6,3,-3,41.7851,-87.60108
KA1503000071,7,11,false,11,7,-4,41.79148,-87.59988
KA1503000074,7,11,false,7,6,-1,41.79174,-87.58395
TA1308000009,7,11,false,8,15,7,41.79522,-87.58075
TA1307000164,7,11,false,4,5,1,41.79527,-87.59647
KA1503000059,7,11,false,3,5,2,41.79952,-87.58643
TA1309000037,7,11,false,7,2,-5,41.79957,-87.59474
KA1503000007,7,11,false,12,7,-5,41.80242,-87.58689
13398,7,11,false,5,2,-3,41.80256,-87.59035
TA1308000035,7,11,false,3,5,2,41.80944,-87.59188
TA1308000023,7,11,false,5,1,-4,41.81649,-87.60659
TA1308000038,7,11,false,5,9,4,41.82298,-87.6071
TA1307000048,7,11,false,10,14,4,41.83855,-87.60821
TA1308000036,7,11,false,6,1,-5,41.83883,-87.62186
TA1309000003,7,11,false,5,1,-4,41.84847,-87.68512
TA1305000004,7,11,false,5,7,2,41.8514,-87.61884
13075,7,11,false,5,10,5,41.8531,-87.63192
15546,7,11,false,6,1,-5,41.85416,-87.61916
15545,7,11,false,8,9,1,41.85627,-87.61334
SL-013,7,11,false,3,5,2,41.85659,-87.62755
13102,7,11,false,8,6,-2,41.85762,-87.61942
13150,7,11,false,8,2,-6,41.85783,-87.62455
13163,7,11,false,6,2,-4,41.85808,-87.65108
SL-012,7,11,false,5,2,-3,41.86038,-87.62581
TA1307000124,7,11,false,6,8,2,41.86411,-87.62372
13029,7,11,false,10,6,-4,41.86531,-87.6179
13431,7,11,false,24,16,-8,41.8661,-87.60728
TA1305000002,7,11,false,25,5,-20,41.86721,-87.62597
15544,7,11,false,50,45,-5,41.86723,-87.61536
KA1706005007,7,11,false,6,4,-2,41.86749,-87.63219
SL-005,7,11,false,33,38,5,41.8679,-87.62304
13160,7,11,false,8,2,-6,41.86947,-87.65548
TA1309000010,7,11,false,16,9,-7,41.87074,-87.62574
SL-009,7,11,false,8,4,-4,41.87081,-87.63121
TA1307000130,7,11,false,8,2,-6,41.87178,-87.65103
SL-008,7,11,false,14,8,-6,41.87209,-87.62956
SL-011,7,11,false,15,8,-7,41.87256,-87.63356
623,7,11,false,39,21,-18,41.87272,-87.62399
SL-010,7,11,false,7,3,-4,41.87501,-87.63309
15541,7,11,false,24,20,-4,41.8758,-87.62086
TA1305000009,7,11,false,12,5,-7,41.87593,-87.63068
TA1305000010,7,11,false,9,20,11,41.87623,-87.62444
624,7,11,false,5,10,5,41.87626,-87.62923
15539,7,11,false,2,5,3,41.87763,-87.64405
13158,7,11,false,13,10,-3,41.87764,-87.64957
13157,7,11,false,7,7,0,41.87773,-87.6548
TA1305000025,7,11,false,9,7,-2,41.87773,-87.63528
TA1309000002,7,11,false,15,19,4,41.87784,-87.62408
TA1309000004,7,11,false,9,1,-8,41.87811,-87.63184
638,7,11,false,6,8,2,41.87827,-87.64078
TA1309000008,7,11,false,6,11,5,41.87933,-87.6355
KA1503000034,7,11,false,6,5,-1,41.87938,-87.63197
KA1503000015,7,11,false,9,2,-7,41.87948,-87.6257
TA1309000007,7,11,false,4,6,2,41.88022,-87.63526
WL-011,7,11,false,11,2,-9,41.88034,-87.64273
13156,7,11,false,8,9,1,41.88042,-87.65554
13300,7,11,false,57,85,28,41.88097,-87.61675
13008,7,11,false,73,59,-14,41.88105,-87.62408
TA1305000006,7,11,false,9,14,5,41.88122,-87.6296
13056,7,11,false,6,2,-4,41.88168,-87.63951
TA1307000120,7,11,false,15,20,5,41.88188,-87.64879
13036,7,11,false,8,12,4,41.8821,-87.62513
TA1305000032,7,11,false,14,2,-12,41.88218,-87.64109
13006,7,11,false,10,2,-8,41.88268,-87.63252
KA1503000072,7,11,false,6,5,-1,41.88317,-87.63693
WL-012,7,11,false,7,5,-2,41.88337,-87.6412
13053,7,11,false,31,20,-11,41.88365,-87.64863
13001,7,11,false,48,36,-12,41.88397,-87.62459
18062,7,11,false,13,8,-5,41.88412,-87.65427
TA1306000010,7,11,false,11,8,-3,41.88419,-87.62961
15535,7,11,false,10,15,5,41.8846,-87.64455
TA1305000029,7,11,false,19,11,-8,41.88466,-87.62787
13263,7,11,false,16,19,3,41.88467,-87.61952
TA1306000015,7,11,false,13,25,12,41.88549,-87.65232
13021,7,11,false,4,15,11,41.88559,-87.64184
TA1307000111,7,11,false,6,4,-2,41.88582,-87.63548
KA1503000012,7,11,false,9,9,0,41.88599,-87.63089
TA1305000011,7,11,false,29,21,-8,41.886,-87.62418
15534,7,11,false,13,6,-7,41.88627,-87.61749
TA1308000029,7,11,false,7,14,7,41.88673,-87.62225
TA1307000131,7,11,false,14,14,0,41.88688,-87.62606
KA1503000064,7,11,false,30,17,-13,41.88697,-87.61281
TA1305000022,7,11,false,7,6,-1,41.88817,-87.63656
TA1306000003,7,11,false,13,12,-1,41.88867,-87.64442
KA1503000043,7,11,false,19,11,-8,41.88918,-87.63851
13050,7,11,false,26,19,-7,41.88919,-87.62775
TA1307000151,7,11,false,19,20,1,41.88993,-87.63427
636,7,11,false,8,7,-1,41.88997,-87.63662
13427,7,11,false,14,13,-1,41.89054,-87.62205
13430,7,11,false,29,31,2,41.89077,-87.63169
TA1306000013,7,11,false,26,23,-3,41.89083,-87.61852
RN-,7,11,false,7,8,1,41.89102,-87.63546
13434,7,11,false,7,4,-3,41.89108,-87.66663
TA1308000006,7,11,false,5,3,-2,41.89128,-87.67686
TA1307000117,7,11,false,16,18,2,41.89144,-87.62675
13033,7,11,false,19,15,-4,41.8916,-87.64835
13194,7,11,false,6,6,0,41.8918,-87.65878
TA1305000003,7,11,false,16,15,-1,41.89187,-87.62061
13022,7,11,false,149,162,13,41.89227,-87.61205
TA1306000029,7,11,false,23,29,6,41.89256,-87.61449
13265,7,11,false,12,8,-4,41.89383,-87.64172
13045,7,11,false,13,11,-2,41.89403,-87.62931
13016,7,11,false,20,23,3,41.89431,-87.62277
KA1503000041,7,11,false,28,16,-12,41.89452,-87.61798
13196,7,11,false,11,2,-9,41.89455,-87.65345
TA1307000062,7,11,false,14,6,-8,41.89466,-87.63839
TA1306000012,7,11,false,26,13,-13,41.89475,-87.63438
KP1705001026,7,11,false,3,6,3,41.89483,-87.6323
13132,7,11,false,6,8,2,41.89573,-87.67718
15530,7,11,false,22,9,-13,41.89575,-87.62596
18003,7,11,false,11,1,-10,41.89575,-87.62011
13247,7,11,false,7,6,-1,41.89597,-87.66775
13289,7,11,false,6,4,-2,41.89638,-87.661
13303,7,11,false,8,4,-4,41.89672,-87.63088
13017,7,11,false,21,1,-20,41.89676,-87.6357
13338,7,11,false,12,10,-2,41.89697,-87.62173
TA1307000061,7,11,false,4,7,3,41.89745,-87.62873
13034,7,11,false,11,20,9,41.89754,-87.62352
TA1306000009,7,11,false,11,3,-8,41.89772,-87.64299
620,7,11,false,12,5,-7,41.89817,-87.63754
15529,7,11,false,8,7,-1,41.89858,-87.62206
TA1307000128,7,11,false,17,24,7,41.89896,-87.6299
657,7,11,false,8,3,-5,41.89918,-87.6722
13248,7,11,false,8,2,-6,41.89964,-87.66788
TA1306000011,7,11,false,7,7,0,41.89994,-87.63443
KA1504000116,7,11,false,5,3,-2,41.90023,-87.64299
13290,7,11,false,6,2,-4,41.90069,-87.66259
13042,7,11,false,71,64,-7,41.90097,-87.62377
TA1307000070,7,11,false,6,2,-4,41.90133,-87.67742
KA1504000133,7,11,false,12,18,6,41.90234,-87.62773
13241,7,11,false,7,3,-4,41.9029,-87.68731
TA1306000006,7,11,false,11,3,-8,41.90292,-87.63772
TA1307000039,7,11,false,20,34,14,41.90294,-87.63137
TA1305000034,7,11,false,15,5,-10,41.90313,-87.67391
KA1504000135,7,11,false,21,27,6,41.90319,-87.63439
13136,7,11,false,7,9,2,41.90326,-87.67845
13061,7,11,false,25,24,-1,41.90342,-87.66779
KA1504000079,7,11,false,9,3,-6,41.9035,-87.64334
TA1308000049,7,11,false,15,22,7,41.90672,-87.6349
KA1504000134,7,11,false,6,5,-1,41.90687,-87.6262
13224,7,11,false,7,8,1,41.90706,-87.66725
13221,7,11,false,10,7,-3,41.90765,-87.67254
TA1309000024,7,11,false,9,9,0,41.908,-87.63152
TA1305000041,7,11,false,16,26,10,41.9094,-87.67769
331,7,11,false,10,11,1,41.90965,-87.64812
15653,7,11,false,5,1,-4,41.90979,-87.7053
TA1305000037,7,11,false,8,11,3,41.91018,-87.67003
TA1308000005,7,11,false,9,1,-8,41.91042,-87.68238
13257,7,11,false,12,2,-10,41.91054,-87.68956
13154,7,11,false,7,9,2,41.91054,-87.65312
13058,7,11,false,6,4,-2,41.91059,-87.64942
TA1307000038,7,11,false,7,11,4,41.91138,-87.63868
LF-005,7,11,false,73,94,21,41.91172,-87.62681
13128,7,11,false,13,19,6,41.91197,-87.63197
TA1308000050,7,11,false,29,36,7,41.91211,-87.6347
13243,7,11,false,6,12,6,41.91262,-87.6814
TA1307000166,7,11,false,11,11,0,41.91386,-87.64877
15655,7,11,false,6,2,-4,41.91401,-87.70514
18067,7,11,false,9,1,-8,41.9146,-87.66796
TA1306000007,7,11,false,5,1,-4,41.91469,-87.64333
13068,7,11,false,8,4,-4,41.91554,-87.68703
13179,7,11,false,28,23,-5,41.9157,-87.63461
13133,7,11,false,9,8,-1,41.91598,-87.67733
TA1305000039,7,11,false,1,5,4,41.9163,-87.66749
15650,7,11,false,3,5,2,41.91711,-87.71023
15651,7,11,false,5,3,-2,41.91752,-87.70181
TA1309000029,7,11,false,8,1,-7,41.9178,-87.68245
TA1309000006,7,11,false,7,7,0,41.91809,-87.64375
TA1307000163,7,11,false,5,2,-3,41.91821,-87.65696
13146,7,11,false,20,30,10,41.91831,-87.63629
13059,7,11,false,30,23,-7,41.91845,-87.65222
13192,7,11,false,10,7,-3,41.91995,-87.64884
13288,7,11,false,8,2,-6,41.92008,-87.67788
TA1309000030,7,11,false,7,10,3,41.92077,-87.66372
TA1309000033,7,11,false,6,12,6,41.92158,-87.65381
13193,7,11,false,13,10,-3,41.92182,-87.64412
13191,7,11,false,13,4,-9,41.92217,-87.63891
13084,7,11,false,4,9,5,41.92268,-87.69715
LP-,7,11,false,27,22,-5,41.92396,-87.63584
TA1307000001,7,11,false,7,6,-1,41.92535,-87.66581
TA1306000026,7,11,false,9,11,2,41.92558,-87.65842
TA1306000016,7,11,false,8,8,0,41.9256,-87.65371
TA1309000019,7,11,false,20,14,-6,41.92586,-87.63897
TA1309000058,7,11,false,16,20,4,41.92591,-87.64927
TA1308000001,7,11,false,29,60,31,41.92627,-87.63086
15646,7,11,false,1,6,5,41.92668,-87.6977
13124,7,11,false,12,11,-1,41.92675,-87.63444
TA1309000023,7,11,false,10,5,-5,41.9287,-87.65383
TA1307000113,7,11,false,6,12,6,41.92878,-87.66391
13296,7,11,false,6,7,1,41.92883,-87.66852
TA1309000061,7,11,false,10,9,-1,41.92915,-87.64909
TA1305000014,7,11,false,18,23,5,41.92956,-87.64313
13085,7,11,false,13,15,2,41.92958,-87.70789
TA1307000142,7,11,false,15,10,-5,41.93125,-87.64432
13276,7,11,false,18,12,-6,41.93132,-87.63874
TA1307000064,7,11,false,9,3,-6,41.93222,-87.65864
TA1306000014,7,11,false,12,9,-3,41.93242,-87.65271
TA1309000039,7,11,false,31,17,-14,41.93258,-87.63642
13294,7,11,false,15,5,-10,41.9326,-87.66595
TA1309000036,7,11,false,13,5,-8,41.93313,-87.64776
TA1307000006,7,11,false,11,11,0,41.93571,-87.6636
13269,7,11,false,7,2,-5,41.93609,-87.66983
TA1307000052,7,11,false,16,16,0,41.93628,-87.65266
TA1307000136,7,11,false,10,9,-1,41.9365,-87.64755
TA1307000041,7,11,false,19,19,0,41.93669,-87.63683
13137,7,11,false,15,13,-2,41.9376,-87.6441
TA1309000042,7,11,false,10,4,-6,41.93937,-87.66836
13229,7,11,false,14,2,-12,41.93946,-87.66376
TA1308000019,7,11,false,13,10,-3,41.93973,-87.65886
13277,7,11,false,23,12,-11,41.9401,-87.64546
TA1307000134,7,11,false,9,14,5,41.94016,-87.65303
13143,7,11,false,2,7,5,41.94059,-87.67853
TA1309000049,7,11,false,28,21,-7,41.94077,-87.63919
13144,7,11,false,6,4,-2,41.9434,-87.67964
TA1309000025,7,11,false,14,10,-4,41.94368,-87.64894
13071,7,11,false,22,11,-11,41.94373,-87.66401
632,7,11,false,10,17,7,41.94453,-87.6547
13278,7,11,false,11,11,0,41.94553,-87.64644
13235,7,11,false,10,10,0,41.94814,-87.66396
13325,7,11,false,7,9,2,41.94907,-87.64863
TA1307000126,7,11,false,14,25,11,41.94936,-87.65451
TA1307000150,7,11,false,24,17,-7,41.94945,-87.64646
13319,7,11,false,8,5,-3,41.95069,-87.6687
TA1307000127,7,11,false,9,10,1,41.9508,-87.65918
13323,7,11,false,11,8,-3,41.95282,-87.65
13063,7,11,false,10,2,-8,41.95424,-87.65441
TA1308000022,7,11,false,20,9,-11,41.95438,-87.64805
13379,7,11,false,8,8,0,41.95786,-87.6495
TA1309000027,7,11,false,10,4,-6,41.9585,-87.65499
13389,7,11,false,7,2,-5,41.961,-87.64958
15622,7,11,false,6,1,-5,41.96108,-87.69544
TA1307000107,7,11,false,15,5,-10,41.96164,-87.65464
TA1308000012,7,11,false,25,26,1,41.96398,-87.63818
13074,7,11,false,5,6,1,41.96521,-87.6582
639,7,11,false,11,9,-2,41.96584,-87.64538
KA1504000127,7,11,false,6,3,-3,41.96587,-87.70083
TA1307000140,7,11,false,1,5,4,41.96643,-87.68865
TA1309000014,7,11,false,10,7,-3,41.96709,-87.66744
TA1307000119,7,11,false,6,4,-2,41.96796,-87.65
TA1308000021,7,11,false,5,8,3,41.96883,-87.65765
TA1309000066,7,11,false,5,1,-4,41.9691,-87.67423
TA1309000041,7,11,false,6,1,-5,41.96951,-87.65471
KA1504000171,7,11,false,9,11,2,41.97161,-87.65016
TA1309000035,7,11,false,15,11,-4,41.97335,-87.66785
13108,7,11,false,4,5,1,41.97379,-87.65971
KA1504000146,7,11,false,4,9,5,41.978,-87.66805
KA1504000152,7,11,false,10,6,-4,41.98403,-87.65231
596,7,11,false,2,6,4,42.04822,-87.68348
E008,7,11,false,2,6,4,42.05049,-87.67782
KA1503000014,7,11,true,4,5,1,41.7851,-87.60108
KA1503000074,7,11,true,10,6,-4,41.79174,-87.58395
TA1309000063,7,11,true,2,5,3,41.79325,-87.5878
TA1308000009,7,11,true,6,7,1,41.79522,-87.58075
TA1309000037,7,11,true,4,9,5,41.79957,-87.59474
KA1503000007,7,11,true,6,4,-2,41.80242,-87.58689
TA1308000046,7,11,true,6,1,-5,41.83779,-87.65115
TA1309000055,7,11,true,3,6,3,41.8382,-87.64514
TA1307000048,7,11,true,5,3,-2,41.83855,-87.60821
TA1308000036,7,11,true,5,2,-3,41.83883,-87.62186
TA1307000139,7,11,true,5,7,2,41.84205,-87.61698
15545,7,11,true,18,25,7,41.85627,-87.61334
13102,7,11,true,8,15,7,41.85762,-87.61942
13150,7,11,true,9,6,-3,41.85783,-87.62455
SL-012,7,11,true,9,6,-3,41.86038,-87.62581
TA1306000002,7,11,true,6,5,-1,41.86238,-87.65108
TA1307000124,7,11,true,10,7,-3,41.86411,-87.62372
13354,7,11,true,3,9,6,41.86524,-87.66651
13431,7,11,true,9,12,3,41.8661,-87.60728
WL-008,7,11,true,7,5,-2,41.86712,-87.64108
TA1305000002,7,11,true,14,19,5,41.86721,-87.62597
15544,7,11,true,12,13,1,41.86723,-87.61536
KA1706005007,7,11,true,7,3,-4,41.86749,-87.63219
SL-005,7,11,true,12,17,5,41.8679,-87.62304
644,7,11,true,6,2,-4,41.86859,-87.68625
13139,7,11,true,2,5,3,41.86893,-87.65913
15550,7,11,true,4,6,2,41.87024,-87.63947
TA1309000010,7,11,true,10,5,-5,41.87074,-87.62574
TA1309000064,7,11,true,3,5,2,41.87127,-87.67369
TA1307000130,7,11,true,7,3,-4,41.87178,-87.65103
TA1307000121,7,11,true,5,8,3,41.87184,-87.64664
SL-008,7,11,true,13,5,-8,41.87209,-87.62956
13332,7,11,true,18,6,-12,41.87219,-87.6615
SL-011,7,11,true,10,7,-3,41.87256,-87.63356
623,7,11,true,4,6,2,41.87272,-87.62399
SL-007,7,11,true,9,3,-6,41.87404,-87.6277
15539,7,11,true,7,3,-4,41.87763,-87.64405
13158,7,11,true,12,4,-8,41.87764,-87.64957
13206,7,11,true,5,4,-1,41.87794,-87.66201
13011,7,11,true,7,3,-4,41.87931,-87.63993
WL-011,7,11,true,11,6,-5,41.88034,-87.64273
13156,7,11,true,8,6,-2,41.88042,-87.65554
13300,7,11,true,17,14,-3,41.88097,-87.61675
13008,7,11,true,10,12,2,41.88105,-87.62408
TA1305000006,7,11,true,3,10,7,41.88122,-87.6296
TA1307000120,7,11,true,18,17,-1,41.88188,-87.64879
13036,7,11,true,2,5,3,41.8821,-87.62513
TA1305000032,7,11,true,10,11,1,41.88218,-87.64109
654,7,11,true,9,10,1,41.88307,-87.65698
13409,7,11,true,5,4,-1,41.8831,-87.6511
WL-012,7,11,true,8,4,-4,41.88337,-87.6412
13053,7,11,true,18,17,-1,41.88365,-87.64863
13001,7,11,true,7,7,0,41.88397,-87.62459
18062,7,11,true,6,4,-2,41.88412,-87.65427
TA1306000010,7,11,true,2,11,9,41.88419,-87.62961
15535,7,11,true,6,6,0,41.8846,-87.64455
TA1305000029,7,11,true,8,11,3,41.88466,-87.62787
13263,7,11,true,9,7,-2,41.88467,-87.61952
TA1306000015,7,11,true,5,18,13,41.88549,-87.65232
13021,7,11,true,11,3,-8,41.88559,-87.64184
KA1503000012,7,11,true,4,5,1,41.88599,-87.63089
TA1305000011,7,11,true,2,6,4,41.886,-87.62418
15534,7,11,true,6,11,5,41.88627,-87.61749
TA1308000029,7,11,true,6,1,-5,41.88673,-87.62225
KA1503000064,7,11,true,10,13,3,41.88697,-87.61281
TA1305000022,7,11,true,22,11,-11,41.88817,-87.63656
TA1306000003,7,11,true,16,25,9,41.88867,-87.64442
KA1503000043,7,11,true,18,19,1,41.88918,-87.63851
13050,7,11,true,8,13,5,41.88919,-87.62775
TA1307000151,7,11,true,8,8,0,41.88993,-87.63427
636,7,11,true,10,11,1,41.88997,-87.63662
13427,7,11,true,4,6,2,41.89054,-87.62205
13430,7,11,true,5,16,11,41.89077,-87.63169
TA1306000013,7,11,true,15,11,-4,41.89083,-87.61852
RN-,7,11,true,8,12,4,41.89102,-87.63546
13434,7,11,true,5,2,-3,41.89108,-87.66663
TA1307000117,7,11,true,12,15,3,41.89144,-87.62675
13033,7,11,true,7,15,8,41.8916,-87.64835
13194,7,11,true,16,9,-7,41.8918,-87.65878
TA1305000003,7,11,true,11,8,-3,41.89187,-87.62061
13022,7,11,true,42,38,-4,41.89227,-87.61205
TA1306000029,7,11,true,9,10,1,41.89256,-87.61449
13265,7,11,true,17,15,-2,41.89383,-87.64172
13045,7,11,true,9,16,7,41.89403,-87.62931
13016,7,11,true,6,3,-3,41.89431,-87.62277
KA1503000041,7,11,true,12,10,-2,41.89452,-87.61798
13196,7,11,true,6,6,0,41.89455,-87.65345
TA1307000062,7,11,true,8,1,-7,41.89466,-87.63839
TA1306000012,7,11,true,22,19,-3,41.89475,-87.63438
KP1705001026,7,11,true,9,7,-2,41.89483,-87.6323
637,7,11,true,7,1,-6,41.89563,-87.67209
13132,7,11,true,3,7,4,41.89573,-87.67718
15530,7,11,true,11,13,2,41.89575,-87.62596
18003,7,11,true,5,2,-3,41.89575,-87.62011
13247,7,11,true,5,5,0,41.89597,-87.66775
TA1305000020,7,11,true,5,9,4,41.89636,-87.65406
13289,7,11,true,8,10,2,41.89638,-87.661
13303,7,11,true,4,9,5,41.89672,-87.63088
13338,7,11,true,6,3,-3,41.89697,-87.62173
TA1307000061,7,11,true,1,5,4,41.89745,-87.62873
13034,7,11,true,12,2,-10,41.89754,-87.62352
TA1306000009,7,11,true,9,8,-1,41.89772,-87.64299
620,7,11,true,8,2,-6,41.89817,-87.63754
KA1504000103,7,11,true,6,1,-5,41.89842,-87.68659
15529,7,11,true,3,8,5,41.89858,-87.62206
TA1307000128,7,11,true,19,17,-2,41.89896,-87.6299
13248,7,11,true,6,1,-5,41.89964,-87.66788
TA1306000011,7,11,true,5,5,0,41.89994,-87.63443
KA1504000116,7,11,true,6,10,4,41.90023,-87.64299
17660,7,11,true,3,7,4,41.90036,-87.69671
13290,7,11,true,12,7,-5,41.90069,-87.66259
13042,7,11,true,22,28,6,41.90097,-87.62377
TA1307000070,7,11,true,7,8,1,41.90133,-87.67742
KA1504000133,7,11,true,15,18,3,41.90234,-87.62773
TA1306000006,7,11,true,3,5,2,41.90292,-87.63772
TA1307000039,7,11,true,28,23,-5,41.90294,-87.63137
TA1305000034,7,11,true,6,9,3,41.90313,-87.67391
KA1504000135,7,11,true,21,21,0,41.90319,-87.63439
13136,7,11,true,3,5,2,41.90326,-87.67845
13061,7,11,true,23,14,-9,41.90342,-87.66779
KA1504000079,7,11,true,14,4,-10,41.9035,-87.64334
TA1307000115,7,11,true,5,9,4,41.9046,-87.64056
TA1308000049,7,11,true,13,17,4,41.90672,-87.6349
KA1504000134,7,11,true,5,7,2,41.90687,-87.6262
13224,7,11,true,14,6,-8,41.90706,-87.66725
TA1307000143,7,11,true,7,5,-2,41.90762,-87.63854
13221,7,11,true,12,6,-6,41.90765,-87.67254
TA1309000024,7,11,true,14,12,-2,41.908,-87.63152
TA1305000041,7,11,true,18,17,-1,41.9094,-87.67769
331,7,11,true,16,21,5,41.90965,-87.64812
TA1305000037,7,11,true,16,9,-7,41.91018,-87.67003
TA1308000005,7,11,true,8,4,-4,41.91042,-87.68238
13154,7,11,true,11,15,4,41.91054,-87.65312
13058,7,11,true,9,16,7,41.91059,-87.64942
TA1307000038,7,11,true,7,7,0,41.91138,-87.63868
LF-005,7,11,true,35,48,13,41.91172,-87.62681
13128,7,11,true,13,9,-4,41.91197,-87.63197
TA1308000050,7,11,true,33,33,0,41.91211,-87.6347
13243,7,11,true,14,7,-7,41.91262,-87.6814
TA1306000032,7,11,true,5,10,5,41.9137,-87.65285
TA1307000166,7,11,true,11,10,-1,41.91386,-87.64877
15655,7,11,true,5,5,0,41.91401,-87.70514
18067,7,11,true,8,6,-2,41.9146,-87.66796
TA1306000007,7,11,true,7,2,-5,41.91469,-87.64333
13068,7,11,true,7,3,-4,41.91554,-87.68703
13179,7,11,true,20,26,6,41.9157,-87.63461
13133,7,11,true,10,7,-3,41.91598,-87.67733
TA1305000039,7,11,true,5,4,-1,41.9163,-87.66749
15650,7,11,true,5,1,-4,41.91711,-87.71023
TA1307000163,7,11,true,9,11,2,41.91821,-87.65696
13146,7,11,true,20,21,1,41.91831,-87.63629
13059,7,11,true,20,10,-10,41.91845,-87.65222
13192,7,11,true,9,11,2,41.91995,-87.64884
13288,7,11,true,7,16,9,41.92008,-87.67788
TA1309000030,7,11,true,6,12,6,41.92077,-87.66372
TA1309000033,7,11,true,15,15,0,41.92158,-87.65381
13193,7,11,true,15,11,-4,41.92182,-87.64412
13191,7,11,true,17,9,-8,41.92217,-87.63891
13084,7,11,true,8,5,-3,41.92268,-87.69715
LP-,7,11,true,8,4,-4,41.92396,-87.63584
TA1307000001,7,11,true,10,5,-5,41.92535,-87.66581
TA1306000026,7,11,true,11,7,-4,41.92558,-87.65842
TA1306000016,7,11,true,3,12,9,41.9256,-87.65371
TA1309000019,7,11,true,15,9,-6,41.92586,-87.63897
TA1309000058,7,11,true,12,19,7,41.92591,-87.64927
TA1308000001,7,11,true,32,32,0,41.92627,-87.63086
13124,7,11,true,5,3,-2,41.92675,-87.63444
TA1309000023,7,11,true,10,15,5,41.9287,-87.65383
TA1307000113,7,11,true,8,7,-1,41.92878,-87.66391
13296,7,11,true,6,3,-3,41.92883,-87.66852
TA1309000059,7,11,true,9,6,-3,41.92889,-87.65898
TA1309000061,7,11,true,13,13,0,41.92915,-87.64909
TA1308000031,7,11,true,7,6,-1,41.92946,-87.68417
TA1305000014,7,11,true,23,12,-11,41.92956,-87.64313
13085,7,11,true,10,6,-4,41.92958,-87.70789
TA1307000142,7,11,true,13,20,7,41.93125,-87.64432
13276,7,11,true,15,23,8,41.93132,-87.63874
13271,7,11,true,7,2,-5,41.93192,-87.67784
TA1307000064,7,11,true,9,6,-3,41.93222,-87.65864
TA1306000014,7,11,true,24,16,-8,41.93242,-87.65271
TA1309000039,7,11,true,9,8,-1,41.93258,-87.63642
TA1309000036,7,11,true,10,14,4,41.93313,-87.64776
TA1307000006,7,11,true,10,6,-4,41.93571,-87.6636
13269,7,11,true,10,1,-9,41.93609,-87.66983
TA1307000052,7,11,true,16,9,-7,41.93628,-87.65266
TA1307000136,7,11,true,20,10,-10,41.9365,-87.64755
TA1307000041,7,11,true,16,11,-5,41.93669,-87.63683
13137,7,11,true,20,12,-8,41.9376,-87.6441
15642,7,11,true,5,5,0,41.93843,-87.69801
KA17018068,7,11,true,5,1,-4,41.93935,-87.68327
TA1309000042,7,11,true,8,12,4,41.93937,-87.66836
TA1308000019,7,11,true,8,7,-1,41.93973,-87.65886
13277,7,11,true,9,14,5,41.9401,-87.64546
TA1307000134,7,11,true,5,18,13,41.94016,-87.65303
TA1309000049,7,11,true,16,13,-3,41.94077,-87.63919
13144,7,11,true,4,5,1,41.9434,-87.67964
TA1309000025,7,11,true,13,17,4,41.94368,-87.64894
13071,7,11,true,12,18,6,41.94373,-87.66401
632,7,11,true,9,9,0,41.94453,-87.6547
13278,7,11,true,15,20,5,41.94553,-87.64644
TA1309000050,7,11,true,2,5,3,41.94618,-87.67331
13235,7,11,true,16,11,-5,41.94814,-87.66396
13325,7,11,true,11,16,5,41.94907,-87.64863
TA1307000126,7,11,true,12,15,3,41.94936,-87.65451
TA1307000150,7,11,true,13,14,1,41.94945,-87.64646
13319,7,11,true,9,4,-5,41.95069,-87.6687
TA1307000127,7,11,true,10,11,1,41.9508,-87.65918
13323,7,11,true,10,11,1,41.95282,-87.65
TA1309000043,7,11,true,8,6,-2,41.95417,-87.66434
13063,7,11,true,8,6,-2,41.95424,-87.65441
TA1308000022,7,11,true,14,11,-3,41.95438,-87.64805
TA1309000026,7,11,true,5,5,0,41.95601,-87.6802
13379,7,11,true,10,8,-2,41.95786,-87.6495
TA1309000027,7,11,true,14,2,-12,41.9585,-87.65499
13389,7,11,true,18,5,-13,41.961,-87.64958
TA1307000144,7,11,true,4,5,1,41.96142,-87.6762
KA1503000022,7,11,true,7,4,-3,41.96158,-87.66609
TA1307000107,7,11,true,15,13,-2,41.96164,-87.65464
TA1307000156,7,11,true,5,6,1,41.96301,-87.68479
TA1308000012,7,11,true,2,13,11,41.96398,-87.63818
13074,7,11,true,6,4,-2,41.96521,-87.6582
639,7,11,true,5,4,-1,41.96584,-87.64538
TA1307000140,7,11,true,6,7,1,41.96643,-87.68865
TA1309000014,7,11,true,3,5,2,41.96709,-87.66744
TA1307000158,7,11,true,6,8,2,41.9671,-87.67904
TA1308000021,7,11,true,3,5,2,41.96883,-87.65765
TA1309000066,7,11,true,6,6,0,41.9691,-87.67423
TA1309000041,7,11,true,6,4,-2,41.96951,-87.65471
KA1504000171,7,11,true,6,13,7,41.97161,-87.65016
TA1309000035,7,11,true,6,7,1,41.97335,-87.66785
13108,7,11,true,4,8,4,41.97379,-87.65971
KA1504000160,7,11,true,5,3,-2,41.97564,-87.70143
KA1504000146,7,11,true,8,11,3,41.978,-87.66805
13109,7,11,true,5,2,-3,41.97835,-87.65976
KA1504000151,7,11,true,7,6,-1,41.98359,-87.66916
KA1504000152,7,11,true,19,22,3,41.98403,-87.65231
15578,7,11,true,1,7,6,41.98405,-87.66027
15575,7,11,true,5,5,0,41.98975,-87.66014
15571,7,11,true,5,2,-3,41.99478,-87.66028
520,7,11,true,5,6,1,42.01597,-87.66859
523,7,11,true,5,4,-1,42.02089,-87.66505
KA1503000002,7,12,false,5,1,-4,41.76641,-87.5657
KA1503000054,7,12,false,4,7,3,41.78061,-87.60582
15491,7,12,false,5,7,2,41.78096,-87.57624
KA1503000014,7,12,false,8,1,-7,41.7851,-87.60108
KA1503000071,7,12,false,11,8,-3,41.79148,-87.59988
KA1503000074,7,12,false,6,8,2,41.79174,-87.58395
TA1308000009,7,12,false,12,21,9,41.79522,-87.58075
KA1503000052,7,12,false,5,4,-1,41.79935,-87.60097
KA1503000059,7,12,false,7,17,10,41.79952,-87.58643
TA1309000037,7,12,false,5,5,0,41.79957,-87.59474
TA1308000035,7,12,false,5,5,0,41.80944,-87.59188
TA1308000007,7,12,false,4,7,3,41.80984,-87.61628
TA1308000038,7,12,false,5,5,0,41.82298,-87.6071
TA1307000129,7,12,false,7,1,-6,41.83104,-87.62683
KA1503000004,7,12,false,8,3,-5,41.83127,-87.6088
TA1309000055,7,12,false,5,3,-2,41.8382,-87.64514
TA1307000048,7,12,false,22,21,-1,41.83855,-87.60821
TA1308000036,7,12,false,5,3,-2,41.83883,-87.62186
TA1307000005,7,12,false,9,6,-3,41.84569,-87.6225
TA1305000004,7,12,false,7,1,-6,41.8514,-87.61884
13075,7,12,false,14,3,-11,41.8531,-87.63192
15546,7,12,false,7,1,-6,41.85416,-87.61916
13089,7,12,false,7,6,-1,41.85497,-87.67567
15545,7,12,false,17,16,-1,41.85627,-87.61334
SL-006,7,12,false,9,6,-3,41.8568,-87.63387
13102,7,12,false,2,6,4,41.85762,-87.61942
13150,7,12,false,6,3,-3,41.85783,-87.62455
13164,7,12,false,6,2,-4,41.85818,-87.65648
SL-012,7,12,false,6,2,-4,41.86038,-87.62581
TA1307000124,7,12,false,6,6,0,41.86411,-87.62372
TA1309000001,7,12,false,6,3,-3,41.86488,-87.64708
13029,7,12,false,14,22,8,41.86531,-87.6179
13431,7,12,false,26,31,5,41.8661,-87.60728
TA1305000002,7,12,false,15,8,-7,41.86721,-87.62597
15544,7,12,false,57,50,-7,41.86723,-87.61536
KA1706005007,7,12,false,5,3,-2,41.86749,-87.63219
SL-005,7,12,false,42,30,-12,41.8679,-87.62304
13160,7,12,false,5,5,0,41.86947,-87.65548
TA1309000010,7,12,false,15,10,-5,41.87074,-87.62574
SL-009,7,12,false,8,3,-5,41.87081,-87.63121
SL-008,7,12,false,8,2,-6,41.87209,-87.62956
SL-011,7,12,false,6,5,-1,41.87256,-87.63356
623,7,12,false,29,14,-15,41.87272,-87.62399
SL-007,7,12,false,5,6,1,41.87404,-87.6277
13028,7,12,false,1,6,5,41.87475,-87.64981
15541,7,12,false,26,19,-7,41.8758,-87.62086
TA1305000009,7,12,false,5,1,-4,41.87593,-87.63068
TA1305000010,7,12,false,17,4,-13,41.87623,-87.62444
624,7,12,false,9,3,-6,41.87626,-87.62923
TA1305000035,7,12,false,8,4,-4,41.87716,-87.62787
13158,7,12,false,7,9,2,41.87764,-87.64957
13157,7,12,false,5,3,-2,41.87773,-87.6548
TA1305000025,7,12,false,8,6,-2,41.87773,-87.63528
TA1309000002,7,12,false,19,11,-8,41.87784,-87.62408
13206,7,12,false,5,2,-3,41.87794,-87.66201
TA1309000004,7,12,false,7,3,-4,41.87811,-87.63184
638,7,12,false,7,10,3,41.87827,-87.64078
TA1305000005,7,12,false,7,3,-4,41.87924,-87.62975
13011,7,12,false,9,14,5,41.87931,-87.63993
TA1309000008,7,12,false,11,7,-4,41.87933,-87.6355
KA1503000015,7,12,false,12,5,-7,41.87948,-87.6257
WL-011,7,12,false,5,2,-3,41.88034,-87.64273
13156,7,12,false,17,10,-7,41.88042,-87.65554
13300,7,12,false,102,93,-9,41.88097,-87.61675
13008,7,12,false,99,85,-14,41.88105,-87.62408
TA1305000006,7,12,false,16,6,-10,41.88122,-87.6296
13056,7,12,false,7,3,-4,41.88168,-87.63951
TA1307000120,7,12,false,24,20,-4,41.88188,-87.64879
13341,7,12,false,11,5,-6,41.88208,-87.63985
13036,7,12,false,27,6,-21,41.8821,-87.62513
TA1305000032,7,12,false,20,10,-10,41.88218,-87.64109
KA1503000072,7,12,false,8,3,-5,41.88317,-87.63693
WL-012,7,12,false,8,10,2,41.88337,-87.6412
13053,7,12,false,17,33,16,41.88365,-87.64863
13001,7,12,false,33,30,-3,41.88397,-87.62459
13155,7,12,false,1,5,4,41.88407,-87.65689
18062,7,12,false,8,9,1,41.88412,-87.65427
TA1306000010,7,12,false,13,7,-6,41.88419,-87.62961
TA1305000030,7,12,false,8,6,-2,41.88459,-87.63178
15535,7,12,false,16,7,-9,41.8846,-87.64455
TA1305000029,7,12,false,18,21,3,41.88466,-87.62787
13263,7,12,false,24,19,-5,41.88467,-87.61952
TA1306000015,7,12,false,10,17,7,41.88549,-87.65232
13021,7,12,false,15,7,-8,41.88559,-87.64184
TA1307000111,7,12,false,10,8,-2,41.88582,-87.63548
13073,7,12,false,5,1,-4,41.88592,-87.66717
KA1503000012,7,12,false,19,9,-10,41.88599,-87.63089
TA1305000011,7,12,false,18,21,3,41.886,-87.62418
15534,7,12,false,8,4,-4,41.88627,-87.61749
13197,7,12,false,2,7,5,41.8866,-87.65816
TA1308000029,7,12,false,12,17,5,41.88673,-87.62225
TA1307000131,7,12,false,11,20,9,41.88688,-87.62606
KA1503000064,7,12,false,48,37,-11,41.88697,-87.61281
TA1305000022,7,12,false,20,10,-10,41.88817,-87.63656
TA1306000003,7,12,false,27,11,-16,41.88867,-87.64442
KA1503000043,7,12,false,12,13,1,41.88918,-87.63851
13050,7,12,false,15,20,5,41.88919,-87.62775
TA1307000151,7,12,false,12,20,8,41.88993,-87.63427
636,7,12,false,11,10,-1,41.88997,-87.63662
KA1503000044,7,12,false,15,13,-2,41.89018,-87.6262
13427,7,12,false,9,2,-7,41.89054,-87.62205
13430,7,12,false,26,15,-11,41.89077,-87.63169
TA1306000013,7,12,false,29,22,-7,41.89083,-87.61852
RN-,7,12,false,12,15,3,41.89102,-87.63546
TA1308000006,7,12,false,11,5,-6,41.89128,-87.67686
TA1307000117,7,12,false,39,44,5,41.89144,-87.62675
13033,7,12,false,15,18,3,41.8916,-87.64835
13194,7,12,false,10,6,-4,41.8918,-87.65878
TA1305000003,7,12,false,28,34,6,41.89187,-87.62061
13022,7,12,false,215,218,3,41.89227,-87.61205
TA1306000029,7,12,false,29,25,-4,41.89256,-87.61449
13265,7,12,false,17,15,-2,41.89383,-87.64172
13045,7,12,false,18,18,0,41.89403,-87.62931
13016,7,12,false,12,21,9,41.89431,-87.62277
KA1503000041,7,12,false,12,11,-1,41.89452,-87.61798
13196,7,12,false,12,6,-6,41.89455,-87.65345
TA1306000012,7,12,false,15,20,5,41.89475,-87.63438
KP1705001026,7,12,false,12,10,-2,41.89483,-87.6323
18058,7,12,false,7,1,-6,41.8955,-87.68201
637,7,12,false,2,5,3,41.89563,-87.67209
13132,7,12,false,11,16,5,41.89573,-87.67718
15530,7,12,false,20,21,1,41.89575,-87.62596
18003,7,12,false,3,5,2,41.89575,-87.62011
13247,7,12,false,13,7,-6,41.89597,-87.66775
TA1305000020,7,12,false,8,3,-5,41.89636,-87.65406
13289,7,12,false,15,5,-10,41.89638,-87.661
13303,7,12,false,5,10,5,41.89672,-87.63088
13338,7,12,false,15,5,-10,41.89697,-87.62173
TA1307000061,7,12,false,5,4,-1,41.89745,-87.62873
13034,7,12,false,15,21,6,41.89754,-87.62352
TA1306000009,7,12,false,15,3,-12,41.89772,-87.64299
620,7,12,false,6,7,1,41.89817,-87.63754
KA1504000103,7,12,false,10,5,-5,41.89842,-87.68659
15529,7,12,false,8,8,0,41.89858,-87.62206
TA1307000128,7,12,false,21,34,13,41.89896,-87.6299
657,7,12,false,10,8,-2,41.89918,-87.6722
13248,7,12,false,12,4,-8,41.89964,-87.66788
TA1306000011,7,12,false,15,15,0,41.89994,-87.63443
KA1504000116,7,12,false,20,4,-16,41.90023,-87.64299
17660,7,12,false,8,3,-5,41.90036,-87.69671
13290,7,12,false,7,7,0,41.90069,-87.66259
13042,7,12,false,92,110,18,41.90097,-87.62377
TA1307000070,7,12,false,19,7,-12,41.90133,-87.67742
KA1504000133,7,12,false,23,31,8,41.90234,-87.62773
13241,7,12,false,9,4,-5,41.9029,-87.68731
TA1307000039,7,12,false,25,25,0,41.90294,-87.63137
TA1305000034,7,12,false,10,11,1,41.90313,-87.67391
KA1504000135,7,12,false,30,22,-8,41.90319,-87.63439
13136,7,12,false,4,5,1,41.90326,-87.67845
13061,7,12,false,20,21,1,41.90342,-87.66779
KA1504000079,7,12,false,8,9,1,41.9035,-87.64334
TA1307000115,7,12,false,5,3,-2,41.9046,-87.64056
TA1308000049,7,12,false,29,26,-3,41.90672,-87.6349
KA1504000134,7,12,false,12,6,-6,41.90687,-87.6262
13224,7,12,false,13,8,-5,41.90706,-87.66725
TA1307000143,7,12,false,7,8,1,41.90762,-87.63854
13221,7,12,false,18,14,-4,41.90765,-87.67254
TA1309000024,7,12,false,15,19,4,41.908,-87.63152
TA1305000041,7,12,false,32,26,-6,41.9094,-87.67769
331,7,12,false,19,23,4,41.90965,-87.64812
TA1305000037,7,12,false,18,6,-12,41.91018,-87.67003
TA1306000008,7,12,false,6,4,-2,41.9102,-87.6435
TA1308000005,7,12,false,8,9,1,41.91042,-87.68238
13258,7,12,false,9,5,-4,41.91043,-87.69718
13154,7,12,false,10,12,2,41.91054,-87.65312
TA1307000038,7,12,false,8,15,7,41.91138,-87.63868
LF-005,7,12,false,86,125,39,41.91172,-87.62681
13128,7,12,false,20,29,9,41.91197,-87.63197
TA1308000050,7,12,false,39,41,2,41.91211,-87.6347
13243,7,12,false,15,12,-3,41.91262,-87.6814
TA1306000032,7,12,false,5,11,6,41.9137,-87.65285
TA1307000166,7,12,false,6,16,10,41.91386,-87.64877
18017,7,12,false,7,6,-1,41.91416,-87.71676
18067,7,12,false,9,15,6,41.9146,-87.66796
TA1306000007,7,12,false,11,8,-3,41.91469,-87.64333
13068,7,12,false,9,4,-5,41.91554,-87.68703
13179,7,12,false,24,27,3,41.9157,-87.63461
13133,7,12,false,6,10,4,41.91598,-87.67733
TA1305000039,7,12,false,8,6,-2,41.9163,-87.66749
15651,7,12,false,9,4,-5,41.91752,-87.70181
13266,7,12,false,5,1,-4,41.91774,-87.69142
TA1309000006,7,12,false,18,17,-1,41.91809,-87.64375
TA1307000163,7,12,false,12,7,-5,41.91821,-87.65696
13146,7,12,false,31,47,16,41.91831,-87.63629
13059,7,12,false,22,24,2,41.91845,-87.65222
13259,7,12,false,5,3,-2,41.91852,-87.69744
13192,7,12,false,19,17,-2,41.91995,-87.64884
13288,7,12,false,6,2,-4,41.92008,-87.67788
TA1309000030,7,12,false,10,6,-4,41.92077,-87.66372
TA1309000033,7,12,false,19,17,-2,41.92158,-87.65381
13193,7,12,false,13,9,-4,41.92182,-87.64412
13191,7,12,false,8,8,0,41.92217,-87.63891
13084,7,12,false,6,8,2,41.92268,-87.69715
LP-,7,12,false,31,33,2,41.92396,-87.63584
KA1504000140,7,12,false,5,3,-2,41.92409,-87.67646
15648,7,12,false,5,2,-3,41.92464,-87.68931
TA1307000001,7,12,false,9,8,-1,41.92535,-87.66581
TA1306000026,7,12,false,8,4,-4,41.92558,-87.65842
TA1306000016,7,12,false,11,7,-4,41.9256,-87.65371
TA1309000019,7,12,false,25,35,10,41.92586,-87.63897
TA1309000058,7,12,false,24,20,-4,41.92591,-87.64927
TA1308000001,7,12,false,57,51,-6,41.92627,-87.63086
15646,7,12,false,7,5,-2,41.92668,-87.6977
13124,7,12,false,15,33,18,41.92675,-87.63444
TA1309000023,7,12,false,10,10,0,41.9287,-87.65383
TA1307000113,7,12,false,15,8,-7,41.92878,-87.66391
13296,7,12,false,9,3,-6,41.92883,-87.66852
TA1309000059,7,12,false,9,10,1,41.92889,-87.65898
TA1309000061,7,12,false,18,18,0,41.92915,-87.64909
TA1308000031,7,12,false,3,8,5,41.92946,-87.68417
TA1305000014,7,12,false,38,32,-6,41.92956,-87.64313
13085,7,12,false,15,8,-7,41.92958,-87.70789
TA1307000142,7,12,false,20,21,1,41.93125,-87.64432
13276,7,12,false,24,22,-2,41.93132,-87.63874
13271,7,12,false,9,1,-8,41.93192,-87.67784
TA1307000064,7,12,false,4,13,9,41.93222,-87.65864
TA1306000014,7,12,false,22,8,-14,41.93242,-87.65271
TA1309000039,7,12,false,41,36,-5,41.93258,-87.63642
13294,7,12,false,6,3,-3,41.9326,-87.66595
TA1309000036,7,12,false,12,13,1,41.93313,-87.64776
TA1307000006,7,12,false,14,4,-10,41.93571,-87.6636
13269,7,12,false,5,2,-3,41.93609,-87.66983
TA1307000052,7,12,false,16,12,-4,41.93628,-87.65266
TA1307000136,7,12,false,16,17,1,41.9365,-87.64755
TA1307000041,7,12,false,25,30,5,41.93669,-87.63683
13137,7,12,false,27,23,-4,41.9376,-87.6441
TA1309000042,7,12,false,10,5,-5,41.93937,-87.66836
13229,7,12,false,7,8,1,41.93946,-87.66376
TA1308000019,7,12,false,15,10,-5,41.93973,-87.65886
13277,7,12,false,14,10,-4,41.9401,-87.64546
TA1307000134,7,12,false,21,26,5,41.94016,-87.65303
TA1309000049,7,12,false,29,34,5,41.94077,-87.63919
TA1307000138,7,12,false,6,5,-1,41.94334,-87.67094
13144,7,12,false,5,1,-4,41.9434,-87.67964
TA1309000025,7,12,false,18,21,3,41.94368,-87.64894
13071,7,12,false,22,20,-2,41.94373,-87.66401
632,7,12,false,31,32,1,41.94453,-87.6547
13278,7,12,false,15,12,-3,41.94553,-87.64644
KA1504000143,7,12,false,5,1,-4,41.94664,-87.68337
13235,7,12,false,15,13,-2,41.94814,-87.66396
13253,7,12,false,5,1,-4,41.9488,-87.67527
13325,7,12,false,11,18,7,41.94907,-87.64863
TA1307000126,7,12,false,9,22,13,41.94936,-87.65451
TA1307000150,7,12,false,17,21,4,41.94945,-87.64646
13319,7,12,false,12,17,5,41.95069,-87.6687
TA1307000127,7,12,false,15,20,5,41.9508,-87.65918
13323,7,12,false,14,13,-1,41.95282,-87.65
TA1309000043,7,12,false,8,4,-4,41.95417,-87.66434
13063,7,12,false,15,8,-7,41.95424,-87.65441
TA1308000022,7,12,false,12,19,7,41.95438,-87.64805
TA1307000149,7,12,false,4,5,1,41.95467,-87.67392
13249,7,12,false,1,6,5,41.95606,-87.66885
TA1308000047,7,12,false,7,7,0,41.95709,-87.6642
13379,7,12,false,13,5,-8,41.95786,-87.6495
TA1309000027,7,12,false,10,5,-5,41.9585,-87.65499
13389,7,12,false,11,7,-4,41.961,-87.64958
TA1307000107,7,12,false,12,2,-10,41.96164,-87.65464
TA1308000012,7,12,false,26,26,0,41.96398,-87.63818
13074,7,12,false,7,4,-3,41.96521,-87.6582
639,7,12,false,7,20,13,41.96584,-87.64538
TA1307000140,7,12,false,9,2,-7,41.96643,-87.68865
TA1307000119,7,12,false,8,5,-3,41.96796,-87.65
TA1308000021,7,12,false,5,2,-3,41.96883,-87.65765
TA1309000066,7,12,false,17,5,-12,41.9691,-87.67423
TA1309000041,7,12,false,9,5,-4,41.96951,-87.65471
KA1504000171,7,12,false,10,7,-3,41.97161,-87.65016
TA1309000035,7,12,false,6,13,7,41.97335,-87.66785
13108,7,12,false,22,6,-16,41.97379,-87.65971
KA1504000146,7,12,false,5,3,-2,41.978,-87.66805
13109,7,12,false,3,7,4,41.97835,-87.65976
KA1504000151,7,12,false,5,5,0,41.98359,-87.66916
KA1504000152,7,12,false,13,24,11,41.98403,-87.65231
15578,7,12,false,5,6,1,41.98405,-87.66027
15575,7,12,false,8,5,-3,41.98975,-87.66014
15571,7,12,false,8,7,-1,41.99478,-87.66028
E002,7,12,false,7,4,-3,42.03256,-87.67912
596,7,12,false,6,8,2,42.04822,-87.68348
E008,7,12,false,6,4,-2,42.05049,-87.67782
604,7,12,false,2,8,6,42.05824,-87.67744
KA1503000014,7,12,true,5,1,-4,41.7851,-87.60108
TA1308000009,7,12,true,5,7,2,41.79522,-87.58075
TA1307000164,7,12,true,2,5,3,41.79527,-87.59647
KA1503000059,7,12,true,7,6,-1,41.79952,-87.58643
TA1309000037,7,12,true,8,7,-1,41.79957,-87.59474
TA1308000045,7,12,true,1,5,4,41.83062,-87.64129
15445,7,12,true,2,7,5,41.83453,-87.63183
TA1309000055,7,12,true,5,3,-2,41.8382,-87.64514
TA1307000048,7,12,true,10,8,-2,41.83855,-87.60821
TA1307000139,7,12,true,6,7,1,41.84205,-87.61698
TA1307000005,7,12,true,5,1,-4,41.84569,-87.6225
13075,7,12,true,4,5,1,41.8531,-87.63192
15546,7,12,true,5,2,-3,41.85416,-87.61916
15545,7,12,true,14,13,-1,41.85627,-87.61334
SL-006,7,12,true,1,5,4,41.8568,-87.63387
13135,7,12,true,5,2,-3,41.85753,-87.66157
13102,7,12,true,6,9,3,41.85762,-87.61942
13150,7,12,true,8,11,3,41.85783,-87.62455
TA1307000159,7,12,true,6,4,-2,41.8579,-87.6687
TA1307000044,7,12,true,5,4,-1,41.85794,-87.64083
13163,7,12,true,5,4,-1,41.85808,-87.65108
13164,7,12,true,8,2,-6,41.85818,-87.65648
SL-012,7,12,true,8,7,-1,41.86038,-87.62581
13304,7,12,true,5,3,-2,41.86126,-87.65659
TA1307000124,7,12,true,14,11,-3,41.86411,-87.62372
13029,7,12,true,3,5,2,41.86531,-87.6179
13431,7,12,true,3,6,3,41.8661,-87.60728
WL-008,7,12,true,9,7,-2,41.86712,-87.64108
TA1305000002,7,12,true,14,16,2,41.86721,-87.62597
15544,7,12,true,7,8,1,41.86723,-87.61536
SL-005,7,12,true,14,19,5,41.8679,-87.62304
644,7,12,true,5,1,-4,41.86859,-87.68625
13139,7,12,true,6,4,-2,41.86893,-87.65913
13285,7,12,true,3,8,5,41.86928,-87.67372
13160,7,12,true,7,11,4,41.86947,-87.65548
15550,7,12,true,6,6,0,41.87024,-87.63947
TA1309000010,7,12,true,7,8,1,41.87074,-87.62574
SL-009,7,12,true,6,2,-4,41.87081,-87.63121
TA1309000064,7,12,true,8,2,-6,41.87127,-87.67369
TA1307000121,7,12,true,7,9,2,41.87184,-87.64664
SL-008,7,12,true,10,9,-1,41.87209,-87.62956
13332,7,12,true,14,10,-4,41.87219,-87.6615
SL-011,7,12,true,13,6,-7,41.87256,-87.63356
SL-007,7,12,true,9,4,-5,41.87404,-87.6277
TA1306000025,7,12,true,4,5,1,41.87464,-87.65703
SL-010,7,12,true,6,1,-5,41.87501,-87.63309
15541,7,12,true,4,7,3,41.8758,-87.62086
13138,7,12,true,1,6,5,41.87723,-87.63941
15539,7,12,true,10,12,2,41.87763,-87.64405
13158,7,12,true,18,14,-4,41.87764,-87.64957
13157,7,12,true,8,8,0,41.87773,-87.6548
TA1305000025,7,12,true,7,5,-2,41.87773,-87.63528
TA1309000002,7,12,true,5,1,-4,41.87784,-87.62408
638,7,12,true,9,8,-1,41.87827,-87.64078
13011,7,12,true,5,3,-2,41.87931,-87.63993
KA1503000015,7,12,true,2,7,5,41.87948,-87.6257
WL-011,7,12,true,6,10,4,41.88034,-87.64273
13156,7,12,true,15,3,-12,41.88042,-87.65554
13300,7,12,true,16,24,8,41.88097,-87.61675
13008,7,12,true,7,18,11,41.88105,-87.62408
TA1305000006,7,12,true,8,7,-1,41.88122,-87.6296
TA1307000120,7,12,true,19,23,4,41.88188,-87.64879
13341,7,12,true,3,7,4,41.88208,-87.63985
TA1305000032,7,12,true,17,14,-3,41.88218,-87.64109
13353,7,12,true,9,3,-6,41.88283,-87.6612
13409,7,12,true,8,3,-5,41.8831,-87.6511
WL-012,7,12,true,13,4,-9,41.88337,-87.6412
13053,7,12,true,16,15,-1,41.88365,-87.64863
13001,7,12,true,4,7,3,41.88397,-87.62459
18062,7,12,true,10,7,-3,41.88412,-87.65427
TA1306000010,7,12,true,5,14,9,41.88419,-87.62961
15535,7,12,true,7,13,6,41.8846,-87.64455
TA1305000029,7,12,true,8,10,2,41.88466,-87.62787
13263,7,12,true,13,7,-6,41.88467,-87.61952
TA1306000015,7,12,true,12,7,-5,41.88549,-87.65232
13021,7,12,true,6,9,3,41.88559,-87.64184
KA1503000012,7,12,true,4,13,9,41.88599,-87.63089
TA1305000011,7,12,true,14,8,-6,41.886,-87.62418
15534,7,12,true,9,9,0,41.88627,-87.61749
TA1308000029,7,12,true,8,1,-7,41.88673,-87.62225
TA1307000131,7,12,true,3,6,3,41.88688,-87.62606
KA1503000064,7,12,true,10,21,11,41.88697,-87.61281
TA1305000022,7,12,true,9,8,-1,41.88817,-87.63656
TA1306000003,7,12,true,23,23,0,41.88867,-87.64442
KA1503000043,7,12,true,18,21,3,41.88918,-87.63851
13050,7,12,true,11,10,-1,41.88919,-87.62775
TA1307000151,7,12,true,13,9,-4,41.88993,-87.63427
636,7,12,true,8,4,-4,41.88997,-87.63662
KA1503000044,7,12,true,5,7,2,41.89018,-87.6262
13427,7,12,true,4,5,1,41.89054,-87.62205
13430,7,12,true,13,13,0,41.89077,-87.63169
TA1306000013,7,12,true,5,10,5,41.89083,-87.61852
RN-,7,12,true,14,7,-7,41.89102,-87.63546
TA1307000117,7,12,true,17,14,-3,41.89144,-87.62675
13033,7,12,true,18,11,-7,41.8916,-87.64835
13194,7,12,true,7,7,0,41.8918,-87.65878
TA1305000003,7,12,true,12,10,-2,41.89187,-87.62061
13022,7,12,true,38,32,-6,41.89227,-87.61205
TA1306000029,7,12,true,8,14,6,41.89256,-87.61449
13265,7,12,true,13,11,-2,41.89383,-87.64172
13045,7,12,true,13,16,3,41.89403,-87.62931
13016,7,12,true,4,5,1,41.89431,-87.62277
KA1503000041,7,12,true,5,5,0,41.89452,-87.61798
13196,7,12,true,9,11,2,41.89455,-87.65345
TA1307000062,7,12,true,6,4,-2,41.89466,-87.63839
TA1306000012,7,12,true,19,14,-5,41.89475,-87.63438
KP1705001026,7,12,true,6,11,5,41.89483,-87.6323
637,7,12,true,8,8,0,41.89563,-87.67209
13132,7,12,true,8,5,-3,41.89573,-87.67718
15530,7,12,true,10,14,4,41.89575,-87.62596
18003,7,12,true,5,3,-2,41.89575,-87.62011
13247,7,12,true,10,3,-7,41.89597,-87.66775
TA1305000020,7,12,true,12,10,-2,41.89636,-87.65406
13289,7,12,true,2,15,13,41.89638,-87.661
13303,7,12,true,7,3,-4,41.89672,-87.63088
13017,7,12,true,7,11,4,41.89676,-87.6357
13338,7,12,true,3,7,4,41.89697,-87.62173
TA1307000061,7,12,true,5,6,1,41.89745,-87.62873
13034,7,12,true,5,1,-4,41.89754,-87.62352
TA1306000009,7,12,true,6,5,-1,41.89772,-87.64299
KA1504000103,7,12,true,2,5,3,41.89842,-87.68659
15529,7,12,true,6,10,4,41.89858,-87.62206
TA1307000128,7,12,true,30,22,-8,41.89896,-87.6299
657,7,12,true,8,6,-2,41.89918,-87.6722
13248,7,12,true,9,6,-3,41.89964,-87.66788
TA1306000011,7,12,true,16,9,-7,41.89994,-87.63443
KA1504000116,7,12,true,15,6,-9,41.90023,-87.64299
17660,7,12,true,2,7,5,41.90036,-87.69671
13290,7,12,true,8,4,-4,41.90069,-87.66259
13042,7,12,true,27,18,-9,41.90097,-87.62377
TA1307000070,7,12,true,8,4,-4,41.90133,-87.67742
KA1504000133,7,12,true,20,10,-10,41.90234,-87.62773
13241,7,12,true,3,5,2,41.9029,-87.68731
TA1307000039,7,12,true,24,28,4,41.90294,-87.63137
TA1305000034,7,12,true,13,9,-4,41.90313,-87.67391
KA1504000135,7,12,true,21,34,13,41.90319,-87.63439
13136,7,12,true,3,6,3,41.90326,-87.67845
13061,7,12,true,9,12,3,41.90342,-87.66779
KA1504000079,7,12,true,8,8,0,41.9035,-87.64334
TA1307000115,7,12,true,5,7,2,41.9046,-87.64056
TA1308000049,7,12,true,20,22,2,41.90672,-87.6349
KA1504000134,7,12,true,7,9,2,41.90687,-87.6262
13224,7,12,true,9,3,-6,41.90706,-87.66725
13221,7,12,true,12,15,3,41.90765,-87.67254
TA1309000024,7,12,true,11,8,-3,41.908,-87.63152
TA1305000041,7,12,true,11,13,2,41.9094,-87.67769
331,7,12,true,13,20,7,41.90965,-87.64812
TA1305000037,7,12,true,8,7,-1,41.91018,-87.67003
TA1308000005,7,12,true,6,6,0,41.91042,-87.68238
13154,7,12,true,15,11,-4,41.91054,-87.65312
13058,7,12,true,11,18,7,41.91059,-87.64942
TA1307000038,7,12,true,8,24,16,41.91138,-87.63868
LF-005,7,12,true,45,49,4,41.91172,-87.62681
13128,7,12,true,18,13,-5,41.91197,-87.63197
TA1308000050,7,12,true,29,25,-4,41.91211,-87.6347
13243,7,12,true,20,13,-7,41.91262,-87.6814
TA1306000032,7,12,true,11,9,-2,41.9137,-87.65285
TA1307000166,7,12,true,14,8,-6,41.91386,-87.64877
18067,7,12,true,9,10,1,41.9146,-87.66796
13068,7,12,true,6,6,0,41.91554,-87.68703
13179,7,12,true,22,15,-7,41.9157,-87.63461
13133,7,12,true,7,14,7,41.91598,-87.67733
TA1305000039,7,12,true,4,9,5,41.9163,-87.66749
15651,7,12,true,5,9,4,41.91752,-87.70181
TA1309000029,7,12,true,9,6,-3,41.9178,-87.68245
TA1309000006,7,12,true,11,5,-6,41.91809,-87.64375
TA1307000163,7,12,true,9,5,-4,41.91821,-87.65696
13146,7,12,true,28,23,-5,41.91831,-87.63629
13059,7,12,true,20,14,-6,41.91845,-87.65222
13192,7,12,true,22,13,-9,41.91995,-87.64884
13288,7,12,true,6,9,3,41.92008,-87.67788
13242,7,12,true,5,5,0,41.92021,-87.69266
TA1309000030,7,12,true,9,8,-1,41.92077,-87.66372
13292,7,12,true,7,2,-5,41.92152,-87.70733
TA1309000033,7,12,true,14,10,-4,41.92158,-87.65381
13193,7,12,true,10,24,14,41.92182,-87.64412
13191,7,12,true,7,9,2,41.92217,-87.63891
13084,7,12,true,8,5,-3,41.92268,-87.69715
LP-,7,12,true,14,6,-8,41.92396,-87.63584
TA1307000001,7,12,true,9,6,-3,41.92535,-87.66581
TA1306000026,7,12,true,11,3,-8,41.92558,-87.65842
TA1306000016,7,12,true,10,10,0,41.9256,-87.65371
TA1309000019,7,12,true,23,16,-7,41.92586,-87.63897
TA1309000058,7,12,true,15,14,-1,41.92591,-87.64927
TA1308000001,7,12,true,13,22,9,41.92627,-87.63086
15646,7,12,true,6,4,-2,41.92668,-87.6977
13124,7,12,true,6,12,6,41.92675,-87.63444
TA1309000023,7,12,true,6,9,3,41.9287,-87.65383
TA1307000113,7,12,true,6,13,7,41.92878,-87.66391
TA1309000059,7,12,true,7,8,1,41.92889,-87.65898
TA1309000061,7,12,true,14,15,1,41.92915,-87.64909
TA1308000031,7,12,true,5,5,0,41.92946,-87.68417
TA1305000014,7,12,true,24,28,4,41.92956,-87.64313
13085,7,12,true,8,13,5,41.92958,-87.70789
TA1307000142,7,12,true,22,19,-3,41.93125,-87.64432
13276,7,12,true,14,10,-4,41.93132,-87.63874
13271,7,12,true,5,6,1,41.93192,-87.67784
TA1307000064,7,12,true,11,15,4,41.93222,-87.65864
TA1306000014,7,12,true,7,6,-1,41.93242,-87.65271
TA1309000039,7,12,true,18,18,0,41.93258,-87.63642
13294,7,12,true,5,5,0,41.9326,-87.66595
TA1309000036,7,12,true,12,14,2,41.93313,-87.64776
TA1307000006,7,12,true,11,10,-1,41.93571,-87.6636
TA1307000052,7,12,true,11,13,2,41.93628,-87.65266
TA1307000136,7,12,true,17,9,-8,41.9365,-87.64755
TA1307000041,7,12,true,17,23,6,41.93669,-87.63683
13137,7,12,true,20,22,2,41.9376,-87.6441
TA1309000042,7,12,true,11,9,-2,41.93937,-87.66836
13229,7,12,true,3,6,3,41.93946,-87.66376
TA1308000019,7,12,true,13,12,-1,41.93973,-87.65886
13277,7,12,true,9,9,0,41.9401,-87.64546
TA1307000134,7,12,true,20,20,0,41.94016,-87.65303
13143,7,12,true,2,5,3,41.94059,-87.67853
TA1309000049,7,12,true,15,14,-1,41.94077,-87.63919
15634,7,12,true,7,7,0,41.94304,-87.68729
TA1307000138,7,12,true,9,8,-1,41.94334,-87.67094
13144,7,12,true,4,7,3,41.9434,-87.67964
TA1309000025,7,12,true,12,20,8,41.94368,-87.64894
13071,7,12,true,17,16,-1,41.94373,-87.66401
632,7,12,true,11,17,6,41.94453,-87.6547
13278,7,12,true,14,16,2,41.94553,-87.64644
15632,7,12,true,1,7,6,41.94664,-87.69463
13235,7,12,true,10,17,7,41.94814,-87.66396
13253,7,12,true,5,3,-2,41.9488,-87.67527
13325,7,12,true,24,22,-2,41.94907,-87.64863
TA1307000126,7,12,true,13,14,1,41.94936,-87.65451
TA1307000150,7,12,true,16,16,0,41.94945,-87.64646
13319,7,12,true,9,2,-7,41.95069,-87.6687
TA1307000127,7,12,true,5,16,11,41.9508,-87.65918
13323,7,12,true,12,12,0,41.95282,-87.65
TA1309000043,7,12,true,7,5,-2,41.95417,-87.66434
13063,7,12,true,5,5,0,41.95424,-87.65441
TA1308000022,7,12,true,8,10,2,41.95438,-87.64805
TA1307000149,7,12,true,2,6,4,41.95467,-87.67392
TA1309000026,7,12,true,5,2,-3,41.95601,-87.6802
TA1308000047,7,12,true,6,4,-2,41.95709,-87.6642
13379,7,12,true,8,8,0,41.95786,-87.6495
TA1309000027,7,12,true,7,7,0,41.9585,-87.65499
13389,7,12,true,13,3,-10,41.961,-87.64958
15622,7,12,true,6,2,-4,41.96108,-87.69544
TA1307000144,7,12,true,6,4,-2,41.96142,-87.6762
KA1503000022,7,12,true,7,2,-5,41.96158,-87.66609
TA1307000107,7,12,true,17,11,-6,41.96164,-87.65464
TA1307000156,7,12,true,4,5,1,41.96301,-87.68479
TA1309000012,7,12,true,6,2,-4,41.96325,-87.67928
TA1308000012,7,12,true,19,28,9,41.96398,-87.63818
13074,7,12,true,6,3,-3,41.96521,-87.6582
639,7,12,true,9,11,2,41.96584,-87.64538
TA1307000140,7,12,true,5,6,1,41.96643,-87.68865
TA1309000014,7,12,true,8,11,3,41.96709,-87.66744
TA1307000158,7,12,true,3,5,2,41.9671,-87.67904
TA1307000119,7,12,true,3,6,3,41.96796,-87.65
TA1308000021,7,12,true,6,3,-3,41.96883,-87.65765
KA1504000080,7,12,true,1,5,4,41.96887,-87.69609
TA1309000066,7,12,true,13,3,-10,41.9691,-87.67423
KA1504000171,7,12,true,4,9,5,41.97161,-87.65016
TA1309000035,7,12,true,13,10,-3,41.97335,-87.66785
13108,7,12,true,11,12,1,41.97379,-87.65971
KA1504000146,7,12,true,10,6,-4,41.978,-87.66805
13109,7,12,true,7,3,-4,41.97835,-87.65976
KA1504000151,7,12,true,6,3,-3,41.98359,-87.66916
KA1504000152,7,12,true,18,13,-5,41.98403,-87.65231
15578,7,12,true,4,6,2,41.98405,-87.66027
15575,7,12,true,5,3,-2,41.98975,-87.66014
15571,7,12,true,4,6,2,41.99478,-87.66028
KA1503000002,7,13,false,5,3,-2,41.76641,-87.5657
15491,7,13,false,5,8,3,41.78096,-87.57624
KA1503000074,7,13,false,10,11,1,41.79174,-87.58395
TA1308000009,7,13,false,24,12,-12,41.79522,-87.58075
TA1307000164,7,13,false,5,6,1,41.79527,-87.59647
KA1503000059,7,13,false,12,7,-5,41.79952,-87.58643
TA1309000037,7,13,false,5,3,-2,41.79957,-87.59474
KA1503000007,7,13,false,3,5,2,41.80242,-87.58689
TA1309000053,7,13,false,5,1,-4,41.80985,-87.60675
KA1503000065,7,13,false,6,2,-4,41.81409,-87.59701
TA1308000045,7,13,false,2,10,8,41.83062,-87.64129
TA1309000055,7,13,false,7,4,-3,41.8382,-87.64514
TA1307000048,7,13,false,18,27,9,41.83855,-87.60821
TA1305000001,7,13,false,9,7,-2,41.85262,-87.6265
13075,7,13,false,11,10,-1,41.8531,-87.63192
15546,7,13,false,6,4,-2,41.85416,-87.61916
13089,7,13,false,5,1,-4,41.85497,-87.67567
15545,7,13,false,22,30,8,41.85627,-87.61334
SL-013,7,13,false,6,3,-3,41.85659,-87.62755
SL-006,7,13,false,3,6,3,41.8568,-87.63387
13102,7,13,false,15,7,-8,41.85762,-87.61942
13150,7,13,false,8,6,-2,41.85783,-87.62455
13099,7,13,false,6,1,-5,41.85784,-87.64627
TA1307000159,7,13,false,6,4,-2,41.8579,-87.6687
13163,7,13,false,1,10,9,41.85808,-87.65108
SL-012,7,13,false,9,1,-8,41.86038,-87.62581
TA1307000124,7,13,false,2,7,5,41.86411,-87.62372
TA1309000001,7,13,false,9,7,-2,41.86488,-87.64708
13431,7,13,false,39,28,-11,41.8661,-87.60728
TA1305000002,7,13,false,20,18,-2,41.86721,-87.62597
15544,7,13,false,54,70,16,41.86723,-87.61536
KA1706005007,7,13,false,7,10,3,41.86749,-87.63219
SL-005,7,13,false,30,28,-2,41.8679,-87.62304
13139,7,13,false,5,2,-3,41.86893,-87.65913
13160,7,13,false,7,3,-4,41.86947,-87.65548
15550,7,13,false,8,2,-6,41.87024,-87.63947
TA1309000010,7,13,false,12,13,1,41.87074,-87.62574
SL-009,7,13,false,5,2,-3,41.87081,-87.63121
TA1307000121,7,13,false,5,3,-2,41.87184,-87.64664
SL-008,7,13,false,23,13,-10,41.87209,-87.62956
SL-011,7,13,false,22,11,-11,41.87256,-87.63356
623,7,13,false,22,24,2,41.87272,-87.62399
SL-007,7,13,false,14,11,-3,41.87404,-87.6277
SL-010,7,13,false,9,4,-5,41.87501,-87.63309
15541,7,13,false,32,36,4,41.8758,-87.62086
TA1305000010,7,13,false,9,6,-3,41.87623,-87.62444
624,7,13,false,6,5,-1,41.87626,-87.62923
TA1305000035,7,13,false,7,5,-2,41.87716,-87.62787
15539,7,13,false,11,6,-5,41.87763,-87.64405
13158,7,13,false,8,5,-3,41.87764,-87.64957
13157,7,13,false,8,4,-4,41.87773,-87.6548
TA1305000025,7,13,false,8,9,1,41.87773,-87.63528
TA1309000002,7,13,false,4,12,8,41.87784,-87.62408
13206,7,13,false,5,2,-3,41.87794,-87.66201
638,7,13,false,10,3,-7,41.87827,-87.64078
13011,7,13,false,19,7,-12,41.87931,-87.63993
TA1309000008,7,13,false,8,5,-3,41.87933,-87.6355
KA1503000015,7,13,false,9,7,-2,41.87948,-87.6257
TA1309000007,7,13,false,7,3,-4,41.88022,-87.63526
WL-011,7,13,false,6,5,-1,41.88034,-87.64273
13156,7,13,false,12,1,-11,41.88042,-87.65554
13300,7,13,false,97,96,-1,41.88097,-87.61675
13008,7,13,false,87,76,-11,41.88105,-87.62408
TA1305000006,7,13,false,6,4,-2,41.88122,-87.6296
13056,7,13,false,16,2,-14,41.88168,-87.63951
TA1307000120,7,13,false,23,9,-14,41.88188,-87.64879
13341,7,13,false,7,5,-2,41.88208,-87.63985
13036,7,13,false,9,12,3,41.8821,-87.62513
TA1305000032,7,13,false,10,8,-2,41.88218,-87.64109
13353,7,13,false,6,8,2,41.88283,-87.6612
13409,7,13,false,3,5,2,41.8831,-87.6511
WL-012,7,13,false,5,3,-2,41.88337,-87.6412
13053,7,13,false,22,22,0,41.88365,-87.64863
13001,7,13,false,27,30,3,41.88397,-87.62459
13155,7,13,false,8,2,-6,41.88407,-87.65689
18062,7,13,false,4,6,2,41.88412,-87.65427
TA1306000010,7,13,false,16,6,-10,41.88419,-87.62961
TA1305000030,7,13,false,7,3,-4,41.88459,-87.63178
15535,7,13,false,13,6,-7,41.8846,-87.64455
TA1305000029,7,13,false,19,12,-7,41.88466,-87.62787
13263,7,13,false,12,19,7,41.88467,-87.61952
TA1306000015,7,13,false,20,12,-8,41.88549,-87.65232
13021,7,13,false,7,21,14,41.88559,-87.64184
TA1307000111,7,13,false,12,8,-4,41.88582,-87.63548
13073,7,13,false,2,11,9,41.88592,-87.66717
KA1503000012,7,13,false,12,6,-6,41.88599,-87.63089
TA1305000011,7,13,false,13,22,9,41.886,-87.62418
15534,7,13,false,5,10,5,41.88627,-87.61749
TA1308000029,7,13,false,12,12,0,41.88673,-87.62225
TA1307000131,7,13,false,23,19,-4,41.88688,-87.62606
KA1503000064,7,13,false,45,56,11,41.88697,-87.61281
TA1305000022,7,13,false,15,5,-10,41.88817,-87.63656
TA1306000003,7,13,false,8,20,12,41.88867,-87.64442
KA1503000043,7,13,false,16,14,-2,41.88918,-87.63851
13050,7,13,false,25,21,-4,41.88919,-87.62775
TA1307000151,7,13,false,16,21,5,41.88993,-87.63427
636,7,13,false,7,4,-3,41.88997,-87.63662
KA1503000044,7,13,false,17,13,-4,41.89018,-87.6262
13427,7,13,false,19,18,-1,41.89054,-87.62205
13430,7,13,false,14,20,6,41.89077,-87.63169
TA1306000013,7,13,false,20,13,-7,41.89083,-87.61852
RN-,7,13,false,13,7,-6,41.89102,-87.63546
TA1308000006,7,13,false,3,5,2,41.89128,-87.67686
TA1307000117,7,13,false,26,18,-8,41.89144,-87.62675
13033,7,13,false,29,19,-10,41.8916,-87.64835
13194,7,13,false,1,9,8,41.8918,-87.65878
TA1305000003,7,13,false,25,34,9,41.89187,-87.62061
13022,7,13,false,260,253,-7,41.89227,-87.61205
TA1306000029,7,13,false,42,30,-12,41.89256,-87.61449
13265,7,13,false,11,17,6,41.89383,-87.64172
13045,7,13,false,29,30,1,41.89403,-87.62931
13016,7,13,false,43,34,-9,41.89431,-87.62277
KA1503000041,7,13,false,5,6,1,41.89452,-87.61798
13196,7,13,false,18,11,-7,41.89455,-87.65345
TA1307000062,7,13,false,5,7,2,41.89466,-87.63839
TA1306000012,7,13,false,29,24,-5,41.89475,-87.63438
KP1705001026,7,13,false,10,4,-6,41.89483,-87.6323
637,7,13,false,3,7,4,41.89563,-87.67209
13132,7,13,false,10,10,0,41.89573,-87.67718
15530,7,13,false,19,12,-7,41.89575,-87.62596
18003,7,13,false,6,4,-2,41.89575,-87.62011
13247,7,13,false,7,7,0,41.89597,-87.66775
TA1305000020,7,13,false,12,8,-4,41.89636,-87.65406
13289,7,13,false,17,4,-13,41.89638,-87.661
13303,7,13,false,14,19,5,41.89672,-87.63088
13017,7,13,false,3,5,2,41.89676,-87.6357
13338,7,13,false,5,14,9,41.89697,-87.62173
TA1307000061,7,13,false,12,6,-6,41.89745,-87.62873
13034,7,13,false,8,11,3,41.89754,-87.62352
TA1306000009,7,13,false,1,5,4,41.89772,-87.64299
KA1504000103,7,13,false,5,5,0,41.89842,-87.68659
15529,7,13,false,15,19,4,41.89858,-87.62206
TA1307000128,7,13,false,25,30,5,41.89896,-87.6299
657,7,13,false,2,5,3,41.89918,-87.6722
13248,7,13,false,6,4,-2,41.89964,-87.66788
TA1306000011,7,13,false,5,2,-3,41.89994,-87.63443
13290,7,13,false,11,6,-5,41.90069,-87.66259
13042,7,13,false,94,110,16,41.90097,-87.62377
KA1504000133,7,13,false,24,23,-1,41.90234,-87.62773
13241,7,13,false,6,4,-2,41.9029,-87.68731
TA1307000039,7,13,false,23,38,15,41.90294,-87.63137
TA1305000034,7,13,false,9,15,6,41.90313,-87.67391
KA1504000135,7,13,false,36,29,-7,41.90319,-87.63439
13136,7,13,false,5,5,0,41.90326,-87.67845
13061,7,13,false,23,13,-10,41.90342,-87.66779
KA1504000079,7,13,false,15,10,-5,41.9035,-87.64334
TA1307000115,7,13,false,6,2,-4,41.9046,-87.64056
TA1308000049,7,13,false,31,44,13,41.90672,-87.6349
KA1504000134,7,13,false,14,22,8,41.90687,-87.6262
13224,7,13,false,8,8,0,41.90706,-87.66725
TA1307000143,7,13,false,5,6,1,41.90762,-87.63854
13221,7,13,false,16,16,0,41.90765,-87.67254
TA1309000024,7,13,false,17,18,1,41.908,-87.63152
TA1305000041,7,13,false,19,38,19,41.9094,-87.67769
331,7,13,false,25,21,-4,41.90965,-87.64812
15653,7,13,false,9,5,-4,41.90979,-87.7053
TA1305000037,7,13,false,4,6,2,41.91018,-87.67003
TA1306000008,7,13,false,8,8,0,41.9102,-87.6435
TA1308000005,7,13,false,9,2,-7,41.91042,-87.68238
13258,7,13,false,2,9,7,41.91043,-87.69718
13257,7,13,false,1,6,5,41.91054,-87.68956
13154,7,13,false,14,13,-1,41.91054,-87.65312
13058,7,13,false,9,5,-4,41.91059,-87.64942
TA1307000038,7,13,false,19,12,-7,41.91138,-87.63868
LF-005,7,13,false,131,133,2,41.91172,-87.62681
13128,7,13,false,18,26,8,41.91197,-87.63197
TA1308000050,7,13,false,48,50,2,41.91211,-87.6347
13243,7,13,false,12,10,-2,41.91262,-87.6814
TA1306000032,7,13,false,16,4,-12,41.9137,-87.65285
TA1307000166,7,13,false,19,12,-7,41.91386,-87.64877
18067,7,13,false,15,6,-9,41.9146,-87.66796
TA1306000007,7,13,false,11,6,-5,41.91469,-87.64333
13068,7,13,false,5,8,3,41.91554,-87.68703
13179,7,13,false,39,62,23,41.9157,-87.63461
13133,7,13,false,5,4,-1,41.91598,-87.67733
TA1305000039,7,13,false,6,2,-4,41.9163,-87.66749
15650,7,13,false,5,3,-2,41.91711,-87.71023
15651,7,13,false,8,8,0,41.91752,-87.70181
TA1309000006,7,13,false,13,7,-6,41.91809,-87.64375
TA1307000163,7,13,false,13,4,-9,41.91821,-87.65696
13146,7,13,false,38,44,6,41.91831,-87.63629
13059,7,13,false,14,16,2,41.91845,-87.65222
13259,7,13,false,9,5,-4,41.91852,-87.69744
13192,7,13,false,14,19,5,41.91995,-87.64884
13288,7,13,false,4,7,3,41.92008,-87.67788
13242,7,13,false,6,5,-1,41.92021,-87.69266
TA1309000030,7,13,false,9,14,5,41.92077,-87.66372
TA1309000033,7,13,false,17,9,-8,41.92158,-87.65381
13193,7,13,false,25,28,3,41.92182,-87.64412
13191,7,13,false,12,12,0,41.92217,-87.63891
LP-,7,13,false,26,54,28,41.92396,-87.63584
KA1504000140,7,13,false,10,3,-7,41.92409,-87.67646
KA1504000090,7,13,false,7,2,-5,41.92483,-87.7145
TA1307000001,7,13,false,10,7,-3,41.92535,-87.66581
TA1306000026,7,13,false,1,11,10,41.92558,-87.65842
TA1306000016,7,13,false,11,4,-7,41.9256,-87.65371
TA1309000019,7,13,false,26,42,16,41.92586,-87.63897
TA1309000058,7,13,false,18,31,13,41.92591,-87.64927
TA1308000001,7,13,false,65,73,8,41.92627,-87.63086
13124,7,13,false,30,32,2,41.92675,-87.63444
TA1309000023,7,13,false,10,12,2,41.9287,-87.65383
TA1307000113,7,13,false,21,9,-12,41.92878,-87.66391
TA1309000059,7,13,false,15,8,-7,41.92889,-87.65898
TA1309000061,7,13,false,13,15,2,41.92915,-87.64909
TA1305000014,7,13,false,22,17,-5,41.92956,-87.64313
13085,7,13,false,15,17,2,41.92958,-87.70789
TA1307000142,7,13,false,33,17,-16,41.93125,-87.64432
13276,7,13,false,16,21,5,41.93132,-87.63874
13271,7,13,false,3,6,3,41.93192,-87.67784
TA1307000064,7,13,false,8,8,0,41.93222,-87.65864
TA1306000014,7,13,false,13,5,-8,41.93242,-87.65271
TA1309000039,7,13,false,38,45,7,41.93258,-87.63642
13294,7,13,false,7,3,-4,41.9326,-87.66595
TA1309000036,7,13,false,19,9,-10,41.93313,-87.64776
TA1307000006,7,13,false,5,9,4,41.93571,-87.6636
13269,7,13,false,5,5,0,41.93609,-87.66983
TA1307000052,7,13,false,15,17,2,41.93628,-87.65266
TA1307000136,7,13,false,21,14,-7,41.9365,-87.64755
TA1307000041,7,13,false,46,33,-13,41.93669,-87.63683
13137,7,13,false,21,24,3,41.9376,-87.6441
TA1309000042,7,13,false,6,12,6,41.93937,-87.66836
TA1308000019,7,13,false,14,12,-2,41.93973,-87.65886
13277,7,13,false,20,14,-6,41.9401,-87.64546
TA1307000134,7,13,false,20,30,10,41.94016,-87.65303
TA1309000049,7,13,false,37,35,-2,41.94077,-87.63919
TA1307000138,7,13,false,13,9,-4,41.94334,-87.67094
TA1309000025,7,13,false,25,28,3,41.94368,-87.64894
13071,7,13,false,14,15,1,41.94373,-87.66401
632,7,13,false,19,21,2,41.94453,-87.6547
13278,7,13,false,14,16,2,41.94553,-87.64644
TA1309000050,7,13,false,5,2,-3,41.94618,-87.67331
13235,7,13,false,10,22,12,41.94814,-87.66396
13325,7,13,false,26,20,-6,41.94907,-87.64863
TA1307000126,7,13,false,10,42,32,41.94936,-87.65451
TA1307000150,7,13,false,20,28,8,41.94945,-87.64646
13319,7,13,false,9,8,-1,41.95069,-87.6687
TA1307000127,7,13,false,24,19,-5,41.9508,-87.65918
13323,7,13,false,19,8,-11,41.95282,-87.65
TA1309000043,7,13,false,5,6,1,41.95417,-87.66434
13063,7,13,false,12,7,-5,41.95424,-87.65441
TA1308000022,7,13,false,18,16,-2,41.95438,-87.64805
13249,7,13,false,5,1,-4,41.95606,-87.66885
13379,7,13,false,10,9,-1,41.95786,-87.6495
TA1309000027,7,13,false,12,5,-7,41.9585,-87.65499
13389,7,13,false,11,27,16,41.961,-87.64958
TA1307000144,7,13,false,8,4,-4,41.96142,-87.6762
TA1309000021,7,13,false,5,1,-4,41.9615,-87.6714
KA1503000022,7,13,false,2,5,3,41.96158,-87.66609
TA1307000107,7,13,false,15,16,1,41.96164,-87.65464
TA1308000012,7,13,false,33,46,13,41.96398,-87.63818
13074,7,13,false,6,5,-1,41.96521,-87.6582
639,7,13,false,6,12,6,41.96584,-87.64538
KA1504000127,7,13,false,5,1,-4,41.96587,-87.70083
TA1307000140,7,13,false,7,2,-5,41.96643,-87.68865
TA1309000014,7,13,false,7,8,1,41.96709,-87.66744
TA1307000119,7,13,false,8,18,10,41.96796,-87.65
TA1308000021,7,13,false,3,8,5,41.96883,-87.65765
TA1309000066,7,13,false,6,12,6,41.9691,-87.67423
TA1309000041,7,13,false,9,15,6,41.96951,-87.65471
KA1504000171,7,13,false,6,13,7,41.97161,-87.65016
TA1309000035,7,13,false,14,9,-5,41.97335,-87.66785
13108,7,13,false,6,3,-3,41.97379,-87.65971
KA1504000146,7,13,false,9,7,-2,41.978,-87.66805
13109,7,13,false,6,6,0,41.97835,-87.65976
KA1504000151,7,13,false,3,6,3,41.98359,-87.66916
KA1504000152,7,13,false,22,22,0,41.98403,-87.65231
15578,7,13,false,9,12,3,41.98405,-87.66027
15575,7,13,false,13,11,-2,41.98975,-87.66014
RP-009,7,13,false,10,3,-7,42.00107,-87.66122
596,7,13,false,2,9,7,42.04822,-87.68348
KA1503000014,7,13,true,7,7,0,41.7851,-87.60108
KA1503000071,7,13,true,7,10,3,41.79148,-87.59988
TA1308000009,7,13,true,8,8,0,41.79522,-87.58075
TA1307000164,7,13,true,5,3,-2,41.79527,-87.59647
KA1503000052,7,13,true,3,5,2,41.79935,-87.60097
TA1309000037,7,13,true,6,7,1,41.79957,-87.59474
KA1503000007,7,13,true,5,4,-1,41.80242,-87.58689
13398,7,13,true,5,2,-3,41.80256,-87.59035
13217,7,13,true,4,5,1,41.83488,-87.61792
TA1309000055,7,13,true,3,6,3,41.8382,-87.64514
TA1307000048,7,13,true,8,7,-1,41.83855,-87.60821
TA1307000139,7,13,true,5,4,-1,41.84205,-87.61698
13075,7,13,true,5,5,0,41.8531,-87.63192
15546,7,13,true,6,1,-5,41.85416,-87.61916
15545,7,13,true,16,16,0,41.85627,-87.61334
SL-013,7,13,true,7,5,-2,41.85659,-87.62755
13135,7,13,true,6,5,-1,41.85753,-87.66157
13102,7,13,true,17,15,-2,41.85762,-87.61942
13150,7,13,true,10,9,-1,41.85783,-87.62455
TA1307000044,7,13,true,3,5,2,41.85794,-87.64083
13164,7,13,true,6,11,5,41.85818,-87.65648
SL-012,7,13,true,7,3,-4,41.86038,-87.62581
TA1307000124,7,13,true,9,8,-1,41.86411,-87.62372
13354,7,13,true,5,1,-4,41.86524,-87.66651
13431,7,13,true,8,14,6,41.8661,-87.60728
WL-008,7,13,true,7,9,2,41.86712,-87.64108
TA1305000002,7,13,true,14,18,4,41.86721,-87.62597
15544,7,13,true,6,11,5,41.86723,-87.61536
KA1706005007,7,13,true,2,7,5,41.86749,-87.63219
SL-005,7,13,true,13,13,0,41.8679,-87.62304
13139,7,13,true,6,4,-2,41.86893,-87.65913
13285,7,13,true,7,6,-1,41.86928,-87.67372
13160,7,13,true,7,5,-2,41.86947,-87.65548
15550,7,13,true,5,3,-2,41.87024,-87.63947
TA1309000010,7,13,true,6,7,1,41.87074,-87.62574
TA1307000130,7,13,true,6,3,-3,41.87178,-87.65103
TA1307000121,7,13,true,12,11,-1,41.87184,-87.64664
SL-008,7,13,true,8,21,13,41.87209,-87.62956
13332,7,13,true,11,5,-6,41.87219,-87.6615
SL-011,7,13,true,6,12,6,41.87256,-87.63356
623,7,13,true,6,5,-1,41.87272,-87.62399
13028,7,13,true,5,2,-3,41.87475,-87.64981
SL-010,7,13,true,8,3,-5,41.87501,-87.63309
15541,7,13,true,4,6,2,41.8758,-87.62086
15539,7,13,true,9,3,-6,41.87763,-87.64405
13158,7,13,true,5,5,0,41.87764,-87.64957
13157,7,13,true,8,7,-1,41.87773,-87.6548
TA1305000025,7,13,true,5,8,3,41.87773,-87.63528
TA1309000002,7,13,true,5,2,-3,41.87784,-87.62408
638,7,13,true,6,6,0,41.87827,-87.64078
13011,7,13,true,7,3,-4,41.87931,-87.63993
KA1503000015,7,13,true,7,9,2,41.87948,-87.6257
WL-011,7,13,true,7,9,2,41.88034,-87.64273
13156,7,13,true,11,16,5,41.88042,-87.65554
13300,7,13,true,21,27,6,41.88097,-87.61675
13008,7,13,true,11,20,9,41.88105,-87.62408
TA1307000120,7,13,true,21,24,3,41.88188,-87.64879
13036,7,13,true,5,2,-3,41.8821,-87.62513
TA1305000032,7,13,true,8,8,0,41.88218,-87.64109
13006,7,13,true,2,5,3,41.88268,-87.63252
13353,7,13,true,9,6,-3,41.88283,-87.6612
654,7,13,true,5,3,-2,41.88307,-87.65698
13409,7,13,true,6,7,1,41.8831,-87.6511
13053,7,13,true,17,14,-3,41.88365,-87.64863
13001,7,13,true,12,7,-5,41.88397,-87.62459
18062,7,13,true,3,9,6,41.88412,-87.65427
TA1306000010,7,13,true,13,14,1,41.88419,-87.62961
TA1305000030,7,13,true,4,5,1,41.88459,-87.63178
15535,7,13,true,8,7,-1,41.8846,-87.64455
TA1305000029,7,13,true,12,8,-4,41.88466,-87.62787
13263,7,13,true,10,8,-2,41.88467,-87.61952
TA1306000015,7,13,true,12,12,0,41.88549,-87.65232
13021,7,13,true,8,14,6,41.88559,-87.64184
TA1307000111,7,13,true,4,5,1,41.88582,-87.63548
13197,7,13,true,4,5,1,41.8866,-87.65816
TA1308000029,7,13,true,6,2,-4,41.88673,-87.62225
KA1503000064,7,13,true,13,13,0,41.88697,-87.61281
TA1305000022,7,13,true,2,6,4,41.88817,-87.63656
TA1306000003,7,13,true,20,20,0,41.88867,-87.64442
KA1503000043,7,13,true,18,17,-1,41.88918,-87.63851
13050,7,13,true,7,12,5,41.88919,-87.62775
TA1307000151,7,13,true,16,7,-9,41.88993,-87.63427
636,7,13,true,5,3,-2,41.88997,-87.63662
KA1503000044,7,13,true,5,4,-1,41.89018,-87.6262
13427,7,13,true,6,9,3,41.89054,-87.62205
13430,7,13,true,9,7,-2,41.89077,-87.63169
TA1306000013,7,13,true,11,18,7,41.89083,-87.61852
RN-,7,13,true,4,7,3,41.89102,-87.63546
TA1308000006,7,13,true,1,7,6,41.89128,-87.67686
TA1307000117,7,13,true,13,17,4,41.89144,-87.62675
13033,7,13,true,15,10,-5,41.8916,-87.64835
TA1305000003,7,13,true,19,12,-7,41.89187,-87.62061
13022,7,13,true,44,28,-16,41.89227,-87.61205
TA1306000029,7,13,true,18,18,0,41.89256,-87.61449
13265,7,13,true,13,15,2,41.89383,-87.64172
13045,7,13,true,14,18,4,41.89403,-87.62931
13016,7,13,true,7,8,1,41.89431,-87.62277
KA1503000041,7,13,true,5,5,0,41.89452,-87.61798
13196,7,13,true,10,7,-3,41.89455,-87.65345
TA1307000062,7,13,true,9,4,-5,41.89466,-87.63839
TA1306000012,7,13,true,21,23,2,41.89475,-87.63438
KP1705001026,7,13,true,7,6,-1,41.89483,-87.6323
637,7,13,true,5,4,-1,41.89563,-87.67209
13132,7,13,true,15,10,-5,41.89573,-87.67718
15530,7,13,true,12,13,1,41.89575,-87.62596
13247,7,13,true,9,8,-1,41.89597,-87.66775
TA1305000020,7,13,true,11,12,1,41.89636,-87.65406
13289,7,13,true,11,5,-6,41.89638,-87.661
13303,7,13,true,8,8,0,41.89672,-87.63088
13017,7,13,true,12,12,0,41.89676,-87.6357
13338,7,13,true,6,6,0,41.89697,-87.62173
13034,7,13,true,9,5,-4,41.89754,-87.62352
TA1306000009,7,13,true,8,3,-5,41.89772,-87.64299
KA1504000103,7,13,true,5,2,-3,41.89842,-87.68659
15529,7,13,true,9,6,-3,41.89858,-87.62206
TA1307000128,7,13,true,19,20,1,41.89896,-87.6299
657,7,13,true,5,3,-2,41.89918,-87.6722
13248,7,13,true,7,6,-1,41.89964,-87.66788
TA1306000011,7,13,true,7,5,-2,41.89994,-87.63443
KA1504000116,7,13,true,3,8,5,41.90023,-87.64299
13290,7,13,true,11,8,-3,41.90069,-87.66259
13042,7,13,true,28,23,-5,41.90097,-87.62377
TA1307000070,7,13,true,11,5,-6,41.90133,-87.67742
KA1504000133,7,13,true,9,14,5,41.90234,-87.62773
13241,7,13,true,5,3,-2,41.9029,-87.68731
TA1307000039,7,13,true,36,34,-2,41.90294,-87.63137
658,7,13,true,5,4,-1,41.903,-87.6838
TA1305000034,7,13,true,12,12,0,41.90313,-87.67391
KA1504000135,7,13,true,17,18,1,41.90319,-87.63439
13136,7,13,true,7,4,-3,41.90326,-87.67845
13061,7,13,true,15,17,2,41.90342,-87.66779
KA1504000079,7,13,true,8,9,1,41.9035,-87.64334
TA1307000115,7,13,true,6,5,-1,41.9046,-87.64056
TA1308000049,7,13,true,26,19,-7,41.90672,-87.6349
KA1504000134,7,13,true,2,5,3,41.90687,-87.6262
13224,7,13,true,8,8,0,41.90706,-87.66725
TA1307000143,7,13,true,2,6,4,41.90762,-87.63854
13221,7,13,true,12,17,5,41.90765,-87.67254
TA1309000024,7,13,true,16,19,3,41.908,-87.63152
TA1305000041,7,13,true,17,17,0,41.9094,-87.67769
331,7,13,true,17,23,6,41.90965,-87.64812
TA1305000037,7,13,true,7,7,0,41.91018,-87.67003
TA1306000008,7,13,true,8,5,-3,41.9102,-87.6435
TA1308000005,7,13,true,5,11,6,41.91042,-87.68238
13258,7,13,true,5,6,1,41.91043,-87.69718
13257,7,13,true,5,4,-1,41.91054,-87.68956
13154,7,13,true,14,20,6,41.91054,-87.65312
13058,7,13,true,15,10,-5,41.91059,-87.64942
TA1307000038,7,13,true,13,10,-3,41.91138,-87.63868
LF-005,7,13,true,33,40,7,41.91172,-87.62681
13128,7,13,true,18,16,-2,41.91197,-87.63197
TA1308000050,7,13,true,36,35,-1,41.91211,-87.6347
13243,7,13,true,12,8,-4,41.91262,-87.6814
TA1306000032,7,13,true,15,11,-4,41.9137,-87.65285
TA1307000166,7,13,true,17,8,-9,41.91386,-87.64877
18067,7,13,true,9,6,-3,41.9146,-87.66796
TA1306000007,7,13,true,5,3,-2,41.91469,-87.64333
13179,7,13,true,32,23,-9,41.9157,-87.63461
13133,7,13,true,4,11,7,41.91598,-87.67733
15651,7,13,true,8,4,-4,41.91752,-87.70181
TA1309000006,7,13,true,2,15,13,41.91809,-87.64375
TA1307000163,7,13,true,8,11,3,41.91821,-87.65696
13146,7,13,true,23,31,8,41.91831,-87.63629
13059,7,13,true,26,29,3,41.91845,-87.65222
13259,7,13,true,5,5,0,41.91852,-87.69744
13192,7,13,true,15,16,1,41.91995,-87.64884
13288,7,13,true,5,5,0,41.92008,-87.67788
13242,7,13,true,5,8,3,41.92021,-87.69266
TA1309000030,7,13,true,12,7,-5,41.92077,-87.66372
13292,7,13,true,1,5,4,41.92152,-87.70733
TA1309000033,7,13,true,16,14,-2,41.92158,-87.65381
13193,7,13,true,17,19,2,41.92182,-87.64412
13191,7,13,true,8,6,-2,41.92217,-87.63891
13084,7,13,true,6,4,-2,41.92268,-87.69715
LP-,7,13,true,15,25,10,41.92396,-87.63584
KA1504000140,7,13,true,2,5,3,41.92409,-87.67646
TA1307000001,7,13,true,11,11,0,41.92535,-87.66581
TA1306000026,7,13,true,8,11,3,41.92558,-87.65842
TA1306000016,7,13,true,15,13,-2,41.9256,-87.65371
TA1309000019,7,13,true,26,26,0,41.92586,-87.63897
TA1309000058,7,13,true,12,20,8,41.92591,-87.64927
TA1308000001,7,13,true,28,23,-5,41.92627,-87.63086
15646,7,13,true,4,5,1,41.92668,-87.6977
13124,7,13,true,9,12,3,41.92675,-87.63444
TA1309000023,7,13,true,6,7,1,41.9287,-87.65383
TA1307000113,7,13,true,19,10,-9,41.92878,-87.66391
13296,7,13,true,4,9,5,41.92883,-87.66852
TA1309000059,7,13,true,11,7,-4,41.92889,-87.65898
TA1309000061,7,13,true,10,11,1,41.92915,-87.64909
TA1305000014,7,13,true,16,15,-1,41.92956,-87.64313
13085,7,13,true,7,14,7,41.92958,-87.70789
TA1307000142,7,13,true,25,15,-10,41.93125,-87.64432
13276,7,13,true,19,11,-8,41.93132,-87.63874
13271,7,13,true,4,6,2,41.93192,-87.67784
TA1307000064,7,13,true,15,12,-3,41.93222,-87.65864
TA1306000014,7,13,true,15,10,-5,41.93242,-87.65271
TA1309000039,7,13,true,28,27,-1,41.93258,-87.63642
TA1309000036,7,13,true,8,13,5,41.93313,-87.64776
TA1307000006,7,13,true,17,5,-12,41.93571,-87.6636
TA1307000052,7,13,true,14,14,0,41.93628,-87.65266
TA1307000136,7,13,true,16,22,6,41.9365,-87.64755
TA1307000041,7,13,true,12,30,18,41.93669,-87.63683
13137,7,13,true,23,25,2,41.9376,-87.6441
15642,7,13,true,3,6,3,41.93843,-87.69801
TA1309000042,7,13,true,12,9,-3,41.93937,-87.66836
13229,7,13,true,5,3,-2,41.93946,-87.66376
TA1308000019,7,13,true,7,14,7,41.93973,-87.65886
13277,7,13,true,13,18,5,41.9401,-87.64546
TA1307000134,7,13,true,16,23,7,41.94016,-87.65303
TA1309000049,7,13,true,15,17,2,41.94077,-87.63919
TA1307000138,7,13,true,12,6,-6,41.94334,-87.67094
TA1309000025,7,13,true,18,22,4,41.94368,-87.64894
13071,7,13,true,19,24,5,41.94373,-87.66401
632,7,13,true,12,12,0,41.94453,-87.6547
13278,7,13,true,16,17,1,41.94553,-87.64644
13235,7,13,true,14,12,-2,41.94814,-87.66396
13325,7,13,true,10,9,-1,41.94907,-87.64863
TA1307000126,7,13,true,12,22,10,41.94936,-87.65451
TA1307000150,7,13,true,12,24,12,41.94945,-87.64646
13319,7,13,true,7,11,4,41.95069,-87.6687
TA1307000127,7,13,true,9,15,6,41.9508,-87.65918
13323,7,13,true,12,7,-5,41.95282,-87.65
TA1309000043,7,13,true,5,3,-2,41.95417,-87.66434
13063,7,13,true,10,6,-4,41.95424,-87.65441
TA1308000022,7,13,true,14,11,-3,41.95438,-87.64805
TA1307000149,7,13,true,4,6,2,41.95467,-87.67392
TA1309000026,7,13,true,5,5,0,41.95601,-87.6802
13379,7,13,true,10,8,-2,41.95786,-87.6495
TA1309000027,7,13,true,6,13,7,41.9585,-87.65499
13389,7,13,true,13,14,1,41.961,-87.64958
TA1307000144,7,13,true,3,6,3,41.96142,-87.6762
TA1309000021,7,13,true,5,5,0,41.9615,-87.6714
15623,7,13,true,6,10,4,41.96154,-87.69117
KA1503000022,7,13,true,3,7,4,41.96158,-87.66609
TA1307000107,7,13,true,7,15,8,41.96164,-87.65464
TA1307000156,7,13,true,6,7,1,41.96301,-87.68479
TA1309000012,7,13,true,6,1,-5,41.96325,-87.67928
TA1308000012,7,13,true,27,26,-1,41.96398,-87.63818
13074,7,13,true,9,3,-6,41.96521,-87.6582
639,7,13,true,12,13,1,41.96584,-87.64538
TA1307000140,7,13,true,11,5,-6,41.96643,-87.68865
TA1307000158,7,13,true,8,5,-3,41.9671,-87.67904
TA1307000119,7,13,true,6,3,-3,41.96796,-87.65
TA1308000021,7,13,true,6,8,2,41.96883,-87.65765
TA1309000066,7,13,true,13,7,-6,41.9691,-87.67423
TA1309000041,7,13,true,5,3,-2,41.96951,-87.65471
KA1504000171,7,13,true,5,8,3,41.97161,-87.65016
TA1309000035,7,13,true,6,6,0,41.97335,-87.66785
KA1504000146,7,13,true,10,12,2,41.978,-87.66805
13109,7,13,true,9,13,4,41.97835,-87.65976
KA1504000152,7,13,true,16,21,5,41.98403,-87.65231
15578,7,13,true,4,13,9,41.98405,-87.66027
15575,7,13,true,5,9,4,41.98975,-87.66014
15571,7,13,true,4,10,6,41.99478,-87.66028
KA1504000159,7,13,true,6,3,-3,42.01059,-87.66241
E002,7,13,true,6,3,-3,42.03256,-87.67912
596,7,13,true,4,7,3,42.04822,-87.68348
KA1503000071,7,14,false,7,12,5,41.79148,-87.59988
KA1503000074,7,14,false,19,17,-2,41.79174,-87.58395
TA1309000063,7,14,false,1,6,5,41.79325,-87.5878
TA1308000009,7,14,false,18,25,7,41.79522,-87.58075
TA1307000164,7,14,false,6,8,2,41.79527,-87.59647
KA1503000052,7,14,false,5,3,-2,41.79935,-87.60097
KA1503000059,7,14,false,5,10,5,41.79952,-87.58643
TA1309000037,7,14,false,8,7,-1,41.79957,-87.59474
KA1503000007,7,14,false,5,3,-2,41.80242,-87.58689
KA1503000065,7,14,false,2,6,4,41.81409,-87.59701
TA1308000038,7,14,false,6,6,0,41.82298,-87.6071
TA1308000043,7,14,false,1,8,7,41.83066,-87.64715
KA1503000004,7,14,false,7,9,2,41.83127,-87.6088
TA1307000048,7,14,false,28,20,-8,41.83855,-87.60821
TA1307000005,7,14,false,6,2,-4,41.84569,-87.6225
TA1305000001,7,14,false,8,5,-3,41.85262,-87.6265
13075,7,14,false,3,14,11,41.8531,-87.63192
15545,7,14,false,23,23,0,41.85627,-87.61334
SL-013,7,14,false,8,8,0,41.85659,-87.62755
SL-006,7,14,false,4,6,2,41.8568,-87.63387
13102,7,14,false,11,13,2,41.85762,-87.61942
13150,7,14,false,6,11,5,41.85783,-87.62455
13163,7,14,false,5,1,-4,41.85808,-87.65108
TA1307000124,7,14,false,8,2,-6,41.86411,-87.62372
TA1309000001,7,14,false,5,4,-1,41.86488,-87.64708
13029,7,14,false,24,13,-11,41.86531,-87.6179
13431,7,14,false,42,39,-3,41.8661,-87.60728
WL-008,7,14,false,12,8,-4,41.86712,-87.64108
TA1305000002,7,14,false,9,16,7,41.86721,-87.62597
15544,7,14,false,105,81,-24,41.86723,-87.61536
TA1305000017,7,14,false,5,2,-3,41.86734,-87.64863
SL-005,7,14,false,37,37,0,41.8679,-87.62304
13160,7,14,false,4,5,1,41.86947,-87.65548
15550,7,14,false,2,11,9,41.87024,-87.63947
TA1309000010,7,14,false,12,14,2,41.87074,-87.62574
SL-008,7,14,false,22,17,-5,41.87209,-87.62956
13332,7,14,false,6,6,0,41.87219,-87.6615
SL-011,7,14,false,13,12,-1,41.87256,-87.63356
623,7,14,false,25,43,18,41.87272,-87.62399
SL-007,7,14,false,7,4,-3,41.87404,-87.6277
TA1306000025,7,14,false,5,2,-3,41.87464,-87.65703
15541,7,14,false,43,42,-1,41.8758,-87.62086
TA1305000010,7,14,false,7,13,6,41.87623,-87.62444
TA1305000035,7,14,false,5,7,2,41.87716,-87.62787
13138,7,14,false,5,2,-3,41.87723,-87.63941
15539,7,14,false,3,5,2,41.87763,-87.64405
13158,7,14,false,9,5,-4,41.87764,-87.64957
TA1305000025,7,14,false,13,8,-5,41.87773,-87.63528
TA1309000002,7,14,false,16,15,-1,41.87784,-87.62408
TA1309000004,7,14,false,5,1,-4,41.87811,-87.63184
638,7,14,false,12,2,-10,41.87827,-87.64078
13011,7,14,false,10,4,-6,41.87931,-87.63993
TA1309000008,7,14,false,3,8,5,41.87933,-87.6355
KA1503000034,7,14,false,4,6,2,41.87938,-87.63197
KA1503000015,7,14,false,13,11,-2,41.87948,-87.6257
WL-011,7,14,false,10,7,-3,41.88034,-87.64273
13156,7,14,false,17,12,-5,41.88042,-87.65554
13300,7,14,false,134,112,-22,41.88097,-87.61675
13008,7,14,false,105,126,21,41.88105,-87.62408
TA1305000006,7,14,false,15,11,-4,41.88122,-87.6296
TA1307000120,7,14,false,15,29,14,41.88188,-87.64879
13341,7,14,false,5,8,3,41.88208,-87.63985
13036,7,14,false,18,11,-7,41.8821,-87.62513
TA1305000032,7,14,false,16,9,-7,41.88218,-87.64109
13353,7,14,false,5,5,0,41.88283,-87.6612
13409,7,14,false,8,9,1,41.8831,-87.6511
13053,7,14,false,36,20,-16,41.88365,-87.64863
13001,7,14,false,27,54,27,41.88397,-87.62459
13155,7,14,false,7,3,-4,41.88407,-87.65689
18062,7,14,false,11,6,-5,41.88412,-87.65427
TA1306000010,7,14,false,6,12,6,41.88419,-87.62961
TA1305000030,7,14,false,6,11,5,41.88459,-87.63178
15535,7,14,false,9,9,0,41.8846,-87.64455
TA1305000029,7,14,false,24,19,-5,41.88466,-87.62787
13263,7,14,false,19,14,-5,41.88467,-87.61952
TA1306000015,7,14,false,24,26,2,41.88549,-87.65232
13021,7,14,false,16,7,-9,41.88559,-87.64184
TA1307000111,7,14,false,7,6,-1,41.88582,-87.63548
KA1503000012,7,14,false,9,11,2,41.88599,-87.63089
TA1305000011,7,14,false,25,28,3,41.886,-87.62418
15534,7,14,false,13,9,-4,41.88627,-87.61749
13197,7,14,false,5,7,2,41.8866,-87.65816
TA1308000029,7,14,false,7,9,2,41.88673,-87.62225
TA1307000131,7,14,false,22,32,10,41.88688,-87.62606
KA1503000064,7,14,false,37,39,2,41.88697,-87.61281
TA1305000022,7,14,false,8,12,4,41.88817,-87.63656
TA1306000003,7,14,false,11,8,-3,41.88867,-87.64442
KA1503000043,7,14,false,14,16,2,41.88918,-87.63851
13050,7,14,false,23,28,5,41.88919,-87.62775
TA1307000151,7,14,false,19,14,-5,41.88993,-87.63427
636,7,14,false,8,9,1,41.88997,-87.63662
KA1503000044,7,14,false,7,5,-2,41.89018,-87.6262
13427,7,14,false,17,8,-9,41.89054,-87.62205
13430,7,14,false,21,23,2,41.89077,-87.63169
TA1306000013,7,14,false,17,26,9,41.89083,-87.61852
RN-,7,14,false,9,10,1,41.89102,-87.63546
13434,7,14,false,5,4,-1,41.89108,-87.66663
TA1308000006,7,14,false,5,3,-2,41.89128,-87.67686
TA1307000117,7,14,false,29,37,8,41.89144,-87.62675
13033,7,14,false,19,16,-3,41.8916,-87.64835
13194,7,14,false,4,6,2,41.8918,-87.65878
TA1305000003,7,14,false,27,23,-4,41.89187,-87.62061
643,7,14,false,1,5,4,41.89203,-87.68939
13022,7,14,false,300,285,-15,41.89227,-87.61205
TA1306000029,7,14,false,29,35,6,41.89256,-87.61449
13265,7,14,false,16,14,-2,41.89383,-87.64172
13045,7,14,false,15,22,7,41.89403,-87.62931
13016,7,14,false,23,18,-5,41.89431,-87.62277
KA1503000041,7,14,false,6,4,-2,41.89452,-87.61798
13196,7,14,false,10,2,-8,41.89455,-87.65345
TA1307000062,7,14,false,7,5,-2,41.89466,-87.63839
TA1306000012,7,14,false,15,23,8,41.89475,-87.63438
KP1705001026,7,14,false,11,15,4,41.89483,-87.6323
637,7,14,false,5,2,-3,41.89563,-87.67209
13132,7,14,false,4,9,5,41.89573,-87.67718
15530,7,14,false,21,30,9,41.89575,-87.62596
18003,7,14,false,8,8,0,41.89575,-87.62011
13247,7,14,false,7,8,1,41.89597,-87.66775
TA1305000020,7,14,false,21,13,-8,41.89636,-87.65406
13289,7,14,false,7,6,-1,41.89638,-87.661
13303,7,14,false,5,9,4,41.89672,-87.63088
13017,7,14,false,6,2,-4,41.89676,-87.6357
13338,7,14,false,17,12,-5,41.89697,-87.62173
TA1307000061,7,14,false,14,9,-5,41.89745,-87.62873
13034,7,14,false,21,18,-3,41.89754,-87.62352
620,7,14,false,5,10,5,41.89817,-87.63754
15529,7,14,false,18,15,-3,41.89858,-87.62206
TA1307000128,7,14,false,22,17,-5,41.89896,-87.6299
657,7,14,false,7,2,-5,41.89918,-87.6722
13248,7,14,false,6,5,-1,41.89964,-87.66788
TA1306000011,7,14,false,5,3,-2,41.89994,-87.63443
17660,7,14,false,9,4,-5,41.90036,-87.69671
13290,7,14,false,6,2,-4,41.90069,-87.66259
13042,7,14,false,126,108,-18,41.90097,-87.62377
TA1307000070,7,14,false,4,6,2,41.90133,-87.67742
KA1504000133,7,14,false,13,12,-1,41.90234,-87.62773
TA1306000006,7,14,false,8,5,-3,41.90292,-87.63772
TA1307000039,7,14,false,28,30,2,41.90294,-87.63137
13256,7,14,false,8,1,-7,41.90302,-87.69749
TA1305000034,7,14,false,13,7,-6,41.90313,-87.67391
KA1504000135,7,14,false,21,28,7,41.90319,-87.63439
13136,7,14,false,9,6,-3,41.90326,-87.67845
13061,7,14,false,27,20,-7,41.90342,-87.66779
KA1504000079,7,14,false,7,8,1,41.9035,-87.64334
TA1308000049,7,14,false,19,25,6,41.90672,-87.6349
KA1504000134,7,14,false,7,9,2,41.90687,-87.6262
13224,7,14,false,12,10,-2,41.90706,-87.66725
TA1307000143,7,14,false,8,6,-2,41.90762,-87.63854
13221,7,14,false,21,25,4,41.90765,-87.67254
TA1309000024,7,14,false,32,36,4,41.908,-87.63152
TA1305000041,7,14,false,16,9,-7,41.9094,-87.67769
331,7,14,false,10,11,1,41.90965,-87.64812
15653,7,14,false,4,5,1,41.90979,-87.7053
TA1305000037,7,14,false,7,8,1,41.91018,-87.67003
TA1306000008,7,14,false,7,19,12,41.9102,-87.6435
TA1308000005,7,14,false,10,2,-8,41.91042,-87.68238
13258,7,14,false,3,7,4,41.91043,-87.69718
13257,7,14,false,1,5,4,41.91054,-87.68956
13154,7,14,false,7,14,7,41.91054,-87.65312
13058,7,14,false,13,16,3,41.91059,-87.64942
TA1307000038,7,14,false,13,10,-3,41.91138,-87.63868
LF-005,7,14,false,132,170,38,41.91172,-87.62681
13128,7,14,false,13,18,5,41.91197,-87.63197
TA1308000050,7,14,false,45,61,16,41.91211,-87.6347
13243,7,14,false,5,5,0,41.91262,-87.6814
TA1306000032,7,14,false,8,9,1,41.9137,-87.65285
TA1307000166,7,14,false,11,6,-5,41.91386,-87.64877
15655,7,14,false,6,7,1,41.91401,-87.70514
18067,7,14,false,11,10,-1,41.9146,-87.66796
TA1306000007,7,14,false,5,4,-1,41.91469,-87.64333
13068,7,14,false,9,6,-3,41.91554,-87.68703
13179,7,14,false,37,41,4,41.9157,-87.63461
13133,7,14,false,11,10,-1,41.91598,-87.67733
TA1305000039,7,14,false,7,6,-1,41.9163,-87.66749
15651,7,14,false,13,5,-8,41.91752,-87.70181
TA1309000029,7,14,false,1,7,6,41.9178,-87.68245
TA1309000006,7,14,false,9,12,3,41.91809,-87.64375
TA1307000163,7,14,false,10,2,-8,41.91821,-87.65696
13146,7,14,false,60,55,-5,41.91831,-87.63629
13059,7,14,false,19,22,3,41.91845,-87.65222
13192,7,14,false,21,19,-2,41.91995,-87.64884
13288,7,14,false,7,8,1,41.92008,-87.67788
13242,7,14,false,6,3,-3,41.92021,-87.69266
TA1309000030,7,14,false,8,6,-2,41.92077,-87.66372
TA1309000033,7,14,false,15,8,-7,41.92158,-87.65381
13193,7,14,false,27,23,-4,41.92182,-87.64412
13191,7,14,false,6,13,7,41.92217,-87.63891
13084,7,14,false,6,9,3,41.92268,-87.69715
LP-,7,14,false,43,39,-4,41.92396,-87.63584
TA1307000001,7,14,false,14,14,0,41.92535,-87.66581
TA1306000026,7,14,false,11,3,-8,41.92558,-87.65842
TA1306000016,7,14,false,11,8,-3,41.9256,-87.65371
TA1309000019,7,14,false,30,30,0,41.92586,-87.63897
TA1309000058,7,14,false,27,21,-6,41.92591,-87.64927
TA1308000001,7,14,false,80,91,11,41.92627,-87.63086
13124,7,14,false,35,23,-12,41.92675,-87.63444
TA1309000023,7,14,false,10,11,1,41.9287,-87.65383
TA1307000113,7,14,false,12,15,3,41.92878,-87.66391
13296,7,14,false,12,7,-5,41.92883,-87.66852
TA1309000059,7,14,false,6,5,-1,41.92889,-87.65898
TA1309000061,7,14,false,29,19,-10,41.92915,-87.64909
TA1308000031,7,14,false,4,9,5,41.92946,-87.68417
TA1305000014,7,14,false,23,24,1,41.92956,-87.64313
13085,7,14,false,12,21,9,41.92958,-87.70789
15643,7,14,false,5,6,1,41.93057,-87.7238
TA1307000142,7,14,false,15,12,-3,41.93125,-87.64432
13276,7,14,false,21,31,10,41.93132,-87.63874
13271,7,14,false,5,3,-2,41.93192,-87.67784
TA1307000064,7,14,false,11,7,-4,41.93222,-87.65864
TA1306000014,7,14,false,7,12,5,41.93242,-87.65271
TA1309000039,7,14,false,53,46,-7,41.93258,-87.63642
13294,7,14,false,8,5,-3,41.9326,-87.66595
TA1309000036,7,14,false,11,7,-4,41.93313,-87.64776
TA1307000006,7,14,false,9,5,-4,41.93571,-87.6636
13268,7,14,false,7,3,-4,41.93588,-87.67843
TA1307000052,7,14,false,17,14,-3,41.93628,-87.65266
TA1307000136,7,14,false,16,18,2,41.9365,-87.64755
TA1307000041,7,14,false,45,42,-3,41.93669,-87.63683
13137,7,14,false,26,25,-1,41.9376,-87.6441
TA1309000042,7,14,false,12,10,-2,41.93937,-87.66836
13229,7,14,false,7,10,3,41.93946,-87.66376
TA1308000019,7,14,false,9,8,-1,41.93973,-87.65886
13277,7,14,false,12,15,3,41.9401,-87.64546
TA1307000134,7,14,false,30,25,-5,41.94016,-87.65303
13143,7,14,false,11,6,-5,41.94059,-87.67853
TA1309000049,7,14,false,32,34,2,41.94077,-87.63919
TA1307000138,7,14,false,9,15,6,41.94334,-87.67094
TA1309000025,7,14,false,25,16,-9,41.94368,-87.64894
13071,7,14,false,24,18,-6,41.94373,-87.66401
632,7,14,false,18,12,-6,41.94453,-87.6547
13278,7,14,false,22,33,11,41.94553,-87.64644
13235,7,14,false,19,19,0,41.94814,-87.66396
13325,7,14,false,9,15,6,41.94907,-87.64863
TA1307000126,7,14,false,27,47,20,41.94936,-87.65451
TA1307000150,7,14,false,24,29,5,41.94945,-87.64646
13319,7,14,false,4,9,5,41.95069,-87.6687
TA1307000127,7,14,false,15,21,6,41.9508,-87.65918
13323,7,14,false,15,3,-12,41.95282,-87.65
13063,7,14,false,7,1,-6,41.95424,-87.65441
TA1308000022,7,14,false,14,13,-1,41.95438,-87.64805
TA1309000026,7,14,false,7,1,-6,41.95601,-87.6802
13379,7,14,false,6,10,4,41.95786,-87.6495
TA1309000027,7,14,false,5,2,-3,41.9585,-87.65499
13389,7,14,false,15,17,2,41.961,-87.64958
KA1503000022,7,14,false,6,8,2,41.96158,-87.66609
TA1307000107,7,14,false,18,14,-4,41.96164,-87.65464
TA1308000012,7,14,false,41,40,-1,41.96398,-87.63818
13074,7,14,false,9,6,-3,41.96521,-87.6582
639,7,14,false,9,7,-2,41.96584,-87.64538
TA1307000119,7,14,false,4,10,6,41.96796,-87.65
TA1308000021,7,14,false,7,2,-5,41.96883,-87.65765
TA1309000066,7,14,false,12,7,-5,41.9691,-87.67423
TA1309000041,7,14,false,10,6,-4,41.96951,-87.65471
KA1504000171,7,14,false,7,17,10,41.97161,-87.65016
TA1309000035,7,14,false,12,9,-3,41.97335,-87.66785
13108,7,14,false,7,2,-5,41.97379,-87.65971
KA1504000146,7,14,false,9,17,8,41.978,-87.66805
13109,7,14,false,8,12,4,41.97835,-87.65976
655,7,14,false,4,6,2,41.97987,-87.68194
KA1504000151,7,14,false,5,7,2,41.98359,-87.66916
KA1504000152,7,14,false,16,17,1,41.98403,-87.65231
15575,7,14,false,12,12,0,41.98975,-87.66014
KA1504000148,7,14,false,8,3,-5,41.99086,-87.66971
15571,7,14,false,9,17,8,41.99478,-87.66028
RP-009,7,14,false,13,7,-6,42.00107,-87.66122
660,7,14,false,5,2,-3,42.00458,-87.66143
KA1504000159,7,14,false,5,2,-3,42.01059,-87.66241
E002,7,14,false,6,9,3,42.03256,-87.67912
596,7,14,false,3,7,4,42.04822,-87.68348
605,7,14,false,6,10,4,42.05294,-87.67342
KA1503000014,7,14,true,4,5,1,41.7851,-87.60108
KA1503000071,7,14,true,13,5,-8,41.79148,-87.59988
KA1503000074,7,14,true,2,6,4,41.79174,-87.58395
TA1308000009,7,14,true,13,10,-3,41.79522,-87.58075
KA1503000059,7,14,true,5,4,-1,41.79952,-87.58643
TA1309000037,7,14,true,5,7,2,41.79957,-87.59474
TA1308000043,7,14,true,3,6,3,41.83066,-87.64715
13217,7,14,true,5,2,-3,41.83488,-87.61792
TA1309000055,7,14,true,11,1,-10,41.8382,-87.64514
KA1503000038,7,14,true,8,3,-5,41.83845,-87.6354
TA1307000048,7,14,true,6,11,5,41.83855,-87.60821
TA1307000139,7,14,true,5,6,1,41.84205,-87.61698
15545,7,14,true,33,27,-6,41.85627,-87.61334
SL-013,7,14,true,10,6,-4,41.85659,-87.62755
SL-006,7,14,true,6,4,-2,41.8568,-87.63387
13102,7,14,true,9,10,1,41.85762,-87.61942
13150,7,14,true,5,7,2,41.85783,-87.62455
13099,7,14,true,3,5,2,41.85784,-87.64627
13164,7,14,true,5,5,0,41.85818,-87.65648
SL-012,7,14,true,7,4,-3,41.86038,-87.62581
TA1307000124,7,14,true,3,6,3,41.86411,-87.62372
13029,7,14,true,5,3,-2,41.86531,-87.6179
13431,7,14,true,18,19,1,41.8661,-87.60728
KA1504000101,7,14,true,3,5,2,41.86651,-87.68466
WL-008,7,14,true,5,5,0,41.86712,-87.64108
TA1305000002,7,14,true,13,13,0,41.86721,-87.62597
15544,7,14,true,9,8,-1,41.86723,-87.61536
KA1706005007,7,14,true,6,2,-4,41.86749,-87.63219
SL-005,7,14,true,22,26,4,41.8679,-87.62304
644,7,14,true,5,2,-3,41.86859,-87.68625
13139,7,14,true,5,9,4,41.86893,-87.65913
13160,7,14,true,4,6,2,41.86947,-87.65548
TA1309000010,7,14,true,5,6,1,41.87074,-87.62574
TA1309000064,7,14,true,4,6,2,41.87127,-87.67369
TA1307000130,7,14,true,7,3,-4,41.87178,-87.65103
TA1307000121,7,14,true,7,7,0,41.87184,-87.64664
SL-008,7,14,true,14,10,-4,41.87209,-87.62956
13332,7,14,true,6,10,4,41.87219,-87.6615
SL-011,7,14,true,5,5,0,41.87256,-87.63356
623,7,14,true,10,8,-2,41.87272,-87.62399
15541,7,14,true,7,9,2,41.8758,-87.62086
TA1305000035,7,14,true,5,5,0,41.87716,-87.62787
15539,7,14,true,12,7,-5,41.87763,-87.64405
13158,7,14,true,5,9,4,41.87764,-87.64957
13157,7,14,true,8,8,0,41.87773,-87.6548
TA1305000025,7,14,true,6,6,0,41.87773,-87.63528
TA1309000002,7,14,true,4,8,4,41.87784,-87.62408
638,7,14,true,4,6,2,41.87827,-87.64078
13011,7,14,true,4,5,1,41.87931,-87.63993
WL-011,7,14,true,6,6,0,41.88034,-87.64273
13156,7,14,true,3,12,9,41.88042,-87.65554
13300,7,14,true,18,22,4,41.88097,-87.61675
13008,7,14,true,8,8,0,41.88105,-87.62408
TA1305000006,7,14,true,8,7,-1,41.88122,-87.6296
13056,7,14,true,5,3,-2,41.88168,-87.63951
TA1307000120,7,14,true,18,17,-1,41.88188,-87.64879
13036,7,14,true,7,10,3,41.8821,-87.62513
TA1305000032,7,14,true,11,15,4,41.88218,-87.64109
13353,7,14,true,4,9,5,41.88283,-87.6612
13409,7,14,true,6,2,-4,41.8831,-87.6511
13053,7,14,true,15,13,-2,41.88365,-87.64863
13001,7,14,true,9,3,-6,41.88397,-87.62459
18062,7,14,true,6,2,-4,41.88412,-87.65427
15535,7,14,true,4,5,1,41.8846,-87.64455
TA1305000029,7,14,true,5,14,9,41.88466,-87.62787
13263,7,14,true,6,9,3,41.88467,-87.61952
TA1306000015,7,14,true,10,19,9,41.88549,-87.65232
13021,7,14,true,9,7,-2,41.88559,-87.64184
13073,7,14,true,2,6,4,41.88592,-87.66717
KA1503000012,7,14,true,7,9,2,41.88599,-87.63089
TA1305000011,7,14,true,6,9,3,41.886,-87.62418
15534,7,14,true,3,6,3,41.88627,-87.61749
TA1308000029,7,14,true,5,4,-1,41.88673,-87.62225
KA1503000064,7,14,true,16,13,-3,41.88697,-87.61281
TA1305000022,7,14,true,6,6,0,41.88817,-87.63656
TA1306000003,7,14,true,16,12,-4,41.88867,-87.64442
KA1503000043,7,14,true,21,21,0,41.88918,-87.63851
13050,7,14,true,12,6,-6,41.88919,-87.62775
TA1307000151,7,14,true,12,7,-5,41.88993,-87.63427
636,7,14,true,8,11,3,41.88997,-87.63662
13427,7,14,true,2,7,5,41.89054,-87.62205
13430,7,14,true,14,8,-6,41.89077,-87.63169
TA1306000013,7,14,true,10,15,5,41.89083,-87.61852
RN-,7,14,true,6,9,3,41.89102,-87.63546
TA1307000117,7,14,true,13,17,4,41.89144,-87.62675
13033,7,14,true,14,3,-11,41.8916,-87.64835
13194,7,14,true,7,7,0,41.8918,-87.65878
TA1305000003,7,14,true,13,12,-1,41.89187,-87.62061
13022,7,14,true,49,54,5,41.89227,-87.61205
TA1306000029,7,14,true,9,15,6,41.89256,-87.61449
13265,7,14,true,11,5,-6,41.89383,-87.64172
13045,7,14,true,21,14,-7,41.89403,-87.62931
13016,7,14,true,6,4,-2,41.89431,-87.62277
KA1503000041,7,14,true,3,6,3,41.89452,-87.61798
TA1307000062,7,14,true,5,4,-1,41.89466,-87.63839
TA1306000012,7,14,true,19,23,4,41.89475,-87.63438
KP1705001026,7,14,true,10,7,-3,41.89483,-87.6323
18058,7,14,true,5,1,-4,41.8955,-87.68201
637,7,14,true,5,2,-3,41.89563,-87.67209
13132,7,14,true,11,13,2,41.89573,-87.67718
15530,7,14,true,8,8,0,41.89575,-87.62596
13247,7,14,true,5,6,1,41.89597,-87.66775
TA1305000020,7,14,true,11,6,-5,41.89636,-87.65406
13289,7,14,true,5,3,-2,41.89638,-87.661
13303,7,14,true,5,9,4,41.89672,-87.63088
13017,7,14,true,7,5,-2,41.89676,-87.6357
13338,7,14,true,5,3,-2,41.89697,-87.62173
TA1307000061,7,14,true,17,5,-12,41.89745,-87.62873
13034,7,14,true,5,5,0,41.89754,-87.62352
TA1306000009,7,14,true,7,7,0,41.89772,-87.64299
620,7,14,true,5,5,0,41.89817,-87.63754
15529,7,14,true,7,6,-1,41.89858,-87.62206
TA1307000128,7,14,true,13,15,2,41.89896,-87.6299
657,7,14,true,5,3,-2,41.89918,-87.6722
13248,7,14,true,5,3,-2,41.89964,-87.66788
TA1306000011,7,14,true,3,5,2,41.89994,-87.63443
KA1504000116,7,14,true,6,3,-3,41.90023,-87.64299
17660,7,14,true,2,8,6,41.90036,-87.69671
13290,7,14,true,8,4,-4,41.90069,-87.66259
13042,7,14,true,32,38,6,41.90097,-87.62377
KA1504000133,7,14,true,13,7,-6,41.90234,-87.62773
TA1307000039,7,14,true,22,24,2,41.90294,-87.63137
TA1305000034,7,14,true,7,12,5,41.90313,-87.67391
KA1504000135,7,14,true,24,20,-4,41.90319,-87.63439
13061,7,14,true,20,15,-5,41.90342,-87.66779
KA1504000079,7,14,true,5,11,6,41.9035,-87.64334
TA1307000115,7,14,true,6,4,-2,41.9046,-87.64056
TA1308000049,7,14,true,16,16,0,41.90672,-87.6349
13224,7,14,true,6,10,4,41.90706,-87.66725
TA1307000143,7,14,true,3,5,2,41.90762,-87.63854
13221,7,14,true,9,11,2,41.90765,-87.67254
TA1309000024,7,14,true,18,26,8,41.908,-87.63152
TA1305000041,7,14,true,10,5,-5,41.9094,-87.67769
331,7,14,true,11,9,-2,41.90965,-87.64812
TA1305000037,7,14,true,3,16,13,41.91018,-87.67003
TA1306000008,7,14,true,5,6,1,41.9102,-87.6435
TA1308000005,7,14,true,5,4,-1,41.91042,-87.68238
13258,7,14,true,5,3,-2,41.91043,-87.69718
13154,7,14,true,14,11,-3,41.91054,-87.65312
13058,7,14,true,10,13,3,41.91059,-87.64942
TA1307000038,7,14,true,12,8,-4,41.91138,-87.63868
LF-005,7,14,true,49,68,19,41.91172,-87.62681
13128,7,14,true,12,9,-3,41.91197,-87.63197
TA1308000050,7,14,true,37,29,-8,41.91211,-87.6347
13243,7,14,true,12,8,-4,41.91262,-87.6814
TA1306000032,7,14,true,12,8,-4,41.9137,-87.65285
TA1307000166,7,14,true,5,10,5,41.91386,-87.64877
18067,7,14,true,9,8,-1,41.9146,-87.66796
TA1306000007,7,14,true,5,4,-1,41.91469,-87.64333
13068,7,14,true,4,5,1,41.91554,-87.68703
13179,7,14,true,23,28,5,41.9157,-87.63461
13133,7,14,true,9,9,0,41.91598,-87.67733
TA1305000039,7,14,true,5,3,-2,41.9163,-87.66749
15651,7,14,true,5,5,0,41.91752,-87.70181
TA1309000006,7,14,true,6,9,3,41.91809,-87.64375
TA1307000163,7,14,true,9,9,0,41.91821,-87.65696
13146,7,14,true,26,20,-6,41.91831,-87.63629
13059,7,14,true,23,18,-5,41.91845,-87.65222
13192,7,14,true,9,13,4,41.91995,-87.64884
13288,7,14,true,5,4,-1,41.92008,-87.67788
13242,7,14,true,2,5,3,41.92021,-87.69266
TA1309000030,7,14,true,5,11,6,41.92077,-87.66372
13292,7,14,true,2,6,4,41.92152,-87.70733
TA1309000033,7,14,true,19,6,-13,41.92158,-87.65381
13193,7,14,true,22,35,13,41.92182,-87.64412
13191,7,14,true,7,15,8,41.92217,-87.63891
13084,7,14,true,8,8,0,41.92268,-87.69715
LP-,7,14,true,17,15,-2,41.92396,-87.63584
15648,7,14,true,6,4,-2,41.92464,-87.68931
TA1307000001,7,14,true,4,10,6,41.92535,-87.66581
TA1306000026,7,14,true,6,2,-4,41.92558,-87.65842
TA1306000016,7,14,true,7,4,-3,41.9256,-87.65371
TA1309000019,7,14,true,17,22,5,41.92586,-87.63897
TA1309000058,7,14,true,28,15,-13,41.92591,-87.64927
TA1308000001,7,14,true,52,40,-12,41.92627,-87.63086
13124,7,14,true,9,16,7,41.92675,-87.63444
TA1309000023,7,14,true,15,5,-10,41.9287,-87.65383
TA1307000113,7,14,true,10,6,-4,41.92878,-87.66391
13296,7,14,true,11,4,-7,41.92883,-87.66852
TA1309000059,7,14,true,6,5,-1,41.92889,-87.65898
TA1309000061,7,14,true,5,12,7,41.92915,-87.64909
TA1305000014,7,14,true,13,10,-3,41.92956,-87.64313
13085,7,14,true,10,4,-6,41.92958,-87.70789
TA1307000142,7,14,true,22,16,-6,41.93125,-87.64432
13276,7,14,true,18,13,-5,41.93132,-87.63874
13271,7,14,true,9,12,3,41.93192,-87.67784
TA1307000064,7,14,true,7,12,5,41.93222,-87.65864
TA1306000014,7,14,true,14,17,3,41.93242,-87.65271
TA1309000039,7,14,true,23,33,10,41.93258,-87.63642
13294,7,14,true,9,4,-5,41.9326,-87.66595
TA1309000036,7,14,true,12,15,3,41.93313,-87.64776
TA1307000006,7,14,true,12,8,-4,41.93571,-87.6636
13268,7,14,true,3,7,4,41.93588,-87.67843
TA1307000052,7,14,true,14,12,-2,41.93628,-87.65266
TA1307000136,7,14,true,13,12,-1,41.9365,-87.64755
TA1307000041,7,14,true,29,34,5,41.93669,-87.63683
13137,7,14,true,30,27,-3,41.9376,-87.6441
TA1309000042,7,14,true,11,15,4,41.93937,-87.66836
TA1308000019,7,14,true,14,10,-4,41.93973,-87.65886
13277,7,14,true,10,9,-1,41.9401,-87.64546
TA1307000134,7,14,true,16,23,7,41.94016,-87.65303
TA1309000049,7,14,true,23,30,7,41.94077,-87.63919
TA1307000138,7,14,true,5,6,1,41.94334,-87.67094
13144,7,14,true,5,3,-2,41.9434,-87.67964
TA1309000025,7,14,true,14,16,2,41.94368,-87.64894
13071,7,14,true,18,12,-6,41.94373,-87.66401
632,7,14,true,5,8,3,41.94453,-87.6547
13278,7,14,true,14,16,2,41.94553,-87.64644
13235,7,14,true,15,16,1,41.94814,-87.66396
13253,7,14,true,5,9,4,41.9488,-87.67527
13325,7,14,true,14,15,1,41.94907,-87.64863
TA1307000126,7,14,true,12,16,4,41.94936,-87.65451
TA1307000150,7,14,true,8,14,6,41.94945,-87.64646
13319,7,14,true,4,7,3,41.95069,-87.6687
TA1307000127,7,14,true,18,7,-11,41.9508,-87.65918
13323,7,14,true,4,15,11,41.95282,-87.65
13063,7,14,true,7,7,0,41.95424,-87.65441
TA1308000022,7,14,true,10,12,2,41.95438,-87.64805
TA1307000149,7,14,true,12,2,-10,41.95467,-87.67392
TA1309000026,7,14,true,8,3,-5,41.95601,-87.6802
TA1308000047,7,14,true,1,7,6,41.95709,-87.6642
13379,7,14,true,8,9,1,41.95786,-87.6495
TA1309000027,7,14,true,7,10,3,41.9585,-87.65499
13389,7,14,true,12,6,-6,41.961,-87.64958
15623,7,14,true,6,4,-2,41.96154,-87.69117
TA1307000107,7,14,true,13,9,-4,41.96164,-87.65464
TA1307000156,7,14,true,5,1,-4,41.96301,-87.68479
TA1308000012,7,14,true,29,24,-5,41.96398,-87.63818
13074,7,14,true,7,7,0,41.96521,-87.6582
639,7,14,true,6,8,2,41.96584,-87.64538
KA1504000127,7,14,true,3,5,2,41.96587,-87.70083
TA1307000140,7,14,true,3,5,2,41.96643,-87.68865
TA1309000014,7,14,true,16,8,-8,41.96709,-87.66744
TA1307000158,7,14,true,6,5,-1,41.9671,-87.67904
TA1307000119,7,14,true,4,5,1,41.96796,-87.65
TA1308000021,7,14,true,7,8,1,41.96883,-87.65765
TA1309000066,7,14,true,8,10,2,41.9691,-87.67423
TA1309000041,7,14,true,11,3,-8,41.96951,-87.65471
KA1504000171,7,14,true,9,8,-1,41.97161,-87.65016
TA1309000035,7,14,true,9,8,-1,41.97335,-87.66785
13108,7,14,true,10,16,6,41.97379,-87.65971
KA1504000146,7,14,true,11,8,-3,41.978,-87.66805
13109,7,14,true,8,4,-4,41.97835,-87.65976
KA1504000151,7,14,true,7,4,-3,41.98359,-87.66916
KA1504000152,7,14,true,14,12,-2,41.98403,-87.65231
15575,7,14,true,7,6,-1,41.98975,-87.66014
KA1504000155,7,14,true,9,4,-5,41.99118,-87.68359
15571,7,14,true,3,16,13,41.99478,-87.66028
RP-009,7,14,true,1,6,5,42.00107,-87.66122
KA1504000175,7,14,true,3,5,2,42.00797,-87.66549
E002,7,14,true,4,5,1,42.03256,-87.67912
596,7,14,true,5,6,1,42.04822,-87.68348
KA1503000002,7,15,false,5,1,-4,41.76641,-87.5657
15491,7,15,false,6,6,0,41.78096,-87.57624
KA1503000014,7,15,false,7,3,-4,41.7851,-87.60108
KA1503000071,7,15,false,9,2,-7,41.79148,-87.59988
KA1503000074,7,15,false,16,8,-8,41.79174,-87.58395
TA1309000063,7,15,false,5,10,5,41.79325,-87.5878
KA1504000076,7,15,false,1,5,4,41.7943,-87.60145
TA1308000009,7,15,false,19,16,-3,41.79522,-87.58075
TA1307000164,7,15,false,6,1,-5,41.79527,-87.59647
KA1503000059,7,15,false,7,12,5,41.79952,-87.58643
TA1309000037,7,15,false,7,6,-1,41.79957,-87.59474
KA1503000007,7,15,false,7,4,-3,41.80242,-87.58689
KA1503000004,7,15,false,6,9,3,41.83127,-87.6088
13215,7,15,false,4,9,5,41.83634,-87.6135
TA1307000048,7,15,false,26,36,10,41.83855,-87.60821
TA1305000001,7,15,false,16,5,-11,41.85262,-87.6265
13075,7,15,false,23,11,-12,41.8531,-87.63192
13307,7,15,false,8,2,-6,41.85489,-87.66359
15545,7,15,false,20,18,-2,41.85627,-87.61334
SL-013,7,15,false,9,9,0,41.85659,-87.62755
SL-006,7,15,false,4,6,2,41.8568,-87.63387
13102,7,15,false,18,22,4,41.85762,-87.61942
13150,7,15,false,11,2,-9,41.85783,-87.62455
13164,7,15,false,7,8,1,41.85818,-87.65648
TA1307000124,7,15,false,10,8,-2,41.86411,-87.62372
TA1309000001,7,15,false,7,7,0,41.86488,-87.64708
13029,7,15,false,20,17,-3,41.86531,-87.6179
13431,7,15,false,38,30,-8,41.8661,-87.60728
WL-008,7,15,false,5,7,2,41.86712,-87.64108
TA1305000002,7,15,false,28,29,1,41.86721,-87.62597
15544,7,15,false,88,64,-24,41.86723,-87.61536
SL-005,7,15,false,38,28,-10,41.8679,-87.62304
13139,7,15,false,2,6,4,41.86893,-87.65913
15550,7,15,false,9,3,-6,41.87024,-87.63947
TA1309000010,7,15,false,7,8,1,41.87074,-87.62574
SL-008,7,15,false,10,9,-1,41.87209,-87.62956
13332,7,15,false,1,5,4,41.87219,-87.6615
SL-011,7,15,false,11,11,0,41.87256,-87.63356
623,7,15,false,35,31,-4,41.87272,-87.62399
SL-007,7,15,false,7,19,12,41.87404,-87.6277
SL-010,7,15,false,5,3,-2,41.87501,-87.63309
15541,7,15,false,48,39,-9,41.8758,-87.62086
TA1305000010,7,15,false,9,16,7,41.87623,-87.62444
TA1305000035,7,15,false,5,11,6,41.87716,-87.62787
13138,7,15,false,3,5,2,41.87723,-87.63941
631,7,15,false,6,1,-5,41.87761,-87.6739
15539,7,15,false,4,8,4,41.87763,-87.64405
13158,7,15,false,7,8,1,41.87764,-87.64957
13157,7,15,false,6,2,-4,41.87773,-87.6548
TA1305000025,7,15,false,11,11,0,41.87773,-87.63528
TA1309000002,7,15,false,9,11,2,41.87784,-87.62408
638,7,15,false,3,10,7,41.87827,-87.64078
TA1305000005,7,15,false,1,6,5,41.87924,-87.62975
TA1309000008,7,15,false,8,12,4,41.87933,-87.6355
KA1503000034,7,15,false,6,4,-2,41.87938,-87.63197
KA1503000015,7,15,false,11,5,-6,41.87948,-87.6257
WL-011,7,15,false,7,1,-6,41.88034,-87.64273
13156,7,15,false,9,14,5,41.88042,-87.65554
13300,7,15,false,95,104,9,41.88097,-87.61675
13008,7,15,false,109,98,-11,41.88105,-87.62408
TA1307000120,7,15,false,32,21,-11,41.88188,-87.64879
13341,7,15,false,7,3,-4,41.88208,-87.63985
13036,7,15,false,12,17,5,41.8821,-87.62513
TA1305000032,7,15,false,12,2,-10,41.88218,-87.64109
13353,7,15,false,8,2,-6,41.88283,-87.6612
13409,7,15,false,11,4,-7,41.8831,-87.6511
13053,7,15,false,36,29,-7,41.88365,-87.64863
13001,7,15,false,33,19,-14,41.88397,-87.62459
18062,7,15,false,8,12,4,41.88412,-87.65427
TA1306000010,7,15,false,13,15,2,41.88419,-87.62961
TA1305000030,7,15,false,7,11,4,41.88459,-87.63178
15535,7,15,false,10,8,-2,41.8846,-87.64455
TA1305000029,7,15,false,21,25,4,41.88466,-87.62787
13263,7,15,false,16,18,2,41.88467,-87.61952
TA1306000015,7,15,false,39,22,-17,41.88549,-87.65232
13021,7,15,false,6,13,7,41.88559,-87.64184
TA1307000111,7,15,false,7,9,2,41.88582,-87.63548
KA1503000012,7,15,false,12,11,-1,41.88599,-87.63089
TA1305000011,7,15,false,16,31,15,41.886,-87.62418
15534,7,15,false,12,15,3,41.88627,-87.61749
TA1308000029,7,15,false,4,7,3,41.88673,-87.62225
TA1307000131,7,15,false,19,20,1,41.88688,-87.62606
KA1503000064,7,15,false,40,37,-3,41.88697,-87.61281
TA1305000022,7,15,false,8,17,9,41.88817,-87.63656
TA1306000003,7,15,false,18,12,-6,41.88867,-87.64442
KA1503000043,7,15,false,20,12,-8,41.88918,-87.63851
13050,7,15,false,18,22,4,41.88919,-87.62775
13432,7,15,false,2,7,5,41.88989,-87.67149
TA1307000151,7,15,false,20,20,0,41.88993,-87.63427
636,7,15,false,7,6,-1,41.88997,-87.63662
KA1503000044,7,15,false,5,11,6,41.89018,-87.6262
13427,7,15,false,12,11,-1,41.89054,-87.62205
13430,7,15,false,19,28,9,41.89077,-87.63169
TA1306000013,7,15,false,24,34,10,41.89083,-87.61852
RN-,7,15,false,18,10,-8,41.89102,-87.63546
13434,7,15,false,5,3,-2,41.89108,-87.66663
TA1308000006,7,15,false,7,5,-2,41.89128,-87.67686
TA1307000117,7,15,false,40,27,-13,41.89144,-87.62675
13033,7,15,false,7,9,2,41.8916,-87.64835
13194,7,15,false,3,5,2,41.8918,-87.65878
TA1305000003,7,15,false,28,31,3,41.89187,-87.62061
13022,7,15,false,260,248,-12,41.89227,-87.61205
TA1306000029,7,15,false,32,23,-9,41.89256,-87.61449
13265,7,15,false,12,18,6,41.89383,-87.64172
13045,7,15,false,24,19,-5,41.89403,-87.62931
13016,7,15,false,28,24,-4,41.89431,-87.62277
KA1503000041,7,15,false,7,17,10,41.89452,-87.61798
13196,7,15,false,3,8,5,41.89455,-87.65345
TA1307000062,7,15,false,7,12,5,41.89466,-87.63839
TA1306000012,7,15,false,19,21,2,41.89475,-87.63438
KP1705001026,7,15,false,9,18,9,41.89483,-87.6323
13132,7,15,false,6,12,6,41.89573,-87.67718
15530,7,15,false,24,19,-5,41.89575,-87.62596
18003,7,15,false,9,13,4,41.89575,-87.62011
13247,7,15,false,6,5,-1,41.89597,-87.66775
TA1305000020,7,15,false,13,8,-5,41.89636,-87.65406
13289,7,15,false,5,7,2,41.89638,-87.661
13303,7,15,false,17,7,-10,41.89672,-87.63088
13017,7,15,false,4,5,1,41.89676,-87.6357
13338,7,15,false,14,13,-1,41.89697,-87.62173
TA1307000061,7,15,false,3,6,3,41.89745,-87.62873
13034,7,15,false,16,15,-1,41.89754,-87.62352
620,7,15,false,8,13,5,41.89817,-87.63754
KA1504000103,7,15,false,2,8,6,41.89842,-87.68659
15529,7,15,false,22,31,9,41.89858,-87.62206
TA1307000128,7,15,false,33,31,-2,41.89896,-87.6299
657,7,15,false,7,1,-6,41.89918,-87.6722
17660,7,15,false,4,5,1,41.90036,-87.69671
13290,7,15,false,5,8,3,41.90069,-87.66259
13042,7,15,false,108,107,-1,41.90097,-87.62377
KA1504000133,7,15,false,25,27,2,41.90234,-87.62773
TA1307000039,7,15,false,27,27,0,41.90294,-87.63137
13256,7,15,false,2,5,3,41.90302,-87.69749
TA1305000034,7,15,false,11,11,0,41.90313,-87.67391
KA1504000135,7,15,false,22,29,7,41.90319,-87.63439
13136,7,15,false,5,12,7,41.90326,-87.67845
13061,7,15,false,18,9,-9,41.90342,-87.66779
KA1504000079,7,15,false,13,11,-2,41.9035,-87.64334
TA1307000115,7,15,false,6,3,-3,41.9046,-87.64056
TA1308000049,7,15,false,35,50,15,41.90672,-87.6349
KA1504000134,7,15,false,14,5,-9,41.90687,-87.6262
13224,7,15,false,8,15,7,41.90706,-87.66725
13221,7,15,false,27,17,-10,41.90765,-87.67254
TA1309000024,7,15,false,23,28,5,41.908,-87.63152
TA1305000041,7,15,false,19,21,2,41.9094,-87.67769
331,7,15,false,8,7,-1,41.90965,-87.64812
TA1305000037,7,15,false,8,6,-2,41.91018,-87.67003
TA1306000008,7,15,false,6,5,-1,41.9102,-87.6435
TA1308000005,7,15,false,5,10,5,41.91042,-87.68238
13154,7,15,false,16,15,-1,41.91054,-87.65312
13058,7,15,false,7,10,3,41.91059,-87.64942
TA1307000038,7,15,false,23,23,0,41.91138,-87.63868
LF-005,7,15,false,139,160,21,41.91172,-87.62681
13128,7,15,false,22,10,-12,41.91197,-87.63197
TA1308000050,7,15,false,37,53,16,41.91211,-87.6347
13243,7,15,false,9,22,13,41.91262,-87.6814
TA1306000032,7,15,false,18,17,-1,41.9137,-87.65285
TA1307000166,7,15,false,16,10,-6,41.91386,-87.64877
18067,7,15,false,7,9,2,41.9146,-87.66796
TA1306000007,7,15,false,4,6,2,41.91469,-87.64333
13068,7,15,false,9,9,0,41.91554,-87.68703
13179,7,15,false,61,44,-17,41.9157,-87.63461
13133,7,15,false,13,9,-4,41.91598,-87.67733
TA1305000039,7,15,false,6,6,0,41.9163,-87.66749
15651,7,15,false,3,6,3,41.91752,-87.70181
TA1309000029,7,15,false,6,4,-2,41.9178,-87.68245
TA1309000006,7,15,false,11,6,-5,41.91809,-87.64375
TA1307000163,7,15,false,4,12,8,41.91821,-87.65696
13146,7,15,false,45,48,3,41.91831,-87.63629
13059,7,15,false,22,19,-3,41.91845,-87.65222
13259,7,15,false,4,7,3,41.91852,-87.69744
13192,7,15,false,7,4,-3,41.91995,-87.64884
TA1309000030,7,15,false,14,7,-7,41.92077,-87.66372
TA1309000033,7,15,false,16,18,2,41.92158,-87.65381
13193,7,15,false,39,32,-7,41.92182,-87.64412
13191,7,15,false,9,17,8,41.92217,-87.63891
13084,7,15,false,9,4,-5,41.92268,-87.69715
LP-,7,15,false,36,33,-3,41.92396,-87.63584
TA1307000001,7,15,false,7,14,7,41.92535,-87.66581
TA1306000026,7,15,false,6,10,4,41.92558,-87.65842
TA1306000016,7,15,false,13,9,-4,41.9256,-87.65371
TA1309000019,7,15,false,34,34,0,41.92586,-87.63897
TA1309000058,7,15,false,35,22,-13,41.92591,-87.64927
TA1308000001,7,15,false,102,94,-8,41.92627,-87.63086
13124,7,15,false,26,19,-7,41.92675,-87.63444
TA1309000023,7,15,false,13,11,-2,41.9287,-87.65383
TA1307000113,7,15,false,14,11,-3,41.92878,-87.66391
13296,7,15,false,8,7,-1,41.92883,-87.66852
TA1309000059,7,15,false,5,3,-2,41.92889,-87.65898
TA1309000061,7,15,false,17,18,1,41.92915,-87.64909
TA1308000031,7,15,false,2,5,3,41.92946,-87.68417
TA1305000014,7,15,false,19,19,0,41.92956,-87.64313
13085,7,15,false,6,10,4,41.92958,-87.70789
TA1307000142,7,15,false,24,23,-1,41.93125,-87.64432
13276,7,15,false,26,21,-5,41.93132,-87.63874
TA1307000064,7,15,false,10,14,4,41.93222,-87.65864
TA1306000014,7,15,false,9,13,4,41.93242,-87.65271
TA1309000039,7,15,false,30,35,5,41.93258,-87.63642
13294,7,15,false,5,5,0,41.9326,-87.66595
TA1309000036,7,15,false,8,14,6,41.93313,-87.64776
TA1307000006,7,15,false,12,3,-9,41.93571,-87.6636
TA1307000052,7,15,false,9,11,2,41.93628,-87.65266
TA1307000136,7,15,false,4,14,10,41.9365,-87.64755
TA1307000041,7,15,false,30,33,3,41.93669,-87.63683
13137,7,15,false,22,45,23,41.9376,-87.6441
TA1309000042,7,15,false,9,8,-1,41.93937,-87.66836
13229,7,15,false,7,7,0,41.93946,-87.66376
TA1308000019,7,15,false,14,14,0,41.93973,-87.65886
13277,7,15,false,8,19,11,41.9401,-87.64546
TA1307000134,7,15,false,26,24,-2,41.94016,-87.65303
13143,7,15,false,6,3,-3,41.94059,-87.67853
TA1309000049,7,15,false,48,60,12,41.94077,-87.63919
TA1307000138,7,15,false,8,8,0,41.94334,-87.67094
TA1309000025,7,15,false,19,25,6,41.94368,-87.64894
13071,7,15,false,15,32,17,41.94373,-87.66401
632,7,15,false,27,30,3,41.94453,-87.6547
13278,7,15,false,10,9,-1,41.94553,-87.64644
13235,7,15,false,11,8,-3,41.94814,-87.66396
13325,7,15,false,14,19,5,41.94907,-87.64863
TA1307000126,7,15,false,25,27,2,41.94936,-87.65451
TA1307000150,7,15,false,22,37,15,41.94945,-87.64646
13319,7,15,false,4,6,2,41.95069,-87.6687
TA1307000127,7,15,false,17,15,-2,41.9508,-87.65918
13323,7,15,false,9,11,2,41.95282,-87.65
13063,7,15,false,10,7,-3,41.95424,-87.65441
TA1308000022,7,15,false,16,22,6,41.95438,-87.64805
13249,7,15,false,5,4,-1,41.95606,-87.66885
TA1308000047,7,15,false,3,5,2,41.95709,-87.6642
13379,7,15,false,11,12,1,41.95786,-87.6495
TA1309000027,7,15,false,5,1,-4,41.9585,-87.65499
13389,7,15,false,25,16,-9,41.961,-87.64958
15622,7,15,false,1,6,5,41.96108,-87.69544
TA1307000144,7,15,false,5,3,-2,41.96142,-87.6762
KA1503000022,7,15,false,5,3,-2,41.96158,-87.66609
TA1307000107,7,15,false,18,12,-6,41.96164,-87.65464
TA1307000156,7,15,false,5,5,0,41.96301,-87.68479
TA1309000012,7,15,false,5,1,-4,41.96325,-87.67928
TA1308000012,7,15,false,67,68,1,41.96398,-87.63818
639,7,15,false,16,13,-3,41.96584,-87.64538
TA1307000140,7,15,false,5,4,-1,41.96643,-87.68865
TA1309000014,7,15,false,5,13,8,41.96709,-87.66744
TA1307000158,7,15,false,1,5,4,41.9671,-87.67904
TA1307000119,7,15,false,8,5,-3,41.96796,-87.65
TA1308000021,7,15,false,4,7,3,41.96883,-87.65765
TA1309000066,7,15,false,12,10,-2,41.9691,-87.67423
TA1309000041,7,15,false,6,7,1,41.96951,-87.65471
KA1504000171,7,15,false,15,14,-1,41.97161,-87.65016
TA1309000035,7,15,false,7,9,2,41.97335,-87.66785
13108,7,15,false,5,10,5,41.97379,-87.65971
KA1504000149,7,15,false,5,6,1,41.97562,-87.67945
KA1504000160,7,15,false,5,4,-1,41.97564,-87.70143
KA1504000146,7,15,false,8,5,-3,41.978,-87.66805
13109,7,15,false,9,6,-3,41.97835,-87.65976
KA1504000151,7,15,false,6,5,-1,41.98359,-87.66916
KA1504000152,7,15,false,34,31,-3,41.98403,-87.65231
15578,7,15,false,3,6,3,41.98405,-87.66027
15575,7,15,false,10,8,-2,41.98975,-87.66014
KA1504000148,7,15,false,6,7,1,41.99086,-87.66971
KA1504000155,7,15,false,1,5,4,41.99118,-87.68359
15571,7,15,false,7,5,-2,41.99478,-87.66028
RP-009,7,15,false,4,6,2,42.00107,-87.66122
KA1504000159,7,15,false,3,6,3,42.01059,-87.66241
596,7,15,false,12,3,-9,42.04822,-87.68348
E008,7,15,false,6,3,-3,42.05049,-87.67782
KA1503000014,7,15,true,3,7,4,41.7851,-87.60108
TA1308000009,7,15,true,14,12,-2,41.79522,-87.58075
TA1307000164,7,15,true,6,5,-1,41.79527,-87.59647
KA1503000059,7,15,true,7,6,-1,41.79952,-87.58643
TA1309000037,7,15,true,10,4,-6,41.79957,-87.59474
13217,7,15,true,7,2,-5,41.83488,-87.61792
TA1307000048,7,15,true,12,12,0,41.83855,-87.60821
TA1307000139,7,15,true,2,7,5,41.84205,-87.61698
TA1307000005,7,15,true,2,5,3,41.84569,-87.6225
13075,7,15,true,5,9,4,41.8531,-87.63192
15546,7,15,true,5,3,-2,41.85416,-87.61916
15545,7,15,true,13,16,3,41.85627,-87.61334
13135,7,15,true,2,5,3,41.85753,-87.66157
13102,7,15,true,10,9,-1,41.85762,-87.61942
13150,7,15,true,6,2,-4,41.85783,-87.62455
13164,7,15,true,10,1,-9,41.85818,-87.65648
SL-012,7,15,true,6,6,0,41.86038,-87.62581
TA1307000124,7,15,true,7,10,3,41.86411,-87.62372
13354,7,15,true,3,7,4,41.86524,-87.66651
13029,7,15,true,5,2,-3,41.86531,-87.6179
13431,7,15,true,17,18,1,41.8661,-87.60728
WL-008,7,15,true,6,11,5,41.86712,-87.64108
TA1305000002,7,15,true,16,18,2,41.86721,-87.62597
15544,7,15,true,18,15,-3,41.86723,-87.61536
SL-005,7,15,true,24,18,-6,41.8679,-87.62304
13139,7,15,true,9,5,-4,41.86893,-87.65913
13285,7,15,true,7,3,-4,41.86928,-87.67372
13160,7,15,true,10,7,-3,41.86947,-87.65548
15550,7,15,true,4,5,1,41.87024,-87.63947
TA1309000010,7,15,true,16,12,-4,41.87074,-87.62574
TA1309000064,7,15,true,6,2,-4,41.87127,-87.67369
TA1307000130,7,15,true,9,3,-6,41.87178,-87.65103
TA1307000121,7,15,true,15,5,-10,41.87184,-87.64664
SL-008,7,15,true,5,12,7,41.87209,-87.62956
13332,7,15,true,16,14,-2,41.87219,-87.6615
SL-011,7,15,true,6,13,7,41.87256,-87.63356
623,7,15,true,12,8,-4,41.87272,-87.62399
KA1504000104,7,15,true,6,3,-3,41.87296,-87.66912
SL-007,7,15,true,8,1,-7,41.87404,-87.6277
TA1306000025,7,15,true,9,8,-1,41.87464,-87.65703
SL-010,7,15,true,8,3,-5,41.87501,-87.63309
15541,7,15,true,6,11,5,41.8758,-87.62086
13037,7,15,true,5,5,0,41.87588,-87.64078
TA1305000010,7,15,true,8,4,-4,41.87623,-87.62444
TA1305000035,7,15,true,5,5,0,41.87716,-87.62787
15539,7,15,true,11,11,0,41.87763,-87.64405
13158,7,15,true,6,8,2,41.87764,-87.64957
13157,7,15,true,9,8,-1,41.87773,-87.6548
TA1305000025,7,15,true,5,6,1,41.87773,-87.63528
TA1309000002,7,15,true,8,5,-3,41.87784,-87.62408
638,7,15,true,3,6,3,41.87827,-87.64078
13011,7,15,true,7,2,-5,41.87931,-87.63993
KA1503000034,7,15,true,6,3,-3,41.87938,-87.63197
13156,7,15,true,5,7,2,41.88042,-87.65554
13300,7,15,true,33,27,-6,41.88097,-87.61675
13008,7,15,true,7,15,8,41.88105,-87.62408
TA1305000006,7,15,true,4,6,2,41.88122,-87.6296
TA1307000120,7,15,true,18,22,4,41.88188,-87.64879
TA1305000032,7,15,true,13,11,-2,41.88218,-87.64109
13353,7,15,true,5,2,-3,41.88283,-87.6612
654,7,15,true,3,6,3,41.88307,-87.65698
WL-012,7,15,true,9,3,-6,41.88337,-87.6412
13053,7,15,true,14,16,2,41.88365,-87.64863
13001,7,15,true,8,7,-1,41.88397,-87.62459
TA1306000010,7,15,true,10,12,2,41.88419,-87.62961
TA1305000030,7,15,true,9,9,0,41.88459,-87.63178
15535,7,15,true,7,8,1,41.8846,-87.64455
TA1305000029,7,15,true,11,17,6,41.88466,-87.62787
13263,7,15,true,14,10,-4,41.88467,-87.61952
TA1306000015,7,15,true,12,11,-1,41.88549,-87.65232
13021,7,15,true,15,4,-11,41.88559,-87.64184
TA1307000111,7,15,true,5,4,-1,41.88582,-87.63548
13073,7,15,true,4,5,1,41.88592,-87.66717
KA1503000012,7,15,true,8,11,3,41.88599,-87.63089
TA1305000011,7,15,true,13,2,-11,41.886,-87.62418
15534,7,15,true,8,15,7,41.88627,-87.61749
KA1503000064,7,15,true,15,13,-2,41.88697,-87.61281
TA1305000022,7,15,true,11,7,-4,41.88817,-87.63656
TA1306000003,7,15,true,18,23,5,41.88867,-87.64442
KA1503000043,7,15,true,23,15,-8,41.88918,-87.63851
13050,7,15,true,8,8,0,41.88919,-87.62775
TA1307000151,7,15,true,15,14,-1,41.88993,-87.63427
636,7,15,true,6,5,-1,41.88997,-87.63662
13430,7,15,true,6,8,2,41.89077,-87.63169
TA1306000013,7,15,true,6,15,9,41.89083,-87.61852
RN-,7,15,true,10,11,1,41.89102,-87.63546
TA1307000117,7,15,true,18,28,10,41.89144,-87.62675
13033,7,15,true,5,7,2,41.8916,-87.64835
13194,7,15,true,8,9,1,41.8918,-87.65878
TA1305000003,7,15,true,10,9,-1,41.89187,-87.62061
13022,7,15,true,34,52,18,41.89227,-87.61205
TA1306000029,7,15,true,10,8,-2,41.89256,-87.61449
13265,7,15,true,9,8,-1,41.89383,-87.64172
13045,7,15,true,14,15,1,41.89403,-87.62931
13016,7,15,true,5,5,0,41.89431,-87.62277
KA1503000041,7,15,true,6,2,-4,41.89452,-87.61798
13196,7,15,true,7,6,-1,41.89455,-87.65345
TA1307000062,7,15,true,7,4,-3,41.89466,-87.63839
TA1306000012,7,15,true,18,11,-7,41.89475,-87.63438
KP1705001026,7,15,true,6,11,5,41.89483,-87.6323
637,7,15,true,4,5,1,41.89563,-87.67209
13132,7,15,true,6,7,1,41.89573,-87.67718
15530,7,15,true,13,13,0,41.89575,-87.62596
13247,7,15,true,4,5,1,41.89597,-87.66775
TA1305000020,7,15,true,8,11,3,41.89636,-87.65406
13289,7,15,true,8,5,-3,41.89638,-87.661
13303,7,15,true,6,4,-2,41.89672,-87.63088
13338,7,15,true,5,2,-3,41.89697,-87.62173
TA1307000061,7,15,true,3,6,3,41.89745,-87.62873
13034,7,15,true,2,10,8,41.89754,-87.62352
TA1306000009,7,15,true,6,4,-2,41.89772,-87.64299
620,7,15,true,21,11,-10,41.89817,-87.63754
15529,7,15,true,8,18,10,41.89858,-87.62206
TA1307000128,7,15,true,17,22,5,41.89896,-87.6299
KA1504000116,7,15,true,1,6,5,41.90023,-87.64299
13290,7,15,true,6,7,1,41.90069,-87.66259
13042,7,15,true,22,36,14,41.90097,-87.62377
KA1504000133,7,15,true,13,8,-5,41.90234,-87.62773
TA1307000039,7,15,true,25,31,6,41.90294,-87.63137
658,7,15,true,6,5,-1,41.903,-87.6838
TA1305000034,7,15,true,9,8,-1,41.90313,-87.67391
KA1504000135,7,15,true,22,22,0,41.90319,-87.63439
13136,7,15,true,3,8,5,41.90326,-87.67845
13061,7,15,true,8,14,6,41.90342,-87.66779
KA1504000079,7,15,true,12,17,5,41.9035,-87.64334
TA1307000115,7,15,true,5,3,-2,41.9046,-87.64056
TA1308000049,7,15,true,40,19,-21,41.90672,-87.6349
KA1504000134,7,15,true,6,4,-2,41.90687,-87.6262
13224,7,15,true,10,3,-7,41.90706,-87.66725
13221,7,15,true,12,8,-4,41.90765,-87.67254
TA1309000024,7,15,true,23,13,-10,41.908,-87.63152
TA1305000041,7,15,true,21,12,-9,41.9094,-87.67769
331,7,15,true,10,14,4,41.90965,-87.64812
15653,7,15,true,5,3,-2,41.90979,-87.7053
TA1305000037,7,15,true,8,10,2,41.91018,-87.67003
TA1306000008,7,15,true,8,7,-1,41.9102,-87.6435
TA1308000005,7,15,true,3,8,5,41.91042,-87.68238
13154,7,15,true,18,17,-1,41.91054,-87.65312
13058,7,15,true,7,11,4,41.91059,-87.64942
TA1307000038,7,15,true,7,16,9,41.91138,-87.63868
LF-005,7,15,true,59,73,14,41.91172,-87.62681
13128,7,15,true,2,11,9,41.91197,-87.63197
TA1308000050,7,15,true,44,36,-8,41.91211,-87.6347
13243,7,15,true,7,6,-1,41.91262,-87.6814
TA1306000032,7,15,true,10,16,6,41.9137,-87.65285
TA1307000166,7,15,true,13,14,1,41.91386,-87.64877
15655,7,15,true,7,2,-5,41.91401,-87.70514
18067,7,15,true,10,12,2,41.9146,-87.66796
TA1306000007,7,15,true,6,9,3,41.91469,-87.64333
13068,7,15,true,5,6,1,41.91554,-87.68703
13179,7,15,true,30,31,1,41.9157,-87.63461
13133,7,15,true,8,15,7,41.91598,-87.67733
TA1305000039,7,15,true,8,4,-4,41.9163,-87.66749
15651,7,15,true,3,6,3,41.91752,-87.70181
13266,7,15,true,5,3,-2,41.91774,-87.69142
TA1309000029,7,15,true,5,3,-2,41.9178,-87.68245
TA1309000006,7,15,true,8,7,-1,41.91809,-87.64375
TA1307000163,7,15,true,9,12,3,41.91821,-87.65696
13146,7,15,true,22,25,3,41.91831,-87.63629
13059,7,15,true,16,18,2,41.91845,-87.65222
13259,7,15,true,5,3,-2,41.91852,-87.69744
13192,7,15,true,8,13,5,41.91995,-87.64884
13242,7,15,true,4,6,2,41.92021,-87.69266
TA1309000030,7,15,true,8,3,-5,41.92077,-87.66372
TA1309000033,7,15,true,12,17,5,41.92158,-87.65381
13193,7,15,true,20,24,4,41.92182,-87.64412
13191,7,15,true,5,6,1,41.92217,-87.63891
13084,7,15,true,6,8,2,41.92268,-87.69715
LP-,7,15,true,6,11,5,41.92396,-87.63584
TA1307000001,7,15,true,12,7,-5,41.92535,-87.66581
TA1306000026,7,15,true,5,7,2,41.92558,-87.65842
TA1306000016,7,15,true,7,11,4,41.9256,-87.65371
TA1309000019,7,15,true,18,20,2,41.92586,-87.63897
TA1309000058,7,15,true,9,10,1,41.92591,-87.64927
TA1308000001,7,15,true,46,43,-3,41.92627,-87.63086
13124,7,15,true,10,12,2,41.92675,-87.63444
TA1309000023,7,15,true,3,7,4,41.9287,-87.65383
TA1307000113,7,15,true,8,11,3,41.92878,-87.66391
13296,7,15,true,6,3,-3,41.92883,-87.66852
TA1309000059,7,15,true,6,4,-2,41.92889,-87.65898
TA1309000061,7,15,true,11,17,6,41.92915,-87.64909
TA1305000014,7,15,true,18,23,5,41.92956,-87.64313
13085,7,15,true,8,7,-1,41.92958,-87.70789
TA1307000142,7,15,true,19,16,-3,41.93125,-87.64432
13276,7,15,true,12,22,10,41.93132,-87.63874
13271,7,15,true,8,4,-4,41.93192,-87.67784
TA1307000064,7,15,true,7,10,3,41.93222,-87.65864
TA1306000014,7,15,true,13,15,2,41.93242,-87.65271
TA1309000039,7,15,true,25,23,-2,41.93258,-87.63642
13294,7,15,true,5,6,1,41.9326,-87.66595
TA1309000036,7,15,true,13,11,-2,41.93313,-87.64776
TA1307000052,7,15,true,9,6,-3,41.93628,-87.65266
TA1307000136,7,15,true,11,12,1,41.9365,-87.64755
TA1307000041,7,15,true,25,24,-1,41.93669,-87.63683
13137,7,15,true,20,19,-1,41.9376,-87.6441
KA17018068,7,15,true,5,2,-3,41.93935,-87.68327
TA1309000042,7,15,true,7,3,-4,41.93937,-87.66836
13229,7,15,true,4,6,2,41.93946,-87.66376
TA1308000019,7,15,true,10,7,-3,41.93973,-87.65886
13277,7,15,true,5,12,7,41.9401,-87.64546
TA1307000134,7,15,true,21,12,-9,41.94016,-87.65303
TA1309000049,7,15,true,29,15,-14,41.94077,-87.63919
TA1307000138,7,15,true,9,7,-2,41.94334,-87.67094
TA1309000025,7,15,true,22,18,-4,41.94368,-87.64894
13071,7,15,true,7,16,9,41.94373,-87.66401
632,7,15,true,7,9,2,41.94453,-87.6547
13278,7,15,true,16,17,1,41.94553,-87.64644
TA1309000050,7,15,true,5,3,-2,41.94618,-87.67331
13235,7,15,true,13,8,-5,41.94814,-87.66396
13325,7,15,true,16,16,0,41.94907,-87.64863
TA1307000126,7,15,true,10,12,2,41.94936,-87.65451
TA1307000150,7,15,true,14,17,3,41.94945,-87.64646
13319,7,15,true,5,1,-4,41.95069,-87.6687
15628,7,15,true,3,6,3,41.95216,-87.69806
13323,7,15,true,5,4,-1,41.95282,-87.65
TA1309000043,7,15,true,5,2,-3,41.95417,-87.66434
TA1308000022,7,15,true,7,9,2,41.95438,-87.64805
TA1309000026,7,15,true,4,8,4,41.95601,-87.6802
13379,7,15,true,13,13,0,41.95786,-87.6495
TA1309000027,7,15,true,4,6,2,41.9585,-87.65499
13389,7,15,true,18,7,-11,41.961,-87.64958
TA1307000144,7,15,true,7,4,-3,41.96142,-87.6762
TA1307000107,7,15,true,15,11,-4,41.96164,-87.65464
TA1307000156,7,15,true,7,6,-1,41.96301,-87.68479
TA1308000012,7,15,true,29,27,-2,41.96398,-87.63818
13074,7,15,true,4,13,9,41.96521,-87.6582
TA1309000014,7,15,true,11,9,-2,41.96709,-87.66744
TA1307000158,7,15,true,7,7,0,41.9671,-87.67904
TA1307000119,7,15,true,9,5,-4,41.96796,-87.65
TA1308000021,7,15,true,2,6,4,41.96883,-87.65765
TA1309000066,7,15,true,12,10,-2,41.9691,-87.67423
TA1309000041,7,15,true,2,6,4,41.96951,-87.65471
KA1504000171,7,15,true,10,6,-4,41.97161,-87.65016
TA1309000035,7,15,true,9,11,2,41.97335,-87.66785
13108,7,15,true,11,7,-4,41.97379,-87.65971
KA1504000149,7,15,true,8,6,-2,41.97562,-87.67945
KA1504000146,7,15,true,6,9,3,41.978,-87.66805
13109,7,15,true,8,8,0,41.97835,-87.65976
KA1504000151,7,15,true,5,6,1,41.98359,-87.66916
KA1504000152,7,15,true,21,27,6,41.98403,-87.65231
15578,7,15,true,5,3,-2,41.98405,-87.66027
15571,7,15,true,7,1,-6,41.99478,-87.66028
RP-009,7,15,true,6,3,-3,42.00107,-87.66122
660,7,15,true,1,5,4,42.00458,-87.66143
KA1504000175,7,15,true,5,1,-4,42.00797,-87.66549
596,7,15,true,2,6,4,42.04822,-87.68348
KA1503000002,7,16,false,3,5,2,41.76641,-87.5657
15491,7,16,false,4,9,5,41.78096,-87.57624
KA1503000014,7,16,false,3,8,5,41.7851,-87.60108
KA1503000074,7,16,false,13,5,-8,41.79174,-87.58395
TA1309000063,7,16,false,7,6,-1,41.79325,-87.5878
KA1504000076,7,16,false,3,5,2,41.7943,-87.60145
TA1308000009,7,16,false,15,33,18,41.79522,-87.58075
TA1307000164,7,16,false,3,7,4,41.79527,-87.59647
KA1503000059,7,16,false,13,3,-10,41.79952,-87.58643
TA1309000037,7,16,false,1,8,7,41.79957,-87.59474
KA1503000007,7,16,false,7,4,-3,41.80242,-87.58689
TA1308000023,7,16,false,7,5,-2,41.81649,-87.60659
TA1308000043,7,16,false,8,1,-7,41.83066,-87.64715
KA1503000005,7,16,false,9,1,-8,41.83079,-87.6325
KA1503000004,7,16,false,9,10,1,41.83127,-87.6088
13216,7,16,false,8,2,-6,41.83473,-87.62581
TA1309000055,7,16,false,1,8,7,41.8382,-87.64514
TA1307000048,7,16,false,16,30,14,41.83855,-87.60821
TA1307000139,7,16,false,4,5,1,41.84205,-87.61698
TA1308000026,7,16,false,2,5,3,41.85008,-87.63214
TA1305000001,7,16,false,9,7,-2,41.85262,-87.6265
13075,7,16,false,14,10,-4,41.8531,-87.63192
13096,7,16,false,1,6,5,41.8538,-87.69577
15545,7,16,false,17,20,3,41.85627,-87.61334
SL-013,7,16,false,5,1,-4,41.85659,-87.62755
SL-006,7,16,false,1,5,4,41.8568,-87.63387
13135,7,16,false,6,2,-4,41.85753,-87.66157
13102,7,16,false,11,7,-4,41.85762,-87.61942
13150,7,16,false,11,5,-6,41.85783,-87.62455
13099,7,16,false,5,2,-3,41.85784,-87.64627
TA1307000044,7,16,false,2,5,3,41.85794,-87.64083
13164,7,16,false,5,15,10,41.85818,-87.65648
SL-012,7,16,false,5,8,3,41.86038,-87.62581
TA1307000124,7,16,false,12,5,-7,41.86411,-87.62372
TA1309000001,7,16,false,1,9,8,41.86488,-87.64708
13029,7,16,false,17,5,-12,41.86531,-87.6179
13431,7,16,false,33,30,-3,41.8661,-87.60728
WL-008,7,16,false,13,4,-9,41.86712,-87.64108
TA1305000002,7,16,false,23,15,-8,41.86721,-87.62597
15544,7,16,false,38,42,4,41.86723,-87.61536
KA1706005007,7,16,false,7,8,1,41.86749,-87.63219
SL-005,7,16,false,25,34,9,41.8679,-87.62304
13139,7,16,false,2,5,3,41.86893,-87.65913
13160,7,16,false,4,8,4,41.86947,-87.65548
TA1309000010,7,16,false,13,15,2,41.87074,-87.62574
SL-009,7,16,false,1,5,4,41.87081,-87.63121
SL-008,7,16,false,7,18,11,41.87209,-87.62956
SL-011,7,16,false,6,7,1,41.87256,-87.63356
623,7,16,false,35,29,-6,41.87272,-87.62399
SL-007,7,16,false,11,5,-6,41.87404,-87.6277
SL-010,7,16,false,5,5,0,41.87501,-87.63309
15541,7,16,false,33,32,-1,41.8758,-87.62086
TA1305000010,7,16,false,12,7,-5,41.87623,-87.62444
624,7,16,false,4,14,10,41.87626,-87.62923
TA1305000035,7,16,false,13,8,-5,41.87716,-87.62787
13138,7,16,false,4,6,2,41.87723,-87.63941
15539,7,16,false,12,13,1,41.87763,-87.64405
13158,7,16,false,9,9,0,41.87764,-87.64957
13157,7,16,false,9,9,0,41.87773,-87.6548
TA1305000025,7,16,false,4,12,8,41.87773,-87.63528
TA1309000002,7,16,false,23,18,-5,41.87784,-87.62408
638,7,16,false,2,7,5,41.87827,-87.64078
13011,7,16,false,3,11,8,41.87931,-87.63993
TA1309000008,7,16,false,11,19,8,41.87933,-87.6355
13156,7,16,false,10,7,-3,41.88042,-87.65554
13300,7,16,false,107,102,-5,41.88097,-87.61675
13008,7,16,false,87,75,-12,41.88105,-87.62408
TA1305000006,7,16,false,11,10,-1,41.88122,-87.6296
13056,7,16,false,3,8,5,41.88168,-87.63951
TA1307000120,7,16,false,22,18,-4,41.88188,-87.64879
13341,7,16,false,4,11,7,41.88208,-87.63985
13036,7,16,false,12,10,-2,41.8821,-87.62513
TA1305000032,7,16,false,8,7,-1,41.88218,-87.64109
13353,7,16,false,13,5,-8,41.88283,-87.6612
13409,7,16,false,7,9,2,41.8831,-87.6511
KA1503000072,7,16,false,2,6,4,41.88317,-87.63693
13053,7,16,false,35,23,-12,41.88365,-87.64863
13001,7,16,false,31,28,-3,41.88397,-87.62459
18062,7,16,false,1,5,4,41.88412,-87.65427
TA1306000010,7,16,false,6,8,2,41.88419,-87.62961
TA1305000030,7,16,false,12,16,4,41.88459,-87.63178
15535,7,16,false,6,5,-1,41.8846,-87.64455
TA1305000029,7,16,false,35,22,-13,41.88466,-87.62787
13263,7,16,false,26,22,-4,41.88467,-87.61952
TA1306000015,7,16,false,20,14,-6,41.88549,-87.65232
13021,7,16,false,9,17,8,41.88559,-87.64184
TA1307000111,7,16,false,7,10,3,41.88582,-87.63548
KA1503000012,7,16,false,19,12,-7,41.88599,-87.63089
TA1305000011,7,16,false,28,25,-3,41.886,-87.62418
15534,7,16,false,18,11,-7,41.88627,-87.61749
TA1308000029,7,16,false,6,13,7,41.88673,-87.62225
TA1307000131,7,16,false,25,22,-3,41.88688,-87.62606
KA1503000064,7,16,false,43,42,-1,41.88697,-87.61281
TA1305000022,7,16,false,19,19,0,41.88817,-87.63656
TA1306000003,7,16,false,9,16,7,41.88867,-87.64442
KA1503000043,7,16,false,12,10,-2,41.88918,-87.63851
13050,7,16,false,28,25,-3,41.88919,-87.62775
13432,7,16,false,10,6,-4,41.88989,-87.67149
TA1307000151,7,16,false,23,24,1,41.88993,-87.63427
636,7,16,false,7,10,3,41.88997,-87.63662
KA1503000044,7,16,false,7,6,-1,41.89018,-87.6262
13427,7,16,false,8,12,4,41.89054,-87.62205
13430,7,16,false,11,27,16,41.89077,-87.63169
TA1306000013,7,16,false,41,27,-14,41.89083,-87.61852
RN-,7,16,false,4,9,5,41.89102,-87.63546
TA1307000117,7,16,false,27,54,27,41.89144,-87.62675
13033,7,16,false,16,21,5,41.8916,-87.64835
13194,7,16,false,5,9,4,41.8918,-87.65878
TA1305000003,7,16,false,24,27,3,41.89187,-87.62061
13022,7,16,false,260,279,19,41.89227,-87.61205
TA1306000029,7,16,false,28,36,8,41.89256,-87.61449
13265,7,16,false,10,10,0,41.89383,-87.64172
13045,7,16,false,24,26,2,41.89403,-87.62931
13016,7,16,false,13,27,14,41.89431,-87.62277
KA1503000041,7,16,false,17,8,-9,41.89452,-87.61798
13196,7,16,false,7,4,-3,41.89455,-87.65345
TA1307000062,7,16,false,13,7,-6,41.89466,-87.63839
TA1306000012,7,16,false,17,25,8,41.89475,-87.63438
KP1705001026,7,16,false,13,17,4,41.89483,-87.6323
637,7,16,false,10,4,-6,41.89563,-87.67209
13132,7,16,false,12,7,-5,41.89573,-87.67718
15530,7,16,false,14,18,4,41.89575,-87.62596
18003,7,16,false,4,9,5,41.89575,-87.62011
13247,7,16,false,8,7,-1,41.89597,-87.66775
TA1305000020,7,16,false,12,17,5,41.89636,-87.65406
13289,7,16,false,6,7,1,41.89638,-87.661
13303,7,16,false,17,15,-2,41.89672,-87.63088
13017,7,16,false,2,7,5,41.89676,-87.6357
13338,7,16,false,17,21,4,41.89697,-87.62173
TA1307000061,7,16,false,14,12,-2,41.89745,-87.62873
13034,7,16,false,20,28,8,41.89754,-87.62352
620,7,16,false,8,9,1,41.89817,-87.63754
KA1504000103,7,16,false,1,7,6,41.89842,-87.68659
15529,7,16,false,25,14,-11,41.89858,-87.62206
TA1307000128,7,16,false,13,32,19,41.89896,-87.6299
657,7,16,false,2,8,6,41.89918,-87.6722
TA1306000011,7,16,false,4,8,4,41.89994,-87.63443
13290,7,16,false,7,8,1,41.90069,-87.66259
13042,7,16,false,119,124,5,41.90097,-87.62377
KA1504000133,7,16,false,21,30,9,41.90234,-87.62773
13241,7,16,false,6,3,-3,41.9029,-87.68731
TA1307000039,7,16,false,37,33,-4,41.90294,-87.63137
TA1305000034,7,16,false,8,10,2,41.90313,-87.67391
KA1504000135,7,16,false,34,29,-5,41.90319,-87.63439
13136,7,16,false,6,6,0,41.90326,-87.67845
13061,7,16,false,13,18,5,41.90342,-87.66779
KA1504000079,7,16,false,13,10,-3,41.9035,-87.64334
TA1308000049,7,16,false,23,40,17,41.90672,-87.6349
KA1504000134,7,16,false,24,23,-1,41.90687,-87.6262
13224,7,16,false,12,8,-4,41.90706,-87.66725
TA1307000143,7,16,false,7,5,-2,41.90762,-87.63854
13221,7,16,false,13,17,4,41.90765,-87.67254
TA1309000024,7,16,false,26,29,3,41.908,-87.63152
TA1305000041,7,16,false,24,21,-3,41.9094,-87.67769
331,7,16,false,12,8,-4,41.90965,-87.64812
TA1305000037,7,16,false,11,7,-4,41.91018,-87.67003
TA1306000008,7,16,false,3,6,3,41.9102,-87.6435
TA1308000005,7,16,false,5,2,-3,41.91042,-87.68238
13258,7,16,false,6,10,4,41.91043,-87.69718
13257,7,16,false,5,6,1,41.91054,-87.68956
13154,7,16,false,8,11,3,41.91054,-87.65312
13058,7,16,false,11,4,-7,41.91059,-87.64942
TA1307000038,7,16,false,26,25,-1,41.91138,-87.63868
LF-005,7,16,false,174,116,-58,41.91172,-87.62681
13128,7,16,false,18,19,1,41.91197,-87.63197
TA1308000050,7,16,false,54,31,-23,41.91211,-87.6347
13243,7,16,false,7,6,-1,41.91262,-87.6814
TA1306000032,7,16,false,7,5,-2,41.9137,-87.65285
TA1307000166,7,16,false,9,11,2,41.91386,-87.64877
18017,7,16,false,4,5,1,41.91416,-87.71676
18067,7,16,false,8,7,-1,41.9146,-87.66796
TA1306000007,7,16,false,7,4,-3,41.91469,-87.64333
13068,7,16,false,1,5,4,41.91554,-87.68703
13179,7,16,false,59,71,12,41.9157,-87.63461
13133,7,16,false,8,9,1,41.91598,-87.67733
TA1305000039,7,16,false,6,7,1,41.9163,-87.66749
15650,7,16,false,4,6,2,41.91711,-87.71023
15651,7,16,false,6,10,4,41.91752,-87.70181
13266,7,16,false,8,4,-4,41.91774,-87.69142
TA1309000029,7,16,false,5,11,6,41.9178,-87.68245
TA1309000006,7,16,false,9,9,0,41.91809,-87.64375
TA1307000163,7,16,false,7,6,-1,41.91821,-87.65696
13146,7,16,false,52,35,-17,41.91831,-87.63629
13059,7,16,false,15,20,5,41.91845,-87.65222
13259,7,16,false,4,5,1,41.91852,-87.69744
13192,7,16,false,9,11,2,41.91995,-87.64884
13242,7,16,false,9,12,3,41.92021,-87.69266
TA1309000030,7,16,false,10,14,4,41.92077,-87.66372
13292,7,16,false,8,3,-5,41.92152,-87.70733
TA1309000033,7,16,false,20,16,-4,41.92158,-87.65381
13193,7,16,false,32,34,2,41.92182,-87.64412
13191,7,16,false,17,8,-9,41.92217,-87.63891
13084,7,16,false,8,4,-4,41.92268,-87.69715
LP-,7,16,false,20,18,-2,41.92396,-87.63584
TA1307000001,7,16,false,6,9,3,41.92535,-87.66581
TA1306000026,7,16,false,4,9,5,41.92558,-87.65842
TA1306000016,7,16,false,14,9,-5,41.9256,-87.65371
TA1309000019,7,16,false,27,35,8,41.92586,-87.63897
TA1309000058,7,16,false,12,18,6,41.92591,-87.64927
TA1308000001,7,16,false,112,92,-20,41.92627,-87.63086
13124,7,16,false,25,18,-7,41.92675,-87.63444
TA1309000023,7,16,false,19,12,-7,41.9287,-87.65383
TA1307000113,7,16,false,7,17,10,41.92878,-87.66391
13296,7,16,false,6,7,1,41.92883,-87.66852
TA1309000061,7,16,false,20,14,-6,41.92915,-87.64909
TA1308000031,7,16,false,5,5,0,41.92946,-87.68417
TA1305000014,7,16,false,20,29,9,41.92956,-87.64313
13085,7,16,false,7,13,6,41.92958,-87.70789
TA1307000142,7,16,false,20,20,0,41.93125,-87.64432
13276,7,16,false,27,17,-10,41.93132,-87.63874
13271,7,16,false,4,7,3,41.93192,-87.67784
TA1307000064,7,16,false,11,8,-3,41.93222,-87.65864
TA1306000014,7,16,false,11,12,1,41.93242,-87.65271
TA1309000039,7,16,false,48,27,-21,41.93258,-87.63642
13294,7,16,false,5,8,3,41.9326,-87.66595
TA1309000036,7,16,false,8,14,6,41.93313,-87.64776
TA1307000006,7,16,false,8,8,0,41.93571,-87.6636
13268,7,16,false,12,8,-4,41.93588,-87.67843
13269,7,16,false,11,7,-4,41.93609,-87.66983
TA1307000052,7,16,false,4,22,18,41.93628,-87.65266
TA1307000136,7,16,false,15,11,-4,41.9365,-87.64755
TA1307000041,7,16,false,33,39,6,41.93669,-87.63683
13137,7,16,false,21,31,10,41.9376,-87.6441
15642,7,16,false,4,5,1,41.93843,-87.69801
TA1309000042,7,16,false,8,15,7,41.93937,-87.66836
13229,7,16,false,14,11,-3,41.93946,-87.66376
TA1308000019,7,16,false,20,20,0,41.93973,-87.65886
13277,7,16,false,9,8,-1,41.9401,-87.64546
TA1307000134,7,16,false,34,34,0,41.94016,-87.65303
TA1309000049,7,16,false,32,37,5,41.94077,-87.63919
TA1307000138,7,16,false,4,9,5,41.94334,-87.67094
13144,7,16,false,7,4,-3,41.9434,-87.67964
TA1309000025,7,16,false,12,27,15,41.94368,-87.64894
13071,7,16,false,18,18,0,41.94373,-87.66401
632,7,16,false,14,16,2,41.94453,-87.6547
13278,7,16,false,12,29,17,41.94553,-87.64644
KA1504000142,7,16,false,5,5,0,41.94735,-87.71759
13235,7,16,false,28,19,-9,41.94814,-87.66396
13325,7,16,false,18,21,3,41.94907,-87.64863
TA1307000126,7,16,false,42,43,1,41.94936,-87.65451
TA1307000150,7,16,false,22,23,1,41.94945,-87.64646
13319,7,16,false,6,4,-2,41.95069,-87.6687
TA1307000127,7,16,false,21,28,7,41.9508,-87.65918
13063,7,16,false,8,3,-5,41.95424,-87.65441
TA1308000022,7,16,false,13,29,16,41.95438,-87.64805
TA1307000149,7,16,false,7,1,-6,41.95467,-87.67392
13379,7,16,false,7,9,2,41.95786,-87.6495
TA1309000027,7,16,false,1,8,7,41.9585,-87.65499
13389,7,16,false,13,15,2,41.961,-87.64958
15622,7,16,false,5,4,-1,41.96108,-87.69544
KA1503000022,7,16,false,12,7,-5,41.96158,-87.66609
TA1307000107,7,16,false,11,26,15,41.96164,-87.65464
TA1307000156,7,16,false,5,3,-2,41.96301,-87.68479
TA1308000012,7,16,false,63,62,-1,41.96398,-87.63818
13074,7,16,false,6,10,4,41.96521,-87.6582
639,7,16,false,10,15,5,41.96584,-87.64538
TA1307000140,7,16,false,4,6,2,41.96643,-87.68865
TA1309000014,7,16,false,7,2,-5,41.96709,-87.66744
TA1307000119,7,16,false,9,4,-5,41.96796,-87.65
TA1308000021,7,16,false,4,6,2,41.96883,-87.65765
KA1504000080,7,16,false,2,6,4,41.96887,-87.69609
TA1309000066,7,16,false,11,3,-8,41.9691,-87.67423
KA1504000171,7,16,false,14,10,-4,41.97161,-87.65016
TA1309000035,7,16,false,6,13,7,41.97335,-87.66785
13108,7,16,false,10,6,-4,41.97379,-87.65971
KA1504000149,7,16,false,2,6,4,41.97562,-87.67945
KA1504000128,7,16,false,7,4,-3,41.97567,-87.70927
KA1504000146,7,16,false,11,8,-3,41.978,-87.66805
13109,7,16,false,3,10,7,41.97835,-87.65976
655,7,16,false,6,5,-1,41.97987,-87.68194
KA1504000151,7,16,false,7,6,-1,41.98359,-87.66916
KA1504000152,7,16,false,28,20,-8,41.98403,-87.65231
15578,7,16,false,6,3,-3,41.98405,-87.66027
15575,7,16,false,6,7,1,41.98975,-87.66014
15571,7,16,false,6,10,4,41.99478,-87.66028
RP-009,7,16,false,3,7,4,42.00107,-87.66122
660,7,16,false,3,5,2,42.00458,-87.66143
523,7,16,false,1,6,5,42.02089,-87.66505
E002,7,16,false,5,3,-2,42.03256,-87.67912
596,7,16,false,8,6,-2,42.04822,-87.68348
E008,7,16,false,4,8,4,42.05049,-87.67782
605,7,16,false,7,3,-4,42.05294,-87.67342
604,7,16,false,6,2,-4,42.05824,-87.67744
KA1503000014,7,16,true,1,7,6,41.7851,-87.60108
KA1503000074,7,16,true,5,1,-4,41.79174,-87.58395
TA1309000063,7,16,true,8,5,-3,41.79325,-87.5878
TA1308000009,7,16,true,14,12,-2,41.79522,-87.58075
TA1307000164,7,16,true,6,4,-2,41.79527,-87.59647
KA1503000059,7,16,true,6,2,-4,41.79952,-87.58643
KA1503000007,7,16,true,2,7,5,41.80242,-87.58689
13398,7,16,true,5,3,-2,41.80256,-87.59035
15446,7,16,true,5,7,2,41.83068,-87.65603
13216,7,16,true,6,6,0,41.83473,-87.62581
TA1309000055,7,16,true,5,7,2,41.8382,-87.64514
TA1307000048,7,16,true,9,6,-3,41.83855,-87.60821
TA1307000139,7,16,true,7,4,-3,41.84205,-87.61698
TA1307000153,7,16,true,3,6,3,41.84358,-87.64538
TA1305000001,7,16,true,2,7,5,41.85262,-87.6265
13075,7,16,true,11,8,-3,41.8531,-87.63192
15545,7,16,true,23,24,1,41.85627,-87.61334
SL-013,7,16,true,7,2,-5,41.85659,-87.62755
13102,7,16,true,7,11,4,41.85762,-87.61942
13150,7,16,true,6,10,4,41.85783,-87.62455
13164,7,16,true,2,6,4,41.85818,-87.65648
SL-012,7,16,true,5,11,6,41.86038,-87.62581
TA1306000002,7,16,true,5,4,-1,41.86238,-87.65108
TA1307000124,7,16,true,11,12,1,41.86411,-87.62372
TA1309000001,7,16,true,5,3,-2,41.86488,-87.64708
13431,7,16,true,9,10,1,41.8661,-87.60728
WL-008,7,16,true,15,9,-6,41.86712,-87.64108
TA1305000002,7,16,true,18,18,0,41.86721,-87.62597
15544,7,16,true,3,5,2,41.86723,-87.61536
KA1706005007,7,16,true,8,10,2,41.86749,-87.63219
SL-005,7,16,true,14,13,-1,41.8679,-87.62304
644,7,16,true,5,3,-2,41.86859,-87.68625
13139,7,16,true,8,6,-2,41.86893,-87.65913
13160,7,16,true,3,11,8,41.86947,-87.65548
TA1309000010,7,16,true,8,11,3,41.87074,-87.62574
SL-009,7,16,true,1,9,8,41.87081,-87.63121
TA1307000130,7,16,true,8,3,-5,41.87178,-87.65103
TA1307000121,7,16,true,11,5,-6,41.87184,-87.64664
SL-008,7,16,true,13,9,-4,41.87209,-87.62956
13332,7,16,true,17,16,-1,41.87219,-87.6615
SL-011,7,16,true,5,2,-3,41.87256,-87.63356
623,7,16,true,8,7,-1,41.87272,-87.62399
SL-007,7,16,true,9,8,-1,41.87404,-87.6277
TA1306000025,7,16,true,3,5,2,41.87464,-87.65703
15668,7,16,true,7,2,-5,41.87471,-87.68642
15541,7,16,true,7,4,-3,41.8758,-87.62086
624,7,16,true,5,1,-4,41.87626,-87.62923
TA1305000035,7,16,true,9,3,-6,41.87716,-87.62787
15539,7,16,true,10,12,2,41.87763,-87.64405
13158,7,16,true,6,10,4,41.87764,-87.64957
13157,7,16,true,10,10,0,41.87773,-87.6548
TA1305000025,7,16,true,6,6,0,41.87773,-87.63528
13206,7,16,true,6,3,-3,41.87794,-87.66201
13011,7,16,true,5,2,-3,41.87931,-87.63993
WL-011,7,16,true,7,10,3,41.88034,-87.64273
13156,7,16,true,8,14,6,41.88042,-87.65554
13300,7,16,true,25,38,13,41.88097,-87.61675
13008,7,16,true,7,11,4,41.88105,-87.62408
TA1305000006,7,16,true,8,10,2,41.88122,-87.6296
TA1307000120,7,16,true,18,18,0,41.88188,-87.64879
13036,7,16,true,6,3,-3,41.8821,-87.62513
TA1305000032,7,16,true,12,9,-3,41.88218,-87.64109
13353,7,16,true,2,5,3,41.88283,-87.6612
654,7,16,true,5,4,-1,41.88307,-87.65698
13409,7,16,true,5,4,-1,41.8831,-87.6511
13053,7,16,true,11,17,6,41.88365,-87.64863
13001,7,16,true,9,5,-4,41.88397,-87.62459
13155,7,16,true,5,2,-3,41.88407,-87.65689
18062,7,16,true,5,6,1,41.88412,-87.65427
TA1306000010,7,16,true,12,7,-5,41.88419,-87.62961
TA1305000030,7,16,true,8,2,-6,41.88459,-87.63178
15535,7,16,true,8,13,5,41.8846,-87.64455
TA1305000029,7,16,true,10,10,0,41.88466,-87.62787
13263,7,16,true,10,9,-1,41.88467,-87.61952
TA1306000015,7,16,true,10,8,-2,41.88549,-87.65232
13021,7,16,true,10,3,-7,41.88559,-87.64184
TA1307000111,7,16,true,6,6,0,41.88582,-87.63548
13073,7,16,true,6,1,-5,41.88592,-87.66717
KA1503000012,7,16,true,12,12,0,41.88599,-87.63089
TA1305000011,7,16,true,4,5,1,41.886,-87.62418
15534,7,16,true,5,12,7,41.88627,-87.61749
TA1308000029,7,16,true,5,4,-1,41.88673,-87.62225
TA1307000131,7,16,true,7,6,-1,41.88688,-87.62606
KA1503000064,7,16,true,13,11,-2,41.88697,-87.61281
TA1305000022,7,16,true,13,10,-3,41.88817,-87.63656
TA1306000003,7,16,true,21,12,-9,41.88867,-87.64442
KA1503000043,7,16,true,22,17,-5,41.88918,-87.63851
13050,7,16,true,7,6,-1,41.88919,-87.62775
13432,7,16,true,3,6,3,41.88989,-87.67149
TA1307000151,7,16,true,12,12,0,41.88993,-87.63427
636,7,16,true,6,12,6,41.88997,-87.63662
KA1503000044,7,16,true,5,9,4,41.89018,-87.6262
13427,7,16,true,4,5,1,41.89054,-87.62205
13430,7,16,true,17,13,-4,41.89077,-87.63169
TA1306000013,7,16,true,17,15,-2,41.89083,-87.61852
TA1307000117,7,16,true,23,17,-6,41.89144,-87.62675
13033,7,16,true,9,22,13,41.8916,-87.64835
13194,7,16,true,4,6,2,41.8918,-87.65878
TA1305000003,7,16,true,9,12,3,41.89187,-87.62061
13022,7,16,true,45,47,2,41.89227,-87.61205
TA1306000029,7,16,true,12,22,10,41.89256,-87.61449
13265,7,16,true,12,13,1,41.89383,-87.64172
13045,7,16,true,19,15,-4,41.89403,-87.62931
13016,7,16,true,8,6,-2,41.89431,-87.62277
KA1503000041,7,16,true,2,5,3,41.89452,-87.61798
13196,7,16,true,5,5,0,41.89455,-87.65345
TA1307000062,7,16,true,9,15,6,41.89466,-87.63839
TA1306000012,7,16,true,15,17,2,41.89475,-87.63438
KP1705001026,7,16,true,9,9,0,41.89483,-87.6323
637,7,16,true,4,9,5,41.89563,-87.67209
13132,7,16,true,4,8,4,41.89573,-87.67718
15530,7,16,true,12,10,-2,41.89575,-87.62596
18003,7,16,true,6,3,-3,41.89575,-87.62011
TA1305000020,7,16,true,2,5,3,41.89636,-87.65406
13289,7,16,true,7,9,2,41.89638,-87.661
13303,7,16,true,8,11,3,41.89672,-87.63088
13017,7,16,true,5,6,1,41.89676,-87.6357
13338,7,16,true,6,7,1,41.89697,-87.62173
13034,7,16,true,10,6,-4,41.89754,-87.62352
TA1306000009,7,16,true,6,4,-2,41.89772,-87.64299
620,7,16,true,7,6,-1,41.89817,-87.63754
15529,7,16,true,8,12,4,41.89858,-87.62206
TA1307000128,7,16,true,20,21,1,41.89896,-87.6299
657,7,16,true,3,5,2,41.89918,-87.6722
13248,7,16,true,3,6,3,41.89964,-87.66788
TA1306000011,7,16,true,4,5,1,41.89994,-87.63443
17660,7,16,true,6,1,-5,41.90036,-87.69671
13290,7,16,true,7,8,1,41.90069,-87.66259
13042,7,16,true,46,41,-5,41.90097,-87.62377
TA1307000070,7,16,true,8,6,-2,41.90133,-87.67742
KA1504000133,7,16,true,11,10,-1,41.90234,-87.62773
13241,7,16,true,2,5,3,41.9029,-87.68731
TA1307000039,7,16,true,36,17,-19,41.90294,-87.63137
TA1305000034,7,16,true,15,6,-9,41.90313,-87.67391
KA1504000135,7,16,true,27,29,2,41.90319,-87.63439
13136,7,16,true,9,6,-3,41.90326,-87.67845
13061,7,16,true,7,8,1,41.90342,-87.66779
KA1504000079,7,16,true,10,17,7,41.9035,-87.64334
TA1308000049,7,16,true,18,24,6,41.90672,-87.6349
KA1504000134,7,16,true,4,9,5,41.90687,-87.6262
13224,7,16,true,4,8,4,41.90706,-87.66725
13221,7,16,true,13,6,-7,41.90765,-87.67254
TA1309000024,7,16,true,11,14,3,41.908,-87.63152
TA1305000041,7,16,true,10,17,7,41.9094,-87.67769
331,7,16,true,16,16,0,41.90965,-87.64812
TA1305000037,7,16,true,3,8,5,41.91018,-87.67003
TA1306000008,7,16,true,8,3,-5,41.9102,-87.6435
TA1308000005,7,16,true,8,4,-4,41.91042,-87.68238
13258,7,16,true,6,4,-2,41.91043,-87.69718
13154,7,16,true,21,16,-5,41.91054,-87.65312
13058,7,16,true,8,8,0,41.91059,-87.64942
TA1307000038,7,16,true,7,15,8,41.91138,-87.63868
LF-005,7,16,true,73,56,-17,41.91172,-87.62681
13128,7,16,true,17,7,-10,41.91197,-87.63197
TA1308000050,7,16,true,42,34,-8,41.91211,-87.6347
13243,7,16,true,12,10,-2,41.91262,-87.6814
TA1306000032,7,16,true,10,8,-2,41.9137,-87.65285
TA1307000166,7,16,true,11,10,-1,41.91386,-87.64877
18017,7,16,true,4,5,1,41.91416,-87.71676
18067,7,16,true,14,8,-6,41.9146,-87.66796
TA1306000007,7,16,true,4,5,1,41.91469,-87.64333
13068,7,16,true,6,3,-3,41.91554,-87.68703
13179,7,16,true,43,34,-9,41.9157,-87.63461
13133,7,16,true,9,13,4,41.91598,-87.67733
TA1305000039,7,16,true,9,7,-2,41.9163,-87.66749
15651,7,16,true,5,2,-3,41.91752,-87.70181
TA1309000029,7,16,true,6,8,2,41.9178,-87.68245
TA1309000006,7,16,true,12,8,-4,41.91809,-87.64375
TA1307000163,7,16,true,10,5,-5,41.91821,-87.65696
13146,7,16,true,22,22,0,41.91831,-87.63629
13059,7,16,true,16,25,9,41.91845,-87.65222
13192,7,16,true,8,11,3,41.91995,-87.64884
13288,7,16,true,4,9,5,41.92008,-87.67788
TA1309000030,7,16,true,5,8,3,41.92077,-87.66372
TA1309000033,7,16,true,19,19,0,41.92158,-87.65381
13193,7,16,true,24,25,1,41.92182,-87.64412
13191,7,16,true,8,7,-1,41.92217,-87.63891
13084,7,16,true,8,10,2,41.92268,-87.69715
LP-,7,16,true,13,10,-3,41.92396,-87.63584
TA1307000001,7,16,true,5,6,1,41.92535,-87.66581
TA1306000026,7,16,true,7,7,0,41.92558,-87.65842
TA1306000016,7,16,true,5,8,3,41.9256,-87.65371
TA1309000019,7,16,true,19,19,0,41.92586,-87.63897
TA1309000058,7,16,true,15,10,-5,41.92591,-87.64927
TA1308000001,7,16,true,57,49,-8,41.92627,-87.63086
15646,7,16,true,5,7,2,41.92668,-87.6977
13124,7,16,true,5,4,-1,41.92675,-87.63444
TA1309000023,7,16,true,13,14,1,41.9287,-87.65383
TA1307000113,7,16,true,8,11,3,41.92878,-87.66391
13296,7,16,true,4,8,4,41.92883,-87.66852
TA1309000059,7,16,true,4,9,5,41.92889,-87.65898
TA1309000061,7,16,true,9,21,12,41.92915,-87.64909
TA1305000014,7,16,true,18,22,4,41.92956,-87.64313
13085,7,16,true,2,5,3,41.92958,-87.70789
TA1307000142,7,16,true,18,22,4,41.93125,-87.64432
13276,7,16,true,12,11,-1,41.93132,-87.63874
13271,7,16,true,6,6,0,41.93192,-87.67784
TA1307000064,7,16,true,11,6,-5,41.93222,-87.65864
TA1306000014,7,16,true,15,7,-8,41.93242,-87.65271
TA1309000039,7,16,true,22,26,4,41.93258,-87.63642
TA1309000036,7,16,true,5,9,4,41.93313,-87.64776
TA1307000006,7,16,true,5,15,10,41.93571,-87.6636
13268,7,16,true,2,5,3,41.93588,-87.67843
TA1307000052,7,16,true,12,11,-1,41.93628,-87.65266
TA1307000136,7,16,true,13,17,4,41.9365,-87.64755
TA1307000041,7,16,true,30,23,-7,41.93669,-87.63683
13137,7,16,true,28,25,-3,41.9376,-87.6441
TA1309000042,7,16,true,5,11,6,41.93937,-87.66836
13229,7,16,true,6,6,0,41.93946,-87.66376
TA1308000019,7,16,true,6,10,4,41.93973,-87.65886
13277,7,16,true,15,16,1,41.9401,-87.64546
TA1307000134,7,16,true,16,24,8,41.94016,-87.65303
13143,7,16,true,2,7,5,41.94059,-87.67853
TA1309000049,7,16,true,17,21,4,41.94077,-87.63919
TA1307000138,7,16,true,6,5,-1,41.94334,-87.67094
TA1309000025,7,16,true,15,17,2,41.94368,-87.64894
13071,7,16,true,20,13,-7,41.94373,-87.66401
632,7,16,true,12,7,-5,41.94453,-87.6547
13278,7,16,true,14,24,10,41.94553,-87.64644
13235,7,16,true,17,15,-2,41.94814,-87.66396
13253,7,16,true,3,6,3,41.9488,-87.67527
13325,7,16,true,23,24,1,41.94907,-87.64863
TA1307000126,7,16,true,21,22,1,41.94936,-87.65451
TA1307000150,7,16,true,16,19,3,41.94945,-87.64646
13319,7,16,true,5,3,-2,41.95069,-87.6687
TA1307000127,7,16,true,7,5,-2,41.9508,-87.65918
13323,7,16,true,6,6,0,41.95282,-87.65
TA1309000043,7,16,true,5,4,-1,41.95417,-87.66434
13063,7,16,true,1,10,9,41.95424,-87.65441
TA1308000022,7,16,true,17,10,-7,41.95438,-87.64805
TA1307000149,7,16,true,9,8,-1,41.95467,-87.67392
TA1309000026,7,16,true,8,11,3,41.95601,-87.6802
TA1308000047,7,16,true,3,6,3,41.95709,-87.6642
13379,7,16,true,7,10,3,41.95786,-87.6495
TA1309000027,7,16,true,4,6,2,41.9585,-87.65499
13389,7,16,true,11,14,3,41.961,-87.64958
15622,7,16,true,5,2,-3,41.96108,-87.69544
TA1307000144,7,16,true,5,6,1,41.96142,-87.6762
TA1307000107,7,16,true,17,9,-8,41.96164,-87.65464
TA1307000156,7,16,true,3,7,4,41.96301,-87.68479
TA1308000012,7,16,true,28,25,-3,41.96398,-87.63818
13074,7,16,true,9,5,-4,41.96521,-87.6582
639,7,16,true,17,11,-6,41.96584,-87.64538
TA1307000140,7,16,true,7,10,3,41.96643,-87.68865
TA1309000014,7,16,true,6,6,0,41.96709,-87.66744
TA1307000119,7,16,true,3,6,3,41.96796,-87.65
TA1308000021,7,16,true,4,5,1,41.96883,-87.65765
KA1504000080,7,16,true,4,5,1,41.96887,-87.69609
TA1309000066,7,16,true,10,13,3,41.9691,-87.67423
TA1309000041,7,16,true,3,5,2,41.96951,-87.65471
KA1504000171,7,16,true,8,15,7,41.97161,-87.65016
TA1309000035,7,16,true,6,9,3,41.97335,-87.66785
13108,7,16,true,5,7,2,41.97379,-87.65971
KA1504000149,7,16,true,5,2,-3,41.97562,-87.67945
KA1504000146,7,16,true,18,8,-10,41.978,-87.66805
13109,7,16,true,12,6,-6,41.97835,-87.65976
KA1504000151,7,16,true,6,5,-1,41.98359,-87.66916
KA1504000152,7,16,true,21,18,-3,41.98403,-87.65231
15575,7,16,true,2,5,3,41.98975,-87.66014
15571,7,16,true,5,4,-1,41.99478,-87.66028
660,7,16,true,1,5,4,42.00458,-87.66143
15491,7,17,false,9,2,-7,41.78096,-87.57624
KA1503000014,7,17,false,7,4,-3,41.7851,-87.60108
KA1503000074,7,17,false,11,10,-1,41.79174,-87.58395
TA1309000063,7,17,false,5,2,-3,41.79325,-87.5878
KA1504000076,7,17,false,2,5,3,41.7943,-87.60145
TA1308000009,7,17,false,30,18,-12,41.79522,-87.58075
TA1307000164,7,17,false,6,6,0,41.79527,-87.59647
KA1503000052,7,17,false,2,6,4,41.79935,-87.60097
KA1503000059,7,17,false,8,13,5,41.79952,-87.58643
TA1309000037,7,17,false,8,7,-1,41.79957,-87.59474
KA1503000007,7,17,false,9,11,2,41.80242,-87.58689
13398,7,17,false,7,6,-1,41.80256,-87.59035
KA1503000065,7,17,false,4,6,2,41.81409,-87.59701
13420,7,17,false,7,1,-6,41.82459,-87.61678
KA1503000004,7,17,false,9,7,-2,41.83127,-87.6088
13215,7,17,false,7,2,-5,41.83634,-87.6135
TA1307000048,7,17,false,35,26,-9,41.83855,-87.60821
TA1307000139,7,17,false,8,2,-6,41.84205,-87.61698
TA1305000001,7,17,false,5,5,0,41.85262,-87.6265
13075,7,17,false,13,11,-2,41.8531,-87.63192
13307,7,17,false,1,5,4,41.85489,-87.66359
15545,7,17,false,23,26,3,41.85627,-87.61334
SL-006,7,17,false,5,2,-3,41.8568,-87.63387
13135,7,17,false,3,6,3,41.85753,-87.66157
13102,7,17,false,7,5,-2,41.85762,-87.61942
13150,7,17,false,5,13,8,41.85783,-87.62455
TA1307000159,7,17,false,3,6,3,41.8579,-87.6687
SL-012,7,17,false,6,12,6,41.86038,-87.62581
TA1307000124,7,17,false,3,13,10,41.86411,-87.62372
13029,7,17,false,5,6,1,41.86531,-87.6179
13431,7,17,false,38,34,-4,41.8661,-87.60728
WL-008,7,17,false,6,3,-3,41.86712,-87.64108
TA1305000002,7,17,false,18,27,9,41.86721,-87.62597
15544,7,17,false,60,55,-5,41.86723,-87.61536
KA1706005007,7,17,false,6,1,-5,41.86749,-87.63219
SL-005,7,17,false,41,39,-2,41.8679,-87.62304
TA1309000010,7,17,false,18,14,-4,41.87074,-87.62574
SL-009,7,17,false,6,3,-3,41.87081,-87.63121
TA1307000130,7,17,false,5,2,-3,41.87178,-87.65103
SL-008,7,17,false,17,17,0,41.87209,-87.62956
13332,7,17,false,6,6,0,41.87219,-87.6615
SL-011,7,17,false,13,13,0,41.87256,-87.63356
623,7,17,false,18,27,9,41.87272,-87.62399
SL-007,7,17,false,9,22,13,41.87404,-87.6277
15541,7,17,false,38,29,-9,41.8758,-87.62086
TA1305000010,7,17,false,2,10,8,41.87623,-87.62444
624,7,17,false,11,9,-2,41.87626,-87.62923
TA1305000035,7,17,false,5,12,7,41.87716,-87.62787
15539,7,17,false,7,5,-2,41.87763,-87.64405
13158,7,17,false,11,4,-7,41.87764,-87.64957
13157,7,17,false,10,7,-3,41.87773,-87.6548
TA1305000025,7,17,false,14,16,2,41.87773,-87.63528
TA1309000002,7,17,false,15,11,-4,41.87784,-87.62408
13206,7,17,false,5,5,0,41.87794,-87.66201
13011,7,17,false,11,6,-5,41.87931,-87.63993
KA1503000015,7,17,false,2,7,5,41.87948,-87.6257
TA1309000007,7,17,false,5,10,5,41.88022,-87.63526
WL-011,7,17,false,6,7,1,41.88034,-87.64273
13156,7,17,false,14,10,-4,41.88042,-87.65554
13300,7,17,false,88,86,-2,41.88097,-87.61675
13008,7,17,false,65,80,15,41.88105,-87.62408
TA1305000006,7,17,false,12,7,-5,41.88122,-87.6296
TA1307000120,7,17,false,16,27,11,41.88188,-87.64879
13341,7,17,false,7,2,-5,41.88208,-87.63985
13036,7,17,false,7,5,-2,41.8821,-87.62513
TA1305000032,7,17,false,10,19,9,41.88218,-87.64109
13353,7,17,false,2,7,5,41.88283,-87.6612
13409,7,17,false,10,12,2,41.8831,-87.6511
13053,7,17,false,20,26,6,41.88365,-87.64863
13001,7,17,false,13,36,23,41.88397,-87.62459
13155,7,17,false,1,5,4,41.88407,-87.65689
18062,7,17,false,3,6,3,41.88412,-87.65427
TA1306000010,7,17,false,14,5,-9,41.88419,-87.62961
TA1305000030,7,17,false,14,17,3,41.88459,-87.63178
15535,7,17,false,11,12,1,41.8846,-87.64455
TA1305000029,7,17,false,28,32,4,41.88466,-87.62787
13263,7,17,false,22,20,-2,41.88467,-87.61952
TA1306000015,7,17,false,16,22,6,41.88549,-87.65232
13021,7,17,false,14,8,-6,41.88559,-87.64184
TA1307000111,7,17,false,9,10,1,41.88582,-87.63548
KA1503000012,7,17,false,8,20,12,41.88599,-87.63089
TA1305000011,7,17,false,45,48,3,41.886,-87.62418
15534,7,17,false,16,19,3,41.88627,-87.61749
13197,7,17,false,3,5,2,41.8866,-87.65816
TA1308000029,7,17,false,12,17,5,41.88673,-87.62225
TA1307000131,7,17,false,28,20,-8,41.88688,-87.62606
KA1503000064,7,17,false,31,33,2,41.88697,-87.61281
TA1305000022,7,17,false,15,16,1,41.88817,-87.63656
TA1306000003,7,17,false,10,16,6,41.88867,-87.64442
KA1503000043,7,17,false,17,12,-5,41.88918,-87.63851
13050,7,17,false,11,26,15,41.88919,-87.62775
15664,7,17,false,1,6,5,41.8895,-87.68821
TA1307000151,7,17,false,9,16,7,41.88993,-87.63427
636,7,17,false,8,3,-5,41.88997,-87.63662
13427,7,17,false,11,4,-7,41.89054,-87.62205
13430,7,17,false,21,13,-8,41.89077,-87.63169
TA1306000013,7,17,false,30,30,0,41.89083,-87.61852
RN-,7,17,false,10,13,3,41.89102,-87.63546
13434,7,17,false,5,10,5,41.89108,-87.66663
TA1308000006,7,17,false,4,9,5,41.89128,-87.67686
TA1307000117,7,17,false,47,41,-6,41.89144,-87.62675
13033,7,17,false,9,7,-2,41.8916,-87.64835
13194,7,17,false,5,9,4,41.8918,-87.65878
TA1305000003,7,17,false,18,30,12,41.89187,-87.62061
13022,7,17,false,225,230,5,41.89227,-87.61205
TA1306000029,7,17,false,31,35,4,41.89256,-87.61449
13265,7,17,false,9,11,2,41.89383,-87.64172
13045,7,17,false,22,25,3,41.89403,-87.62931
13016,7,17,false,14,25,11,41.89431,-87.62277
KA1503000041,7,17,false,13,14,1,41.89452,-87.61798
13196,7,17,false,6,4,-2,41.89455,-87.65345
TA1307000062,7,17,false,4,11,7,41.89466,-87.63839
TA1306000012,7,17,false,28,33,5,41.89475,-87.63438
KP1705001026,7,17,false,11,7,-4,41.89483,-87.6323
637,7,17,false,4,12,8,41.89563,-87.67209
13132,7,17,false,15,15,0,41.89573,-87.67718
15530,7,17,false,12,24,12,41.89575,-87.62596
18003,7,17,false,6,2,-4,41.89575,-87.62011
13247,7,17,false,12,3,-9,41.89597,-87.66775
TA1305000020,7,17,false,9,15,6,41.89636,-87.65406
13289,7,17,false,12,4,-8,41.89638,-87.661
13303,7,17,false,15,15,0,41.89672,-87.63088
13017,7,17,false,5,8,3,41.89676,-87.6357
13338,7,17,false,6,13,7,41.89697,-87.62173
TA1307000061,7,17,false,4,7,3,41.89745,-87.62873
13034,7,17,false,19,8,-11,41.89754,-87.62352
TA1306000009,7,17,false,5,10,5,41.89772,-87.64299
620,7,17,false,4,8,4,41.89817,-87.63754
15529,7,17,false,18,18,0,41.89858,-87.62206
TA1307000128,7,17,false,21,25,4,41.89896,-87.6299
TA1306000011,7,17,false,12,4,-8,41.89994,-87.63443
KA1504000116,7,17,false,5,4,-1,41.90023,-87.64299
13290,7,17,false,1,9,8,41.90069,-87.66259
13042,7,17,false,101,113,12,41.90097,-87.62377
TA1307000070,7,17,false,10,3,-7,41.90133,-87.67742
KA1504000133,7,17,false,15,18,3,41.90234,-87.62773
13241,7,17,false,3,6,3,41.9029,-87.68731
TA1307000039,7,17,false,28,24,-4,41.90294,-87.63137
TA1305000034,7,17,false,7,10,3,41.90313,-87.67391
KA1504000135,7,17,false,26,26,0,41.90319,-87.63439
13136,7,17,false,16,5,-11,41.90326,-87.67845
13061,7,17,false,17,19,2,41.90342,-87.66779
KA1504000079,7,17,false,16,3,-13,41.9035,-87.64334
TA1308000049,7,17,false,32,23,-9,41.90672,-87.6349
KA1504000134,7,17,false,14,14,0,41.90687,-87.6262
13224,7,17,false,10,10,0,41.90706,-87.66725
TA1307000143,7,17,false,11,2,-9,41.90762,-87.63854
13221,7,17,false,9,14,5,41.90765,-87.67254
TA1309000024,7,17,false,20,20,0,41.908,-87.63152
TA1305000041,7,17,false,21,15,-6,41.9094,-87.67769
331,7,17,false,8,9,1,41.90965,-87.64812
TA1305000037,7,17,false,6,8,2,41.91018,-87.67003
TA1306000008,7,17,false,5,6,1,41.9102,-87.6435
13154,7,17,false,9,9,0,41.91054,-87.65312
13058,7,17,false,8,8,0,41.91059,-87.64942
TA1307000038,7,17,false,19,10,-9,41.91138,-87.63868
LF-005,7,17,false,113,93,-20,41.91172,-87.62681
13128,7,17,false,17,14,-3,41.91197,-87.63197
TA1308000050,7,17,false,30,32,2,41.91211,-87.6347
13243,7,17,false,11,20,9,41.91262,-87.6814
TA1306000032,7,17,false,4,9,5,41.9137,-87.65285
TA1307000166,7,17,false,9,14,5,41.91386,-87.64877
18067,7,17,false,4,11,7,41.9146,-87.66796
TA1306000007,7,17,false,3,6,3,41.91469,-87.64333
13179,7,17,false,45,43,-2,41.9157,-87.63461
13133,7,17,false,10,14,4,41.91598,-87.67733
TA1305000039,7,17,false,7,3,-4,41.9163,-87.66749
15651,7,17,false,1,7,6,41.91752,-87.70181
13266,7,17,false,1,7,6,41.91774,-87.69142
TA1309000029,7,17,false,3,11,8,41.9178,-87.68245
TA1309000006,7,17,false,9,3,-6,41.91809,-87.64375
TA1307000163,7,17,false,3,9,6,41.91821,-87.65696
13146,7,17,false,22,38,16,41.91831,-87.63629
13059,7,17,false,24,19,-5,41.91845,-87.65222
13259,7,17,false,4,5,1,41.91852,-87.69744
13192,7,17,false,6,11,5,41.91995,-87.64884
13242,7,17,false,7,2,-5,41.92021,-87.69266
TA1309000030,7,17,false,12,15,3,41.92077,-87.66372
TA1309000033,7,17,false,23,21,-2,41.92158,-87.65381
13193,7,17,false,24,34,10,41.92182,-87.64412
13191,7,17,false,15,10,-5,41.92217,-87.63891
LP-,7,17,false,26,6,-20,41.92396,-87.63584
TA1307000001,7,17,false,8,9,1,41.92535,-87.66581
TA1306000026,7,17,false,10,9,-1,41.92558,-87.65842
TA1306000016,7,17,false,13,12,-1,41.9256,-87.65371
TA1309000019,7,17,false,42,32,-10,41.92586,-87.63897
TA1309000058,7,17,false,13,24,11,41.92591,-87.64927
TA1308000001,7,17,false,80,81,1,41.92627,-87.63086
15646,7,17,false,3,6,3,41.92668,-87.6977
13124,7,17,false,17,11,-6,41.92675,-87.63444
TA1309000023,7,17,false,5,11,6,41.9287,-87.65383
TA1307000113,7,17,false,10,12,2,41.92878,-87.66391
TA1309000059,7,17,false,5,3,-2,41.92889,-87.65898
TA1309000061,7,17,false,16,13,-3,41.92915,-87.64909
TA1308000031,7,17,false,7,3,-4,41.92946,-87.68417
TA1305000014,7,17,false,23,22,-1,41.92956,-87.64313
13085,7,17,false,6,6,0,41.92958,-87.70789
TA1307000142,7,17,false,12,12,0,41.93125,-87.64432
13276,7,17,false,22,23,1,41.93132,-87.63874
TA1307000064,7,17,false,10,19,9,41.93222,-87.65864
TA1306000014,7,17,false,6,8,2,41.93242,-87.65271
TA1309000039,7,17,false,18,42,24,41.93258,-87.63642
13294,7,17,false,2,5,3,41.9326,-87.66595
TA1309000036,7,17,false,11,13,2,41.93313,-87.64776
TA1307000006,7,17,false,6,8,2,41.93571,-87.6636
TA1307000052,7,17,false,8,12,4,41.93628,-87.65266
TA1307000136,7,17,false,10,7,-3,41.9365,-87.64755
TA1307000041,7,17,false,37,40,3,41.93669,-87.63683
13137,7,17,false,17,30,13,41.9376,-87.6441
15642,7,17,false,3,7,4,41.93843,-87.69801
TA1309000042,7,17,false,7,5,-2,41.93937,-87.66836
13229,7,17,false,6,14,8,41.93946,-87.66376
TA1308000019,7,17,false,3,13,10,41.93973,-87.65886
13277,7,17,false,6,18,12,41.9401,-87.64546
TA1307000134,7,17,false,21,34,13,41.94016,-87.65303
13143,7,17,false,2,5,3,41.94059,-87.67853
TA1309000049,7,17,false,28,30,2,41.94077,-87.63919
TA1307000138,7,17,false,3,8,5,41.94334,-87.67094
TA1309000025,7,17,false,23,36,13,41.94368,-87.64894
13071,7,17,false,9,16,7,41.94373,-87.66401
632,7,17,false,19,20,1,41.94453,-87.6547
13278,7,17,false,18,27,9,41.94553,-87.64644
TA1309000050,7,17,false,9,4,-5,41.94618,-87.67331
15632,7,17,false,6,3,-3,41.94664,-87.69463
13235,7,17,false,11,24,13,41.94814,-87.66396
13253,7,17,false,1,6,5,41.9488,-87.67527
13325,7,17,false,14,18,4,41.94907,-87.64863
TA1307000126,7,17,false,14,66,52,41.94936,-87.65451
TA1307000150,7,17,false,35,21,-14,41.94945,-87.64646
TA1307000127,7,17,false,17,16,-1,41.9508,-87.65918
13323,7,17,false,6,10,4,41.95282,-87.65
TA1309000043,7,17,false,5,4,-1,41.95417,-87.66434
13063,7,17,false,11,21,10,41.95424,-87.65441
TA1308000022,7,17,false,15,21,6,41.95438,-87.64805
13249,7,17,false,5,4,-1,41.95606,-87.66885
13379,7,17,false,4,12,8,41.95786,-87.6495
13389,7,17,false,8,16,8,41.961,-87.64958
TA1307000144,7,17,false,3,6,3,41.96142,-87.6762
TA1307000107,7,17,false,13,13,0,41.96164,-87.65464
TA1307000156,7,17,false,2,8,6,41.96301,-87.68479
TA1308000012,7,17,false,73,40,-33,41.96398,-87.63818
13074,7,17,false,4,9,5,41.96521,-87.6582
639,7,17,false,19,12,-7,41.96584,-87.64538
TA1307000140,7,17,false,3,8,5,41.96643,-87.68865
TA1309000014,7,17,false,4,9,5,41.96709,-87.66744
TA1307000119,7,17,false,8,10,2,41.96796,-87.65
TA1309000066,7,17,false,2,7,5,41.9691,-87.67423
TA1309000041,7,17,false,5,3,-2,41.96951,-87.65471
KA1504000171,7,17,false,22,12,-10,41.97161,-87.65016
TA1309000035,7,17,false,14,5,-9,41.97335,-87.66785
13108,7,17,false,2,8,6,41.97379,-87.65971
KA1504000160,7,17,false,1,6,5,41.97564,-87.70143
KA1504000146,7,17,false,5,5,0,41.978,-87.66805
13109,7,17,false,6,10,4,41.97835,-87.65976
KA1504000152,7,17,false,36,22,-14,41.98403,-87.65231
15578,7,17,false,7,4,-3,41.98405,-87.66027
15575,7,17,false,5,6,1,41.98975,-87.66014
15571,7,17,false,6,5,-1,41.99478,-87.66028
RP-009,7,17,false,6,2,-4,42.00107,-87.66122
RP-002,7,17,false,3,7,4,42.00456,-87.68065
596,7,17,false,5,7,2,42.04822,-87.68348
E008,7,17,false,8,12,4,42.05049,-87.67782
604,7,17,false,6,9,3,42.05824,-87.67744
KA1503000002,7,17,true,3,5,2,41.76641,-87.5657
KA1503000014,7,17,true,5,5,0,41.7851,-87.60108
TA1309000063,7,17,true,5,4,-1,41.79325,-87.5878
TA1308000009,7,17,true,10,10,0,41.79522,-87.58075
TA1307000164,7,17,true,5,4,-1,41.79527,-87.59647
TA1309000037,7,17,true,4,10,6,41.79957,-87.59474
KA1503000007,7,17,true,7,7,0,41.80242,-87.58689
15445,7,17,true,7,6,-1,41.83453,-87.63183
13216,7,17,true,7,8,1,41.83473,-87.62581
13217,7,17,true,5,2,-3,41.83488,-87.61792
TA1309000055,7,17,true,3,5,2,41.8382,-87.64514
KA1503000038,7,17,true,3,6,3,41.83845,-87.6354
TA1307000048,7,17,true,8,8,0,41.83855,-87.60821
TA1307000139,7,17,true,9,8,-1,41.84205,-87.61698
13075,7,17,true,11,7,-4,41.8531,-87.63192
15545,7,17,true,18,13,-5,41.85627,-87.61334
13102,7,17,true,11,9,-2,41.85762,-87.61942
13150,7,17,true,4,6,2,41.85783,-87.62455
SL-012,7,17,true,2,8,6,41.86038,-87.62581
TA1307000124,7,17,true,7,9,2,41.86411,-87.62372
TA1309000001,7,17,true,2,6,4,41.86488,-87.64708
13354,7,17,true,11,6,-5,41.86524,-87.66651
13431,7,17,true,12,4,-8,41.8661,-87.60728
TA1305000002,7,17,true,5,7,2,41.86721,-87.62597
15544,7,17,true,8,1,-7,41.86723,-87.61536
KA1706005007,7,17,true,4,10,6,41.86749,-87.63219
SL-005,7,17,true,16,22,6,41.8679,-87.62304
13139,7,17,true,5,5,0,41.86893,-87.65913
TA1309000010,7,17,true,8,14,6,41.87074,-87.62574
TA1309000064,7,17,true,5,4,-1,41.87127,-87.67369
TA1307000130,7,17,true,7,6,-1,41.87178,-87.65103
SL-008,7,17,true,15,19,4,41.87209,-87.62956
13332,7,17,true,8,11,3,41.87219,-87.6615
SL-011,7,17,true,8,11,3,41.87256,-87.63356
623,7,17,true,4,16,12,41.87272,-87.62399
13028,7,17,true,6,1,-5,41.87475,-87.64981
SL-010,7,17,true,2,8,6,41.87501,-87.63309
15541,7,17,true,8,6,-2,41.8758,-87.62086
TA1305000010,7,17,true,5,1,-4,41.87623,-87.62444
624,7,17,true,2,5,3,41.87626,-87.62923
TA1305000035,7,17,true,5,1,-4,41.87716,-87.62787
15539,7,17,true,7,10,3,41.87763,-87.64405
13158,7,17,true,21,2,-19,41.87764,-87.64957
13157,7,17,true,8,10,2,41.87773,-87.6548
TA1305000025,7,17,true,4,8,4,41.87773,-87.63528
13206,7,17,true,2,10,8,41.87794,-87.66201
638,7,17,true,10,3,-7,41.87827,-87.64078
13011,7,17,true,5,5,0,41.87931,-87.63993
WL-011,7,17,true,8,6,-2,41.88034,-87.64273
13156,7,17,true,8,5,-3,41.88042,-87.65554
13300,7,17,true,32,29,-3,41.88097,-87.61675
13008,7,17,true,17,13,-4,41.88105,-87.62408
TA1305000006,7,17,true,7,4,-3,41.88122,-87.6296
TA1307000120,7,17,true,16,25,9,41.88188,-87.64879
13341,7,17,true,5,5,0,41.88208,-87.63985
13036,7,17,true,7,6,-1,41.8821,-87.62513
TA1305000032,7,17,true,12,10,-2,41.88218,-87.64109
13053,7,17,true,18,14,-4,41.88365,-87.64863
13001,7,17,true,13,8,-5,41.88397,-87.62459
13155,7,17,true,5,3,-2,41.88407,-87.65689
18062,7,17,true,7,11,4,41.88412,-87.65427
TA1306000010,7,17,true,9,15,6,41.88419,-87.62961
TA1305000030,7,17,true,5,3,-2,41.88459,-87.63178
15535,7,17,true,6,13,7,41.8846,-87.64455
TA1305000029,7,17,true,8,8,0,41.88466,-87.62787
13263,7,17,true,20,11,-9,41.88467,-87.61952
TA1306000015,7,17,true,7,15,8,41.88549,-87.65232
13021,7,17,true,8,10,2,41.88559,-87.64184
TA1307000111,7,17,true,6,3,-3,41.88582,-87.63548
KA1503000012,7,17,true,9,12,3,41.88599,-87.63089
TA1305000011,7,17,true,10,8,-2,41.886,-87.62418
15534,7,17,true,3,7,4,41.88627,-87.61749
TA1308000029,7,17,true,4,5,1,41.88673,-87.62225
KA1503000064,7,17,true,13,11,-2,41.88697,-87.61281
TA1305000022,7,17,true,5,7,2,41.88817,-87.63656
TA1306000003,7,17,true,18,20,2,41.88867,-87.64442
KA1503000043,7,17,true,14,19,5,41.88918,-87.63851
13050,7,17,true,7,6,-1,41.88919,-87.62775
TA1307000151,7,17,true,12,10,-2,41.88993,-87.63427
636,7,17,true,9,6,-3,41.88997,-87.63662
KA1503000044,7,17,true,3,6,3,41.89018,-87.6262
13427,7,17,true,10,15,5,41.89054,-87.62205
13430,7,17,true,10,5,-5,41.89077,-87.63169
TA1306000013,7,17,true,12,6,-6,41.89083,-87.61852
RN-,7,17,true,5,5,0,41.89102,-87.63546
TA1307000117,7,17,true,27,20,-7,41.89144,-87.62675
13033,7,17,true,14,12,-2,41.8916,-87.64835
13194,7,17,true,8,4,-4,41.8918,-87.65878
TA1305000003,7,17,true,15,8,-7,41.89187,-87.62061
13022,7,17,true,38,33,-5,41.89227,-87.61205
TA1306000029,7,17,true,25,19,-6,41.89256,-87.61449
13265,7,17,true,11,13,2,41.89383,-87.64172
13045,7,17,true,15,13,-2,41.89403,-87.62931
13016,7,17,true,9,4,-5,41.89431,-87.62277
KA1503000041,7,17,true,5,9,4,41.89452,-87.61798
TA1306000012,7,17,true,16,20,4,41.89475,-87.63438
KP1705001026,7,17,true,2,8,6,41.89483,-87.6323
637,7,17,true,3,6,3,41.89563,-87.67209
13132,7,17,true,10,9,-1,41.89573,-87.67718
15530,7,17,true,7,17,10,41.89575,-87.62596
13247,7,17,true,4,7,3,41.89597,-87.66775
TA1305000020,7,17,true,8,5,-3,41.89636,-87.65406
13289,7,17,true,4,13,9,41.89638,-87.661
13303,7,17,true,5,9,4,41.89672,-87.63088
13017,7,17,true,8,6,-2,41.89676,-87.6357
13338,7,17,true,6,3,-3,41.89697,-87.62173
TA1307000061,7,17,true,4,12,8,41.89745,-87.62873
13034,7,17,true,4,5,1,41.89754,-87.62352
620,7,17,true,5,7,2,41.89817,-87.63754
KA1504000103,7,17,true,5,6,1,41.89842,-87.68659
15529,7,17,true,10,11,1,41.89858,-87.62206
TA1307000128,7,17,true,19,14,-5,41.89896,-87.6299
657,7,17,true,8,2,-6,41.89918,-87.6722
13248,7,17,true,3,7,4,41.89964,-87.66788
TA1306000011,7,17,true,3,7,4,41.89994,-87.63443
13290,7,17,true,6,5,-1,41.90069,-87.66259
13042,7,17,true,44,29,-15,41.90097,-87.62377
TA1307000070,7,17,true,9,4,-5,41.90133,-87.67742
KA1504000133,7,17,true,19,7,-12,41.90234,-87.62773
TA1307000039,7,17,true,34,24,-10,41.90294,-87.63137
TA1305000034,7,17,true,7,11,4,41.90313,-87.67391
KA1504000135,7,17,true,25,31,6,41.90319,-87.63439
13136,7,17,true,9,14,5,41.90326,-87.67845
13061,7,17,true,7,14,7,41.90342,-87.66779
KA1504000079,7,17,true,9,7,-2,41.9035,-87.64334
TA1307000115,7,17,true,4,5,1,41.9046,-87.64056
TA1308000049,7,17,true,20,16,-4,41.90672,-87.6349
KA1504000134,7,17,true,12,5,-7,41.90687,-87.6262
13224,7,17,true,15,19,4,41.90706,-87.66725
13221,7,17,true,5,12,7,41.90765,-87.67254
TA1309000024,7,17,true,13,17,4,41.908,-87.63152
TA1305000041,7,17,true,6,11,5,41.9094,-87.67769
331,7,17,true,13,15,2,41.90965,-87.64812
TA1305000037,7,17,true,5,8,3,41.91018,-87.67003
TA1306000008,7,17,true,7,10,3,41.9102,-87.6435
TA1308000005,7,17,true,6,7,1,41.91042,-87.68238
13257,7,17,true,3,6,3,41.91054,-87.68956
13154,7,17,true,17,10,-7,41.91054,-87.65312
13058,7,17,true,9,10,1,41.91059,-87.64942
TA1307000038,7,17,true,11,10,-1,41.91138,-87.63868
LF-005,7,17,true,68,35,-33,41.91172,-87.62681
13128,7,17,true,4,8,4,41.91197,-87.63197
TA1308000050,7,17,true,27,35,8,41.91211,-87.6347
13243,7,17,true,6,5,-1,41.91262,-87.6814
TA1309000032,7,17,true,1,5,4,41.91293,-87.66417
TA1306000032,7,17,true,8,11,3,41.9137,-87.65285
TA1307000166,7,17,true,10,5,-5,41.91386,-87.64877
15655,7,17,true,4,9,5,41.91401,-87.70514
18067,7,17,true,4,7,3,41.9146,-87.66796
13068,7,17,true,5,8,3,41.91554,-87.68703
13179,7,17,true,40,29,-11,41.9157,-87.63461
13133,7,17,true,6,7,1,41.91598,-87.67733
15651,7,17,true,4,5,1,41.91752,-87.70181
TA1309000029,7,17,true,5,3,-2,41.9178,-87.68245
TA1309000006,7,17,true,6,5,-1,41.91809,-87.64375
TA1307000163,7,17,true,3,7,4,41.91821,-87.65696
13146,7,17,true,29,20,-9,41.91831,-87.63629
13059,7,17,true,15,18,3,41.91845,-87.65222
13192,7,17,true,11,9,-2,41.91995,-87.64884
13288,7,17,true,8,7,-1,41.92008,-87.67788
TA1309000030,7,17,true,7,7,0,41.92077,-87.66372
TA1309000033,7,17,true,31,22,-9,41.92158,-87.65381
13193,7,17,true,22,14,-8,41.92182,-87.64412
13191,7,17,true,8,6,-2,41.92217,-87.63891
13084,7,17,true,2,5,3,41.92268,-87.69715
LP-,7,17,true,10,5,-5,41.92396,-87.63584
TA1307000001,7,17,true,3,7,4,41.92535,-87.66581
TA1306000016,7,17,true,4,5,1,41.9256,-87.65371
TA1309000019,7,17,true,16,19,3,41.92586,-87.63897
TA1309000058,7,17,true,11,11,0,41.92591,-87.64927
TA1308000001,7,17,true,44,36,-8,41.92627,-87.63086
13124,7,17,true,5,1,-4,41.92675,-87.63444
TA1309000023,7,17,true,12,14,2,41.9287,-87.65383
TA1307000113,7,17,true,10,7,-3,41.92878,-87.66391
13296,7,17,true,8,4,-4,41.92883,-87.66852
TA1309000059,7,17,true,6,9,3,41.92889,-87.65898
TA1309000061,7,17,true,10,19,9,41.92915,-87.64909
TA1305000014,7,17,true,16,11,-5,41.92956,-87.64313
13085,7,17,true,6,4,-2,41.92958,-87.70789
TA1307000142,7,17,true,14,15,1,41.93125,-87.64432
13276,7,17,true,13,20,7,41.93132,-87.63874
13271,7,17,true,5,5,0,41.93192,-87.67784
TA1307000064,7,17,true,5,6,1,41.93222,-87.65864
TA1306000014,7,17,true,9,10,1,41.93242,-87.65271
TA1309000039,7,17,true,24,18,-6,41.93258,-87.63642
TA1309000036,7,17,true,9,13,4,41.93313,-87.64776
TA1307000006,7,17,true,8,13,5,41.93571,-87.6636
13268,7,17,true,4,7,3,41.93588,-87.67843
TA1307000052,7,17,true,8,11,3,41.93628,-87.65266
TA1307000136,7,17,true,11,17,6,41.9365,-87.64755
TA1307000041,7,17,true,34,31,-3,41.93669,-87.63683
13137,7,17,true,21,22,1,41.9376,-87.6441
KA17018068,7,17,true,2,5,3,41.93935,-87.68327
TA1309000042,7,17,true,6,3,-3,41.93937,-87.66836
13229,7,17,true,5,7,2,41.93946,-87.66376
TA1308000019,7,17,true,9,11,2,41.93973,-87.65886
13277,7,17,true,9,14,5,41.9401,-87.64546
TA1307000134,7,17,true,17,20,3,41.94016,-87.65303
TA1309000049,7,17,true,19,20,1,41.94077,-87.63919
TA1307000138,7,17,true,4,5,1,41.94334,-87.67094
TA1309000025,7,17,true,27,15,-12,41.94368,-87.64894
13071,7,17,true,8,17,9,41.94373,-87.66401
632,7,17,true,11,10,-1,41.94453,-87.6547
13278,7,17,true,17,12,-5,41.94553,-87.64644
13235,7,17,true,16,14,-2,41.94814,-87.66396
13253,7,17,true,6,3,-3,41.9488,-87.67527
13325,7,17,true,14,20,6,41.94907,-87.64863
TA1307000126,7,17,true,5,38,33,41.94936,-87.65451
TA1307000150,7,17,true,16,25,9,41.94945,-87.64646
13319,7,17,true,3,6,3,41.95069,-87.6687
TA1307000127,7,17,true,15,8,-7,41.9508,-87.65918
13323,7,17,true,6,13,7,41.95282,-87.65
TA1309000043,7,17,true,3,5,2,41.95417,-87.66434
13063,7,17,true,12,9,-3,41.95424,-87.65441
TA1308000022,7,17,true,11,12,1,41.95438,-87.64805
TA1307000149,7,17,true,3,6,3,41.95467,-87.67392
13379,7,17,true,8,7,-1,41.95786,-87.6495
TA1309000018,7,17,true,5,5,0,41.95791,-87.67357
TA1309000027,7,17,true,7,6,-1,41.9585,-87.65499
13389,7,17,true,8,6,-2,41.961,-87.64958
TA1307000144,7,17,true,2,6,4,41.96142,-87.6762
TA1309000021,7,17,true,5,4,-1,41.9615,-87.6714
15623,7,17,true,2,6,4,41.96154,-87.69117
KA1503000022,7,17,true,5,3,-2,41.96158,-87.66609
TA1307000107,7,17,true,10,11,1,41.96164,-87.65464
TA1307000156,7,17,true,6,5,-1,41.96301,-87.68479
TA1309000012,7,17,true,5,3,-2,41.96325,-87.67928
TA1308000012,7,17,true,40,32,-8,41.96398,-87.63818
13074,7,17,true,2,7,5,41.96521,-87.6582
639,7,17,true,15,6,-9,41.96584,-87.64538
KA1504000093,7,17,true,5,2,-3,41.96587,-87.69365
TA1309000014,7,17,true,7,7,0,41.96709,-87.66744
TA1307000158,7,17,true,4,7,3,41.9671,-87.67904
TA1307000119,7,17,true,6,4,-2,41.96796,-87.65
TA1308000021,7,17,true,6,4,-2,41.96883,-87.65765
TA1309000066,7,17,true,6,16,10,41.9691,-87.67423
TA1309000041,7,17,true,7,5,-2,41.96951,-87.65471
KA1504000171,7,17,true,15,10,-5,41.97161,-87.65016
TA1309000035,7,17,true,6,8,2,41.97335,-87.66785
13108,7,17,true,6,5,-1,41.97379,-87.65971
KA1504000149,7,17,true,3,6,3,41.97562,-87.67945
KA1504000146,7,17,true,5,10,5,41.978,-87.66805
13109,7,17,true,6,6,0,41.97835,-87.65976
655,7,17,true,7,2,-5,41.97987,-87.68194
KA1504000152,7,17,true,38,31,-7,41.98403,-87.65231
15578,7,17,true,1,6,5,41.98405,-87.66027
15575,7,17,true,7,5,-2,41.98975,-87.66014
15571,7,17,true,6,5,-1,41.99478,-87.66028
KA1504000156,7,17,true,6,2,-4,41.99925,-87.67137
RP-009,7,17,true,3,5,2,42.00107,-87.66122
596,7,17,true,5,8,3,42.04822,-87.68348
15491,7,18,false,9,6,-3,41.78096,-87.57624
KA1503000014,7,18,false,3,9,6,41.7851,-87.60108
KA1503000074,7,18,false,8,6,-2,41.79174,-87.58395
TA1308000009,7,18,false,23,32,9,41.79522,-87.58075
TA1307000164,7,18,false,4,5,1,41.79527,-87.59647
KA1503000052,7,18,false,6,3,-3,41.79935,-87.60097
KA1503000059,7,18,false,3,6,3,41.79952,-87.58643
TA1309000037,7,18,false,6,7,1,41.79957,-87.59474
KA1503000007,7,18,false,8,14,6,41.80242,-87.58689
TA1308000035,7,18,false,5,7,2,41.80944,-87.59188
KA1503000004,7,18,false,10,4,-6,41.83127,-87.6088
TA1308000046,7,18,false,6,3,-3,41.83779,-87.65115
TA1307000048,7,18,false,31,30,-1,41.83855,-87.60821
TA1307000139,7,18,false,6,4,-2,41.84205,-87.61698
TA1308000014,7,18,false,5,1,-4,41.84953,-87.64059
TA1305000004,7,18,false,1,9,8,41.8514,-87.61884
13075,7,18,false,1,8,7,41.8531,-87.63192
15545,7,18,false,13,19,6,41.85627,-87.61334
SL-013,7,18,false,10,10,0,41.85659,-87.62755
SL-006,7,18,false,1,7,6,41.8568,-87.63387
13150,7,18,false,7,7,0,41.85783,-87.62455
TA1307000124,7,18,false,4,9,5,41.86411,-87.62372
TA1309000001,7,18,false,13,8,-5,41.86488,-87.64708
13431,7,18,false,25,25,0,41.8661,-87.60728
WL-008,7,18,false,6,6,0,41.86712,-87.64108
TA1305000002,7,18,false,15,18,3,41.86721,-87.62597
15544,7,18,false,18,14,-4,41.86723,-87.61536
KA1706005007,7,18,false,4,5,1,41.86749,-87.63219
SL-005,7,18,false,25,37,12,41.8679,-87.62304
TA1309000010,7,18,false,15,22,7,41.87074,-87.62574
15542,7,18,false,6,2,-4,41.87146,-87.64095
SL-008,7,18,false,14,18,4,41.87209,-87.62956
13332,7,18,false,1,6,5,41.87219,-87.6615
SL-011,7,18,false,5,7,2,41.87256,-87.63356
623,7,18,false,20,30,10,41.87272,-87.62399
SL-007,7,18,false,9,16,7,41.87404,-87.6277
SL-010,7,18,false,4,6,2,41.87501,-87.63309
15541,7,18,false,29,25,-4,41.8758,-87.62086
TA1305000010,7,18,false,8,8,0,41.87623,-87.62444
15539,7,18,false,2,5,3,41.87763,-87.64405
13158,7,18,false,6,8,2,41.87764,-87.64957
13157,7,18,false,1,5,4,41.87773,-87.6548
TA1305000025,7,18,false,19,8,-11,41.87773,-87.63528
TA1309000002,7,18,false,4,5,1,41.87784,-87.62408
TA1305000005,7,18,false,6,5,-1,41.87924,-87.62975
KA1503000015,7,18,false,11,3,-8,41.87948,-87.6257
WL-011,7,18,false,5,7,2,41.88034,-87.64273
13156,7,18,false,4,6,2,41.88042,-87.65554
13300,7,18,false,80,89,9,41.88097,-87.61675
13008,7,18,false,66,72,6,41.88105,-87.62408
TA1305000006,7,18,false,7,11,4,41.88122,-87.6296
13056,7,18,false,7,5,-2,41.88168,-87.63951
TA1307000120,7,18,false,18,16,-2,41.88188,-87.64879
13341,7,18,false,6,6,0,41.88208,-87.63985
13036,7,18,false,4,7,3,41.8821,-87.62513
TA1305000032,7,18,false,21,23,2,41.88218,-87.64109
13353,7,18,false,3,7,4,41.88283,-87.6612
13409,7,18,false,1,11,10,41.8831,-87.6511
WL-012,7,18,false,3,10,7,41.88337,-87.6412
13053,7,18,false,9,26,17,41.88365,-87.64863
13001,7,18,false,23,29,6,41.88397,-87.62459
18062,7,18,false,11,6,-5,41.88412,-87.65427
TA1306000010,7,18,false,4,5,1,41.88419,-87.62961
TA1305000030,7,18,false,10,12,2,41.88459,-87.63178
15535,7,18,false,13,8,-5,41.8846,-87.64455
TA1305000029,7,18,false,15,27,12,41.88466,-87.62787
13263,7,18,false,17,25,8,41.88467,-87.61952
TA1306000015,7,18,false,16,12,-4,41.88549,-87.65232
13021,7,18,false,8,7,-1,41.88559,-87.64184
TA1307000111,7,18,false,11,5,-6,41.88582,-87.63548
KA1503000012,7,18,false,15,11,-4,41.88599,-87.63089
TA1305000011,7,18,false,39,36,-3,41.886,-87.62418
15534,7,18,false,16,7,-9,41.88627,-87.61749
TA1308000029,7,18,false,16,16,0,41.88673,-87.62225
TA1307000131,7,18,false,11,18,7,41.88688,-87.62606
KA1503000064,7,18,false,34,45,11,41.88697,-87.61281
TA1305000022,7,18,false,8,7,-1,41.88817,-87.63656
TA1306000003,7,18,false,22,22,0,41.88867,-87.64442
KA1503000043,7,18,false,6,9,3,41.88918,-87.63851
13050,7,18,false,21,30,9,41.88919,-87.62775
TA1307000151,7,18,false,13,17,4,41.88993,-87.63427
636,7,18,false,5,11,6,41.88997,-87.63662
KA1503000044,7,18,false,7,6,-1,41.89018,-87.6262
13427,7,18,false,15,6,-9,41.89054,-87.62205
13430,7,18,false,9,19,10,41.89077,-87.63169
TA1306000013,7,18,false,23,30,7,41.89083,-87.61852
RN-,7,18,false,3,11,8,41.89102,-87.63546
13434,7,18,false,2,6,4,41.89108,-87.66663
TA1307000117,7,18,false,40,51,11,41.89144,-87.62675
13033,7,18,false,6,14,8,41.8916,-87.64835
13194,7,18,false,7,4,-3,41.8918,-87.65878
TA1305000003,7,18,false,23,35,12,41.89187,-87.62061
13022,7,18,false,212,196,-16,41.89227,-87.61205
TA1306000029,7,18,false,35,33,-2,41.89256,-87.61449
13265,7,18,false,2,5,3,41.89383,-87.64172
13045,7,18,false,11,22,11,41.89403,-87.62931
13016,7,18,false,17,20,3,41.89431,-87.62277
KA1503000041,7,18,false,18,15,-3,41.89452,-87.61798
13196,7,18,false,5,9,4,41.89455,-87.65345
TA1307000062,7,18,false,5,7,2,41.89466,-87.63839
TA1306000012,7,18,false,17,15,-2,41.89475,-87.63438
KP1705001026,7,18,false,13,14,1,41.89483,-87.6323
13132,7,18,false,12,8,-4,41.89573,-87.67718
15530,7,18,false,17,14,-3,41.89575,-87.62596
13247,7,18,false,2,10,8,41.89597,-87.66775
TA1305000020,7,18,false,10,6,-4,41.89636,-87.65406
13289,7,18,false,6,4,-2,41.89638,-87.661
13303,7,18,false,8,3,-5,41.89672,-87.63088
13017,7,18,false,4,6,2,41.89676,-87.6357
13338,7,18,false,16,14,-2,41.89697,-87.62173
TA1307000061,7,18,false,6,4,-2,41.89745,-87.62873
13034,7,18,false,8,5,-3,41.89754,-87.62352
TA1306000009,7,18,false,7,3,-4,41.89772,-87.64299
620,7,18,false,4,5,1,41.89817,-87.63754
15529,7,18,false,22,9,-13,41.89858,-87.62206
TA1307000128,7,18,false,25,13,-12,41.89896,-87.6299
TA1306000011,7,18,false,7,5,-2,41.89994,-87.63443
13290,7,18,false,9,4,-5,41.90069,-87.66259
13042,7,18,false,76,74,-2,41.90097,-87.62377
TA1307000070,7,18,false,5,4,-1,41.90133,-87.67742
KA1504000133,7,18,false,14,15,1,41.90234,-87.62773
TA1307000039,7,18,false,29,26,-3,41.90294,-87.63137
13256,7,18,false,2,8,6,41.90302,-87.69749
TA1305000034,7,18,false,5,6,1,41.90313,-87.67391
KA1504000135,7,18,false,24,25,1,41.90319,-87.63439
13061,7,18,false,22,23,1,41.90342,-87.66779
KA1504000079,7,18,false,3,6,3,41.9035,-87.64334
TA1308000049,7,18,false,18,22,4,41.90672,-87.6349
KA1504000134,7,18,false,7,10,3,41.90687,-87.6262
13224,7,18,false,7,6,-1,41.90706,-87.66725
TA1307000143,7,18,false,8,3,-5,41.90762,-87.63854
13221,7,18,false,8,17,9,41.90765,-87.67254
TA1309000024,7,18,false,25,7,-18,41.908,-87.63152
TA1305000041,7,18,false,13,10,-3,41.9094,-87.67769
331,7,18,false,8,8,0,41.90965,-87.64812
TA1305000037,7,18,false,11,11,0,41.91018,-87.67003
TA1306000008,7,18,false,8,6,-2,41.9102,-87.6435
TA1308000005,7,18,false,5,5,0,41.91042,-87.68238
13257,7,18,false,8,6,-2,41.91054,-87.68956
13154,7,18,false,8,5,-3,41.91054,-87.65312
13058,7,18,false,6,7,1,41.91059,-87.64942
TA1307000038,7,18,false,11,17,6,41.91138,-87.63868
LF-005,7,18,false,71,67,-4,41.91172,-87.62681
13128,7,18,false,10,4,-6,41.91197,-87.63197
TA1308000050,7,18,false,24,35,11,41.91211,-87.6347
13243,7,18,false,12,12,0,41.91262,-87.6814
TA1306000032,7,18,false,11,8,-3,41.9137,-87.65285
TA1307000166,7,18,false,7,7,0,41.91386,-87.64877
15655,7,18,false,5,2,-3,41.91401,-87.70514
18067,7,18,false,8,5,-3,41.9146,-87.66796
TA1306000007,7,18,false,4,6,2,41.91469,-87.64333
13068,7,18,false,6,8,2,41.91554,-87.68703
13179,7,18,false,44,28,-16,41.9157,-87.63461
13133,7,18,false,13,7,-6,41.91598,-87.67733
TA1305000039,7,18,false,1,5,4,41.9163,-87.66749
TA1309000029,7,18,false,6,5,-1,41.9178,-87.68245
TA1309000006,7,18,false,3,10,7,41.91809,-87.64375
TA1307000163,7,18,false,7,3,-4,41.91821,-87.65696
13146,7,18,false,32,33,1,41.91831,-87.63629
13059,7,18,false,15,15,0,41.91845,-87.65222
13259,7,18,false,1,5,4,41.91852,-87.69744
13192,7,18,false,5,10,5,41.91995,-87.64884
TA1309000030,7,18,false,15,10,-5,41.92077,-87.66372
13292,7,18,false,6,3,-3,41.92152,-87.70733
TA1309000033,7,18,false,15,14,-1,41.92158,-87.65381
13193,7,18,false,25,20,-5,41.92182,-87.64412
13191,7,18,false,14,7,-7,41.92217,-87.63891
13084,7,18,false,4,10,6,41.92268,-87.69715
LP-,7,18,false,13,5,-8,41.92396,-87.63584
TA1307000001,7,18,false,5,8,3,41.92535,-87.66581
TA1306000026,7,18,false,5,6,1,41.92558,-87.65842
TA1306000016,7,18,false,3,5,2,41.9256,-87.65371
TA1309000019,7,18,false,26,17,-9,41.92586,-87.63897
TA1309000058,7,18,false,9,18,9,41.92591,-87.64927
TA1308000001,7,18,false,58,66,8,41.92627,-87.63086
13124,7,18,false,10,17,7,41.92675,-87.63444
TA1309000023,7,18,false,6,13,7,41.9287,-87.65383
TA1307000113,7,18,false,7,11,4,41.92878,-87.66391
TA1309000061,7,18,false,23,11,-12,41.92915,-87.64909
TA1305000014,7,18,false,11,14,3,41.92956,-87.64313
13085,7,18,false,3,7,4,41.92958,-87.70789
TA1307000142,7,18,false,13,14,1,41.93125,-87.64432
13276,7,18,false,23,22,-1,41.93132,-87.63874
TA1307000064,7,18,false,8,9,1,41.93222,-87.65864
TA1306000014,7,18,false,13,7,-6,41.93242,-87.65271
TA1309000039,7,18,false,22,33,11,41.93258,-87.63642
13294,7,18,false,8,3,-5,41.9326,-87.66595
TA1309000036,7,18,false,14,17,3,41.93313,-87.64776
TA1307000006,7,18,false,2,12,10,41.93571,-87.6636
13268,7,18,false,1,7,6,41.93588,-87.67843
13269,7,18,false,5,3,-2,41.93609,-87.66983
TA1307000052,7,18,false,13,23,10,41.93628,-87.65266
TA1307000136,7,18,false,14,21,7,41.9365,-87.64755
TA1307000041,7,18,false,13,22,9,41.93669,-87.63683
13137,7,18,false,23,29,6,41.9376,-87.6441
TA1309000042,7,18,false,3,5,2,41.93937,-87.66836
13229,7,18,false,5,19,14,41.93946,-87.66376
TA1308000019,7,18,false,2,9,7,41.93973,-87.65886
13277,7,18,false,10,15,5,41.9401,-87.64546
TA1307000134,7,18,false,16,20,4,41.94016,-87.65303
TA1309000049,7,18,false,25,28,3,41.94077,-87.63919
TA1307000138,7,18,false,7,4,-3,41.94334,-87.67094
TA1309000025,7,18,false,16,25,9,41.94368,-87.64894
13071,7,18,false,10,8,-2,41.94373,-87.66401
632,7,18,false,15,19,4,41.94453,-87.6547
13278,7,18,false,11,7,-4,41.94553,-87.64644
15632,7,18,false,2,6,4,41.94664,-87.69463
13235,7,18,false,8,9,1,41.94814,-87.66396
13253,7,18,false,5,1,-4,41.9488,-87.67527
13325,7,18,false,7,8,1,41.94907,-87.64863
TA1307000126,7,18,false,20,63,43,41.94936,-87.65451
TA1307000150,7,18,false,17,15,-2,41.94945,-87.64646
13319,7,18,false,9,11,2,41.95069,-87.6687
TA1307000127,7,18,false,11,13,2,41.9508,-87.65918
13323,7,18,false,8,20,12,41.95282,-87.65
13063,7,18,false,7,13,6,41.95424,-87.65441
TA1308000022,7,18,false,10,14,4,41.95438,-87.64805
TA1309000026,7,18,false,2,5,3,41.95601,-87.6802
TA1309000027,7,18,false,5,5,0,41.9585,-87.65499
13389,7,18,false,13,8,-5,41.961,-87.64958
TA1307000107,7,18,false,8,19,11,41.96164,-87.65464
TA1307000156,7,18,false,6,4,-2,41.96301,-87.68479
TA1308000012,7,18,false,30,34,4,41.96398,-87.63818
639,7,18,false,15,8,-7,41.96584,-87.64538
TA1309000014,7,18,false,2,5,3,41.96709,-87.66744
TA1307000119,7,18,false,5,4,-1,41.96796,-87.65
TA1308000021,7,18,false,4,5,1,41.96883,-87.65765
TA1309000066,7,18,false,4,9,5,41.9691,-87.67423
TA1309000041,7,18,false,8,10,2,41.96951,-87.65471
KA1504000171,7,18,false,14,17,3,41.97161,-87.65016
TA1309000035,7,18,false,5,8,3,41.97335,-87.66785
KA1504000146,7,18,false,6,7,1,41.978,-87.66805
13109,7,18,false,14,9,-5,41.97835,-87.65976
KA1504000152,7,18,false,26,21,-5,41.98403,-87.65231
15578,7,18,false,18,1,-17,41.98405,-87.66027
15575,7,18,false,5,11,6,41.98975,-87.66014
15571,7,18,false,7,11,4,41.99478,-87.66028
RP-009,7,18,false,1,8,7,42.00107,-87.66122
RP-001,7,18,false,1,5,4,42.00179,-87.68883
KA1504000175,7,18,false,5,3,-2,42.00797,-87.66549
596,7,18,false,6,9,3,42.04822,-87.68348
E008,7,18,false,4,6,2,42.05049,-87.67782
KA1503000014,7,18,true,3,9,6,41.7851,-87.60108
KA1504000076,7,18,true,7,3,-4,41.7943,-87.60145
TA1308000009,7,18,true,14,12,-2,41.79522,-87.58075
KA1503000052,7,18,true,5,4,-1,41.79935,-87.60097
KA1503000059,7,18,true,2,5,3,41.79952,-87.58643
TA1309000037,7,18,true,4,6,2,41.79957,-87.59474
TA1308000045,7,18,true,5,5,0,41.83062,-87.64129
15446,7,18,true,8,2,-6,41.83068,-87.65603
TA1307000129,7,18,true,3,6,3,41.83104,-87.62683
13345,7,18,true,5,2,-3,41.83138,-87.61803
15445,7,18,true,5,3,-2,41.83453,-87.63183
KA1503000038,7,18,true,10,2,-8,41.83845,-87.6354
TA1307000048,7,18,true,16,12,-4,41.83855,-87.60821
TA1308000036,7,18,true,5,4,-1,41.83883,-87.62186
TA1307000139,7,18,true,8,9,1,41.84205,-87.61698
15545,7,18,true,34,26,-8,41.85627,-87.61334
13102,7,18,true,3,5,2,41.85762,-87.61942
13150,7,18,true,9,9,0,41.85783,-87.62455
TA1307000124,7,18,true,7,6,-1,41.86411,-87.62372
13431,7,18,true,8,12,4,41.8661,-87.60728
WL-008,7,18,true,5,12,7,41.86712,-87.64108
TA1305000002,7,18,true,17,13,-4,41.86721,-87.62597
15544,7,18,true,14,7,-7,41.86723,-87.61536
SL-005,7,18,true,6,28,22,41.8679,-87.62304
644,7,18,true,5,2,-3,41.86859,-87.68625
13139,7,18,true,2,6,4,41.86893,-87.65913
13160,7,18,true,7,8,1,41.86947,-87.65548
15550,7,18,true,5,4,-1,41.87024,-87.63947
TA1309000010,7,18,true,9,11,2,41.87074,-87.62574
TA1307000130,7,18,true,6,5,-1,41.87178,-87.65103
SL-008,7,18,true,9,13,4,41.87209,-87.62956
13332,7,18,true,13,13,0,41.87219,-87.6615
SL-011,7,18,true,9,10,1,41.87256,-87.63356
623,7,18,true,6,3,-3,41.87272,-87.62399
KA1504000104,7,18,true,2,5,3,41.87296,-87.66912
SL-007,7,18,true,3,8,5,41.87404,-87.6277
13028,7,18,true,8,2,-6,41.87475,-87.64981
SL-010,7,18,true,9,5,-4,41.87501,-87.63309
15541,7,18,true,2,5,3,41.8758,-87.62086
624,7,18,true,5,8,3,41.87626,-87.62923
TA1305000035,7,18,true,5,1,-4,41.87716,-87.62787
15539,7,18,true,5,2,-3,41.87763,-87.64405
13158,7,18,true,4,9,5,41.87764,-87.64957
13157,7,18,true,12,12,0,41.87773,-87.6548
TA1305000025,7,18,true,8,6,-2,41.87773,-87.63528
KA1503000034,7,18,true,1,5,4,41.87938,-87.63197
WL-011,7,18,true,5,5,0,41.88034,-87.64273
13156,7,18,true,6,6,0,41.88042,-87.65554
13300,7,18,true,31,25,-6,41.88097,-87.61675
13008,7,18,true,17,16,-1,41.88105,-87.62408
TA1307000120,7,18,true,21,9,-12,41.88188,-87.64879
TA1305000032,7,18,true,15,18,3,41.88218,-87.64109
13409,7,18,true,1,5,4,41.8831,-87.6511
13053,7,18,true,7,6,-1,41.88365,-87.64863
18062,7,18,true,4,9,5,41.88412,-87.65427
TA1306000010,7,18,true,6,8,2,41.88419,-87.62961
15535,7,18,true,9,3,-6,41.8846,-87.64455
TA1305000029,7,18,true,12,4,-8,41.88466,-87.62787
13263,7,18,true,16,21,5,41.88467,-87.61952
TA1306000015,7,18,true,5,7,2,41.88549,-87.65232
13021,7,18,true,3,11,8,41.88559,-87.64184
TA1307000111,7,18,true,4,7,3,41.88582,-87.63548
KA1503000012,7,18,true,10,9,-1,41.88599,-87.63089
15534,7,18,true,10,9,-1,41.88627,-87.61749
TA1308000029,7,18,true,6,3,-3,41.88673,-87.62225
TA1307000131,7,18,true,5,9,4,41.88688,-87.62606
KA1503000064,7,18,true,7,7,0,41.88697,-87.61281
TA1305000022,7,18,true,12,9,-3,41.88817,-87.63656
TA1306000003,7,18,true,22,24,2,41.88867,-87.64442
KA1503000043,7,18,true,16,16,0,41.88918,-87.63851
13050,7,18,true,7,8,1,41.88919,-87.62775
TA1307000151,7,18,true,13,6,-7,41.88993,-87.63427
636,7,18,true,7,5,-2,41.88997,-87.63662
KA1503000044,7,18,true,7,6,-1,41.89018,-87.6262
13427,7,18,true,7,7,0,41.89054,-87.62205
13430,7,18,true,8,9,1,41.89077,-87.63169
TA1306000013,7,18,true,14,13,-1,41.89083,-87.61852
RN-,7,18,true,6,9,3,41.89102,-87.63546
13434,7,18,true,3,6,3,41.89108,-87.66663
TA1307000117,7,18,true,22,27,5,41.89144,-87.62675
13033,7,18,true,16,23,7,41.8916,-87.64835
13194,7,18,true,10,14,4,41.8918,-87.65878
TA1305000003,7,18,true,11,14,3,41.89187,-87.62061
13022,7,18,true,39,46,7,41.89227,-87.61205
TA1306000029,7,18,true,7,17,10,41.89256,-87.61449
13265,7,18,true,7,12,5,41.89383,-87.64172
13045,7,18,true,23,20,-3,41.89403,-87.62931
13016,7,18,true,13,11,-2,41.89431,-87.62277
KA1503000041,7,18,true,8,11,3,41.89452,-87.61798
TA1307000062,7,18,true,6,6,0,41.89466,-87.63839
TA1306000012,7,18,true,20,19,-1,41.89475,-87.63438
KP1705001026,7,18,true,9,7,-2,41.89483,-87.6323
637,7,18,true,1,5,4,41.89563,-87.67209
13132,7,18,true,5,5,0,41.89573,-87.67718
15530,7,18,true,10,5,-5,41.89575,-87.62596
13247,7,18,true,2,5,3,41.89597,-87.66775
TA1305000020,7,18,true,3,5,2,41.89636,-87.65406
13289,7,18,true,6,2,-4,41.89638,-87.661
13303,7,18,true,5,12,7,41.89672,-87.63088
13338,7,18,true,6,17,11,41.89697,-87.62173
620,7,18,true,5,4,-1,41.89817,-87.63754
KA1504000103,7,18,true,11,6,-5,41.89842,-87.68659
15529,7,18,true,9,10,1,41.89858,-87.62206
TA1307000128,7,18,true,21,15,-6,41.89896,-87.6299
TA1306000011,7,18,true,5,2,-3,41.89994,-87.63443
KA1504000116,7,18,true,4,5,1,41.90023,-87.64299
13290,7,18,true,6,9,3,41.90069,-87.66259
13042,7,18,true,31,16,-15,41.90097,-87.62377
TA1307000070,7,18,true,1,8,7,41.90133,-87.67742
KA1504000133,7,18,true,10,6,-4,41.90234,-87.62773
TA1307000039,7,18,true,23,25,2,41.90294,-87.63137
TA1305000034,7,18,true,6,7,1,41.90313,-87.67391
KA1504000135,7,18,true,17,30,13,41.90319,-87.63439
13136,7,18,true,6,2,-4,41.90326,-87.67845
13061,7,18,true,9,16,7,41.90342,-87.66779
KA1504000079,7,18,true,8,8,0,41.9035,-87.64334
TA1308000049,7,18,true,12,13,1,41.90672,-87.6349
KA1504000134,7,18,true,5,6,1,41.90687,-87.6262
13224,7,18,true,9,12,3,41.90706,-87.66725
13221,7,18,true,17,10,-7,41.90765,-87.67254
TA1309000024,7,18,true,14,8,-6,41.908,-87.63152
TA1305000041,7,18,true,9,9,0,41.9094,-87.67769
331,7,18,true,25,10,-15,41.90965,-87.64812
TA1305000037,7,18,true,7,13,6,41.91018,-87.67003
TA1306000008,7,18,true,11,13,2,41.9102,-87.6435
TA1308000005,7,18,true,2,8,6,41.91042,-87.68238
13154,7,18,true,6,5,-1,41.91054,-87.65312
13058,7,18,true,9,10,1,41.91059,-87.64942
TA1307000038,7,18,true,9,8,-1,41.91138,-87.63868
LF-005,7,18,true,36,38,2,41.91172,-87.62681
13128,7,18,true,7,8,1,41.91197,-87.63197
TA1308000050,7,18,true,29,26,-3,41.91211,-87.6347
13243,7,18,true,6,11,5,41.91262,-87.6814
TA1306000032,7,18,true,9,6,-3,41.9137,-87.65285
TA1307000166,7,18,true,6,8,2,41.91386,-87.64877
15655,7,18,true,6,2,-4,41.91401,-87.70514
18067,7,18,true,5,4,-1,41.9146,-87.66796
TA1306000007,7,18,true,5,4,-1,41.91469,-87.64333
13179,7,18,true,21,25,4,41.9157,-87.63461
13133,7,18,true,10,9,-1,41.91598,-87.67733
15651,7,18,true,2,7,5,41.91752,-87.70181
TA1309000029,7,18,true,2,6,4,41.9178,-87.68245
TA1307000163,7,18,true,2,8,6,41.91821,-87.65696
13146,7,18,true,20,11,-9,41.91831,-87.63629
13059,7,18,true,16,22,6,41.91845,-87.65222
13192,7,18,true,8,17,9,41.91995,-87.64884
13288,7,18,true,6,2,-4,41.92008,-87.67788
13242,7,18,true,5,1,-4,41.92021,-87.69266
TA1309000033,7,18,true,16,13,-3,41.92158,-87.65381
13193,7,18,true,25,20,-5,41.92182,-87.64412
13191,7,18,true,4,7,3,41.92217,-87.63891
13084,7,18,true,3,6,3,41.92268,-87.69715
LP-,7,18,true,10,6,-4,41.92396,-87.63584
TA1307000001,7,18,true,5,8,3,41.92535,-87.66581
TA1306000026,7,18,true,9,4,-5,41.92558,-87.65842
TA1306000016,7,18,true,8,9,1,41.9256,-87.65371
TA1309000019,7,18,true,19,14,-5,41.92586,-87.63897
TA1309000058,7,18,true,19,15,-4,41.92591,-87.64927
TA1308000001,7,18,true,37,29,-8,41.92627,-87.63086
TA1309000023,7,18,true,13,17,4,41.9287,-87.65383
TA1307000113,7,18,true,6,11,5,41.92878,-87.66391
TA1309000059,7,18,true,8,3,-5,41.92889,-87.65898
TA1309000061,7,18,true,13,11,-2,41.92915,-87.64909
TA1305000014,7,18,true,14,14,0,41.92956,-87.64313
13085,7,18,true,6,6,0,41.92958,-87.70789
TA1307000142,7,18,true,11,16,5,41.93125,-87.64432
13276,7,18,true,15,19,4,41.93132,-87.63874
TA1307000064,7,18,true,8,5,-3,41.93222,-87.65864
TA1306000014,7,18,true,8,17,9,41.93242,-87.65271
TA1309000039,7,18,true,25,23,-2,41.93258,-87.63642
13294,7,18,true,6,1,-5,41.9326,-87.66595
TA1309000036,7,18,true,4,15,11,41.93313,-87.64776
TA1307000006,7,18,true,4,10,6,41.93571,-87.6636
13268,7,18,true,5,3,-2,41.93588,-87.67843
TA1307000052,7,18,true,13,18,5,41.93628,-87.65266
TA1307000136,7,18,true,15,13,-2,41.9365,-87.64755
TA1307000041,7,18,true,22,21,-1,41.93669,-87.63683
13137,7,18,true,23,20,-3,41.9376,-87.6441
KA17018068,7,18,true,3,5,2,41.93935,-87.68327
TA1309000042,7,18,true,1,13,12,41.93937,-87.66836
13229,7,18,true,4,6,2,41.93946,-87.66376
TA1308000019,7,18,true,8,6,-2,41.93973,-87.65886
13277,7,18,true,11,18,7,41.9401,-87.64546
TA1307000134,7,18,true,9,17,8,41.94016,-87.65303
TA1309000049,7,18,true,15,19,4,41.94077,-87.63919
TA1307000138,7,18,true,4,10,6,41.94334,-87.67094
TA1309000025,7,18,true,18,9,-9,41.94368,-87.64894
632,7,18,true,16,10,-6,41.94453,-87.6547
13278,7,18,true,12,14,2,41.94553,-87.64644
13235,7,18,true,6,14,8,41.94814,-87.66396
13253,7,18,true,3,5,2,41.9488,-87.67527
13325,7,18,true,11,10,-1,41.94907,-87.64863
TA1307000126,7,18,true,8,22,14,41.94936,-87.65451
TA1307000150,7,18,true,14,18,4,41.94945,-87.64646
13319,7,18,true,5,2,-3,41.95069,-87.6687
TA1307000127,7,18,true,5,11,6,41.9508,-87.65918
TA1309000043,7,18,true,2,10,8,41.95417,-87.66434
13063,7,18,true,10,8,-2,41.95424,-87.65441
TA1308000022,7,18,true,8,11,3,41.95438,-87.64805
TA1309000026,7,18,true,3,5,2,41.95601,-87.6802
13379,7,18,true,6,10,4,41.95786,-87.6495
13389,7,18,true,8,6,-2,41.961,-87.64958
TA1307000144,7,18,true,4,9,5,41.96142,-87.6762
15623,7,18,true,7,5,-2,41.96154,-87.69117
KA1503000022,7,18,true,3,7,4,41.96158,-87.66609
TA1307000107,7,18,true,10,13,3,41.96164,-87.65464
TA1308000012,7,18,true,20,18,-2,41.96398,-87.63818
13074,7,18,true,6,12,6,41.96521,-87.6582
639,7,18,true,10,9,-1,41.96584,-87.64538
TA1309000014,7,18,true,3,9,6,41.96709,-87.66744
TA1309000066,7,18,true,5,8,3,41.9691,-87.67423
TA1309000041,7,18,true,5,6,1,41.96951,-87.65471
KA1504000171,7,18,true,6,11,5,41.97161,-87.65016
TA1309000035,7,18,true,7,12,5,41.97335,-87.66785
13108,7,18,true,4,5,1,41.97379,-87.65971
KA1504000146,7,18,true,9,6,-3,41.978,-87.66805
13109,7,18,true,4,6,2,41.97835,-87.65976
KA1504000151,7,18,true,5,8,3,41.98359,-87.66916
KA1504000152,7,18,true,19,10,-9,41.98403,-87.65231
15578,7,18,true,8,2,-6,41.98405,-87.66027
15575,7,18,true,5,7,2,41.98975,-87.66014
KA1504000175,7,18,true,2,6,4,42.00797,-87.66549
596,7,18,true,5,3,-2,42.04822,-87.68348
20236,7,19,false,2,9,7,41.7314,-87.58577
15491,7,19,false,8,6,-2,41.78096,-87.57624
TA1308000009,7,19,false,23,27,4,41.79522,-87.58075
TA1307000164,7,19,false,2,6,4,41.79527,-87.59647
KA1503000052,7,19,false,6,6,0,41.79935,-87.60097
KA1503000059,7,19,false,9,9,0,41.79952,-87.58643
TA1309000037,7,19,false,7,5,-2,41.79957,-87.59474
KA1503000007,7,19,false,18,11,-7,41.80242,-87.58689
13398,7,19,false,6,8,2,41.80256,-87.59035
KA1503000004,7,19,false,2,8,6,41.83127,-87.6088
KA1503000038,7,19,false,2,5,3,41.83845,-87.6354
TA1307000048,7,19,false,27,21,-6,41.83855,-87.60821
TA1307000139,7,19,false,1,7,6,41.84205,-87.61698
TA1305000001,7,19,false,5,5,0,41.85262,-87.6265
13075,7,19,false,8,6,-2,41.8531,-87.63192
15545,7,19,false,19,16,-3,41.85627,-87.61334
SL-013,7,19,false,1,6,5,41.85659,-87.62755
13135,7,19,false,1,5,4,41.85753,-87.66157
13150,7,19,false,13,10,-3,41.85783,-87.62455
13164,7,19,false,4,5,1,41.85818,-87.65648
SL-012,7,19,false,11,4,-7,41.86038,-87.62581
TA1307000124,7,19,false,11,12,1,41.86411,-87.62372
TA1309000001,7,19,false,7,7,0,41.86488,-87.64708
13431,7,19,false,16,27,11,41.8661,-87.60728
TA1305000002,7,19,false,9,15,6,41.86721,-87.62597
15544,7,19,false,16,17,1,41.86723,-87.61536
KA1706005007,7,19,false,4,6,2,41.86749,-87.63219
SL-005,7,19,false,35,27,-8,41.8679,-87.62304
13160,7,19,false,5,5,0,41.86947,-87.65548
TA1309000010,7,19,false,12,10,-2,41.87074,-87.62574
TA1307000130,7,19,false,5,2,-3,41.87178,-87.65103
SL-008,7,19,false,12,10,-2,41.87209,-87.62956
13332,7,19,false,6,5,-1,41.87219,-87.6615
SL-011,7,19,false,9,9,0,41.87256,-87.63356
623,7,19,false,42,28,-14,41.87272,-87.62399
SL-007,7,19,false,18,19,1,41.87404,-87.6277
SL-010,7,19,false,5,3,-2,41.87501,-87.63309
15541,7,19,false,26,53,27,41.8758,-87.62086
TA1305000010,7,19,false,8,14,6,41.87623,-87.62444
TA1305000035,7,19,false,9,6,-3,41.87716,-87.62787
15539,7,19,false,1,8,7,41.87763,-87.64405
13158,7,19,false,2,11,9,41.87764,-87.64957
13157,7,19,false,10,7,-3,41.87773,-87.6548
TA1305000025,7,19,false,12,6,-6,41.87773,-87.63528
TA1309000002,7,19,false,5,21,16,41.87784,-87.62408
13206,7,19,false,5,8,3,41.87794,-87.66201
TA1309000004,7,19,false,4,6,2,41.87811,-87.63184
638,7,19,false,6,5,-1,41.87827,-87.64078
TA1309000008,7,19,false,4,7,3,41.87933,-87.6355
KA1503000015,7,19,false,10,2,-8,41.87948,-87.6257
WL-011,7,19,false,7,7,0,41.88034,-87.64273
13300,7,19,false,76,78,2,41.88097,-87.61675
13008,7,19,false,52,52,0,41.88105,-87.62408
13056,7,19,false,6,5,-1,41.88168,-87.63951
TA1307000120,7,19,false,5,11,6,41.88188,-87.64879
13036,7,19,false,9,12,3,41.8821,-87.62513
TA1305000032,7,19,false,9,8,-1,41.88218,-87.64109
13053,7,19,false,25,21,-4,41.88365,-87.64863
13001,7,19,false,24,19,-5,41.88397,-87.62459
18062,7,19,false,4,17,13,41.88412,-87.65427
TA1306000010,7,19,false,9,12,3,41.88419,-87.62961
KA1504000106,7,19,false,5,1,-4,41.88459,-87.70631
TA1305000030,7,19,false,10,15,5,41.88459,-87.63178
15535,7,19,false,9,13,4,41.8846,-87.64455
TA1305000029,7,19,false,15,11,-4,41.88466,-87.62787
13263,7,19,false,13,21,8,41.88467,-87.61952
TA1306000015,7,19,false,7,17,10,41.88549,-87.65232
13021,7,19,false,10,13,3,41.88559,-87.64184
TA1307000111,7,19,false,8,14,6,41.88582,-87.63548
KA1503000012,7,19,false,10,11,1,41.88599,-87.63089
TA1305000011,7,19,false,21,24,3,41.886,-87.62418
15534,7,19,false,11,16,5,41.88627,-87.61749
TA1308000029,7,19,false,8,13,5,41.88673,-87.62225
TA1307000131,7,19,false,17,13,-4,41.88688,-87.62606
KA1503000064,7,19,false,27,40,13,41.88697,-87.61281
TA1305000022,7,19,false,8,6,-2,41.88817,-87.63656
TA1306000003,7,19,false,19,18,-1,41.88867,-87.64442
KA1503000043,7,19,false,13,17,4,41.88918,-87.63851
13050,7,19,false,18,19,1,41.88919,-87.62775
TA1307000151,7,19,false,4,7,3,41.88993,-87.63427
KA1503000044,7,19,false,6,5,-1,41.89018,-87.6262
13427,7,19,false,6,4,-2,41.89054,-87.62205
13430,7,19,false,6,17,11,41.89077,-87.63169
TA1306000013,7,19,false,24,29,5,41.89083,-87.61852
RN-,7,19,false,13,13,0,41.89102,-87.63546
13434,7,19,false,6,4,-2,41.89108,-87.66663
TA1307000117,7,19,false,27,22,-5,41.89144,-87.62675
13033,7,19,false,13,10,-3,41.8916,-87.64835
TA1305000003,7,19,false,22,14,-8,41.89187,-87.62061
13022,7,19,false,198,177,-21,41.89227,-87.61205
TA1306000029,7,19,false,34,22,-12,41.89256,-87.61449
13265,7,19,false,8,13,5,41.89383,-87.64172
13045,7,19,false,16,20,4,41.89403,-87.62931
13016,7,19,false,23,12,-11,41.89431,-87.62277
KA1503000041,7,19,false,11,11,0,41.89452,-87.61798
13196,7,19,false,6,9,3,41.89455,-87.65345
TA1307000062,7,19,false,7,3,-4,41.89466,-87.63839
TA1306000012,7,19,false,16,13,-3,41.89475,-87.63438
KP1705001026,7,19,false,4,13,9,41.89483,-87.6323
13132,7,19,false,6,10,4,41.89573,-87.67718
15530,7,19,false,11,14,3,41.89575,-87.62596
18003,7,19,false,5,3,-2,41.89575,-87.62011
13247,7,19,false,5,4,-1,41.89597,-87.66775
TA1305000020,7,19,false,4,9,5,41.89636,-87.65406
13289,7,19,false,8,3,-5,41.89638,-87.661
13303,7,19,false,8,5,-3,41.89672,-87.63088
13017,7,19,false,2,6,4,41.89676,-87.6357
13338,7,19,false,12,6,-6,41.89697,-87.62173
TA1307000061,7,19,false,8,3,-5,41.89745,-87.62873
13034,7,19,false,5,6,1,41.89754,-87.62352
TA1306000009,7,19,false,11,8,-3,41.89772,-87.64299
620,7,19,false,6,9,3,41.89817,-87.63754
15529,7,19,false,18,16,-2,41.89858,-87.62206
TA1307000128,7,19,false,12,19,7,41.89896,-87.6299
17660,7,19,false,7,3,-4,41.90036,-87.69671
13042,7,19,false,43,48,5,41.90097,-87.62377
KA1504000133,7,19,false,9,19,10,41.90234,-87.62773
13241,7,19,false,1,6,5,41.9029,-87.68731
TA1307000039,7,19,false,17,13,-4,41.90294,-87.63137
658,7,19,false,3,6,3,41.903,-87.6838
TA1305000034,7,19,false,5,6,1,41.90313,-87.67391
KA1504000135,7,19,false,18,18,0,41.90319,-87.63439
13136,7,19,false,5,3,-2,41.90326,-87.67845
13061,7,19,false,15,26,11,41.90342,-87.66779
KA1504000079,7,19,false,6,10,4,41.9035,-87.64334
TA1307000115,7,19,false,5,1,-4,41.9046,-87.64056
TA1308000049,7,19,false,23,19,-4,41.90672,-87.6349
KA1504000134,7,19,false,15,15,0,41.90687,-87.6262
13224,7,19,false,10,9,-1,41.90706,-87.66725
TA1307000143,7,19,false,4,10,6,41.90762,-87.63854
13221,7,19,false,7,12,5,41.90765,-87.67254
TA1309000024,7,19,false,13,17,4,41.908,-87.63152
TA1305000041,7,19,false,11,3,-8,41.9094,-87.67769
331,7,19,false,6,6,0,41.90965,-87.64812
TA1305000037,7,19,false,8,9,1,41.91018,-87.67003
TA1306000008,7,19,false,6,6,0,41.9102,-87.6435
13058,7,19,false,8,3,-5,41.91059,-87.64942
TA1307000038,7,19,false,3,5,2,41.91138,-87.63868
LF-005,7,19,false,60,45,-15,41.91172,-87.62681
13128,7,19,false,9,14,5,41.91197,-87.63197
TA1308000050,7,19,false,26,20,-6,41.91211,-87.6347
13243,7,19,false,8,10,2,41.91262,-87.6814
TA1306000032,7,19,false,5,10,5,41.9137,-87.65285
TA1307000166,7,19,false,15,8,-7,41.91386,-87.64877
18067,7,19,false,3,6,3,41.9146,-87.66796
13179,7,19,false,24,20,-4,41.9157,-87.63461
13133,7,19,false,11,5,-6,41.91598,-87.67733
15651,7,19,false,10,9,-1,41.91752,-87.70181
TA1309000006,7,19,false,7,5,-2,41.91809,-87.64375
TA1307000163,7,19,false,6,2,-4,41.91821,-87.65696
13146,7,19,false,29,11,-18,41.91831,-87.63629
13059,7,19,false,8,13,5,41.91845,-87.65222
13259,7,19,false,6,3,-3,41.91852,-87.69744
13192,7,19,false,10,9,-1,41.91995,-87.64884
13288,7,19,false,2,5,3,41.92008,-87.67788
TA1309000030,7,19,false,9,3,-6,41.92077,-87.66372
TA1309000033,7,19,false,9,14,5,41.92158,-87.65381
13193,7,19,false,14,10,-4,41.92182,-87.64412
13191,7,19,false,12,11,-1,41.92217,-87.63891
13084,7,19,false,3,7,4,41.92268,-87.69715
LP-,7,19,false,5,14,9,41.92396,-87.63584
15648,7,19,false,6,2,-4,41.92464,-87.68931
KA1504000090,7,19,false,6,1,-5,41.92483,-87.7145
TA1307000001,7,19,false,5,13,8,41.92535,-87.66581
TA1306000026,7,19,false,6,10,4,41.92558,-87.65842
TA1306000016,7,19,false,5,2,-3,41.9256,-87.65371
TA1309000019,7,19,false,17,24,7,41.92586,-87.63897
TA1309000058,7,19,false,22,14,-8,41.92591,-87.64927
TA1308000001,7,19,false,51,64,13,41.92627,-87.63086
13124,7,19,false,8,10,2,41.92675,-87.63444
TA1309000023,7,19,false,9,8,-1,41.9287,-87.65383
13296,7,19,false,7,5,-2,41.92883,-87.66852
TA1309000059,7,19,false,2,5,3,41.92889,-87.65898
TA1309000061,7,19,false,10,12,2,41.92915,-87.64909
TA1305000014,7,19,false,24,9,-15,41.92956,-87.64313
13085,7,19,false,7,5,-2,41.92958,-87.70789
TA1307000142,7,19,false,11,12,1,41.93125,-87.64432
13276,7,19,false,9,11,2,41.93132,-87.63874
TA1306000014,7,19,false,13,8,-5,41.93242,-87.65271
TA1309000039,7,19,false,24,28,4,41.93258,-87.63642
TA1309000036,7,19,false,12,7,-5,41.93313,-87.64776
TA1307000006,7,19,false,1,9,8,41.93571,-87.6636
13268,7,19,false,10,1,-9,41.93588,-87.67843
TA1307000052,7,19,false,8,14,6,41.93628,-87.65266
TA1307000136,7,19,false,7,16,9,41.9365,-87.64755
TA1307000041,7,19,false,10,15,5,41.93669,-87.63683
13137,7,19,false,15,19,4,41.9376,-87.6441
13229,7,19,false,6,6,0,41.93946,-87.66376
TA1308000019,7,19,false,3,7,4,41.93973,-87.65886
13277,7,19,false,14,12,-2,41.9401,-87.64546
TA1307000134,7,19,false,20,22,2,41.94016,-87.65303
TA1309000049,7,19,false,17,19,2,41.94077,-87.63919
TA1309000025,7,19,false,16,15,-1,41.94368,-87.64894
13071,7,19,false,10,10,0,41.94373,-87.66401
632,7,19,false,9,8,-1,41.94453,-87.6547
13278,7,19,false,6,14,8,41.94553,-87.64644
15632,7,19,false,7,2,-5,41.94664,-87.69463
KA1504000143,7,19,false,4,5,1,41.94664,-87.68337
13235,7,19,false,4,10,6,41.94814,-87.66396
13325,7,19,false,8,12,4,41.94907,-87.64863
TA1307000126,7,19,false,5,12,7,41.94936,-87.65451
TA1307000150,7,19,false,13,20,7,41.94945,-87.64646
TA1307000127,7,19,false,4,12,8,41.9508,-87.65918
13323,7,19,false,7,2,-5,41.95282,-87.65
TA1309000043,7,19,false,5,6,1,41.95417,-87.66434
13063,7,19,false,2,7,5,41.95424,-87.65441
TA1308000022,7,19,false,11,13,2,41.95438,-87.64805
13379,7,19,false,2,7,5,41.95786,-87.6495
13389,7,19,false,10,4,-6,41.961,-87.64958
TA1307000107,7,19,false,17,12,-5,41.96164,-87.65464
TA1307000156,7,19,false,4,5,1,41.96301,-87.68479
TA1308000012,7,19,false,31,20,-11,41.96398,-87.63818
13074,7,19,false,4,12,8,41.96521,-87.6582
639,7,19,false,12,8,-4,41.96584,-87.64538
TA1309000014,7,19,false,5,6,1,41.96709,-87.66744
TA1307000119,7,19,false,21,10,-11,41.96796,-87.65
TA1308000021,7,19,false,5,9,4,41.96883,-87.65765
TA1309000066,7,19,false,6,3,-3,41.9691,-87.67423
TA1309000041,7,19,false,2,7,5,41.96951,-87.65471
KA1504000171,7,19,false,7,12,5,41.97161,-87.65016
13108,7,19,false,8,5,-3,41.97379,-87.65971
KA1504000146,7,19,false,4,5,1,41.978,-87.66805
13109,7,19,false,9,7,-2,41.97835,-87.65976
KA1504000152,7,19,false,7,15,8,41.98403,-87.65231
15578,7,19,false,7,2,-5,41.98405,-87.66027
RP-009,7,19,false,2,7,5,42.00107,-87.66122
E008,7,19,false,1,5,4,42.05049,-87.67782
KA1503000014,7,19,true,6,7,1,41.7851,-87.60108
TA1308000009,7,19,true,14,8,-6,41.79522,-87.58075
KA1503000059,7,19,true,5,1,-4,41.79952,-87.58643
TA1309000037,7,19,true,4,5,1,41.79957,-87.59474
KA1503000007,7,19,true,8,10,2,41.80242,-87.58689
TA1308000045,7,19,true,5,3,-2,41.83062,-87.64129
15445,7,19,true,9,5,-4,41.83453,-87.63183
13216,7,19,true,9,8,-1,41.83473,-87.62581
13217,7,19,true,2,6,4,41.83488,-87.61792
13215,7,19,true,6,5,-1,41.83634,-87.6135
TA1309000055,7,19,true,5,4,-1,41.8382,-87.64514
TA1307000048,7,19,true,16,21,5,41.83855,-87.60821
TA1307000139,7,19,true,5,5,0,41.84205,-87.61698
TA1307000005,7,19,true,7,2,-5,41.84569,-87.6225
13075,7,19,true,6,4,-2,41.8531,-87.63192
15545,7,19,true,19,18,-1,41.85627,-87.61334
13102,7,19,true,8,10,2,41.85762,-87.61942
TA1307000124,7,19,true,3,5,2,41.86411,-87.62372
13431,7,19,true,21,20,-1,41.8661,-87.60728
WL-008,7,19,true,12,6,-6,41.86712,-87.64108
TA1305000002,7,19,true,9,8,-1,41.86721,-87.62597
TA1305000017,7,19,true,6,2,-4,41.86734,-87.64863
KA1706005007,7,19,true,7,4,-3,41.86749,-87.63219
SL-005,7,19,true,16,20,4,41.8679,-87.62304
644,7,19,true,2,5,3,41.86859,-87.68625
13139,7,19,true,8,5,-3,41.86893,-87.65913
13160,7,19,true,15,3,-12,41.86947,-87.65548
TA1309000010,7,19,true,9,7,-2,41.87074,-87.62574
TA1307000130,7,19,true,4,7,3,41.87178,-87.65103
SL-008,7,19,true,11,10,-1,41.87209,-87.62956
13332,7,19,true,13,16,3,41.87219,-87.6615
623,7,19,true,4,9,5,41.87272,-87.62399
KA1504000104,7,19,true,3,5,2,41.87296,-87.66912
13028,7,19,true,5,7,2,41.87475,-87.64981
15541,7,19,true,6,10,4,41.8758,-87.62086
13138,7,19,true,5,2,-3,41.87723,-87.63941
15539,7,19,true,7,10,3,41.87763,-87.64405
13158,7,19,true,9,9,0,41.87764,-87.64957
13157,7,19,true,4,13,9,41.87773,-87.6548
TA1305000025,7,19,true,2,11,9,41.87773,-87.63528
638,7,19,true,14,2,-12,41.87827,-87.64078
13011,7,19,true,11,3,-8,41.87931,-87.63993
KA1503000015,7,19,true,2,6,4,41.87948,-87.6257
WL-011,7,19,true,2,13,11,41.88034,-87.64273
13156,7,19,true,1,6,5,41.88042,-87.65554
13300,7,19,true,14,18,4,41.88097,-87.61675
13008,7,19,true,11,8,-3,41.88105,-87.62408
TA1305000006,7,19,true,7,3,-4,41.88122,-87.6296
TA1307000120,7,19,true,12,15,3,41.88188,-87.64879
13036,7,19,true,8,4,-4,41.8821,-87.62513
TA1305000032,7,19,true,11,6,-5,41.88218,-87.64109
13053,7,19,true,9,6,-3,41.88365,-87.64863
18062,7,19,true,1,5,4,41.88412,-87.65427
TA1306000010,7,19,true,9,7,-2,41.88419,-87.62961
15535,7,19,true,4,7,3,41.8846,-87.64455
TA1305000029,7,19,true,8,7,-1,41.88466,-87.62787
13263,7,19,true,10,13,3,41.88467,-87.61952
TA1306000015,7,19,true,13,7,-6,41.88549,-87.65232
13021,7,19,true,3,11,8,41.88559,-87.64184
TA1307000111,7,19,true,2,9,7,41.88582,-87.63548
TA1305000011,7,19,true,6,3,-3,41.886,-87.62418
15534,7,19,true,7,9,2,41.88627,-87.61749
TA1307000131,7,19,true,6,4,-2,41.88688,-87.62606
KA1503000064,7,19,true,9,6,-3,41.88697,-87.61281
TA1305000022,7,19,true,8,9,1,41.88817,-87.63656
TA1306000003,7,19,true,22,32,10,41.88867,-87.64442
KA1503000043,7,19,true,11,12,1,41.88918,-87.63851
13050,7,19,true,5,11,6,41.88919,-87.62775
TA1307000151,7,19,true,13,4,-9,41.88993,-87.63427
636,7,19,true,5,2,-3,41.88997,-87.63662
KA1503000044,7,19,true,6,5,-1,41.89018,-87.6262
13427,7,19,true,6,6,0,41.89054,-87.62205
13430,7,19,true,8,6,-2,41.89077,-87.63169
TA1306000013,7,19,true,13,21,8,41.89083,-87.61852
RN-,7,19,true,11,8,-3,41.89102,-87.63546
13434,7,19,true,6,4,-2,41.89108,-87.66663
TA1307000117,7,19,true,17,21,4,41.89144,-87.62675
13033,7,19,true,13,6,-7,41.8916,-87.64835
13194,7,19,true,4,6,2,41.8918,-87.65878
TA1305000003,7,19,true,12,8,-4,41.89187,-87.62061
13022,7,19,true,33,34,1,41.89227,-87.61205
TA1306000029,7,19,true,12,11,-1,41.89256,-87.61449
13265,7,19,true,8,6,-2,41.89383,-87.64172
13045,7,19,true,15,14,-1,41.89403,-87.62931
13016,7,19,true,15,16,1,41.89431,-87.62277
KA1503000041,7,19,true,7,7,0,41.89452,-87.61798
13196,7,19,true,5,6,1,41.89455,-87.65345
TA1307000062,7,19,true,6,6,0,41.89466,-87.63839
TA1306000012,7,19,true,13,22,9,41.89475,-87.63438
KP1705001026,7,19,true,6,7,1,41.89483,-87.6323
13132,7,19,true,3,8,5,41.89573,-87.67718
15530,7,19,true,8,7,-1,41.89575,-87.62596
TA1305000020,7,19,true,9,5,-4,41.89636,-87.65406
13303,7,19,true,6,4,-2,41.89672,-87.63088
13017,7,19,true,5,6,1,41.89676,-87.6357
13338,7,19,true,11,3,-8,41.89697,-87.62173
TA1307000061,7,19,true,6,6,0,41.89745,-87.62873
TA1306000009,7,19,true,6,8,2,41.89772,-87.64299
620,7,19,true,6,6,0,41.89817,-87.63754
15529,7,19,true,13,10,-3,41.89858,-87.62206
TA1307000128,7,19,true,16,10,-6,41.89896,-87.6299
TA1306000011,7,19,true,6,5,-1,41.89994,-87.63443
13290,7,19,true,5,10,5,41.90069,-87.66259
13042,7,19,true,17,12,-5,41.90097,-87.62377
TA1307000070,7,19,true,3,5,2,41.90133,-87.67742
KA1504000133,7,19,true,15,10,-5,41.90234,-87.62773
TA1307000039,7,19,true,17,22,5,41.90294,-87.63137
13256,7,19,true,5,3,-2,41.90302,-87.69749
TA1305000034,7,19,true,3,7,4,41.90313,-87.67391
KA1504000135,7,19,true,19,18,-1,41.90319,-87.63439
13136,7,19,true,4,7,3,41.90326,-87.67845
13061,7,19,true,6,8,2,41.90342,-87.66779
KA1504000079,7,19,true,8,6,-2,41.9035,-87.64334
TA1308000049,7,19,true,21,18,-3,41.90672,-87.6349
KA1504000134,7,19,true,7,9,2,41.90687,-87.6262
13224,7,19,true,5,5,0,41.90706,-87.66725
13221,7,19,true,12,5,-7,41.90765,-87.67254
TA1309000024,7,19,true,5,12,7,41.908,-87.63152
TA1305000041,7,19,true,11,8,-3,41.9094,-87.67769
331,7,19,true,7,8,1,41.90965,-87.64812
TA1305000037,7,19,true,7,4,-3,41.91018,-87.67003
13257,7,19,true,5,3,-2,41.91054,-87.68956
13154,7,19,true,6,6,0,41.91054,-87.65312
TA1307000038,7,19,true,6,9,3,41.91138,-87.63868
LF-005,7,19,true,28,23,-5,41.91172,-87.62681
13128,7,19,true,7,10,3,41.91197,-87.63197
TA1308000050,7,19,true,30,29,-1,41.91211,-87.6347
13243,7,19,true,8,10,2,41.91262,-87.6814
TA1306000032,7,19,true,9,5,-4,41.9137,-87.65285
TA1307000166,7,19,true,4,15,11,41.91386,-87.64877
15655,7,19,true,1,5,4,41.91401,-87.70514
18067,7,19,true,5,7,2,41.9146,-87.66796
TA1306000007,7,19,true,8,3,-5,41.91469,-87.64333
13068,7,19,true,7,3,-4,41.91554,-87.68703
13179,7,19,true,15,18,3,41.9157,-87.63461
13133,7,19,true,1,5,4,41.91598,-87.67733
15651,7,19,true,8,5,-3,41.91752,-87.70181
TA1309000006,7,19,true,6,8,2,41.91809,-87.64375
TA1307000163,7,19,true,5,4,-1,41.91821,-87.65696
13146,7,19,true,15,19,4,41.91831,-87.63629
13059,7,19,true,16,16,0,41.91845,-87.65222
13259,7,19,true,6,7,1,41.91852,-87.69744
13192,7,19,true,5,9,4,41.91995,-87.64884
13288,7,19,true,2,5,3,41.92008,-87.67788
13242,7,19,true,5,1,-4,41.92021,-87.69266
TA1309000030,7,19,true,7,5,-2,41.92077,-87.66372
TA1309000033,7,19,true,5,11,6,41.92158,-87.65381
13193,7,19,true,22,19,-3,41.92182,-87.64412
13191,7,19,true,7,11,4,41.92217,-87.63891
13084,7,19,true,4,5,1,41.92268,-87.69715
LP-,7,19,true,7,14,7,41.92396,-87.63584
15648,7,19,true,5,4,-1,41.92464,-87.68931
TA1307000001,7,19,true,8,5,-3,41.92535,-87.66581
TA1306000026,7,19,true,5,1,-4,41.92558,-87.65842
TA1306000016,7,19,true,2,5,3,41.9256,-87.65371
TA1309000019,7,19,true,15,18,3,41.92586,-87.63897
TA1309000058,7,19,true,12,12,0,41.92591,-87.64927
TA1308000001,7,19,true,37,27,-10,41.92627,-87.63086
TA1309000023,7,19,true,13,8,-5,41.9287,-87.65383
TA1307000113,7,19,true,6,4,-2,41.92878,-87.66391
TA1309000061,7,19,true,8,12,4,41.92915,-87.64909
TA1305000014,7,19,true,10,19,9,41.92956,-87.64313
TA1307000142,7,19,true,13,13,0,41.93125,-87.64432
13276,7,19,true,20,11,-9,41.93132,-87.63874
TA1307000064,7,19,true,6,6,0,41.93222,-87.65864
TA1306000014,7,19,true,6,6,0,41.93242,-87.65271
TA1309000039,7,19,true,17,19,2,41.93258,-87.63642
TA1309000036,7,19,true,15,10,-5,41.93313,-87.64776
TA1307000006,7,19,true,7,8,1,41.93571,-87.6636
TA1307000052,7,19,true,13,11,-2,41.93628,-87.65266
TA1307000136,7,19,true,13,14,1,41.9365,-87.64755
TA1307000041,7,19,true,19,15,-4,41.93669,-87.63683
13137,7,19,true,19,18,-1,41.9376,-87.6441
TA1309000042,7,19,true,6,12,6,41.93937,-87.66836
13229,7,19,true,5,5,0,41.93946,-87.66376
TA1308000019,7,19,true,4,5,1,41.93973,-87.65886
13277,7,19,true,9,9,0,41.9401,-87.64546
TA1307000134,7,19,true,10,10,0,41.94016,-87.65303
TA1309000049,7,19,true,24,13,-11,41.94077,-87.63919
TA1307000138,7,19,true,6,8,2,41.94334,-87.67094
TA1309000025,7,19,true,14,9,-5,41.94368,-87.64894
13071,7,19,true,7,4,-3,41.94373,-87.66401
632,7,19,true,9,12,3,41.94453,-87.6547
13278,7,19,true,13,14,1,41.94553,-87.64644
13235,7,19,true,5,10,5,41.94814,-87.66396
13325,7,19,true,10,9,-1,41.94907,-87.64863
TA1307000126,7,19,true,11,13,2,41.94936,-87.65451
TA1307000150,7,19,true,5,6,1,41.94945,-87.64646
TA1307000127,7,19,true,10,8,-2,41.9508,-87.65918
13323,7,19,true,6,5,-1,41.95282,-87.65
TA1308000022,7,19,true,10,11,1,41.95438,-87.64805
TA1309000026,7,19,true,6,5,-1,41.95601,-87.6802
13249,7,19,true,2,5,3,41.95606,-87.66885
13379,7,19,true,3,8,5,41.95786,-87.6495
13389,7,19,true,5,17,12,41.961,-87.64958
15622,7,19,true,6,2,-4,41.96108,-87.69544
KA1503000022,7,19,true,5,3,-2,41.96158,-87.66609
TA1307000107,7,19,true,8,17,9,41.96164,-87.65464
TA1308000012,7,19,true,21,17,-4,41.96398,-87.63818
13074,7,19,true,6,6,0,41.96521,-87.6582
639,7,19,true,5,6,1,41.96584,-87.64538
TA1307000140,7,19,true,4,7,3,41.96643,-87.68865
TA1309000014,7,19,true,6,6,0,41.96709,-87.66744
TA1307000119,7,19,true,5,2,-3,41.96796,-87.65
TA1308000021,7,19,true,5,3,-2,41.96883,-87.65765
KA1504000080,7,19,true,5,3,-2,41.96887,-87.69609
TA1309000066,7,19,true,6,5,-1,41.9691,-87.67423
KA1504000171,7,19,true,9,8,-1,41.97161,-87.65016
KA1504000146,7,19,true,3,7,4,41.978,-87.66805
13109,7,19,true,6,2,-4,41.97835,-87.65976
KA1504000151,7,19,true,2,5,3,41.98359,-87.66916
KA1504000152,7,19,true,15,5,-10,41.98403,-87.65231
15575,7,19,true,8,7,-1,41.98975,-87.66014
15571,7,19,true,2,5,3,41.99478,-87.66028
KA1504000175,7,19,true,5,3,-2,42.00797,-87.66549
15491,7,20,false,12,12,0,41.78096,-87.57624
KA1503000014,7,20,false,7,9,2,41.7851,-87.60108
TA1308000009,7,20,false,15,13,-2,41.79522,-87.58075
TA1307000164,7,20,false,4,5,1,41.79527,-87.59647
KA1503000059,7,20,false,7,7,0,41.79952,-87.58643
TA1309000037,7,20,false,9,4,-5,41.79957,-87.59474
KA1503000007,7,20,false,8,10,2,41.80242,-87.58689
13398,7,20,false,2,5,3,41.80256,-87.59035
KA1503000065,7,20,false,2,7,5,41.81409,-87.59701
TA1308000038,7,20,false,6,4,-2,41.82298,-87.6071
KA1503000004,7,20,false,4,8,4,41.83127,-87.6088
13215,7,20,false,6,13,7,41.83634,-87.6135
TA1307000048,7,20,false,25,32,7,41.83855,-87.60821
TA1305000004,7,20,false,5,1,-4,41.8514,-87.61884
13075,7,20,false,15,7,-8,41.8531,-87.63192
15545,7,20,false,13,13,0,41.85627,-87.61334
SL-013,7,20,false,1,11,10,41.85659,-87.62755
13102,7,20,false,5,2,-3,41.85762,-87.61942
13150,7,20,false,5,5,0,41.85783,-87.62455
13164,7,20,false,3,5,2,41.85818,-87.65648
SL-012,7,20,false,6,5,-1,41.86038,-87.62581
TA1307000124,7,20,false,7,5,-2,41.86411,-87.62372
13431,7,20,false,15,11,-4,41.8661,-87.60728
TA1305000002,7,20,false,13,19,6,41.86721,-87.62597
15544,7,20,false,18,20,2,41.86723,-87.61536
KA1706005007,7,20,false,5,1,-4,41.86749,-87.63219
SL-005,7,20,false,8,28,20,41.8679,-87.62304
TA1309000010,7,20,false,10,23,13,41.87074,-87.62574
SL-008,7,20,false,4,21,17,41.87209,-87.62956
SL-011,7,20,false,7,7,0,41.87256,-87.63356
623,7,20,false,21,18,-3,41.87272,-87.62399
SL-007,7,20,false,18,13,-5,41.87404,-87.6277
15541,7,20,false,28,26,-2,41.8758,-87.62086
TA1305000010,7,20,false,18,12,-6,41.87623,-87.62444
624,7,20,false,5,5,0,41.87626,-87.62923
TA1305000035,7,20,false,7,8,1,41.87716,-87.62787
15539,7,20,false,7,2,-5,41.87763,-87.64405
13157,7,20,false,2,8,6,41.87773,-87.6548
TA1305000025,7,20,false,10,11,1,41.87773,-87.63528
TA1309000002,7,20,false,8,8,0,41.87784,-87.62408
638,7,20,false,1,5,4,41.87827,-87.64078
TA1305000005,7,20,false,6,2,-4,41.87924,-87.62975
13011,7,20,false,2,7,5,41.87931,-87.63993
TA1309000008,7,20,false,4,10,6,41.87933,-87.6355
KA1503000034,7,20,false,5,6,1,41.87938,-87.63197
KA1503000015,7,20,false,6,10,4,41.87948,-87.6257
TA1309000007,7,20,false,7,4,-3,41.88022,-87.63526
WL-011,7,20,false,2,10,8,41.88034,-87.64273
13300,7,20,false,64,69,5,41.88097,-87.61675
13008,7,20,false,59,47,-12,41.88105,-87.62408
TA1305000006,7,20,false,4,5,1,41.88122,-87.6296
13134,7,20,false,4,7,3,41.88138,-87.67493
TA1307000120,7,20,false,8,10,2,41.88188,-87.64879
13341,7,20,false,7,14,7,41.88208,-87.63985
TA1305000032,7,20,false,5,16,11,41.88218,-87.64109
13353,7,20,false,4,9,5,41.88283,-87.6612
13409,7,20,false,7,7,0,41.8831,-87.6511
WL-012,7,20,false,1,6,5,41.88337,-87.6412
13053,7,20,false,14,18,4,41.88365,-87.64863
13001,7,20,false,11,19,8,41.88397,-87.62459
TA1306000010,7,20,false,6,7,1,41.88419,-87.62961
TA1305000030,7,20,false,9,10,1,41.88459,-87.63178
15535,7,20,false,11,5,-6,41.8846,-87.64455
TA1305000029,7,20,false,18,19,1,41.88466,-87.62787
13263,7,20,false,23,9,-14,41.88467,-87.61952
TA1306000015,7,20,false,4,9,5,41.88549,-87.65232
13021,7,20,false,4,7,3,41.88559,-87.64184
TA1307000111,7,20,false,2,5,3,41.88582,-87.63548
13073,7,20,false,1,6,5,41.88592,-87.66717
TA1305000011,7,20,false,13,18,5,41.886,-87.62418
15534,7,20,false,12,10,-2,41.88627,-87.61749
TA1308000029,7,20,false,7,6,-1,41.88673,-87.62225
TA1307000131,7,20,false,13,18,5,41.88688,-87.62606
KA1503000064,7,20,false,30,15,-15,41.88697,-87.61281
TA1305000022,7,20,false,5,8,3,41.88817,-87.63656
TA1306000003,7,20,false,8,13,5,41.88867,-87.64442
KA1503000043,7,20,false,7,18,11,41.88918,-87.63851
13050,7,20,false,8,20,12,41.88919,-87.62775
TA1307000151,7,20,false,11,15,4,41.88993,-87.63427
636,7,20,false,4,5,1,41.88997,-87.63662
KA1503000044,7,20,false,7,13,6,41.89018,-87.6262
13430,7,20,false,8,29,21,41.89077,-87.63169
TA1306000013,7,20,false,26,33,7,41.89083,-87.61852
RN-,7,20,false,3,6,3,41.89102,-87.63546
TA1307000117,7,20,false,28,28,0,41.89144,-87.62675
13033,7,20,false,8,11,3,41.8916,-87.64835
13194,7,20,false,2,5,3,41.8918,-87.65878
TA1305000003,7,20,false,16,18,2,41.89187,-87.62061
13022,7,20,false,145,116,-29,41.89227,-87.61205
TA1306000029,7,20,false,20,25,5,41.89256,-87.61449
13045,7,20,false,16,10,-6,41.89403,-87.62931
13016,7,20,false,16,12,-4,41.89431,-87.62277
KA1503000041,7,20,false,7,9,2,41.89452,-87.61798
13196,7,20,false,3,9,6,41.89455,-87.65345
TA1307000062,7,20,false,4,5,1,41.89466,-87.63839
TA1306000012,7,20,false,16,9,-7,41.89475,-87.63438
KP1705001026,7,20,false,2,9,7,41.89483,-87.6323
15530,7,20,false,6,1,-5,41.89575,-87.62596
TA1305000020,7,20,false,5,9,4,41.89636,-87.65406
13289,7,20,false,3,6,3,41.89638,-87.661
13303,7,20,false,4,6,2,41.89672,-87.63088
13034,7,20,false,4,10,6,41.89754,-87.62352
620,7,20,false,6,3,-3,41.89817,-87.63754
15529,7,20,false,5,15,10,41.89858,-87.62206
TA1307000128,7,20,false,8,9,1,41.89896,-87.6299
13042,7,20,false,28,44,16,41.90097,-87.62377
TA1307000070,7,20,false,3,5,2,41.90133,-87.67742
KA1504000133,7,20,false,16,11,-5,41.90234,-87.62773
TA1307000039,7,20,false,15,26,11,41.90294,-87.63137
TA1305000034,7,20,false,8,3,-5,41.90313,-87.67391
KA1504000135,7,20,false,23,18,-5,41.90319,-87.63439
13061,7,20,false,11,20,9,41.90342,-87.66779
KA1504000079,7,20,false,9,6,-3,41.9035,-87.64334
TA1308000049,7,20,false,8,10,2,41.90672,-87.6349
KA1504000134,7,20,false,5,3,-2,41.90687,-87.6262
13224,7,20,false,4,9,5,41.90706,-87.66725
13221,7,20,false,11,5,-6,41.90765,-87.67254
TA1309000024,7,20,false,11,7,-4,41.908,-87.63152
TA1305000041,7,20,false,14,10,-4,41.9094,-87.67769
TA1306000008,7,20,false,5,2,-3,41.9102,-87.6435
13058,7,20,false,5,2,-3,41.91059,-87.64942
TA1307000038,7,20,false,4,6,2,41.91138,-87.63868
LF-005,7,20,false,48,34,-14,41.91172,-87.62681
13128,7,20,false,10,6,-4,41.91197,-87.63197
TA1308000050,7,20,false,22,28,6,41.91211,-87.6347
13243,7,20,false,10,5,-5,41.91262,-87.6814
TA1307000166,7,20,false,5,5,0,41.91386,-87.64877
15655,7,20,false,6,9,3,41.91401,-87.70514
18017,7,20,false,5,1,-4,41.91416,-87.71676
13068,7,20,false,3,5,2,41.91554,-87.68703
13179,7,20,false,20,18,-2,41.9157,-87.63461
13133,7,20,false,5,8,3,41.91598,-87.67733
15651,7,20,false,7,7,0,41.91752,-87.70181
TA1309000006,7,20,false,6,5,-1,41.91809,-87.64375
13146,7,20,false,7,16,9,41.91831,-87.63629
13059,7,20,false,8,8,0,41.91845,-87.65222
13192,7,20,false,11,9,-2,41.91995,-87.64884
13288,7,20,false,3,6,3,41.92008,-87.67788
TA1309000033,7,20,false,11,9,-2,41.92158,-87.65381
13193,7,20,false,12,13,1,41.92182,-87.64412
13191,7,20,false,2,6,4,41.92217,-87.63891
13084,7,20,false,5,3,-2,41.92268,-87.69715
LP-,7,20,false,15,13,-2,41.92396,-87.63584
15648,7,20,false,5,13,8,41.92464,-87.68931
TA1307000001,7,20,false,8,3,-5,41.92535,-87.66581
TA1309000019,7,20,false,7,10,3,41.92586,-87.63897
TA1309000058,7,20,false,5,7,2,41.92591,-87.64927
TA1308000001,7,20,false,34,39,5,41.92627,-87.63086
13124,7,20,false,4,5,1,41.92675,-87.63444
TA1309000023,7,20,false,7,7,0,41.9287,-87.65383
TA1307000113,7,20,false,9,5,-4,41.92878,-87.66391
TA1309000059,7,20,false,3,5,2,41.92889,-87.65898
TA1309000061,7,20,false,13,6,-7,41.92915,-87.64909
TA1305000014,7,20,false,9,20,11,41.92956,-87.64313
13085,7,20,false,4,8,4,41.92958,-87.70789
TA1307000142,7,20,false,12,10,-2,41.93125,-87.64432
13276,7,20,false,9,20,11,41.93132,-87.63874
TA1306000014,7,20,false,11,6,-5,41.93242,-87.65271
TA1309000039,7,20,false,18,11,-7,41.93258,-87.63642
TA1309000036,7,20,false,6,13,7,41.93313,-87.64776
15644,7,20,false,1,7,6,41.93534,-87.71687
TA1307000006,7,20,false,4,7,3,41.93571,-87.6636
13268,7,20,false,3,9,6,41.93588,-87.67843
TA1307000052,7,20,false,7,4,-3,41.93628,-87.65266
TA1307000136,7,20,false,2,7,5,41.9365,-87.64755
TA1307000041,7,20,false,14,19,5,41.93669,-87.63683
13137,7,20,false,9,14,5,41.9376,-87.6441
15642,7,20,false,6,2,-4,41.93843,-87.69801
TA1309000042,7,20,false,3,7,4,41.93937,-87.66836
13229,7,20,false,4,9,5,41.93946,-87.66376
TA1308000019,7,20,false,4,5,1,41.93973,-87.65886
TA1307000134,7,20,false,17,13,-4,41.94016,-87.65303
TA1309000049,7,20,false,7,28,21,41.94077,-87.63919
TA1307000138,7,20,false,2,8,6,41.94334,-87.67094
TA1309000025,7,20,false,20,18,-2,41.94368,-87.64894
13071,7,20,false,6,5,-1,41.94373,-87.66401
632,7,20,false,22,9,-13,41.94453,-87.6547
13278,7,20,false,3,7,4,41.94553,-87.64644
13235,7,20,false,9,5,-4,41.94814,-87.66396
13325,7,20,false,22,18,-4,41.94907,-87.64863
TA1307000126,7,20,false,34,27,-7,41.94936,-87.65451
TA1307000150,7,20,false,9,7,-2,41.94945,-87.64646
TA1307000127,7,20,false,16,14,-2,41.9508,-87.65918
13063,7,20,false,9,10,1,41.95424,-87.65441
TA1308000022,7,20,false,13,13,0,41.95438,-87.64805
TA1309000026,7,20,false,1,6,5,41.95601,-87.6802
13379,7,20,false,5,2,-3,41.95786,-87.6495
TA1309000027,7,20,false,5,5,0,41.9585,-87.65499
13389,7,20,false,16,9,-7,41.961,-87.64958
TA1307000107,7,20,false,7,14,7,41.96164,-87.65464
TA1308000012,7,20,false,9,11,2,41.96398,-87.63818
639,7,20,false,6,4,-2,41.96584,-87.64538
TA1309000014,7,20,false,5,4,-1,41.96709,-87.66744
TA1307000119,7,20,false,6,13,7,41.96796,-87.65
TA1309000066,7,20,false,7,1,-6,41.9691,-87.67423
TA1309000041,7,20,false,5,3,-2,41.96951,-87.65471
KA1504000171,7,20,false,4,8,4,41.97161,-87.65016
TA1309000035,7,20,false,5,1,-4,41.97335,-87.66785
13108,7,20,false,9,9,0,41.97379,-87.65971
KA1504000146,7,20,false,8,8,0,41.978,-87.66805
13109,7,20,false,6,11,5,41.97835,-87.65976
KA1504000152,7,20,false,6,16,10,41.98403,-87.65231
15571,7,20,false,1,7,6,41.99478,-87.66028
KA1504000159,7,20,false,7,3,-4,42.01059,-87.66241
523,7,20,false,6,7,1,42.02089,-87.66505
E002,7,20,false,5,8,3,42.03256,-87.67912
596,7,20,false,5,3,-2,42.04822,-87.68348
KA1503000074,7,20,true,2,5,3,41.79174,-87.58395
TA1308000009,7,20,true,11,10,-1,41.79522,-87.58075
KA1503000052,7,20,true,1,5,4,41.79935,-87.60097
13217,7,20,true,4,7,3,41.83488,-87.61792
13215,7,20,true,2,5,3,41.83634,-87.6135
KA1503000038,7,20,true,1,12,11,41.83845,-87.6354
TA1307000048,7,20,true,14,11,-3,41.83855,-87.60821
TA1307000139,7,20,true,5,8,3,41.84205,-87.61698
TA1305000001,7,20,true,5,2,-3,41.85262,-87.6265
13075,7,20,true,6,9,3,41.8531,-87.63192
15545,7,20,true,16,15,-1,41.85627,-87.61334
SL-012,7,20,true,4,8,4,41.86038,-87.62581
TA1309000001,7,20,true,5,1,-4,41.86488,-87.64708
13431,7,20,true,11,9,-2,41.8661,-87.60728
TA1305000002,7,20,true,13,18,5,41.86721,-87.62597
15544,7,20,true,7,7,0,41.86723,-87.61536
SL-005,7,20,true,6,14,8,41.8679,-87.62304
644,7,20,true,4,5,1,41.86859,-87.68625
13160,7,20,true,4,6,2,41.86947,-87.65548
TA1307000130,7,20,true,9,6,-3,41.87178,-87.65103
SL-008,7,20,true,7,9,2,41.87209,-87.62956
SL-011,7,20,true,7,10,3,41.87256,-87.63356
TA1306000025,7,20,true,4,8,4,41.87464,-87.65703
15668,7,20,true,2,5,3,41.87471,-87.68642
13028,7,20,true,2,5,3,41.87475,-87.64981
13158,7,20,true,5,14,9,41.87764,-87.64957
13157,7,20,true,6,7,1,41.87773,-87.6548
TA1305000025,7,20,true,8,4,-4,41.87773,-87.63528
KA1503000015,7,20,true,1,5,4,41.87948,-87.6257
WL-011,7,20,true,5,7,2,41.88034,-87.64273
13300,7,20,true,27,21,-6,41.88097,-87.61675
13008,7,20,true,12,5,-7,41.88105,-87.62408
TA1307000120,7,20,true,6,7,1,41.88188,-87.64879
13341,7,20,true,7,5,-2,41.88208,-87.63985
TA1305000032,7,20,true,4,8,4,41.88218,-87.64109
13409,7,20,true,4,10,6,41.8831,-87.6511
13053,7,20,true,8,8,0,41.88365,-87.64863
TA1306000010,7,20,true,4,5,1,41.88419,-87.62961
TA1305000030,7,20,true,5,1,-4,41.88459,-87.63178
15535,7,20,true,1,6,5,41.8846,-87.64455
TA1305000029,7,20,true,6,10,4,41.88466,-87.62787
13263,7,20,true,10,8,-2,41.88467,-87.61952
TA1306000015,7,20,true,6,9,3,41.88549,-87.65232
13021,7,20,true,8,6,-2,41.88559,-87.64184
TA1307000111,7,20,true,8,2,-6,41.88582,-87.63548
KA1503000012,7,20,true,6,4,-2,41.88599,-87.63089
TA1308000029,7,20,true,1,6,5,41.88673,-87.62225
TA1307000131,7,20,true,5,1,-4,41.88688,-87.62606
KA1503000064,7,20,true,11,8,-3,41.88697,-87.61281
TA1305000022,7,20,true,1,6,5,41.88817,-87.63656
TA1306000003,7,20,true,9,12,3,41.88867,-87.64442
KA1503000043,7,20,true,12,13,1,41.88918,-87.63851
13050,7,20,true,2,7,5,41.88919,-87.62775
TA1307000151,7,20,true,6,8,2,41.88993,-87.63427
636,7,20,true,2,7,5,41.88997,-87.63662
13427,7,20,true,5,4,-1,41.89054,-87.62205
13430,7,20,true,11,4,-7,41.89077,-87.63169
TA1306000013,7,20,true,6,9,3,41.89083,-87.61852
TA1307000117,7,20,true,11,5,-6,41.89144,-87.62675
13033,7,20,true,12,13,1,41.8916,-87.64835
13194,7,20,true,2,7,5,41.8918,-87.65878
TA1305000003,7,20,true,12,13,1,41.89187,-87.62061
13022,7,20,true,18,18,0,41.89227,-87.61205
TA1306000029,7,20,true,5,15,10,41.89256,-87.61449
13265,7,20,true,8,18,10,41.89383,-87.64172
13045,7,20,true,14,15,1,41.89403,-87.62931
13016,7,20,true,9,8,-1,41.89431,-87.62277
KA1503000041,7,20,true,2,12,10,41.89452,-87.61798
13196,7,20,true,4,5,1,41.89455,-87.65345
TA1306000012,7,20,true,6,10,4,41.89475,-87.63438
KP1705001026,7,20,true,7,6,-1,41.89483,-87.6323
13132,7,20,true,2,6,4,41.89573,-87.67718
15530,7,20,true,6,8,2,41.89575,-87.62596
TA1305000020,7,20,true,10,5,-5,41.89636,-87.65406
13303,7,20,true,4,5,1,41.89672,-87.63088
13338,7,20,true,13,4,-9,41.89697,-87.62173
TA1307000061,7,20,true,6,6,0,41.89745,-87.62873
620,7,20,true,4,7,3,41.89817,-87.63754
15529,7,20,true,4,6,2,41.89858,-87.62206
TA1307000128,7,20,true,6,11,5,41.89896,-87.6299
13248,7,20,true,1,5,4,41.89964,-87.66788
17660,7,20,true,2,5,3,41.90036,-87.69671
13290,7,20,true,1,5,4,41.90069,-87.66259
13042,7,20,true,8,9,1,41.90097,-87.62377
KA1504000133,7,20,true,10,12,2,41.90234,-87.62773
TA1307000039,7,20,true,14,12,-2,41.90294,-87.63137
KA1504000135,7,20,true,18,16,-2,41.90319,-87.63439
KA1504000079,7,20,true,4,8,4,41.9035,-87.64334
TA1308000049,7,20,true,4,5,1,41.90672,-87.6349
KA1504000134,7,20,true,7,7,0,41.90687,-87.6262
TA1307000143,7,20,true,5,4,-1,41.90762,-87.63854
13221,7,20,true,5,11,6,41.90765,-87.67254
TA1309000024,7,20,true,12,9,-3,41.908,-87.63152
TA1305000041,7,20,true,6,8,2,41.9094,-87.67769
331,7,20,true,7,3,-4,41.90965,-87.64812
TA1305000037,7,20,true,7,4,-3,41.91018,-87.67003
TA1306000008,7,20,true,6,4,-2,41.9102,-87.6435
13258,7,20,true,6,1,-5,41.91043,-87.69718
13257,7,20,true,5,3,-2,41.91054,-87.68956
13154,7,20,true,5,1,-4,41.91054,-87.65312
TA1307000038,7,20,true,4,7,3,41.91138,-87.63868
LF-005,7,20,true,24,15,-9,41.91172,-87.62681
13128,7,20,true,10,4,-6,41.91197,-87.63197
TA1308000050,7,20,true,19,8,-11,41.91211,-87.6347
13243,7,20,true,6,3,-3,41.91262,-87.6814
TA1306000032,7,20,true,6,2,-4,41.9137,-87.65285
TA1307000166,7,20,true,7,9,2,41.91386,-87.64877
13179,7,20,true,6,13,7,41.9157,-87.63461
13133,7,20,true,6,8,2,41.91598,-87.67733
TA1305000039,7,20,true,6,2,-4,41.9163,-87.66749
15651,7,20,true,4,10,6,41.91752,-87.70181
13146,7,20,true,8,7,-1,41.91831,-87.63629
13059,7,20,true,6,7,1,41.91845,-87.65222
13259,7,20,true,3,5,2,41.91852,-87.69744
13192,7,20,true,2,5,3,41.91995,-87.64884
TA1309000033,7,20,true,7,5,-2,41.92158,-87.65381
13193,7,20,true,12,15,3,41.92182,-87.64412
13191,7,20,true,6,5,-1,41.92217,-87.63891
TA1307000001,7,20,true,2,8,6,41.92535,-87.66581
TA1306000026,7,20,true,7,6,-1,41.92558,-87.65842
TA1306000016,7,20,true,6,2,-4,41.9256,-87.65371
TA1309000019,7,20,true,6,16,10,41.92586,-87.63897
TA1309000058,7,20,true,9,8,-1,41.92591,-87.64927
TA1308000001,7,20,true,25,15,-10,41.92627,-87.63086
TA1309000061,7,20,true,10,8,-2,41.92915,-87.64909
TA1305000014,7,20,true,13,10,-3,41.92956,-87.64313
13085,7,20,true,5,8,3,41.92958,-87.70789
TA1307000142,7,20,true,7,19,12,41.93125,-87.64432
13276,7,20,true,6,7,1,41.93132,-87.63874
TA1307000064,7,20,true,3,6,3,41.93222,-87.65864
TA1306000014,7,20,true,10,11,1,41.93242,-87.65271
TA1309000039,7,20,true,10,16,6,41.93258,-87.63642
TA1309000036,7,20,true,10,17,7,41.93313,-87.64776
TA1307000136,7,20,true,12,9,-3,41.9365,-87.64755
TA1307000041,7,20,true,18,12,-6,41.93669,-87.63683
13137,7,20,true,13,11,-2,41.9376,-87.6441
TA1309000042,7,20,true,7,5,-2,41.93937,-87.66836
13229,7,20,true,1,6,5,41.93946,-87.66376
TA1308000019,7,20,true,3,12,9,41.93973,-87.65886
13277,7,20,true,6,6,0,41.9401,-87.64546
TA1307000134,7,20,true,13,18,5,41.94016,-87.65303
TA1309000049,7,20,true,14,10,-4,41.94077,-87.63919
TA1309000025,7,20,true,14,12,-2,41.94368,-87.64894
13071,7,20,true,3,8,5,41.94373,-87.66401
632,7,20,true,8,10,2,41.94453,-87.6547
13278,7,20,true,11,13,2,41.94553,-87.64644
13235,7,20,true,5,8,3,41.94814,-87.66396
13253,7,20,true,2,5,3,41.9488,-87.67527
13325,7,20,true,6,9,3,41.94907,-87.64863
TA1307000126,7,20,true,24,11,-13,41.94936,-87.65451
TA1307000150,7,20,true,10,8,-2,41.94945,-87.64646
TA1307000127,7,20,true,12,6,-6,41.9508,-87.65918
13323,7,20,true,5,1,-4,41.95282,-87.65
13063,7,20,true,1,5,4,41.95424,-87.65441
TA1308000022,7,20,true,5,8,3,41.95438,-87.64805
13379,7,20,true,6,8,2,41.95786,-87.6495
13389,7,20,true,7,2,-5,41.961,-87.64958
15623,7,20,true,1,5,4,41.96154,-87.69117
TA1307000107,7,20,true,7,13,6,41.96164,-87.65464
TA1308000012,7,20,true,8,7,-1,41.96398,-87.63818
13074,7,20,true,7,5,-2,41.96521,-87.6582
TA1307000140,7,20,true,5,1,-4,41.96643,-87.68865
TA1307000158,7,20,true,6,3,-3,41.9671,-87.67904
KA1504000080,7,20,true,4,10,6,41.96887,-87.69609
TA1309000066,7,20,true,4,5,1,41.9691,-87.67423
KA1504000171,7,20,true,4,6,2,41.97161,-87.65016
TA1309000035,7,20,true,2,5,3,41.97335,-87.66785
13108,7,20,true,6,3,-3,41.97379,-87.65971
KA1504000146,7,20,true,6,3,-3,41.978,-87.66805
13109,7,20,true,7,4,-3,41.97835,-87.65976
KA1504000152,7,20,true,5,11,6,41.98403,-87.65231
KA1503000014,7,21,false,5,5,0,41.7851,-87.60108
TA1309000063,7,21,false,1,5,4,41.79325,-87.5878
TA1308000009,7,21,false,5,3,-2,41.79522,-87.58075
KA1503000052,7,21,false,5,6,1,41.79935,-87.60097
KA1503000059,7,21,false,3,13,10,41.79952,-87.58643
KA1503000007,7,21,false,3,16,13,41.80242,-87.58689
KA1503000004,7,21,false,1,9,8,41.83127,-87.6088
TA1307000048,7,21,false,16,16,0,41.83855,-87.60821
13075,7,21,false,6,3,-3,41.8531,-87.63192
15545,7,21,false,8,9,1,41.85627,-87.61334
SL-012,7,21,false,2,5,3,41.86038,-87.62581
TA1307000124,7,21,false,4,9,5,41.86411,-87.62372
13431,7,21,false,12,19,7,41.8661,-87.60728
TA1305000002,7,21,false,8,12,4,41.86721,-87.62597
15544,7,21,false,6,10,4,41.86723,-87.61536
SL-005,7,21,false,21,20,-1,41.8679,-87.62304
TA1309000010,7,21,false,3,7,4,41.87074,-87.62574
SL-009,7,21,false,3,5,2,41.87081,-87.63121
SL-008,7,21,false,3,11,8,41.87209,-87.62956
SL-011,7,21,false,7,5,-2,41.87256,-87.63356
623,7,21,false,7,22,15,41.87272,-87.62399
SL-007,7,21,false,11,19,8,41.87404,-87.6277
SL-010,7,21,false,2,9,7,41.87501,-87.63309
15541,7,21,false,19,27,8,41.8758,-87.62086
TA1305000010,7,21,false,6,11,5,41.87623,-87.62444
624,7,21,false,4,6,2,41.87626,-87.62923
TA1309000002,7,21,false,9,15,6,41.87784,-87.62408
13011,7,21,false,13,8,-5,41.87931,-87.63993
KA1503000034,7,21,false,6,2,-4,41.87938,-87.63197
KA1503000015,7,21,false,5,5,0,41.87948,-87.6257
WL-011,7,21,false,3,15,12,41.88034,-87.64273
13300,7,21,false,43,40,-3,41.88097,-87.61675
13008,7,21,false,30,51,21,41.88105,-87.62408
TA1305000006,7,21,false,3,16,13,41.88122,-87.6296
TA1307000120,7,21,false,4,9,5,41.88188,-87.64879
13036,7,21,false,7,10,3,41.8821,-87.62513
TA1305000032,7,21,false,6,12,6,41.88218,-87.64109
13006,7,21,false,6,5,-1,41.88268,-87.63252
13053,7,21,false,9,15,6,41.88365,-87.64863
13001,7,21,false,20,8,-12,41.88397,-87.62459
TA1306000010,7,21,false,8,6,-2,41.88419,-87.62961
TA1305000030,7,21,false,3,5,2,41.88459,-87.63178
15535,7,21,false,2,6,4,41.8846,-87.64455
TA1305000029,7,21,false,8,9,1,41.88466,-87.62787
13263,7,21,false,7,17,10,41.88467,-87.61952
TA1306000015,7,21,false,6,8,2,41.88549,-87.65232
13021,7,21,false,2,9,7,41.88559,-87.64184
TA1307000111,7,21,false,8,17,9,41.88582,-87.63548
KA1503000012,7,21,false,8,6,-2,41.88599,-87.63089
TA1305000011,7,21,false,26,42,16,41.886,-87.62418
15534,7,21,false,11,13,2,41.88627,-87.61749
TA1308000029,7,21,false,13,14,1,41.88673,-87.62225
TA1307000131,7,21,false,22,15,-7,41.88688,-87.62606
KA1503000064,7,21,false,10,20,10,41.88697,-87.61281
TA1305000022,7,21,false,10,7,-3,41.88817,-87.63656
TA1306000003,7,21,false,10,7,-3,41.88867,-87.64442
KA1503000043,7,21,false,6,5,-1,41.88918,-87.63851
13050,7,21,false,5,10,5,41.88919,-87.62775
TA1307000151,7,21,false,9,6,-3,41.88993,-87.63427
KA1503000044,7,21,false,7,7,0,41.89018,-87.6262
13430,7,21,false,23,8,-15,41.89077,-87.63169
TA1306000013,7,21,false,30,17,-13,41.89083,-87.61852
RN-,7,21,false,9,6,-3,41.89102,-87.63546
13434,7,21,false,8,8,0,41.89108,-87.66663
TA1307000117,7,21,false,14,19,5,41.89144,-87.62675
13033,7,21,false,10,4,-6,41.8916,-87.64835
TA1305000003,7,21,false,24,14,-10,41.89187,-87.62061
13022,7,21,false,69,71,2,41.89227,-87.61205
TA1306000029,7,21,false,22,11,-11,41.89256,-87.61449
13265,7,21,false,4,11,7,41.89383,-87.64172
13045,7,21,false,13,11,-2,41.89403,-87.62931
13016,7,21,false,7,14,7,41.89431,-87.62277
KA1503000041,7,21,false,10,14,4,41.89452,-87.61798
13196,7,21,false,6,4,-2,41.89455,-87.65345
TA1306000012,7,21,false,4,17,13,41.89475,-87.63438
KP1705001026,7,21,false,5,2,-3,41.89483,-87.6323
15530,7,21,false,4,6,2,41.89575,-87.62596
13303,7,21,false,5,10,5,41.89672,-87.63088
13338,7,21,false,15,11,-4,41.89697,-87.62173
13034,7,21,false,6,1,-5,41.89754,-87.62352
15529,7,21,false,10,5,-5,41.89858,-87.62206
TA1307000128,7,21,false,5,6,1,41.89896,-87.6299
657,7,21,false,5,2,-3,41.89918,-87.6722
13042,7,21,false,31,23,-8,41.90097,-87.62377
TA1307000070,7,21,false,1,6,5,41.90133,-87.67742
KA1504000133,7,21,false,13,12,-1,41.90234,-87.62773
TA1307000039,7,21,false,9,20,11,41.90294,-87.63137
TA1305000034,7,21,false,9,8,-1,41.90313,-87.67391
KA1504000135,7,21,false,9,14,5,41.90319,-87.63439
13061,7,21,false,11,10,-1,41.90342,-87.66779
TA1308000049,7,21,false,17,9,-8,41.90672,-87.6349
13224,7,21,false,2,5,3,41.90706,-87.66725
13221,7,21,false,3,5,2,41.90765,-87.67254
TA1309000024,7,21,false,6,12,6,41.908,-87.63152
TA1305000041,7,21,false,5,11,6,41.9094,-87.67769
TA1305000037,7,21,false,5,2,-3,41.91018,-87.67003
TA1308000005,7,21,false,1,5,4,41.91042,-87.68238
13258,7,21,false,1,5,4,41.91043,-87.69718
13257,7,21,false,3,6,3,41.91054,-87.68956
TA1307000038,7,21,false,3,5,2,41.91138,-87.63868
LF-005,7,21,false,13,11,-2,41.91172,-87.62681
TA1308000050,7,21,false,23,14,-9,41.91211,-87.6347
18017,7,21,false,1,6,5,41.91416,-87.71676
18067,7,21,false,2,8,6,41.9146,-87.66796
13179,7,21,false,11,17,6,41.9157,-87.63461
13133,7,21,false,4,17,13,41.91598,-87.67733
13146,7,21,false,12,4,-8,41.91831,-87.63629
13059,7,21,false,5,4,-1,41.91845,-87.65222
13192,7,21,false,11,6,-5,41.91995,-87.64884
TA1309000033,7,21,false,7,4,-3,41.92158,-87.65381
13193,7,21,false,7,12,5,41.92182,-87.64412
13191,7,21,false,7,8,1,41.92217,-87.63891
LP-,7,21,false,13,9,-4,41.92396,-87.63584
TA1307000001,7,21,false,3,5,2,41.92535,-87.66581
TA1306000026,7,21,false,6,2,-4,41.92558,-87.65842
TA1309000019,7,21,false,7,8,1,41.92586,-87.63897
TA1309000058,7,21,false,5,11,6,41.92591,-87.64927
TA1308000001,7,21,false,18,15,-3,41.92627,-87.63086
13124,7,21,false,5,14,9,41.92675,-87.63444
TA1309000023,7,21,false,6,5,-1,41.9287,-87.65383
TA1307000113,7,21,false,7,5,-2,41.92878,-87.66391
13296,7,21,false,1,7,6,41.92883,-87.66852
TA1309000061,7,21,false,8,4,-4,41.92915,-87.64909
TA1305000014,7,21,false,4,10,6,41.92956,-87.64313
13085,7,21,false,3,8,5,41.92958,-87.70789
TA1307000142,7,21,false,20,5,-15,41.93125,-87.64432
TA1306000014,7,21,false,7,13,6,41.93242,-87.65271
TA1309000039,7,21,false,9,17,8,41.93258,-87.63642
TA1309000036,7,21,false,11,7,-4,41.93313,-87.64776
15644,7,21,false,1,5,4,41.93534,-87.71687
TA1307000006,7,21,false,5,5,0,41.93571,-87.6636
13268,7,21,false,1,7,6,41.93588,-87.67843
TA1307000052,7,21,false,4,5,1,41.93628,-87.65266
TA1307000136,7,21,false,12,5,-7,41.9365,-87.64755
13137,7,21,false,7,9,2,41.9376,-87.6441
13229,7,21,false,9,3,-6,41.93946,-87.66376
TA1308000019,7,21,false,9,5,-4,41.93973,-87.65886
13277,7,21,false,10,15,5,41.9401,-87.64546
TA1307000134,7,21,false,27,19,-8,41.94016,-87.65303
TA1309000049,7,21,false,10,9,-1,41.94077,-87.63919
TA1309000025,7,21,false,19,18,-1,41.94368,-87.64894
13071,7,21,false,13,7,-6,41.94373,-87.66401
632,7,21,false,8,9,1,41.94453,-87.6547
13278,7,21,false,16,14,-2,41.94553,-87.64644
13235,7,21,false,12,7,-5,41.94814,-87.66396
13325,7,21,false,9,11,2,41.94907,-87.64863
TA1307000126,7,21,false,26,4,-22,41.94936,-87.65451
TA1307000150,7,21,false,3,5,2,41.94945,-87.64646
13319,7,21,false,7,3,-4,41.95069,-87.6687
TA1307000127,7,21,false,16,8,-8,41.9508,-87.65918
13323,7,21,false,5,1,-4,41.95282,-87.65
13063,7,21,false,4,9,5,41.95424,-87.65441
TA1308000022,7,21,false,8,11,3,41.95438,-87.64805
13389,7,21,false,4,16,12,41.961,-87.64958
TA1307000107,7,21,false,5,10,5,41.96164,-87.65464
TA1307000156,7,21,false,4,5,1,41.96301,-87.68479
TA1308000012,7,21,false,7,12,5,41.96398,-87.63818
KA1504000171,7,21,false,3,5,2,41.97161,-87.65016
TA1309000035,7,21,false,3,7,4,41.97335,-87.66785
13108,7,21,false,4,5,1,41.97379,-87.65971
KA1504000146,7,21,false,2,7,5,41.978,-87.66805
13109,7,21,false,7,3,-4,41.97835,-87.65976
KA1504000152,7,21,false,7,8,1,41.98403,-87.65231
KA1503000007,7,21,true,2,9,7,41.80242,-87.58689
TA1308000045,7,21,true,2,5,3,41.83062,-87.64129
13217,7,21,true,2,7,5,41.83488,-87.61792
TA1307000048,7,21,true,6,5,-1,41.83855,-87.60821
TA1307000139,7,21,true,1,5,4,41.84205,-87.61698
TA1305000002,7,21,true,8,8,0,41.86721,-87.62597
SL-005,7,21,true,5,4,-1,41.8679,-87.62304
SL-009,7,21,true,2,9,7,41.87081,-87.63121
TA1307000130,7,21,true,4,7,3,41.87178,-87.65103
SL-008,7,21,true,6,6,0,41.87209,-87.62956
13332,7,21,true,7,13,6,41.87219,-87.6615
13028,7,21,true,7,4,-3,41.87475,-87.64981
SL-010,7,21,true,3,5,2,41.87501,-87.63309
TA1305000035,7,21,true,5,2,-3,41.87716,-87.62787
15539,7,21,true,5,3,-2,41.87763,-87.64405
13158,7,21,true,4,11,7,41.87764,-87.64957
KA1503000015,7,21,true,5,2,-3,41.87948,-87.6257
13156,7,21,true,2,6,4,41.88042,-87.65554
13008,7,21,true,9,4,-5,41.88105,-87.62408
TA1307000120,7,21,true,8,7,-1,41.88188,-87.64879
TA1305000032,7,21,true,1,10,9,41.88218,-87.64109
13053,7,21,true,10,6,-4,41.88365,-87.64863
13001,7,21,true,1,8,7,41.88397,-87.62459
18062,7,21,true,5,1,-4,41.88412,-87.65427
TA1306000010,7,21,true,4,6,2,41.88419,-87.62961
TA1305000029,7,21,true,4,7,3,41.88466,-87.62787
13263,7,21,true,3,5,2,41.88467,-87.61952
TA1306000015,7,21,true,6,5,-1,41.88549,-87.65232
13021,7,21,true,5,2,-3,41.88559,-87.64184
TA1307000111,7,21,true,2,7,5,41.88582,-87.63548
15534,7,21,true,2,9,7,41.88627,-87.61749
TA1305000022,7,21,true,8,7,-1,41.88817,-87.63656
TA1306000003,7,21,true,7,11,4,41.88867,-87.64442
KA1503000043,7,21,true,3,7,4,41.88918,-87.63851
13050,7,21,true,7,4,-3,41.88919,-87.62775
TA1307000151,7,21,true,5,3,-2,41.88993,-87.63427
KA1503000044,7,21,true,6,4,-2,41.89018,-87.6262
TA1306000013,7,21,true,2,5,3,41.89083,-87.61852
RN-,7,21,true,5,7,2,41.89102,-87.63546
TA1307000117,7,21,true,5,5,0,41.89144,-87.62675
13194,7,21,true,6,5,-1,41.8918,-87.65878
TA1305000003,7,21,true,7,8,1,41.89187,-87.62061
13022,7,21,true,12,8,-4,41.89227,-87.61205
TA1306000029,7,21,true,5,6,1,41.89256,-87.61449
13265,7,21,true,7,11,4,41.89383,-87.64172
13045,7,21,true,8,13,5,41.89403,-87.62931
KA1503000041,7,21,true,3,5,2,41.89452,-87.61798
TA1306000012,7,21,true,12,23,11,41.89475,-87.63438
18058,7,21,true,4,6,2,41.8955,-87.68201
TA1305000020,7,21,true,7,8,1,41.89636,-87.65406
13303,7,21,true,4,5,1,41.89672,-87.63088
13338,7,21,true,2,5,3,41.89697,-87.62173
TA1307000061,7,21,true,2,7,5,41.89745,-87.62873
15529,7,21,true,4,7,3,41.89858,-87.62206
TA1307000128,7,21,true,9,3,-6,41.89896,-87.6299
13248,7,21,true,5,2,-3,41.89964,-87.66788
13290,7,21,true,3,5,2,41.90069,-87.66259
13042,7,21,true,13,10,-3,41.90097,-87.62377
KA1504000133,7,21,true,3,5,2,41.90234,-87.62773
TA1307000039,7,21,true,9,13,4,41.90294,-87.63137
TA1305000034,7,21,true,1,5,4,41.90313,-87.67391
KA1504000135,7,21,true,14,6,-8,41.90319,-87.63439
13061,7,21,true,8,11,3,41.90342,-87.66779
KA1504000079,7,21,true,2,5,3,41.9035,-87.64334
TA1308000049,7,21,true,11,10,-1,41.90672,-87.6349
13221,7,21,true,7,3,-4,41.90765,-87.67254
TA1309000024,7,21,true,5,7,2,41.908,-87.63152
TA1305000041,7,21,true,3,7,4,41.9094,-87.67769
TA1306000008,7,21,true,1,7,6,41.9102,-87.6435
TA1307000038,7,21,true,8,1,-7,41.91138,-87.63868
LF-005,7,21,true,14,8,-6,41.91172,-87.62681
13128,7,21,true,5,2,-3,41.91197,-87.63197
TA1308000050,7,21,true,11,23,12,41.91211,-87.6347
TA1306000007,7,21,true,6,1,-5,41.91469,-87.64333
13179,7,21,true,10,11,1,41.9157,-87.63461
13146,7,21,true,10,7,-3,41.91831,-87.63629
13059,7,21,true,14,9,-5,41.91845,-87.65222
TA1309000033,7,21,true,6,2,-4,41.92158,-87.65381
13193,7,21,true,9,20,11,41.92182,-87.64412
13191,7,21,true,5,5,0,41.92217,-87.63891
TA1306000026,7,21,true,5,13,8,41.92558,-87.65842
TA1309000019,7,21,true,2,5,3,41.92586,-87.63897
TA1309000058,7,21,true,9,3,-6,41.92591,-87.64927
TA1308000001,7,21,true,8,5,-3,41.92627,-87.63086
TA1309000023,7,21,true,5,4,-1,41.9287,-87.65383
TA1307000113,7,21,true,2,8,6,41.92878,-87.66391
TA1309000061,7,21,true,4,9,5,41.92915,-87.64909
TA1305000014,7,21,true,12,7,-5,41.92956,-87.64313
13085,7,21,true,5,2,-3,41.92958,-87.70789
TA1307000142,7,21,true,10,13,3,41.93125,-87.64432
TA1307000064,7,21,true,3,5,2,41.93222,-87.65864
TA1306000014,7,21,true,6,6,0,41.93242,-87.65271
13294,7,21,true,3,5,2,41.9326,-87.66595
TA1307000052,7,21,true,4,11,7,41.93628,-87.65266
TA1307000136,7,21,true,7,10,3,41.9365,-87.64755
13137,7,21,true,5,5,0,41.9376,-87.6441
TA1309000042,7,21,true,5,1,-4,41.93937,-87.66836
13229,7,21,true,6,2,-4,41.93946,-87.66376
TA1308000019,7,21,true,9,4,-5,41.93973,-87.65886
13277,7,21,true,5,2,-3,41.9401,-87.64546
TA1307000134,7,21,true,11,7,-4,41.94016,-87.65303
TA1309000025,7,21,true,14,9,-5,41.94368,-87.64894
13071,7,21,true,4,5,1,41.94373,-87.66401
632,7,21,true,1,6,5,41.94453,-87.6547
13278,7,21,true,8,13,5,41.94553,-87.64644
13235,7,21,true,7,7,0,41.94814,-87.66396
TA1307000126,7,21,true,17,3,-14,41.94936,-87.65451
TA1307000127,7,21,true,6,6,0,41.9508,-87.65918
13323,7,21,true,3,6,3,41.95282,-87.65
TA1308000022,7,21,true,4,5,1,41.95438,-87.64805
TA1309000027,7,21,true,1,8,7,41.9585,-87.65499
13389,7,21,true,2,12,10,41.961,-87.64958
TA1307000107,7,21,true,12,4,-8,41.96164,-87.65464
TA1309000014,7,21,true,6,6,0,41.96709,-87.66744
KA1504000080,7,21,true,5,7,2,41.96887,-87.69609
TA1309000035,7,21,true,6,3,-3,41.97335,-87.66785
KA1504000146,7,21,true,5,7,2,41.978,-87.66805
13109,7,21,true,5,4,-1,41.97835,-87.65976
KA1504000152,7,21,true,2,5,3,41.98403,-87.65231
KA1503000014,7,22,false,2,8,6,41.7851,-87.60108
TA1308000009,7,22,false,6,2,-4,41.79522,-87.58075
KA1503000052,7,22,false,6,1,-5,41.79935,-87.60097
KA1503000007,7,22,false,8,2,-6,41.80242,-87.58689
KA1503000004,7,22,false,10,6,-4,41.83127,-87.6088
TA1307000048,7,22,false,11,15,4,41.83855,-87.60821
SL-013,7,22,false,11,7,-4,41.85659,-87.62755
13150,7,22,false,2,5,3,41.85783,-87.62455
TA1307000159,7,22,false,2,6,4,41.8579,-87.6687
TA1307000124,7,22,false,1,10,9,41.86411,-87.62372
13431,7,22,false,11,5,-6,41.8661,-87.60728
TA1305000002,7,22,false,25,23,-2,41.86721,-87.62597
15544,7,22,false,3,5,2,41.86723,-87.61536
SL-005,7,22,false,16,17,1,41.8679,-87.62304
TA1309000010,7,22,false,2,11,9,41.87074,-87.62574
SL-008,7,22,false,2,5,3,41.87209,-87.62956
623,7,22,false,13,28,15,41.87272,-87.62399
SL-007,7,22,false,14,15,1,41.87404,-87.6277
13028,7,22,false,1,7,6,41.87475,-87.64981
15541,7,22,false,47,37,-10,41.8758,-87.62086
TA1305000010,7,22,false,12,13,1,41.87623,-87.62444
TA1305000035,7,22,false,3,8,5,41.87716,-87.62787
13158,7,22,false,1,9,8,41.87764,-87.64957
TA1309000002,7,22,false,3,7,4,41.87784,-87.62408
TA1309000008,7,22,false,11,6,-5,41.87933,-87.6355
KA1503000015,7,22,false,7,1,-6,41.87948,-87.6257
13300,7,22,false,23,34,11,41.88097,-87.61675
13008,7,22,false,41,31,-10,41.88105,-87.62408
TA1305000006,7,22,false,13,9,-4,41.88122,-87.6296
TA1307000120,7,22,false,3,12,9,41.88188,-87.64879
13036,7,22,false,9,6,-3,41.8821,-87.62513
TA1305000032,7,22,false,14,12,-2,41.88218,-87.64109
13353,7,22,false,6,5,-1,41.88283,-87.6612
WL-012,7,22,false,5,3,-2,41.88337,-87.6412
13053,7,22,false,23,2,-21,41.88365,-87.64863
13001,7,22,false,17,11,-6,41.88397,-87.62459
TA1306000010,7,22,false,6,2,-4,41.88419,-87.62961
TA1305000030,7,22,false,9,8,-1,41.88459,-87.63178
15535,7,22,false,7,5,-2,41.8846,-87.64455
TA1305000029,7,22,false,13,9,-4,41.88466,-87.62787
13263,7,22,false,10,8,-2,41.88467,-87.61952
13021,7,22,false,9,6,-3,41.88559,-87.64184
KA1503000012,7,22,false,5,2,-3,41.88599,-87.63089
TA1305000011,7,22,false,47,22,-25,41.886,-87.62418
15534,7,22,false,11,8,-3,41.88627,-87.61749
TA1308000029,7,22,false,25,21,-4,41.88673,-87.62225
TA1307000131,7,22,false,12,16,4,41.88688,-87.62606
KA1503000064,7,22,false,8,6,-2,41.88697,-87.61281
TA1306000003,7,22,false,4,11,7,41.88867,-87.64442
13050,7,22,false,22,9,-13,41.88919,-87.62775
KA1503000044,7,22,false,3,6,3,41.89018,-87.6262
13427,7,22,false,10,4,-6,41.89054,-87.62205
13430,7,22,false,16,12,-4,41.89077,-87.63169
TA1306000013,7,22,false,18,6,-12,41.89083,-87.61852
TA1307000117,7,22,false,24,28,4,41.89144,-87.62675
13033,7,22,false,4,6,2,41.8916,-87.64835
TA1305000003,7,22,false,14,16,2,41.89187,-87.62061
13022,7,22,false,21,26,5,41.89227,-87.61205
TA1306000029,7,22,false,9,8,-1,41.89256,-87.61449
13265,7,22,false,3,10,7,41.89383,-87.64172
13045,7,22,false,7,11,4,41.89403,-87.62931
13016,7,22,false,14,6,-8,41.89431,-87.62277
KA1503000041,7,22,false,9,13,4,41.89452,-87.61798
TA1306000012,7,22,false,12,13,1,41.89475,-87.63438
KP1705001026,7,22,false,15,10,-5,41.89483,-87.6323
TA1305000020,7,22,false,5,3,-2,41.89636,-87.65406
13303,7,22,false,7,6,-1,41.89672,-87.63088
13338,7,22,false,4,9,5,41.89697,-87.62173
13034,7,22,false,14,13,-1,41.89754,-87.62352
15529,7,22,false,1,9,8,41.89858,-87.62206
TA1307000128,7,22,false,6,7,1,41.89896,-87.6299
TA1306000011,7,22,false,4,5,1,41.89994,-87.63443
13042,7,22,false,24,33,9,41.90097,-87.62377
KA1504000133,7,22,false,13,18,5,41.90234,-87.62773
13241,7,22,false,4,5,1,41.9029,-87.68731
TA1307000039,7,22,false,6,4,-2,41.90294,-87.63137
KA1504000135,7,22,false,4,13,9,41.90319,-87.63439
13061,7,22,false,3,6,3,41.90342,-87.66779
KA1504000079,7,22,false,2,6,4,41.9035,-87.64334
TA1308000049,7,22,false,8,11,3,41.90672,-87.6349
KA1504000134,7,22,false,3,7,4,41.90687,-87.6262
13224,7,22,false,2,5,3,41.90706,-87.66725
13221,7,22,false,4,6,2,41.90765,-87.67254
TA1309000024,7,22,false,5,13,8,41.908,-87.63152
TA1305000041,7,22,false,7,3,-4,41.9094,-87.67769
TA1306000008,7,22,false,3,7,4,41.9102,-87.6435
13058,7,22,false,8,9,1,41.91059,-87.64942
LF-005,7,22,false,13,16,3,41.91172,-87.62681
13128,7,22,false,5,4,-1,41.91197,-87.63197
TA1308000050,7,22,false,17,17,0,41.91211,-87.6347
TA1307000166,7,22,false,5,1,-4,41.91386,-87.64877
13179,7,22,false,11,11,0,41.9157,-87.63461
13133,7,22,false,6,4,-2,41.91598,-87.67733
TA1309000006,7,22,false,9,4,-5,41.91809,-87.64375
13146,7,22,false,10,10,0,41.91831,-87.63629
13059,7,22,false,5,3,-2,41.91845,-87.65222
13192,7,22,false,7,5,-2,41.91995,-87.64884
TA1309000033,7,22,false,3,11,8,41.92158,-87.65381
13193,7,22,false,6,6,0,41.92182,-87.64412
TA1307000001,7,22,false,6,3,-3,41.92535,-87.66581
TA1306000026,7,22,false,3,6,3,41.92558,-87.65842
TA1309000019,7,22,false,13,6,-7,41.92586,-87.63897
TA1309000058,7,22,false,7,4,-3,41.92591,-87.64927
TA1308000001,7,22,false,6,17,11,41.92627,-87.63086
TA1305000014,7,22,false,1,9,8,41.92956,-87.64313
13085,7,22,false,6,3,-3,41.92958,-87.70789
TA1307000142,7,22,false,5,6,1,41.93125,-87.64432
TA1306000014,7,22,false,7,4,-3,41.93242,-87.65271
TA1309000039,7,22,false,8,8,0,41.93258,-87.63642
TA1307000052,7,22,false,15,6,-9,41.93628,-87.65266
13137,7,22,false,8,13,5,41.9376,-87.6441
13229,7,22,false,1,8,7,41.93946,-87.66376
TA1308000019,7,22,false,9,5,-4,41.93973,-87.65886
13277,7,22,false,9,6,-3,41.9401,-87.64546
TA1307000134,7,22,false,12,14,2,41.94016,-87.65303
TA1307000138,7,22,false,10,4,-6,41.94334,-87.67094
TA1309000025,7,22,false,10,8,-2,41.94368,-87.64894
13071,7,22,false,8,5,-3,41.94373,-87.66401
632,7,22,false,14,8,-6,41.94453,-87.6547
13278,7,22,false,9,9,0,41.94553,-87.64644
13235,7,22,false,12,11,-1,41.94814,-87.66396
13325,7,22,false,4,6,2,41.94907,-87.64863
TA1307000126,7,22,false,11,9,-2,41.94936,-87.65451
TA1307000127,7,22,false,2,6,4,41.9508,-87.65918
13323,7,22,false,5,4,-1,41.95282,-87.65
13063,7,22,false,6,3,-3,41.95424,-87.65441
TA1308000022,7,22,false,4,5,1,41.95438,-87.64805
13389,7,22,false,6,11,5,41.961,-87.64958
TA1307000119,7,22,false,2,6,4,41.96796,-87.65
TA1309000066,7,22,false,2,5,3,41.9691,-87.67423
KA1504000152,7,22,false,1,7,6,41.98403,-87.65231
13216,7,22,true,9,3,-6,41.83473,-87.62581
13217,7,22,true,1,6,5,41.83488,-87.61792
13150,7,22,true,1,5,4,41.85783,-87.62455
TA1305000002,7,22,true,9,7,-2,41.86721,-87.62597
SL-005,7,22,true,3,5,2,41.8679,-87.62304
644,7,22,true,2,5,3,41.86859,-87.68625
TA1309000010,7,22,true,7,3,-4,41.87074,-87.62574
SL-009,7,22,true,4,5,1,41.87081,-87.63121
TA1307000130,7,22,true,1,6,5,41.87178,-87.65103
SL-008,7,22,true,5,2,-3,41.87209,-87.62956
15541,7,22,true,8,1,-7,41.8758,-87.62086
13158,7,22,true,1,5,4,41.87764,-87.64957
TA1305000025,7,22,true,3,12,9,41.87773,-87.63528
13300,7,22,true,5,5,0,41.88097,-87.61675
13008,7,22,true,3,5,2,41.88105,-87.62408
TA1305000006,7,22,true,5,1,-4,41.88122,-87.6296
TA1307000120,7,22,true,6,2,-4,41.88188,-87.64879
TA1305000032,7,22,true,4,8,4,41.88218,-87.64109
13001,7,22,true,6,1,-5,41.88397,-87.62459
TA1306000003,7,22,true,7,10,3,41.88867,-87.64442
13050,7,22,true,11,5,-6,41.88919,-87.62775
13430,7,22,true,6,1,-5,41.89077,-87.63169
TA1306000013,7,22,true,8,5,-3,41.89083,-87.61852
RN-,7,22,true,3,5,2,41.89102,-87.63546
TA1307000117,7,22,true,6,4,-2,41.89144,-87.62675
13194,7,22,true,1,6,5,41.8918,-87.65878
TA1305000003,7,22,true,7,6,-1,41.89187,-87.62061
13265,7,22,true,5,6,1,41.89383,-87.64172
13045,7,22,true,4,9,5,41.89403,-87.62931
KA1503000041,7,22,true,2,5,3,41.89452,-87.61798
TA1306000012,7,22,true,7,5,-2,41.89475,-87.63438
13132,7,22,true,5,5,0,41.89573,-87.67718
13303,7,22,true,3,5,2,41.89672,-87.63088
TA1307000061,7,22,true,3,5,2,41.89745,-87.62873
620,7,22,true,2,5,3,41.89817,-87.63754
15529,7,22,true,6,5,-1,41.89858,-87.62206
TA1307000128,7,22,true,5,3,-2,41.89896,-87.6299
TA1307000039,7,22,true,8,7,-1,41.90294,-87.63137
KA1504000135,7,22,true,4,5,1,41.90319,-87.63439
TA1308000049,7,22,true,5,2,-3,41.90672,-87.6349
TA1309000024,7,22,true,3,7,4,41.908,-87.63152
LF-005,7,22,true,3,6,3,41.91172,-87.62681
TA1308000050,7,22,true,9,7,-2,41.91211,-87.6347
TA1307000166,7,22,true,4,5,1,41.91386,-87.64877
13179,7,22,true,7,5,-2,41.9157,-87.63461
TA1309000006,7,22,true,7,7,0,41.91809,-87.64375
TA1307000163,7,22,true,5,4,-1,41.91821,-87.65696
13059,7,22,true,3,5,2,41.91845,-87.65222
TA1309000033,7,22,true,5,3,-2,41.92158,-87.65381
13193,7,22,true,9,5,-4,41.92182,-87.64412
TA1306000026,7,22,true,2,10,8,41.92558,-87.65842
TA1309000019,7,22,true,5,9,4,41.92586,-87.63897
TA1309000023,7,22,true,6,3,-3,41.9287,-87.65383
TA1307000113,7,22,true,2,7,5,41.92878,-87.66391
13296,7,22,true,1,5,4,41.92883,-87.66852
TA1309000061,7,22,true,6,4,-2,41.92915,-87.64909
TA1305000014,7,22,true,8,7,-1,41.92956,-87.64313
TA1307000142,7,22,true,7,10,3,41.93125,-87.64432
TA1307000064,7,22,true,5,6,1,41.93222,-87.65864
TA1309000039,7,22,true,4,5,1,41.93258,-87.63642
TA1307000052,7,22,true,11,3,-8,41.93628,-87.65266
13137,7,22,true,4,13,9,41.9376,-87.6441
TA1309000042,7,22,true,5,2,-3,41.93937,-87.66836
TA1307000134,7,22,true,7,6,-1,41.94016,-87.65303
TA1307000138,7,22,true,6,1,-5,41.94334,-87.67094
TA1309000025,7,22,true,6,7,1,41.94368,-87.64894
632,7,22,true,5,2,-3,41.94453,-87.6547
13278,7,22,true,8,3,-5,41.94553,-87.64644
TA1307000126,7,22,true,9,6,-3,41.94936,-87.65451
TA1307000150,7,22,true,5,3,-2,41.94945,-87.64646
13323,7,22,true,1,11,10,41.95282,-87.65
TA1308000022,7,22,true,1,6,5,41.95438,-87.64805
13379,7,22,true,5,5,0,41.95786,-87.6495
13389,7,22,true,7,3,-4,41.961,-87.64958
13074,7,22,true,6,3,-3,41.96521,-87.6582
TA1309000014,7,22,true,2,5,3,41.96709,-87.66744
13109,7,22,true,3,5,2,41.97835,-87.65976
KA1504000152,7,22,true,1,7,6,41.98403,-87.65231
TA1307000164,7,23,false,8,2,-6,41.79527,-87.59647
TA1307000048,7,23,false,15,17,2,41.83855,-87.60821
13075,7,23,false,5,5,0,41.8531,-87.63192
TA1305000002,7,23,false,8,14,6,41.86721,-87.62597
15544,7,23,false,6,2,-4,41.86723,-87.61536
KA1706005007,7,23,false,1,5,4,41.86749,-87.63219
SL-005,7,23,false,12,11,-1,41.8679,-87.62304
TA1309000010,7,23,false,7,8,1,41.87074,-87.62574
623,7,23,false,17,24,7,41.87272,-87.62399
SL-007,7,23,false,4,9,5,41.87404,-87.6277
15541,7,23,false,16,16,0,41.8758,-87.62086
TA1309000002,7,23,false,7,11,4,41.87784,-87.62408
13011,7,23,false,6,4,-2,41.87931,-87.63993
KA1503000015,7,23,false,9,7,-2,41.87948,-87.6257
13300,7,23,false,26,33,7,41.88097,-87.61675
13008,7,23,false,21,29,8,41.88105,-87.62408
TA1305000006,7,23,false,9,14,5,41.88122,-87.6296
13036,7,23,false,3,13,10,41.8821,-87.62513
13053,7,23,false,6,2,-4,41.88365,-87.64863
13001,7,23,false,9,16,7,41.88397,-87.62459
15535,7,23,false,8,1,-7,41.8846,-87.64455
TA1305000029,7,23,false,4,10,6,41.88466,-87.62787
13263,7,23,false,16,18,2,41.88467,-87.61952
KA1503000012,7,23,false,2,5,3,41.88599,-87.63089
TA1305000011,7,23,false,7,18,11,41.886,-87.62418
TA1308000029,7,23,false,6,15,9,41.88673,-87.62225
TA1307000131,7,23,false,18,13,-5,41.88688,-87.62606
13050,7,23,false,7,22,15,41.88919,-87.62775
TA1307000151,7,23,false,2,6,4,41.88993,-87.63427
KA1503000044,7,23,false,4,5,1,41.89018,-87.6262
13427,7,23,false,7,2,-5,41.89054,-87.62205
13430,7,23,false,3,10,7,41.89077,-87.63169
TA1307000117,7,23,false,15,8,-7,41.89144,-87.62675
TA1305000003,7,23,false,11,12,1,41.89187,-87.62061
13022,7,23,false,8,3,-5,41.89227,-87.61205
TA1306000029,7,23,false,10,6,-4,41.89256,-87.61449
13016,7,23,false,7,8,1,41.89431,-87.62277
KA1503000041,7,23,false,9,7,-2,41.89452,-87.61798
TA1306000012,7,23,false,7,8,1,41.89475,-87.63438
13289,7,23,false,1,6,5,41.89638,-87.661
13017,7,23,false,3,6,3,41.89676,-87.6357
13034,7,23,false,3,10,7,41.89754,-87.62352
KA1504000133,7,23,false,4,5,1,41.90234,-87.62773
TA1307000039,7,23,false,6,7,1,41.90294,-87.63137
KA1504000135,7,23,false,5,5,0,41.90319,-87.63439
TA1308000049,7,23,false,2,7,5,41.90672,-87.6349
KA1504000134,7,23,false,1,5,4,41.90687,-87.6262
13221,7,23,false,2,6,4,41.90765,-87.67254
TA1309000024,7,23,false,15,7,-8,41.908,-87.63152
TA1305000041,7,23,false,7,3,-4,41.9094,-87.67769
LF-005,7,23,false,9,7,-2,41.91172,-87.62681
TA1308000050,7,23,false,5,8,3,41.91211,-87.6347
13179,7,23,false,10,4,-6,41.9157,-87.63461
TA1307000163,7,23,false,2,5,3,41.91821,-87.65696
13146,7,23,false,5,5,0,41.91831,-87.63629
13059,7,23,false,6,1,-5,41.91845,-87.65222
LP-,7,23,false,6,8,2,41.92396,-87.63584
TA1307000001,7,23,false,3,5,2,41.92535,-87.66581
TA1309000019,7,23,false,7,5,-2,41.92586,-87.63897
TA1308000001,7,23,false,9,7,-2,41.92627,-87.63086
13124,7,23,false,3,5,2,41.92675,-87.63444
TA1309000061,7,23,false,2,5,3,41.92915,-87.64909
13085,7,23,false,4,5,1,41.92958,-87.70789
TA1307000142,7,23,false,3,15,12,41.93125,-87.64432
13276,7,23,false,7,3,-4,41.93132,-87.63874
TA1307000052,7,23,false,3,11,8,41.93628,-87.65266
TA1307000134,7,23,false,6,5,-1,41.94016,-87.65303
TA1309000025,7,23,false,11,8,-3,41.94368,-87.64894
632,7,23,false,7,10,3,41.94453,-87.6547
13235,7,23,false,1,5,4,41.94814,-87.66396
13325,7,23,false,3,5,2,41.94907,-87.64863
TA1307000126,7,23,false,11,7,-4,41.94936,-87.65451
TA1307000150,7,23,false,5,4,-1,41.94945,-87.64646
13074,7,23,false,5,1,-4,41.96521,-87.6582
13108,7,23,false,1,6,5,41.97379,-87.65971
13332,7,23,true,5,5,0,41.87219,-87.6615
13430,7,23,true,5,2,-3,41.89077,-87.63169
TA1307000039,7,23,true,4,6,2,41.90294,-87.63137
TA1305000041,7,23,true,7,2,-5,41.9094,-87.67769
TA1309000033,7,23,true,2,5,3,41.92158,-87.65381
TA1307000001,7,23,true,2,5,3,41.92535,-87.66581
13277,7,23,true,1,8,7,41.9401,-87.64546
TA1309000025,7,23,true,9,2,-7,41.94368,-87.64894
632,7,23,true,2,6,4,41.94453,-87.6547
13278,7,23,true,5,3,-2,41.94553,-87.64644
13235,7,23,true,6,2,-4,41.94814,-87.66396